Anlagen,AGS,Ort,Alter von bis unter,Bevölkerung insgesamt,Bevölkerung männlich,Bevölkerung weiblich
False,8,Land Baden-Württemberg,unter 3 Jahre,345251,177575,167676
False,8,Land Baden-Württemberg,3 -  6 Jahre,366298,187894,178404
False,8,Land Baden-Württemberg,6 - 10 Jahre,477822,244905,232917
False,8,Land Baden-Württemberg,10 - 15 Jahre,555961,285066,270895
False,8,Land Baden-Württemberg,15 - 18 Jahre,323346,165779,157567
False,8,Land Baden-Württemberg,18 - 20 Jahre,216406,110392,106014
False,8,Land Baden-Württemberg,20 - 25 Jahre,634911,321119,313792
False,8,Land Baden-Württemberg,25 - 30 Jahre,885562,456603,428959
False,8,Land Baden-Württemberg,30 - 35 Jahre,941874,490528,451346
False,8,Land Baden-Württemberg,35 - 40 Jahre,820031,423978,396053
False,8,Land Baden-Württemberg,40 - 45 Jahre,704350,355676,348674
False,8,Land Baden-Württemberg,45 - 50 Jahre,634053,321539,312514
False,8,Land Baden-Württemberg,50 - 55 Jahre,614270,311138,303132
False,8,Land Baden-Württemberg,55 - 60 Jahre,725442,364246,361196
False,8,Land Baden-Württemberg,60 - 65 Jahre,540540,267121,273419
False,8,Land Baden-Württemberg,65 - 75 Jahre,888010,370414,517596
False,8,Land Baden-Württemberg,75 und mehr Jahre,645240,192874,452366
False,8,Land Baden-Württemberg,Insgesamt,10319367,5046847,5272520
False,81,Regierungsbezirk Stuttgart,unter 3 Jahre,130509,66901,63608
False,81,Regierungsbezirk Stuttgart,3 -  6 Jahre,136864,70451,66413
False,81,Regierungsbezirk Stuttgart,6 - 10 Jahre,176672,90575,86097
False,81,Regierungsbezirk Stuttgart,10 - 15 Jahre,205058,105143,99915
False,81,Regierungsbezirk Stuttgart,15 - 18 Jahre,121694,62345,59349
False,81,Regierungsbezirk Stuttgart,18 - 20 Jahre,82234,41850,40384
False,81,Regierungsbezirk Stuttgart,20 - 25 Jahre,238174,121030,117144
False,81,Regierungsbezirk Stuttgart,25 - 30 Jahre,327971,169544,158427
False,81,Regierungsbezirk Stuttgart,30 - 35 Jahre,348684,183157,165527
False,81,Regierungsbezirk Stuttgart,35 - 40 Jahre,303613,157943,145670
False,81,Regierungsbezirk Stuttgart,40 - 45 Jahre,260311,131054,129257
False,81,Regierungsbezirk Stuttgart,45 - 50 Jahre,240854,121774,119080
False,81,Regierungsbezirk Stuttgart,50 - 55 Jahre,242465,123225,119240
False,81,Regierungsbezirk Stuttgart,55 - 60 Jahre,278546,140816,137730
False,81,Regierungsbezirk Stuttgart,60 - 65 Jahre,205732,103165,102567
False,81,Regierungsbezirk Stuttgart,65 - 75 Jahre,325057,136567,188490
False,81,Regierungsbezirk Stuttgart,75 und mehr Jahre,237873,72093,165780
False,81,Regierungsbezirk Stuttgart,Insgesamt,3862311,1897633,1964678
False,8111,Stadtkreis Stuttgart,unter 3 Jahre,16399,8386,8013
False,8111,Stadtkreis Stuttgart,3 -  6 Jahre,16478,8517,7961
False,8111,Stadtkreis Stuttgart,6 - 10 Jahre,20545,10491,10054
False,8111,Stadtkreis Stuttgart,10 - 15 Jahre,23733,12038,11695
False,8111,Stadtkreis Stuttgart,15 - 18 Jahre,15163,7615,7548
False,8111,Stadtkreis Stuttgart,18 - 20 Jahre,11304,5574,5730
False,8111,Stadtkreis Stuttgart,20 - 25 Jahre,37796,18384,19412
False,8111,Stadtkreis Stuttgart,25 - 30 Jahre,55546,28609,26937
False,8111,Stadtkreis Stuttgart,30 - 35 Jahre,57792,31467,26325
False,8111,Stadtkreis Stuttgart,35 - 40 Jahre,45840,24451,21389
False,8111,Stadtkreis Stuttgart,40 - 45 Jahre,38199,19274,18925
False,8111,Stadtkreis Stuttgart,45 - 50 Jahre,37857,19207,18650
False,8111,Stadtkreis Stuttgart,50 - 55 Jahre,39541,20037,19504
False,8111,Stadtkreis Stuttgart,55 - 60 Jahre,43634,22095,21539
False,8111,Stadtkreis Stuttgart,60 - 65 Jahre,31541,15667,15874
False,8111,Stadtkreis Stuttgart,65 - 75 Jahre,49568,19539,30029
False,8111,Stadtkreis Stuttgart,75 und mehr Jahre,44668,12812,31856
False,8111,Stadtkreis Stuttgart,Insgesamt,585604,284163,301441
False,8111000,"Stuttgart, Landeshauptstadt",unter 3 Jahre,16399,8386,8013
False,8111000,"Stuttgart, Landeshauptstadt",3 -  6 Jahre,16478,8517,7961
False,8111000,"Stuttgart, Landeshauptstadt",6 - 10 Jahre,20545,10491,10054
False,8111000,"Stuttgart, Landeshauptstadt",10 - 15 Jahre,23733,12038,11695
False,8111000,"Stuttgart, Landeshauptstadt",15 - 18 Jahre,15163,7615,7548
False,8111000,"Stuttgart, Landeshauptstadt",18 - 20 Jahre,11304,5574,5730
False,8111000,"Stuttgart, Landeshauptstadt",20 - 25 Jahre,37796,18384,19412
False,8111000,"Stuttgart, Landeshauptstadt",25 - 30 Jahre,55546,28609,26937
False,8111000,"Stuttgart, Landeshauptstadt",30 - 35 Jahre,57792,31467,26325
False,8111000,"Stuttgart, Landeshauptstadt",35 - 40 Jahre,45840,24451,21389
False,8111000,"Stuttgart, Landeshauptstadt",40 - 45 Jahre,38199,19274,18925
False,8111000,"Stuttgart, Landeshauptstadt",45 - 50 Jahre,37857,19207,18650
False,8111000,"Stuttgart, Landeshauptstadt",50 - 55 Jahre,39541,20037,19504
False,8111000,"Stuttgart, Landeshauptstadt",55 - 60 Jahre,43634,22095,21539
False,8111000,"Stuttgart, Landeshauptstadt",60 - 65 Jahre,31541,15667,15874
False,8111000,"Stuttgart, Landeshauptstadt",65 - 75 Jahre,49568,19539,30029
False,8111000,"Stuttgart, Landeshauptstadt",75 und mehr Jahre,44668,12812,31856
False,8111000,"Stuttgart, Landeshauptstadt",Insgesamt,585604,284163,301441
False,8115,Landkreis Böblingen,unter 3 Jahre,12355,6306,6049
False,8115,Landkreis Böblingen,3 -  6 Jahre,12836,6599,6237
False,8115,Landkreis Böblingen,6 - 10 Jahre,16523,8464,8059
False,8115,Landkreis Böblingen,10 - 15 Jahre,18946,9684,9262
False,8115,Landkreis Böblingen,15 - 18 Jahre,11233,5700,5533
False,8115,Landkreis Böblingen,18 - 20 Jahre,7629,3964,3665
False,8115,Landkreis Böblingen,20 - 25 Jahre,21447,10872,10575
False,8115,Landkreis Böblingen,25 - 30 Jahre,30182,15547,14635
False,8115,Landkreis Böblingen,30 - 35 Jahre,32111,16639,15472
False,8115,Landkreis Böblingen,35 - 40 Jahre,28500,14667,13833
False,8115,Landkreis Böblingen,40 - 45 Jahre,24281,12135,12146
False,8115,Landkreis Böblingen,45 - 50 Jahre,22317,11078,11239
False,8115,Landkreis Böblingen,50 - 55 Jahre,24074,12378,11696
False,8115,Landkreis Böblingen,55 - 60 Jahre,26386,13480,12906
False,8115,Landkreis Böblingen,60 - 65 Jahre,18451,9457,8994
False,8115,Landkreis Böblingen,65 - 75 Jahre,26461,11501,14960
False,8115,Landkreis Böblingen,75 und mehr Jahre,17295,5241,12054
False,8115,Landkreis Böblingen,Insgesamt,351027,173712,177315
False,8115001,Aidlingen,unter 3 Jahre,322,155,167
False,8115001,Aidlingen,3 -  6 Jahre,380,213,167
False,8115001,Aidlingen,6 - 10 Jahre,404,218,186
False,8115001,Aidlingen,10 - 15 Jahre,487,250,237
False,8115001,Aidlingen,15 - 18 Jahre,313,142,171
False,8115001,Aidlingen,18 - 20 Jahre,185,82,103
False,8115001,Aidlingen,20 - 25 Jahre,575,264,311
False,8115001,Aidlingen,25 - 30 Jahre,838,409,429
False,8115001,Aidlingen,30 - 35 Jahre,938,477,461
False,8115001,Aidlingen,35 - 40 Jahre,723,373,350
False,8115001,Aidlingen,40 - 45 Jahre,593,308,285
False,8115001,Aidlingen,45 - 50 Jahre,561,268,293
False,8115001,Aidlingen,50 - 55 Jahre,563,286,277
False,8115001,Aidlingen,55 - 60 Jahre,627,335,292
False,8115001,Aidlingen,60 - 65 Jahre,440,223,217
False,8115001,Aidlingen,65 - 75 Jahre,604,276,328
False,8115001,Aidlingen,75 und mehr Jahre,367,123,244
False,8115001,Aidlingen,Insgesamt,8920,4402,4518
False,8115002,Altdorf,unter 3 Jahre,107,60,47
False,8115002,Altdorf,3 -  6 Jahre,144,71,73
False,8115002,Altdorf,6 - 10 Jahre,153,75,78
False,8115002,Altdorf,10 - 15 Jahre,184,97,87
False,8115002,Altdorf,15 - 18 Jahre,103,61,42
False,8115002,Altdorf,18 - 20 Jahre,77,40,37
False,8115002,Altdorf,20 - 25 Jahre,182,95,87
False,8115002,Altdorf,25 - 30 Jahre,219,117,102
False,8115002,Altdorf,30 - 35 Jahre,252,129,123
False,8115002,Altdorf,35 - 40 Jahre,253,117,136
False,8115002,Altdorf,40 - 45 Jahre,230,116,114
False,8115002,Altdorf,45 - 50 Jahre,193,90,103
False,8115002,Altdorf,50 - 55 Jahre,235,114,121
False,8115002,Altdorf,55 - 60 Jahre,247,129,118
False,8115002,Altdorf,60 - 65 Jahre,154,82,72
False,8115002,Altdorf,65 - 75 Jahre,203,85,118
False,8115002,Altdorf,75 und mehr Jahre,102,37,65
False,8115002,Altdorf,Insgesamt,3038,1515,1523
False,8115003,"Böblingen, Stadt",unter 3 Jahre,1450,750,700
False,8115003,"Böblingen, Stadt",3 -  6 Jahre,1472,746,726
False,8115003,"Böblingen, Stadt",6 - 10 Jahre,1823,905,918
False,8115003,"Böblingen, Stadt",10 - 15 Jahre,2175,1115,1060
False,8115003,"Böblingen, Stadt",15 - 18 Jahre,1468,770,698
False,8115003,"Böblingen, Stadt",18 - 20 Jahre,1065,590,475
False,8115003,"Böblingen, Stadt",20 - 25 Jahre,3005,1495,1510
False,8115003,"Böblingen, Stadt",25 - 30 Jahre,4036,2168,1868
False,8115003,"Böblingen, Stadt",30 - 35 Jahre,4021,2110,1911
False,8115003,"Böblingen, Stadt",35 - 40 Jahre,3637,1926,1711
False,8115003,"Böblingen, Stadt",40 - 45 Jahre,3046,1462,1584
False,8115003,"Böblingen, Stadt",45 - 50 Jahre,3037,1475,1562
False,8115003,"Böblingen, Stadt",50 - 55 Jahre,3335,1703,1632
False,8115003,"Böblingen, Stadt",55 - 60 Jahre,3695,1801,1894
False,8115003,"Böblingen, Stadt",60 - 65 Jahre,2657,1360,1297
False,8115003,"Böblingen, Stadt",65 - 75 Jahre,3907,1663,2244
False,8115003,"Böblingen, Stadt",75 und mehr Jahre,2687,807,1880
False,8115003,"Böblingen, Stadt",Insgesamt,46516,22846,23670
False,8115004,Bondorf,unter 3 Jahre,205,110,95
False,8115004,Bondorf,3 -  6 Jahre,225,100,125
False,8115004,Bondorf,6 - 10 Jahre,262,139,123
False,8115004,Bondorf,10 - 15 Jahre,305,154,151
False,8115004,Bondorf,15 - 18 Jahre,146,83,63
False,8115004,Bondorf,18 - 20 Jahre,77,37,40
False,8115004,Bondorf,20 - 25 Jahre,267,141,126
False,8115004,Bondorf,25 - 30 Jahre,379,193,186
False,8115004,Bondorf,30 - 35 Jahre,429,210,219
False,8115004,Bondorf,35 - 40 Jahre,394,204,190
False,8115004,Bondorf,40 - 45 Jahre,323,173,150
False,8115004,Bondorf,45 - 50 Jahre,247,120,127
False,8115004,Bondorf,50 - 55 Jahre,237,126,111
False,8115004,Bondorf,55 - 60 Jahre,248,134,114
False,8115004,Bondorf,60 - 65 Jahre,197,90,107
False,8115004,Bondorf,65 - 75 Jahre,274,120,154
False,8115004,Bondorf,75 und mehr Jahre,153,54,99
False,8115004,Bondorf,Insgesamt,4368,2188,2180
False,8115010,Deckenpfronn,unter 3 Jahre,100,45,55
False,8115010,Deckenpfronn,3 -  6 Jahre,106,53,53
False,8115010,Deckenpfronn,6 - 10 Jahre,133,65,68
False,8115010,Deckenpfronn,10 - 15 Jahre,134,64,70
False,8115010,Deckenpfronn,15 - 18 Jahre,69,31,38
False,8115010,Deckenpfronn,18 - 20 Jahre,51,20,31
False,8115010,Deckenpfronn,20 - 25 Jahre,170,102,68
False,8115010,Deckenpfronn,25 - 30 Jahre,218,111,107
False,8115010,Deckenpfronn,30 - 35 Jahre,294,150,144
False,8115010,Deckenpfronn,35 - 40 Jahre,194,104,90
False,8115010,Deckenpfronn,40 - 45 Jahre,147,83,64
False,8115010,Deckenpfronn,45 - 50 Jahre,144,72,72
False,8115010,Deckenpfronn,50 - 55 Jahre,141,77,64
False,8115010,Deckenpfronn,55 - 60 Jahre,153,76,77
False,8115010,Deckenpfronn,60 - 65 Jahre,111,57,54
False,8115010,Deckenpfronn,65 - 75 Jahre,168,75,93
False,8115010,Deckenpfronn,75 und mehr Jahre,83,21,62
False,8115010,Deckenpfronn,Insgesamt,2416,1206,1210
False,8115013,Ehningen,unter 3 Jahre,259,120,139
False,8115013,Ehningen,3 -  6 Jahre,245,133,112
False,8115013,Ehningen,6 - 10 Jahre,331,168,163
False,8115013,Ehningen,10 - 15 Jahre,402,209,193
False,8115013,Ehningen,15 - 18 Jahre,232,127,105
False,8115013,Ehningen,18 - 20 Jahre,140,68,72
False,8115013,Ehningen,20 - 25 Jahre,440,221,219
False,8115013,Ehningen,25 - 30 Jahre,667,326,341
False,8115013,Ehningen,30 - 35 Jahre,701,362,339
False,8115013,Ehningen,35 - 40 Jahre,567,310,257
False,8115013,Ehningen,40 - 45 Jahre,485,226,259
False,8115013,Ehningen,45 - 50 Jahre,444,220,224
False,8115013,Ehningen,50 - 55 Jahre,534,260,274
False,8115013,Ehningen,55 - 60 Jahre,549,285,264
False,8115013,Ehningen,60 - 65 Jahre,365,183,182
False,8115013,Ehningen,65 - 75 Jahre,517,229,288
False,8115013,Ehningen,75 und mehr Jahre,298,95,203
False,8115013,Ehningen,Insgesamt,7176,3542,3634
False,8115015,Gärtringen,unter 3 Jahre,376,197,179
False,8115015,Gärtringen,3 -  6 Jahre,413,195,218
False,8115015,Gärtringen,6 - 10 Jahre,559,279,280
False,8115015,Gärtringen,10 - 15 Jahre,655,330,325
False,8115015,Gärtringen,15 - 18 Jahre,369,165,204
False,8115015,Gärtringen,18 - 20 Jahre,238,137,101
False,8115015,Gärtringen,20 - 25 Jahre,708,343,365
False,8115015,Gärtringen,25 - 30 Jahre,997,486,511
False,8115015,Gärtringen,30 - 35 Jahre,1088,553,535
False,8115015,Gärtringen,35 - 40 Jahre,937,486,451
False,8115015,Gärtringen,40 - 45 Jahre,820,440,380
False,8115015,Gärtringen,45 - 50 Jahre,684,327,357
False,8115015,Gärtringen,50 - 55 Jahre,783,398,385
False,8115015,Gärtringen,55 - 60 Jahre,768,400,368
False,8115015,Gärtringen,60 - 65 Jahre,520,275,245
False,8115015,Gärtringen,65 - 75 Jahre,707,304,403
False,8115015,Gärtringen,75 und mehr Jahre,416,136,280
False,8115015,Gärtringen,Insgesamt,11038,5451,5587
False,8115016,Gäufelden,unter 3 Jahre,368,181,187
False,8115016,Gäufelden,3 -  6 Jahre,393,195,198
False,8115016,Gäufelden,6 - 10 Jahre,497,272,225
False,8115016,Gäufelden,10 - 15 Jahre,543,255,288
False,8115016,Gäufelden,15 - 18 Jahre,290,150,140
False,8115016,Gäufelden,18 - 20 Jahre,171,81,90
False,8115016,Gäufelden,20 - 25 Jahre,532,270,262
False,8115016,Gäufelden,25 - 30 Jahre,685,344,341
False,8115016,Gäufelden,30 - 35 Jahre,826,432,394
False,8115016,Gäufelden,35 - 40 Jahre,757,382,375
False,8115016,Gäufelden,40 - 45 Jahre,590,298,292
False,8115016,Gäufelden,45 - 50 Jahre,492,246,246
False,8115016,Gäufelden,50 - 55 Jahre,459,245,214
False,8115016,Gäufelden,55 - 60 Jahre,444,236,208
False,8115016,Gäufelden,60 - 65 Jahre,357,181,176
False,8115016,Gäufelden,65 - 75 Jahre,438,193,245
False,8115016,Gäufelden,75 und mehr Jahre,256,75,181
False,8115016,Gäufelden,Insgesamt,8098,4036,4062
False,8115021,"Herrenberg, Stadt",unter 3 Jahre,1021,503,518
False,8115021,"Herrenberg, Stadt",3 -  6 Jahre,1092,570,522
False,8115021,"Herrenberg, Stadt",6 - 10 Jahre,1358,718,640
False,8115021,"Herrenberg, Stadt",10 - 15 Jahre,1626,847,779
False,8115021,"Herrenberg, Stadt",15 - 18 Jahre,915,467,448
False,8115021,"Herrenberg, Stadt",18 - 20 Jahre,675,332,343
False,8115021,"Herrenberg, Stadt",20 - 25 Jahre,1866,954,912
False,8115021,"Herrenberg, Stadt",25 - 30 Jahre,2527,1329,1198
False,8115021,"Herrenberg, Stadt",30 - 35 Jahre,2556,1319,1237
False,8115021,"Herrenberg, Stadt",35 - 40 Jahre,2301,1162,1139
False,8115021,"Herrenberg, Stadt",40 - 45 Jahre,1989,1011,978
False,8115021,"Herrenberg, Stadt",45 - 50 Jahre,1666,815,851
False,8115021,"Herrenberg, Stadt",50 - 55 Jahre,1862,957,905
False,8115021,"Herrenberg, Stadt",55 - 60 Jahre,2177,1087,1090
False,8115021,"Herrenberg, Stadt",60 - 65 Jahre,1486,740,746
False,8115021,"Herrenberg, Stadt",65 - 75 Jahre,2229,956,1273
False,8115021,"Herrenberg, Stadt",75 und mehr Jahre,1493,424,1069
False,8115021,"Herrenberg, Stadt",Insgesamt,28839,14191,14648
False,8115022,Hildrizhausen,unter 3 Jahre,142,81,61
False,8115022,Hildrizhausen,3 -  6 Jahre,128,76,52
False,8115022,Hildrizhausen,6 - 10 Jahre,155,81,74
False,8115022,Hildrizhausen,10 - 15 Jahre,158,93,65
False,8115022,Hildrizhausen,15 - 18 Jahre,103,50,53
False,8115022,Hildrizhausen,18 - 20 Jahre,76,43,33
False,8115022,Hildrizhausen,20 - 25 Jahre,188,107,81
False,8115022,Hildrizhausen,25 - 30 Jahre,290,153,137
False,8115022,Hildrizhausen,30 - 35 Jahre,352,181,171
False,8115022,Hildrizhausen,35 - 40 Jahre,292,155,137
False,8115022,Hildrizhausen,40 - 45 Jahre,219,108,111
False,8115022,Hildrizhausen,45 - 50 Jahre,189,93,96
False,8115022,Hildrizhausen,50 - 55 Jahre,221,124,97
False,8115022,Hildrizhausen,55 - 60 Jahre,208,111,97
False,8115022,Hildrizhausen,60 - 65 Jahre,146,80,66
False,8115022,Hildrizhausen,65 - 75 Jahre,178,75,103
False,8115022,Hildrizhausen,75 und mehr Jahre,118,35,83
False,8115022,Hildrizhausen,Insgesamt,3163,1646,1517
False,8115024,"Holzgerlingen, Stadt",unter 3 Jahre,422,229,193
False,8115024,"Holzgerlingen, Stadt",3 -  6 Jahre,458,241,217
False,8115024,"Holzgerlingen, Stadt",6 - 10 Jahre,554,288,266
False,8115024,"Holzgerlingen, Stadt",10 - 15 Jahre,610,305,305
False,8115024,"Holzgerlingen, Stadt",15 - 18 Jahre,323,147,176
False,8115024,"Holzgerlingen, Stadt",18 - 20 Jahre,225,122,103
False,8115024,"Holzgerlingen, Stadt",20 - 25 Jahre,691,364,327
False,8115024,"Holzgerlingen, Stadt",25 - 30 Jahre,1033,520,513
False,8115024,"Holzgerlingen, Stadt",30 - 35 Jahre,1157,587,570
False,8115024,"Holzgerlingen, Stadt",35 - 40 Jahre,946,511,435
False,8115024,"Holzgerlingen, Stadt",40 - 45 Jahre,719,368,351
False,8115024,"Holzgerlingen, Stadt",45 - 50 Jahre,680,322,358
False,8115024,"Holzgerlingen, Stadt",50 - 55 Jahre,713,372,341
False,8115024,"Holzgerlingen, Stadt",55 - 60 Jahre,775,407,368
False,8115024,"Holzgerlingen, Stadt",60 - 65 Jahre,496,256,240
False,8115024,"Holzgerlingen, Stadt",65 - 75 Jahre,772,344,428
False,8115024,"Holzgerlingen, Stadt",75 und mehr Jahre,487,157,330
False,8115024,"Holzgerlingen, Stadt",Insgesamt,11061,5540,5521
False,8115028,"Leonberg, Stadt",unter 3 Jahre,1493,774,719
False,8115028,"Leonberg, Stadt",3 -  6 Jahre,1455,715,740
False,8115028,"Leonberg, Stadt",6 - 10 Jahre,1863,984,879
False,8115028,"Leonberg, Stadt",10 - 15 Jahre,2101,1100,1001
False,8115028,"Leonberg, Stadt",15 - 18 Jahre,1270,619,651
False,8115028,"Leonberg, Stadt",18 - 20 Jahre,879,437,442
False,8115028,"Leonberg, Stadt",20 - 25 Jahre,2506,1250,1256
False,8115028,"Leonberg, Stadt",25 - 30 Jahre,3652,1842,1810
False,8115028,"Leonberg, Stadt",30 - 35 Jahre,3862,2018,1844
False,8115028,"Leonberg, Stadt",35 - 40 Jahre,3460,1743,1717
False,8115028,"Leonberg, Stadt",40 - 45 Jahre,3039,1500,1539
False,8115028,"Leonberg, Stadt",45 - 50 Jahre,2934,1441,1493
False,8115028,"Leonberg, Stadt",50 - 55 Jahre,3298,1621,1677
False,8115028,"Leonberg, Stadt",55 - 60 Jahre,3418,1738,1680
False,8115028,"Leonberg, Stadt",60 - 65 Jahre,2372,1208,1164
False,8115028,"Leonberg, Stadt",65 - 75 Jahre,3532,1504,2028
False,8115028,"Leonberg, Stadt",75 und mehr Jahre,2614,817,1797
False,8115028,"Leonberg, Stadt",Insgesamt,43748,21311,22437
False,8115029,Magstadt,unter 3 Jahre,307,145,162
False,8115029,Magstadt,3 -  6 Jahre,324,166,158
False,8115029,Magstadt,6 - 10 Jahre,412,213,199
False,8115029,Magstadt,10 - 15 Jahre,493,233,260
False,8115029,Magstadt,15 - 18 Jahre,274,151,123
False,8115029,Magstadt,18 - 20 Jahre,202,106,96
False,8115029,Magstadt,20 - 25 Jahre,573,306,267
False,8115029,Magstadt,25 - 30 Jahre,808,422,386
False,8115029,Magstadt,30 - 35 Jahre,794,405,389
False,8115029,Magstadt,35 - 40 Jahre,686,347,339
False,8115029,Magstadt,40 - 45 Jahre,596,286,310
False,8115029,Magstadt,45 - 50 Jahre,537,287,250
False,8115029,Magstadt,50 - 55 Jahre,585,314,271
False,8115029,Magstadt,55 - 60 Jahre,602,308,294
False,8115029,Magstadt,60 - 65 Jahre,429,222,207
False,8115029,Magstadt,65 - 75 Jahre,605,275,330
False,8115029,Magstadt,75 und mehr Jahre,389,110,279
False,8115029,Magstadt,Insgesamt,8616,4296,4320
False,8115034,Mötzingen,unter 3 Jahre,171,88,83
False,8115034,Mötzingen,3 -  6 Jahre,167,93,74
False,8115034,Mötzingen,6 - 10 Jahre,214,99,115
False,8115034,Mötzingen,10 - 15 Jahre,236,132,104
False,8115034,Mötzingen,15 - 18 Jahre,132,73,59
False,8115034,Mötzingen,18 - 20 Jahre,66,45,21
False,8115034,Mötzingen,20 - 25 Jahre,191,86,105
False,8115034,Mötzingen,25 - 30 Jahre,308,155,153
False,8115034,Mötzingen,30 - 35 Jahre,358,173,185
False,8115034,Mötzingen,35 - 40 Jahre,309,153,156
False,8115034,Mötzingen,40 - 45 Jahre,246,140,106
False,8115034,Mötzingen,45 - 50 Jahre,188,94,94
False,8115034,Mötzingen,50 - 55 Jahre,165,90,75
False,8115034,Mötzingen,55 - 60 Jahre,214,112,102
False,8115034,Mötzingen,60 - 65 Jahre,150,74,76
False,8115034,Mötzingen,65 - 75 Jahre,201,85,116
False,8115034,Mötzingen,75 und mehr Jahre,127,42,85
False,8115034,Mötzingen,Insgesamt,3443,1734,1709
False,8115037,Nufringen,unter 3 Jahre,161,83,78
False,8115037,Nufringen,3 -  6 Jahre,160,90,70
False,8115037,Nufringen,6 - 10 Jahre,224,130,94
False,8115037,Nufringen,10 - 15 Jahre,280,154,126
False,8115037,Nufringen,15 - 18 Jahre,147,73,74
False,8115037,Nufringen,18 - 20 Jahre,84,43,41
False,8115037,Nufringen,20 - 25 Jahre,263,149,114
False,8115037,Nufringen,25 - 30 Jahre,362,181,181
False,8115037,Nufringen,30 - 35 Jahre,420,212,208
False,8115037,Nufringen,35 - 40 Jahre,375,188,187
False,8115037,Nufringen,40 - 45 Jahre,342,168,174
False,8115037,Nufringen,45 - 50 Jahre,275,143,132
False,8115037,Nufringen,50 - 55 Jahre,295,156,139
False,8115037,Nufringen,55 - 60 Jahre,330,181,149
False,8115037,Nufringen,60 - 65 Jahre,232,106,126
False,8115037,Nufringen,65 - 75 Jahre,324,159,165
False,8115037,Nufringen,75 und mehr Jahre,179,54,125
False,8115037,Nufringen,Insgesamt,4453,2270,2183
False,8115041,"Renningen, Stadt",unter 3 Jahre,581,297,284
False,8115041,"Renningen, Stadt",3 -  6 Jahre,596,301,295
False,8115041,"Renningen, Stadt",6 - 10 Jahre,852,405,447
False,8115041,"Renningen, Stadt",10 - 15 Jahre,960,493,467
False,8115041,"Renningen, Stadt",15 - 18 Jahre,543,271,272
False,8115041,"Renningen, Stadt",18 - 20 Jahre,324,160,164
False,8115041,"Renningen, Stadt",20 - 25 Jahre,902,479,423
False,8115041,"Renningen, Stadt",25 - 30 Jahre,1373,700,673
False,8115041,"Renningen, Stadt",30 - 35 Jahre,1503,768,735
False,8115041,"Renningen, Stadt",35 - 40 Jahre,1381,649,732
False,8115041,"Renningen, Stadt",40 - 45 Jahre,1174,575,599
False,8115041,"Renningen, Stadt",45 - 50 Jahre,1044,534,510
False,8115041,"Renningen, Stadt",50 - 55 Jahre,1038,527,511
False,8115041,"Renningen, Stadt",55 - 60 Jahre,1141,587,554
False,8115041,"Renningen, Stadt",60 - 65 Jahre,825,437,388
False,8115041,"Renningen, Stadt",65 - 75 Jahre,1102,504,598
False,8115041,"Renningen, Stadt",75 und mehr Jahre,745,220,525
False,8115041,"Renningen, Stadt",Insgesamt,16084,7907,8177
False,8115042,"Rutesheim, Stadt",unter 3 Jahre,344,175,169
False,8115042,"Rutesheim, Stadt",3 -  6 Jahre,361,172,189
False,8115042,"Rutesheim, Stadt",6 - 10 Jahre,489,243,246
False,8115042,"Rutesheim, Stadt",10 - 15 Jahre,536,269,267
False,8115042,"Rutesheim, Stadt",15 - 18 Jahre,291,149,142
False,8115042,"Rutesheim, Stadt",18 - 20 Jahre,223,125,98
False,8115042,"Rutesheim, Stadt",20 - 25 Jahre,587,326,261
False,8115042,"Rutesheim, Stadt",25 - 30 Jahre,856,424,432
False,8115042,"Rutesheim, Stadt",30 - 35 Jahre,896,464,432
False,8115042,"Rutesheim, Stadt",35 - 40 Jahre,792,412,380
False,8115042,"Rutesheim, Stadt",40 - 45 Jahre,641,329,312
False,8115042,"Rutesheim, Stadt",45 - 50 Jahre,602,296,306
False,8115042,"Rutesheim, Stadt",50 - 55 Jahre,599,310,289
False,8115042,"Rutesheim, Stadt",55 - 60 Jahre,700,352,348
False,8115042,"Rutesheim, Stadt",60 - 65 Jahre,499,243,256
False,8115042,"Rutesheim, Stadt",65 - 75 Jahre,684,307,377
False,8115042,"Rutesheim, Stadt",75 und mehr Jahre,415,132,283
False,8115042,"Rutesheim, Stadt",Insgesamt,9515,4728,4787
False,8115044,Schönaich,unter 3 Jahre,329,179,150
False,8115044,Schönaich,3 -  6 Jahre,327,165,162
False,8115044,Schönaich,6 - 10 Jahre,458,248,210
False,8115044,Schönaich,10 - 15 Jahre,544,262,282
False,8115044,Schönaich,15 - 18 Jahre,333,153,180
False,8115044,Schönaich,18 - 20 Jahre,234,109,125
False,8115044,Schönaich,20 - 25 Jahre,587,302,285
False,8115044,Schönaich,25 - 30 Jahre,897,445,452
False,8115044,Schönaich,30 - 35 Jahre,872,460,412
False,8115044,Schönaich,35 - 40 Jahre,797,435,362
False,8115044,Schönaich,40 - 45 Jahre,692,345,347
False,8115044,Schönaich,45 - 50 Jahre,621,309,312
False,8115044,Schönaich,50 - 55 Jahre,725,363,362
False,8115044,Schönaich,55 - 60 Jahre,768,399,369
False,8115044,Schönaich,60 - 65 Jahre,570,299,271
False,8115044,Schönaich,65 - 75 Jahre,693,325,368
False,8115044,Schönaich,75 und mehr Jahre,507,142,365
False,8115044,Schönaich,Insgesamt,9954,4940,5014
False,8115045,"Sindelfingen, Stadt",unter 3 Jahre,1867,946,921
False,8115045,"Sindelfingen, Stadt",3 -  6 Jahre,1906,974,932
False,8115045,"Sindelfingen, Stadt",6 - 10 Jahre,2606,1287,1319
False,8115045,"Sindelfingen, Stadt",10 - 15 Jahre,3092,1616,1476
False,8115045,"Sindelfingen, Stadt",15 - 18 Jahre,1881,996,885
False,8115045,"Sindelfingen, Stadt",18 - 20 Jahre,1325,693,632
False,8115045,"Sindelfingen, Stadt",20 - 25 Jahre,3655,1863,1792
False,8115045,"Sindelfingen, Stadt",25 - 30 Jahre,4929,2592,2337
False,8115045,"Sindelfingen, Stadt",30 - 35 Jahre,5046,2680,2366
False,8115045,"Sindelfingen, Stadt",35 - 40 Jahre,4497,2287,2210
False,8115045,"Sindelfingen, Stadt",40 - 45 Jahre,3920,1965,1955
False,8115045,"Sindelfingen, Stadt",45 - 50 Jahre,3871,1941,1930
False,8115045,"Sindelfingen, Stadt",50 - 55 Jahre,4215,2170,2045
False,8115045,"Sindelfingen, Stadt",55 - 60 Jahre,5011,2613,2398
False,8115045,"Sindelfingen, Stadt",60 - 65 Jahre,3414,1783,1631
False,8115045,"Sindelfingen, Stadt",65 - 75 Jahre,4967,2147,2820
False,8115045,"Sindelfingen, Stadt",75 und mehr Jahre,3233,965,2268
False,8115045,"Sindelfingen, Stadt",Insgesamt,59435,29518,29917
False,8115046,Steinenbronn,unter 3 Jahre,247,126,121
False,8115046,Steinenbronn,3 -  6 Jahre,256,144,112
False,8115046,Steinenbronn,6 - 10 Jahre,318,162,156
False,8115046,Steinenbronn,10 - 15 Jahre,351,173,178
False,8115046,Steinenbronn,15 - 18 Jahre,182,85,97
False,8115046,Steinenbronn,18 - 20 Jahre,115,60,55
False,8115046,Steinenbronn,20 - 25 Jahre,297,140,157
False,8115046,Steinenbronn,25 - 30 Jahre,473,237,236
False,8115046,Steinenbronn,30 - 35 Jahre,598,300,298
False,8115046,Steinenbronn,35 - 40 Jahre,536,283,253
False,8115046,Steinenbronn,40 - 45 Jahre,430,235,195
False,8115046,Steinenbronn,45 - 50 Jahre,333,156,177
False,8115046,Steinenbronn,50 - 55 Jahre,370,195,175
False,8115046,Steinenbronn,55 - 60 Jahre,384,175,209
False,8115046,Steinenbronn,60 - 65 Jahre,308,174,134
False,8115046,Steinenbronn,65 - 75 Jahre,360,156,204
False,8115046,Steinenbronn,75 und mehr Jahre,254,74,180
False,8115046,Steinenbronn,Insgesamt,5812,2875,2937
False,8115048,"Waldenbuch, Stadt",unter 3 Jahre,282,148,134
False,8115048,"Waldenbuch, Stadt",3 -  6 Jahre,316,168,148
False,8115048,"Waldenbuch, Stadt",6 - 10 Jahre,399,218,181
False,8115048,"Waldenbuch, Stadt",10 - 15 Jahre,431,204,227
False,8115048,"Waldenbuch, Stadt",15 - 18 Jahre,312,162,150
False,8115048,"Waldenbuch, Stadt",18 - 20 Jahre,188,90,98
False,8115048,"Waldenbuch, Stadt",20 - 25 Jahre,492,246,246
False,8115048,"Waldenbuch, Stadt",25 - 30 Jahre,673,343,330
False,8115048,"Waldenbuch, Stadt",30 - 35 Jahre,736,363,373
False,8115048,"Waldenbuch, Stadt",35 - 40 Jahre,689,362,327
False,8115048,"Waldenbuch, Stadt",40 - 45 Jahre,669,317,352
False,8115048,"Waldenbuch, Stadt",45 - 50 Jahre,601,314,287
False,8115048,"Waldenbuch, Stadt",50 - 55 Jahre,563,295,268
False,8115048,"Waldenbuch, Stadt",55 - 60 Jahre,561,280,281
False,8115048,"Waldenbuch, Stadt",60 - 65 Jahre,405,201,204
False,8115048,"Waldenbuch, Stadt",65 - 75 Jahre,586,251,335
False,8115048,"Waldenbuch, Stadt",75 und mehr Jahre,364,109,255
False,8115048,"Waldenbuch, Stadt",Insgesamt,8267,4071,4196
False,8115050,"Weil der Stadt, Stadt",unter 3 Jahre,657,350,307
False,8115050,"Weil der Stadt, Stadt",3 -  6 Jahre,712,370,342
False,8115050,"Weil der Stadt, Stadt",6 - 10 Jahre,939,473,466
False,8115050,"Weil der Stadt, Stadt",10 - 15 Jahre,1001,496,505
False,8115050,"Weil der Stadt, Stadt",15 - 18 Jahre,623,324,299
False,8115050,"Weil der Stadt, Stadt",18 - 20 Jahre,388,200,188
False,8115050,"Weil der Stadt, Stadt",20 - 25 Jahre,1051,517,534
False,8115050,"Weil der Stadt, Stadt",25 - 30 Jahre,1496,798,698
False,8115050,"Weil der Stadt, Stadt",30 - 35 Jahre,1583,828,755
False,8115050,"Weil der Stadt, Stadt",35 - 40 Jahre,1471,763,708
False,8115050,"Weil der Stadt, Stadt",40 - 45 Jahre,1339,665,674
False,8115050,"Weil der Stadt, Stadt",45 - 50 Jahre,1160,595,565
False,8115050,"Weil der Stadt, Stadt",50 - 55 Jahre,1179,647,532
False,8115050,"Weil der Stadt, Stadt",55 - 60 Jahre,1297,645,652
False,8115050,"Weil der Stadt, Stadt",60 - 65 Jahre,967,492,475
False,8115050,"Weil der Stadt, Stadt",65 - 75 Jahre,1419,612,807
False,8115050,"Weil der Stadt, Stadt",75 und mehr Jahre,848,258,590
False,8115050,"Weil der Stadt, Stadt",Insgesamt,18130,9033,9097
False,8115051,Weil im Schönbuch,unter 3 Jahre,340,156,184
False,8115051,Weil im Schönbuch,3 -  6 Jahre,359,202,157
False,8115051,Weil im Schönbuch,6 - 10 Jahre,423,242,181
False,8115051,Weil im Schönbuch,10 - 15 Jahre,476,250,226
False,8115051,Weil im Schönbuch,15 - 18 Jahre,257,126,131
False,8115051,Weil im Schönbuch,18 - 20 Jahre,198,107,91
False,8115051,Weil im Schönbuch,20 - 25 Jahre,523,251,272
False,8115051,Weil im Schönbuch,25 - 30 Jahre,857,453,404
False,8115051,Weil im Schönbuch,30 - 35 Jahre,927,495,432
False,8115051,Weil im Schönbuch,35 - 40 Jahre,770,411,359
False,8115051,Weil im Schönbuch,40 - 45 Jahre,584,280,304
False,8115051,Weil im Schönbuch,45 - 50 Jahre,549,279,270
False,8115051,Weil im Schönbuch,50 - 55 Jahre,646,341,305
False,8115051,Weil im Schönbuch,55 - 60 Jahre,682,353,329
False,8115051,Weil im Schönbuch,60 - 65 Jahre,441,221,220
False,8115051,Weil im Schönbuch,65 - 75 Jahre,650,285,365
False,8115051,Weil im Schönbuch,75 und mehr Jahre,380,115,265
False,8115051,Weil im Schönbuch,Insgesamt,9062,4567,4495
False,8115052,Weissach,unter 3 Jahre,311,166,145
False,8115052,Weissach,3 -  6 Jahre,313,171,142
False,8115052,Weissach,6 - 10 Jahre,367,199,168
False,8115052,Weissach,10 - 15 Jahre,431,212,219
False,8115052,Weissach,15 - 18 Jahre,237,115,122
False,8115052,Weissach,18 - 20 Jahre,149,78,71
False,8115052,Weissach,20 - 25 Jahre,430,234,196
False,8115052,Weissach,25 - 30 Jahre,580,303,277
False,8115052,Weissach,30 - 35 Jahre,669,330,339
False,8115052,Weissach,35 - 40 Jahre,640,327,313
False,8115052,Weissach,40 - 45 Jahre,546,284,262
False,8115052,Weissach,45 - 50 Jahre,470,232,238
False,8115052,Weissach,50 - 55 Jahre,483,261,222
False,8115052,Weissach,55 - 60 Jahre,512,268,244
False,8115052,Weissach,60 - 65 Jahre,300,151,149
False,8115052,Weissach,65 - 75 Jahre,496,215,281
False,8115052,Weissach,75 und mehr Jahre,279,81,198
False,8115052,Weissach,Insgesamt,7213,3627,3586
False,8115053,Jettingen,unter 3 Jahre,279,135,144
False,8115053,Jettingen,3 -  6 Jahre,313,163,150
False,8115053,Jettingen,6 - 10 Jahre,438,205,233
False,8115053,Jettingen,10 - 15 Jahre,465,238,227
False,8115053,Jettingen,15 - 18 Jahre,255,118,137
False,8115053,Jettingen,18 - 20 Jahre,145,87,58
False,8115053,Jettingen,20 - 25 Jahre,395,179,216
False,8115053,Jettingen,25 - 30 Jahre,510,240,270
False,8115053,Jettingen,30 - 35 Jahre,657,322,335
False,8115053,Jettingen,35 - 40 Jahre,613,312,301
False,8115053,Jettingen,40 - 45 Jahre,483,245,238
False,8115053,Jettingen,45 - 50 Jahre,410,226,184
False,8115053,Jettingen,50 - 55 Jahre,394,206,188
False,8115053,Jettingen,55 - 60 Jahre,445,230,215
False,8115053,Jettingen,60 - 65 Jahre,294,152,142
False,8115053,Jettingen,65 - 75 Jahre,419,181,238
False,8115053,Jettingen,75 und mehr Jahre,230,72,158
False,8115053,Jettingen,Insgesamt,6745,3311,3434
False,8115054,Grafenau,unter 3 Jahre,214,107,107
False,8115054,Grafenau,3 -  6 Jahre,215,112,103
False,8115054,Grafenau,6 - 10 Jahre,292,148,144
False,8115054,Grafenau,10 - 15 Jahre,270,133,137
False,8115054,Grafenau,15 - 18 Jahre,165,92,73
False,8115054,Grafenau,18 - 20 Jahre,129,72,57
False,8115054,Grafenau,20 - 25 Jahre,371,188,183
False,8115054,Grafenau,25 - 30 Jahre,519,256,263
False,8115054,Grafenau,30 - 35 Jahre,576,311,265
False,8115054,Grafenau,35 - 40 Jahre,483,265,218
False,8115054,Grafenau,40 - 45 Jahre,419,208,211
False,8115054,Grafenau,45 - 50 Jahre,385,183,202
False,8115054,Grafenau,50 - 55 Jahre,436,220,216
False,8115054,Grafenau,55 - 60 Jahre,430,238,192
False,8115054,Grafenau,60 - 65 Jahre,316,167,149
False,8115054,Grafenau,65 - 75 Jahre,426,175,251
False,8115054,Grafenau,75 und mehr Jahre,271,86,185
False,8115054,Grafenau,Insgesamt,5917,2961,2956
False,8116,Landkreis Esslingen,unter 3 Jahre,16590,8478,8112
False,8116,Landkreis Esslingen,3 -  6 Jahre,16982,8743,8239
False,8116,Landkreis Esslingen,6 - 10 Jahre,21668,11174,10494
False,8116,Landkreis Esslingen,10 - 15 Jahre,24923,12822,12101
False,8116,Landkreis Esslingen,15 - 18 Jahre,15150,7792,7358
False,8116,Landkreis Esslingen,18 - 20 Jahre,10077,5127,4950
False,8116,Landkreis Esslingen,20 - 25 Jahre,29165,14940,14225
False,8116,Landkreis Esslingen,25 - 30 Jahre,41102,21030,20072
False,8116,Landkreis Esslingen,30 - 35 Jahre,44685,23237,21448
False,8116,Landkreis Esslingen,35 - 40 Jahre,38854,20098,18756
False,8116,Landkreis Esslingen,40 - 45 Jahre,32804,16286,16518
False,8116,Landkreis Esslingen,45 - 50 Jahre,31814,15891,15923
False,8116,Landkreis Esslingen,50 - 55 Jahre,33188,16913,16275
False,8116,Landkreis Esslingen,55 - 60 Jahre,37061,18697,18364
False,8116,Landkreis Esslingen,60 - 65 Jahre,26750,13618,13132
False,8116,Landkreis Esslingen,65 - 75 Jahre,40293,17375,22918
False,8116,Landkreis Esslingen,75 und mehr Jahre,29063,9074,19989
False,8116,Landkreis Esslingen,Insgesamt,490169,241295,248874
False,8116004,Altbach,unter 3 Jahre,168,75,93
False,8116004,Altbach,3 -  6 Jahre,162,88,74
False,8116004,Altbach,6 - 10 Jahre,219,112,107
False,8116004,Altbach,10 - 15 Jahre,237,131,106
False,8116004,Altbach,15 - 18 Jahre,159,80,79
False,8116004,Altbach,18 - 20 Jahre,101,49,52
False,8116004,Altbach,20 - 25 Jahre,365,169,196
False,8116004,Altbach,25 - 30 Jahre,491,255,236
False,8116004,Altbach,30 - 35 Jahre,504,245,259
False,8116004,Altbach,35 - 40 Jahre,409,230,179
False,8116004,Altbach,40 - 45 Jahre,329,159,170
False,8116004,Altbach,45 - 50 Jahre,390,192,198
False,8116004,Altbach,50 - 55 Jahre,405,210,195
False,8116004,Altbach,55 - 60 Jahre,503,267,236
False,8116004,Altbach,60 - 65 Jahre,294,138,156
False,8116004,Altbach,65 - 75 Jahre,496,213,283
False,8116004,Altbach,75 und mehr Jahre,354,120,234
False,8116004,Altbach,Insgesamt,5586,2733,2853
False,8116005,Altdorf,unter 3 Jahre,56,32,24
False,8116005,Altdorf,3 -  6 Jahre,66,33,33
False,8116005,Altdorf,6 - 10 Jahre,59,28,31
False,8116005,Altdorf,10 - 15 Jahre,74,33,41
False,8116005,Altdorf,15 - 18 Jahre,35,16,19
False,8116005,Altdorf,18 - 20 Jahre,23,11,12
False,8116005,Altdorf,20 - 25 Jahre,69,36,33
False,8116005,Altdorf,25 - 30 Jahre,111,53,58
False,8116005,Altdorf,30 - 35 Jahre,150,83,67
False,8116005,Altdorf,35 - 40 Jahre,109,55,54
False,8116005,Altdorf,40 - 45 Jahre,76,42,34
False,8116005,Altdorf,45 - 50 Jahre,81,46,35
False,8116005,Altdorf,50 - 55 Jahre,60,34,26
False,8116005,Altdorf,55 - 60 Jahre,63,33,30
False,8116005,Altdorf,60 - 65 Jahre,41,19,22
False,8116005,Altdorf,65 - 75 Jahre,62,27,35
False,8116005,Altdorf,75 und mehr Jahre,28,11,17
False,8116005,Altdorf,Insgesamt,1163,592,571
False,8116006,Altenriet,unter 3 Jahre,62,29,33
False,8116006,Altenriet,3 -  6 Jahre,64,30,34
False,8116006,Altenriet,6 - 10 Jahre,81,36,45
False,8116006,Altenriet,10 - 15 Jahre,90,48,42
False,8116006,Altenriet,15 - 18 Jahre,45,28,17
False,8116006,Altenriet,18 - 20 Jahre,31,14,17
False,8116006,Altenriet,20 - 25 Jahre,85,35,50
False,8116006,Altenriet,25 - 30 Jahre,125,61,64
False,8116006,Altenriet,30 - 35 Jahre,157,83,74
False,8116006,Altenriet,35 - 40 Jahre,138,65,73
False,8116006,Altenriet,40 - 45 Jahre,105,54,51
False,8116006,Altenriet,45 - 50 Jahre,110,57,53
False,8116006,Altenriet,50 - 55 Jahre,97,51,46
False,8116006,Altenriet,55 - 60 Jahre,119,63,56
False,8116006,Altenriet,60 - 65 Jahre,80,36,44
False,8116006,Altenriet,65 - 75 Jahre,84,35,49
False,8116006,Altenriet,75 und mehr Jahre,69,23,46
False,8116006,Altenriet,Insgesamt,1542,748,794
False,8116007,Baltmannsweiler,unter 3 Jahre,194,94,100
False,8116007,Baltmannsweiler,3 -  6 Jahre,228,117,111
False,8116007,Baltmannsweiler,6 - 10 Jahre,284,162,122
False,8116007,Baltmannsweiler,10 - 15 Jahre,257,131,126
False,8116007,Baltmannsweiler,15 - 18 Jahre,158,75,83
False,8116007,Baltmannsweiler,18 - 20 Jahre,124,77,47
False,8116007,Baltmannsweiler,20 - 25 Jahre,315,156,159
False,8116007,Baltmannsweiler,25 - 30 Jahre,425,223,202
False,8116007,Baltmannsweiler,30 - 35 Jahre,496,260,236
False,8116007,Baltmannsweiler,35 - 40 Jahre,411,212,199
False,8116007,Baltmannsweiler,40 - 45 Jahre,369,181,188
False,8116007,Baltmannsweiler,45 - 50 Jahre,361,183,178
False,8116007,Baltmannsweiler,50 - 55 Jahre,425,202,223
False,8116007,Baltmannsweiler,55 - 60 Jahre,405,208,197
False,8116007,Baltmannsweiler,60 - 65 Jahre,299,162,137
False,8116007,Baltmannsweiler,65 - 75 Jahre,437,195,242
False,8116007,Baltmannsweiler,75 und mehr Jahre,237,73,164
False,8116007,Baltmannsweiler,Insgesamt,5425,2711,2714
False,8116008,Bempflingen,unter 3 Jahre,99,45,54
False,8116008,Bempflingen,3 -  6 Jahre,123,65,58
False,8116008,Bempflingen,6 - 10 Jahre,137,61,76
False,8116008,Bempflingen,10 - 15 Jahre,192,97,95
False,8116008,Bempflingen,15 - 18 Jahre,117,55,62
False,8116008,Bempflingen,18 - 20 Jahre,55,32,23
False,8116008,Bempflingen,20 - 25 Jahre,192,103,89
False,8116008,Bempflingen,25 - 30 Jahre,241,115,126
False,8116008,Bempflingen,30 - 35 Jahre,262,141,121
False,8116008,Bempflingen,35 - 40 Jahre,225,99,126
False,8116008,Bempflingen,40 - 45 Jahre,215,108,107
False,8116008,Bempflingen,45 - 50 Jahre,197,95,102
False,8116008,Bempflingen,50 - 55 Jahre,228,124,104
False,8116008,Bempflingen,55 - 60 Jahre,250,123,127
False,8116008,Bempflingen,60 - 65 Jahre,174,92,82
False,8116008,Bempflingen,65 - 75 Jahre,252,109,143
False,8116008,Bempflingen,75 und mehr Jahre,187,59,128
False,8116008,Bempflingen,Insgesamt,3146,1523,1623
False,8116011,Beuren,unter 3 Jahre,111,54,57
False,8116011,Beuren,3 -  6 Jahre,141,81,60
False,8116011,Beuren,6 - 10 Jahre,210,126,84
False,8116011,Beuren,10 - 15 Jahre,187,106,81
False,8116011,Beuren,15 - 18 Jahre,129,61,68
False,8116011,Beuren,18 - 20 Jahre,54,28,26
False,8116011,Beuren,20 - 25 Jahre,193,102,91
False,8116011,Beuren,25 - 30 Jahre,243,124,119
False,8116011,Beuren,30 - 35 Jahre,274,147,127
False,8116011,Beuren,35 - 40 Jahre,295,140,155
False,8116011,Beuren,40 - 45 Jahre,236,132,104
False,8116011,Beuren,45 - 50 Jahre,170,89,81
False,8116011,Beuren,50 - 55 Jahre,215,103,112
False,8116011,Beuren,55 - 60 Jahre,270,122,148
False,8116011,Beuren,60 - 65 Jahre,191,93,98
False,8116011,Beuren,65 - 75 Jahre,310,132,178
False,8116011,Beuren,75 und mehr Jahre,220,79,141
False,8116011,Beuren,Insgesamt,3449,1719,1730
False,8116012,Bissingen an der Teck,unter 3 Jahre,141,80,61
False,8116012,Bissingen an der Teck,3 -  6 Jahre,140,70,70
False,8116012,Bissingen an der Teck,6 - 10 Jahre,169,89,80
False,8116012,Bissingen an der Teck,10 - 15 Jahre,223,122,101
False,8116012,Bissingen an der Teck,15 - 18 Jahre,128,71,57
False,8116012,Bissingen an der Teck,18 - 20 Jahre,86,45,41
False,8116012,Bissingen an der Teck,20 - 25 Jahre,202,108,94
False,8116012,Bissingen an der Teck,25 - 30 Jahre,258,140,118
False,8116012,Bissingen an der Teck,30 - 35 Jahre,301,148,153
False,8116012,Bissingen an der Teck,35 - 40 Jahre,283,138,145
False,8116012,Bissingen an der Teck,40 - 45 Jahre,249,125,124
False,8116012,Bissingen an der Teck,45 - 50 Jahre,221,113,108
False,8116012,Bissingen an der Teck,50 - 55 Jahre,192,103,89
False,8116012,Bissingen an der Teck,55 - 60 Jahre,247,129,118
False,8116012,Bissingen an der Teck,60 - 65 Jahre,203,106,97
False,8116012,Bissingen an der Teck,65 - 75 Jahre,264,108,156
False,8116012,Bissingen an der Teck,75 und mehr Jahre,169,55,114
False,8116012,Bissingen an der Teck,Insgesamt,3476,1750,1726
False,8116014,Deizisau,unter 3 Jahre,205,116,89
False,8116014,Deizisau,3 -  6 Jahre,187,96,91
False,8116014,Deizisau,6 - 10 Jahre,251,128,123
False,8116014,Deizisau,10 - 15 Jahre,295,173,122
False,8116014,Deizisau,15 - 18 Jahre,168,88,80
False,8116014,Deizisau,18 - 20 Jahre,109,65,44
False,8116014,Deizisau,20 - 25 Jahre,361,195,166
False,8116014,Deizisau,25 - 30 Jahre,542,278,264
False,8116014,Deizisau,30 - 35 Jahre,570,303,267
False,8116014,Deizisau,35 - 40 Jahre,406,204,202
False,8116014,Deizisau,40 - 45 Jahre,402,213,189
False,8116014,Deizisau,45 - 50 Jahre,382,172,210
False,8116014,Deizisau,50 - 55 Jahre,479,240,239
False,8116014,Deizisau,55 - 60 Jahre,510,265,245
False,8116014,Deizisau,60 - 65 Jahre,373,193,180
False,8116014,Deizisau,65 - 75 Jahre,520,236,284
False,8116014,Deizisau,75 und mehr Jahre,294,111,183
False,8116014,Deizisau,Insgesamt,6054,3076,2978
False,8116015,Denkendorf,unter 3 Jahre,364,215,149
False,8116015,Denkendorf,3 -  6 Jahre,351,169,182
False,8116015,Denkendorf,6 - 10 Jahre,467,245,222
False,8116015,Denkendorf,10 - 15 Jahre,510,260,250
False,8116015,Denkendorf,15 - 18 Jahre,329,171,158
False,8116015,Denkendorf,18 - 20 Jahre,234,113,121
False,8116015,Denkendorf,20 - 25 Jahre,613,315,298
False,8116015,Denkendorf,25 - 30 Jahre,932,480,452
False,8116015,Denkendorf,30 - 35 Jahre,946,528,418
False,8116015,Denkendorf,35 - 40 Jahre,768,393,375
False,8116015,Denkendorf,40 - 45 Jahre,686,340,346
False,8116015,Denkendorf,45 - 50 Jahre,686,357,329
False,8116015,Denkendorf,50 - 55 Jahre,713,362,351
False,8116015,Denkendorf,55 - 60 Jahre,807,431,376
False,8116015,Denkendorf,60 - 65 Jahre,609,333,276
False,8116015,Denkendorf,65 - 75 Jahre,745,328,417
False,8116015,Denkendorf,75 und mehr Jahre,448,135,313
False,8116015,Denkendorf,Insgesamt,10208,5175,5033
False,8116016,Dettingen unter Teck,unter 3 Jahre,194,109,85
False,8116016,Dettingen unter Teck,3 -  6 Jahre,187,99,88
False,8116016,Dettingen unter Teck,6 - 10 Jahre,255,114,141
False,8116016,Dettingen unter Teck,10 - 15 Jahre,279,145,134
False,8116016,Dettingen unter Teck,15 - 18 Jahre,170,91,79
False,8116016,Dettingen unter Teck,18 - 20 Jahre,110,60,50
False,8116016,Dettingen unter Teck,20 - 25 Jahre,278,152,126
False,8116016,Dettingen unter Teck,25 - 30 Jahre,406,208,198
False,8116016,Dettingen unter Teck,30 - 35 Jahre,428,225,203
False,8116016,Dettingen unter Teck,35 - 40 Jahre,390,197,193
False,8116016,Dettingen unter Teck,40 - 45 Jahre,375,174,201
False,8116016,Dettingen unter Teck,45 - 50 Jahre,356,183,173
False,8116016,Dettingen unter Teck,50 - 55 Jahre,386,197,189
False,8116016,Dettingen unter Teck,55 - 60 Jahre,401,208,193
False,8116016,Dettingen unter Teck,60 - 65 Jahre,289,143,146
False,8116016,Dettingen unter Teck,65 - 75 Jahre,479,211,268
False,8116016,Dettingen unter Teck,75 und mehr Jahre,372,84,288
False,8116016,Dettingen unter Teck,Insgesamt,5355,2600,2755
False,8116018,Erkenbrechtsweiler,unter 3 Jahre,82,39,43
False,8116018,Erkenbrechtsweiler,3 -  6 Jahre,111,58,53
False,8116018,Erkenbrechtsweiler,6 - 10 Jahre,106,39,67
False,8116018,Erkenbrechtsweiler,10 - 15 Jahre,122,61,61
False,8116018,Erkenbrechtsweiler,15 - 18 Jahre,55,24,31
False,8116018,Erkenbrechtsweiler,18 - 20 Jahre,44,25,19
False,8116018,Erkenbrechtsweiler,20 - 25 Jahre,116,63,53
False,8116018,Erkenbrechtsweiler,25 - 30 Jahre,159,79,80
False,8116018,Erkenbrechtsweiler,30 - 35 Jahre,176,84,92
False,8116018,Erkenbrechtsweiler,35 - 40 Jahre,185,101,84
False,8116018,Erkenbrechtsweiler,40 - 45 Jahre,160,80,80
False,8116018,Erkenbrechtsweiler,45 - 50 Jahre,121,67,54
False,8116018,Erkenbrechtsweiler,50 - 55 Jahre,110,56,54
False,8116018,Erkenbrechtsweiler,55 - 60 Jahre,131,63,68
False,8116018,Erkenbrechtsweiler,60 - 65 Jahre,94,48,46
False,8116018,Erkenbrechtsweiler,65 - 75 Jahre,146,54,92
False,8116018,Erkenbrechtsweiler,75 und mehr Jahre,94,27,67
False,8116018,Erkenbrechtsweiler,Insgesamt,2012,968,1044
False,8116019,"Esslingen am Neckar, Stadt",unter 3 Jahre,2663,1385,1278
False,8116019,"Esslingen am Neckar, Stadt",3 -  6 Jahre,2645,1390,1255
False,8116019,"Esslingen am Neckar, Stadt",6 - 10 Jahre,3271,1710,1561
False,8116019,"Esslingen am Neckar, Stadt",10 - 15 Jahre,3989,2053,1936
False,8116019,"Esslingen am Neckar, Stadt",15 - 18 Jahre,2650,1322,1328
False,8116019,"Esslingen am Neckar, Stadt",18 - 20 Jahre,1899,947,952
False,8116019,"Esslingen am Neckar, Stadt",20 - 25 Jahre,5355,2725,2630
False,8116019,"Esslingen am Neckar, Stadt",25 - 30 Jahre,7478,3954,3524
False,8116019,"Esslingen am Neckar, Stadt",30 - 35 Jahre,7972,4299,3673
False,8116019,"Esslingen am Neckar, Stadt",35 - 40 Jahre,6805,3571,3234
False,8116019,"Esslingen am Neckar, Stadt",40 - 45 Jahre,5614,2817,2797
False,8116019,"Esslingen am Neckar, Stadt",45 - 50 Jahre,5768,2872,2896
False,8116019,"Esslingen am Neckar, Stadt",50 - 55 Jahre,6330,3254,3076
False,8116019,"Esslingen am Neckar, Stadt",55 - 60 Jahre,7214,3612,3602
False,8116019,"Esslingen am Neckar, Stadt",60 - 65 Jahre,5171,2644,2527
False,8116019,"Esslingen am Neckar, Stadt",65 - 75 Jahre,8223,3473,4750
False,8116019,"Esslingen am Neckar, Stadt",75 und mehr Jahre,6982,2161,4821
False,8116019,"Esslingen am Neckar, Stadt",Insgesamt,90029,44189,45840
False,8116020,Frickenhausen,unter 3 Jahre,323,157,166
False,8116020,Frickenhausen,3 -  6 Jahre,341,164,177
False,8116020,Frickenhausen,6 - 10 Jahre,426,236,190
False,8116020,Frickenhausen,10 - 15 Jahre,471,252,219
False,8116020,Frickenhausen,15 - 18 Jahre,272,135,137
False,8116020,Frickenhausen,18 - 20 Jahre,180,104,76
False,8116020,Frickenhausen,20 - 25 Jahre,528,280,248
False,8116020,Frickenhausen,25 - 30 Jahre,717,373,344
False,8116020,Frickenhausen,30 - 35 Jahre,790,422,368
False,8116020,Frickenhausen,35 - 40 Jahre,688,375,313
False,8116020,Frickenhausen,40 - 45 Jahre,592,283,309
False,8116020,Frickenhausen,45 - 50 Jahre,584,295,289
False,8116020,Frickenhausen,50 - 55 Jahre,599,323,276
False,8116020,Frickenhausen,55 - 60 Jahre,691,360,331
False,8116020,Frickenhausen,60 - 65 Jahre,529,278,251
False,8116020,Frickenhausen,65 - 75 Jahre,696,299,397
False,8116020,Frickenhausen,75 und mehr Jahre,530,177,353
False,8116020,Frickenhausen,Insgesamt,8957,4513,4444
False,8116022,Großbettlingen,unter 3 Jahre,134,62,72
False,8116022,Großbettlingen,3 -  6 Jahre,123,58,65
False,8116022,Großbettlingen,6 - 10 Jahre,189,85,104
False,8116022,Großbettlingen,10 - 15 Jahre,213,91,122
False,8116022,Großbettlingen,15 - 18 Jahre,118,67,51
False,8116022,Großbettlingen,18 - 20 Jahre,66,36,30
False,8116022,Großbettlingen,20 - 25 Jahre,228,117,111
False,8116022,Großbettlingen,25 - 30 Jahre,288,156,132
False,8116022,Großbettlingen,30 - 35 Jahre,364,182,182
False,8116022,Großbettlingen,35 - 40 Jahre,286,149,137
False,8116022,Großbettlingen,40 - 45 Jahre,249,109,140
False,8116022,Großbettlingen,45 - 50 Jahre,263,134,129
False,8116022,Großbettlingen,50 - 55 Jahre,243,113,130
False,8116022,Großbettlingen,55 - 60 Jahre,292,162,130
False,8116022,Großbettlingen,60 - 65 Jahre,181,93,88
False,8116022,Großbettlingen,65 - 75 Jahre,264,110,154
False,8116022,Großbettlingen,75 und mehr Jahre,233,74,159
False,8116022,Großbettlingen,Insgesamt,3734,1798,1936
False,8116027,Hochdorf,unter 3 Jahre,168,77,91
False,8116027,Hochdorf,3 -  6 Jahre,167,82,85
False,8116027,Hochdorf,6 - 10 Jahre,185,87,98
False,8116027,Hochdorf,10 - 15 Jahre,232,114,118
False,8116027,Hochdorf,15 - 18 Jahre,130,76,54
False,8116027,Hochdorf,18 - 20 Jahre,94,49,45
False,8116027,Hochdorf,20 - 25 Jahre,237,143,94
False,8116027,Hochdorf,25 - 30 Jahre,382,192,190
False,8116027,Hochdorf,30 - 35 Jahre,370,174,196
False,8116027,Hochdorf,35 - 40 Jahre,366,194,172
False,8116027,Hochdorf,40 - 45 Jahre,316,163,153
False,8116027,Hochdorf,45 - 50 Jahre,291,146,145
False,8116027,Hochdorf,50 - 55 Jahre,311,146,165
False,8116027,Hochdorf,55 - 60 Jahre,371,193,178
False,8116027,Hochdorf,60 - 65 Jahre,277,133,144
False,8116027,Hochdorf,65 - 75 Jahre,378,182,196
False,8116027,Hochdorf,75 und mehr Jahre,217,62,155
False,8116027,Hochdorf,Insgesamt,4492,2213,2279
False,8116029,Holzmaden,unter 3 Jahre,73,32,41
False,8116029,Holzmaden,3 -  6 Jahre,89,54,35
False,8116029,Holzmaden,6 - 10 Jahre,85,40,45
False,8116029,Holzmaden,10 - 15 Jahre,128,64,64
False,8116029,Holzmaden,15 - 18 Jahre,72,39,33
False,8116029,Holzmaden,18 - 20 Jahre,52,34,18
False,8116029,Holzmaden,20 - 25 Jahre,109,49,60
False,8116029,Holzmaden,25 - 30 Jahre,143,70,73
False,8116029,Holzmaden,30 - 35 Jahre,182,95,87
False,8116029,Holzmaden,35 - 40 Jahre,172,80,92
False,8116029,Holzmaden,40 - 45 Jahre,138,76,62
False,8116029,Holzmaden,45 - 50 Jahre,111,52,59
False,8116029,Holzmaden,50 - 55 Jahre,105,53,52
False,8116029,Holzmaden,55 - 60 Jahre,119,67,52
False,8116029,Holzmaden,60 - 65 Jahre,82,40,42
False,8116029,Holzmaden,65 - 75 Jahre,154,65,89
False,8116029,Holzmaden,75 und mehr Jahre,95,27,68
False,8116029,Holzmaden,Insgesamt,1909,937,972
False,8116033,"Kirchheim unter Teck, Stadt",unter 3 Jahre,1295,657,638
False,8116033,"Kirchheim unter Teck, Stadt",3 -  6 Jahre,1324,687,637
False,8116033,"Kirchheim unter Teck, Stadt",6 - 10 Jahre,1843,951,892
False,8116033,"Kirchheim unter Teck, Stadt",10 - 15 Jahre,2161,1117,1044
False,8116033,"Kirchheim unter Teck, Stadt",15 - 18 Jahre,1288,660,628
False,8116033,"Kirchheim unter Teck, Stadt",18 - 20 Jahre,810,441,369
False,8116033,"Kirchheim unter Teck, Stadt",20 - 25 Jahre,2314,1163,1151
False,8116033,"Kirchheim unter Teck, Stadt",25 - 30 Jahre,3058,1525,1533
False,8116033,"Kirchheim unter Teck, Stadt",30 - 35 Jahre,3294,1653,1641
False,8116033,"Kirchheim unter Teck, Stadt",35 - 40 Jahre,3109,1604,1505
False,8116033,"Kirchheim unter Teck, Stadt",40 - 45 Jahre,2687,1315,1372
False,8116033,"Kirchheim unter Teck, Stadt",45 - 50 Jahre,2271,1171,1100
False,8116033,"Kirchheim unter Teck, Stadt",50 - 55 Jahre,2231,1121,1110
False,8116033,"Kirchheim unter Teck, Stadt",55 - 60 Jahre,2631,1339,1292
False,8116033,"Kirchheim unter Teck, Stadt",60 - 65 Jahre,1964,982,982
False,8116033,"Kirchheim unter Teck, Stadt",65 - 75 Jahre,3365,1419,1946
False,8116033,"Kirchheim unter Teck, Stadt",75 und mehr Jahre,2560,756,1804
False,8116033,"Kirchheim unter Teck, Stadt",Insgesamt,38205,18561,19644
False,8116035,Köngen,unter 3 Jahre,323,165,158
False,8116035,Köngen,3 -  6 Jahre,352,181,171
False,8116035,Köngen,6 - 10 Jahre,402,206,196
False,8116035,Köngen,10 - 15 Jahre,421,199,222
False,8116035,Köngen,15 - 18 Jahre,263,119,144
False,8116035,Köngen,18 - 20 Jahre,161,73,88
False,8116035,Köngen,20 - 25 Jahre,502,259,243
False,8116035,Köngen,25 - 30 Jahre,775,400,375
False,8116035,Köngen,30 - 35 Jahre,860,447,413
False,8116035,Köngen,35 - 40 Jahre,720,375,345
False,8116035,Köngen,40 - 45 Jahre,540,260,280
False,8116035,Köngen,45 - 50 Jahre,559,286,273
False,8116035,Köngen,50 - 55 Jahre,580,298,282
False,8116035,Köngen,55 - 60 Jahre,662,341,321
False,8116035,Köngen,60 - 65 Jahre,507,254,253
False,8116035,Köngen,65 - 75 Jahre,707,294,413
False,8116035,Köngen,75 und mehr Jahre,484,151,333
False,8116035,Köngen,Insgesamt,8818,4308,4510
False,8116036,Kohlberg,unter 3 Jahre,70,39,31
False,8116036,Kohlberg,3 -  6 Jahre,72,46,26
False,8116036,Kohlberg,6 - 10 Jahre,113,50,63
False,8116036,Kohlberg,10 - 15 Jahre,137,76,61
False,8116036,Kohlberg,15 - 18 Jahre,67,33,34
False,8116036,Kohlberg,18 - 20 Jahre,44,18,26
False,8116036,Kohlberg,20 - 25 Jahre,174,101,73
False,8116036,Kohlberg,25 - 30 Jahre,165,90,75
False,8116036,Kohlberg,30 - 35 Jahre,195,100,95
False,8116036,Kohlberg,35 - 40 Jahre,171,84,87
False,8116036,Kohlberg,40 - 45 Jahre,140,72,68
False,8116036,Kohlberg,45 - 50 Jahre,152,71,81
False,8116036,Kohlberg,50 - 55 Jahre,154,83,71
False,8116036,Kohlberg,55 - 60 Jahre,173,90,83
False,8116036,Kohlberg,60 - 65 Jahre,109,49,60
False,8116036,Kohlberg,65 - 75 Jahre,191,85,106
False,8116036,Kohlberg,75 und mehr Jahre,132,36,96
False,8116036,Kohlberg,Insgesamt,2259,1123,1136
False,8116037,Lichtenwald,unter 3 Jahre,96,44,52
False,8116037,Lichtenwald,3 -  6 Jahre,91,50,41
False,8116037,Lichtenwald,6 - 10 Jahre,124,61,63
False,8116037,Lichtenwald,10 - 15 Jahre,186,91,95
False,8116037,Lichtenwald,15 - 18 Jahre,85,43,42
False,8116037,Lichtenwald,18 - 20 Jahre,62,37,25
False,8116037,Lichtenwald,20 - 25 Jahre,123,69,54
False,8116037,Lichtenwald,25 - 30 Jahre,175,92,83
False,8116037,Lichtenwald,30 - 35 Jahre,231,111,120
False,8116037,Lichtenwald,35 - 40 Jahre,192,102,90
False,8116037,Lichtenwald,40 - 45 Jahre,180,86,94
False,8116037,Lichtenwald,45 - 50 Jahre,198,95,103
False,8116037,Lichtenwald,50 - 55 Jahre,174,93,81
False,8116037,Lichtenwald,55 - 60 Jahre,196,99,97
False,8116037,Lichtenwald,60 - 65 Jahre,169,83,86
False,8116037,Lichtenwald,65 - 75 Jahre,189,88,101
False,8116037,Lichtenwald,75 und mehr Jahre,99,35,64
False,8116037,Lichtenwald,Insgesamt,2570,1279,1291
False,8116041,Neckartailfingen,unter 3 Jahre,148,65,83
False,8116041,Neckartailfingen,3 -  6 Jahre,159,81,78
False,8116041,Neckartailfingen,6 - 10 Jahre,187,105,82
False,8116041,Neckartailfingen,10 - 15 Jahre,190,114,76
False,8116041,Neckartailfingen,15 - 18 Jahre,119,56,63
False,8116041,Neckartailfingen,18 - 20 Jahre,79,30,49
False,8116041,Neckartailfingen,20 - 25 Jahre,257,126,131
False,8116041,Neckartailfingen,25 - 30 Jahre,359,183,176
False,8116041,Neckartailfingen,30 - 35 Jahre,366,199,167
False,8116041,Neckartailfingen,35 - 40 Jahre,321,161,160
False,8116041,Neckartailfingen,40 - 45 Jahre,231,113,118
False,8116041,Neckartailfingen,45 - 50 Jahre,219,106,113
False,8116041,Neckartailfingen,50 - 55 Jahre,232,124,108
False,8116041,Neckartailfingen,55 - 60 Jahre,233,105,128
False,8116041,Neckartailfingen,60 - 65 Jahre,190,94,96
False,8116041,Neckartailfingen,65 - 75 Jahre,285,134,151
False,8116041,Neckartailfingen,75 und mehr Jahre,109,28,81
False,8116041,Neckartailfingen,Insgesamt,3684,1824,1860
False,8116042,Neckartenzlingen,unter 3 Jahre,229,113,116
False,8116042,Neckartenzlingen,3 -  6 Jahre,213,106,107
False,8116042,Neckartenzlingen,6 - 10 Jahre,296,157,139
False,8116042,Neckartenzlingen,10 - 15 Jahre,355,182,173
False,8116042,Neckartenzlingen,15 - 18 Jahre,204,91,113
False,8116042,Neckartenzlingen,18 - 20 Jahre,125,75,50
False,8116042,Neckartenzlingen,20 - 25 Jahre,370,199,171
False,8116042,Neckartenzlingen,25 - 30 Jahre,466,246,220
False,8116042,Neckartenzlingen,30 - 35 Jahre,500,248,252
False,8116042,Neckartenzlingen,35 - 40 Jahre,509,266,243
False,8116042,Neckartenzlingen,40 - 45 Jahre,438,221,217
False,8116042,Neckartenzlingen,45 - 50 Jahre,447,225,222
False,8116042,Neckartenzlingen,50 - 55 Jahre,417,214,203
False,8116042,Neckartenzlingen,55 - 60 Jahre,415,230,185
False,8116042,Neckartenzlingen,60 - 65 Jahre,275,139,136
False,8116042,Neckartenzlingen,65 - 75 Jahre,371,157,214
False,8116042,Neckartenzlingen,75 und mehr Jahre,248,77,171
False,8116042,Neckartenzlingen,Insgesamt,5878,2946,2932
False,8116043,Neidlingen,unter 3 Jahre,82,36,46
False,8116043,Neidlingen,3 -  6 Jahre,79,43,36
False,8116043,Neidlingen,6 - 10 Jahre,84,47,37
False,8116043,Neidlingen,10 - 15 Jahre,103,47,56
False,8116043,Neidlingen,15 - 18 Jahre,64,25,39
False,8116043,Neidlingen,18 - 20 Jahre,29,13,16
False,8116043,Neidlingen,20 - 25 Jahre,151,78,73
False,8116043,Neidlingen,25 - 30 Jahre,156,81,75
False,8116043,Neidlingen,30 - 35 Jahre,179,89,90
False,8116043,Neidlingen,35 - 40 Jahre,154,82,72
False,8116043,Neidlingen,40 - 45 Jahre,122,68,54
False,8116043,Neidlingen,45 - 50 Jahre,128,64,64
False,8116043,Neidlingen,50 - 55 Jahre,78,44,34
False,8116043,Neidlingen,55 - 60 Jahre,138,65,73
False,8116043,Neidlingen,60 - 65 Jahre,94,50,44
False,8116043,Neidlingen,65 - 75 Jahre,154,74,80
False,8116043,Neidlingen,75 und mehr Jahre,87,27,60
False,8116043,Neidlingen,Insgesamt,1882,933,949
False,8116046,"Neuffen, Stadt",unter 3 Jahre,232,126,106
False,8116046,"Neuffen, Stadt",3 -  6 Jahre,218,104,114
False,8116046,"Neuffen, Stadt",6 - 10 Jahre,294,148,146
False,8116046,"Neuffen, Stadt",10 - 15 Jahre,322,163,159
False,8116046,"Neuffen, Stadt",15 - 18 Jahre,197,100,97
False,8116046,"Neuffen, Stadt",18 - 20 Jahre,129,71,58
False,8116046,"Neuffen, Stadt",20 - 25 Jahre,378,209,169
False,8116046,"Neuffen, Stadt",25 - 30 Jahre,513,256,257
False,8116046,"Neuffen, Stadt",30 - 35 Jahre,491,244,247
False,8116046,"Neuffen, Stadt",35 - 40 Jahre,486,256,230
False,8116046,"Neuffen, Stadt",40 - 45 Jahre,420,208,212
False,8116046,"Neuffen, Stadt",45 - 50 Jahre,354,174,180
False,8116046,"Neuffen, Stadt",50 - 55 Jahre,361,196,165
False,8116046,"Neuffen, Stadt",55 - 60 Jahre,368,163,205
False,8116046,"Neuffen, Stadt",60 - 65 Jahre,293,157,136
False,8116046,"Neuffen, Stadt",65 - 75 Jahre,479,202,277
False,8116046,"Neuffen, Stadt",75 und mehr Jahre,404,122,282
False,8116046,"Neuffen, Stadt",Insgesamt,5939,2899,3040
False,8116047,Neuhausen auf den Fildern,unter 3 Jahre,345,175,170
False,8116047,Neuhausen auf den Fildern,3 -  6 Jahre,382,192,190
False,8116047,Neuhausen auf den Fildern,6 - 10 Jahre,499,254,245
False,8116047,Neuhausen auf den Fildern,10 - 15 Jahre,563,277,286
False,8116047,Neuhausen auf den Fildern,15 - 18 Jahre,351,172,179
False,8116047,Neuhausen auf den Fildern,18 - 20 Jahre,215,104,111
False,8116047,Neuhausen auf den Fildern,20 - 25 Jahre,610,312,298
False,8116047,Neuhausen auf den Fildern,25 - 30 Jahre,782,377,405
False,8116047,Neuhausen auf den Fildern,30 - 35 Jahre,949,493,456
False,8116047,Neuhausen auf den Fildern,35 - 40 Jahre,845,442,403
False,8116047,Neuhausen auf den Fildern,40 - 45 Jahre,682,322,360
False,8116047,Neuhausen auf den Fildern,45 - 50 Jahre,739,380,359
False,8116047,Neuhausen auf den Fildern,50 - 55 Jahre,723,363,360
False,8116047,Neuhausen auf den Fildern,55 - 60 Jahre,811,415,396
False,8116047,Neuhausen auf den Fildern,60 - 65 Jahre,603,288,315
False,8116047,Neuhausen auf den Fildern,65 - 75 Jahre,866,392,474
False,8116047,Neuhausen auf den Fildern,75 und mehr Jahre,520,166,354
False,8116047,Neuhausen auf den Fildern,Insgesamt,10485,5124,5361
False,8116048,Notzingen,unter 3 Jahre,140,73,67
False,8116048,Notzingen,3 -  6 Jahre,140,84,56
False,8116048,Notzingen,6 - 10 Jahre,194,105,89
False,8116048,Notzingen,10 - 15 Jahre,194,106,88
False,8116048,Notzingen,15 - 18 Jahre,119,57,62
False,8116048,Notzingen,18 - 20 Jahre,79,43,36
False,8116048,Notzingen,20 - 25 Jahre,162,72,90
False,8116048,Notzingen,25 - 30 Jahre,257,151,106
False,8116048,Notzingen,30 - 35 Jahre,328,178,150
False,8116048,Notzingen,35 - 40 Jahre,301,143,158
False,8116048,Notzingen,40 - 45 Jahre,273,138,135
False,8116048,Notzingen,45 - 50 Jahre,238,118,120
False,8116048,Notzingen,50 - 55 Jahre,228,115,113
False,8116048,Notzingen,55 - 60 Jahre,279,148,131
False,8116048,Notzingen,60 - 65 Jahre,188,86,102
False,8116048,Notzingen,65 - 75 Jahre,250,119,131
False,8116048,Notzingen,75 und mehr Jahre,142,41,101
False,8116048,Notzingen,Insgesamt,3512,1777,1735
False,8116049,"Nürtingen, Stadt",unter 3 Jahre,1204,604,600
False,8116049,"Nürtingen, Stadt",3 -  6 Jahre,1252,639,613
False,8116049,"Nürtingen, Stadt",6 - 10 Jahre,1810,934,876
False,8116049,"Nürtingen, Stadt",10 - 15 Jahre,2103,1123,980
False,8116049,"Nürtingen, Stadt",15 - 18 Jahre,1241,652,589
False,8116049,"Nürtingen, Stadt",18 - 20 Jahre,863,404,459
False,8116049,"Nürtingen, Stadt",20 - 25 Jahre,2510,1298,1212
False,8116049,"Nürtingen, Stadt",25 - 30 Jahre,3230,1694,1536
False,8116049,"Nürtingen, Stadt",30 - 35 Jahre,3421,1748,1673
False,8116049,"Nürtingen, Stadt",35 - 40 Jahre,2926,1478,1448
False,8116049,"Nürtingen, Stadt",40 - 45 Jahre,2528,1242,1286
False,8116049,"Nürtingen, Stadt",45 - 50 Jahre,2471,1251,1220
False,8116049,"Nürtingen, Stadt",50 - 55 Jahre,2619,1319,1300
False,8116049,"Nürtingen, Stadt",55 - 60 Jahre,2852,1413,1439
False,8116049,"Nürtingen, Stadt",60 - 65 Jahre,2030,1027,1003
False,8116049,"Nürtingen, Stadt",65 - 75 Jahre,3315,1420,1895
False,8116049,"Nürtingen, Stadt",75 und mehr Jahre,2483,735,1748
False,8116049,"Nürtingen, Stadt",Insgesamt,38858,18981,19877
False,8116050,Oberboihingen,unter 3 Jahre,185,96,89
False,8116050,Oberboihingen,3 -  6 Jahre,197,95,102
False,8116050,Oberboihingen,6 - 10 Jahre,231,113,118
False,8116050,Oberboihingen,10 - 15 Jahre,318,149,169
False,8116050,Oberboihingen,15 - 18 Jahre,172,89,83
False,8116050,Oberboihingen,18 - 20 Jahre,110,56,54
False,8116050,Oberboihingen,20 - 25 Jahre,315,166,149
False,8116050,Oberboihingen,25 - 30 Jahre,444,239,205
False,8116050,Oberboihingen,30 - 35 Jahre,456,254,202
False,8116050,Oberboihingen,35 - 40 Jahre,454,236,218
False,8116050,Oberboihingen,40 - 45 Jahre,390,196,194
False,8116050,Oberboihingen,45 - 50 Jahre,349,159,190
False,8116050,Oberboihingen,50 - 55 Jahre,344,192,152
False,8116050,Oberboihingen,55 - 60 Jahre,341,183,158
False,8116050,Oberboihingen,60 - 65 Jahre,282,146,136
False,8116050,Oberboihingen,65 - 75 Jahre,354,155,199
False,8116050,Oberboihingen,75 und mehr Jahre,229,72,157
False,8116050,Oberboihingen,Insgesamt,5171,2596,2575
False,8116053,Ohmden,unter 3 Jahre,52,26,26
False,8116053,Ohmden,3 -  6 Jahre,71,33,38
False,8116053,Ohmden,6 - 10 Jahre,91,52,39
False,8116053,Ohmden,10 - 15 Jahre,108,50,58
False,8116053,Ohmden,15 - 18 Jahre,45,20,25
False,8116053,Ohmden,18 - 20 Jahre,44,23,21
False,8116053,Ohmden,20 - 25 Jahre,106,55,51
False,8116053,Ohmden,25 - 30 Jahre,164,91,73
False,8116053,Ohmden,30 - 35 Jahre,152,82,70
False,8116053,Ohmden,35 - 40 Jahre,121,64,57
False,8116053,Ohmden,40 - 45 Jahre,137,70,67
False,8116053,Ohmden,45 - 50 Jahre,110,60,50
False,8116053,Ohmden,50 - 55 Jahre,121,51,70
False,8116053,Ohmden,55 - 60 Jahre,121,64,57
False,8116053,Ohmden,60 - 65 Jahre,92,51,41
False,8116053,Ohmden,65 - 75 Jahre,128,57,71
False,8116053,Ohmden,75 und mehr Jahre,70,25,45
False,8116053,Ohmden,Insgesamt,1733,874,859
False,8116054,"Owen, Stadt",unter 3 Jahre,115,66,49
False,8116054,"Owen, Stadt",3 -  6 Jahre,148,81,67
False,8116054,"Owen, Stadt",6 - 10 Jahre,196,115,81
False,8116054,"Owen, Stadt",10 - 15 Jahre,207,107,100
False,8116054,"Owen, Stadt",15 - 18 Jahre,117,53,64
False,8116054,"Owen, Stadt",18 - 20 Jahre,68,31,37
False,8116054,"Owen, Stadt",20 - 25 Jahre,172,91,81
False,8116054,"Owen, Stadt",25 - 30 Jahre,234,120,114
False,8116054,"Owen, Stadt",30 - 35 Jahre,292,145,147
False,8116054,"Owen, Stadt",35 - 40 Jahre,262,128,134
False,8116054,"Owen, Stadt",40 - 45 Jahre,214,99,115
False,8116054,"Owen, Stadt",45 - 50 Jahre,215,124,91
False,8116054,"Owen, Stadt",50 - 55 Jahre,179,99,80
False,8116054,"Owen, Stadt",55 - 60 Jahre,205,109,96
False,8116054,"Owen, Stadt",60 - 65 Jahre,186,88,98
False,8116054,"Owen, Stadt",65 - 75 Jahre,275,116,159
False,8116054,"Owen, Stadt",75 und mehr Jahre,187,54,133
False,8116054,"Owen, Stadt",Insgesamt,3272,1626,1646
False,8116056,"Plochingen, Stadt",unter 3 Jahre,403,207,196
False,8116056,"Plochingen, Stadt",3 -  6 Jahre,393,191,202
False,8116056,"Plochingen, Stadt",6 - 10 Jahre,490,252,238
False,8116056,"Plochingen, Stadt",10 - 15 Jahre,588,303,285
False,8116056,"Plochingen, Stadt",15 - 18 Jahre,382,217,165
False,8116056,"Plochingen, Stadt",18 - 20 Jahre,278,153,125
False,8116056,"Plochingen, Stadt",20 - 25 Jahre,819,443,376
False,8116056,"Plochingen, Stadt",25 - 30 Jahre,1160,598,562
False,8116056,"Plochingen, Stadt",30 - 35 Jahre,1191,631,560
False,8116056,"Plochingen, Stadt",35 - 40 Jahre,945,496,449
False,8116056,"Plochingen, Stadt",40 - 45 Jahre,846,435,411
False,8116056,"Plochingen, Stadt",45 - 50 Jahre,828,434,394
False,8116056,"Plochingen, Stadt",50 - 55 Jahre,887,448,439
False,8116056,"Plochingen, Stadt",55 - 60 Jahre,1074,534,540
False,8116056,"Plochingen, Stadt",60 - 65 Jahre,738,373,365
False,8116056,"Plochingen, Stadt",65 - 75 Jahre,1124,485,639
False,8116056,"Plochingen, Stadt",75 und mehr Jahre,939,275,664
False,8116056,"Plochingen, Stadt",Insgesamt,13085,6475,6610
False,8116058,Reichenbach an der Fils,unter 3 Jahre,255,134,121
False,8116058,Reichenbach an der Fils,3 -  6 Jahre,263,121,142
False,8116058,Reichenbach an der Fils,6 - 10 Jahre,285,156,129
False,8116058,Reichenbach an der Fils,10 - 15 Jahre,343,181,162
False,8116058,Reichenbach an der Fils,15 - 18 Jahre,204,94,110
False,8116058,Reichenbach an der Fils,18 - 20 Jahre,146,63,83
False,8116058,Reichenbach an der Fils,20 - 25 Jahre,406,189,217
False,8116058,Reichenbach an der Fils,25 - 30 Jahre,548,282,266
False,8116058,Reichenbach an der Fils,30 - 35 Jahre,673,363,310
False,8116058,Reichenbach an der Fils,35 - 40 Jahre,565,302,263
False,8116058,Reichenbach an der Fils,40 - 45 Jahre,513,260,253
False,8116058,Reichenbach an der Fils,45 - 50 Jahre,440,208,232
False,8116058,Reichenbach an der Fils,50 - 55 Jahre,511,243,268
False,8116058,Reichenbach an der Fils,55 - 60 Jahre,584,290,294
False,8116058,Reichenbach an der Fils,60 - 65 Jahre,461,248,213
False,8116058,Reichenbach an der Fils,65 - 75 Jahre,744,312,432
False,8116058,Reichenbach an der Fils,75 und mehr Jahre,483,166,317
False,8116058,Reichenbach an der Fils,Insgesamt,7424,3612,3812
False,8116063,Schlaitdorf,unter 3 Jahre,71,30,41
False,8116063,Schlaitdorf,3 -  6 Jahre,80,33,47
False,8116063,Schlaitdorf,6 - 10 Jahre,89,40,49
False,8116063,Schlaitdorf,10 - 15 Jahre,90,55,35
False,8116063,Schlaitdorf,15 - 18 Jahre,47,22,25
False,8116063,Schlaitdorf,18 - 20 Jahre,44,21,23
False,8116063,Schlaitdorf,20 - 25 Jahre,84,44,40
False,8116063,Schlaitdorf,25 - 30 Jahre,117,67,50
False,8116063,Schlaitdorf,30 - 35 Jahre,138,71,67
False,8116063,Schlaitdorf,35 - 40 Jahre,139,65,74
False,8116063,Schlaitdorf,40 - 45 Jahre,121,58,63
False,8116063,Schlaitdorf,45 - 50 Jahre,109,56,53
False,8116063,Schlaitdorf,50 - 55 Jahre,89,52,37
False,8116063,Schlaitdorf,55 - 60 Jahre,92,40,52
False,8116063,Schlaitdorf,60 - 65 Jahre,80,42,38
False,8116063,Schlaitdorf,65 - 75 Jahre,104,44,60
False,8116063,Schlaitdorf,75 und mehr Jahre,84,29,55
False,8116063,Schlaitdorf,Insgesamt,1578,769,809
False,8116068,Unterensingen,unter 3 Jahre,181,83,98
False,8116068,Unterensingen,3 -  6 Jahre,165,84,81
False,8116068,Unterensingen,6 - 10 Jahre,218,103,115
False,8116068,Unterensingen,10 - 15 Jahre,212,101,111
False,8116068,Unterensingen,15 - 18 Jahre,141,75,66
False,8116068,Unterensingen,18 - 20 Jahre,75,34,41
False,8116068,Unterensingen,20 - 25 Jahre,263,132,131
False,8116068,Unterensingen,25 - 30 Jahre,452,218,234
False,8116068,Unterensingen,30 - 35 Jahre,436,235,201
False,8116068,Unterensingen,35 - 40 Jahre,325,185,140
False,8116068,Unterensingen,40 - 45 Jahre,285,139,146
False,8116068,Unterensingen,45 - 50 Jahre,266,124,142
False,8116068,Unterensingen,50 - 55 Jahre,318,159,159
False,8116068,Unterensingen,55 - 60 Jahre,323,168,155
False,8116068,Unterensingen,60 - 65 Jahre,250,130,120
False,8116068,Unterensingen,65 - 75 Jahre,287,140,147
False,8116068,Unterensingen,75 und mehr Jahre,169,54,115
False,8116068,Unterensingen,Insgesamt,4366,2164,2202
False,8116070,"Weilheim an der Teck, Stadt",unter 3 Jahre,357,188,169
False,8116070,"Weilheim an der Teck, Stadt",3 -  6 Jahre,353,187,166
False,8116070,"Weilheim an der Teck, Stadt",6 - 10 Jahre,475,240,235
False,8116070,"Weilheim an der Teck, Stadt",10 - 15 Jahre,615,315,300
False,8116070,"Weilheim an der Teck, Stadt",15 - 18 Jahre,369,199,170
False,8116070,"Weilheim an der Teck, Stadt",18 - 20 Jahre,168,71,97
False,8116070,"Weilheim an der Teck, Stadt",20 - 25 Jahre,515,255,260
False,8116070,"Weilheim an der Teck, Stadt",25 - 30 Jahre,746,373,373
False,8116070,"Weilheim an der Teck, Stadt",30 - 35 Jahre,832,436,396
False,8116070,"Weilheim an der Teck, Stadt",35 - 40 Jahre,811,440,371
False,8116070,"Weilheim an der Teck, Stadt",40 - 45 Jahre,627,319,308
False,8116070,"Weilheim an der Teck, Stadt",45 - 50 Jahre,570,298,272
False,8116070,"Weilheim an der Teck, Stadt",50 - 55 Jahre,568,293,275
False,8116070,"Weilheim an der Teck, Stadt",55 - 60 Jahre,610,314,296
False,8116070,"Weilheim an der Teck, Stadt",60 - 65 Jahre,470,235,235
False,8116070,"Weilheim an der Teck, Stadt",65 - 75 Jahre,749,313,436
False,8116070,"Weilheim an der Teck, Stadt",75 und mehr Jahre,531,168,363
False,8116070,"Weilheim an der Teck, Stadt",Insgesamt,9366,4644,4722
False,8116071,"Wendlingen am Neckar, Stadt",unter 3 Jahre,563,273,290
False,8116071,"Wendlingen am Neckar, Stadt",3 -  6 Jahre,594,308,286
False,8116071,"Wendlingen am Neckar, Stadt",6 - 10 Jahre,717,387,330
False,8116071,"Wendlingen am Neckar, Stadt",10 - 15 Jahre,802,387,415
False,8116071,"Wendlingen am Neckar, Stadt",15 - 18 Jahre,502,265,237
False,8116071,"Wendlingen am Neckar, Stadt",18 - 20 Jahre,327,182,145
False,8116071,"Wendlingen am Neckar, Stadt",20 - 25 Jahre,901,453,448
False,8116071,"Wendlingen am Neckar, Stadt",25 - 30 Jahre,1381,690,691
False,8116071,"Wendlingen am Neckar, Stadt",30 - 35 Jahre,1444,769,675
False,8116071,"Wendlingen am Neckar, Stadt",35 - 40 Jahre,1247,628,619
False,8116071,"Wendlingen am Neckar, Stadt",40 - 45 Jahre,997,493,504
False,8116071,"Wendlingen am Neckar, Stadt",45 - 50 Jahre,996,494,502
False,8116071,"Wendlingen am Neckar, Stadt",50 - 55 Jahre,1045,530,515
False,8116071,"Wendlingen am Neckar, Stadt",55 - 60 Jahre,1183,596,587
False,8116071,"Wendlingen am Neckar, Stadt",60 - 65 Jahre,854,451,403
False,8116071,"Wendlingen am Neckar, Stadt",65 - 75 Jahre,1136,507,629
False,8116071,"Wendlingen am Neckar, Stadt",75 und mehr Jahre,868,263,605
False,8116071,"Wendlingen am Neckar, Stadt",Insgesamt,15557,7676,7881
False,8116072,"Wernau (Neckar), Stadt",unter 3 Jahre,377,195,182
False,8116072,"Wernau (Neckar), Stadt",3 -  6 Jahre,377,186,191
False,8116072,"Wernau (Neckar), Stadt",6 - 10 Jahre,519,266,253
False,8116072,"Wernau (Neckar), Stadt",10 - 15 Jahre,556,274,282
False,8116072,"Wernau (Neckar), Stadt",15 - 18 Jahre,368,193,175
False,8116072,"Wernau (Neckar), Stadt",18 - 20 Jahre,250,129,121
False,8116072,"Wernau (Neckar), Stadt",20 - 25 Jahre,708,367,341
False,8116072,"Wernau (Neckar), Stadt",25 - 30 Jahre,989,495,494
False,8116072,"Wernau (Neckar), Stadt",30 - 35 Jahre,1040,562,478
False,8116072,"Wernau (Neckar), Stadt",35 - 40 Jahre,847,478,369
False,8116072,"Wernau (Neckar), Stadt",40 - 45 Jahre,770,372,398
False,8116072,"Wernau (Neckar), Stadt",45 - 50 Jahre,748,384,364
False,8116072,"Wernau (Neckar), Stadt",50 - 55 Jahre,710,335,375
False,8116072,"Wernau (Neckar), Stadt",55 - 60 Jahre,974,481,493
False,8116072,"Wernau (Neckar), Stadt",60 - 65 Jahre,745,358,387
False,8116072,"Wernau (Neckar), Stadt",65 - 75 Jahre,1170,546,624
False,8116072,"Wernau (Neckar), Stadt",75 und mehr Jahre,769,242,527
False,8116072,"Wernau (Neckar), Stadt",Insgesamt,11917,5863,6054
False,8116073,Wolfschlugen,unter 3 Jahre,222,123,99
False,8116073,Wolfschlugen,3 -  6 Jahre,191,94,97
False,8116073,Wolfschlugen,6 - 10 Jahre,275,129,146
False,8116073,Wolfschlugen,10 - 15 Jahre,293,152,141
False,8116073,Wolfschlugen,15 - 18 Jahre,216,121,95
False,8116073,Wolfschlugen,18 - 20 Jahre,134,68,66
False,8116073,Wolfschlugen,20 - 25 Jahre,330,160,170
False,8116073,Wolfschlugen,25 - 30 Jahre,468,244,224
False,8116073,Wolfschlugen,30 - 35 Jahre,509,252,257
False,8116073,Wolfschlugen,35 - 40 Jahre,521,265,256
False,8116073,Wolfschlugen,40 - 45 Jahre,445,214,231
False,8116073,Wolfschlugen,45 - 50 Jahre,374,190,184
False,8116073,Wolfschlugen,50 - 55 Jahre,420,225,195
False,8116073,Wolfschlugen,55 - 60 Jahre,397,202,195
False,8116073,Wolfschlugen,60 - 65 Jahre,270,137,133
False,8116073,Wolfschlugen,65 - 75 Jahre,380,175,205
False,8116073,Wolfschlugen,75 und mehr Jahre,265,83,182
False,8116073,Wolfschlugen,Insgesamt,5710,2834,2876
False,8116076,Aichwald,unter 3 Jahre,241,117,124
False,8116076,Aichwald,3 -  6 Jahre,281,152,129
False,8116076,Aichwald,6 - 10 Jahre,334,168,166
False,8116076,Aichwald,10 - 15 Jahre,433,215,218
False,8116076,Aichwald,15 - 18 Jahre,268,131,137
False,8116076,Aichwald,18 - 20 Jahre,205,110,95
False,8116076,Aichwald,20 - 25 Jahre,460,251,209
False,8116076,Aichwald,25 - 30 Jahre,590,300,290
False,8116076,Aichwald,30 - 35 Jahre,623,319,304
False,8116076,Aichwald,35 - 40 Jahre,595,291,304
False,8116076,Aichwald,40 - 45 Jahre,538,260,278
False,8116076,Aichwald,45 - 50 Jahre,588,267,321
False,8116076,Aichwald,50 - 55 Jahre,692,344,348
False,8116076,Aichwald,55 - 60 Jahre,697,369,328
False,8116076,Aichwald,60 - 65 Jahre,464,238,226
False,8116076,Aichwald,65 - 75 Jahre,600,281,319
False,8116076,Aichwald,75 und mehr Jahre,367,136,231
False,8116076,Aichwald,Insgesamt,7976,3949,4027
False,8116077,"Filderstadt, Stadt",unter 3 Jahre,1646,831,815
False,8116077,"Filderstadt, Stadt",3 -  6 Jahre,1552,796,756
False,8116077,"Filderstadt, Stadt",6 - 10 Jahre,1850,1001,849
False,8116077,"Filderstadt, Stadt",10 - 15 Jahre,2039,983,1056
False,8116077,"Filderstadt, Stadt",15 - 18 Jahre,1201,633,568
False,8116077,"Filderstadt, Stadt",18 - 20 Jahre,777,417,360
False,8116077,"Filderstadt, Stadt",20 - 25 Jahre,2492,1232,1260
False,8116077,"Filderstadt, Stadt",25 - 30 Jahre,4007,1965,2042
False,8116077,"Filderstadt, Stadt",30 - 35 Jahre,4366,2248,2118
False,8116077,"Filderstadt, Stadt",35 - 40 Jahre,3669,1874,1795
False,8116077,"Filderstadt, Stadt",40 - 45 Jahre,2865,1444,1421
False,8116077,"Filderstadt, Stadt",45 - 50 Jahre,2824,1406,1418
False,8116077,"Filderstadt, Stadt",50 - 55 Jahre,2688,1393,1295
False,8116077,"Filderstadt, Stadt",55 - 60 Jahre,2839,1422,1417
False,8116077,"Filderstadt, Stadt",60 - 65 Jahre,1945,1013,932
False,8116077,"Filderstadt, Stadt",65 - 75 Jahre,2653,1131,1522
False,8116077,"Filderstadt, Stadt",75 und mehr Jahre,1732,549,1183
False,8116077,"Filderstadt, Stadt",Insgesamt,41145,20338,20807
False,8116078,"Leinfelden-Echterdingen, Stadt",unter 3 Jahre,1069,563,506
False,8116078,"Leinfelden-Echterdingen, Stadt",3 -  6 Jahre,1147,587,560
False,8116078,"Leinfelden-Echterdingen, Stadt",6 - 10 Jahre,1389,713,676
False,8116078,"Leinfelden-Echterdingen, Stadt",10 - 15 Jahre,1569,836,733
False,8116078,"Leinfelden-Echterdingen, Stadt",15 - 18 Jahre,912,498,414
False,8116078,"Leinfelden-Echterdingen, Stadt",18 - 20 Jahre,636,297,339
False,8116078,"Leinfelden-Echterdingen, Stadt",20 - 25 Jahre,1964,997,967
False,8116078,"Leinfelden-Echterdingen, Stadt",25 - 30 Jahre,2970,1486,1484
False,8116078,"Leinfelden-Echterdingen, Stadt",30 - 35 Jahre,3398,1719,1679
False,8116078,"Leinfelden-Echterdingen, Stadt",35 - 40 Jahre,2830,1477,1353
False,8116078,"Leinfelden-Echterdingen, Stadt",40 - 45 Jahre,2379,1190,1189
False,8116078,"Leinfelden-Echterdingen, Stadt",45 - 50 Jahre,2324,1110,1214
False,8116078,"Leinfelden-Echterdingen, Stadt",50 - 55 Jahre,2682,1323,1359
False,8116078,"Leinfelden-Echterdingen, Stadt",55 - 60 Jahre,2821,1347,1474
False,8116078,"Leinfelden-Echterdingen, Stadt",60 - 65 Jahre,2027,1041,986
False,8116078,"Leinfelden-Echterdingen, Stadt",65 - 75 Jahre,3006,1269,1737
False,8116078,"Leinfelden-Echterdingen, Stadt",75 und mehr Jahre,1991,652,1339
False,8116078,"Leinfelden-Echterdingen, Stadt",Insgesamt,35114,17105,18009
False,8116079,Lenningen,unter 3 Jahre,309,155,154
False,8116079,Lenningen,3 -  6 Jahre,360,210,150
False,8116079,Lenningen,6 - 10 Jahre,487,250,237
False,8116079,Lenningen,10 - 15 Jahre,511,259,252
False,8116079,Lenningen,15 - 18 Jahre,283,138,145
False,8116079,Lenningen,18 - 20 Jahre,185,94,91
False,8116079,Lenningen,20 - 25 Jahre,494,254,240
False,8116079,Lenningen,25 - 30 Jahre,679,357,322
False,8116079,Lenningen,30 - 35 Jahre,821,426,395
False,8116079,Lenningen,35 - 40 Jahre,723,391,332
False,8116079,Lenningen,40 - 45 Jahre,557,283,274
False,8116079,Lenningen,45 - 50 Jahre,556,296,260
False,8116079,Lenningen,50 - 55 Jahre,510,278,232
False,8116079,Lenningen,55 - 60 Jahre,656,355,301
False,8116079,Lenningen,60 - 65 Jahre,495,247,248
False,8116079,Lenningen,65 - 75 Jahre,743,310,433
False,8116079,Lenningen,75 und mehr Jahre,479,155,324
False,8116079,Lenningen,Insgesamt,8848,4458,4390
False,8116080,"Ostfildern, Stadt",unter 3 Jahre,1011,513,498
False,8116080,"Ostfildern, Stadt",3 -  6 Jahre,1029,537,492
False,8116080,"Ostfildern, Stadt",6 - 10 Jahre,1280,627,653
False,8116080,"Ostfildern, Stadt",10 - 15 Jahre,1502,807,695
False,8116080,"Ostfildern, Stadt",15 - 18 Jahre,899,487,412
False,8116080,"Ostfildern, Stadt",18 - 20 Jahre,614,312,302
False,8116080,"Ostfildern, Stadt",20 - 25 Jahre,1837,962,875
False,8116080,"Ostfildern, Stadt",25 - 30 Jahre,2519,1249,1270
False,8116080,"Ostfildern, Stadt",30 - 35 Jahre,2752,1392,1360
False,8116080,"Ostfildern, Stadt",35 - 40 Jahre,2325,1164,1161
False,8116080,"Ostfildern, Stadt",40 - 45 Jahre,2057,996,1061
False,8116080,"Ostfildern, Stadt",45 - 50 Jahre,1983,950,1033
False,8116080,"Ostfildern, Stadt",50 - 55 Jahre,2115,1068,1047
False,8116080,"Ostfildern, Stadt",55 - 60 Jahre,2370,1206,1164
False,8116080,"Ostfildern, Stadt",60 - 65 Jahre,1603,804,799
False,8116080,"Ostfildern, Stadt",65 - 75 Jahre,2478,1079,1399
False,8116080,"Ostfildern, Stadt",75 und mehr Jahre,1728,582,1146
False,8116080,"Ostfildern, Stadt",Insgesamt,30102,14735,15367
False,8116081,"Aichtal, Stadt",unter 3 Jahre,332,180,152
False,8116081,"Aichtal, Stadt",3 -  6 Jahre,374,181,193
False,8116081,"Aichtal, Stadt",6 - 10 Jahre,502,246,256
False,8116081,"Aichtal, Stadt",10 - 15 Jahre,503,272,231
False,8116081,"Aichtal, Stadt",15 - 18 Jahre,291,150,141
False,8116081,"Aichtal, Stadt",18 - 20 Jahre,158,68,90
False,8116081,"Aichtal, Stadt",20 - 25 Jahre,502,255,247
False,8116081,"Aichtal, Stadt",25 - 30 Jahre,757,400,357
False,8116081,"Aichtal, Stadt",30 - 35 Jahre,806,404,402
False,8116081,"Aichtal, Stadt",35 - 40 Jahre,805,418,387
False,8116081,"Aichtal, Stadt",40 - 45 Jahre,711,357,354
False,8116081,"Aichtal, Stadt",45 - 50 Jahre,666,337,329
False,8116081,"Aichtal, Stadt",50 - 55 Jahre,614,339,275
False,8116081,"Aichtal, Stadt",55 - 60 Jahre,623,303,320
False,8116081,"Aichtal, Stadt",60 - 65 Jahre,479,256,223
False,8116081,"Aichtal, Stadt",65 - 75 Jahre,680,294,386
False,8116081,"Aichtal, Stadt",75 und mehr Jahre,375,117,258
False,8116081,"Aichtal, Stadt",Insgesamt,9178,4577,4601
False,8117,Landkreis Göppingen,unter 3 Jahre,8615,4415,4200
False,8117,Landkreis Göppingen,3 -  6 Jahre,9366,4887,4479
False,8117,Landkreis Göppingen,6 - 10 Jahre,12099,6180,5919
False,8117,Landkreis Göppingen,10 - 15 Jahre,14275,7398,6877
False,8117,Landkreis Göppingen,15 - 18 Jahre,8293,4204,4089
False,8117,Landkreis Göppingen,18 - 20 Jahre,5540,2814,2726
False,8117,Landkreis Göppingen,20 - 25 Jahre,15692,8101,7591
False,8117,Landkreis Göppingen,25 - 30 Jahre,20551,10650,9901
False,8117,Landkreis Göppingen,30 - 35 Jahre,21484,11298,10186
False,8117,Landkreis Göppingen,35 - 40 Jahre,19272,9928,9344
False,8117,Landkreis Göppingen,40 - 45 Jahre,17074,8654,8420
False,8117,Landkreis Göppingen,45 - 50 Jahre,15695,7987,7708
False,8117,Landkreis Göppingen,50 - 55 Jahre,15544,7909,7635
False,8117,Landkreis Göppingen,55 - 60 Jahre,18394,9206,9188
False,8117,Landkreis Göppingen,60 - 65 Jahre,13807,6969,6838
False,8117,Landkreis Göppingen,65 - 75 Jahre,22584,9535,13049
False,8117,Landkreis Göppingen,75 und mehr Jahre,16918,5212,11706
False,8117,Landkreis Göppingen,Insgesamt,255203,125347,129856
False,8117001,Adelberg,unter 3 Jahre,70,37,33
False,8117001,Adelberg,3 -  6 Jahre,76,41,35
False,8117001,Adelberg,6 - 10 Jahre,105,55,50
False,8117001,Adelberg,10 - 15 Jahre,126,78,48
False,8117001,Adelberg,15 - 18 Jahre,71,39,32
False,8117001,Adelberg,18 - 20 Jahre,37,18,19
False,8117001,Adelberg,20 - 25 Jahre,139,72,67
False,8117001,Adelberg,25 - 30 Jahre,173,105,68
False,8117001,Adelberg,30 - 35 Jahre,191,95,96
False,8117001,Adelberg,35 - 40 Jahre,153,87,66
False,8117001,Adelberg,40 - 45 Jahre,171,84,87
False,8117001,Adelberg,45 - 50 Jahre,158,85,73
False,8117001,Adelberg,50 - 55 Jahre,127,64,63
False,8117001,Adelberg,55 - 60 Jahre,135,75,60
False,8117001,Adelberg,60 - 65 Jahre,100,55,45
False,8117001,Adelberg,65 - 75 Jahre,152,69,83
False,8117001,Adelberg,75 und mehr Jahre,107,40,67
False,8117001,Adelberg,Insgesamt,2091,1099,992
False,8117002,Aichelberg,unter 3 Jahre,43,27,16
False,8117002,Aichelberg,3 -  6 Jahre,41,22,19
False,8117002,Aichelberg,6 - 10 Jahre,54,28,26
False,8117002,Aichelberg,10 - 15 Jahre,46,25,21
False,8117002,Aichelberg,15 - 18 Jahre,36,13,23
False,8117002,Aichelberg,18 - 20 Jahre,20,6,14
False,8117002,Aichelberg,20 - 25 Jahre,62,30,32
False,8117002,Aichelberg,25 - 30 Jahre,92,48,44
False,8117002,Aichelberg,30 - 35 Jahre,107,54,53
False,8117002,Aichelberg,35 - 40 Jahre,77,39,38
False,8117002,Aichelberg,40 - 45 Jahre,88,51,37
False,8117002,Aichelberg,45 - 50 Jahre,75,40,35
False,8117002,Aichelberg,50 - 55 Jahre,68,35,33
False,8117002,Aichelberg,55 - 60 Jahre,65,27,38
False,8117002,Aichelberg,60 - 65 Jahre,52,27,25
False,8117002,Aichelberg,65 - 75 Jahre,82,36,46
False,8117002,Aichelberg,75 und mehr Jahre,61,21,40
False,8117002,Aichelberg,Insgesamt,1069,529,540
False,8117003,Albershausen,unter 3 Jahre,170,81,89
False,8117003,Albershausen,3 -  6 Jahre,157,87,70
False,8117003,Albershausen,6 - 10 Jahre,204,100,104
False,8117003,Albershausen,10 - 15 Jahre,243,121,122
False,8117003,Albershausen,15 - 18 Jahre,127,65,62
False,8117003,Albershausen,18 - 20 Jahre,106,48,58
False,8117003,Albershausen,20 - 25 Jahre,219,111,108
False,8117003,Albershausen,25 - 30 Jahre,325,155,170
False,8117003,Albershausen,30 - 35 Jahre,380,206,174
False,8117003,Albershausen,35 - 40 Jahre,309,141,168
False,8117003,Albershausen,40 - 45 Jahre,289,150,139
False,8117003,Albershausen,45 - 50 Jahre,247,131,116
False,8117003,Albershausen,50 - 55 Jahre,272,142,130
False,8117003,Albershausen,55 - 60 Jahre,279,140,139
False,8117003,Albershausen,60 - 65 Jahre,251,121,130
False,8117003,Albershausen,65 - 75 Jahre,338,168,170
False,8117003,Albershausen,75 und mehr Jahre,216,61,155
False,8117003,Albershausen,Insgesamt,4132,2028,2104
False,8117006,Bad Ditzenbach,unter 3 Jahre,152,78,74
False,8117006,Bad Ditzenbach,3 -  6 Jahre,162,91,71
False,8117006,Bad Ditzenbach,6 - 10 Jahre,166,80,86
False,8117006,Bad Ditzenbach,10 - 15 Jahre,199,100,99
False,8117006,Bad Ditzenbach,15 - 18 Jahre,102,60,42
False,8117006,Bad Ditzenbach,18 - 20 Jahre,57,28,29
False,8117006,Bad Ditzenbach,20 - 25 Jahre,186,77,109
False,8117006,Bad Ditzenbach,25 - 30 Jahre,298,159,139
False,8117006,Bad Ditzenbach,30 - 35 Jahre,329,171,158
False,8117006,Bad Ditzenbach,35 - 40 Jahre,285,150,135
False,8117006,Bad Ditzenbach,40 - 45 Jahre,214,117,97
False,8117006,Bad Ditzenbach,45 - 50 Jahre,188,97,91
False,8117006,Bad Ditzenbach,50 - 55 Jahre,176,92,84
False,8117006,Bad Ditzenbach,55 - 60 Jahre,247,122,125
False,8117006,Bad Ditzenbach,60 - 65 Jahre,183,91,92
False,8117006,Bad Ditzenbach,65 - 75 Jahre,324,131,193
False,8117006,Bad Ditzenbach,75 und mehr Jahre,287,82,205
False,8117006,Bad Ditzenbach,Insgesamt,3555,1726,1829
False,8117007,Bad Überkingen,unter 3 Jahre,133,70,63
False,8117007,Bad Überkingen,3 -  6 Jahre,141,77,64
False,8117007,Bad Überkingen,6 - 10 Jahre,174,82,92
False,8117007,Bad Überkingen,10 - 15 Jahre,217,105,112
False,8117007,Bad Überkingen,15 - 18 Jahre,129,73,56
False,8117007,Bad Überkingen,18 - 20 Jahre,81,43,38
False,8117007,Bad Überkingen,20 - 25 Jahre,221,110,111
False,8117007,Bad Überkingen,25 - 30 Jahre,294,135,159
False,8117007,Bad Überkingen,30 - 35 Jahre,269,146,123
False,8117007,Bad Überkingen,35 - 40 Jahre,234,115,119
False,8117007,Bad Überkingen,40 - 45 Jahre,252,112,140
False,8117007,Bad Überkingen,45 - 50 Jahre,204,113,91
False,8117007,Bad Überkingen,50 - 55 Jahre,279,114,165
False,8117007,Bad Überkingen,55 - 60 Jahre,305,156,149
False,8117007,Bad Überkingen,60 - 65 Jahre,213,104,109
False,8117007,Bad Überkingen,65 - 75 Jahre,343,162,181
False,8117007,Bad Überkingen,75 und mehr Jahre,301,100,201
False,8117007,Bad Überkingen,Insgesamt,3790,1817,1973
False,8117009,Birenbach,unter 3 Jahre,65,28,37
False,8117009,Birenbach,3 -  6 Jahre,69,32,37
False,8117009,Birenbach,6 - 10 Jahre,91,44,47
False,8117009,Birenbach,10 - 15 Jahre,107,52,55
False,8117009,Birenbach,15 - 18 Jahre,61,30,31
False,8117009,Birenbach,18 - 20 Jahre,35,18,17
False,8117009,Birenbach,20 - 25 Jahre,101,54,47
False,8117009,Birenbach,25 - 30 Jahre,176,82,94
False,8117009,Birenbach,30 - 35 Jahre,174,106,68
False,8117009,Birenbach,35 - 40 Jahre,158,78,80
False,8117009,Birenbach,40 - 45 Jahre,127,69,58
False,8117009,Birenbach,45 - 50 Jahre,114,54,60
False,8117009,Birenbach,50 - 55 Jahre,119,53,66
False,8117009,Birenbach,55 - 60 Jahre,143,76,67
False,8117009,Birenbach,60 - 65 Jahre,109,55,54
False,8117009,Birenbach,65 - 75 Jahre,137,58,79
False,8117009,Birenbach,75 und mehr Jahre,90,31,59
False,8117009,Birenbach,Insgesamt,1876,920,956
False,8117010,Böhmenkirch,unter 3 Jahre,231,120,111
False,8117010,Böhmenkirch,3 -  6 Jahre,224,119,105
False,8117010,Böhmenkirch,6 - 10 Jahre,328,179,149
False,8117010,Böhmenkirch,10 - 15 Jahre,335,180,155
False,8117010,Böhmenkirch,15 - 18 Jahre,167,88,79
False,8117010,Böhmenkirch,18 - 20 Jahre,131,66,65
False,8117010,Böhmenkirch,20 - 25 Jahre,345,198,147
False,8117010,Böhmenkirch,25 - 30 Jahre,460,216,244
False,8117010,Böhmenkirch,30 - 35 Jahre,542,273,269
False,8117010,Böhmenkirch,35 - 40 Jahre,400,213,187
False,8117010,Böhmenkirch,40 - 45 Jahre,354,195,159
False,8117010,Böhmenkirch,45 - 50 Jahre,325,159,166
False,8117010,Böhmenkirch,50 - 55 Jahre,287,147,140
False,8117010,Böhmenkirch,55 - 60 Jahre,364,187,177
False,8117010,Böhmenkirch,60 - 65 Jahre,231,122,109
False,8117010,Böhmenkirch,65 - 75 Jahre,417,182,235
False,8117010,Böhmenkirch,75 und mehr Jahre,286,97,189
False,8117010,Böhmenkirch,Insgesamt,5427,2741,2686
False,8117011,Börtlingen,unter 3 Jahre,49,27,22
False,8117011,Börtlingen,3 -  6 Jahre,64,35,29
False,8117011,Börtlingen,6 - 10 Jahre,75,47,28
False,8117011,Börtlingen,10 - 15 Jahre,114,64,50
False,8117011,Börtlingen,15 - 18 Jahre,72,41,31
False,8117011,Börtlingen,18 - 20 Jahre,35,15,20
False,8117011,Börtlingen,20 - 25 Jahre,103,55,48
False,8117011,Börtlingen,25 - 30 Jahre,122,65,57
False,8117011,Börtlingen,30 - 35 Jahre,117,69,48
False,8117011,Börtlingen,35 - 40 Jahre,150,67,83
False,8117011,Börtlingen,40 - 45 Jahre,142,76,66
False,8117011,Börtlingen,45 - 50 Jahre,130,65,65
False,8117011,Börtlingen,50 - 55 Jahre,116,63,53
False,8117011,Börtlingen,55 - 60 Jahre,137,69,68
False,8117011,Börtlingen,60 - 65 Jahre,81,38,43
False,8117011,Börtlingen,65 - 75 Jahre,161,66,95
False,8117011,Börtlingen,75 und mehr Jahre,98,34,64
False,8117011,Börtlingen,Insgesamt,1766,896,870
False,8117012,Bad Boll,unter 3 Jahre,176,96,80
False,8117012,Bad Boll,3 -  6 Jahre,211,113,98
False,8117012,Bad Boll,6 - 10 Jahre,270,147,123
False,8117012,Bad Boll,10 - 15 Jahre,303,167,136
False,8117012,Bad Boll,15 - 18 Jahre,153,81,72
False,8117012,Bad Boll,18 - 20 Jahre,108,65,43
False,8117012,Bad Boll,20 - 25 Jahre,319,167,152
False,8117012,Bad Boll,25 - 30 Jahre,360,162,198
False,8117012,Bad Boll,30 - 35 Jahre,418,197,221
False,8117012,Bad Boll,35 - 40 Jahre,409,197,212
False,8117012,Bad Boll,40 - 45 Jahre,353,176,177
False,8117012,Bad Boll,45 - 50 Jahre,326,159,167
False,8117012,Bad Boll,50 - 55 Jahre,290,138,152
False,8117012,Bad Boll,55 - 60 Jahre,360,171,189
False,8117012,Bad Boll,60 - 65 Jahre,229,121,108
False,8117012,Bad Boll,65 - 75 Jahre,440,179,261
False,8117012,Bad Boll,75 und mehr Jahre,368,94,274
False,8117012,Bad Boll,Insgesamt,5093,2430,2663
False,8117014,Deggingen,unter 3 Jahre,159,86,73
False,8117014,Deggingen,3 -  6 Jahre,195,102,93
False,8117014,Deggingen,6 - 10 Jahre,267,129,138
False,8117014,Deggingen,10 - 15 Jahre,330,159,171
False,8117014,Deggingen,15 - 18 Jahre,171,87,84
False,8117014,Deggingen,18 - 20 Jahre,125,73,52
False,8117014,Deggingen,20 - 25 Jahre,323,166,157
False,8117014,Deggingen,25 - 30 Jahre,452,234,218
False,8117014,Deggingen,30 - 35 Jahre,523,274,249
False,8117014,Deggingen,35 - 40 Jahre,391,206,185
False,8117014,Deggingen,40 - 45 Jahre,398,200,198
False,8117014,Deggingen,45 - 50 Jahre,347,181,166
False,8117014,Deggingen,50 - 55 Jahre,363,177,186
False,8117014,Deggingen,55 - 60 Jahre,434,222,212
False,8117014,Deggingen,60 - 65 Jahre,322,168,154
False,8117014,Deggingen,65 - 75 Jahre,501,204,297
False,8117014,Deggingen,75 und mehr Jahre,408,106,302
False,8117014,Deggingen,Insgesamt,5709,2774,2935
False,8117015,"Donzdorf, Stadt",unter 3 Jahre,377,184,193
False,8117015,"Donzdorf, Stadt",3 -  6 Jahre,446,238,208
False,8117015,"Donzdorf, Stadt",6 - 10 Jahre,529,267,262
False,8117015,"Donzdorf, Stadt",10 - 15 Jahre,700,358,342
False,8117015,"Donzdorf, Stadt",15 - 18 Jahre,425,219,206
False,8117015,"Donzdorf, Stadt",18 - 20 Jahre,270,130,140
False,8117015,"Donzdorf, Stadt",20 - 25 Jahre,762,395,367
False,8117015,"Donzdorf, Stadt",25 - 30 Jahre,921,475,446
False,8117015,"Donzdorf, Stadt",30 - 35 Jahre,903,481,422
False,8117015,"Donzdorf, Stadt",35 - 40 Jahre,826,439,387
False,8117015,"Donzdorf, Stadt",40 - 45 Jahre,723,354,369
False,8117015,"Donzdorf, Stadt",45 - 50 Jahre,752,378,374
False,8117015,"Donzdorf, Stadt",50 - 55 Jahre,730,373,357
False,8117015,"Donzdorf, Stadt",55 - 60 Jahre,786,411,375
False,8117015,"Donzdorf, Stadt",60 - 65 Jahre,590,301,289
False,8117015,"Donzdorf, Stadt",65 - 75 Jahre,930,401,529
False,8117015,"Donzdorf, Stadt",75 und mehr Jahre,647,207,440
False,8117015,"Donzdorf, Stadt",Insgesamt,11317,5611,5706
False,8117016,Drackenstein,unter 3 Jahre,27,13,14
False,8117016,Drackenstein,3 -  6 Jahre,25,15,10
False,8117016,Drackenstein,6 - 10 Jahre,19,10,9
False,8117016,Drackenstein,10 - 15 Jahre,30,22,8
False,8117016,Drackenstein,15 - 18 Jahre,13,4,9
False,8117016,Drackenstein,18 - 20 Jahre,12,7,5
False,8117016,Drackenstein,20 - 25 Jahre,30,15,15
False,8117016,Drackenstein,25 - 30 Jahre,27,11,16
False,8117016,Drackenstein,30 - 35 Jahre,52,30,22
False,8117016,Drackenstein,35 - 40 Jahre,36,17,19
False,8117016,Drackenstein,40 - 45 Jahre,31,18,13
False,8117016,Drackenstein,45 - 50 Jahre,23,14,9
False,8117016,Drackenstein,50 - 55 Jahre,15,10,5
False,8117016,Drackenstein,55 - 60 Jahre,22,14,8
False,8117016,Drackenstein,60 - 65 Jahre,20,10,10
False,8117016,Drackenstein,65 - 75 Jahre,27,12,15
False,8117016,Drackenstein,75 und mehr Jahre,16,4,12
False,8117016,Drackenstein,Insgesamt,425,226,199
False,8117017,Dürnau,unter 3 Jahre,84,44,40
False,8117017,Dürnau,3 -  6 Jahre,77,39,38
False,8117017,Dürnau,6 - 10 Jahre,104,57,47
False,8117017,Dürnau,10 - 15 Jahre,86,43,43
False,8117017,Dürnau,15 - 18 Jahre,63,33,30
False,8117017,Dürnau,18 - 20 Jahre,37,21,16
False,8117017,Dürnau,20 - 25 Jahre,102,50,52
False,8117017,Dürnau,25 - 30 Jahre,162,87,75
False,8117017,Dürnau,30 - 35 Jahre,179,99,80
False,8117017,Dürnau,35 - 40 Jahre,148,78,70
False,8117017,Dürnau,40 - 45 Jahre,137,71,66
False,8117017,Dürnau,45 - 50 Jahre,131,72,59
False,8117017,Dürnau,50 - 55 Jahre,94,42,52
False,8117017,Dürnau,55 - 60 Jahre,141,73,68
False,8117017,Dürnau,60 - 65 Jahre,86,43,43
False,8117017,Dürnau,65 - 75 Jahre,150,66,84
False,8117017,Dürnau,75 und mehr Jahre,94,29,65
False,8117017,Dürnau,Insgesamt,1875,947,928
False,8117018,"Ebersbach an der Fils, Stadt",unter 3 Jahre,587,301,286
False,8117018,"Ebersbach an der Fils, Stadt",3 -  6 Jahre,606,309,297
False,8117018,"Ebersbach an der Fils, Stadt",6 - 10 Jahre,770,379,391
False,8117018,"Ebersbach an der Fils, Stadt",10 - 15 Jahre,907,479,428
False,8117018,"Ebersbach an der Fils, Stadt",15 - 18 Jahre,509,260,249
False,8117018,"Ebersbach an der Fils, Stadt",18 - 20 Jahre,320,144,176
False,8117018,"Ebersbach an der Fils, Stadt",20 - 25 Jahre,1015,531,484
False,8117018,"Ebersbach an der Fils, Stadt",25 - 30 Jahre,1237,623,614
False,8117018,"Ebersbach an der Fils, Stadt",30 - 35 Jahre,1409,754,655
False,8117018,"Ebersbach an der Fils, Stadt",35 - 40 Jahre,1249,647,602
False,8117018,"Ebersbach an der Fils, Stadt",40 - 45 Jahre,1051,527,524
False,8117018,"Ebersbach an der Fils, Stadt",45 - 50 Jahre,967,522,445
False,8117018,"Ebersbach an der Fils, Stadt",50 - 55 Jahre,1039,510,529
False,8117018,"Ebersbach an der Fils, Stadt",55 - 60 Jahre,1192,614,578
False,8117018,"Ebersbach an der Fils, Stadt",60 - 65 Jahre,899,480,419
False,8117018,"Ebersbach an der Fils, Stadt",65 - 75 Jahre,1285,569,716
False,8117018,"Ebersbach an der Fils, Stadt",75 und mehr Jahre,906,276,630
False,8117018,"Ebersbach an der Fils, Stadt",Insgesamt,15948,7925,8023
False,8117019,"Eislingen/Fils, Stadt",unter 3 Jahre,617,308,309
False,8117019,"Eislingen/Fils, Stadt",3 -  6 Jahre,675,348,327
False,8117019,"Eislingen/Fils, Stadt",6 - 10 Jahre,841,423,418
False,8117019,"Eislingen/Fils, Stadt",10 - 15 Jahre,1051,571,480
False,8117019,"Eislingen/Fils, Stadt",15 - 18 Jahre,653,325,328
False,8117019,"Eislingen/Fils, Stadt",18 - 20 Jahre,448,224,224
False,8117019,"Eislingen/Fils, Stadt",20 - 25 Jahre,1253,629,624
False,8117019,"Eislingen/Fils, Stadt",25 - 30 Jahre,1606,830,776
False,8117019,"Eislingen/Fils, Stadt",30 - 35 Jahre,1589,849,740
False,8117019,"Eislingen/Fils, Stadt",35 - 40 Jahre,1495,774,721
False,8117019,"Eislingen/Fils, Stadt",40 - 45 Jahre,1274,629,645
False,8117019,"Eislingen/Fils, Stadt",45 - 50 Jahre,1229,623,606
False,8117019,"Eislingen/Fils, Stadt",50 - 55 Jahre,1173,602,571
False,8117019,"Eislingen/Fils, Stadt",55 - 60 Jahre,1365,716,649
False,8117019,"Eislingen/Fils, Stadt",60 - 65 Jahre,1002,500,502
False,8117019,"Eislingen/Fils, Stadt",65 - 75 Jahre,1702,702,1000
False,8117019,"Eislingen/Fils, Stadt",75 und mehr Jahre,1321,390,931
False,8117019,"Eislingen/Fils, Stadt",Insgesamt,19294,9443,9851
False,8117020,Eschenbach,unter 3 Jahre,78,47,31
False,8117020,Eschenbach,3 -  6 Jahre,92,50,42
False,8117020,Eschenbach,6 - 10 Jahre,89,51,38
False,8117020,Eschenbach,10 - 15 Jahre,140,75,65
False,8117020,Eschenbach,15 - 18 Jahre,72,43,29
False,8117020,Eschenbach,18 - 20 Jahre,47,27,20
False,8117020,Eschenbach,20 - 25 Jahre,123,66,57
False,8117020,Eschenbach,25 - 30 Jahre,206,96,110
False,8117020,Eschenbach,30 - 35 Jahre,212,111,101
False,8117020,Eschenbach,35 - 40 Jahre,182,90,92
False,8117020,Eschenbach,40 - 45 Jahre,192,90,102
False,8117020,Eschenbach,45 - 50 Jahre,141,77,64
False,8117020,Eschenbach,50 - 55 Jahre,111,58,53
False,8117020,Eschenbach,55 - 60 Jahre,131,66,65
False,8117020,Eschenbach,60 - 65 Jahre,99,43,56
False,8117020,Eschenbach,65 - 75 Jahre,164,72,92
False,8117020,Eschenbach,75 und mehr Jahre,118,44,74
False,8117020,Eschenbach,Insgesamt,2197,1106,1091
False,8117023,Gammelshausen,unter 3 Jahre,59,33,26
False,8117023,Gammelshausen,3 -  6 Jahre,57,39,18
False,8117023,Gammelshausen,6 - 10 Jahre,86,43,43
False,8117023,Gammelshausen,10 - 15 Jahre,80,38,42
False,8117023,Gammelshausen,15 - 18 Jahre,46,21,25
False,8117023,Gammelshausen,18 - 20 Jahre,34,18,16
False,8117023,Gammelshausen,20 - 25 Jahre,90,50,40
False,8117023,Gammelshausen,25 - 30 Jahre,131,78,53
False,8117023,Gammelshausen,30 - 35 Jahre,152,71,81
False,8117023,Gammelshausen,35 - 40 Jahre,115,69,46
False,8117023,Gammelshausen,40 - 45 Jahre,102,42,60
False,8117023,Gammelshausen,45 - 50 Jahre,116,62,54
False,8117023,Gammelshausen,50 - 55 Jahre,95,48,47
False,8117023,Gammelshausen,55 - 60 Jahre,122,59,63
False,8117023,Gammelshausen,60 - 65 Jahre,87,50,37
False,8117023,Gammelshausen,65 - 75 Jahre,114,53,61
False,8117023,Gammelshausen,75 und mehr Jahre,76,33,43
False,8117023,Gammelshausen,Insgesamt,1562,807,755
False,8117024,"Geislingen an der Steige, Stadt",unter 3 Jahre,968,479,489
False,8117024,"Geislingen an der Steige, Stadt",3 -  6 Jahre,1069,557,512
False,8117024,"Geislingen an der Steige, Stadt",6 - 10 Jahre,1378,694,684
False,8117024,"Geislingen an der Steige, Stadt",10 - 15 Jahre,1538,790,748
False,8117024,"Geislingen an der Steige, Stadt",15 - 18 Jahre,879,437,442
False,8117024,"Geislingen an der Steige, Stadt",18 - 20 Jahre,615,319,296
False,8117024,"Geislingen an der Steige, Stadt",20 - 25 Jahre,1734,877,857
False,8117024,"Geislingen an der Steige, Stadt",25 - 30 Jahre,2337,1219,1118
False,8117024,"Geislingen an der Steige, Stadt",30 - 35 Jahre,2375,1256,1119
False,8117024,"Geislingen an der Steige, Stadt",35 - 40 Jahre,2074,1086,988
False,8117024,"Geislingen an der Steige, Stadt",40 - 45 Jahre,1769,904,865
False,8117024,"Geislingen an der Steige, Stadt",45 - 50 Jahre,1626,824,802
False,8117024,"Geislingen an der Steige, Stadt",50 - 55 Jahre,1586,799,787
False,8117024,"Geislingen an der Steige, Stadt",55 - 60 Jahre,1957,965,992
False,8117024,"Geislingen an der Steige, Stadt",60 - 65 Jahre,1676,815,861
False,8117024,"Geislingen an der Steige, Stadt",65 - 75 Jahre,2735,1141,1594
False,8117024,"Geislingen an der Steige, Stadt",75 und mehr Jahre,2113,636,1477
False,8117024,"Geislingen an der Steige, Stadt",Insgesamt,28429,13798,14631
False,8117025,Gingen an der Fils,unter 3 Jahre,130,64,66
False,8117025,Gingen an der Fils,3 -  6 Jahre,161,67,94
False,8117025,Gingen an der Fils,6 - 10 Jahre,224,118,106
False,8117025,Gingen an der Fils,10 - 15 Jahre,216,108,108
False,8117025,Gingen an der Fils,15 - 18 Jahre,145,69,76
False,8117025,Gingen an der Fils,18 - 20 Jahre,97,42,55
False,8117025,Gingen an der Fils,20 - 25 Jahre,254,128,126
False,8117025,Gingen an der Fils,25 - 30 Jahre,347,171,176
False,8117025,Gingen an der Fils,30 - 35 Jahre,367,193,174
False,8117025,Gingen an der Fils,35 - 40 Jahre,322,184,138
False,8117025,Gingen an der Fils,40 - 45 Jahre,263,130,133
False,8117025,Gingen an der Fils,45 - 50 Jahre,252,116,136
False,8117025,Gingen an der Fils,50 - 55 Jahre,280,146,134
False,8117025,Gingen an der Fils,55 - 60 Jahre,337,173,164
False,8117025,Gingen an der Fils,60 - 65 Jahre,233,122,111
False,8117025,Gingen an der Fils,65 - 75 Jahre,407,178,229
False,8117025,Gingen an der Fils,75 und mehr Jahre,276,79,197
False,8117025,Gingen an der Fils,Insgesamt,4311,2088,2223
False,8117026,"Göppingen, Stadt",unter 3 Jahre,1781,890,891
False,8117026,"Göppingen, Stadt",3 -  6 Jahre,1936,1036,900
False,8117026,"Göppingen, Stadt",6 - 10 Jahre,2546,1281,1265
False,8117026,"Göppingen, Stadt",10 - 15 Jahre,3081,1577,1504
False,8117026,"Göppingen, Stadt",15 - 18 Jahre,1764,878,886
False,8117026,"Göppingen, Stadt",18 - 20 Jahre,1231,655,576
False,8117026,"Göppingen, Stadt",20 - 25 Jahre,3671,1922,1749
False,8117026,"Göppingen, Stadt",25 - 30 Jahre,4782,2557,2225
False,8117026,"Göppingen, Stadt",30 - 35 Jahre,4708,2456,2252
False,8117026,"Göppingen, Stadt",35 - 40 Jahre,4131,2098,2033
False,8117026,"Göppingen, Stadt",40 - 45 Jahre,3819,1940,1879
False,8117026,"Göppingen, Stadt",45 - 50 Jahre,3430,1719,1711
False,8117026,"Göppingen, Stadt",50 - 55 Jahre,3578,1805,1773
False,8117026,"Göppingen, Stadt",55 - 60 Jahre,4173,2056,2117
False,8117026,"Göppingen, Stadt",60 - 65 Jahre,3147,1556,1591
False,8117026,"Göppingen, Stadt",65 - 75 Jahre,5773,2318,3455
False,8117026,"Göppingen, Stadt",75 und mehr Jahre,4535,1399,3136
False,8117026,"Göppingen, Stadt",Insgesamt,58086,28143,29943
False,8117028,Gruibingen,unter 3 Jahre,76,44,32
False,8117028,Gruibingen,3 -  6 Jahre,89,47,42
False,8117028,Gruibingen,6 - 10 Jahre,161,92,69
False,8117028,Gruibingen,10 - 15 Jahre,161,75,86
False,8117028,Gruibingen,15 - 18 Jahre,82,50,32
False,8117028,Gruibingen,18 - 20 Jahre,50,27,23
False,8117028,Gruibingen,20 - 25 Jahre,125,73,52
False,8117028,Gruibingen,25 - 30 Jahre,192,89,103
False,8117028,Gruibingen,30 - 35 Jahre,211,116,95
False,8117028,Gruibingen,35 - 40 Jahre,217,110,107
False,8117028,Gruibingen,40 - 45 Jahre,187,88,99
False,8117028,Gruibingen,45 - 50 Jahre,159,92,67
False,8117028,Gruibingen,50 - 55 Jahre,114,68,46
False,8117028,Gruibingen,55 - 60 Jahre,137,82,55
False,8117028,Gruibingen,60 - 65 Jahre,108,54,54
False,8117028,Gruibingen,65 - 75 Jahre,189,78,111
False,8117028,Gruibingen,75 und mehr Jahre,93,39,54
False,8117028,Gruibingen,Insgesamt,2351,1224,1127
False,8117029,Hattenhofen,unter 3 Jahre,101,46,55
False,8117029,Hattenhofen,3 -  6 Jahre,103,49,54
False,8117029,Hattenhofen,6 - 10 Jahre,153,80,73
False,8117029,Hattenhofen,10 - 15 Jahre,191,100,91
False,8117029,Hattenhofen,15 - 18 Jahre,127,71,56
False,8117029,Hattenhofen,18 - 20 Jahre,73,36,37
False,8117029,Hattenhofen,20 - 25 Jahre,174,90,84
False,8117029,Hattenhofen,25 - 30 Jahre,226,116,110
False,8117029,Hattenhofen,30 - 35 Jahre,243,126,117
False,8117029,Hattenhofen,35 - 40 Jahre,246,119,127
False,8117029,Hattenhofen,40 - 45 Jahre,238,129,109
False,8117029,Hattenhofen,45 - 50 Jahre,240,118,122
False,8117029,Hattenhofen,50 - 55 Jahre,215,119,96
False,8117029,Hattenhofen,55 - 60 Jahre,202,107,95
False,8117029,Hattenhofen,60 - 65 Jahre,140,76,64
False,8117029,Hattenhofen,65 - 75 Jahre,242,110,132
False,8117029,Hattenhofen,75 und mehr Jahre,142,48,94
False,8117029,Hattenhofen,Insgesamt,3056,1540,1516
False,8117030,Heiningen,unter 3 Jahre,176,96,80
False,8117030,Heiningen,3 -  6 Jahre,191,98,93
False,8117030,Heiningen,6 - 10 Jahre,236,108,128
False,8117030,Heiningen,10 - 15 Jahre,323,174,149
False,8117030,Heiningen,15 - 18 Jahre,178,88,90
False,8117030,Heiningen,18 - 20 Jahre,116,59,57
False,8117030,Heiningen,20 - 25 Jahre,338,175,163
False,8117030,Heiningen,25 - 30 Jahre,371,225,146
False,8117030,Heiningen,30 - 35 Jahre,417,214,203
False,8117030,Heiningen,35 - 40 Jahre,447,227,220
False,8117030,Heiningen,40 - 45 Jahre,406,220,186
False,8117030,Heiningen,45 - 50 Jahre,367,195,172
False,8117030,Heiningen,50 - 55 Jahre,329,164,165
False,8117030,Heiningen,55 - 60 Jahre,422,201,221
False,8117030,Heiningen,60 - 65 Jahre,282,144,138
False,8117030,Heiningen,65 - 75 Jahre,392,179,213
False,8117030,Heiningen,75 und mehr Jahre,291,100,191
False,8117030,Heiningen,Insgesamt,5282,2667,2615
False,8117031,Hohenstadt,unter 3 Jahre,18,8,10
False,8117031,Hohenstadt,3 -  6 Jahre,20,9,11
False,8117031,Hohenstadt,6 - 10 Jahre,35,12,23
False,8117031,Hohenstadt,10 - 15 Jahre,42,17,25
False,8117031,Hohenstadt,15 - 18 Jahre,27,16,11
False,8117031,Hohenstadt,18 - 20 Jahre,13,2,11
False,8117031,Hohenstadt,20 - 25 Jahre,49,31,18
False,8117031,Hohenstadt,25 - 30 Jahre,43,26,17
False,8117031,Hohenstadt,30 - 35 Jahre,38,20,18
False,8117031,Hohenstadt,35 - 40 Jahre,51,22,29
False,8117031,Hohenstadt,40 - 45 Jahre,52,25,27
False,8117031,Hohenstadt,45 - 50 Jahre,50,29,21
False,8117031,Hohenstadt,50 - 55 Jahre,37,19,18
False,8117031,Hohenstadt,55 - 60 Jahre,42,17,25
False,8117031,Hohenstadt,60 - 65 Jahre,51,26,25
False,8117031,Hohenstadt,65 - 75 Jahre,49,23,26
False,8117031,Hohenstadt,75 und mehr Jahre,26,8,18
False,8117031,Hohenstadt,Insgesamt,643,310,333
False,8117033,Kuchen,unter 3 Jahre,182,101,81
False,8117033,Kuchen,3 -  6 Jahre,186,111,75
False,8117033,Kuchen,6 - 10 Jahre,272,148,124
False,8117033,Kuchen,10 - 15 Jahre,296,165,131
False,8117033,Kuchen,15 - 18 Jahre,168,80,88
False,8117033,Kuchen,18 - 20 Jahre,115,63,52
False,8117033,Kuchen,20 - 25 Jahre,324,184,140
False,8117033,Kuchen,25 - 30 Jahre,500,269,231
False,8117033,Kuchen,30 - 35 Jahre,473,254,219
False,8117033,Kuchen,35 - 40 Jahre,387,196,191
False,8117033,Kuchen,40 - 45 Jahre,376,186,190
False,8117033,Kuchen,45 - 50 Jahre,399,206,193
False,8117033,Kuchen,50 - 55 Jahre,387,195,192
False,8117033,Kuchen,55 - 60 Jahre,479,227,252
False,8117033,Kuchen,60 - 65 Jahre,321,172,149
False,8117033,Kuchen,65 - 75 Jahre,494,217,277
False,8117033,Kuchen,75 und mehr Jahre,350,118,232
False,8117033,Kuchen,Insgesamt,5709,2892,2817
False,8117035,Mühlhausen im Täle,unter 3 Jahre,45,26,19
False,8117035,Mühlhausen im Täle,3 -  6 Jahre,56,27,29
False,8117035,Mühlhausen im Täle,6 - 10 Jahre,57,29,28
False,8117035,Mühlhausen im Täle,10 - 15 Jahre,80,43,37
False,8117035,Mühlhausen im Täle,15 - 18 Jahre,33,12,21
False,8117035,Mühlhausen im Täle,18 - 20 Jahre,20,8,12
False,8117035,Mühlhausen im Täle,20 - 25 Jahre,56,29,27
False,8117035,Mühlhausen im Täle,25 - 30 Jahre,73,31,42
False,8117035,Mühlhausen im Täle,30 - 35 Jahre,108,53,55
False,8117035,Mühlhausen im Täle,35 - 40 Jahre,100,66,34
False,8117035,Mühlhausen im Täle,40 - 45 Jahre,81,35,46
False,8117035,Mühlhausen im Täle,45 - 50 Jahre,66,44,22
False,8117035,Mühlhausen im Täle,50 - 55 Jahre,47,22,25
False,8117035,Mühlhausen im Täle,55 - 60 Jahre,70,35,35
False,8117035,Mühlhausen im Täle,60 - 65 Jahre,50,27,23
False,8117035,Mühlhausen im Täle,65 - 75 Jahre,92,37,55
False,8117035,Mühlhausen im Täle,75 und mehr Jahre,39,9,30
False,8117035,Mühlhausen im Täle,Insgesamt,1073,533,540
False,8117037,Ottenbach,unter 3 Jahre,79,33,46
False,8117037,Ottenbach,3 -  6 Jahre,74,40,34
False,8117037,Ottenbach,6 - 10 Jahre,118,61,57
False,8117037,Ottenbach,10 - 15 Jahre,144,65,79
False,8117037,Ottenbach,15 - 18 Jahre,100,51,49
False,8117037,Ottenbach,18 - 20 Jahre,53,24,29
False,8117037,Ottenbach,20 - 25 Jahre,144,71,73
False,8117037,Ottenbach,25 - 30 Jahre,186,95,91
False,8117037,Ottenbach,30 - 35 Jahre,188,94,94
False,8117037,Ottenbach,35 - 40 Jahre,167,86,81
False,8117037,Ottenbach,40 - 45 Jahre,185,95,90
False,8117037,Ottenbach,45 - 50 Jahre,135,63,72
False,8117037,Ottenbach,50 - 55 Jahre,132,75,57
False,8117037,Ottenbach,55 - 60 Jahre,171,87,84
False,8117037,Ottenbach,60 - 65 Jahre,111,54,57
False,8117037,Ottenbach,65 - 75 Jahre,178,80,98
False,8117037,Ottenbach,75 und mehr Jahre,140,37,103
False,8117037,Ottenbach,Insgesamt,2305,1111,1194
False,8117038,Rechberghausen,unter 3 Jahre,177,97,80
False,8117038,Rechberghausen,3 -  6 Jahre,177,96,81
False,8117038,Rechberghausen,6 - 10 Jahre,224,116,108
False,8117038,Rechberghausen,10 - 15 Jahre,296,139,157
False,8117038,Rechberghausen,15 - 18 Jahre,166,82,84
False,8117038,Rechberghausen,18 - 20 Jahre,75,36,39
False,8117038,Rechberghausen,20 - 25 Jahre,306,144,162
False,8117038,Rechberghausen,25 - 30 Jahre,395,201,194
False,8117038,Rechberghausen,30 - 35 Jahre,398,198,200
False,8117038,Rechberghausen,35 - 40 Jahre,376,191,185
False,8117038,Rechberghausen,40 - 45 Jahre,321,153,168
False,8117038,Rechberghausen,45 - 50 Jahre,353,171,182
False,8117038,Rechberghausen,50 - 55 Jahre,371,183,188
False,8117038,Rechberghausen,55 - 60 Jahre,412,201,211
False,8117038,Rechberghausen,60 - 65 Jahre,326,161,165
False,8117038,Rechberghausen,65 - 75 Jahre,528,233,295
False,8117038,Rechberghausen,75 und mehr Jahre,344,125,219
False,8117038,Rechberghausen,Insgesamt,5245,2527,2718
False,8117042,Salach,unter 3 Jahre,251,137,114
False,8117042,Salach,3 -  6 Jahre,288,143,145
False,8117042,Salach,6 - 10 Jahre,367,193,174
False,8117042,Salach,10 - 15 Jahre,415,204,211
False,8117042,Salach,15 - 18 Jahre,262,133,129
False,8117042,Salach,18 - 20 Jahre,177,86,91
False,8117042,Salach,20 - 25 Jahre,461,215,246
False,8117042,Salach,25 - 30 Jahre,679,356,323
False,8117042,Salach,30 - 35 Jahre,669,366,303
False,8117042,Salach,35 - 40 Jahre,577,300,277
False,8117042,Salach,40 - 45 Jahre,508,260,248
False,8117042,Salach,45 - 50 Jahre,465,239,226
False,8117042,Salach,50 - 55 Jahre,458,243,215
False,8117042,Salach,55 - 60 Jahre,536,264,272
False,8117042,Salach,60 - 65 Jahre,392,198,194
False,8117042,Salach,65 - 75 Jahre,591,219,372
False,8117042,Salach,75 und mehr Jahre,578,170,408
False,8117042,Salach,Insgesamt,7674,3726,3948
False,8117043,Schlat,unter 3 Jahre,43,24,19
False,8117043,Schlat,3 -  6 Jahre,62,38,24
False,8117043,Schlat,6 - 10 Jahre,80,40,40
False,8117043,Schlat,10 - 15 Jahre,99,58,41
False,8117043,Schlat,15 - 18 Jahre,58,28,30
False,8117043,Schlat,18 - 20 Jahre,34,17,17
False,8117043,Schlat,20 - 25 Jahre,91,49,42
False,8117043,Schlat,25 - 30 Jahre,130,68,62
False,8117043,Schlat,30 - 35 Jahre,142,77,65
False,8117043,Schlat,35 - 40 Jahre,151,72,79
False,8117043,Schlat,40 - 45 Jahre,123,70,53
False,8117043,Schlat,45 - 50 Jahre,96,37,59
False,8117043,Schlat,50 - 55 Jahre,127,70,57
False,8117043,Schlat,55 - 60 Jahre,117,65,52
False,8117043,Schlat,60 - 65 Jahre,105,42,63
False,8117043,Schlat,65 - 75 Jahre,150,68,82
False,8117043,Schlat,75 und mehr Jahre,91,27,64
False,8117043,Schlat,Insgesamt,1699,850,849
False,8117044,Schlierbach,unter 3 Jahre,159,83,76
False,8117044,Schlierbach,3 -  6 Jahre,151,57,94
False,8117044,Schlierbach,6 - 10 Jahre,169,85,84
False,8117044,Schlierbach,10 - 15 Jahre,202,110,92
False,8117044,Schlierbach,15 - 18 Jahre,126,59,67
False,8117044,Schlierbach,18 - 20 Jahre,80,39,41
False,8117044,Schlierbach,20 - 25 Jahre,229,122,107
False,8117044,Schlierbach,25 - 30 Jahre,270,137,133
False,8117044,Schlierbach,30 - 35 Jahre,336,173,163
False,8117044,Schlierbach,35 - 40 Jahre,261,140,121
False,8117044,Schlierbach,40 - 45 Jahre,236,121,115
False,8117044,Schlierbach,45 - 50 Jahre,258,124,134
False,8117044,Schlierbach,50 - 55 Jahre,247,141,106
False,8117044,Schlierbach,55 - 60 Jahre,274,139,135
False,8117044,Schlierbach,60 - 65 Jahre,210,107,103
False,8117044,Schlierbach,65 - 75 Jahre,285,138,147
False,8117044,Schlierbach,75 und mehr Jahre,162,47,115
False,8117044,Schlierbach,Insgesamt,3655,1822,1833
False,8117049,"Süßen, Stadt",unter 3 Jahre,351,188,163
False,8117049,"Süßen, Stadt",3 -  6 Jahre,397,195,202
False,8117049,"Süßen, Stadt",6 - 10 Jahre,499,270,229
False,8117049,"Süßen, Stadt",10 - 15 Jahre,596,303,293
False,8117049,"Süßen, Stadt",15 - 18 Jahre,368,194,174
False,8117049,"Süßen, Stadt",18 - 20 Jahre,222,112,110
False,8117049,"Süßen, Stadt",20 - 25 Jahre,619,312,307
False,8117049,"Süßen, Stadt",25 - 30 Jahre,791,402,389
False,8117049,"Süßen, Stadt",30 - 35 Jahre,906,480,426
False,8117049,"Süßen, Stadt",35 - 40 Jahre,863,468,395
False,8117049,"Süßen, Stadt",40 - 45 Jahre,731,372,359
False,8117049,"Süßen, Stadt",45 - 50 Jahre,619,318,301
False,8117049,"Süßen, Stadt",50 - 55 Jahre,551,288,263
False,8117049,"Süßen, Stadt",55 - 60 Jahre,729,347,382
False,8117049,"Süßen, Stadt",60 - 65 Jahre,530,277,253
False,8117049,"Süßen, Stadt",65 - 75 Jahre,790,335,455
False,8117049,"Süßen, Stadt",75 und mehr Jahre,652,195,457
False,8117049,"Süßen, Stadt",Insgesamt,10214,5056,5158
False,8117051,"Uhingen, Stadt",unter 3 Jahre,475,242,233
False,8117051,"Uhingen, Stadt",3 -  6 Jahre,529,278,251
False,8117051,"Uhingen, Stadt",6 - 10 Jahre,672,348,324
False,8117051,"Uhingen, Stadt",10 - 15 Jahre,702,379,323
False,8117051,"Uhingen, Stadt",15 - 18 Jahre,464,246,218
False,8117051,"Uhingen, Stadt",18 - 20 Jahre,302,146,156
False,8117051,"Uhingen, Stadt",20 - 25 Jahre,769,424,345
False,8117051,"Uhingen, Stadt",25 - 30 Jahre,998,517,481
False,8117051,"Uhingen, Stadt",30 - 35 Jahre,1060,550,510
False,8117051,"Uhingen, Stadt",35 - 40 Jahre,1050,544,506
False,8117051,"Uhingen, Stadt",40 - 45 Jahre,873,438,435
False,8117051,"Uhingen, Stadt",45 - 50 Jahre,786,386,400
False,8117051,"Uhingen, Stadt",50 - 55 Jahre,842,432,410
False,8117051,"Uhingen, Stadt",55 - 60 Jahre,998,502,496
False,8117051,"Uhingen, Stadt",60 - 65 Jahre,803,421,382
False,8117051,"Uhingen, Stadt",65 - 75 Jahre,1202,518,684
False,8117051,"Uhingen, Stadt",75 und mehr Jahre,860,259,601
False,8117051,"Uhingen, Stadt",Insgesamt,13385,6630,6755
False,8117053,Wäschenbeuren,unter 3 Jahre,136,59,77
False,8117053,Wäschenbeuren,3 -  6 Jahre,158,78,80
False,8117053,Wäschenbeuren,6 - 10 Jahre,194,91,103
False,8117053,Wäschenbeuren,10 - 15 Jahre,221,113,108
False,8117053,Wäschenbeuren,15 - 18 Jahre,108,53,55
False,8117053,Wäschenbeuren,18 - 20 Jahre,68,34,34
False,8117053,Wäschenbeuren,20 - 25 Jahre,233,115,118
False,8117053,Wäschenbeuren,25 - 30 Jahre,297,146,151
False,8117053,Wäschenbeuren,30 - 35 Jahre,359,187,172
False,8117053,Wäschenbeuren,35 - 40 Jahre,342,170,172
False,8117053,Wäschenbeuren,40 - 45 Jahre,210,109,101
False,8117053,Wäschenbeuren,45 - 50 Jahre,199,98,101
False,8117053,Wäschenbeuren,50 - 55 Jahre,215,109,106
False,8117053,Wäschenbeuren,55 - 60 Jahre,256,125,131
False,8117053,Wäschenbeuren,60 - 65 Jahre,165,83,82
False,8117053,Wäschenbeuren,65 - 75 Jahre,237,118,119
False,8117053,Wäschenbeuren,75 und mehr Jahre,181,54,127
False,8117053,Wäschenbeuren,Insgesamt,3579,1742,1837
False,8117055,Wangen,unter 3 Jahre,100,56,44
False,8117055,Wangen,3 -  6 Jahre,122,59,63
False,8117055,Wangen,6 - 10 Jahre,153,78,75
False,8117055,Wangen,10 - 15 Jahre,193,99,94
False,8117055,Wangen,15 - 18 Jahre,110,52,58
False,8117055,Wangen,18 - 20 Jahre,87,53,34
False,8117055,Wangen,20 - 25 Jahre,214,107,107
False,8117055,Wangen,25 - 30 Jahre,261,136,125
False,8117055,Wangen,30 - 35 Jahre,282,154,128
False,8117055,Wangen,35 - 40 Jahre,265,115,150
False,8117055,Wangen,40 - 45 Jahre,246,126,120
False,8117055,Wangen,45 - 50 Jahre,204,110,94
False,8117055,Wangen,50 - 55 Jahre,222,116,106
False,8117055,Wangen,55 - 60 Jahre,264,131,133
False,8117055,Wangen,60 - 65 Jahre,175,85,90
False,8117055,Wangen,65 - 75 Jahre,288,132,156
False,8117055,Wangen,75 und mehr Jahre,179,62,117
False,8117055,Wangen,Insgesamt,3365,1671,1694
False,8117058,"Wiesensteig, Stadt",unter 3 Jahre,85,52,33
False,8117058,"Wiesensteig, Stadt",3 -  6 Jahre,67,35,32
False,8117058,"Wiesensteig, Stadt",6 - 10 Jahre,115,60,55
False,8117058,"Wiesensteig, Stadt",10 - 15 Jahre,127,68,59
False,8117058,"Wiesensteig, Stadt",15 - 18 Jahre,84,32,52
False,8117058,"Wiesensteig, Stadt",18 - 20 Jahre,81,46,35
False,8117058,"Wiesensteig, Stadt",20 - 25 Jahre,168,80,88
False,8117058,"Wiesensteig, Stadt",25 - 30 Jahre,193,109,84
False,8117058,"Wiesensteig, Stadt",30 - 35 Jahre,202,112,90
False,8117058,"Wiesensteig, Stadt",35 - 40 Jahre,173,93,80
False,8117058,"Wiesensteig, Stadt",40 - 45 Jahre,151,85,66
False,8117058,"Wiesensteig, Stadt",45 - 50 Jahre,129,67,62
False,8117058,"Wiesensteig, Stadt",50 - 55 Jahre,116,61,55
False,8117058,"Wiesensteig, Stadt",55 - 60 Jahre,191,79,112
False,8117058,"Wiesensteig, Stadt",60 - 65 Jahre,174,87,87
False,8117058,"Wiesensteig, Stadt",65 - 75 Jahre,226,103,123
False,8117058,"Wiesensteig, Stadt",75 und mehr Jahre,163,48,115
False,8117058,"Wiesensteig, Stadt",Insgesamt,2445,1217,1228
False,8117060,Zell unter Aichelberg,unter 3 Jahre,95,52,43
False,8117060,Zell unter Aichelberg,3 -  6 Jahre,92,52,40
False,8117060,Zell unter Aichelberg,6 - 10 Jahre,138,80,58
False,8117060,Zell unter Aichelberg,10 - 15 Jahre,170,92,78
False,8117060,Zell unter Aichelberg,15 - 18 Jahre,99,57,42
False,8117060,Zell unter Aichelberg,18 - 20 Jahre,55,27,28
False,8117060,Zell unter Aichelberg,20 - 25 Jahre,147,80,67
False,8117060,Zell unter Aichelberg,25 - 30 Jahre,207,100,107
False,8117060,Zell unter Aichelberg,30 - 35 Jahre,211,106,105
False,8117060,Zell unter Aichelberg,35 - 40 Jahre,233,118,115
False,8117060,Zell unter Aichelberg,40 - 45 Jahre,215,111,104
False,8117060,Zell unter Aichelberg,45 - 50 Jahre,212,104,108
False,8117060,Zell unter Aichelberg,50 - 55 Jahre,198,105,93
False,8117060,Zell unter Aichelberg,55 - 60 Jahre,188,102,86
False,8117060,Zell unter Aichelberg,60 - 65 Jahre,136,66,70
False,8117060,Zell unter Aichelberg,65 - 75 Jahre,187,71,116
False,8117060,Zell unter Aichelberg,75 und mehr Jahre,123,38,85
False,8117060,Zell unter Aichelberg,Insgesamt,2706,1361,1345
False,8117061,"Lauterstein, Stadt",unter 3 Jahre,110,58,52
False,8117061,"Lauterstein, Stadt",3 -  6 Jahre,120,58,62
False,8117061,"Lauterstein, Stadt",6 - 10 Jahre,136,75,61
False,8117061,"Lauterstein, Stadt",10 - 15 Jahre,168,82,86
False,8117061,"Lauterstein, Stadt",15 - 18 Jahre,75,34,41
False,8117061,"Lauterstein, Stadt",18 - 20 Jahre,73,32,41
False,8117061,"Lauterstein, Stadt",20 - 25 Jahre,193,97,96
False,8117061,"Lauterstein, Stadt",25 - 30 Jahre,231,119,112
False,8117061,"Lauterstein, Stadt",30 - 35 Jahre,245,127,118
False,8117061,"Lauterstein, Stadt",35 - 40 Jahre,222,116,106
False,8117061,"Lauterstein, Stadt",40 - 45 Jahre,186,96,90
False,8117061,"Lauterstein, Stadt",45 - 50 Jahre,177,95,82
False,8117061,"Lauterstein, Stadt",50 - 55 Jahre,138,81,57
False,8117061,"Lauterstein, Stadt",55 - 60 Jahre,211,103,108
False,8117061,"Lauterstein, Stadt",60 - 65 Jahre,118,67,51
False,8117061,"Lauterstein, Stadt",65 - 75 Jahre,282,109,173
False,8117061,"Lauterstein, Stadt",75 und mehr Jahre,180,65,115
False,8117061,"Lauterstein, Stadt",Insgesamt,2865,1414,1451
False,8118,Landkreis Ludwigsburg,unter 3 Jahre,16660,8571,8089
False,8118,Landkreis Ludwigsburg,3 -  6 Jahre,17628,9000,8628
False,8118,Landkreis Ludwigsburg,6 - 10 Jahre,22149,11418,10731
False,8118,Landkreis Ludwigsburg,10 - 15 Jahre,25322,12880,12442
False,8118,Landkreis Ludwigsburg,15 - 18 Jahre,15236,7859,7377
False,8118,Landkreis Ludwigsburg,18 - 20 Jahre,10311,5353,4958
False,8118,Landkreis Ludwigsburg,20 - 25 Jahre,29172,14846,14326
False,8118,Landkreis Ludwigsburg,25 - 30 Jahre,41231,21291,19940
False,8118,Landkreis Ludwigsburg,30 - 35 Jahre,43908,23044,20864
False,8118,Landkreis Ludwigsburg,35 - 40 Jahre,38827,20090,18737
False,8118,Landkreis Ludwigsburg,40 - 45 Jahre,33282,16611,16671
False,8118,Landkreis Ludwigsburg,45 - 50 Jahre,31080,15649,15431
False,8118,Landkreis Ludwigsburg,50 - 55 Jahre,32793,16586,16207
False,8118,Landkreis Ludwigsburg,55 - 60 Jahre,36522,18518,18004
False,8118,Landkreis Ludwigsburg,60 - 65 Jahre,26378,13367,13011
False,8118,Landkreis Ludwigsburg,65 - 75 Jahre,38719,16636,22083
False,8118,Landkreis Ludwigsburg,75 und mehr Jahre,26613,8110,18503
False,8118,Landkreis Ludwigsburg,Insgesamt,485831,239829,246002
False,8118001,Affalterbach,unter 3 Jahre,156,95,61
False,8118001,Affalterbach,3 -  6 Jahre,175,87,88
False,8118001,Affalterbach,6 - 10 Jahre,251,149,102
False,8118001,Affalterbach,10 - 15 Jahre,252,125,127
False,8118001,Affalterbach,15 - 18 Jahre,151,87,64
False,8118001,Affalterbach,18 - 20 Jahre,113,54,59
False,8118001,Affalterbach,20 - 25 Jahre,249,141,108
False,8118001,Affalterbach,25 - 30 Jahre,319,164,155
False,8118001,Affalterbach,30 - 35 Jahre,345,176,169
False,8118001,Affalterbach,35 - 40 Jahre,357,177,180
False,8118001,Affalterbach,40 - 45 Jahre,334,155,179
False,8118001,Affalterbach,45 - 50 Jahre,355,181,174
False,8118001,Affalterbach,50 - 55 Jahre,324,156,168
False,8118001,Affalterbach,55 - 60 Jahre,362,194,168
False,8118001,Affalterbach,60 - 65 Jahre,253,136,117
False,8118001,Affalterbach,65 - 75 Jahre,303,134,169
False,8118001,Affalterbach,75 und mehr Jahre,225,72,153
False,8118001,Affalterbach,Insgesamt,4524,2283,2241
False,8118003,"Asperg, Stadt",unter 3 Jahre,369,180,189
False,8118003,"Asperg, Stadt",3 -  6 Jahre,388,179,209
False,8118003,"Asperg, Stadt",6 - 10 Jahre,497,258,239
False,8118003,"Asperg, Stadt",10 - 15 Jahre,571,289,282
False,8118003,"Asperg, Stadt",15 - 18 Jahre,353,197,156
False,8118003,"Asperg, Stadt",18 - 20 Jahre,216,107,109
False,8118003,"Asperg, Stadt",20 - 25 Jahre,646,315,331
False,8118003,"Asperg, Stadt",25 - 30 Jahre,1025,545,480
False,8118003,"Asperg, Stadt",30 - 35 Jahre,1057,544,513
False,8118003,"Asperg, Stadt",35 - 40 Jahre,971,515,456
False,8118003,"Asperg, Stadt",40 - 45 Jahre,827,448,379
False,8118003,"Asperg, Stadt",45 - 50 Jahre,769,399,370
False,8118003,"Asperg, Stadt",50 - 55 Jahre,874,436,438
False,8118003,"Asperg, Stadt",55 - 60 Jahre,910,446,464
False,8118003,"Asperg, Stadt",60 - 65 Jahre,738,379,359
False,8118003,"Asperg, Stadt",65 - 75 Jahre,1057,466,591
False,8118003,"Asperg, Stadt",75 und mehr Jahre,797,242,555
False,8118003,"Asperg, Stadt",Insgesamt,12065,5945,6120
False,8118006,Benningen am Neckar,unter 3 Jahre,190,96,94
False,8118006,Benningen am Neckar,3 -  6 Jahre,200,114,86
False,8118006,Benningen am Neckar,6 - 10 Jahre,274,142,132
False,8118006,Benningen am Neckar,10 - 15 Jahre,279,129,150
False,8118006,Benningen am Neckar,15 - 18 Jahre,157,79,78
False,8118006,Benningen am Neckar,18 - 20 Jahre,124,72,52
False,8118006,Benningen am Neckar,20 - 25 Jahre,296,163,133
False,8118006,Benningen am Neckar,25 - 30 Jahre,414,203,211
False,8118006,Benningen am Neckar,30 - 35 Jahre,472,248,224
False,8118006,Benningen am Neckar,35 - 40 Jahre,431,208,223
False,8118006,Benningen am Neckar,40 - 45 Jahre,453,228,225
False,8118006,Benningen am Neckar,45 - 50 Jahre,382,190,192
False,8118006,Benningen am Neckar,50 - 55 Jahre,340,178,162
False,8118006,Benningen am Neckar,55 - 60 Jahre,390,187,203
False,8118006,Benningen am Neckar,60 - 65 Jahre,250,118,132
False,8118006,Benningen am Neckar,65 - 75 Jahre,385,186,199
False,8118006,Benningen am Neckar,75 und mehr Jahre,241,71,170
False,8118006,Benningen am Neckar,Insgesamt,5278,2612,2666
False,8118007,"Besigheim, Stadt",unter 3 Jahre,389,203,186
False,8118007,"Besigheim, Stadt",3 -  6 Jahre,381,201,180
False,8118007,"Besigheim, Stadt",6 - 10 Jahre,521,264,257
False,8118007,"Besigheim, Stadt",10 - 15 Jahre,634,313,321
False,8118007,"Besigheim, Stadt",15 - 18 Jahre,319,147,172
False,8118007,"Besigheim, Stadt",18 - 20 Jahre,209,119,90
False,8118007,"Besigheim, Stadt",20 - 25 Jahre,661,297,364
False,8118007,"Besigheim, Stadt",25 - 30 Jahre,848,425,423
False,8118007,"Besigheim, Stadt",30 - 35 Jahre,945,458,487
False,8118007,"Besigheim, Stadt",35 - 40 Jahre,869,439,430
False,8118007,"Besigheim, Stadt",40 - 45 Jahre,718,357,361
False,8118007,"Besigheim, Stadt",45 - 50 Jahre,624,330,294
False,8118007,"Besigheim, Stadt",50 - 55 Jahre,648,342,306
False,8118007,"Besigheim, Stadt",55 - 60 Jahre,750,375,375
False,8118007,"Besigheim, Stadt",60 - 65 Jahre,561,284,277
False,8118007,"Besigheim, Stadt",65 - 75 Jahre,859,343,516
False,8118007,"Besigheim, Stadt",75 und mehr Jahre,687,190,497
False,8118007,"Besigheim, Stadt",Insgesamt,10623,5087,5536
False,8118010,"Bönnigheim, Stadt",unter 3 Jahre,247,132,115
False,8118010,"Bönnigheim, Stadt",3 -  6 Jahre,261,135,126
False,8118010,"Bönnigheim, Stadt",6 - 10 Jahre,350,180,170
False,8118010,"Bönnigheim, Stadt",10 - 15 Jahre,360,170,190
False,8118010,"Bönnigheim, Stadt",15 - 18 Jahre,192,102,90
False,8118010,"Bönnigheim, Stadt",18 - 20 Jahre,197,100,97
False,8118010,"Bönnigheim, Stadt",20 - 25 Jahre,479,270,209
False,8118010,"Bönnigheim, Stadt",25 - 30 Jahre,625,324,301
False,8118010,"Bönnigheim, Stadt",30 - 35 Jahre,641,335,306
False,8118010,"Bönnigheim, Stadt",35 - 40 Jahre,539,278,261
False,8118010,"Bönnigheim, Stadt",40 - 45 Jahre,421,222,199
False,8118010,"Bönnigheim, Stadt",45 - 50 Jahre,440,217,223
False,8118010,"Bönnigheim, Stadt",50 - 55 Jahre,339,176,163
False,8118010,"Bönnigheim, Stadt",55 - 60 Jahre,483,239,244
False,8118010,"Bönnigheim, Stadt",60 - 65 Jahre,384,197,187
False,8118010,"Bönnigheim, Stadt",65 - 75 Jahre,516,216,300
False,8118010,"Bönnigheim, Stadt",75 und mehr Jahre,341,111,230
False,8118010,"Bönnigheim, Stadt",Insgesamt,6815,3404,3411
False,8118011,"Ditzingen, Stadt",unter 3 Jahre,828,433,395
False,8118011,"Ditzingen, Stadt",3 -  6 Jahre,838,403,435
False,8118011,"Ditzingen, Stadt",6 - 10 Jahre,1064,534,530
False,8118011,"Ditzingen, Stadt",10 - 15 Jahre,1219,631,588
False,8118011,"Ditzingen, Stadt",15 - 18 Jahre,726,374,352
False,8118011,"Ditzingen, Stadt",18 - 20 Jahre,485,248,237
False,8118011,"Ditzingen, Stadt",20 - 25 Jahre,1403,698,705
False,8118011,"Ditzingen, Stadt",25 - 30 Jahre,1962,1006,956
False,8118011,"Ditzingen, Stadt",30 - 35 Jahre,2174,1122,1052
False,8118011,"Ditzingen, Stadt",35 - 40 Jahre,1936,1008,928
False,8118011,"Ditzingen, Stadt",40 - 45 Jahre,1645,839,806
False,8118011,"Ditzingen, Stadt",45 - 50 Jahre,1602,798,804
False,8118011,"Ditzingen, Stadt",50 - 55 Jahre,1765,889,876
False,8118011,"Ditzingen, Stadt",55 - 60 Jahre,1836,952,884
False,8118011,"Ditzingen, Stadt",60 - 65 Jahre,1253,615,638
False,8118011,"Ditzingen, Stadt",65 - 75 Jahre,1739,790,949
False,8118011,"Ditzingen, Stadt",75 und mehr Jahre,1073,321,752
False,8118011,"Ditzingen, Stadt",Insgesamt,23548,11661,11887
False,8118012,Eberdingen,unter 3 Jahre,284,146,138
False,8118012,Eberdingen,3 -  6 Jahre,296,151,145
False,8118012,Eberdingen,6 - 10 Jahre,304,139,165
False,8118012,Eberdingen,10 - 15 Jahre,383,190,193
False,8118012,Eberdingen,15 - 18 Jahre,241,129,112
False,8118012,Eberdingen,18 - 20 Jahre,159,78,81
False,8118012,Eberdingen,20 - 25 Jahre,386,190,196
False,8118012,Eberdingen,25 - 30 Jahre,555,262,293
False,8118012,Eberdingen,30 - 35 Jahre,626,333,293
False,8118012,Eberdingen,35 - 40 Jahre,509,278,231
False,8118012,Eberdingen,40 - 45 Jahre,476,247,229
False,8118012,Eberdingen,45 - 50 Jahre,443,222,221
False,8118012,Eberdingen,50 - 55 Jahre,451,221,230
False,8118012,Eberdingen,55 - 60 Jahre,453,229,224
False,8118012,Eberdingen,60 - 65 Jahre,281,148,133
False,8118012,Eberdingen,65 - 75 Jahre,444,211,233
False,8118012,Eberdingen,75 und mehr Jahre,249,79,170
False,8118012,Eberdingen,Insgesamt,6540,3253,3287
False,8118014,Erdmannhausen,unter 3 Jahre,166,82,84
False,8118014,Erdmannhausen,3 -  6 Jahre,182,92,90
False,8118014,Erdmannhausen,6 - 10 Jahre,254,124,130
False,8118014,Erdmannhausen,10 - 15 Jahre,273,143,130
False,8118014,Erdmannhausen,15 - 18 Jahre,179,92,87
False,8118014,Erdmannhausen,18 - 20 Jahre,94,41,53
False,8118014,Erdmannhausen,20 - 25 Jahre,272,149,123
False,8118014,Erdmannhausen,25 - 30 Jahre,380,196,184
False,8118014,Erdmannhausen,30 - 35 Jahre,432,213,219
False,8118014,Erdmannhausen,35 - 40 Jahre,389,209,180
False,8118014,Erdmannhausen,40 - 45 Jahre,385,171,214
False,8118014,Erdmannhausen,45 - 50 Jahre,313,175,138
False,8118014,Erdmannhausen,50 - 55 Jahre,281,141,140
False,8118014,Erdmannhausen,55 - 60 Jahre,322,173,149
False,8118014,Erdmannhausen,60 - 65 Jahre,241,120,121
False,8118014,Erdmannhausen,65 - 75 Jahre,379,164,215
False,8118014,Erdmannhausen,75 und mehr Jahre,193,62,131
False,8118014,Erdmannhausen,Insgesamt,4735,2347,2388
False,8118015,Erligheim,unter 3 Jahre,96,44,52
False,8118015,Erligheim,3 -  6 Jahre,121,68,53
False,8118015,Erligheim,6 - 10 Jahre,164,90,74
False,8118015,Erligheim,10 - 15 Jahre,143,76,67
False,8118015,Erligheim,15 - 18 Jahre,87,44,43
False,8118015,Erligheim,18 - 20 Jahre,47,25,22
False,8118015,Erligheim,20 - 25 Jahre,148,74,74
False,8118015,Erligheim,25 - 30 Jahre,212,107,105
False,8118015,Erligheim,30 - 35 Jahre,254,124,130
False,8118015,Erligheim,35 - 40 Jahre,235,128,107
False,8118015,Erligheim,40 - 45 Jahre,202,99,103
False,8118015,Erligheim,45 - 50 Jahre,137,69,68
False,8118015,Erligheim,50 - 55 Jahre,142,75,67
False,8118015,Erligheim,55 - 60 Jahre,164,77,87
False,8118015,Erligheim,60 - 65 Jahre,119,66,53
False,8118015,Erligheim,65 - 75 Jahre,162,77,85
False,8118015,Erligheim,75 und mehr Jahre,85,20,65
False,8118015,Erligheim,Insgesamt,2518,1263,1255
False,8118016,Freudental,unter 3 Jahre,77,42,35
False,8118016,Freudental,3 -  6 Jahre,101,48,53
False,8118016,Freudental,6 - 10 Jahre,115,67,48
False,8118016,Freudental,10 - 15 Jahre,117,60,57
False,8118016,Freudental,15 - 18 Jahre,76,43,33
False,8118016,Freudental,18 - 20 Jahre,50,28,22
False,8118016,Freudental,20 - 25 Jahre,126,72,54
False,8118016,Freudental,25 - 30 Jahre,233,120,113
False,8118016,Freudental,30 - 35 Jahre,210,118,92
False,8118016,Freudental,35 - 40 Jahre,202,107,95
False,8118016,Freudental,40 - 45 Jahre,148,77,71
False,8118016,Freudental,45 - 50 Jahre,146,65,81
False,8118016,Freudental,50 - 55 Jahre,164,84,80
False,8118016,Freudental,55 - 60 Jahre,164,83,81
False,8118016,Freudental,60 - 65 Jahre,111,62,49
False,8118016,Freudental,65 - 75 Jahre,157,69,88
False,8118016,Freudental,75 und mehr Jahre,183,50,133
False,8118016,Freudental,Insgesamt,2380,1195,1185
False,8118018,Gemmrigheim,unter 3 Jahre,128,65,63
False,8118018,Gemmrigheim,3 -  6 Jahre,133,74,59
False,8118018,Gemmrigheim,6 - 10 Jahre,171,84,87
False,8118018,Gemmrigheim,10 - 15 Jahre,196,96,100
False,8118018,Gemmrigheim,15 - 18 Jahre,131,65,66
False,8118018,Gemmrigheim,18 - 20 Jahre,70,43,27
False,8118018,Gemmrigheim,20 - 25 Jahre,215,118,97
False,8118018,Gemmrigheim,25 - 30 Jahre,336,162,174
False,8118018,Gemmrigheim,30 - 35 Jahre,321,180,141
False,8118018,Gemmrigheim,35 - 40 Jahre,266,138,128
False,8118018,Gemmrigheim,40 - 45 Jahre,244,124,120
False,8118018,Gemmrigheim,45 - 50 Jahre,217,113,104
False,8118018,Gemmrigheim,50 - 55 Jahre,213,114,99
False,8118018,Gemmrigheim,55 - 60 Jahre,261,127,134
False,8118018,Gemmrigheim,60 - 65 Jahre,205,102,103
False,8118018,Gemmrigheim,65 - 75 Jahre,247,108,139
False,8118018,Gemmrigheim,75 und mehr Jahre,174,55,119
False,8118018,Gemmrigheim,Insgesamt,3528,1768,1760
False,8118019,"Gerlingen, Stadt",unter 3 Jahre,536,279,257
False,8118019,"Gerlingen, Stadt",3 -  6 Jahre,527,283,244
False,8118019,"Gerlingen, Stadt",6 - 10 Jahre,696,363,333
False,8118019,"Gerlingen, Stadt",10 - 15 Jahre,768,391,377
False,8118019,"Gerlingen, Stadt",15 - 18 Jahre,484,271,213
False,8118019,"Gerlingen, Stadt",18 - 20 Jahre,313,154,159
False,8118019,"Gerlingen, Stadt",20 - 25 Jahre,953,495,458
False,8118019,"Gerlingen, Stadt",25 - 30 Jahre,1456,780,676
False,8118019,"Gerlingen, Stadt",30 - 35 Jahre,1637,853,784
False,8118019,"Gerlingen, Stadt",35 - 40 Jahre,1364,713,651
False,8118019,"Gerlingen, Stadt",40 - 45 Jahre,1116,551,565
False,8118019,"Gerlingen, Stadt",45 - 50 Jahre,1074,520,554
False,8118019,"Gerlingen, Stadt",50 - 55 Jahre,1328,654,674
False,8118019,"Gerlingen, Stadt",55 - 60 Jahre,1590,756,834
False,8118019,"Gerlingen, Stadt",60 - 65 Jahre,1143,595,548
False,8118019,"Gerlingen, Stadt",65 - 75 Jahre,1768,776,992
False,8118019,"Gerlingen, Stadt",75 und mehr Jahre,1190,375,815
False,8118019,"Gerlingen, Stadt",Insgesamt,17943,8809,9134
False,8118021,"Großbottwar, Stadt",unter 3 Jahre,326,163,163
False,8118021,"Großbottwar, Stadt",3 -  6 Jahre,334,166,168
False,8118021,"Großbottwar, Stadt",6 - 10 Jahre,409,207,202
False,8118021,"Großbottwar, Stadt",10 - 15 Jahre,430,235,195
False,8118021,"Großbottwar, Stadt",15 - 18 Jahre,265,133,132
False,8118021,"Großbottwar, Stadt",18 - 20 Jahre,169,94,75
False,8118021,"Großbottwar, Stadt",20 - 25 Jahre,415,219,196
False,8118021,"Großbottwar, Stadt",25 - 30 Jahre,670,336,334
False,8118021,"Großbottwar, Stadt",30 - 35 Jahre,719,384,335
False,8118021,"Großbottwar, Stadt",35 - 40 Jahre,582,310,272
False,8118021,"Großbottwar, Stadt",40 - 45 Jahre,549,269,280
False,8118021,"Großbottwar, Stadt",45 - 50 Jahre,493,245,248
False,8118021,"Großbottwar, Stadt",50 - 55 Jahre,480,255,225
False,8118021,"Großbottwar, Stadt",55 - 60 Jahre,562,292,270
False,8118021,"Großbottwar, Stadt",60 - 65 Jahre,401,207,194
False,8118021,"Großbottwar, Stadt",65 - 75 Jahre,577,255,322
False,8118021,"Großbottwar, Stadt",75 und mehr Jahre,366,113,253
False,8118021,"Großbottwar, Stadt",Insgesamt,7747,3883,3864
False,8118027,Hemmingen,unter 3 Jahre,251,112,139
False,8118027,Hemmingen,3 -  6 Jahre,299,179,120
False,8118027,Hemmingen,6 - 10 Jahre,306,163,143
False,8118027,Hemmingen,10 - 15 Jahre,411,209,202
False,8118027,Hemmingen,15 - 18 Jahre,237,116,121
False,8118027,Hemmingen,18 - 20 Jahre,142,76,66
False,8118027,Hemmingen,20 - 25 Jahre,422,214,208
False,8118027,Hemmingen,25 - 30 Jahre,593,284,309
False,8118027,Hemmingen,30 - 35 Jahre,654,344,310
False,8118027,Hemmingen,35 - 40 Jahre,584,316,268
False,8118027,Hemmingen,40 - 45 Jahre,580,276,304
False,8118027,Hemmingen,45 - 50 Jahre,511,261,250
False,8118027,Hemmingen,50 - 55 Jahre,575,291,284
False,8118027,Hemmingen,55 - 60 Jahre,579,303,276
False,8118027,Hemmingen,60 - 65 Jahre,383,210,173
False,8118027,Hemmingen,65 - 75 Jahre,496,225,271
False,8118027,Hemmingen,75 und mehr Jahre,301,86,215
False,8118027,Hemmingen,Insgesamt,7324,3665,3659
False,8118028,Hessigheim,unter 3 Jahre,86,38,48
False,8118028,Hessigheim,3 -  6 Jahre,103,56,47
False,8118028,Hessigheim,6 - 10 Jahre,156,82,74
False,8118028,Hessigheim,10 - 15 Jahre,129,70,59
False,8118028,Hessigheim,15 - 18 Jahre,69,39,30
False,8118028,Hessigheim,18 - 20 Jahre,47,23,24
False,8118028,Hessigheim,20 - 25 Jahre,104,62,42
False,8118028,Hessigheim,25 - 30 Jahre,168,83,85
False,8118028,Hessigheim,30 - 35 Jahre,220,112,108
False,8118028,Hessigheim,35 - 40 Jahre,159,83,76
False,8118028,Hessigheim,40 - 45 Jahre,150,75,75
False,8118028,Hessigheim,45 - 50 Jahre,114,59,55
False,8118028,Hessigheim,50 - 55 Jahre,100,46,54
False,8118028,Hessigheim,55 - 60 Jahre,136,68,68
False,8118028,Hessigheim,60 - 65 Jahre,111,55,56
False,8118028,Hessigheim,65 - 75 Jahre,168,67,101
False,8118028,Hessigheim,75 und mehr Jahre,87,29,58
False,8118028,Hessigheim,Insgesamt,2107,1047,1060
False,8118040,Kirchheim am Neckar,unter 3 Jahre,225,117,108
False,8118040,Kirchheim am Neckar,3 -  6 Jahre,213,103,110
False,8118040,Kirchheim am Neckar,6 - 10 Jahre,261,136,125
False,8118040,Kirchheim am Neckar,10 - 15 Jahre,257,121,136
False,8118040,Kirchheim am Neckar,15 - 18 Jahre,134,67,67
False,8118040,Kirchheim am Neckar,18 - 20 Jahre,102,54,48
False,8118040,Kirchheim am Neckar,20 - 25 Jahre,330,146,184
False,8118040,Kirchheim am Neckar,25 - 30 Jahre,436,214,222
False,8118040,Kirchheim am Neckar,30 - 35 Jahre,439,230,209
False,8118040,Kirchheim am Neckar,35 - 40 Jahre,389,200,189
False,8118040,Kirchheim am Neckar,40 - 45 Jahre,331,177,154
False,8118040,Kirchheim am Neckar,45 - 50 Jahre,280,154,126
False,8118040,Kirchheim am Neckar,50 - 55 Jahre,256,124,132
False,8118040,Kirchheim am Neckar,55 - 60 Jahre,299,143,156
False,8118040,Kirchheim am Neckar,60 - 65 Jahre,275,142,133
False,8118040,Kirchheim am Neckar,65 - 75 Jahre,359,156,203
False,8118040,Kirchheim am Neckar,75 und mehr Jahre,234,68,166
False,8118040,Kirchheim am Neckar,Insgesamt,4820,2352,2468
False,8118046,"Kornwestheim, Stadt",unter 3 Jahre,972,520,452
False,8118046,"Kornwestheim, Stadt",3 -  6 Jahre,998,558,440
False,8118046,"Kornwestheim, Stadt",6 - 10 Jahre,1198,628,570
False,8118046,"Kornwestheim, Stadt",10 - 15 Jahre,1460,761,699
False,8118046,"Kornwestheim, Stadt",15 - 18 Jahre,831,465,366
False,8118046,"Kornwestheim, Stadt",18 - 20 Jahre,601,309,292
False,8118046,"Kornwestheim, Stadt",20 - 25 Jahre,1881,956,925
False,8118046,"Kornwestheim, Stadt",25 - 30 Jahre,2515,1320,1195
False,8118046,"Kornwestheim, Stadt",30 - 35 Jahre,2677,1435,1242
False,8118046,"Kornwestheim, Stadt",35 - 40 Jahre,2416,1258,1158
False,8118046,"Kornwestheim, Stadt",40 - 45 Jahre,1812,930,882
False,8118046,"Kornwestheim, Stadt",45 - 50 Jahre,1842,906,936
False,8118046,"Kornwestheim, Stadt",50 - 55 Jahre,1975,996,979
False,8118046,"Kornwestheim, Stadt",55 - 60 Jahre,2281,1171,1110
False,8118046,"Kornwestheim, Stadt",60 - 65 Jahre,1795,907,888
False,8118046,"Kornwestheim, Stadt",65 - 75 Jahre,2681,1133,1548
False,8118046,"Kornwestheim, Stadt",75 und mehr Jahre,1883,575,1308
False,8118046,"Kornwestheim, Stadt",Insgesamt,29818,14828,14990
False,8118047,Löchgau,unter 3 Jahre,173,93,80
False,8118047,Löchgau,3 -  6 Jahre,216,101,115
False,8118047,Löchgau,6 - 10 Jahre,243,137,106
False,8118047,Löchgau,10 - 15 Jahre,295,146,149
False,8118047,Löchgau,15 - 18 Jahre,153,77,76
False,8118047,Löchgau,18 - 20 Jahre,70,37,33
False,8118047,Löchgau,20 - 25 Jahre,258,121,137
False,8118047,Löchgau,25 - 30 Jahre,340,185,155
False,8118047,Löchgau,30 - 35 Jahre,421,220,201
False,8118047,Löchgau,35 - 40 Jahre,462,218,244
False,8118047,Löchgau,40 - 45 Jahre,354,199,155
False,8118047,Löchgau,45 - 50 Jahre,307,150,157
False,8118047,Löchgau,50 - 55 Jahre,328,166,162
False,8118047,Löchgau,55 - 60 Jahre,356,186,170
False,8118047,Löchgau,60 - 65 Jahre,289,145,144
False,8118047,Löchgau,65 - 75 Jahre,393,167,226
False,8118047,Löchgau,75 und mehr Jahre,222,77,145
False,8118047,Löchgau,Insgesamt,4880,2425,2455
False,8118048,"Ludwigsburg, Stadt",unter 3 Jahre,2692,1375,1317
False,8118048,"Ludwigsburg, Stadt",3 -  6 Jahre,2837,1393,1444
False,8118048,"Ludwigsburg, Stadt",6 - 10 Jahre,3502,1832,1670
False,8118048,"Ludwigsburg, Stadt",10 - 15 Jahre,4112,2040,2072
False,8118048,"Ludwigsburg, Stadt",15 - 18 Jahre,2557,1316,1241
False,8118048,"Ludwigsburg, Stadt",18 - 20 Jahre,1836,976,860
False,8118048,"Ludwigsburg, Stadt",20 - 25 Jahre,5686,2908,2778
False,8118048,"Ludwigsburg, Stadt",25 - 30 Jahre,8084,4234,3850
False,8118048,"Ludwigsburg, Stadt",30 - 35 Jahre,7913,4207,3706
False,8118048,"Ludwigsburg, Stadt",35 - 40 Jahre,6636,3464,3172
False,8118048,"Ludwigsburg, Stadt",40 - 45 Jahre,5570,2748,2822
False,8118048,"Ludwigsburg, Stadt",45 - 50 Jahre,5383,2691,2692
False,8118048,"Ludwigsburg, Stadt",50 - 55 Jahre,5533,2784,2749
False,8118048,"Ludwigsburg, Stadt",55 - 60 Jahre,6377,3225,3152
False,8118048,"Ludwigsburg, Stadt",60 - 65 Jahre,4704,2295,2409
False,8118048,"Ludwigsburg, Stadt",65 - 75 Jahre,7433,2986,4447
False,8118048,"Ludwigsburg, Stadt",75 und mehr Jahre,5955,1810,4145
False,8118048,"Ludwigsburg, Stadt",Insgesamt,86810,42284,44526
False,8118049,"Marbach am Neckar, Stadt",unter 3 Jahre,504,257,247
False,8118049,"Marbach am Neckar, Stadt",3 -  6 Jahre,523,265,258
False,8118049,"Marbach am Neckar, Stadt",6 - 10 Jahre,616,334,282
False,8118049,"Marbach am Neckar, Stadt",10 - 15 Jahre,685,343,342
False,8118049,"Marbach am Neckar, Stadt",15 - 18 Jahre,435,236,199
False,8118049,"Marbach am Neckar, Stadt",18 - 20 Jahre,296,164,132
False,8118049,"Marbach am Neckar, Stadt",20 - 25 Jahre,738,377,361
False,8118049,"Marbach am Neckar, Stadt",25 - 30 Jahre,1064,529,535
False,8118049,"Marbach am Neckar, Stadt",30 - 35 Jahre,1233,662,571
False,8118049,"Marbach am Neckar, Stadt",35 - 40 Jahre,1058,549,509
False,8118049,"Marbach am Neckar, Stadt",40 - 45 Jahre,890,430,460
False,8118049,"Marbach am Neckar, Stadt",45 - 50 Jahre,770,396,374
False,8118049,"Marbach am Neckar, Stadt",50 - 55 Jahre,888,439,449
False,8118049,"Marbach am Neckar, Stadt",55 - 60 Jahre,1007,489,518
False,8118049,"Marbach am Neckar, Stadt",60 - 65 Jahre,745,356,389
False,8118049,"Marbach am Neckar, Stadt",65 - 75 Jahre,1130,479,651
False,8118049,"Marbach am Neckar, Stadt",75 und mehr Jahre,935,270,665
False,8118049,"Marbach am Neckar, Stadt",Insgesamt,13517,6575,6942
False,8118050,"Markgröningen, Stadt",unter 3 Jahre,513,283,230
False,8118050,"Markgröningen, Stadt",3 -  6 Jahre,541,279,262
False,8118050,"Markgröningen, Stadt",6 - 10 Jahre,743,384,359
False,8118050,"Markgröningen, Stadt",10 - 15 Jahre,753,392,361
False,8118050,"Markgröningen, Stadt",15 - 18 Jahre,419,222,197
False,8118050,"Markgröningen, Stadt",18 - 20 Jahre,286,155,131
False,8118050,"Markgröningen, Stadt",20 - 25 Jahre,874,436,438
False,8118050,"Markgröningen, Stadt",25 - 30 Jahre,1197,621,576
False,8118050,"Markgröningen, Stadt",30 - 35 Jahre,1380,713,667
False,8118050,"Markgröningen, Stadt",35 - 40 Jahre,1196,613,583
False,8118050,"Markgröningen, Stadt",40 - 45 Jahre,990,509,481
False,8118050,"Markgröningen, Stadt",45 - 50 Jahre,886,450,436
False,8118050,"Markgröningen, Stadt",50 - 55 Jahre,902,479,423
False,8118050,"Markgröningen, Stadt",55 - 60 Jahre,969,495,474
False,8118050,"Markgröningen, Stadt",60 - 65 Jahre,671,338,333
False,8118050,"Markgröningen, Stadt",65 - 75 Jahre,1029,453,576
False,8118050,"Markgröningen, Stadt",75 und mehr Jahre,580,186,394
False,8118050,"Markgröningen, Stadt",Insgesamt,13929,7008,6921
False,8118051,Möglingen,unter 3 Jahre,385,205,180
False,8118051,Möglingen,3 -  6 Jahre,389,205,184
False,8118051,Möglingen,6 - 10 Jahre,509,267,242
False,8118051,Möglingen,10 - 15 Jahre,497,231,266
False,8118051,Möglingen,15 - 18 Jahre,301,165,136
False,8118051,Möglingen,18 - 20 Jahre,171,99,72
False,8118051,Möglingen,20 - 25 Jahre,598,298,300
False,8118051,Möglingen,25 - 30 Jahre,926,469,457
False,8118051,Möglingen,30 - 35 Jahre,1059,569,490
False,8118051,Möglingen,35 - 40 Jahre,837,411,426
False,8118051,Möglingen,40 - 45 Jahre,648,342,306
False,8118051,Möglingen,45 - 50 Jahre,681,318,363
False,8118051,Möglingen,50 - 55 Jahre,788,398,390
False,8118051,Möglingen,55 - 60 Jahre,892,450,442
False,8118051,Möglingen,60 - 65 Jahre,602,319,283
False,8118051,Möglingen,65 - 75 Jahre,757,333,424
False,8118051,Möglingen,75 und mehr Jahre,474,155,319
False,8118051,Möglingen,Insgesamt,10514,5234,5280
False,8118053,Mundelsheim,unter 3 Jahre,128,72,56
False,8118053,Mundelsheim,3 -  6 Jahre,139,70,69
False,8118053,Mundelsheim,6 - 10 Jahre,170,73,97
False,8118053,Mundelsheim,10 - 15 Jahre,193,106,87
False,8118053,Mundelsheim,15 - 18 Jahre,105,55,50
False,8118053,Mundelsheim,18 - 20 Jahre,66,35,31
False,8118053,Mundelsheim,20 - 25 Jahre,180,89,91
False,8118053,Mundelsheim,25 - 30 Jahre,229,120,109
False,8118053,Mundelsheim,30 - 35 Jahre,266,137,129
False,8118053,Mundelsheim,35 - 40 Jahre,266,142,124
False,8118053,Mundelsheim,40 - 45 Jahre,209,105,104
False,8118053,Mundelsheim,45 - 50 Jahre,190,90,100
False,8118053,Mundelsheim,50 - 55 Jahre,185,100,85
False,8118053,Mundelsheim,55 - 60 Jahre,238,118,120
False,8118053,Mundelsheim,60 - 65 Jahre,172,93,79
False,8118053,Mundelsheim,65 - 75 Jahre,218,89,129
False,8118053,Mundelsheim,75 und mehr Jahre,131,38,93
False,8118053,Mundelsheim,Insgesamt,3085,1532,1553
False,8118054,Murr,unter 3 Jahre,208,100,108
False,8118054,Murr,3 -  6 Jahre,184,96,88
False,8118054,Murr,6 - 10 Jahre,244,133,111
False,8118054,Murr,10 - 15 Jahre,254,117,137
False,8118054,Murr,15 - 18 Jahre,160,70,90
False,8118054,Murr,18 - 20 Jahre,121,64,57
False,8118054,Murr,20 - 25 Jahre,333,177,156
False,8118054,Murr,25 - 30 Jahre,516,267,249
False,8118054,Murr,30 - 35 Jahre,530,272,258
False,8118054,Murr,35 - 40 Jahre,398,194,204
False,8118054,Murr,40 - 45 Jahre,402,210,192
False,8118054,Murr,45 - 50 Jahre,362,167,195
False,8118054,Murr,50 - 55 Jahre,370,191,179
False,8118054,Murr,55 - 60 Jahre,391,200,191
False,8118054,Murr,60 - 65 Jahre,252,135,117
False,8118054,Murr,65 - 75 Jahre,392,177,215
False,8118054,Murr,75 und mehr Jahre,179,52,127
False,8118054,Murr,Insgesamt,5296,2622,2674
False,8118059,"Oberriexingen, Stadt",unter 3 Jahre,125,59,66
False,8118059,"Oberriexingen, Stadt",3 -  6 Jahre,123,72,51
False,8118059,"Oberriexingen, Stadt",6 - 10 Jahre,130,66,64
False,8118059,"Oberriexingen, Stadt",10 - 15 Jahre,170,88,82
False,8118059,"Oberriexingen, Stadt",15 - 18 Jahre,83,44,39
False,8118059,"Oberriexingen, Stadt",18 - 20 Jahre,58,35,23
False,8118059,"Oberriexingen, Stadt",20 - 25 Jahre,141,80,61
False,8118059,"Oberriexingen, Stadt",25 - 30 Jahre,254,127,127
False,8118059,"Oberriexingen, Stadt",30 - 35 Jahre,273,148,125
False,8118059,"Oberriexingen, Stadt",35 - 40 Jahre,240,120,120
False,8118059,"Oberriexingen, Stadt",40 - 45 Jahre,193,100,93
False,8118059,"Oberriexingen, Stadt",45 - 50 Jahre,169,85,84
False,8118059,"Oberriexingen, Stadt",50 - 55 Jahre,200,98,102
False,8118059,"Oberriexingen, Stadt",55 - 60 Jahre,175,95,80
False,8118059,"Oberriexingen, Stadt",60 - 65 Jahre,127,67,60
False,8118059,"Oberriexingen, Stadt",65 - 75 Jahre,201,82,119
False,8118059,"Oberriexingen, Stadt",75 und mehr Jahre,95,27,68
False,8118059,"Oberriexingen, Stadt",Insgesamt,2757,1393,1364
False,8118060,Oberstenfeld,unter 3 Jahre,289,164,125
False,8118060,Oberstenfeld,3 -  6 Jahre,314,176,138
False,8118060,Oberstenfeld,6 - 10 Jahre,447,238,209
False,8118060,Oberstenfeld,10 - 15 Jahre,497,273,224
False,8118060,Oberstenfeld,15 - 18 Jahre,304,153,151
False,8118060,Oberstenfeld,18 - 20 Jahre,195,100,95
False,8118060,Oberstenfeld,20 - 25 Jahre,494,257,237
False,8118060,Oberstenfeld,25 - 30 Jahre,645,325,320
False,8118060,Oberstenfeld,30 - 35 Jahre,667,343,324
False,8118060,Oberstenfeld,35 - 40 Jahre,628,329,299
False,8118060,Oberstenfeld,40 - 45 Jahre,480,238,242
False,8118060,Oberstenfeld,45 - 50 Jahre,553,256,297
False,8118060,Oberstenfeld,50 - 55 Jahre,590,301,289
False,8118060,Oberstenfeld,55 - 60 Jahre,618,334,284
False,8118060,Oberstenfeld,60 - 65 Jahre,382,198,184
False,8118060,Oberstenfeld,65 - 75 Jahre,557,241,316
False,8118060,Oberstenfeld,75 und mehr Jahre,384,104,280
False,8118060,Oberstenfeld,Insgesamt,8044,4030,4014
False,8118063,Pleidelsheim,unter 3 Jahre,254,132,122
False,8118063,Pleidelsheim,3 -  6 Jahre,231,119,112
False,8118063,Pleidelsheim,6 - 10 Jahre,277,127,150
False,8118063,Pleidelsheim,10 - 15 Jahre,264,129,135
False,8118063,Pleidelsheim,15 - 18 Jahre,173,81,92
False,8118063,Pleidelsheim,18 - 20 Jahre,127,62,65
False,8118063,Pleidelsheim,20 - 25 Jahre,369,177,192
False,8118063,Pleidelsheim,25 - 30 Jahre,566,271,295
False,8118063,Pleidelsheim,30 - 35 Jahre,621,331,290
False,8118063,Pleidelsheim,35 - 40 Jahre,460,245,215
False,8118063,Pleidelsheim,40 - 45 Jahre,412,182,230
False,8118063,Pleidelsheim,45 - 50 Jahre,337,183,154
False,8118063,Pleidelsheim,50 - 55 Jahre,346,166,180
False,8118063,Pleidelsheim,55 - 60 Jahre,362,181,181
False,8118063,Pleidelsheim,60 - 65 Jahre,246,130,116
False,8118063,Pleidelsheim,65 - 75 Jahre,329,145,184
False,8118063,Pleidelsheim,75 und mehr Jahre,282,75,207
False,8118063,Pleidelsheim,Insgesamt,5656,2736,2920
False,8118067,Schwieberdingen,unter 3 Jahre,316,160,156
False,8118067,Schwieberdingen,3 -  6 Jahre,322,165,157
False,8118067,Schwieberdingen,6 - 10 Jahre,372,180,192
False,8118067,Schwieberdingen,10 - 15 Jahre,464,218,246
False,8118067,Schwieberdingen,15 - 18 Jahre,297,133,164
False,8118067,Schwieberdingen,18 - 20 Jahre,209,103,106
False,8118067,Schwieberdingen,20 - 25 Jahre,577,331,246
False,8118067,Schwieberdingen,25 - 30 Jahre,804,430,374
False,8118067,Schwieberdingen,30 - 35 Jahre,804,440,364
False,8118067,Schwieberdingen,35 - 40 Jahre,739,390,349
False,8118067,Schwieberdingen,40 - 45 Jahre,681,326,355
False,8118067,Schwieberdingen,45 - 50 Jahre,677,349,328
False,8118067,Schwieberdingen,50 - 55 Jahre,792,414,378
False,8118067,Schwieberdingen,55 - 60 Jahre,765,389,376
False,8118067,Schwieberdingen,60 - 65 Jahre,520,264,256
False,8118067,Schwieberdingen,65 - 75 Jahre,691,335,356
False,8118067,Schwieberdingen,75 und mehr Jahre,428,145,283
False,8118067,Schwieberdingen,Insgesamt,9458,4772,4686
False,8118068,Sersheim,unter 3 Jahre,195,91,104
False,8118068,Sersheim,3 -  6 Jahre,209,105,104
False,8118068,Sersheim,6 - 10 Jahre,254,138,116
False,8118068,Sersheim,10 - 15 Jahre,294,157,137
False,8118068,Sersheim,15 - 18 Jahre,148,79,69
False,8118068,Sersheim,18 - 20 Jahre,116,52,64
False,8118068,Sersheim,20 - 25 Jahre,294,149,145
False,8118068,Sersheim,25 - 30 Jahre,478,235,243
False,8118068,Sersheim,30 - 35 Jahre,458,241,217
False,8118068,Sersheim,35 - 40 Jahre,387,206,181
False,8118068,Sersheim,40 - 45 Jahre,339,174,165
False,8118068,Sersheim,45 - 50 Jahre,311,154,157
False,8118068,Sersheim,50 - 55 Jahre,272,140,132
False,8118068,Sersheim,55 - 60 Jahre,341,171,170
False,8118068,Sersheim,60 - 65 Jahre,222,119,103
False,8118068,Sersheim,65 - 75 Jahre,347,150,197
False,8118068,Sersheim,75 und mehr Jahre,202,65,137
False,8118068,Sersheim,Insgesamt,4867,2426,2441
False,8118070,"Steinheim an der Murr, Stadt",unter 3 Jahre,407,226,181
False,8118070,"Steinheim an der Murr, Stadt",3 -  6 Jahre,457,227,230
False,8118070,"Steinheim an der Murr, Stadt",6 - 10 Jahre,650,341,309
False,8118070,"Steinheim an der Murr, Stadt",10 - 15 Jahre,689,363,326
False,8118070,"Steinheim an der Murr, Stadt",15 - 18 Jahre,343,171,172
False,8118070,"Steinheim an der Murr, Stadt",18 - 20 Jahre,241,125,116
False,8118070,"Steinheim an der Murr, Stadt",20 - 25 Jahre,556,290,266
False,8118070,"Steinheim an der Murr, Stadt",25 - 30 Jahre,831,444,387
False,8118070,"Steinheim an der Murr, Stadt",30 - 35 Jahre,996,509,487
False,8118070,"Steinheim an der Murr, Stadt",35 - 40 Jahre,1012,504,508
False,8118070,"Steinheim an der Murr, Stadt",40 - 45 Jahre,863,440,423
False,8118070,"Steinheim an der Murr, Stadt",45 - 50 Jahre,663,363,300
False,8118070,"Steinheim an der Murr, Stadt",50 - 55 Jahre,667,340,327
False,8118070,"Steinheim an der Murr, Stadt",55 - 60 Jahre,779,399,380
False,8118070,"Steinheim an der Murr, Stadt",60 - 65 Jahre,527,268,259
False,8118070,"Steinheim an der Murr, Stadt",65 - 75 Jahre,757,317,440
False,8118070,"Steinheim an der Murr, Stadt",75 und mehr Jahre,485,153,332
False,8118070,"Steinheim an der Murr, Stadt",Insgesamt,10923,5480,5443
False,8118071,Tamm,unter 3 Jahre,366,184,182
False,8118071,Tamm,3 -  6 Jahre,396,204,192
False,8118071,Tamm,6 - 10 Jahre,543,271,272
False,8118071,Tamm,10 - 15 Jahre,653,337,316
False,8118071,Tamm,15 - 18 Jahre,379,185,194
False,8118071,Tamm,18 - 20 Jahre,253,139,114
False,8118071,Tamm,20 - 25 Jahre,733,388,345
False,8118071,Tamm,25 - 30 Jahre,869,463,406
False,8118071,Tamm,30 - 35 Jahre,987,501,486
False,8118071,Tamm,35 - 40 Jahre,1062,523,539
False,8118071,Tamm,40 - 45 Jahre,1015,485,530
False,8118071,Tamm,45 - 50 Jahre,966,496,470
False,8118071,Tamm,50 - 55 Jahre,911,491,420
False,8118071,Tamm,55 - 60 Jahre,856,423,433
False,8118071,Tamm,60 - 65 Jahre,510,268,242
False,8118071,Tamm,65 - 75 Jahre,721,326,395
False,8118071,Tamm,75 und mehr Jahre,495,157,338
False,8118071,Tamm,Insgesamt,11715,5841,5874
False,8118073,"Vaihingen an der Enz, Stadt",unter 3 Jahre,923,447,476
False,8118073,"Vaihingen an der Enz, Stadt",3 -  6 Jahre,1025,526,499
False,8118073,"Vaihingen an der Enz, Stadt",6 - 10 Jahre,1244,655,589
False,8118073,"Vaihingen an der Enz, Stadt",10 - 15 Jahre,1515,802,713
False,8118073,"Vaihingen an der Enz, Stadt",15 - 18 Jahre,1048,553,495
False,8118073,"Vaihingen an der Enz, Stadt",18 - 20 Jahre,652,366,286
False,8118073,"Vaihingen an der Enz, Stadt",20 - 25 Jahre,1616,843,773
False,8118073,"Vaihingen an der Enz, Stadt",25 - 30 Jahre,2109,1126,983
False,8118073,"Vaihingen an der Enz, Stadt",30 - 35 Jahre,2276,1201,1075
False,8118073,"Vaihingen an der Enz, Stadt",35 - 40 Jahre,2122,1120,1002
False,8118073,"Vaihingen an der Enz, Stadt",40 - 45 Jahre,1770,906,864
False,8118073,"Vaihingen an der Enz, Stadt",45 - 50 Jahre,1655,849,806
False,8118073,"Vaihingen an der Enz, Stadt",50 - 55 Jahre,1727,885,842
False,8118073,"Vaihingen an der Enz, Stadt",55 - 60 Jahre,1877,976,901
False,8118073,"Vaihingen an der Enz, Stadt",60 - 65 Jahre,1454,763,691
False,8118073,"Vaihingen an der Enz, Stadt",65 - 75 Jahre,2007,840,1167
False,8118073,"Vaihingen an der Enz, Stadt",75 und mehr Jahre,1350,400,950
False,8118073,"Vaihingen an der Enz, Stadt",Insgesamt,26370,13258,13112
False,8118074,Walheim,unter 3 Jahre,105,58,47
False,8118074,Walheim,3 -  6 Jahre,114,47,67
False,8118074,Walheim,6 - 10 Jahre,132,68,64
False,8118074,Walheim,10 - 15 Jahre,158,88,70
False,8118074,Walheim,15 - 18 Jahre,83,42,41
False,8118074,Walheim,18 - 20 Jahre,53,24,29
False,8118074,Walheim,20 - 25 Jahre,160,83,77
False,8118074,Walheim,25 - 30 Jahre,226,122,104
False,8118074,Walheim,30 - 35 Jahre,251,135,116
False,8118074,Walheim,35 - 40 Jahre,191,97,94
False,8118074,Walheim,40 - 45 Jahre,188,90,98
False,8118074,Walheim,45 - 50 Jahre,172,95,77
False,8118074,Walheim,50 - 55 Jahre,195,96,99
False,8118074,Walheim,55 - 60 Jahre,209,101,108
False,8118074,Walheim,60 - 65 Jahre,161,83,78
False,8118074,Walheim,65 - 75 Jahre,264,118,146
False,8118074,Walheim,75 und mehr Jahre,159,53,106
False,8118074,Walheim,Insgesamt,2821,1400,1421
False,8118076,"Sachsenheim, Stadt",unter 3 Jahre,606,312,294
False,8118076,"Sachsenheim, Stadt",3 -  6 Jahre,676,353,323
False,8118076,"Sachsenheim, Stadt",6 - 10 Jahre,863,439,424
False,8118076,"Sachsenheim, Stadt",10 - 15 Jahre,926,488,438
False,8118076,"Sachsenheim, Stadt",15 - 18 Jahre,570,265,305
False,8118076,"Sachsenheim, Stadt",18 - 20 Jahre,399,190,209
False,8118076,"Sachsenheim, Stadt",20 - 25 Jahre,1063,546,517
False,8118076,"Sachsenheim, Stadt",25 - 30 Jahre,1410,735,675
False,8118076,"Sachsenheim, Stadt",30 - 35 Jahre,1523,816,707
False,8118076,"Sachsenheim, Stadt",35 - 40 Jahre,1392,732,660
False,8118076,"Sachsenheim, Stadt",40 - 45 Jahre,1198,625,573
False,8118076,"Sachsenheim, Stadt",45 - 50 Jahre,1019,535,484
False,8118076,"Sachsenheim, Stadt",50 - 55 Jahre,1055,525,530
False,8118076,"Sachsenheim, Stadt",55 - 60 Jahre,1174,625,549
False,8118076,"Sachsenheim, Stadt",60 - 65 Jahre,875,434,441
False,8118076,"Sachsenheim, Stadt",65 - 75 Jahre,1375,577,798
False,8118076,"Sachsenheim, Stadt",75 und mehr Jahre,842,267,575
False,8118076,"Sachsenheim, Stadt",Insgesamt,16966,8464,8502
False,8118077,Ingersheim,unter 3 Jahre,175,90,85
False,8118077,Ingersheim,3 -  6 Jahre,194,107,87
False,8118077,Ingersheim,6 - 10 Jahre,260,119,141
False,8118077,Ingersheim,10 - 15 Jahre,292,142,150
False,8118077,Ingersheim,15 - 18 Jahre,192,103,89
False,8118077,Ingersheim,18 - 20 Jahre,125,68,57
False,8118077,Ingersheim,20 - 25 Jahre,340,187,153
False,8118077,Ingersheim,25 - 30 Jahre,482,247,235
False,8118077,Ingersheim,30 - 35 Jahre,443,230,213
False,8118077,Ingersheim,35 - 40 Jahre,406,204,202
False,8118077,Ingersheim,40 - 45 Jahre,389,189,200
False,8118077,Ingersheim,45 - 50 Jahre,362,173,189
False,8118077,Ingersheim,50 - 55 Jahre,402,212,190
False,8118077,Ingersheim,55 - 60 Jahre,334,173,161
False,8118077,Ingersheim,60 - 65 Jahre,291,143,148
False,8118077,Ingersheim,65 - 75 Jahre,433,196,237
False,8118077,Ingersheim,75 und mehr Jahre,258,69,189
False,8118077,Ingersheim,Insgesamt,5378,2652,2726
False,8118078,"Freiberg am Neckar, Stadt",unter 3 Jahre,498,248,250
False,8118078,"Freiberg am Neckar, Stadt",3 -  6 Jahre,518,253,265
False,8118078,"Freiberg am Neckar, Stadt",6 - 10 Jahre,637,338,299
False,8118078,"Freiberg am Neckar, Stadt",10 - 15 Jahre,749,380,369
False,8118078,"Freiberg am Neckar, Stadt",15 - 18 Jahre,407,203,204
False,8118078,"Freiberg am Neckar, Stadt",18 - 20 Jahre,273,145,128
False,8118078,"Freiberg am Neckar, Stadt",20 - 25 Jahre,823,398,425
False,8118078,"Freiberg am Neckar, Stadt",25 - 30 Jahre,1332,682,650
False,8118078,"Freiberg am Neckar, Stadt",30 - 35 Jahre,1443,730,713
False,8118078,"Freiberg am Neckar, Stadt",35 - 40 Jahre,1225,640,585
False,8118078,"Freiberg am Neckar, Stadt",40 - 45 Jahre,1038,522,516
False,8118078,"Freiberg am Neckar, Stadt",45 - 50 Jahre,1001,504,497
False,8118078,"Freiberg am Neckar, Stadt",50 - 55 Jahre,1017,525,492
False,8118078,"Freiberg am Neckar, Stadt",55 - 60 Jahre,1175,605,570
False,8118078,"Freiberg am Neckar, Stadt",60 - 65 Jahre,825,398,427
False,8118078,"Freiberg am Neckar, Stadt",65 - 75 Jahre,1186,540,646
False,8118078,"Freiberg am Neckar, Stadt",75 und mehr Jahre,653,212,441
False,8118078,"Freiberg am Neckar, Stadt",Insgesamt,14800,7323,7477
False,8118079,"Bietigheim-Bissingen, Stadt",unter 3 Jahre,1269,659,610
False,8118079,"Bietigheim-Bissingen, Stadt",3 -  6 Jahre,1359,673,686
False,8118079,"Bietigheim-Bissingen, Stadt",6 - 10 Jahre,1752,888,864
False,8118079,"Bietigheim-Bissingen, Stadt",10 - 15 Jahre,2181,1121,1060
False,8118079,"Bietigheim-Bissingen, Stadt",15 - 18 Jahre,1367,716,651
False,8118079,"Bietigheim-Bissingen, Stadt",18 - 20 Jahre,870,405,465
False,8118079,"Bietigheim-Bissingen, Stadt",20 - 25 Jahre,2301,1125,1176
False,8118079,"Bietigheim-Bissingen, Stadt",25 - 30 Jahre,3167,1611,1556
False,8118079,"Bietigheim-Bissingen, Stadt",30 - 35 Jahre,3280,1705,1575
False,8118079,"Bietigheim-Bissingen, Stadt",35 - 40 Jahre,3129,1540,1589
False,8118079,"Bietigheim-Bissingen, Stadt",40 - 45 Jahre,2791,1371,1420
False,8118079,"Bietigheim-Bissingen, Stadt",45 - 50 Jahre,2461,1240,1221
False,8118079,"Bietigheim-Bissingen, Stadt",50 - 55 Jahre,2756,1338,1418
False,8118079,"Bietigheim-Bissingen, Stadt",55 - 60 Jahre,3255,1630,1625
False,8118079,"Bietigheim-Bissingen, Stadt",60 - 65 Jahre,2426,1239,1187
False,8118079,"Bietigheim-Bissingen, Stadt",65 - 75 Jahre,3490,1506,1984
False,8118079,"Bietigheim-Bissingen, Stadt",75 und mehr Jahre,2261,687,1574
False,8118079,"Bietigheim-Bissingen, Stadt",Insgesamt,40115,19454,20661
False,8118080,"Korntal-Münchingen, Stadt",unter 3 Jahre,554,287,267
False,8118080,"Korntal-Münchingen, Stadt",3 -  6 Jahre,610,323,287
False,8118080,"Korntal-Münchingen, Stadt",6 - 10 Jahre,729,368,361
False,8118080,"Korntal-Münchingen, Stadt",10 - 15 Jahre,853,428,425
False,8118080,"Korntal-Münchingen, Stadt",15 - 18 Jahre,509,256,253
False,8118080,"Korntal-Münchingen, Stadt",18 - 20 Jahre,375,202,173
False,8118080,"Korntal-Münchingen, Stadt",20 - 25 Jahre,988,503,485
False,8118080,"Korntal-Münchingen, Stadt",25 - 30 Jahre,1460,745,715
False,8118080,"Korntal-Münchingen, Stadt",30 - 35 Jahre,1575,874,701
False,8118080,"Korntal-Münchingen, Stadt",35 - 40 Jahre,1289,672,617
False,8118080,"Korntal-Münchingen, Stadt",40 - 45 Jahre,1132,552,580
False,8118080,"Korntal-Münchingen, Stadt",45 - 50 Jahre,1106,522,584
False,8118080,"Korntal-Münchingen, Stadt",50 - 55 Jahre,1243,636,607
False,8118080,"Korntal-Münchingen, Stadt",55 - 60 Jahre,1382,691,691
False,8118080,"Korntal-Münchingen, Stadt",60 - 65 Jahre,934,454,480
False,8118080,"Korntal-Münchingen, Stadt",65 - 75 Jahre,1381,581,800
False,8118080,"Korntal-Münchingen, Stadt",75 und mehr Jahre,1122,326,796
False,8118080,"Korntal-Münchingen, Stadt",Insgesamt,17242,8420,8822
False,8118081,"Remseck am Neckar, Stadt",unter 3 Jahre,649,322,327
False,8118081,"Remseck am Neckar, Stadt",3 -  6 Jahre,701,344,357
False,8118081,"Remseck am Neckar, Stadt",6 - 10 Jahre,841,412,429
False,8118081,"Remseck am Neckar, Stadt",10 - 15 Jahre,946,482,464
False,8118081,"Remseck am Neckar, Stadt",15 - 18 Jahre,571,284,287
False,8118081,"Remseck am Neckar, Stadt",18 - 20 Jahre,381,182,199
False,8118081,"Remseck am Neckar, Stadt",20 - 25 Jahre,1064,504,560
False,8118081,"Remseck am Neckar, Stadt",25 - 30 Jahre,1495,772,723
False,8118081,"Remseck am Neckar, Stadt",30 - 35 Jahre,1686,851,835
False,8118081,"Remseck am Neckar, Stadt",35 - 40 Jahre,1494,812,682
False,8118081,"Remseck am Neckar, Stadt",40 - 45 Jahre,1339,623,716
False,8118081,"Remseck am Neckar, Stadt",45 - 50 Jahre,1307,679,628
False,8118081,"Remseck am Neckar, Stadt",50 - 55 Jahre,1371,684,687
False,8118081,"Remseck am Neckar, Stadt",55 - 60 Jahre,1448,747,701
False,8118081,"Remseck am Neckar, Stadt",60 - 65 Jahre,939,515,424
False,8118081,"Remseck am Neckar, Stadt",65 - 75 Jahre,1331,622,709
False,8118081,"Remseck am Neckar, Stadt",75 und mehr Jahre,812,263,549
False,8118081,"Remseck am Neckar, Stadt",Insgesamt,18375,9098,9277
False,8119,Landkreis Rems-Murr-Kreis,unter 3 Jahre,13991,7155,6836
False,8119,Landkreis Rems-Murr-Kreis,3 -  6 Jahre,14560,7523,7037
False,8119,Landkreis Rems-Murr-Kreis,6 - 10 Jahre,18314,9432,8882
False,8119,Landkreis Rems-Murr-Kreis,10 - 15 Jahre,21066,10888,10178
False,8119,Landkreis Rems-Murr-Kreis,15 - 18 Jahre,12216,6339,5877
False,8119,Landkreis Rems-Murr-Kreis,18 - 20 Jahre,8244,4200,4044
False,8119,Landkreis Rems-Murr-Kreis,20 - 25 Jahre,23631,12108,11523
False,8119,Landkreis Rems-Murr-Kreis,25 - 30 Jahre,33826,17414,16412
False,8119,Landkreis Rems-Murr-Kreis,30 - 35 Jahre,36335,18857,17478
False,8119,Landkreis Rems-Murr-Kreis,35 - 40 Jahre,31294,16218,15076
False,8119,Landkreis Rems-Murr-Kreis,40 - 45 Jahre,26839,13402,13437
False,8119,Landkreis Rems-Murr-Kreis,45 - 50 Jahre,24951,12534,12417
False,8119,Landkreis Rems-Murr-Kreis,50 - 55 Jahre,25714,13011,12703
False,8119,Landkreis Rems-Murr-Kreis,55 - 60 Jahre,30043,15213,14830
False,8119,Landkreis Rems-Murr-Kreis,60 - 65 Jahre,21899,11188,10711
False,8119,Landkreis Rems-Murr-Kreis,65 - 75 Jahre,33046,14021,19025
False,8119,Landkreis Rems-Murr-Kreis,75 und mehr Jahre,23147,7172,15975
False,8119,Landkreis Rems-Murr-Kreis,Insgesamt,399116,196675,202441
False,8119001,Alfdorf,unter 3 Jahre,282,135,147
False,8119001,Alfdorf,3 -  6 Jahre,314,171,143
False,8119001,Alfdorf,6 - 10 Jahre,400,220,180
False,8119001,Alfdorf,10 - 15 Jahre,420,213,207
False,8119001,Alfdorf,15 - 18 Jahre,235,116,119
False,8119001,Alfdorf,18 - 20 Jahre,152,75,77
False,8119001,Alfdorf,20 - 25 Jahre,393,205,188
False,8119001,Alfdorf,25 - 30 Jahre,564,280,284
False,8119001,Alfdorf,30 - 35 Jahre,554,287,267
False,8119001,Alfdorf,35 - 40 Jahre,566,285,281
False,8119001,Alfdorf,40 - 45 Jahre,456,245,211
False,8119001,Alfdorf,45 - 50 Jahre,381,211,170
False,8119001,Alfdorf,50 - 55 Jahre,353,176,177
False,8119001,Alfdorf,55 - 60 Jahre,416,207,209
False,8119001,Alfdorf,60 - 65 Jahre,367,173,194
False,8119001,Alfdorf,65 - 75 Jahre,554,253,301
False,8119001,Alfdorf,75 und mehr Jahre,354,124,230
False,8119001,Alfdorf,Insgesamt,6761,3376,3385
False,8119003,Allmersbach im Tal,unter 3 Jahre,150,71,79
False,8119003,Allmersbach im Tal,3 -  6 Jahre,165,86,79
False,8119003,Allmersbach im Tal,6 - 10 Jahre,231,113,118
False,8119003,Allmersbach im Tal,10 - 15 Jahre,252,125,127
False,8119003,Allmersbach im Tal,15 - 18 Jahre,140,68,72
False,8119003,Allmersbach im Tal,18 - 20 Jahre,80,42,38
False,8119003,Allmersbach im Tal,20 - 25 Jahre,261,144,117
False,8119003,Allmersbach im Tal,25 - 30 Jahre,368,179,189
False,8119003,Allmersbach im Tal,30 - 35 Jahre,422,221,201
False,8119003,Allmersbach im Tal,35 - 40 Jahre,318,165,153
False,8119003,Allmersbach im Tal,40 - 45 Jahre,290,140,150
False,8119003,Allmersbach im Tal,45 - 50 Jahre,289,144,145
False,8119003,Allmersbach im Tal,50 - 55 Jahre,322,167,155
False,8119003,Allmersbach im Tal,55 - 60 Jahre,375,193,182
False,8119003,Allmersbach im Tal,60 - 65 Jahre,254,148,106
False,8119003,Allmersbach im Tal,65 - 75 Jahre,321,141,180
False,8119003,Allmersbach im Tal,75 und mehr Jahre,175,53,122
False,8119003,Allmersbach im Tal,Insgesamt,4413,2200,2213
False,8119004,Althütte,unter 3 Jahre,142,70,72
False,8119004,Althütte,3 -  6 Jahre,134,70,64
False,8119004,Althütte,6 - 10 Jahre,182,92,90
False,8119004,Althütte,10 - 15 Jahre,227,107,120
False,8119004,Althütte,15 - 18 Jahre,127,54,73
False,8119004,Althütte,18 - 20 Jahre,87,41,46
False,8119004,Althütte,20 - 25 Jahre,205,113,92
False,8119004,Althütte,25 - 30 Jahre,315,159,156
False,8119004,Althütte,30 - 35 Jahre,301,161,140
False,8119004,Althütte,35 - 40 Jahre,312,164,148
False,8119004,Althütte,40 - 45 Jahre,256,130,126
False,8119004,Althütte,45 - 50 Jahre,245,120,125
False,8119004,Althütte,50 - 55 Jahre,265,136,129
False,8119004,Althütte,55 - 60 Jahre,280,150,130
False,8119004,Althütte,60 - 65 Jahre,192,96,96
False,8119004,Althütte,65 - 75 Jahre,330,146,184
False,8119004,Althütte,75 und mehr Jahre,223,71,152
False,8119004,Althütte,Insgesamt,3823,1880,1943
False,8119006,Auenwald,unter 3 Jahre,269,138,131
False,8119006,Auenwald,3 -  6 Jahre,276,134,142
False,8119006,Auenwald,6 - 10 Jahre,315,167,148
False,8119006,Auenwald,10 - 15 Jahre,345,172,173
False,8119006,Auenwald,15 - 18 Jahre,199,105,94
False,8119006,Auenwald,18 - 20 Jahre,127,68,59
False,8119006,Auenwald,20 - 25 Jahre,385,188,197
False,8119006,Auenwald,25 - 30 Jahre,522,266,256
False,8119006,Auenwald,30 - 35 Jahre,577,289,288
False,8119006,Auenwald,35 - 40 Jahre,513,241,272
False,8119006,Auenwald,40 - 45 Jahre,444,225,219
False,8119006,Auenwald,45 - 50 Jahre,450,231,219
False,8119006,Auenwald,50 - 55 Jahre,427,207,220
False,8119006,Auenwald,55 - 60 Jahre,480,256,224
False,8119006,Auenwald,60 - 65 Jahre,286,159,127
False,8119006,Auenwald,65 - 75 Jahre,414,166,248
False,8119006,Auenwald,75 und mehr Jahre,295,104,191
False,8119006,Auenwald,Insgesamt,6324,3116,3208
False,8119008,"Backnang, Stadt",unter 3 Jahre,1240,651,589
False,8119008,"Backnang, Stadt",3 -  6 Jahre,1198,578,620
False,8119008,"Backnang, Stadt",6 - 10 Jahre,1560,766,794
False,8119008,"Backnang, Stadt",10 - 15 Jahre,1853,975,878
False,8119008,"Backnang, Stadt",15 - 18 Jahre,1034,507,527
False,8119008,"Backnang, Stadt",18 - 20 Jahre,668,347,321
False,8119008,"Backnang, Stadt",20 - 25 Jahre,1994,1045,949
False,8119008,"Backnang, Stadt",25 - 30 Jahre,2743,1455,1288
False,8119008,"Backnang, Stadt",30 - 35 Jahre,3007,1589,1418
False,8119008,"Backnang, Stadt",35 - 40 Jahre,2651,1424,1227
False,8119008,"Backnang, Stadt",40 - 45 Jahre,2246,1123,1123
False,8119008,"Backnang, Stadt",45 - 50 Jahre,2056,1031,1025
False,8119008,"Backnang, Stadt",50 - 55 Jahre,2047,1062,985
False,8119008,"Backnang, Stadt",55 - 60 Jahre,2444,1245,1199
False,8119008,"Backnang, Stadt",60 - 65 Jahre,1928,960,968
False,8119008,"Backnang, Stadt",65 - 75 Jahre,3094,1310,1784
False,8119008,"Backnang, Stadt",75 und mehr Jahre,2119,671,1448
False,8119008,"Backnang, Stadt",Insgesamt,33882,16739,17143
False,8119018,Burgstetten,unter 3 Jahre,141,75,66
False,8119018,Burgstetten,3 -  6 Jahre,144,79,65
False,8119018,Burgstetten,6 - 10 Jahre,183,99,84
False,8119018,Burgstetten,10 - 15 Jahre,198,99,99
False,8119018,Burgstetten,15 - 18 Jahre,110,54,56
False,8119018,Burgstetten,18 - 20 Jahre,69,33,36
False,8119018,Burgstetten,20 - 25 Jahre,158,85,73
False,8119018,Burgstetten,25 - 30 Jahre,263,124,139
False,8119018,Burgstetten,30 - 35 Jahre,314,156,158
False,8119018,Burgstetten,35 - 40 Jahre,270,133,137
False,8119018,Burgstetten,40 - 45 Jahre,225,117,108
False,8119018,Burgstetten,45 - 50 Jahre,199,101,98
False,8119018,Burgstetten,50 - 55 Jahre,178,98,80
False,8119018,Burgstetten,55 - 60 Jahre,211,107,104
False,8119018,Burgstetten,60 - 65 Jahre,172,95,77
False,8119018,Burgstetten,65 - 75 Jahre,257,118,139
False,8119018,Burgstetten,75 und mehr Jahre,142,43,99
False,8119018,Burgstetten,Insgesamt,3234,1616,1618
False,8119020,"Fellbach, Stadt",unter 3 Jahre,1393,712,681
False,8119020,"Fellbach, Stadt",3 -  6 Jahre,1365,711,654
False,8119020,"Fellbach, Stadt",6 - 10 Jahre,1728,936,792
False,8119020,"Fellbach, Stadt",10 - 15 Jahre,1920,1004,916
False,8119020,"Fellbach, Stadt",15 - 18 Jahre,1126,583,543
False,8119020,"Fellbach, Stadt",18 - 20 Jahre,829,408,421
False,8119020,"Fellbach, Stadt",20 - 25 Jahre,2519,1219,1300
False,8119020,"Fellbach, Stadt",25 - 30 Jahre,3934,2081,1853
False,8119020,"Fellbach, Stadt",30 - 35 Jahre,4137,2203,1934
False,8119020,"Fellbach, Stadt",35 - 40 Jahre,3315,1724,1591
False,8119020,"Fellbach, Stadt",40 - 45 Jahre,2727,1352,1375
False,8119020,"Fellbach, Stadt",45 - 50 Jahre,2596,1294,1302
False,8119020,"Fellbach, Stadt",50 - 55 Jahre,2780,1362,1418
False,8119020,"Fellbach, Stadt",55 - 60 Jahre,3305,1635,1670
False,8119020,"Fellbach, Stadt",60 - 65 Jahre,2398,1242,1156
False,8119020,"Fellbach, Stadt",65 - 75 Jahre,3639,1484,2155
False,8119020,"Fellbach, Stadt",75 und mehr Jahre,2843,831,2012
False,8119020,"Fellbach, Stadt",Insgesamt,42554,20781,21773
False,8119024,Großerlach,unter 3 Jahre,64,33,31
False,8119024,Großerlach,3 -  6 Jahre,104,49,55
False,8119024,Großerlach,6 - 10 Jahre,117,53,64
False,8119024,Großerlach,10 - 15 Jahre,121,62,59
False,8119024,Großerlach,15 - 18 Jahre,52,33,19
False,8119024,Großerlach,18 - 20 Jahre,30,15,15
False,8119024,Großerlach,20 - 25 Jahre,92,54,38
False,8119024,Großerlach,25 - 30 Jahre,155,87,68
False,8119024,Großerlach,30 - 35 Jahre,193,110,83
False,8119024,Großerlach,35 - 40 Jahre,219,140,79
False,8119024,Großerlach,40 - 45 Jahre,187,117,70
False,8119024,Großerlach,45 - 50 Jahre,188,117,71
False,8119024,Großerlach,50 - 55 Jahre,144,91,53
False,8119024,Großerlach,55 - 60 Jahre,194,126,68
False,8119024,Großerlach,60 - 65 Jahre,154,90,64
False,8119024,Großerlach,65 - 75 Jahre,261,112,149
False,8119024,Großerlach,75 und mehr Jahre,248,57,191
False,8119024,Großerlach,Insgesamt,2523,1346,1177
False,8119037,Kaisersbach,unter 3 Jahre,105,46,59
False,8119037,Kaisersbach,3 -  6 Jahre,104,64,40
False,8119037,Kaisersbach,6 - 10 Jahre,169,90,79
False,8119037,Kaisersbach,10 - 15 Jahre,164,90,74
False,8119037,Kaisersbach,15 - 18 Jahre,86,42,44
False,8119037,Kaisersbach,18 - 20 Jahre,59,29,30
False,8119037,Kaisersbach,20 - 25 Jahre,135,77,58
False,8119037,Kaisersbach,25 - 30 Jahre,221,108,113
False,8119037,Kaisersbach,30 - 35 Jahre,224,114,110
False,8119037,Kaisersbach,35 - 40 Jahre,215,109,106
False,8119037,Kaisersbach,40 - 45 Jahre,204,104,100
False,8119037,Kaisersbach,45 - 50 Jahre,122,66,56
False,8119037,Kaisersbach,50 - 55 Jahre,117,65,52
False,8119037,Kaisersbach,55 - 60 Jahre,145,70,75
False,8119037,Kaisersbach,60 - 65 Jahre,99,53,46
False,8119037,Kaisersbach,65 - 75 Jahre,209,88,121
False,8119037,Kaisersbach,75 und mehr Jahre,128,48,80
False,8119037,Kaisersbach,Insgesamt,2506,1263,1243
False,8119038,Kirchberg an der Murr,unter 3 Jahre,163,81,82
False,8119038,Kirchberg an der Murr,3 -  6 Jahre,127,68,59
False,8119038,Kirchberg an der Murr,6 - 10 Jahre,187,104,83
False,8119038,Kirchberg an der Murr,10 - 15 Jahre,210,126,84
False,8119038,Kirchberg an der Murr,15 - 18 Jahre,123,57,66
False,8119038,Kirchberg an der Murr,18 - 20 Jahre,74,36,38
False,8119038,Kirchberg an der Murr,20 - 25 Jahre,248,127,121
False,8119038,Kirchberg an der Murr,25 - 30 Jahre,318,159,159
False,8119038,Kirchberg an der Murr,30 - 35 Jahre,342,173,169
False,8119038,Kirchberg an der Murr,35 - 40 Jahre,292,155,137
False,8119038,Kirchberg an der Murr,40 - 45 Jahre,251,122,129
False,8119038,Kirchberg an der Murr,45 - 50 Jahre,194,100,94
False,8119038,Kirchberg an der Murr,50 - 55 Jahre,231,130,101
False,8119038,Kirchberg an der Murr,55 - 60 Jahre,236,118,118
False,8119038,Kirchberg an der Murr,60 - 65 Jahre,191,95,96
False,8119038,Kirchberg an der Murr,65 - 75 Jahre,297,135,162
False,8119038,Kirchberg an der Murr,75 und mehr Jahre,166,55,111
False,8119038,Kirchberg an der Murr,Insgesamt,3650,1841,1809
False,8119041,Korb,unter 3 Jahre,378,194,184
False,8119041,Korb,3 -  6 Jahre,366,180,186
False,8119041,Korb,6 - 10 Jahre,428,211,217
False,8119041,Korb,10 - 15 Jahre,447,242,205
False,8119041,Korb,15 - 18 Jahre,269,151,118
False,8119041,Korb,18 - 20 Jahre,212,116,96
False,8119041,Korb,20 - 25 Jahre,549,274,275
False,8119041,Korb,25 - 30 Jahre,920,466,454
False,8119041,Korb,30 - 35 Jahre,1020,521,499
False,8119041,Korb,35 - 40 Jahre,762,400,362
False,8119041,Korb,40 - 45 Jahre,678,343,335
False,8119041,Korb,45 - 50 Jahre,624,292,332
False,8119041,Korb,50 - 55 Jahre,652,314,338
False,8119041,Korb,55 - 60 Jahre,796,398,398
False,8119041,Korb,60 - 65 Jahre,569,299,270
False,8119041,Korb,65 - 75 Jahre,808,358,450
False,8119041,Korb,75 und mehr Jahre,485,167,318
False,8119041,Korb,Insgesamt,9963,4926,5037
False,8119042,Leutenbach,unter 3 Jahre,415,205,210
False,8119042,Leutenbach,3 -  6 Jahre,429,224,205
False,8119042,Leutenbach,6 - 10 Jahre,514,259,255
False,8119042,Leutenbach,10 - 15 Jahre,560,283,277
False,8119042,Leutenbach,15 - 18 Jahre,310,168,142
False,8119042,Leutenbach,18 - 20 Jahre,217,87,130
False,8119042,Leutenbach,20 - 25 Jahre,573,283,290
False,8119042,Leutenbach,25 - 30 Jahre,950,473,477
False,8119042,Leutenbach,30 - 35 Jahre,1101,549,552
False,8119042,Leutenbach,35 - 40 Jahre,960,508,452
False,8119042,Leutenbach,40 - 45 Jahre,743,368,375
False,8119042,Leutenbach,45 - 50 Jahre,714,352,362
False,8119042,Leutenbach,50 - 55 Jahre,726,369,357
False,8119042,Leutenbach,55 - 60 Jahre,767,395,372
False,8119042,Leutenbach,60 - 65 Jahre,524,267,257
False,8119042,Leutenbach,65 - 75 Jahre,694,301,393
False,8119042,Leutenbach,75 und mehr Jahre,470,150,320
False,8119042,Leutenbach,Insgesamt,10667,5241,5426
False,8119044,"Murrhardt, Stadt",unter 3 Jahre,495,253,242
False,8119044,"Murrhardt, Stadt",3 -  6 Jahre,524,261,263
False,8119044,"Murrhardt, Stadt",6 - 10 Jahre,653,350,303
False,8119044,"Murrhardt, Stadt",10 - 15 Jahre,827,412,415
False,8119044,"Murrhardt, Stadt",15 - 18 Jahre,405,221,184
False,8119044,"Murrhardt, Stadt",18 - 20 Jahre,280,132,148
False,8119044,"Murrhardt, Stadt",20 - 25 Jahre,843,435,408
False,8119044,"Murrhardt, Stadt",25 - 30 Jahre,1097,589,508
False,8119044,"Murrhardt, Stadt",30 - 35 Jahre,1221,602,619
False,8119044,"Murrhardt, Stadt",35 - 40 Jahre,1071,574,497
False,8119044,"Murrhardt, Stadt",40 - 45 Jahre,969,494,475
False,8119044,"Murrhardt, Stadt",45 - 50 Jahre,837,438,399
False,8119044,"Murrhardt, Stadt",50 - 55 Jahre,824,433,391
False,8119044,"Murrhardt, Stadt",55 - 60 Jahre,1080,540,540
False,8119044,"Murrhardt, Stadt",60 - 65 Jahre,776,385,391
False,8119044,"Murrhardt, Stadt",65 - 75 Jahre,1400,575,825
False,8119044,"Murrhardt, Stadt",75 und mehr Jahre,1136,340,796
False,8119044,"Murrhardt, Stadt",Insgesamt,14438,7034,7404
False,8119053,Oppenweiler,unter 3 Jahre,129,65,64
False,8119053,Oppenweiler,3 -  6 Jahre,158,90,68
False,8119053,Oppenweiler,6 - 10 Jahre,211,123,88
False,8119053,Oppenweiler,10 - 15 Jahre,238,111,127
False,8119053,Oppenweiler,15 - 18 Jahre,142,68,74
False,8119053,Oppenweiler,18 - 20 Jahre,80,47,33
False,8119053,Oppenweiler,20 - 25 Jahre,221,112,109
False,8119053,Oppenweiler,25 - 30 Jahre,293,158,135
False,8119053,Oppenweiler,30 - 35 Jahre,343,168,175
False,8119053,Oppenweiler,35 - 40 Jahre,342,172,170
False,8119053,Oppenweiler,40 - 45 Jahre,267,133,134
False,8119053,Oppenweiler,45 - 50 Jahre,258,135,123
False,8119053,Oppenweiler,50 - 55 Jahre,230,120,110
False,8119053,Oppenweiler,55 - 60 Jahre,300,147,153
False,8119053,Oppenweiler,60 - 65 Jahre,222,109,113
False,8119053,Oppenweiler,65 - 75 Jahre,342,152,190
False,8119053,Oppenweiler,75 und mehr Jahre,245,83,162
False,8119053,Oppenweiler,Insgesamt,4021,1993,2028
False,8119055,Plüderhausen,unter 3 Jahre,303,171,132
False,8119055,Plüderhausen,3 -  6 Jahre,342,166,176
False,8119055,Plüderhausen,6 - 10 Jahre,468,235,233
False,8119055,Plüderhausen,10 - 15 Jahre,550,282,268
False,8119055,Plüderhausen,15 - 18 Jahre,302,168,134
False,8119055,Plüderhausen,18 - 20 Jahre,200,92,108
False,8119055,Plüderhausen,20 - 25 Jahre,541,280,261
False,8119055,Plüderhausen,25 - 30 Jahre,759,393,366
False,8119055,Plüderhausen,30 - 35 Jahre,815,407,408
False,8119055,Plüderhausen,35 - 40 Jahre,722,377,345
False,8119055,Plüderhausen,40 - 45 Jahre,643,332,311
False,8119055,Plüderhausen,45 - 50 Jahre,604,292,312
False,8119055,Plüderhausen,50 - 55 Jahre,593,300,293
False,8119055,Plüderhausen,55 - 60 Jahre,692,358,334
False,8119055,Plüderhausen,60 - 65 Jahre,544,274,270
False,8119055,Plüderhausen,65 - 75 Jahre,781,331,450
False,8119055,Plüderhausen,75 und mehr Jahre,473,155,318
False,8119055,Plüderhausen,Insgesamt,9332,4613,4719
False,8119061,Rudersberg,unter 3 Jahre,408,213,195
False,8119061,Rudersberg,3 -  6 Jahre,445,218,227
False,8119061,Rudersberg,6 - 10 Jahre,614,311,303
False,8119061,Rudersberg,10 - 15 Jahre,738,412,326
False,8119061,Rudersberg,15 - 18 Jahre,382,212,170
False,8119061,Rudersberg,18 - 20 Jahre,249,134,115
False,8119061,Rudersberg,20 - 25 Jahre,626,342,284
False,8119061,Rudersberg,25 - 30 Jahre,929,477,452
False,8119061,Rudersberg,30 - 35 Jahre,1087,586,501
False,8119061,Rudersberg,35 - 40 Jahre,878,452,426
False,8119061,Rudersberg,40 - 45 Jahre,842,419,423
False,8119061,Rudersberg,45 - 50 Jahre,691,357,334
False,8119061,Rudersberg,50 - 55 Jahre,661,336,325
False,8119061,Rudersberg,55 - 60 Jahre,796,420,376
False,8119061,Rudersberg,60 - 65 Jahre,596,327,269
False,8119061,Rudersberg,65 - 75 Jahre,931,389,542
False,8119061,Rudersberg,75 und mehr Jahre,568,175,393
False,8119061,Rudersberg,Insgesamt,11441,5780,5661
False,8119067,"Schorndorf, Stadt",unter 3 Jahre,1228,639,589
False,8119067,"Schorndorf, Stadt",3 -  6 Jahre,1364,703,661
False,8119067,"Schorndorf, Stadt",6 - 10 Jahre,1749,899,850
False,8119067,"Schorndorf, Stadt",10 - 15 Jahre,1956,1000,956
False,8119067,"Schorndorf, Stadt",15 - 18 Jahre,1245,644,601
False,8119067,"Schorndorf, Stadt",18 - 20 Jahre,763,385,378
False,8119067,"Schorndorf, Stadt",20 - 25 Jahre,2223,1128,1095
False,8119067,"Schorndorf, Stadt",25 - 30 Jahre,2998,1532,1466
False,8119067,"Schorndorf, Stadt",30 - 35 Jahre,3183,1668,1515
False,8119067,"Schorndorf, Stadt",35 - 40 Jahre,2797,1443,1354
False,8119067,"Schorndorf, Stadt",40 - 45 Jahre,2582,1265,1317
False,8119067,"Schorndorf, Stadt",45 - 50 Jahre,2435,1210,1225
False,8119067,"Schorndorf, Stadt",50 - 55 Jahre,2485,1197,1288
False,8119067,"Schorndorf, Stadt",55 - 60 Jahre,2882,1502,1380
False,8119067,"Schorndorf, Stadt",60 - 65 Jahre,2210,1127,1083
False,8119067,"Schorndorf, Stadt",65 - 75 Jahre,3400,1370,2030
False,8119067,"Schorndorf, Stadt",75 und mehr Jahre,2505,781,1724
False,8119067,"Schorndorf, Stadt",Insgesamt,38005,18493,19512
False,8119068,Schwaikheim,unter 3 Jahre,291,165,126
False,8119068,Schwaikheim,3 -  6 Jahre,294,150,144
False,8119068,Schwaikheim,6 - 10 Jahre,350,200,150
False,8119068,Schwaikheim,10 - 15 Jahre,414,223,191
False,8119068,Schwaikheim,15 - 18 Jahre,275,126,149
False,8119068,Schwaikheim,18 - 20 Jahre,160,83,77
False,8119068,Schwaikheim,20 - 25 Jahre,505,257,248
False,8119068,Schwaikheim,25 - 30 Jahre,753,374,379
False,8119068,Schwaikheim,30 - 35 Jahre,830,427,403
False,8119068,Schwaikheim,35 - 40 Jahre,623,330,293
False,8119068,Schwaikheim,40 - 45 Jahre,576,280,296
False,8119068,Schwaikheim,45 - 50 Jahre,582,297,285
False,8119068,Schwaikheim,50 - 55 Jahre,560,273,287
False,8119068,Schwaikheim,55 - 60 Jahre,661,335,326
False,8119068,Schwaikheim,60 - 65 Jahre,489,245,244
False,8119068,Schwaikheim,65 - 75 Jahre,657,294,363
False,8119068,Schwaikheim,75 und mehr Jahre,417,132,285
False,8119068,Schwaikheim,Insgesamt,8437,4191,4246
False,8119069,Spiegelberg,unter 3 Jahre,86,49,37
False,8119069,Spiegelberg,3 -  6 Jahre,105,64,41
False,8119069,Spiegelberg,6 - 10 Jahre,114,57,57
False,8119069,Spiegelberg,10 - 15 Jahre,140,75,65
False,8119069,Spiegelberg,15 - 18 Jahre,62,37,25
False,8119069,Spiegelberg,18 - 20 Jahre,35,17,18
False,8119069,Spiegelberg,20 - 25 Jahre,95,53,42
False,8119069,Spiegelberg,25 - 30 Jahre,154,91,63
False,8119069,Spiegelberg,30 - 35 Jahre,196,100,96
False,8119069,Spiegelberg,35 - 40 Jahre,178,91,87
False,8119069,Spiegelberg,40 - 45 Jahre,152,85,67
False,8119069,Spiegelberg,45 - 50 Jahre,106,65,41
False,8119069,Spiegelberg,50 - 55 Jahre,87,44,43
False,8119069,Spiegelberg,55 - 60 Jahre,145,62,83
False,8119069,Spiegelberg,60 - 65 Jahre,106,56,50
False,8119069,Spiegelberg,65 - 75 Jahre,213,97,116
False,8119069,Spiegelberg,75 und mehr Jahre,132,48,84
False,8119069,Spiegelberg,Insgesamt,2106,1091,1015
False,8119075,Sulzbach an der Murr,unter 3 Jahre,172,83,89
False,8119075,Sulzbach an der Murr,3 -  6 Jahre,184,93,91
False,8119075,Sulzbach an der Murr,6 - 10 Jahre,263,128,135
False,8119075,Sulzbach an der Murr,10 - 15 Jahre,291,149,142
False,8119075,Sulzbach an der Murr,15 - 18 Jahre,174,91,83
False,8119075,Sulzbach an der Murr,18 - 20 Jahre,116,64,52
False,8119075,Sulzbach an der Murr,20 - 25 Jahre,273,137,136
False,8119075,Sulzbach an der Murr,25 - 30 Jahre,382,192,190
False,8119075,Sulzbach an der Murr,30 - 35 Jahre,418,219,199
False,8119075,Sulzbach an der Murr,35 - 40 Jahre,391,199,192
False,8119075,Sulzbach an der Murr,40 - 45 Jahre,337,167,170
False,8119075,Sulzbach an der Murr,45 - 50 Jahre,329,172,157
False,8119075,Sulzbach an der Murr,50 - 55 Jahre,297,154,143
False,8119075,Sulzbach an der Murr,55 - 60 Jahre,407,208,199
False,8119075,Sulzbach an der Murr,60 - 65 Jahre,268,136,132
False,8119075,Sulzbach an der Murr,65 - 75 Jahre,406,166,240
False,8119075,Sulzbach an der Murr,75 und mehr Jahre,357,97,260
False,8119075,Sulzbach an der Murr,Insgesamt,5065,2455,2610
False,8119076,Urbach,unter 3 Jahre,269,134,135
False,8119076,Urbach,3 -  6 Jahre,334,166,168
False,8119076,Urbach,6 - 10 Jahre,375,197,178
False,8119076,Urbach,10 - 15 Jahre,463,244,219
False,8119076,Urbach,15 - 18 Jahre,213,111,102
False,8119076,Urbach,18 - 20 Jahre,147,87,60
False,8119076,Urbach,20 - 25 Jahre,494,250,244
False,8119076,Urbach,25 - 30 Jahre,703,373,330
False,8119076,Urbach,30 - 35 Jahre,723,375,348
False,8119076,Urbach,35 - 40 Jahre,648,318,330
False,8119076,Urbach,40 - 45 Jahre,487,254,233
False,8119076,Urbach,45 - 50 Jahre,457,220,237
False,8119076,Urbach,50 - 55 Jahre,444,230,214
False,8119076,Urbach,55 - 60 Jahre,563,277,286
False,8119076,Urbach,60 - 65 Jahre,469,239,230
False,8119076,Urbach,65 - 75 Jahre,635,267,368
False,8119076,Urbach,75 und mehr Jahre,444,135,309
False,8119076,Urbach,Insgesamt,7868,3877,3991
False,8119079,"Waiblingen, Stadt",unter 3 Jahre,1758,879,879
False,8119079,"Waiblingen, Stadt",3 -  6 Jahre,1744,932,812
False,8119079,"Waiblingen, Stadt",6 - 10 Jahre,2090,1065,1025
False,8119079,"Waiblingen, Stadt",10 - 15 Jahre,2385,1203,1182
False,8119079,"Waiblingen, Stadt",15 - 18 Jahre,1493,766,727
False,8119079,"Waiblingen, Stadt",18 - 20 Jahre,1146,586,560
False,8119079,"Waiblingen, Stadt",20 - 25 Jahre,3138,1625,1513
False,8119079,"Waiblingen, Stadt",25 - 30 Jahre,4376,2187,2189
False,8119079,"Waiblingen, Stadt",30 - 35 Jahre,4696,2410,2286
False,8119079,"Waiblingen, Stadt",35 - 40 Jahre,3968,2056,1912
False,8119079,"Waiblingen, Stadt",40 - 45 Jahre,3311,1630,1681
False,8119079,"Waiblingen, Stadt",45 - 50 Jahre,3179,1568,1611
False,8119079,"Waiblingen, Stadt",50 - 55 Jahre,3409,1736,1673
False,8119079,"Waiblingen, Stadt",55 - 60 Jahre,3930,1957,1973
False,8119079,"Waiblingen, Stadt",60 - 65 Jahre,2771,1381,1390
False,8119079,"Waiblingen, Stadt",65 - 75 Jahre,4067,1745,2322
False,8119079,"Waiblingen, Stadt",75 und mehr Jahre,2872,871,2001
False,8119079,"Waiblingen, Stadt",Insgesamt,50333,24597,25736
False,8119083,Weissach im Tal,unter 3 Jahre,229,121,108
False,8119083,Weissach im Tal,3 -  6 Jahre,255,131,124
False,8119083,Weissach im Tal,6 - 10 Jahre,328,157,171
False,8119083,Weissach im Tal,10 - 15 Jahre,461,218,243
False,8119083,Weissach im Tal,15 - 18 Jahre,269,152,117
False,8119083,Weissach im Tal,18 - 20 Jahre,140,72,68
False,8119083,Weissach im Tal,20 - 25 Jahre,422,212,210
False,8119083,Weissach im Tal,25 - 30 Jahre,557,302,255
False,8119083,Weissach im Tal,30 - 35 Jahre,556,290,266
False,8119083,Weissach im Tal,35 - 40 Jahre,536,256,280
False,8119083,Weissach im Tal,40 - 45 Jahre,531,267,264
False,8119083,Weissach im Tal,45 - 50 Jahre,451,232,219
False,8119083,Weissach im Tal,50 - 55 Jahre,456,233,223
False,8119083,Weissach im Tal,55 - 60 Jahre,481,247,234
False,8119083,Weissach im Tal,60 - 65 Jahre,332,181,151
False,8119083,Weissach im Tal,65 - 75 Jahre,512,237,275
False,8119083,Weissach im Tal,75 und mehr Jahre,298,90,208
False,8119083,Weissach im Tal,Insgesamt,6814,3398,3416
False,8119084,"Welzheim, Stadt",unter 3 Jahre,397,219,178
False,8119084,"Welzheim, Stadt",3 -  6 Jahre,475,241,234
False,8119084,"Welzheim, Stadt",6 - 10 Jahre,624,302,322
False,8119084,"Welzheim, Stadt",10 - 15 Jahre,731,393,338
False,8119084,"Welzheim, Stadt",15 - 18 Jahre,401,208,193
False,8119084,"Welzheim, Stadt",18 - 20 Jahre,248,127,121
False,8119084,"Welzheim, Stadt",20 - 25 Jahre,679,360,319
False,8119084,"Welzheim, Stadt",25 - 30 Jahre,808,401,407
False,8119084,"Welzheim, Stadt",30 - 35 Jahre,977,503,474
False,8119084,"Welzheim, Stadt",35 - 40 Jahre,873,456,417
False,8119084,"Welzheim, Stadt",40 - 45 Jahre,713,344,369
False,8119084,"Welzheim, Stadt",45 - 50 Jahre,640,344,296
False,8119084,"Welzheim, Stadt",50 - 55 Jahre,597,298,299
False,8119084,"Welzheim, Stadt",55 - 60 Jahre,704,344,360
False,8119084,"Welzheim, Stadt",60 - 65 Jahre,511,240,271
False,8119084,"Welzheim, Stadt",65 - 75 Jahre,952,397,555
False,8119084,"Welzheim, Stadt",75 und mehr Jahre,627,179,448
False,8119084,"Welzheim, Stadt",Insgesamt,10957,5356,5601
False,8119085,"Winnenden, Stadt",unter 3 Jahre,951,470,481
False,8119085,"Winnenden, Stadt",3 -  6 Jahre,961,504,457
False,8119085,"Winnenden, Stadt",6 - 10 Jahre,1175,602,573
False,8119085,"Winnenden, Stadt",10 - 15 Jahre,1388,738,650
False,8119085,"Winnenden, Stadt",15 - 18 Jahre,778,398,380
False,8119085,"Winnenden, Stadt",18 - 20 Jahre,623,339,284
False,8119085,"Winnenden, Stadt",20 - 25 Jahre,1690,880,810
False,8119085,"Winnenden, Stadt",25 - 30 Jahre,2334,1195,1139
False,8119085,"Winnenden, Stadt",30 - 35 Jahre,2414,1255,1159
False,8119085,"Winnenden, Stadt",35 - 40 Jahre,2077,1110,967
False,8119085,"Winnenden, Stadt",40 - 45 Jahre,1671,855,816
False,8119085,"Winnenden, Stadt",45 - 50 Jahre,1556,751,805
False,8119085,"Winnenden, Stadt",50 - 55 Jahre,1695,861,834
False,8119085,"Winnenden, Stadt",55 - 60 Jahre,1928,973,955
False,8119085,"Winnenden, Stadt",60 - 65 Jahre,1425,769,656
False,8119085,"Winnenden, Stadt",65 - 75 Jahre,2086,896,1190
False,8119085,"Winnenden, Stadt",75 und mehr Jahre,1392,436,956
False,8119085,"Winnenden, Stadt",Insgesamt,26144,13032,13112
False,8119086,Winterbach,unter 3 Jahre,261,113,148
False,8119086,Winterbach,3 -  6 Jahre,306,167,139
False,8119086,Winterbach,6 - 10 Jahre,357,185,172
False,8119086,Winterbach,10 - 15 Jahre,462,227,235
False,8119086,Winterbach,15 - 18 Jahre,241,128,113
False,8119086,Winterbach,18 - 20 Jahre,159,91,68
False,8119086,Winterbach,20 - 25 Jahre,456,237,219
False,8119086,Winterbach,25 - 30 Jahre,632,319,313
False,8119086,Winterbach,30 - 35 Jahre,643,328,315
False,8119086,Winterbach,35 - 40 Jahre,593,301,292
False,8119086,Winterbach,40 - 45 Jahre,568,266,302
False,8119086,Winterbach,45 - 50 Jahre,501,242,259
False,8119086,Winterbach,50 - 55 Jahre,484,266,218
False,8119086,Winterbach,55 - 60 Jahre,517,246,271
False,8119086,Winterbach,60 - 65 Jahre,409,204,205
False,8119086,Winterbach,65 - 75 Jahre,578,242,336
False,8119086,Winterbach,75 und mehr Jahre,432,120,312
False,8119086,Winterbach,Insgesamt,7599,3682,3917
False,8119087,Aspach,unter 3 Jahre,303,143,160
False,8119087,Aspach,3 -  6 Jahre,294,157,137
False,8119087,Aspach,6 - 10 Jahre,413,204,209
False,8119087,Aspach,10 - 15 Jahre,425,206,219
False,8119087,Aspach,15 - 18 Jahre,224,101,123
False,8119087,Aspach,18 - 20 Jahre,171,95,76
False,8119087,Aspach,20 - 25 Jahre,469,232,237
False,8119087,Aspach,25 - 30 Jahre,679,351,328
False,8119087,Aspach,30 - 35 Jahre,729,369,360
False,8119087,Aspach,35 - 40 Jahre,624,334,290
False,8119087,Aspach,40 - 45 Jahre,544,270,274
False,8119087,Aspach,45 - 50 Jahre,472,256,216
False,8119087,Aspach,50 - 55 Jahre,464,251,213
False,8119087,Aspach,55 - 60 Jahre,541,267,274
False,8119087,Aspach,60 - 65 Jahre,418,211,207
False,8119087,Aspach,65 - 75 Jahre,605,264,341
False,8119087,Aspach,75 und mehr Jahre,390,134,256
False,8119087,Aspach,Insgesamt,7765,3845,3920
False,8119089,Berglen,unter 3 Jahre,237,124,113
False,8119089,Berglen,3 -  6 Jahre,231,124,107
False,8119089,Berglen,6 - 10 Jahre,290,152,138
False,8119089,Berglen,10 - 15 Jahre,299,162,137
False,8119089,Berglen,15 - 18 Jahre,180,93,87
False,8119089,Berglen,18 - 20 Jahre,108,56,52
False,8119089,Berglen,20 - 25 Jahre,325,184,141
False,8119089,Berglen,25 - 30 Jahre,553,299,254
False,8119089,Berglen,30 - 35 Jahre,548,275,273
False,8119089,Berglen,35 - 40 Jahre,508,256,252
False,8119089,Berglen,40 - 45 Jahre,408,209,199
False,8119089,Berglen,45 - 50 Jahre,396,227,169
False,8119089,Berglen,50 - 55 Jahre,382,195,187
False,8119089,Berglen,55 - 60 Jahre,441,228,213
False,8119089,Berglen,60 - 65 Jahre,316,155,161
False,8119089,Berglen,65 - 75 Jahre,404,179,225
False,8119089,Berglen,75 und mehr Jahre,283,92,191
False,8119089,Berglen,Insgesamt,5909,3010,2899
False,8119090,Remshalden,unter 3 Jahre,434,220,214
False,8119090,Remshalden,3 -  6 Jahre,463,227,236
False,8119090,Remshalden,6 - 10 Jahre,625,330,295
False,8119090,Remshalden,10 - 15 Jahre,686,345,341
False,8119090,Remshalden,15 - 18 Jahre,390,202,188
False,8119090,Remshalden,18 - 20 Jahre,251,109,142
False,8119090,Remshalden,20 - 25 Jahre,750,370,380
False,8119090,Remshalden,25 - 30 Jahre,1106,578,528
False,8119090,Remshalden,30 - 35 Jahre,1158,597,561
False,8119090,Remshalden,35 - 40 Jahre,978,505,473
False,8119090,Remshalden,40 - 45 Jahre,862,419,443
False,8119090,Remshalden,45 - 50 Jahre,892,434,458
False,8119090,Remshalden,50 - 55 Jahre,969,494,475
False,8119090,Remshalden,55 - 60 Jahre,1087,557,530
False,8119090,Remshalden,60 - 65 Jahre,739,393,346
False,8119090,Remshalden,65 - 75 Jahre,1120,490,630
False,8119090,Remshalden,75 und mehr Jahre,773,264,509
False,8119090,Remshalden,Insgesamt,13283,6534,6749
False,8119091,"Weinstadt, Stadt",unter 3 Jahre,842,424,418
False,8119091,"Weinstadt, Stadt",3 -  6 Jahre,928,489,439
False,8119091,"Weinstadt, Stadt",6 - 10 Jahre,1055,522,533
False,8119091,"Weinstadt, Stadt",10 - 15 Jahre,1267,656,611
False,8119091,"Weinstadt, Stadt",15 - 18 Jahre,823,454,369
False,8119091,"Weinstadt, Stadt",18 - 20 Jahre,485,247,238
False,8119091,"Weinstadt, Stadt",20 - 25 Jahre,1482,763,719
False,8119091,"Weinstadt, Stadt",25 - 30 Jahre,2108,1083,1025
False,8119091,"Weinstadt, Stadt",30 - 35 Jahre,2225,1183,1042
False,8119091,"Weinstadt, Stadt",35 - 40 Jahre,1929,985,944
False,8119091,"Weinstadt, Stadt",40 - 45 Jahre,1696,833,863
False,8119091,"Weinstadt, Stadt",45 - 50 Jahre,1621,786,835
False,8119091,"Weinstadt, Stadt",50 - 55 Jahre,1817,905,912
False,8119091,"Weinstadt, Stadt",55 - 60 Jahre,2025,1025,1000
False,8119091,"Weinstadt, Stadt",60 - 65 Jahre,1368,707,661
False,8119091,"Weinstadt, Stadt",65 - 75 Jahre,1895,804,1091
False,8119091,"Weinstadt, Stadt",75 und mehr Jahre,1375,403,972
False,8119091,"Weinstadt, Stadt",Insgesamt,24941,12269,12672
False,8119093,Kernen im Remstal,unter 3 Jahre,456,259,197
False,8119093,Kernen im Remstal,3 -  6 Jahre,427,226,201
False,8119093,Kernen im Remstal,6 - 10 Jahre,546,303,243
False,8119093,Kernen im Remstal,10 - 15 Jahre,628,334,294
False,8119093,Kernen im Remstal,15 - 18 Jahre,406,221,185
False,8119093,Kernen im Remstal,18 - 20 Jahre,279,140,139
False,8119093,Kernen im Remstal,20 - 25 Jahre,887,437,450
False,8119093,Kernen im Remstal,25 - 30 Jahre,1332,683,649
False,8119093,Kernen im Remstal,30 - 35 Jahre,1381,722,659
False,8119093,Kernen im Remstal,35 - 40 Jahre,1165,555,610
False,8119093,Kernen im Remstal,40 - 45 Jahre,973,494,479
False,8119093,Kernen im Remstal,45 - 50 Jahre,886,449,437
False,8119093,Kernen im Remstal,50 - 55 Jahre,1018,508,510
False,8119093,Kernen im Remstal,55 - 60 Jahre,1214,620,594
False,8119093,Kernen im Remstal,60 - 65 Jahre,796,372,424
False,8119093,Kernen im Remstal,65 - 75 Jahre,1184,514,670
False,8119093,Kernen im Remstal,75 und mehr Jahre,780,263,517
False,8119093,Kernen im Remstal,Insgesamt,14358,7100,7258
False,8121,Stadtkreis Heilbronn,unter 3 Jahre,3677,1885,1792
False,8121,Stadtkreis Heilbronn,3 -  6 Jahre,3753,1939,1814
False,8121,Stadtkreis Heilbronn,6 - 10 Jahre,4973,2512,2461
False,8121,Stadtkreis Heilbronn,10 - 15 Jahre,6122,3068,3054
False,8121,Stadtkreis Heilbronn,15 - 18 Jahre,3760,1939,1821
False,8121,Stadtkreis Heilbronn,18 - 20 Jahre,2589,1369,1220
False,8121,Stadtkreis Heilbronn,20 - 25 Jahre,8117,4249,3868
False,8121,Stadtkreis Heilbronn,25 - 30 Jahre,10427,5522,4905
False,8121,Stadtkreis Heilbronn,30 - 35 Jahre,10723,5739,4984
False,8121,Stadtkreis Heilbronn,35 - 40 Jahre,8917,4732,4185
False,8121,Stadtkreis Heilbronn,40 - 45 Jahre,7734,3860,3874
False,8121,Stadtkreis Heilbronn,45 - 50 Jahre,7367,3618,3749
False,8121,Stadtkreis Heilbronn,50 - 55 Jahre,7666,3860,3806
False,8121,Stadtkreis Heilbronn,55 - 60 Jahre,9002,4502,4500
False,8121,Stadtkreis Heilbronn,60 - 65 Jahre,6628,3223,3405
False,8121,Stadtkreis Heilbronn,65 - 75 Jahre,11379,4619,6760
False,8121,Stadtkreis Heilbronn,75 und mehr Jahre,8675,2544,6131
False,8121,Stadtkreis Heilbronn,Insgesamt,121509,59180,62329
False,8121000,"Heilbronn, Stadt",unter 3 Jahre,3677,1885,1792
False,8121000,"Heilbronn, Stadt",3 -  6 Jahre,3753,1939,1814
False,8121000,"Heilbronn, Stadt",6 - 10 Jahre,4973,2512,2461
False,8121000,"Heilbronn, Stadt",10 - 15 Jahre,6122,3068,3054
False,8121000,"Heilbronn, Stadt",15 - 18 Jahre,3760,1939,1821
False,8121000,"Heilbronn, Stadt",18 - 20 Jahre,2589,1369,1220
False,8121000,"Heilbronn, Stadt",20 - 25 Jahre,8117,4249,3868
False,8121000,"Heilbronn, Stadt",25 - 30 Jahre,10427,5522,4905
False,8121000,"Heilbronn, Stadt",30 - 35 Jahre,10723,5739,4984
False,8121000,"Heilbronn, Stadt",35 - 40 Jahre,8917,4732,4185
False,8121000,"Heilbronn, Stadt",40 - 45 Jahre,7734,3860,3874
False,8121000,"Heilbronn, Stadt",45 - 50 Jahre,7367,3618,3749
False,8121000,"Heilbronn, Stadt",50 - 55 Jahre,7666,3860,3806
False,8121000,"Heilbronn, Stadt",55 - 60 Jahre,9002,4502,4500
False,8121000,"Heilbronn, Stadt",60 - 65 Jahre,6628,3223,3405
False,8121000,"Heilbronn, Stadt",65 - 75 Jahre,11379,4619,6760
False,8121000,"Heilbronn, Stadt",75 und mehr Jahre,8675,2544,6131
False,8121000,"Heilbronn, Stadt",Insgesamt,121509,59180,62329
False,8125,Landkreis Heilbronn,unter 3 Jahre,11143,5772,5371
False,8125,Landkreis Heilbronn,3 -  6 Jahre,12288,6276,6012
False,8125,Landkreis Heilbronn,6 - 10 Jahre,16120,8259,7861
False,8125,Landkreis Heilbronn,10 - 15 Jahre,17878,9124,8754
False,8125,Landkreis Heilbronn,15 - 18 Jahre,10139,5214,4925
False,8125,Landkreis Heilbronn,18 - 20 Jahre,6425,3314,3111
False,8125,Landkreis Heilbronn,20 - 25 Jahre,18404,9361,9043
False,8125,Landkreis Heilbronn,25 - 30 Jahre,25134,12919,12215
False,8125,Landkreis Heilbronn,30 - 35 Jahre,27649,14229,13420
False,8125,Landkreis Heilbronn,35 - 40 Jahre,24675,12892,11783
False,8125,Landkreis Heilbronn,40 - 45 Jahre,21157,10786,10371
False,8125,Landkreis Heilbronn,45 - 50 Jahre,18664,9483,9181
False,8125,Landkreis Heilbronn,50 - 55 Jahre,17271,8807,8464
False,8125,Landkreis Heilbronn,55 - 60 Jahre,20294,10362,9932
False,8125,Landkreis Heilbronn,60 - 65 Jahre,15369,7629,7740
False,8125,Landkreis Heilbronn,65 - 75 Jahre,24450,10519,13931
False,8125,Landkreis Heilbronn,75 und mehr Jahre,16453,4987,11466
False,8125,Landkreis Heilbronn,Insgesamt,303513,149933,153580
False,8125001,Abstatt,unter 3 Jahre,168,84,84
False,8125001,Abstatt,3 -  6 Jahre,180,90,90
False,8125001,Abstatt,6 - 10 Jahre,251,127,124
False,8125001,Abstatt,10 - 15 Jahre,236,126,110
False,8125001,Abstatt,15 - 18 Jahre,140,71,69
False,8125001,Abstatt,18 - 20 Jahre,67,40,27
False,8125001,Abstatt,20 - 25 Jahre,260,132,128
False,8125001,Abstatt,25 - 30 Jahre,358,173,185
False,8125001,Abstatt,30 - 35 Jahre,359,175,184
False,8125001,Abstatt,35 - 40 Jahre,342,176,166
False,8125001,Abstatt,40 - 45 Jahre,338,175,163
False,8125001,Abstatt,45 - 50 Jahre,264,133,131
False,8125001,Abstatt,50 - 55 Jahre,260,138,122
False,8125001,Abstatt,55 - 60 Jahre,233,113,120
False,8125001,Abstatt,60 - 65 Jahre,149,75,74
False,8125001,Abstatt,65 - 75 Jahre,234,109,125
False,8125001,Abstatt,75 und mehr Jahre,131,40,91
False,8125001,Abstatt,Insgesamt,3970,1977,1993
False,8125005,"Bad Friedrichshall, Stadt",unter 3 Jahre,606,301,305
False,8125005,"Bad Friedrichshall, Stadt",3 -  6 Jahre,667,347,320
False,8125005,"Bad Friedrichshall, Stadt",6 - 10 Jahre,876,495,381
False,8125005,"Bad Friedrichshall, Stadt",10 - 15 Jahre,885,469,416
False,8125005,"Bad Friedrichshall, Stadt",15 - 18 Jahre,515,261,254
False,8125005,"Bad Friedrichshall, Stadt",18 - 20 Jahre,354,165,189
False,8125005,"Bad Friedrichshall, Stadt",20 - 25 Jahre,1062,511,551
False,8125005,"Bad Friedrichshall, Stadt",25 - 30 Jahre,1440,732,708
False,8125005,"Bad Friedrichshall, Stadt",30 - 35 Jahre,1523,767,756
False,8125005,"Bad Friedrichshall, Stadt",35 - 40 Jahre,1297,689,608
False,8125005,"Bad Friedrichshall, Stadt",40 - 45 Jahre,1117,602,515
False,8125005,"Bad Friedrichshall, Stadt",45 - 50 Jahre,900,454,446
False,8125005,"Bad Friedrichshall, Stadt",50 - 55 Jahre,778,407,371
False,8125005,"Bad Friedrichshall, Stadt",55 - 60 Jahre,976,459,517
False,8125005,"Bad Friedrichshall, Stadt",60 - 65 Jahre,759,391,368
False,8125005,"Bad Friedrichshall, Stadt",65 - 75 Jahre,1250,557,693
False,8125005,"Bad Friedrichshall, Stadt",75 und mehr Jahre,900,277,623
False,8125005,"Bad Friedrichshall, Stadt",Insgesamt,15905,7884,8021
False,8125006,"Bad Rappenau, Stadt",unter 3 Jahre,650,343,307
False,8125006,"Bad Rappenau, Stadt",3 -  6 Jahre,646,339,307
False,8125006,"Bad Rappenau, Stadt",6 - 10 Jahre,899,441,458
False,8125006,"Bad Rappenau, Stadt",10 - 15 Jahre,1050,510,540
False,8125006,"Bad Rappenau, Stadt",15 - 18 Jahre,561,292,269
False,8125006,"Bad Rappenau, Stadt",18 - 20 Jahre,363,185,178
False,8125006,"Bad Rappenau, Stadt",20 - 25 Jahre,1092,543,549
False,8125006,"Bad Rappenau, Stadt",25 - 30 Jahre,1464,713,751
False,8125006,"Bad Rappenau, Stadt",30 - 35 Jahre,1773,886,887
False,8125006,"Bad Rappenau, Stadt",35 - 40 Jahre,1512,777,735
False,8125006,"Bad Rappenau, Stadt",40 - 45 Jahre,1265,649,616
False,8125006,"Bad Rappenau, Stadt",45 - 50 Jahre,1125,553,572
False,8125006,"Bad Rappenau, Stadt",50 - 55 Jahre,1040,545,495
False,8125006,"Bad Rappenau, Stadt",55 - 60 Jahre,1204,598,606
False,8125006,"Bad Rappenau, Stadt",60 - 65 Jahre,960,462,498
False,8125006,"Bad Rappenau, Stadt",65 - 75 Jahre,1759,726,1033
False,8125006,"Bad Rappenau, Stadt",75 und mehr Jahre,1199,379,820
False,8125006,"Bad Rappenau, Stadt",Insgesamt,18562,8941,9621
False,8125007,"Bad Wimpfen, Stadt",unter 3 Jahre,189,104,85
False,8125007,"Bad Wimpfen, Stadt",3 -  6 Jahre,205,99,106
False,8125007,"Bad Wimpfen, Stadt",6 - 10 Jahre,290,150,140
False,8125007,"Bad Wimpfen, Stadt",10 - 15 Jahre,357,191,166
False,8125007,"Bad Wimpfen, Stadt",15 - 18 Jahre,226,108,118
False,8125007,"Bad Wimpfen, Stadt",18 - 20 Jahre,144,70,74
False,8125007,"Bad Wimpfen, Stadt",20 - 25 Jahre,373,208,165
False,8125007,"Bad Wimpfen, Stadt",25 - 30 Jahre,509,257,252
False,8125007,"Bad Wimpfen, Stadt",30 - 35 Jahre,517,286,231
False,8125007,"Bad Wimpfen, Stadt",35 - 40 Jahre,480,250,230
False,8125007,"Bad Wimpfen, Stadt",40 - 45 Jahre,471,235,236
False,8125007,"Bad Wimpfen, Stadt",45 - 50 Jahre,451,240,211
False,8125007,"Bad Wimpfen, Stadt",50 - 55 Jahre,446,234,212
False,8125007,"Bad Wimpfen, Stadt",55 - 60 Jahre,504,261,243
False,8125007,"Bad Wimpfen, Stadt",60 - 65 Jahre,384,188,196
False,8125007,"Bad Wimpfen, Stadt",65 - 75 Jahre,574,242,332
False,8125007,"Bad Wimpfen, Stadt",75 und mehr Jahre,550,174,376
False,8125007,"Bad Wimpfen, Stadt",Insgesamt,6670,3297,3373
False,8125008,"Beilstein, Stadt",unter 3 Jahre,204,108,96
False,8125008,"Beilstein, Stadt",3 -  6 Jahre,253,113,140
False,8125008,"Beilstein, Stadt",6 - 10 Jahre,332,162,170
False,8125008,"Beilstein, Stadt",10 - 15 Jahre,380,195,185
False,8125008,"Beilstein, Stadt",15 - 18 Jahre,208,105,103
False,8125008,"Beilstein, Stadt",18 - 20 Jahre,126,61,65
False,8125008,"Beilstein, Stadt",20 - 25 Jahre,365,169,196
False,8125008,"Beilstein, Stadt",25 - 30 Jahre,519,271,248
False,8125008,"Beilstein, Stadt",30 - 35 Jahre,464,243,221
False,8125008,"Beilstein, Stadt",35 - 40 Jahre,467,232,235
False,8125008,"Beilstein, Stadt",40 - 45 Jahre,395,187,208
False,8125008,"Beilstein, Stadt",45 - 50 Jahre,469,234,235
False,8125008,"Beilstein, Stadt",50 - 55 Jahre,456,230,226
False,8125008,"Beilstein, Stadt",55 - 60 Jahre,477,253,224
False,8125008,"Beilstein, Stadt",60 - 65 Jahre,303,155,148
False,8125008,"Beilstein, Stadt",65 - 75 Jahre,463,190,273
False,8125008,"Beilstein, Stadt",75 und mehr Jahre,384,115,269
False,8125008,"Beilstein, Stadt",Insgesamt,6265,3023,3242
False,8125013,"Brackenheim, Stadt",unter 3 Jahre,522,281,241
False,8125013,"Brackenheim, Stadt",3 -  6 Jahre,559,279,280
False,8125013,"Brackenheim, Stadt",6 - 10 Jahre,782,343,439
False,8125013,"Brackenheim, Stadt",10 - 15 Jahre,824,407,417
False,8125013,"Brackenheim, Stadt",15 - 18 Jahre,440,250,190
False,8125013,"Brackenheim, Stadt",18 - 20 Jahre,295,167,128
False,8125013,"Brackenheim, Stadt",20 - 25 Jahre,808,401,407
False,8125013,"Brackenheim, Stadt",25 - 30 Jahre,1088,538,550
False,8125013,"Brackenheim, Stadt",30 - 35 Jahre,1261,666,595
False,8125013,"Brackenheim, Stadt",35 - 40 Jahre,1111,581,530
False,8125013,"Brackenheim, Stadt",40 - 45 Jahre,969,480,489
False,8125013,"Brackenheim, Stadt",45 - 50 Jahre,757,413,344
False,8125013,"Brackenheim, Stadt",50 - 55 Jahre,733,375,358
False,8125013,"Brackenheim, Stadt",55 - 60 Jahre,761,381,380
False,8125013,"Brackenheim, Stadt",60 - 65 Jahre,668,330,338
False,8125013,"Brackenheim, Stadt",65 - 75 Jahre,999,409,590
False,8125013,"Brackenheim, Stadt",75 und mehr Jahre,695,214,481
False,8125013,"Brackenheim, Stadt",Insgesamt,13272,6515,6757
False,8125017,Cleebronn,unter 3 Jahre,131,68,63
False,8125017,Cleebronn,3 -  6 Jahre,130,67,63
False,8125017,Cleebronn,6 - 10 Jahre,156,88,68
False,8125017,Cleebronn,10 - 15 Jahre,182,103,79
False,8125017,Cleebronn,15 - 18 Jahre,89,54,35
False,8125017,Cleebronn,18 - 20 Jahre,58,25,33
False,8125017,Cleebronn,20 - 25 Jahre,181,90,91
False,8125017,Cleebronn,25 - 30 Jahre,263,126,137
False,8125017,Cleebronn,30 - 35 Jahre,274,157,117
False,8125017,Cleebronn,35 - 40 Jahre,226,118,108
False,8125017,Cleebronn,40 - 45 Jahre,178,88,90
False,8125017,Cleebronn,45 - 50 Jahre,145,76,69
False,8125017,Cleebronn,50 - 55 Jahre,140,73,67
False,8125017,Cleebronn,55 - 60 Jahre,161,85,76
False,8125017,Cleebronn,60 - 65 Jahre,114,55,59
False,8125017,Cleebronn,65 - 75 Jahre,163,67,96
False,8125017,Cleebronn,75 und mehr Jahre,127,43,84
False,8125017,Cleebronn,Insgesamt,2718,1383,1335
False,8125021,Eberstadt,unter 3 Jahre,97,47,50
False,8125021,Eberstadt,3 -  6 Jahre,129,67,62
False,8125021,Eberstadt,6 - 10 Jahre,160,80,80
False,8125021,Eberstadt,10 - 15 Jahre,173,85,88
False,8125021,Eberstadt,15 - 18 Jahre,80,50,30
False,8125021,Eberstadt,18 - 20 Jahre,59,37,22
False,8125021,Eberstadt,20 - 25 Jahre,185,94,91
False,8125021,Eberstadt,25 - 30 Jahre,223,111,112
False,8125021,Eberstadt,30 - 35 Jahre,246,107,139
False,8125021,Eberstadt,35 - 40 Jahre,241,126,115
False,8125021,Eberstadt,40 - 45 Jahre,217,110,107
False,8125021,Eberstadt,45 - 50 Jahre,177,91,86
False,8125021,Eberstadt,50 - 55 Jahre,185,88,97
False,8125021,Eberstadt,55 - 60 Jahre,211,110,101
False,8125021,Eberstadt,60 - 65 Jahre,159,89,70
False,8125021,Eberstadt,65 - 75 Jahre,240,100,140
False,8125021,Eberstadt,75 und mehr Jahre,136,38,98
False,8125021,Eberstadt,Insgesamt,2918,1430,1488
False,8125024,Ellhofen,unter 3 Jahre,109,55,54
False,8125024,Ellhofen,3 -  6 Jahre,125,52,73
False,8125024,Ellhofen,6 - 10 Jahre,169,91,78
False,8125024,Ellhofen,10 - 15 Jahre,173,96,77
False,8125024,Ellhofen,15 - 18 Jahre,95,56,39
False,8125024,Ellhofen,18 - 20 Jahre,59,27,32
False,8125024,Ellhofen,20 - 25 Jahre,175,104,71
False,8125024,Ellhofen,25 - 30 Jahre,209,111,98
False,8125024,Ellhofen,30 - 35 Jahre,277,136,141
False,8125024,Ellhofen,35 - 40 Jahre,283,146,137
False,8125024,Ellhofen,40 - 45 Jahre,245,126,119
False,8125024,Ellhofen,45 - 50 Jahre,179,99,80
False,8125024,Ellhofen,50 - 55 Jahre,194,90,104
False,8125024,Ellhofen,55 - 60 Jahre,222,111,111
False,8125024,Ellhofen,60 - 65 Jahre,162,74,88
False,8125024,Ellhofen,65 - 75 Jahre,231,101,130
False,8125024,Ellhofen,75 und mehr Jahre,150,48,102
False,8125024,Ellhofen,Insgesamt,3057,1523,1534
False,8125026,"Eppingen, Stadt",unter 3 Jahre,693,370,323
False,8125026,"Eppingen, Stadt",3 -  6 Jahre,780,416,364
False,8125026,"Eppingen, Stadt",6 - 10 Jahre,1083,537,546
False,8125026,"Eppingen, Stadt",10 - 15 Jahre,1202,633,569
False,8125026,"Eppingen, Stadt",15 - 18 Jahre,678,346,332
False,8125026,"Eppingen, Stadt",18 - 20 Jahre,383,193,190
False,8125026,"Eppingen, Stadt",20 - 25 Jahre,1125,587,538
False,8125026,"Eppingen, Stadt",25 - 30 Jahre,1579,773,806
False,8125026,"Eppingen, Stadt",30 - 35 Jahre,1643,832,811
False,8125026,"Eppingen, Stadt",35 - 40 Jahre,1505,776,729
False,8125026,"Eppingen, Stadt",40 - 45 Jahre,1269,645,624
False,8125026,"Eppingen, Stadt",45 - 50 Jahre,1123,595,528
False,8125026,"Eppingen, Stadt",50 - 55 Jahre,839,444,395
False,8125026,"Eppingen, Stadt",55 - 60 Jahre,1221,591,630
False,8125026,"Eppingen, Stadt",60 - 65 Jahre,979,472,507
False,8125026,"Eppingen, Stadt",65 - 75 Jahre,1525,649,876
False,8125026,"Eppingen, Stadt",75 und mehr Jahre,1061,272,789
False,8125026,"Eppingen, Stadt",Insgesamt,18688,9131,9557
False,8125027,Erlenbach,unter 3 Jahre,155,91,64
False,8125027,Erlenbach,3 -  6 Jahre,173,101,72
False,8125027,Erlenbach,6 - 10 Jahre,230,124,106
False,8125027,Erlenbach,10 - 15 Jahre,213,107,106
False,8125027,Erlenbach,15 - 18 Jahre,124,70,54
False,8125027,Erlenbach,18 - 20 Jahre,70,32,38
False,8125027,Erlenbach,20 - 25 Jahre,285,132,153
False,8125027,Erlenbach,25 - 30 Jahre,452,234,218
False,8125027,Erlenbach,30 - 35 Jahre,463,240,223
False,8125027,Erlenbach,35 - 40 Jahre,359,192,167
False,8125027,Erlenbach,40 - 45 Jahre,282,144,138
False,8125027,Erlenbach,45 - 50 Jahre,264,134,130
False,8125027,Erlenbach,50 - 55 Jahre,287,136,151
False,8125027,Erlenbach,55 - 60 Jahre,326,177,149
False,8125027,Erlenbach,60 - 65 Jahre,239,121,118
False,8125027,Erlenbach,65 - 75 Jahre,369,163,206
False,8125027,Erlenbach,75 und mehr Jahre,205,76,129
False,8125027,Erlenbach,Insgesamt,4496,2274,2222
False,8125030,Flein,unter 3 Jahre,166,83,83
False,8125030,Flein,3 -  6 Jahre,163,70,93
False,8125030,Flein,6 - 10 Jahre,225,111,114
False,8125030,Flein,10 - 15 Jahre,272,136,136
False,8125030,Flein,15 - 18 Jahre,169,74,95
False,8125030,Flein,18 - 20 Jahre,87,42,45
False,8125030,Flein,20 - 25 Jahre,299,166,133
False,8125030,Flein,25 - 30 Jahre,426,203,223
False,8125030,Flein,30 - 35 Jahre,477,224,253
False,8125030,Flein,35 - 40 Jahre,405,204,201
False,8125030,Flein,40 - 45 Jahre,347,169,178
False,8125030,Flein,45 - 50 Jahre,392,176,216
False,8125030,Flein,50 - 55 Jahre,407,176,231
False,8125030,Flein,55 - 60 Jahre,535,265,270
False,8125030,Flein,60 - 65 Jahre,397,218,179
False,8125030,Flein,65 - 75 Jahre,570,249,321
False,8125030,Flein,75 und mehr Jahre,373,133,240
False,8125030,Flein,Insgesamt,5710,2699,3011
False,8125034,Gemmingen,unter 3 Jahre,199,95,104
False,8125034,Gemmingen,3 -  6 Jahre,217,129,88
False,8125034,Gemmingen,6 - 10 Jahre,269,140,129
False,8125034,Gemmingen,10 - 15 Jahre,265,128,137
False,8125034,Gemmingen,15 - 18 Jahre,174,99,75
False,8125034,Gemmingen,18 - 20 Jahre,90,48,42
False,8125034,Gemmingen,20 - 25 Jahre,276,146,130
False,8125034,Gemmingen,25 - 30 Jahre,383,198,185
False,8125034,Gemmingen,30 - 35 Jahre,421,221,200
False,8125034,Gemmingen,35 - 40 Jahre,357,173,184
False,8125034,Gemmingen,40 - 45 Jahre,338,170,168
False,8125034,Gemmingen,45 - 50 Jahre,292,151,141
False,8125034,Gemmingen,50 - 55 Jahre,267,144,123
False,8125034,Gemmingen,55 - 60 Jahre,330,174,156
False,8125034,Gemmingen,60 - 65 Jahre,246,122,124
False,8125034,Gemmingen,65 - 75 Jahre,372,171,201
False,8125034,Gemmingen,75 und mehr Jahre,206,68,138
False,8125034,Gemmingen,Insgesamt,4702,2377,2325
False,8125038,"Güglingen, Stadt",unter 3 Jahre,238,116,122
False,8125038,"Güglingen, Stadt",3 -  6 Jahre,301,157,144
False,8125038,"Güglingen, Stadt",6 - 10 Jahre,385,195,190
False,8125038,"Güglingen, Stadt",10 - 15 Jahre,418,196,222
False,8125038,"Güglingen, Stadt",15 - 18 Jahre,207,115,92
False,8125038,"Güglingen, Stadt",18 - 20 Jahre,157,78,79
False,8125038,"Güglingen, Stadt",20 - 25 Jahre,412,228,184
False,8125038,"Güglingen, Stadt",25 - 30 Jahre,538,279,259
False,8125038,"Güglingen, Stadt",30 - 35 Jahre,611,320,291
False,8125038,"Güglingen, Stadt",35 - 40 Jahre,453,249,204
False,8125038,"Güglingen, Stadt",40 - 45 Jahre,370,179,191
False,8125038,"Güglingen, Stadt",45 - 50 Jahre,373,198,175
False,8125038,"Güglingen, Stadt",50 - 55 Jahre,349,180,169
False,8125038,"Güglingen, Stadt",55 - 60 Jahre,340,164,176
False,8125038,"Güglingen, Stadt",60 - 65 Jahre,256,126,130
False,8125038,"Güglingen, Stadt",65 - 75 Jahre,374,160,214
False,8125038,"Güglingen, Stadt",75 und mehr Jahre,264,90,174
False,8125038,"Güglingen, Stadt",Insgesamt,6046,3030,3016
False,8125039,"Gundelsheim, Stadt",unter 3 Jahre,256,129,127
False,8125039,"Gundelsheim, Stadt",3 -  6 Jahre,289,132,157
False,8125039,"Gundelsheim, Stadt",6 - 10 Jahre,412,225,187
False,8125039,"Gundelsheim, Stadt",10 - 15 Jahre,411,212,199
False,8125039,"Gundelsheim, Stadt",15 - 18 Jahre,230,101,129
False,8125039,"Gundelsheim, Stadt",18 - 20 Jahre,189,104,85
False,8125039,"Gundelsheim, Stadt",20 - 25 Jahre,454,219,235
False,8125039,"Gundelsheim, Stadt",25 - 30 Jahre,571,300,271
False,8125039,"Gundelsheim, Stadt",30 - 35 Jahre,661,333,328
False,8125039,"Gundelsheim, Stadt",35 - 40 Jahre,565,306,259
False,8125039,"Gundelsheim, Stadt",40 - 45 Jahre,496,246,250
False,8125039,"Gundelsheim, Stadt",45 - 50 Jahre,461,239,222
False,8125039,"Gundelsheim, Stadt",50 - 55 Jahre,426,211,215
False,8125039,"Gundelsheim, Stadt",55 - 60 Jahre,488,263,225
False,8125039,"Gundelsheim, Stadt",60 - 65 Jahre,388,189,199
False,8125039,"Gundelsheim, Stadt",65 - 75 Jahre,587,235,352
False,8125039,"Gundelsheim, Stadt",75 und mehr Jahre,509,128,381
False,8125039,"Gundelsheim, Stadt",Insgesamt,7393,3572,3821
False,8125046,Ilsfeld,unter 3 Jahre,267,129,138
False,8125046,Ilsfeld,3 -  6 Jahre,321,170,151
False,8125046,Ilsfeld,6 - 10 Jahre,412,200,212
False,8125046,Ilsfeld,10 - 15 Jahre,440,222,218
False,8125046,Ilsfeld,15 - 18 Jahre,251,129,122
False,8125046,Ilsfeld,18 - 20 Jahre,157,86,71
False,8125046,Ilsfeld,20 - 25 Jahre,473,252,221
False,8125046,Ilsfeld,25 - 30 Jahre,644,334,310
False,8125046,Ilsfeld,30 - 35 Jahre,695,357,338
False,8125046,Ilsfeld,35 - 40 Jahre,602,327,275
False,8125046,Ilsfeld,40 - 45 Jahre,559,275,284
False,8125046,Ilsfeld,45 - 50 Jahre,546,274,272
False,8125046,Ilsfeld,50 - 55 Jahre,528,270,258
False,8125046,Ilsfeld,55 - 60 Jahre,584,293,291
False,8125046,Ilsfeld,60 - 65 Jahre,337,182,155
False,8125046,Ilsfeld,65 - 75 Jahre,530,231,299
False,8125046,Ilsfeld,75 und mehr Jahre,363,122,241
False,8125046,Ilsfeld,Insgesamt,7709,3853,3856
False,8125047,Ittlingen,unter 3 Jahre,100,53,47
False,8125047,Ittlingen,3 -  6 Jahre,115,54,61
False,8125047,Ittlingen,6 - 10 Jahre,126,66,60
False,8125047,Ittlingen,10 - 15 Jahre,131,73,58
False,8125047,Ittlingen,15 - 18 Jahre,66,39,27
False,8125047,Ittlingen,18 - 20 Jahre,50,29,21
False,8125047,Ittlingen,20 - 25 Jahre,139,68,71
False,8125047,Ittlingen,25 - 30 Jahre,189,105,84
False,8125047,Ittlingen,30 - 35 Jahre,192,91,101
False,8125047,Ittlingen,35 - 40 Jahre,210,119,91
False,8125047,Ittlingen,40 - 45 Jahre,149,84,65
False,8125047,Ittlingen,45 - 50 Jahre,123,63,60
False,8125047,Ittlingen,50 - 55 Jahre,97,46,51
False,8125047,Ittlingen,55 - 60 Jahre,151,88,63
False,8125047,Ittlingen,60 - 65 Jahre,99,50,49
False,8125047,Ittlingen,65 - 75 Jahre,153,67,86
False,8125047,Ittlingen,75 und mehr Jahre,103,29,74
False,8125047,Ittlingen,Insgesamt,2193,1124,1069
False,8125048,Jagsthausen,unter 3 Jahre,49,24,25
False,8125048,Jagsthausen,3 -  6 Jahre,60,35,25
False,8125048,Jagsthausen,6 - 10 Jahre,62,32,30
False,8125048,Jagsthausen,10 - 15 Jahre,84,41,43
False,8125048,Jagsthausen,15 - 18 Jahre,48,29,19
False,8125048,Jagsthausen,18 - 20 Jahre,27,13,14
False,8125048,Jagsthausen,20 - 25 Jahre,82,45,37
False,8125048,Jagsthausen,25 - 30 Jahre,91,63,28
False,8125048,Jagsthausen,30 - 35 Jahre,133,62,71
False,8125048,Jagsthausen,35 - 40 Jahre,127,74,53
False,8125048,Jagsthausen,40 - 45 Jahre,73,33,40
False,8125048,Jagsthausen,45 - 50 Jahre,80,32,48
False,8125048,Jagsthausen,50 - 55 Jahre,86,45,41
False,8125048,Jagsthausen,55 - 60 Jahre,116,63,53
False,8125048,Jagsthausen,60 - 65 Jahre,95,50,45
False,8125048,Jagsthausen,65 - 75 Jahre,136,65,71
False,8125048,Jagsthausen,75 und mehr Jahre,107,24,83
False,8125048,Jagsthausen,Insgesamt,1456,730,726
False,8125049,Kirchardt,unter 3 Jahre,220,103,117
False,8125049,Kirchardt,3 -  6 Jahre,261,143,118
False,8125049,Kirchardt,6 - 10 Jahre,333,176,157
False,8125049,Kirchardt,10 - 15 Jahre,362,200,162
False,8125049,Kirchardt,15 - 18 Jahre,195,102,93
False,8125049,Kirchardt,18 - 20 Jahre,122,60,62
False,8125049,Kirchardt,20 - 25 Jahre,356,185,171
False,8125049,Kirchardt,25 - 30 Jahre,432,221,211
False,8125049,Kirchardt,30 - 35 Jahre,416,209,207
False,8125049,Kirchardt,35 - 40 Jahre,393,212,181
False,8125049,Kirchardt,40 - 45 Jahre,347,179,168
False,8125049,Kirchardt,45 - 50 Jahre,297,144,153
False,8125049,Kirchardt,50 - 55 Jahre,250,128,122
False,8125049,Kirchardt,55 - 60 Jahre,311,173,138
False,8125049,Kirchardt,60 - 65 Jahre,240,122,118
False,8125049,Kirchardt,65 - 75 Jahre,316,129,187
False,8125049,Kirchardt,75 und mehr Jahre,176,53,123
False,8125049,Kirchardt,Insgesamt,5027,2539,2488
False,8125056,"Lauffen am Neckar, Stadt",unter 3 Jahre,413,221,192
False,8125056,"Lauffen am Neckar, Stadt",3 -  6 Jahre,374,198,176
False,8125056,"Lauffen am Neckar, Stadt",6 - 10 Jahre,584,278,306
False,8125056,"Lauffen am Neckar, Stadt",10 - 15 Jahre,572,302,270
False,8125056,"Lauffen am Neckar, Stadt",15 - 18 Jahre,345,171,174
False,8125056,"Lauffen am Neckar, Stadt",18 - 20 Jahre,228,115,113
False,8125056,"Lauffen am Neckar, Stadt",20 - 25 Jahre,604,278,326
False,8125056,"Lauffen am Neckar, Stadt",25 - 30 Jahre,846,394,452
False,8125056,"Lauffen am Neckar, Stadt",30 - 35 Jahre,1035,552,483
False,8125056,"Lauffen am Neckar, Stadt",35 - 40 Jahre,843,443,400
False,8125056,"Lauffen am Neckar, Stadt",40 - 45 Jahre,717,356,361
False,8125056,"Lauffen am Neckar, Stadt",45 - 50 Jahre,678,323,355
False,8125056,"Lauffen am Neckar, Stadt",50 - 55 Jahre,590,304,286
False,8125056,"Lauffen am Neckar, Stadt",55 - 60 Jahre,710,380,330
False,8125056,"Lauffen am Neckar, Stadt",60 - 65 Jahre,539,246,293
False,8125056,"Lauffen am Neckar, Stadt",65 - 75 Jahre,939,414,525
False,8125056,"Lauffen am Neckar, Stadt",75 und mehr Jahre,542,141,401
False,8125056,"Lauffen am Neckar, Stadt",Insgesamt,10559,5116,5443
False,8125057,Lehrensteinsfeld,unter 3 Jahre,51,26,25
False,8125057,Lehrensteinsfeld,3 -  6 Jahre,73,47,26
False,8125057,Lehrensteinsfeld,6 - 10 Jahre,72,36,36
False,8125057,Lehrensteinsfeld,10 - 15 Jahre,100,53,47
False,8125057,Lehrensteinsfeld,15 - 18 Jahre,64,35,29
False,8125057,Lehrensteinsfeld,18 - 20 Jahre,50,27,23
False,8125057,Lehrensteinsfeld,20 - 25 Jahre,97,46,51
False,8125057,Lehrensteinsfeld,25 - 30 Jahre,93,51,42
False,8125057,Lehrensteinsfeld,30 - 35 Jahre,122,61,61
False,8125057,Lehrensteinsfeld,35 - 40 Jahre,114,61,53
False,8125057,Lehrensteinsfeld,40 - 45 Jahre,139,63,76
False,8125057,Lehrensteinsfeld,45 - 50 Jahre,152,71,81
False,8125057,Lehrensteinsfeld,50 - 55 Jahre,126,64,62
False,8125057,Lehrensteinsfeld,55 - 60 Jahre,124,76,48
False,8125057,Lehrensteinsfeld,60 - 65 Jahre,93,41,52
False,8125057,Lehrensteinsfeld,65 - 75 Jahre,128,55,73
False,8125057,Lehrensteinsfeld,75 und mehr Jahre,77,30,47
False,8125057,Lehrensteinsfeld,Insgesamt,1675,843,832
False,8125058,Leingarten,unter 3 Jahre,319,168,151
False,8125058,Leingarten,3 -  6 Jahre,350,160,190
False,8125058,Leingarten,6 - 10 Jahre,466,253,213
False,8125058,Leingarten,10 - 15 Jahre,510,261,249
False,8125058,Leingarten,15 - 18 Jahre,293,149,144
False,8125058,Leingarten,18 - 20 Jahre,182,90,92
False,8125058,Leingarten,20 - 25 Jahre,587,279,308
False,8125058,Leingarten,25 - 30 Jahre,748,407,341
False,8125058,Leingarten,30 - 35 Jahre,838,399,439
False,8125058,Leingarten,35 - 40 Jahre,736,375,361
False,8125058,Leingarten,40 - 45 Jahre,674,337,337
False,8125058,Leingarten,45 - 50 Jahre,594,291,303
False,8125058,Leingarten,50 - 55 Jahre,595,300,295
False,8125058,Leingarten,55 - 60 Jahre,628,319,309
False,8125058,Leingarten,60 - 65 Jahre,438,212,226
False,8125058,Leingarten,65 - 75 Jahre,717,319,398
False,8125058,Leingarten,75 und mehr Jahre,478,139,339
False,8125058,Leingarten,Insgesamt,9153,4458,4695
False,8125059,"Löwenstein, Stadt",unter 3 Jahre,104,53,51
False,8125059,"Löwenstein, Stadt",3 -  6 Jahre,127,71,56
False,8125059,"Löwenstein, Stadt",6 - 10 Jahre,139,64,75
False,8125059,"Löwenstein, Stadt",10 - 15 Jahre,153,73,80
False,8125059,"Löwenstein, Stadt",15 - 18 Jahre,84,42,42
False,8125059,"Löwenstein, Stadt",18 - 20 Jahre,66,32,34
False,8125059,"Löwenstein, Stadt",20 - 25 Jahre,138,67,71
False,8125059,"Löwenstein, Stadt",25 - 30 Jahre,245,123,122
False,8125059,"Löwenstein, Stadt",30 - 35 Jahre,315,162,153
False,8125059,"Löwenstein, Stadt",35 - 40 Jahre,272,135,137
False,8125059,"Löwenstein, Stadt",40 - 45 Jahre,248,129,119
False,8125059,"Löwenstein, Stadt",45 - 50 Jahre,197,111,86
False,8125059,"Löwenstein, Stadt",50 - 55 Jahre,138,66,72
False,8125059,"Löwenstein, Stadt",55 - 60 Jahre,208,98,110
False,8125059,"Löwenstein, Stadt",60 - 65 Jahre,128,61,67
False,8125059,"Löwenstein, Stadt",65 - 75 Jahre,256,99,157
False,8125059,"Löwenstein, Stadt",75 und mehr Jahre,154,56,98
False,8125059,"Löwenstein, Stadt",Insgesamt,2972,1442,1530
False,8125061,Massenbachhausen,unter 3 Jahre,137,69,68
False,8125061,Massenbachhausen,3 -  6 Jahre,163,84,79
False,8125061,Massenbachhausen,6 - 10 Jahre,227,129,98
False,8125061,Massenbachhausen,10 - 15 Jahre,218,102,116
False,8125061,Massenbachhausen,15 - 18 Jahre,122,59,63
False,8125061,Massenbachhausen,18 - 20 Jahre,74,37,37
False,8125061,Massenbachhausen,20 - 25 Jahre,208,106,102
False,8125061,Massenbachhausen,25 - 30 Jahre,331,164,167
False,8125061,Massenbachhausen,30 - 35 Jahre,367,202,165
False,8125061,Massenbachhausen,35 - 40 Jahre,309,151,158
False,8125061,Massenbachhausen,40 - 45 Jahre,257,129,128
False,8125061,Massenbachhausen,45 - 50 Jahre,198,107,91
False,8125061,Massenbachhausen,50 - 55 Jahre,203,100,103
False,8125061,Massenbachhausen,55 - 60 Jahre,225,112,113
False,8125061,Massenbachhausen,60 - 65 Jahre,173,88,85
False,8125061,Massenbachhausen,65 - 75 Jahre,229,104,125
False,8125061,Massenbachhausen,75 und mehr Jahre,138,35,103
False,8125061,Massenbachhausen,Insgesamt,3579,1778,1801
False,8125063,"Möckmühl, Stadt",unter 3 Jahre,284,143,141
False,8125063,"Möckmühl, Stadt",3 -  6 Jahre,330,152,178
False,8125063,"Möckmühl, Stadt",6 - 10 Jahre,444,239,205
False,8125063,"Möckmühl, Stadt",10 - 15 Jahre,545,307,238
False,8125063,"Möckmühl, Stadt",15 - 18 Jahre,303,147,156
False,8125063,"Möckmühl, Stadt",18 - 20 Jahre,210,105,105
False,8125063,"Möckmühl, Stadt",20 - 25 Jahre,517,291,226
False,8125063,"Möckmühl, Stadt",25 - 30 Jahre,648,365,283
False,8125063,"Möckmühl, Stadt",30 - 35 Jahre,709,395,314
False,8125063,"Möckmühl, Stadt",35 - 40 Jahre,686,374,312
False,8125063,"Möckmühl, Stadt",40 - 45 Jahre,618,327,291
False,8125063,"Möckmühl, Stadt",45 - 50 Jahre,449,219,230
False,8125063,"Möckmühl, Stadt",50 - 55 Jahre,376,187,189
False,8125063,"Möckmühl, Stadt",55 - 60 Jahre,500,254,246
False,8125063,"Möckmühl, Stadt",60 - 65 Jahre,384,194,190
False,8125063,"Möckmühl, Stadt",65 - 75 Jahre,672,270,402
False,8125063,"Möckmühl, Stadt",75 und mehr Jahre,447,144,303
False,8125063,"Möckmühl, Stadt",Insgesamt,8122,4113,4009
False,8125065,"Neckarsulm, Stadt",unter 3 Jahre,889,443,446
False,8125065,"Neckarsulm, Stadt",3 -  6 Jahre,973,532,441
False,8125065,"Neckarsulm, Stadt",6 - 10 Jahre,1220,644,576
False,8125065,"Neckarsulm, Stadt",10 - 15 Jahre,1492,743,749
False,8125065,"Neckarsulm, Stadt",15 - 18 Jahre,898,477,421
False,8125065,"Neckarsulm, Stadt",18 - 20 Jahre,621,323,298
False,8125065,"Neckarsulm, Stadt",20 - 25 Jahre,1779,914,865
False,8125065,"Neckarsulm, Stadt",25 - 30 Jahre,2240,1208,1032
False,8125065,"Neckarsulm, Stadt",30 - 35 Jahre,2218,1150,1068
False,8125065,"Neckarsulm, Stadt",35 - 40 Jahre,2047,1085,962
False,8125065,"Neckarsulm, Stadt",40 - 45 Jahre,1770,917,853
False,8125065,"Neckarsulm, Stadt",45 - 50 Jahre,1556,782,774
False,8125065,"Neckarsulm, Stadt",50 - 55 Jahre,1508,761,747
False,8125065,"Neckarsulm, Stadt",55 - 60 Jahre,1710,880,830
False,8125065,"Neckarsulm, Stadt",60 - 65 Jahre,1309,654,655
False,8125065,"Neckarsulm, Stadt",65 - 75 Jahre,2161,930,1231
False,8125065,"Neckarsulm, Stadt",75 und mehr Jahre,1397,431,966
False,8125065,"Neckarsulm, Stadt",Insgesamt,25788,12874,12914
False,8125066,Neckarwestheim,unter 3 Jahre,146,72,74
False,8125066,Neckarwestheim,3 -  6 Jahre,120,53,67
False,8125066,Neckarwestheim,6 - 10 Jahre,184,99,85
False,8125066,Neckarwestheim,10 - 15 Jahre,182,85,97
False,8125066,Neckarwestheim,15 - 18 Jahre,116,60,56
False,8125066,Neckarwestheim,18 - 20 Jahre,55,27,28
False,8125066,Neckarwestheim,20 - 25 Jahre,205,91,114
False,8125066,Neckarwestheim,25 - 30 Jahre,338,175,163
False,8125066,Neckarwestheim,30 - 35 Jahre,342,188,154
False,8125066,Neckarwestheim,35 - 40 Jahre,280,149,131
False,8125066,Neckarwestheim,40 - 45 Jahre,233,130,103
False,8125066,Neckarwestheim,45 - 50 Jahre,216,111,105
False,8125066,Neckarwestheim,50 - 55 Jahre,209,107,102
False,8125066,Neckarwestheim,55 - 60 Jahre,195,106,89
False,8125066,Neckarwestheim,60 - 65 Jahre,148,73,75
False,8125066,Neckarwestheim,65 - 75 Jahre,181,79,102
False,8125066,Neckarwestheim,75 und mehr Jahre,95,25,70
False,8125066,Neckarwestheim,Insgesamt,3245,1630,1615
False,8125068,"Neudenau, Stadt",unter 3 Jahre,194,96,98
False,8125068,"Neudenau, Stadt",3 -  6 Jahre,206,102,104
False,8125068,"Neudenau, Stadt",6 - 10 Jahre,260,127,133
False,8125068,"Neudenau, Stadt",10 - 15 Jahre,287,160,127
False,8125068,"Neudenau, Stadt",15 - 18 Jahre,183,98,85
False,8125068,"Neudenau, Stadt",18 - 20 Jahre,102,60,42
False,8125068,"Neudenau, Stadt",20 - 25 Jahre,309,156,153
False,8125068,"Neudenau, Stadt",25 - 30 Jahre,424,222,202
False,8125068,"Neudenau, Stadt",30 - 35 Jahre,428,230,198
False,8125068,"Neudenau, Stadt",35 - 40 Jahre,422,230,192
False,8125068,"Neudenau, Stadt",40 - 45 Jahre,338,175,163
False,8125068,"Neudenau, Stadt",45 - 50 Jahre,305,165,140
False,8125068,"Neudenau, Stadt",50 - 55 Jahre,240,112,128
False,8125068,"Neudenau, Stadt",55 - 60 Jahre,327,175,152
False,8125068,"Neudenau, Stadt",60 - 65 Jahre,250,120,130
False,8125068,"Neudenau, Stadt",65 - 75 Jahre,470,189,281
False,8125068,"Neudenau, Stadt",75 und mehr Jahre,301,98,203
False,8125068,"Neudenau, Stadt",Insgesamt,5046,2515,2531
False,8125069,"Neuenstadt am Kocher, Stadt",unter 3 Jahre,338,177,161
False,8125069,"Neuenstadt am Kocher, Stadt",3 -  6 Jahre,372,180,192
False,8125069,"Neuenstadt am Kocher, Stadt",6 - 10 Jahre,447,231,216
False,8125069,"Neuenstadt am Kocher, Stadt",10 - 15 Jahre,574,321,253
False,8125069,"Neuenstadt am Kocher, Stadt",15 - 18 Jahre,350,176,174
False,8125069,"Neuenstadt am Kocher, Stadt",18 - 20 Jahre,195,101,94
False,8125069,"Neuenstadt am Kocher, Stadt",20 - 25 Jahre,551,282,269
False,8125069,"Neuenstadt am Kocher, Stadt",25 - 30 Jahre,687,348,339
False,8125069,"Neuenstadt am Kocher, Stadt",30 - 35 Jahre,812,433,379
False,8125069,"Neuenstadt am Kocher, Stadt",35 - 40 Jahre,703,381,322
False,8125069,"Neuenstadt am Kocher, Stadt",40 - 45 Jahre,705,347,358
False,8125069,"Neuenstadt am Kocher, Stadt",45 - 50 Jahre,558,281,277
False,8125069,"Neuenstadt am Kocher, Stadt",50 - 55 Jahre,465,258,207
False,8125069,"Neuenstadt am Kocher, Stadt",55 - 60 Jahre,582,289,293
False,8125069,"Neuenstadt am Kocher, Stadt",60 - 65 Jahre,384,193,191
False,8125069,"Neuenstadt am Kocher, Stadt",65 - 75 Jahre,661,291,370
False,8125069,"Neuenstadt am Kocher, Stadt",75 und mehr Jahre,404,116,288
False,8125069,"Neuenstadt am Kocher, Stadt",Insgesamt,8788,4405,4383
False,8125074,Nordheim,unter 3 Jahre,218,107,111
False,8125074,Nordheim,3 -  6 Jahre,253,137,116
False,8125074,Nordheim,6 - 10 Jahre,351,181,170
False,8125074,Nordheim,10 - 15 Jahre,379,198,181
False,8125074,Nordheim,15 - 18 Jahre,225,117,108
False,8125074,Nordheim,18 - 20 Jahre,121,78,43
False,8125074,Nordheim,20 - 25 Jahre,342,171,171
False,8125074,Nordheim,25 - 30 Jahre,505,265,240
False,8125074,Nordheim,30 - 35 Jahre,559,282,277
False,8125074,Nordheim,35 - 40 Jahre,469,232,237
False,8125074,Nordheim,40 - 45 Jahre,434,209,225
False,8125074,Nordheim,45 - 50 Jahre,417,207,210
False,8125074,Nordheim,50 - 55 Jahre,384,196,188
False,8125074,Nordheim,55 - 60 Jahre,434,228,206
False,8125074,Nordheim,60 - 65 Jahre,358,175,183
False,8125074,Nordheim,65 - 75 Jahre,537,240,297
False,8125074,Nordheim,75 und mehr Jahre,337,97,240
False,8125074,Nordheim,Insgesamt,6323,3120,3203
False,8125078,Oedheim,unter 3 Jahre,247,138,109
False,8125078,Oedheim,3 -  6 Jahre,234,116,118
False,8125078,Oedheim,6 - 10 Jahre,297,160,137
False,8125078,Oedheim,10 - 15 Jahre,311,160,151
False,8125078,Oedheim,15 - 18 Jahre,177,100,77
False,8125078,Oedheim,18 - 20 Jahre,114,57,57
False,8125078,Oedheim,20 - 25 Jahre,320,186,134
False,8125078,Oedheim,25 - 30 Jahre,499,260,239
False,8125078,Oedheim,30 - 35 Jahre,524,289,235
False,8125078,Oedheim,35 - 40 Jahre,473,240,233
False,8125078,Oedheim,40 - 45 Jahre,344,185,159
False,8125078,Oedheim,45 - 50 Jahre,329,164,165
False,8125078,Oedheim,50 - 55 Jahre,321,166,155
False,8125078,Oedheim,55 - 60 Jahre,362,180,182
False,8125078,Oedheim,60 - 65 Jahre,288,146,142
False,8125078,Oedheim,65 - 75 Jahre,417,184,233
False,8125078,Oedheim,75 und mehr Jahre,247,93,154
False,8125078,Oedheim,Insgesamt,5504,2824,2680
False,8125079,Offenau,unter 3 Jahre,79,44,35
False,8125079,Offenau,3 -  6 Jahre,97,51,46
False,8125079,Offenau,6 - 10 Jahre,119,61,58
False,8125079,Offenau,10 - 15 Jahre,159,85,74
False,8125079,Offenau,15 - 18 Jahre,70,37,33
False,8125079,Offenau,18 - 20 Jahre,53,41,12
False,8125079,Offenau,20 - 25 Jahre,133,65,68
False,8125079,Offenau,25 - 30 Jahre,195,109,86
False,8125079,Offenau,30 - 35 Jahre,237,123,114
False,8125079,Offenau,35 - 40 Jahre,189,103,86
False,8125079,Offenau,40 - 45 Jahre,181,99,82
False,8125079,Offenau,45 - 50 Jahre,137,70,67
False,8125079,Offenau,50 - 55 Jahre,154,78,76
False,8125079,Offenau,55 - 60 Jahre,187,96,91
False,8125079,Offenau,60 - 65 Jahre,132,72,60
False,8125079,Offenau,65 - 75 Jahre,198,87,111
False,8125079,Offenau,75 und mehr Jahre,100,21,79
False,8125079,Offenau,Insgesamt,2420,1242,1178
False,8125081,Pfaffenhofen,unter 3 Jahre,85,44,41
False,8125081,Pfaffenhofen,3 -  6 Jahre,94,51,43
False,8125081,Pfaffenhofen,6 - 10 Jahre,176,78,98
False,8125081,Pfaffenhofen,10 - 15 Jahre,178,82,96
False,8125081,Pfaffenhofen,15 - 18 Jahre,66,36,30
False,8125081,Pfaffenhofen,18 - 20 Jahre,43,17,26
False,8125081,Pfaffenhofen,20 - 25 Jahre,135,73,62
False,8125081,Pfaffenhofen,25 - 30 Jahre,162,87,75
False,8125081,Pfaffenhofen,30 - 35 Jahre,194,94,100
False,8125081,Pfaffenhofen,35 - 40 Jahre,235,126,109
False,8125081,Pfaffenhofen,40 - 45 Jahre,161,81,80
False,8125081,Pfaffenhofen,45 - 50 Jahre,155,81,74
False,8125081,Pfaffenhofen,50 - 55 Jahre,123,64,59
False,8125081,Pfaffenhofen,55 - 60 Jahre,145,78,67
False,8125081,Pfaffenhofen,60 - 65 Jahre,116,59,57
False,8125081,Pfaffenhofen,65 - 75 Jahre,169,70,99
False,8125081,Pfaffenhofen,75 und mehr Jahre,127,33,94
False,8125081,Pfaffenhofen,Insgesamt,2364,1154,1210
False,8125084,Roigheim,unter 3 Jahre,65,33,32
False,8125084,Roigheim,3 -  6 Jahre,57,25,32
False,8125084,Roigheim,6 - 10 Jahre,69,35,34
False,8125084,Roigheim,10 - 15 Jahre,75,38,37
False,8125084,Roigheim,15 - 18 Jahre,46,16,30
False,8125084,Roigheim,18 - 20 Jahre,34,21,13
False,8125084,Roigheim,20 - 25 Jahre,96,53,43
False,8125084,Roigheim,25 - 30 Jahre,102,55,47
False,8125084,Roigheim,30 - 35 Jahre,130,63,67
False,8125084,Roigheim,35 - 40 Jahre,120,50,70
False,8125084,Roigheim,40 - 45 Jahre,87,46,41
False,8125084,Roigheim,45 - 50 Jahre,82,43,39
False,8125084,Roigheim,50 - 55 Jahre,68,38,30
False,8125084,Roigheim,55 - 60 Jahre,115,60,55
False,8125084,Roigheim,60 - 65 Jahre,73,36,37
False,8125084,Roigheim,65 - 75 Jahre,150,66,84
False,8125084,Roigheim,75 und mehr Jahre,97,30,67
False,8125084,Roigheim,Insgesamt,1466,708,758
False,8125086,"Schwaigern, Stadt",unter 3 Jahre,407,204,203
False,8125086,"Schwaigern, Stadt",3 -  6 Jahre,510,278,232
False,8125086,"Schwaigern, Stadt",6 - 10 Jahre,595,322,273
False,8125086,"Schwaigern, Stadt",10 - 15 Jahre,648,313,335
False,8125086,"Schwaigern, Stadt",15 - 18 Jahre,344,169,175
False,8125086,"Schwaigern, Stadt",18 - 20 Jahre,202,101,101
False,8125086,"Schwaigern, Stadt",20 - 25 Jahre,633,317,316
False,8125086,"Schwaigern, Stadt",25 - 30 Jahre,870,445,425
False,8125086,"Schwaigern, Stadt",30 - 35 Jahre,956,488,468
False,8125086,"Schwaigern, Stadt",35 - 40 Jahre,900,467,433
False,8125086,"Schwaigern, Stadt",40 - 45 Jahre,711,383,328
False,8125086,"Schwaigern, Stadt",45 - 50 Jahre,591,302,289
False,8125086,"Schwaigern, Stadt",50 - 55 Jahre,564,280,284
False,8125086,"Schwaigern, Stadt",55 - 60 Jahre,684,352,332
False,8125086,"Schwaigern, Stadt",60 - 65 Jahre,497,241,256
False,8125086,"Schwaigern, Stadt",65 - 75 Jahre,827,348,479
False,8125086,"Schwaigern, Stadt",75 und mehr Jahre,465,149,316
False,8125086,"Schwaigern, Stadt",Insgesamt,10404,5159,5245
False,8125087,Siegelsbach,unter 3 Jahre,53,30,23
False,8125087,Siegelsbach,3 -  6 Jahre,62,31,31
False,8125087,Siegelsbach,6 - 10 Jahre,77,44,33
False,8125087,Siegelsbach,10 - 15 Jahre,77,39,38
False,8125087,Siegelsbach,15 - 18 Jahre,44,17,27
False,8125087,Siegelsbach,18 - 20 Jahre,26,12,14
False,8125087,Siegelsbach,20 - 25 Jahre,93,51,42
False,8125087,Siegelsbach,25 - 30 Jahre,139,79,60
False,8125087,Siegelsbach,30 - 35 Jahre,148,69,79
False,8125087,Siegelsbach,35 - 40 Jahre,109,62,47
False,8125087,Siegelsbach,40 - 45 Jahre,93,43,50
False,8125087,Siegelsbach,45 - 50 Jahre,88,45,43
False,8125087,Siegelsbach,50 - 55 Jahre,68,33,35
False,8125087,Siegelsbach,55 - 60 Jahre,114,57,57
False,8125087,Siegelsbach,60 - 65 Jahre,86,44,42
False,8125087,Siegelsbach,65 - 75 Jahre,121,46,75
False,8125087,Siegelsbach,75 und mehr Jahre,88,28,60
False,8125087,Siegelsbach,Insgesamt,1486,730,756
False,8125094,Talheim,unter 3 Jahre,136,69,67
False,8125094,Talheim,3 -  6 Jahre,156,80,76
False,8125094,Talheim,6 - 10 Jahre,200,114,86
False,8125094,Talheim,10 - 15 Jahre,213,113,100
False,8125094,Talheim,15 - 18 Jahre,118,63,55
False,8125094,Talheim,18 - 20 Jahre,76,38,38
False,8125094,Talheim,20 - 25 Jahre,192,94,98
False,8125094,Talheim,25 - 30 Jahre,298,163,135
False,8125094,Talheim,30 - 35 Jahre,362,172,190
False,8125094,Talheim,35 - 40 Jahre,341,175,166
False,8125094,Talheim,40 - 45 Jahre,308,161,147
False,8125094,Talheim,45 - 50 Jahre,288,140,148
False,8125094,Talheim,50 - 55 Jahre,283,153,130
False,8125094,Talheim,55 - 60 Jahre,308,161,147
False,8125094,Talheim,60 - 65 Jahre,235,108,127
False,8125094,Talheim,65 - 75 Jahre,309,145,164
False,8125094,Talheim,75 und mehr Jahre,224,77,147
False,8125094,Talheim,Insgesamt,4047,2026,2021
False,8125096,Untereisesheim,unter 3 Jahre,134,71,63
False,8125096,Untereisesheim,3 -  6 Jahre,150,76,74
False,8125096,Untereisesheim,6 - 10 Jahre,196,97,99
False,8125096,Untereisesheim,10 - 15 Jahre,246,108,138
False,8125096,Untereisesheim,15 - 18 Jahre,136,66,70
False,8125096,Untereisesheim,18 - 20 Jahre,90,47,43
False,8125096,Untereisesheim,20 - 25 Jahre,189,74,115
False,8125096,Untereisesheim,25 - 30 Jahre,318,173,145
False,8125096,Untereisesheim,30 - 35 Jahre,308,143,165
False,8125096,Untereisesheim,35 - 40 Jahre,319,183,136
False,8125096,Untereisesheim,40 - 45 Jahre,290,138,152
False,8125096,Untereisesheim,45 - 50 Jahre,289,150,139
False,8125096,Untereisesheim,50 - 55 Jahre,226,119,107
False,8125096,Untereisesheim,55 - 60 Jahre,203,103,100
False,8125096,Untereisesheim,60 - 65 Jahre,165,83,82
False,8125096,Untereisesheim,65 - 75 Jahre,201,87,114
False,8125096,Untereisesheim,75 und mehr Jahre,136,42,94
False,8125096,Untereisesheim,Insgesamt,3596,1760,1836
False,8125098,Untergruppenbach,unter 3 Jahre,246,119,127
False,8125098,Untergruppenbach,3 -  6 Jahre,300,140,160
False,8125098,Untergruppenbach,6 - 10 Jahre,313,168,145
False,8125098,Untergruppenbach,10 - 15 Jahre,405,193,212
False,8125098,Untergruppenbach,15 - 18 Jahre,252,123,129
False,8125098,Untergruppenbach,18 - 20 Jahre,169,85,84
False,8125098,Untergruppenbach,20 - 25 Jahre,396,212,184
False,8125098,Untergruppenbach,25 - 30 Jahre,634,322,312
False,8125098,Untergruppenbach,30 - 35 Jahre,689,354,335
False,8125098,Untergruppenbach,35 - 40 Jahre,582,315,267
False,8125098,Untergruppenbach,40 - 45 Jahre,549,265,284
False,8125098,Untergruppenbach,45 - 50 Jahre,488,249,239
False,8125098,Untergruppenbach,50 - 55 Jahre,535,257,278
False,8125098,Untergruppenbach,55 - 60 Jahre,548,294,254
False,8125098,Untergruppenbach,60 - 65 Jahre,412,203,209
False,8125098,Untergruppenbach,65 - 75 Jahre,580,285,295
False,8125098,Untergruppenbach,75 und mehr Jahre,340,96,244
False,8125098,Untergruppenbach,Insgesamt,7438,3680,3758
False,8125102,"Weinsberg, Stadt",unter 3 Jahre,398,213,185
False,8125102,"Weinsberg, Stadt",3 -  6 Jahre,392,193,199
False,8125102,"Weinsberg, Stadt",6 - 10 Jahre,540,266,274
False,8125102,"Weinsberg, Stadt",10 - 15 Jahre,644,331,313
False,8125102,"Weinsberg, Stadt",15 - 18 Jahre,345,162,183
False,8125102,"Weinsberg, Stadt",18 - 20 Jahre,233,111,122
False,8125102,"Weinsberg, Stadt",20 - 25 Jahre,655,339,316
False,8125102,"Weinsberg, Stadt",25 - 30 Jahre,974,499,475
False,8125102,"Weinsberg, Stadt",30 - 35 Jahre,1072,579,493
False,8125102,"Weinsberg, Stadt",35 - 40 Jahre,926,481,445
False,8125102,"Weinsberg, Stadt",40 - 45 Jahre,782,372,410
False,8125102,"Weinsberg, Stadt",45 - 50 Jahre,664,331,333
False,8125102,"Weinsberg, Stadt",50 - 55 Jahre,651,336,315
False,8125102,"Weinsberg, Stadt",55 - 60 Jahre,767,380,387
False,8125102,"Weinsberg, Stadt",60 - 65 Jahre,613,312,301
False,8125102,"Weinsberg, Stadt",65 - 75 Jahre,978,415,563
False,8125102,"Weinsberg, Stadt",75 und mehr Jahre,665,208,457
False,8125102,"Weinsberg, Stadt",Insgesamt,11299,5528,5771
False,8125103,"Widdern, Stadt",unter 3 Jahre,68,40,28
False,8125103,"Widdern, Stadt",3 -  6 Jahre,82,36,46
False,8125103,"Widdern, Stadt",6 - 10 Jahre,79,42,37
False,8125103,"Widdern, Stadt",10 - 15 Jahre,124,61,63
False,8125103,"Widdern, Stadt",15 - 18 Jahre,60,33,27
False,8125103,"Widdern, Stadt",18 - 20 Jahre,35,16,19
False,8125103,"Widdern, Stadt",20 - 25 Jahre,94,43,51
False,8125103,"Widdern, Stadt",25 - 30 Jahre,144,76,68
False,8125103,"Widdern, Stadt",30 - 35 Jahre,158,82,76
False,8125103,"Widdern, Stadt",35 - 40 Jahre,153,79,74
False,8125103,"Widdern, Stadt",40 - 45 Jahre,119,73,46
False,8125103,"Widdern, Stadt",45 - 50 Jahre,101,50,51
False,8125103,"Widdern, Stadt",50 - 55 Jahre,80,45,35
False,8125103,"Widdern, Stadt",55 - 60 Jahre,110,54,56
False,8125103,"Widdern, Stadt",60 - 65 Jahre,87,53,34
False,8125103,"Widdern, Stadt",65 - 75 Jahre,169,74,95
False,8125103,"Widdern, Stadt",75 und mehr Jahre,128,37,91
False,8125103,"Widdern, Stadt",Insgesamt,1791,894,897
False,8125107,Wüstenrot,unter 3 Jahre,238,134,104
False,8125107,Wüstenrot,3 -  6 Jahre,276,138,138
False,8125107,Wüstenrot,6 - 10 Jahre,359,173,186
False,8125107,Wüstenrot,10 - 15 Jahre,352,177,175
False,8125107,Wüstenrot,15 - 18 Jahre,198,103,95
False,8125107,Wüstenrot,18 - 20 Jahre,95,50,45
False,8125107,Wüstenrot,20 - 25 Jahre,316,171,145
False,8125107,Wüstenrot,25 - 30 Jahre,458,217,241
False,8125107,Wüstenrot,30 - 35 Jahre,580,295,285
False,8125107,Wüstenrot,35 - 40 Jahre,504,254,250
False,8125107,Wüstenrot,40 - 45 Jahre,439,236,203
False,8125107,Wüstenrot,45 - 50 Jahre,369,191,178
False,8125107,Wüstenrot,50 - 55 Jahre,294,157,137
False,8125107,Wüstenrot,55 - 60 Jahre,412,223,189
False,8125107,Wüstenrot,60 - 65 Jahre,354,168,186
False,8125107,Wüstenrot,65 - 75 Jahre,690,288,402
False,8125107,Wüstenrot,75 und mehr Jahre,656,190,466
False,8125107,Wüstenrot,Insgesamt,6590,3165,3425
False,8125108,Zaberfeld,unter 3 Jahre,158,92,66
False,8125108,Zaberfeld,3 -  6 Jahre,187,96,91
False,8125108,Zaberfeld,6 - 10 Jahre,225,121,104
False,8125108,Zaberfeld,10 - 15 Jahre,221,104,117
False,8125108,Zaberfeld,15 - 18 Jahre,126,64,62
False,8125108,Zaberfeld,18 - 20 Jahre,92,46,46
False,8125108,Zaberfeld,20 - 25 Jahre,209,113,96
False,8125108,Zaberfeld,25 - 30 Jahre,278,133,145
False,8125108,Zaberfeld,30 - 35 Jahre,349,177,172
False,8125108,Zaberfeld,35 - 40 Jahre,316,153,163
False,8125108,Zaberfeld,40 - 45 Jahre,252,134,118
False,8125108,Zaberfeld,45 - 50 Jahre,209,119,90
False,8125108,Zaberfeld,50 - 55 Jahre,182,103,79
False,8125108,Zaberfeld,55 - 60 Jahre,239,113,126
False,8125108,Zaberfeld,60 - 65 Jahre,169,87,82
False,8125108,Zaberfeld,65 - 75 Jahre,321,132,189
False,8125108,Zaberfeld,75 und mehr Jahre,166,53,113
False,8125108,Zaberfeld,Insgesamt,3699,1840,1859
False,8125110,Obersulm,unter 3 Jahre,441,236,205
False,8125110,Obersulm,3 -  6 Jahre,454,225,229
False,8125110,Obersulm,6 - 10 Jahre,633,332,301
False,8125110,Obersulm,10 - 15 Jahre,726,375,351
False,8125110,Obersulm,15 - 18 Jahre,443,217,226
False,8125110,Obersulm,18 - 20 Jahre,245,130,115
False,8125110,Obersulm,20 - 25 Jahre,792,394,398
False,8125110,Obersulm,25 - 30 Jahre,1007,547,460
False,8125110,Obersulm,30 - 35 Jahre,1151,599,552
False,8125110,Obersulm,35 - 40 Jahre,1107,582,525
False,8125110,Obersulm,40 - 45 Jahre,822,436,386
False,8125110,Obersulm,45 - 50 Jahre,789,389,400
False,8125110,Obersulm,50 - 55 Jahre,792,405,387
False,8125110,Obersulm,55 - 60 Jahre,885,452,433
False,8125110,Obersulm,60 - 65 Jahre,686,329,357
False,8125110,Obersulm,65 - 75 Jahre,1010,460,550
False,8125110,Obersulm,75 und mehr Jahre,729,206,523
False,8125110,Obersulm,Insgesamt,12712,6314,6398
False,8125111,Hardthausen am Kocher,unter 3 Jahre,143,83,60
False,8125111,Hardthausen am Kocher,3 -  6 Jahre,178,94,84
False,8125111,Hardthausen am Kocher,6 - 10 Jahre,206,95,111
False,8125111,Hardthausen am Kocher,10 - 15 Jahre,227,106,121
False,8125111,Hardthausen am Kocher,15 - 18 Jahre,121,71,50
False,8125111,Hardthausen am Kocher,18 - 20 Jahre,69,42,27
False,8125111,Hardthausen am Kocher,20 - 25 Jahre,212,105,107
False,8125111,Hardthausen am Kocher,25 - 30 Jahre,292,153,139
False,8125111,Hardthausen am Kocher,30 - 35 Jahre,354,184,170
False,8125111,Hardthausen am Kocher,35 - 40 Jahre,313,150,163
False,8125111,Hardthausen am Kocher,40 - 45 Jahre,244,134,110
False,8125111,Hardthausen am Kocher,45 - 50 Jahre,162,94,68
False,8125111,Hardthausen am Kocher,50 - 55 Jahre,161,75,86
False,8125111,Hardthausen am Kocher,55 - 60 Jahre,235,111,124
False,8125111,Hardthausen am Kocher,60 - 65 Jahre,170,88,82
False,8125111,Hardthausen am Kocher,65 - 75 Jahre,290,134,156
False,8125111,Hardthausen am Kocher,75 und mehr Jahre,146,43,103
False,8125111,Hardthausen am Kocher,Insgesamt,3523,1762,1761
False,8125113,Langenbrettach,unter 3 Jahre,133,63,70
False,8125113,Langenbrettach,3 -  6 Jahre,144,70,74
False,8125113,Langenbrettach,6 - 10 Jahre,190,87,103
False,8125113,Langenbrettach,10 - 15 Jahre,202,104,98
False,8125113,Langenbrettach,15 - 18 Jahre,114,55,59
False,8125113,Langenbrettach,18 - 20 Jahre,88,43,45
False,8125113,Langenbrettach,20 - 25 Jahre,200,110,90
False,8125113,Langenbrettach,25 - 30 Jahre,281,137,144
False,8125113,Langenbrettach,30 - 35 Jahre,286,152,134
False,8125113,Langenbrettach,35 - 40 Jahre,272,129,143
False,8125113,Langenbrettach,40 - 45 Jahre,217,105,112
False,8125113,Langenbrettach,45 - 50 Jahre,185,98,87
False,8125113,Langenbrettach,50 - 55 Jahre,167,83,84
False,8125113,Langenbrettach,55 - 60 Jahre,186,109,77
False,8125113,Langenbrettach,60 - 65 Jahre,148,72,76
False,8125113,Langenbrettach,65 - 75 Jahre,224,88,136
False,8125113,Langenbrettach,75 und mehr Jahre,130,46,84
False,8125113,Langenbrettach,Insgesamt,3167,1551,1616
False,8126,Landkreis Hohenlohekreis,unter 3 Jahre,3798,1907,1891
False,8126,Landkreis Hohenlohekreis,3 -  6 Jahre,4068,2006,2062
False,8126,Landkreis Hohenlohekreis,6 - 10 Jahre,5491,2824,2667
False,8126,Landkreis Hohenlohekreis,10 - 15 Jahre,6310,3335,2975
False,8126,Landkreis Hohenlohekreis,15 - 18 Jahre,3739,1904,1835
False,8126,Landkreis Hohenlohekreis,18 - 20 Jahre,2382,1184,1198
False,8126,Landkreis Hohenlohekreis,20 - 25 Jahre,6755,3505,3250
False,8126,Landkreis Hohenlohekreis,25 - 30 Jahre,8592,4434,4158
False,8126,Landkreis Hohenlohekreis,30 - 35 Jahre,9182,4820,4362
False,8126,Landkreis Hohenlohekreis,35 - 40 Jahre,8364,4393,3971
False,8126,Landkreis Hohenlohekreis,40 - 45 Jahre,7206,3719,3487
False,8126,Landkreis Hohenlohekreis,45 - 50 Jahre,6007,3183,2824
False,8126,Landkreis Hohenlohekreis,50 - 55 Jahre,5287,2696,2591
False,8126,Landkreis Hohenlohekreis,55 - 60 Jahre,6608,3307,3301
False,8126,Landkreis Hohenlohekreis,60 - 65 Jahre,5284,2637,2647
False,8126,Landkreis Hohenlohekreis,65 - 75 Jahre,9151,3922,5229
False,8126,Landkreis Hohenlohekreis,75 und mehr Jahre,6123,1893,4230
False,8126,Landkreis Hohenlohekreis,Insgesamt,104347,51669,52678
False,8126011,Bretzfeld,unter 3 Jahre,456,218,238
False,8126011,Bretzfeld,3 -  6 Jahre,487,267,220
False,8126011,Bretzfeld,6 - 10 Jahre,642,318,324
False,8126011,Bretzfeld,10 - 15 Jahre,694,351,343
False,8126011,Bretzfeld,15 - 18 Jahre,380,165,215
False,8126011,Bretzfeld,18 - 20 Jahre,244,118,126
False,8126011,Bretzfeld,20 - 25 Jahre,680,341,339
False,8126011,Bretzfeld,25 - 30 Jahre,932,467,465
False,8126011,Bretzfeld,30 - 35 Jahre,1055,516,539
False,8126011,Bretzfeld,35 - 40 Jahre,924,473,451
False,8126011,Bretzfeld,40 - 45 Jahre,848,430,418
False,8126011,Bretzfeld,45 - 50 Jahre,710,381,329
False,8126011,Bretzfeld,50 - 55 Jahre,509,264,245
False,8126011,Bretzfeld,55 - 60 Jahre,607,297,310
False,8126011,Bretzfeld,60 - 65 Jahre,530,271,259
False,8126011,Bretzfeld,65 - 75 Jahre,852,371,481
False,8126011,Bretzfeld,75 und mehr Jahre,578,186,392
False,8126011,Bretzfeld,Insgesamt,11128,5434,5694
False,8126020,Dörzbach,unter 3 Jahre,82,44,38
False,8126020,Dörzbach,3 -  6 Jahre,82,35,47
False,8126020,Dörzbach,6 - 10 Jahre,121,66,55
False,8126020,Dörzbach,10 - 15 Jahre,139,74,65
False,8126020,Dörzbach,15 - 18 Jahre,90,39,51
False,8126020,Dörzbach,18 - 20 Jahre,47,22,25
False,8126020,Dörzbach,20 - 25 Jahre,150,84,66
False,8126020,Dörzbach,25 - 30 Jahre,183,110,73
False,8126020,Dörzbach,30 - 35 Jahre,219,115,104
False,8126020,Dörzbach,35 - 40 Jahre,169,93,76
False,8126020,Dörzbach,40 - 45 Jahre,166,84,82
False,8126020,Dörzbach,45 - 50 Jahre,122,67,55
False,8126020,Dörzbach,50 - 55 Jahre,97,56,41
False,8126020,Dörzbach,55 - 60 Jahre,138,73,65
False,8126020,Dörzbach,60 - 65 Jahre,124,60,64
False,8126020,Dörzbach,65 - 75 Jahre,221,88,133
False,8126020,Dörzbach,75 und mehr Jahre,136,48,88
False,8126020,Dörzbach,Insgesamt,2286,1158,1128
False,8126028,"Forchtenberg, Stadt",unter 3 Jahre,212,101,111
False,8126028,"Forchtenberg, Stadt",3 -  6 Jahre,234,101,133
False,8126028,"Forchtenberg, Stadt",6 - 10 Jahre,276,139,137
False,8126028,"Forchtenberg, Stadt",10 - 15 Jahre,292,159,133
False,8126028,"Forchtenberg, Stadt",15 - 18 Jahre,169,81,88
False,8126028,"Forchtenberg, Stadt",18 - 20 Jahre,111,51,60
False,8126028,"Forchtenberg, Stadt",20 - 25 Jahre,293,161,132
False,8126028,"Forchtenberg, Stadt",25 - 30 Jahre,413,219,194
False,8126028,"Forchtenberg, Stadt",30 - 35 Jahre,441,235,206
False,8126028,"Forchtenberg, Stadt",35 - 40 Jahre,366,184,182
False,8126028,"Forchtenberg, Stadt",40 - 45 Jahre,319,170,149
False,8126028,"Forchtenberg, Stadt",45 - 50 Jahre,293,162,131
False,8126028,"Forchtenberg, Stadt",50 - 55 Jahre,238,127,111
False,8126028,"Forchtenberg, Stadt",55 - 60 Jahre,291,148,143
False,8126028,"Forchtenberg, Stadt",60 - 65 Jahre,247,129,118
False,8126028,"Forchtenberg, Stadt",65 - 75 Jahre,428,190,238
False,8126028,"Forchtenberg, Stadt",75 und mehr Jahre,259,84,175
False,8126028,"Forchtenberg, Stadt",Insgesamt,4882,2441,2441
False,8126039,"Ingelfingen, Stadt",unter 3 Jahre,218,112,106
False,8126039,"Ingelfingen, Stadt",3 -  6 Jahre,206,96,110
False,8126039,"Ingelfingen, Stadt",6 - 10 Jahre,273,131,142
False,8126039,"Ingelfingen, Stadt",10 - 15 Jahre,329,168,161
False,8126039,"Ingelfingen, Stadt",15 - 18 Jahre,187,95,92
False,8126039,"Ingelfingen, Stadt",18 - 20 Jahre,123,66,57
False,8126039,"Ingelfingen, Stadt",20 - 25 Jahre,364,182,182
False,8126039,"Ingelfingen, Stadt",25 - 30 Jahre,489,268,221
False,8126039,"Ingelfingen, Stadt",30 - 35 Jahre,482,263,219
False,8126039,"Ingelfingen, Stadt",35 - 40 Jahre,406,220,186
False,8126039,"Ingelfingen, Stadt",40 - 45 Jahre,370,190,180
False,8126039,"Ingelfingen, Stadt",45 - 50 Jahre,308,155,153
False,8126039,"Ingelfingen, Stadt",50 - 55 Jahre,307,165,142
False,8126039,"Ingelfingen, Stadt",55 - 60 Jahre,392,202,190
False,8126039,"Ingelfingen, Stadt",60 - 65 Jahre,294,143,151
False,8126039,"Ingelfingen, Stadt",65 - 75 Jahre,534,236,298
False,8126039,"Ingelfingen, Stadt",75 und mehr Jahre,420,130,290
False,8126039,"Ingelfingen, Stadt",Insgesamt,5702,2822,2880
False,8126045,"Krautheim, Stadt",unter 3 Jahre,169,88,81
False,8126045,"Krautheim, Stadt",3 -  6 Jahre,205,102,103
False,8126045,"Krautheim, Stadt",6 - 10 Jahre,237,119,118
False,8126045,"Krautheim, Stadt",10 - 15 Jahre,269,141,128
False,8126045,"Krautheim, Stadt",15 - 18 Jahre,166,81,85
False,8126045,"Krautheim, Stadt",18 - 20 Jahre,100,55,45
False,8126045,"Krautheim, Stadt",20 - 25 Jahre,308,160,148
False,8126045,"Krautheim, Stadt",25 - 30 Jahre,390,195,195
False,8126045,"Krautheim, Stadt",30 - 35 Jahre,463,252,211
False,8126045,"Krautheim, Stadt",35 - 40 Jahre,380,191,189
False,8126045,"Krautheim, Stadt",40 - 45 Jahre,297,161,136
False,8126045,"Krautheim, Stadt",45 - 50 Jahre,247,119,128
False,8126045,"Krautheim, Stadt",50 - 55 Jahre,201,108,93
False,8126045,"Krautheim, Stadt",55 - 60 Jahre,326,165,161
False,8126045,"Krautheim, Stadt",60 - 65 Jahre,267,135,132
False,8126045,"Krautheim, Stadt",65 - 75 Jahre,426,184,242
False,8126045,"Krautheim, Stadt",75 und mehr Jahre,257,75,182
False,8126045,"Krautheim, Stadt",Insgesamt,4708,2331,2377
False,8126046,"Künzelsau, Stadt",unter 3 Jahre,450,221,229
False,8126046,"Künzelsau, Stadt",3 -  6 Jahre,507,251,256
False,8126046,"Künzelsau, Stadt",6 - 10 Jahre,715,372,343
False,8126046,"Künzelsau, Stadt",10 - 15 Jahre,827,436,391
False,8126046,"Künzelsau, Stadt",15 - 18 Jahre,544,272,272
False,8126046,"Künzelsau, Stadt",18 - 20 Jahre,366,192,174
False,8126046,"Künzelsau, Stadt",20 - 25 Jahre,955,492,463
False,8126046,"Künzelsau, Stadt",25 - 30 Jahre,1174,594,580
False,8126046,"Künzelsau, Stadt",30 - 35 Jahre,1155,614,541
False,8126046,"Künzelsau, Stadt",35 - 40 Jahre,1128,581,547
False,8126046,"Künzelsau, Stadt",40 - 45 Jahre,997,498,499
False,8126046,"Künzelsau, Stadt",45 - 50 Jahre,809,405,404
False,8126046,"Künzelsau, Stadt",50 - 55 Jahre,762,399,363
False,8126046,"Künzelsau, Stadt",55 - 60 Jahre,914,448,466
False,8126046,"Künzelsau, Stadt",60 - 65 Jahre,720,335,385
False,8126046,"Künzelsau, Stadt",65 - 75 Jahre,1357,559,798
False,8126046,"Künzelsau, Stadt",75 und mehr Jahre,1031,315,716
False,8126046,"Künzelsau, Stadt",Insgesamt,14411,6984,7427
False,8126047,Kupferzell,unter 3 Jahre,252,130,122
False,8126047,Kupferzell,3 -  6 Jahre,256,125,131
False,8126047,Kupferzell,6 - 10 Jahre,317,166,151
False,8126047,Kupferzell,10 - 15 Jahre,365,192,173
False,8126047,Kupferzell,15 - 18 Jahre,200,112,88
False,8126047,Kupferzell,18 - 20 Jahre,126,53,73
False,8126047,Kupferzell,20 - 25 Jahre,336,149,187
False,8126047,Kupferzell,25 - 30 Jahre,541,268,273
False,8126047,Kupferzell,30 - 35 Jahre,515,250,265
False,8126047,Kupferzell,35 - 40 Jahre,490,249,241
False,8126047,Kupferzell,40 - 45 Jahre,372,190,182
False,8126047,Kupferzell,45 - 50 Jahre,303,173,130
False,8126047,Kupferzell,50 - 55 Jahre,229,120,109
False,8126047,Kupferzell,55 - 60 Jahre,300,146,154
False,8126047,Kupferzell,60 - 65 Jahre,257,133,124
False,8126047,Kupferzell,65 - 75 Jahre,398,178,220
False,8126047,Kupferzell,75 und mehr Jahre,240,81,159
False,8126047,Kupferzell,Insgesamt,5497,2715,2782
False,8126056,Mulfingen,unter 3 Jahre,157,84,73
False,8126056,Mulfingen,3 -  6 Jahre,159,81,78
False,8126056,Mulfingen,6 - 10 Jahre,250,136,114
False,8126056,Mulfingen,10 - 15 Jahre,296,152,144
False,8126056,Mulfingen,15 - 18 Jahre,148,72,76
False,8126056,Mulfingen,18 - 20 Jahre,81,40,41
False,8126056,Mulfingen,20 - 25 Jahre,242,143,99
False,8126056,Mulfingen,25 - 30 Jahre,272,149,123
False,8126056,Mulfingen,30 - 35 Jahre,344,177,167
False,8126056,Mulfingen,35 - 40 Jahre,318,173,145
False,8126056,Mulfingen,40 - 45 Jahre,240,129,111
False,8126056,Mulfingen,45 - 50 Jahre,215,131,84
False,8126056,Mulfingen,50 - 55 Jahre,149,71,78
False,8126056,Mulfingen,55 - 60 Jahre,200,108,92
False,8126056,Mulfingen,60 - 65 Jahre,205,108,97
False,8126056,Mulfingen,65 - 75 Jahre,345,146,199
False,8126056,Mulfingen,75 und mehr Jahre,224,72,152
False,8126056,Mulfingen,Insgesamt,3845,1972,1873
False,8126058,"Neuenstein, Stadt",unter 3 Jahre,213,111,102
False,8126058,"Neuenstein, Stadt",3 -  6 Jahre,251,132,119
False,8126058,"Neuenstein, Stadt",6 - 10 Jahre,331,175,156
False,8126058,"Neuenstein, Stadt",10 - 15 Jahre,406,214,192
False,8126058,"Neuenstein, Stadt",15 - 18 Jahre,233,128,105
False,8126058,"Neuenstein, Stadt",18 - 20 Jahre,139,67,72
False,8126058,"Neuenstein, Stadt",20 - 25 Jahre,384,195,189
False,8126058,"Neuenstein, Stadt",25 - 30 Jahre,506,276,230
False,8126058,"Neuenstein, Stadt",30 - 35 Jahre,542,273,269
False,8126058,"Neuenstein, Stadt",35 - 40 Jahre,498,280,218
False,8126058,"Neuenstein, Stadt",40 - 45 Jahre,419,217,202
False,8126058,"Neuenstein, Stadt",45 - 50 Jahre,368,199,169
False,8126058,"Neuenstein, Stadt",50 - 55 Jahre,246,131,115
False,8126058,"Neuenstein, Stadt",55 - 60 Jahre,375,184,191
False,8126058,"Neuenstein, Stadt",60 - 65 Jahre,296,139,157
False,8126058,"Neuenstein, Stadt",65 - 75 Jahre,522,236,286
False,8126058,"Neuenstein, Stadt",75 und mehr Jahre,321,111,210
False,8126058,"Neuenstein, Stadt",Insgesamt,6050,3068,2982
False,8126060,"Niedernhall, Stadt",unter 3 Jahre,110,53,57
False,8126060,"Niedernhall, Stadt",3 -  6 Jahre,128,65,63
False,8126060,"Niedernhall, Stadt",6 - 10 Jahre,175,80,95
False,8126060,"Niedernhall, Stadt",10 - 15 Jahre,191,106,85
False,8126060,"Niedernhall, Stadt",15 - 18 Jahre,142,78,64
False,8126060,"Niedernhall, Stadt",18 - 20 Jahre,99,48,51
False,8126060,"Niedernhall, Stadt",20 - 25 Jahre,251,140,111
False,8126060,"Niedernhall, Stadt",25 - 30 Jahre,287,150,137
False,8126060,"Niedernhall, Stadt",30 - 35 Jahre,296,156,140
False,8126060,"Niedernhall, Stadt",35 - 40 Jahre,296,169,127
False,8126060,"Niedernhall, Stadt",40 - 45 Jahre,272,141,131
False,8126060,"Niedernhall, Stadt",45 - 50 Jahre,278,135,143
False,8126060,"Niedernhall, Stadt",50 - 55 Jahre,214,114,100
False,8126060,"Niedernhall, Stadt",55 - 60 Jahre,269,133,136
False,8126060,"Niedernhall, Stadt",60 - 65 Jahre,181,97,84
False,8126060,"Niedernhall, Stadt",65 - 75 Jahre,302,145,157
False,8126060,"Niedernhall, Stadt",75 und mehr Jahre,192,47,145
False,8126060,"Niedernhall, Stadt",Insgesamt,3683,1857,1826
False,8126066,"Öhringen, Stadt",unter 3 Jahre,718,362,356
False,8126066,"Öhringen, Stadt",3 -  6 Jahre,762,374,388
False,8126066,"Öhringen, Stadt",6 - 10 Jahre,1069,556,513
False,8126066,"Öhringen, Stadt",10 - 15 Jahre,1297,699,598
False,8126066,"Öhringen, Stadt",15 - 18 Jahre,805,416,389
False,8126066,"Öhringen, Stadt",18 - 20 Jahre,467,230,237
False,8126066,"Öhringen, Stadt",20 - 25 Jahre,1361,707,654
False,8126066,"Öhringen, Stadt",25 - 30 Jahre,1607,819,788
False,8126066,"Öhringen, Stadt",30 - 35 Jahre,1830,969,861
False,8126066,"Öhringen, Stadt",35 - 40 Jahre,1771,903,868
False,8126066,"Öhringen, Stadt",40 - 45 Jahre,1506,764,742
False,8126066,"Öhringen, Stadt",45 - 50 Jahre,1182,637,545
False,8126066,"Öhringen, Stadt",50 - 55 Jahre,1164,554,610
False,8126066,"Öhringen, Stadt",55 - 60 Jahre,1404,688,716
False,8126066,"Öhringen, Stadt",60 - 65 Jahre,1127,556,571
False,8126066,"Öhringen, Stadt",65 - 75 Jahre,2058,848,1210
False,8126066,"Öhringen, Stadt",75 und mehr Jahre,1305,398,907
False,8126066,"Öhringen, Stadt",Insgesamt,21433,10480,10953
False,8126069,Pfedelbach,unter 3 Jahre,308,143,165
False,8126069,Pfedelbach,3 -  6 Jahre,308,149,159
False,8126069,Pfedelbach,6 - 10 Jahre,425,227,198
False,8126069,Pfedelbach,10 - 15 Jahre,487,237,250
False,8126069,Pfedelbach,15 - 18 Jahre,287,150,137
False,8126069,Pfedelbach,18 - 20 Jahre,178,89,89
False,8126069,Pfedelbach,20 - 25 Jahre,520,286,234
False,8126069,Pfedelbach,25 - 30 Jahre,667,335,332
False,8126069,Pfedelbach,30 - 35 Jahre,700,376,324
False,8126069,Pfedelbach,35 - 40 Jahre,670,358,312
False,8126069,Pfedelbach,40 - 45 Jahre,565,285,280
False,8126069,Pfedelbach,45 - 50 Jahre,516,259,257
False,8126069,Pfedelbach,50 - 55 Jahre,527,259,268
False,8126069,Pfedelbach,55 - 60 Jahre,557,276,281
False,8126069,Pfedelbach,60 - 65 Jahre,431,225,206
False,8126069,Pfedelbach,65 - 75 Jahre,663,295,368
False,8126069,Pfedelbach,75 und mehr Jahre,433,133,300
False,8126069,Pfedelbach,Insgesamt,8242,4082,4160
False,8126072,Schöntal,unter 3 Jahre,196,109,87
False,8126072,Schöntal,3 -  6 Jahre,221,96,125
False,8126072,Schöntal,6 - 10 Jahre,317,166,151
False,8126072,Schöntal,10 - 15 Jahre,304,178,126
False,8126072,Schöntal,15 - 18 Jahre,163,100,63
False,8126072,Schöntal,18 - 20 Jahre,123,71,52
False,8126072,Schöntal,20 - 25 Jahre,384,210,174
False,8126072,Schöntal,25 - 30 Jahre,487,255,232
False,8126072,Schöntal,30 - 35 Jahre,502,281,221
False,8126072,Schöntal,35 - 40 Jahre,433,232,201
False,8126072,Schöntal,40 - 45 Jahre,374,200,174
False,8126072,Schöntal,45 - 50 Jahre,312,174,138
False,8126072,Schöntal,50 - 55 Jahre,278,139,139
False,8126072,Schöntal,55 - 60 Jahre,423,222,201
False,8126072,Schöntal,60 - 65 Jahre,321,164,157
False,8126072,Schöntal,65 - 75 Jahre,546,229,317
False,8126072,Schöntal,75 und mehr Jahre,348,104,244
False,8126072,Schöntal,Insgesamt,5732,2930,2802
False,8126085,"Waldenburg, Stadt",unter 3 Jahre,118,57,61
False,8126085,"Waldenburg, Stadt",3 -  6 Jahre,122,63,59
False,8126085,"Waldenburg, Stadt",6 - 10 Jahre,144,75,69
False,8126085,"Waldenburg, Stadt",10 - 15 Jahre,223,129,94
False,8126085,"Waldenburg, Stadt",15 - 18 Jahre,100,52,48
False,8126085,"Waldenburg, Stadt",18 - 20 Jahre,77,37,40
False,8126085,"Waldenburg, Stadt",20 - 25 Jahre,280,98,182
False,8126085,"Waldenburg, Stadt",25 - 30 Jahre,305,138,167
False,8126085,"Waldenburg, Stadt",30 - 35 Jahre,295,151,144
False,8126085,"Waldenburg, Stadt",35 - 40 Jahre,232,129,103
False,8126085,"Waldenburg, Stadt",40 - 45 Jahre,205,115,90
False,8126085,"Waldenburg, Stadt",45 - 50 Jahre,136,78,58
False,8126085,"Waldenburg, Stadt",50 - 55 Jahre,182,96,86
False,8126085,"Waldenburg, Stadt",55 - 60 Jahre,167,89,78
False,8126085,"Waldenburg, Stadt",60 - 65 Jahre,121,58,63
False,8126085,"Waldenburg, Stadt",65 - 75 Jahre,212,83,129
False,8126085,"Waldenburg, Stadt",75 und mehr Jahre,143,41,102
False,8126085,"Waldenburg, Stadt",Insgesamt,3062,1489,1573
False,8126086,Weißbach,unter 3 Jahre,79,40,39
False,8126086,Weißbach,3 -  6 Jahre,91,46,45
False,8126086,Weißbach,6 - 10 Jahre,129,62,67
False,8126086,Weißbach,10 - 15 Jahre,123,69,54
False,8126086,Weißbach,15 - 18 Jahre,71,36,35
False,8126086,Weißbach,18 - 20 Jahre,60,26,34
False,8126086,Weißbach,20 - 25 Jahre,146,89,57
False,8126086,Weißbach,25 - 30 Jahre,212,115,97
False,8126086,Weißbach,30 - 35 Jahre,194,104,90
False,8126086,Weißbach,35 - 40 Jahre,163,91,72
False,8126086,Weißbach,40 - 45 Jahre,145,87,58
False,8126086,Weißbach,45 - 50 Jahre,119,59,60
False,8126086,Weißbach,50 - 55 Jahre,124,61,63
False,8126086,Weißbach,55 - 60 Jahre,146,73,73
False,8126086,Weißbach,60 - 65 Jahre,88,48,40
False,8126086,Weißbach,65 - 75 Jahre,152,66,86
False,8126086,Weißbach,75 und mehr Jahre,95,31,64
False,8126086,Weißbach,Insgesamt,2137,1103,1034
False,8126094,Zweiflingen,unter 3 Jahre,60,34,26
False,8126094,Zweiflingen,3 -  6 Jahre,49,23,26
False,8126094,Zweiflingen,6 - 10 Jahre,70,36,34
False,8126094,Zweiflingen,10 - 15 Jahre,68,30,38
False,8126094,Zweiflingen,15 - 18 Jahre,54,27,27
False,8126094,Zweiflingen,18 - 20 Jahre,41,19,22
False,8126094,Zweiflingen,20 - 25 Jahre,101,68,33
False,8126094,Zweiflingen,25 - 30 Jahre,127,76,51
False,8126094,Zweiflingen,30 - 35 Jahre,149,88,61
False,8126094,Zweiflingen,35 - 40 Jahre,120,67,53
False,8126094,Zweiflingen,40 - 45 Jahre,111,58,53
False,8126094,Zweiflingen,45 - 50 Jahre,89,49,40
False,8126094,Zweiflingen,50 - 55 Jahre,60,32,28
False,8126094,Zweiflingen,55 - 60 Jahre,99,55,44
False,8126094,Zweiflingen,60 - 65 Jahre,75,36,39
False,8126094,Zweiflingen,65 - 75 Jahre,135,68,67
False,8126094,Zweiflingen,75 und mehr Jahre,141,37,104
False,8126094,Zweiflingen,Insgesamt,1549,803,746
False,8127,Landkreis Schwäbisch Hall,unter 3 Jahre,6785,3471,3314
False,8127,Landkreis Schwäbisch Hall,3 -  6 Jahre,7117,3690,3427
False,8127,Landkreis Schwäbisch Hall,6 - 10 Jahre,9511,4843,4668
False,8127,Landkreis Schwäbisch Hall,10 - 15 Jahre,11448,5989,5459
False,8127,Landkreis Schwäbisch Hall,15 - 18 Jahre,6418,3371,3047
False,8127,Landkreis Schwäbisch Hall,18 - 20 Jahre,4261,2204,2057
False,8127,Landkreis Schwäbisch Hall,20 - 25 Jahre,11007,5599,5408
False,8127,Landkreis Schwäbisch Hall,25 - 30 Jahre,14561,7615,6946
False,8127,Landkreis Schwäbisch Hall,30 - 35 Jahre,15627,8071,7556
False,8127,Landkreis Schwäbisch Hall,35 - 40 Jahre,14345,7387,6958
False,8127,Landkreis Schwäbisch Hall,40 - 45 Jahre,12697,6445,6252
False,8127,Landkreis Schwäbisch Hall,45 - 50 Jahre,10619,5538,5081
False,8127,Landkreis Schwäbisch Hall,50 - 55 Jahre,9199,4656,4543
False,8127,Landkreis Schwäbisch Hall,55 - 60 Jahre,11187,5619,5568
False,8127,Landkreis Schwäbisch Hall,60 - 65 Jahre,8760,4238,4522
False,8127,Landkreis Schwäbisch Hall,65 - 75 Jahre,15700,6577,9123
False,8127,Landkreis Schwäbisch Hall,75 und mehr Jahre,11406,3524,7882
False,8127,Landkreis Schwäbisch Hall,Insgesamt,180648,88837,91811
False,8127008,Blaufelden,unter 3 Jahre,203,103,100
False,8127008,Blaufelden,3 -  6 Jahre,235,121,114
False,8127008,Blaufelden,6 - 10 Jahre,274,137,137
False,8127008,Blaufelden,10 - 15 Jahre,350,195,155
False,8127008,Blaufelden,15 - 18 Jahre,195,93,102
False,8127008,Blaufelden,18 - 20 Jahre,131,57,74
False,8127008,Blaufelden,20 - 25 Jahre,321,164,157
False,8127008,Blaufelden,25 - 30 Jahre,409,211,198
False,8127008,Blaufelden,30 - 35 Jahre,417,237,180
False,8127008,Blaufelden,35 - 40 Jahre,386,208,178
False,8127008,Blaufelden,40 - 45 Jahre,338,186,152
False,8127008,Blaufelden,45 - 50 Jahre,285,148,137
False,8127008,Blaufelden,50 - 55 Jahre,220,118,102
False,8127008,Blaufelden,55 - 60 Jahre,348,171,177
False,8127008,Blaufelden,60 - 65 Jahre,248,129,119
False,8127008,Blaufelden,65 - 75 Jahre,475,202,273
False,8127008,Blaufelden,75 und mehr Jahre,368,121,247
False,8127008,Blaufelden,Insgesamt,5203,2601,2602
False,8127009,Braunsbach,unter 3 Jahre,102,46,56
False,8127009,Braunsbach,3 -  6 Jahre,91,49,42
False,8127009,Braunsbach,6 - 10 Jahre,150,81,69
False,8127009,Braunsbach,10 - 15 Jahre,150,90,60
False,8127009,Braunsbach,15 - 18 Jahre,84,42,42
False,8127009,Braunsbach,18 - 20 Jahre,56,31,25
False,8127009,Braunsbach,20 - 25 Jahre,119,68,51
False,8127009,Braunsbach,25 - 30 Jahre,149,78,71
False,8127009,Braunsbach,30 - 35 Jahre,206,97,109
False,8127009,Braunsbach,35 - 40 Jahre,216,125,91
False,8127009,Braunsbach,40 - 45 Jahre,156,83,73
False,8127009,Braunsbach,45 - 50 Jahre,126,66,60
False,8127009,Braunsbach,50 - 55 Jahre,143,68,75
False,8127009,Braunsbach,55 - 60 Jahre,156,76,80
False,8127009,Braunsbach,60 - 65 Jahre,112,58,54
False,8127009,Braunsbach,65 - 75 Jahre,267,108,159
False,8127009,Braunsbach,75 und mehr Jahre,147,52,95
False,8127009,Braunsbach,Insgesamt,2430,1218,1212
False,8127012,Bühlertann,unter 3 Jahre,144,70,74
False,8127012,Bühlertann,3 -  6 Jahre,125,70,55
False,8127012,Bühlertann,6 - 10 Jahre,162,95,67
False,8127012,Bühlertann,10 - 15 Jahre,191,109,82
False,8127012,Bühlertann,15 - 18 Jahre,99,60,39
False,8127012,Bühlertann,18 - 20 Jahre,53,25,28
False,8127012,Bühlertann,20 - 25 Jahre,180,94,86
False,8127012,Bühlertann,25 - 30 Jahre,246,135,111
False,8127012,Bühlertann,30 - 35 Jahre,262,132,130
False,8127012,Bühlertann,35 - 40 Jahre,205,107,98
False,8127012,Bühlertann,40 - 45 Jahre,177,89,88
False,8127012,Bühlertann,45 - 50 Jahre,156,87,69
False,8127012,Bühlertann,50 - 55 Jahre,120,59,61
False,8127012,Bühlertann,55 - 60 Jahre,172,84,88
False,8127012,Bühlertann,60 - 65 Jahre,127,62,65
False,8127012,Bühlertann,65 - 75 Jahre,217,94,123
False,8127012,Bühlertann,75 und mehr Jahre,100,40,60
False,8127012,Bühlertann,Insgesamt,2736,1412,1324
False,8127013,Bühlerzell,unter 3 Jahre,75,35,40
False,8127013,Bühlerzell,3 -  6 Jahre,82,45,37
False,8127013,Bühlerzell,6 - 10 Jahre,93,57,36
False,8127013,Bühlerzell,10 - 15 Jahre,122,73,49
False,8127013,Bühlerzell,15 - 18 Jahre,70,34,36
False,8127013,Bühlerzell,18 - 20 Jahre,41,23,18
False,8127013,Bühlerzell,20 - 25 Jahre,122,59,63
False,8127013,Bühlerzell,25 - 30 Jahre,142,79,63
False,8127013,Bühlerzell,30 - 35 Jahre,176,87,89
False,8127013,Bühlerzell,35 - 40 Jahre,149,82,67
False,8127013,Bühlerzell,40 - 45 Jahre,132,70,62
False,8127013,Bühlerzell,45 - 50 Jahre,89,53,36
False,8127013,Bühlerzell,50 - 55 Jahre,97,41,56
False,8127013,Bühlerzell,55 - 60 Jahre,117,60,57
False,8127013,Bühlerzell,60 - 65 Jahre,100,54,46
False,8127013,Bühlerzell,65 - 75 Jahre,157,62,95
False,8127013,Bühlerzell,75 und mehr Jahre,147,39,108
False,8127013,Bühlerzell,Insgesamt,1911,953,958
False,8127014,"Crailsheim, Stadt",unter 3 Jahre,1044,524,520
False,8127014,"Crailsheim, Stadt",3 -  6 Jahre,1096,558,538
False,8127014,"Crailsheim, Stadt",6 - 10 Jahre,1492,779,713
False,8127014,"Crailsheim, Stadt",10 - 15 Jahre,1932,1000,932
False,8127014,"Crailsheim, Stadt",15 - 18 Jahre,1180,589,591
False,8127014,"Crailsheim, Stadt",18 - 20 Jahre,716,367,349
False,8127014,"Crailsheim, Stadt",20 - 25 Jahre,1886,982,904
False,8127014,"Crailsheim, Stadt",25 - 30 Jahre,2491,1341,1150
False,8127014,"Crailsheim, Stadt",30 - 35 Jahre,2582,1362,1220
False,8127014,"Crailsheim, Stadt",35 - 40 Jahre,2428,1256,1172
False,8127014,"Crailsheim, Stadt",40 - 45 Jahre,2213,1093,1120
False,8127014,"Crailsheim, Stadt",45 - 50 Jahre,1835,947,888
False,8127014,"Crailsheim, Stadt",50 - 55 Jahre,1687,816,871
False,8127014,"Crailsheim, Stadt",55 - 60 Jahre,1993,1019,974
False,8127014,"Crailsheim, Stadt",60 - 65 Jahre,1657,796,861
False,8127014,"Crailsheim, Stadt",65 - 75 Jahre,2887,1185,1702
False,8127014,"Crailsheim, Stadt",75 und mehr Jahre,2103,621,1482
False,8127014,"Crailsheim, Stadt",Insgesamt,31222,15235,15987
False,8127023,Fichtenberg,unter 3 Jahre,104,54,50
False,8127023,Fichtenberg,3 -  6 Jahre,97,53,44
False,8127023,Fichtenberg,6 - 10 Jahre,162,89,73
False,8127023,Fichtenberg,10 - 15 Jahre,160,95,65
False,8127023,Fichtenberg,15 - 18 Jahre,68,37,31
False,8127023,Fichtenberg,18 - 20 Jahre,58,25,33
False,8127023,Fichtenberg,20 - 25 Jahre,165,82,83
False,8127023,Fichtenberg,25 - 30 Jahre,234,122,112
False,8127023,Fichtenberg,30 - 35 Jahre,227,119,108
False,8127023,Fichtenberg,35 - 40 Jahre,241,131,110
False,8127023,Fichtenberg,40 - 45 Jahre,190,92,98
False,8127023,Fichtenberg,45 - 50 Jahre,177,97,80
False,8127023,Fichtenberg,50 - 55 Jahre,147,74,73
False,8127023,Fichtenberg,55 - 60 Jahre,195,108,87
False,8127023,Fichtenberg,60 - 65 Jahre,139,69,70
False,8127023,Fichtenberg,65 - 75 Jahre,235,96,139
False,8127023,Fichtenberg,75 und mehr Jahre,170,57,113
False,8127023,Fichtenberg,Insgesamt,2769,1400,1369
False,8127025,"Gaildorf, Stadt",unter 3 Jahre,460,249,211
False,8127025,"Gaildorf, Stadt",3 -  6 Jahre,431,247,184
False,8127025,"Gaildorf, Stadt",6 - 10 Jahre,606,306,300
False,8127025,"Gaildorf, Stadt",10 - 15 Jahre,755,388,367
False,8127025,"Gaildorf, Stadt",15 - 18 Jahre,465,259,206
False,8127025,"Gaildorf, Stadt",18 - 20 Jahre,321,174,147
False,8127025,"Gaildorf, Stadt",20 - 25 Jahre,767,374,393
False,8127025,"Gaildorf, Stadt",25 - 30 Jahre,940,477,463
False,8127025,"Gaildorf, Stadt",30 - 35 Jahre,1060,556,504
False,8127025,"Gaildorf, Stadt",35 - 40 Jahre,948,477,471
False,8127025,"Gaildorf, Stadt",40 - 45 Jahre,888,457,431
False,8127025,"Gaildorf, Stadt",45 - 50 Jahre,709,360,349
False,8127025,"Gaildorf, Stadt",50 - 55 Jahre,649,334,315
False,8127025,"Gaildorf, Stadt",55 - 60 Jahre,806,404,402
False,8127025,"Gaildorf, Stadt",60 - 65 Jahre,653,313,340
False,8127025,"Gaildorf, Stadt",65 - 75 Jahre,1087,464,623
False,8127025,"Gaildorf, Stadt",75 und mehr Jahre,720,212,508
False,8127025,"Gaildorf, Stadt",Insgesamt,12265,6051,6214
False,8127032,"Gerabronn, Stadt",unter 3 Jahre,165,83,82
False,8127032,"Gerabronn, Stadt",3 -  6 Jahre,172,94,78
False,8127032,"Gerabronn, Stadt",6 - 10 Jahre,221,116,105
False,8127032,"Gerabronn, Stadt",10 - 15 Jahre,300,157,143
False,8127032,"Gerabronn, Stadt",15 - 18 Jahre,155,75,80
False,8127032,"Gerabronn, Stadt",18 - 20 Jahre,96,53,43
False,8127032,"Gerabronn, Stadt",20 - 25 Jahre,234,136,98
False,8127032,"Gerabronn, Stadt",25 - 30 Jahre,348,205,143
False,8127032,"Gerabronn, Stadt",30 - 35 Jahre,372,195,177
False,8127032,"Gerabronn, Stadt",35 - 40 Jahre,359,185,174
False,8127032,"Gerabronn, Stadt",40 - 45 Jahre,315,183,132
False,8127032,"Gerabronn, Stadt",45 - 50 Jahre,246,135,111
False,8127032,"Gerabronn, Stadt",50 - 55 Jahre,254,132,122
False,8127032,"Gerabronn, Stadt",55 - 60 Jahre,272,142,130
False,8127032,"Gerabronn, Stadt",60 - 65 Jahre,216,93,123
False,8127032,"Gerabronn, Stadt",65 - 75 Jahre,439,200,239
False,8127032,"Gerabronn, Stadt",75 und mehr Jahre,311,103,208
False,8127032,"Gerabronn, Stadt",Insgesamt,4475,2287,2188
False,8127043,"Ilshofen, Stadt",unter 3 Jahre,232,117,115
False,8127043,"Ilshofen, Stadt",3 -  6 Jahre,243,127,116
False,8127043,"Ilshofen, Stadt",6 - 10 Jahre,338,163,175
False,8127043,"Ilshofen, Stadt",10 - 15 Jahre,360,179,181
False,8127043,"Ilshofen, Stadt",15 - 18 Jahre,206,106,100
False,8127043,"Ilshofen, Stadt",18 - 20 Jahre,135,83,52
False,8127043,"Ilshofen, Stadt",20 - 25 Jahre,352,183,169
False,8127043,"Ilshofen, Stadt",25 - 30 Jahre,498,270,228
False,8127043,"Ilshofen, Stadt",30 - 35 Jahre,514,277,237
False,8127043,"Ilshofen, Stadt",35 - 40 Jahre,409,221,188
False,8127043,"Ilshofen, Stadt",40 - 45 Jahre,383,196,187
False,8127043,"Ilshofen, Stadt",45 - 50 Jahre,256,134,122
False,8127043,"Ilshofen, Stadt",50 - 55 Jahre,267,129,138
False,8127043,"Ilshofen, Stadt",55 - 60 Jahre,326,163,163
False,8127043,"Ilshofen, Stadt",60 - 65 Jahre,273,139,134
False,8127043,"Ilshofen, Stadt",65 - 75 Jahre,416,177,239
False,8127043,"Ilshofen, Stadt",75 und mehr Jahre,281,95,186
False,8127043,"Ilshofen, Stadt",Insgesamt,5489,2759,2730
False,8127046,"Kirchberg an der Jagst, Stadt",unter 3 Jahre,165,74,91
False,8127046,"Kirchberg an der Jagst, Stadt",3 -  6 Jahre,172,93,79
False,8127046,"Kirchberg an der Jagst, Stadt",6 - 10 Jahre,216,102,114
False,8127046,"Kirchberg an der Jagst, Stadt",10 - 15 Jahre,303,171,132
False,8127046,"Kirchberg an der Jagst, Stadt",15 - 18 Jahre,202,120,82
False,8127046,"Kirchberg an der Jagst, Stadt",18 - 20 Jahre,122,77,45
False,8127046,"Kirchberg an der Jagst, Stadt",20 - 25 Jahre,323,190,133
False,8127046,"Kirchberg an der Jagst, Stadt",25 - 30 Jahre,427,259,168
False,8127046,"Kirchberg an der Jagst, Stadt",30 - 35 Jahre,366,192,174
False,8127046,"Kirchberg an der Jagst, Stadt",35 - 40 Jahre,337,164,173
False,8127046,"Kirchberg an der Jagst, Stadt",40 - 45 Jahre,316,181,135
False,8127046,"Kirchberg an der Jagst, Stadt",45 - 50 Jahre,220,123,97
False,8127046,"Kirchberg an der Jagst, Stadt",50 - 55 Jahre,179,91,88
False,8127046,"Kirchberg an der Jagst, Stadt",55 - 60 Jahre,244,128,116
False,8127046,"Kirchberg an der Jagst, Stadt",60 - 65 Jahre,165,82,83
False,8127046,"Kirchberg an der Jagst, Stadt",65 - 75 Jahre,335,146,189
False,8127046,"Kirchberg an der Jagst, Stadt",75 und mehr Jahre,368,102,266
False,8127046,"Kirchberg an der Jagst, Stadt",Insgesamt,4460,2295,2165
False,8127047,"Langenburg, Stadt",unter 3 Jahre,80,43,37
False,8127047,"Langenburg, Stadt",3 -  6 Jahre,71,40,31
False,8127047,"Langenburg, Stadt",6 - 10 Jahre,98,53,45
False,8127047,"Langenburg, Stadt",10 - 15 Jahre,107,56,51
False,8127047,"Langenburg, Stadt",15 - 18 Jahre,51,26,25
False,8127047,"Langenburg, Stadt",18 - 20 Jahre,32,20,12
False,8127047,"Langenburg, Stadt",20 - 25 Jahre,101,47,54
False,8127047,"Langenburg, Stadt",25 - 30 Jahre,107,49,58
False,8127047,"Langenburg, Stadt",30 - 35 Jahre,159,73,86
False,8127047,"Langenburg, Stadt",35 - 40 Jahre,149,88,61
False,8127047,"Langenburg, Stadt",40 - 45 Jahre,117,59,58
False,8127047,"Langenburg, Stadt",45 - 50 Jahre,129,63,66
False,8127047,"Langenburg, Stadt",50 - 55 Jahre,92,45,47
False,8127047,"Langenburg, Stadt",55 - 60 Jahre,161,76,85
False,8127047,"Langenburg, Stadt",60 - 65 Jahre,124,75,49
False,8127047,"Langenburg, Stadt",65 - 75 Jahre,194,85,109
False,8127047,"Langenburg, Stadt",75 und mehr Jahre,151,47,104
False,8127047,"Langenburg, Stadt",Insgesamt,1923,945,978
False,8127052,Mainhardt,unter 3 Jahre,226,108,118
False,8127052,Mainhardt,3 -  6 Jahre,219,94,125
False,8127052,Mainhardt,6 - 10 Jahre,293,156,137
False,8127052,Mainhardt,10 - 15 Jahre,330,165,165
False,8127052,Mainhardt,15 - 18 Jahre,189,102,87
False,8127052,Mainhardt,18 - 20 Jahre,115,67,48
False,8127052,Mainhardt,20 - 25 Jahre,256,144,112
False,8127052,Mainhardt,25 - 30 Jahre,409,205,204
False,8127052,Mainhardt,30 - 35 Jahre,483,246,237
False,8127052,Mainhardt,35 - 40 Jahre,412,212,200
False,8127052,Mainhardt,40 - 45 Jahre,364,187,177
False,8127052,Mainhardt,45 - 50 Jahre,297,160,137
False,8127052,Mainhardt,50 - 55 Jahre,273,140,133
False,8127052,Mainhardt,55 - 60 Jahre,312,160,152
False,8127052,Mainhardt,60 - 65 Jahre,228,108,120
False,8127052,Mainhardt,65 - 75 Jahre,449,203,246
False,8127052,Mainhardt,75 und mehr Jahre,325,109,216
False,8127052,Mainhardt,Insgesamt,5180,2566,2614
False,8127056,Michelbach an der Bilz,unter 3 Jahre,127,75,52
False,8127056,Michelbach an der Bilz,3 -  6 Jahre,130,60,70
False,8127056,Michelbach an der Bilz,6 - 10 Jahre,182,86,96
False,8127056,Michelbach an der Bilz,10 - 15 Jahre,207,116,91
False,8127056,Michelbach an der Bilz,15 - 18 Jahre,138,73,65
False,8127056,Michelbach an der Bilz,18 - 20 Jahre,101,43,58
False,8127056,Michelbach an der Bilz,20 - 25 Jahre,191,94,97
False,8127056,Michelbach an der Bilz,25 - 30 Jahre,294,158,136
False,8127056,Michelbach an der Bilz,30 - 35 Jahre,286,133,153
False,8127056,Michelbach an der Bilz,35 - 40 Jahre,269,141,128
False,8127056,Michelbach an der Bilz,40 - 45 Jahre,244,112,132
False,8127056,Michelbach an der Bilz,45 - 50 Jahre,202,108,94
False,8127056,Michelbach an der Bilz,50 - 55 Jahre,196,109,87
False,8127056,Michelbach an der Bilz,55 - 60 Jahre,209,104,105
False,8127056,Michelbach an der Bilz,60 - 65 Jahre,132,77,55
False,8127056,Michelbach an der Bilz,65 - 75 Jahre,251,111,140
False,8127056,Michelbach an der Bilz,75 und mehr Jahre,138,43,95
False,8127056,Michelbach an der Bilz,Insgesamt,3297,1643,1654
False,8127059,Michelfeld,unter 3 Jahre,127,66,61
False,8127059,Michelfeld,3 -  6 Jahre,136,78,58
False,8127059,Michelfeld,6 - 10 Jahre,180,91,89
False,8127059,Michelfeld,10 - 15 Jahre,206,116,90
False,8127059,Michelfeld,15 - 18 Jahre,102,54,48
False,8127059,Michelfeld,18 - 20 Jahre,61,34,27
False,8127059,Michelfeld,20 - 25 Jahre,190,102,88
False,8127059,Michelfeld,25 - 30 Jahre,295,142,153
False,8127059,Michelfeld,30 - 35 Jahre,336,164,172
False,8127059,Michelfeld,35 - 40 Jahre,286,152,134
False,8127059,Michelfeld,40 - 45 Jahre,273,136,137
False,8127059,Michelfeld,45 - 50 Jahre,200,109,91
False,8127059,Michelfeld,50 - 55 Jahre,132,69,63
False,8127059,Michelfeld,55 - 60 Jahre,193,102,91
False,8127059,Michelfeld,60 - 65 Jahre,144,65,79
False,8127059,Michelfeld,65 - 75 Jahre,262,115,147
False,8127059,Michelfeld,75 und mehr Jahre,140,38,102
False,8127059,Michelfeld,Insgesamt,3263,1633,1630
False,8127062,Oberrot,unter 3 Jahre,157,84,73
False,8127062,Oberrot,3 -  6 Jahre,167,85,82
False,8127062,Oberrot,6 - 10 Jahre,202,97,105
False,8127062,Oberrot,10 - 15 Jahre,233,114,119
False,8127062,Oberrot,15 - 18 Jahre,102,56,46
False,8127062,Oberrot,18 - 20 Jahre,63,35,28
False,8127062,Oberrot,20 - 25 Jahre,197,96,101
False,8127062,Oberrot,25 - 30 Jahre,251,132,119
False,8127062,Oberrot,30 - 35 Jahre,307,153,154
False,8127062,Oberrot,35 - 40 Jahre,293,138,155
False,8127062,Oberrot,40 - 45 Jahre,263,150,113
False,8127062,Oberrot,45 - 50 Jahre,208,116,92
False,8127062,Oberrot,50 - 55 Jahre,153,80,73
False,8127062,Oberrot,55 - 60 Jahre,191,95,96
False,8127062,Oberrot,60 - 65 Jahre,152,68,84
False,8127062,Oberrot,65 - 75 Jahre,281,131,150
False,8127062,Oberrot,75 und mehr Jahre,256,71,185
False,8127062,Oberrot,Insgesamt,3476,1701,1775
False,8127063,Obersontheim,unter 3 Jahre,178,80,98
False,8127063,Obersontheim,3 -  6 Jahre,210,103,107
False,8127063,Obersontheim,6 - 10 Jahre,284,130,154
False,8127063,Obersontheim,10 - 15 Jahre,299,138,161
False,8127063,Obersontheim,15 - 18 Jahre,138,75,63
False,8127063,Obersontheim,18 - 20 Jahre,88,56,32
False,8127063,Obersontheim,20 - 25 Jahre,260,139,121
False,8127063,Obersontheim,25 - 30 Jahre,366,180,186
False,8127063,Obersontheim,30 - 35 Jahre,396,216,180
False,8127063,Obersontheim,35 - 40 Jahre,430,220,210
False,8127063,Obersontheim,40 - 45 Jahre,309,164,145
False,8127063,Obersontheim,45 - 50 Jahre,221,114,107
False,8127063,Obersontheim,50 - 55 Jahre,175,89,86
False,8127063,Obersontheim,55 - 60 Jahre,276,123,153
False,8127063,Obersontheim,60 - 65 Jahre,234,112,122
False,8127063,Obersontheim,65 - 75 Jahre,400,170,230
False,8127063,Obersontheim,75 und mehr Jahre,249,75,174
False,8127063,Obersontheim,Insgesamt,4513,2184,2329
False,8127071,Rot am See,unter 3 Jahre,186,90,96
False,8127071,Rot am See,3 -  6 Jahre,217,98,119
False,8127071,Rot am See,6 - 10 Jahre,298,149,149
False,8127071,Rot am See,10 - 15 Jahre,322,160,162
False,8127071,Rot am See,15 - 18 Jahre,174,94,80
False,8127071,Rot am See,18 - 20 Jahre,135,66,69
False,8127071,Rot am See,20 - 25 Jahre,286,149,137
False,8127071,Rot am See,25 - 30 Jahre,374,184,190
False,8127071,Rot am See,30 - 35 Jahre,426,220,206
False,8127071,Rot am See,35 - 40 Jahre,411,218,193
False,8127071,Rot am See,40 - 45 Jahre,336,178,158
False,8127071,Rot am See,45 - 50 Jahre,289,162,127
False,8127071,Rot am See,50 - 55 Jahre,239,121,118
False,8127071,Rot am See,55 - 60 Jahre,282,151,131
False,8127071,Rot am See,60 - 65 Jahre,240,117,123
False,8127071,Rot am See,65 - 75 Jahre,479,210,269
False,8127071,Rot am See,75 und mehr Jahre,314,106,208
False,8127071,Rot am See,Insgesamt,5008,2473,2535
False,8127073,Satteldorf,unter 3 Jahre,175,96,79
False,8127073,Satteldorf,3 -  6 Jahre,195,110,85
False,8127073,Satteldorf,6 - 10 Jahre,255,128,127
False,8127073,Satteldorf,10 - 15 Jahre,327,159,168
False,8127073,Satteldorf,15 - 18 Jahre,187,90,97
False,8127073,Satteldorf,18 - 20 Jahre,106,54,52
False,8127073,Satteldorf,20 - 25 Jahre,258,128,130
False,8127073,Satteldorf,25 - 30 Jahre,338,186,152
False,8127073,Satteldorf,30 - 35 Jahre,387,186,201
False,8127073,Satteldorf,35 - 40 Jahre,394,211,183
False,8127073,Satteldorf,40 - 45 Jahre,345,180,165
False,8127073,Satteldorf,45 - 50 Jahre,303,148,155
False,8127073,Satteldorf,50 - 55 Jahre,214,124,90
False,8127073,Satteldorf,55 - 60 Jahre,247,132,115
False,8127073,Satteldorf,60 - 65 Jahre,210,97,113
False,8127073,Satteldorf,65 - 75 Jahre,373,149,224
False,8127073,Satteldorf,75 und mehr Jahre,260,85,175
False,8127073,Satteldorf,Insgesamt,4574,2263,2311
False,8127075,"Schrozberg, Stadt",unter 3 Jahre,240,126,114
False,8127075,"Schrozberg, Stadt",3 -  6 Jahre,230,113,117
False,8127075,"Schrozberg, Stadt",6 - 10 Jahre,333,168,165
False,8127075,"Schrozberg, Stadt",10 - 15 Jahre,375,206,169
False,8127075,"Schrozberg, Stadt",15 - 18 Jahre,233,125,108
False,8127075,"Schrozberg, Stadt",18 - 20 Jahre,141,78,63
False,8127075,"Schrozberg, Stadt",20 - 25 Jahre,346,198,148
False,8127075,"Schrozberg, Stadt",25 - 30 Jahre,446,236,210
False,8127075,"Schrozberg, Stadt",30 - 35 Jahre,527,258,269
False,8127075,"Schrozberg, Stadt",35 - 40 Jahre,412,228,184
False,8127075,"Schrozberg, Stadt",40 - 45 Jahre,408,214,194
False,8127075,"Schrozberg, Stadt",45 - 50 Jahre,370,190,180
False,8127075,"Schrozberg, Stadt",50 - 55 Jahre,309,163,146
False,8127075,"Schrozberg, Stadt",55 - 60 Jahre,411,192,219
False,8127075,"Schrozberg, Stadt",60 - 65 Jahre,329,166,163
False,8127075,"Schrozberg, Stadt",65 - 75 Jahre,623,270,353
False,8127075,"Schrozberg, Stadt",75 und mehr Jahre,436,140,296
False,8127075,"Schrozberg, Stadt",Insgesamt,6169,3071,3098
False,8127076,"Schwäbisch Hall, Stadt",unter 3 Jahre,1120,613,507
False,8127076,"Schwäbisch Hall, Stadt",3 -  6 Jahre,1188,574,614
False,8127076,"Schwäbisch Hall, Stadt",6 - 10 Jahre,1612,788,824
False,8127076,"Schwäbisch Hall, Stadt",10 - 15 Jahre,2066,1067,999
False,8127076,"Schwäbisch Hall, Stadt",15 - 18 Jahre,1138,608,530
False,8127076,"Schwäbisch Hall, Stadt",18 - 20 Jahre,883,407,476
False,8127076,"Schwäbisch Hall, Stadt",20 - 25 Jahre,2319,1092,1227
False,8127076,"Schwäbisch Hall, Stadt",25 - 30 Jahre,2908,1466,1442
False,8127076,"Schwäbisch Hall, Stadt",30 - 35 Jahre,2927,1491,1436
False,8127076,"Schwäbisch Hall, Stadt",35 - 40 Jahre,2631,1280,1351
False,8127076,"Schwäbisch Hall, Stadt",40 - 45 Jahre,2443,1143,1300
False,8127076,"Schwäbisch Hall, Stadt",45 - 50 Jahre,2197,1093,1104
False,8127076,"Schwäbisch Hall, Stadt",50 - 55 Jahre,2025,1005,1020
False,8127076,"Schwäbisch Hall, Stadt",55 - 60 Jahre,2271,1095,1176
False,8127076,"Schwäbisch Hall, Stadt",60 - 65 Jahre,1618,768,850
False,8127076,"Schwäbisch Hall, Stadt",65 - 75 Jahre,3059,1174,1885
False,8127076,"Schwäbisch Hall, Stadt",75 und mehr Jahre,2505,743,1762
False,8127076,"Schwäbisch Hall, Stadt",Insgesamt,34910,16407,18503
False,8127079,Sulzbach-Laufen,unter 3 Jahre,88,40,48
False,8127079,Sulzbach-Laufen,3 -  6 Jahre,127,73,54
False,8127079,Sulzbach-Laufen,6 - 10 Jahre,156,83,73
False,8127079,Sulzbach-Laufen,10 - 15 Jahre,132,70,62
False,8127079,Sulzbach-Laufen,15 - 18 Jahre,105,57,48
False,8127079,Sulzbach-Laufen,18 - 20 Jahre,66,38,28
False,8127079,Sulzbach-Laufen,20 - 25 Jahre,166,93,73
False,8127079,Sulzbach-Laufen,25 - 30 Jahre,216,119,97
False,8127079,Sulzbach-Laufen,30 - 35 Jahre,214,110,104
False,8127079,Sulzbach-Laufen,35 - 40 Jahre,202,96,106
False,8127079,Sulzbach-Laufen,40 - 45 Jahre,161,85,76
False,8127079,Sulzbach-Laufen,45 - 50 Jahre,145,76,69
False,8127079,Sulzbach-Laufen,50 - 55 Jahre,127,70,57
False,8127079,Sulzbach-Laufen,55 - 60 Jahre,187,99,88
False,8127079,Sulzbach-Laufen,60 - 65 Jahre,133,57,76
False,8127079,Sulzbach-Laufen,65 - 75 Jahre,235,107,128
False,8127079,Sulzbach-Laufen,75 und mehr Jahre,129,46,83
False,8127079,Sulzbach-Laufen,Insgesamt,2589,1319,1270
False,8127086,Untermünkheim,unter 3 Jahre,157,72,85
False,8127086,Untermünkheim,3 -  6 Jahre,153,90,63
False,8127086,Untermünkheim,6 - 10 Jahre,171,94,77
False,8127086,Untermünkheim,10 - 15 Jahre,193,101,92
False,8127086,Untermünkheim,15 - 18 Jahre,85,39,46
False,8127086,Untermünkheim,18 - 20 Jahre,70,37,33
False,8127086,Untermünkheim,20 - 25 Jahre,188,91,97
False,8127086,Untermünkheim,25 - 30 Jahre,305,159,146
False,8127086,Untermünkheim,30 - 35 Jahre,278,153,125
False,8127086,Untermünkheim,35 - 40 Jahre,251,123,128
False,8127086,Untermünkheim,40 - 45 Jahre,196,101,95
False,8127086,Untermünkheim,45 - 50 Jahre,197,106,91
False,8127086,Untermünkheim,50 - 55 Jahre,149,76,73
False,8127086,Untermünkheim,55 - 60 Jahre,154,90,64
False,8127086,Untermünkheim,60 - 65 Jahre,151,66,85
False,8127086,Untermünkheim,65 - 75 Jahre,232,107,125
False,8127086,Untermünkheim,75 und mehr Jahre,131,39,92
False,8127086,Untermünkheim,Insgesamt,3061,1544,1517
False,8127089,"Vellberg, Stadt",unter 3 Jahre,153,79,74
False,8127089,"Vellberg, Stadt",3 -  6 Jahre,161,81,80
False,8127089,"Vellberg, Stadt",6 - 10 Jahre,226,112,114
False,8127089,"Vellberg, Stadt",10 - 15 Jahre,261,128,133
False,8127089,"Vellberg, Stadt",15 - 18 Jahre,140,80,60
False,8127089,"Vellberg, Stadt",18 - 20 Jahre,83,39,44
False,8127089,"Vellberg, Stadt",20 - 25 Jahre,253,135,118
False,8127089,"Vellberg, Stadt",25 - 30 Jahre,319,148,171
False,8127089,"Vellberg, Stadt",30 - 35 Jahre,373,206,167
False,8127089,"Vellberg, Stadt",35 - 40 Jahre,347,176,171
False,8127089,"Vellberg, Stadt",40 - 45 Jahre,296,173,123
False,8127089,"Vellberg, Stadt",45 - 50 Jahre,285,128,157
False,8127089,"Vellberg, Stadt",50 - 55 Jahre,240,125,115
False,8127089,"Vellberg, Stadt",55 - 60 Jahre,244,124,120
False,8127089,"Vellberg, Stadt",60 - 65 Jahre,162,94,68
False,8127089,"Vellberg, Stadt",65 - 75 Jahre,331,133,198
False,8127089,"Vellberg, Stadt",75 und mehr Jahre,259,86,173
False,8127089,"Vellberg, Stadt",Insgesamt,4133,2047,2086
False,8127091,Wallhausen,unter 3 Jahre,141,77,64
False,8127091,Wallhausen,3 -  6 Jahre,163,75,88
False,8127091,Wallhausen,6 - 10 Jahre,187,108,79
False,8127091,Wallhausen,10 - 15 Jahre,207,104,103
False,8127091,Wallhausen,15 - 18 Jahre,103,62,41
False,8127091,Wallhausen,18 - 20 Jahre,61,27,34
False,8127091,Wallhausen,20 - 25 Jahre,189,91,98
False,8127091,Wallhausen,25 - 30 Jahre,258,133,125
False,8127091,Wallhausen,30 - 35 Jahre,325,153,172
False,8127091,Wallhausen,35 - 40 Jahre,280,160,120
False,8127091,Wallhausen,40 - 45 Jahre,220,128,92
False,8127091,Wallhausen,45 - 50 Jahre,146,77,69
False,8127091,Wallhausen,50 - 55 Jahre,120,57,63
False,8127091,Wallhausen,55 - 60 Jahre,146,82,64
False,8127091,Wallhausen,60 - 65 Jahre,141,64,77
False,8127091,Wallhausen,65 - 75 Jahre,212,87,125
False,8127091,Wallhausen,75 und mehr Jahre,145,48,97
False,8127091,Wallhausen,Insgesamt,3044,1533,1511
False,8127099,Wolpertshausen,unter 3 Jahre,85,38,47
False,8127099,Wolpertshausen,3 -  6 Jahre,79,38,41
False,8127099,Wolpertshausen,6 - 10 Jahre,110,58,52
False,8127099,Wolpertshausen,10 - 15 Jahre,109,62,47
False,8127099,Wolpertshausen,15 - 18 Jahre,53,31,22
False,8127099,Wolpertshausen,18 - 20 Jahre,38,22,16
False,8127099,Wolpertshausen,20 - 25 Jahre,100,57,43
False,8127099,Wolpertshausen,25 - 30 Jahre,131,79,52
False,8127099,Wolpertshausen,30 - 35 Jahre,149,73,76
False,8127099,Wolpertshausen,35 - 40 Jahre,127,66,61
False,8127099,Wolpertshausen,40 - 45 Jahre,119,65,54
False,8127099,Wolpertshausen,45 - 50 Jahre,88,47,41
False,8127099,Wolpertshausen,50 - 55 Jahre,56,33,23
False,8127099,Wolpertshausen,55 - 60 Jahre,69,33,36
False,8127099,Wolpertshausen,60 - 65 Jahre,75,39,36
False,8127099,Wolpertshausen,65 - 75 Jahre,133,56,77
False,8127099,Wolpertshausen,75 und mehr Jahre,97,39,58
False,8127099,Wolpertshausen,Insgesamt,1618,836,782
False,8127100,Rosengarten,unter 3 Jahre,187,94,93
False,8127100,Rosengarten,3 -  6 Jahre,218,120,98
False,8127100,Rosengarten,6 - 10 Jahre,265,140,125
False,8127100,Rosengarten,10 - 15 Jahre,275,142,133
False,8127100,Rosengarten,15 - 18 Jahre,148,66,82
False,8127100,Rosengarten,18 - 20 Jahre,101,52,49
False,8127100,Rosengarten,20 - 25 Jahre,247,111,136
False,8127100,Rosengarten,25 - 30 Jahre,415,216,199
False,8127100,Rosengarten,30 - 35 Jahre,459,232,227
False,8127100,Rosengarten,35 - 40 Jahre,398,204,194
False,8127100,Rosengarten,40 - 45 Jahre,334,157,177
False,8127100,Rosengarten,45 - 50 Jahre,283,153,130
False,8127100,Rosengarten,50 - 55 Jahre,246,123,123
False,8127100,Rosengarten,55 - 60 Jahre,296,163,133
False,8127100,Rosengarten,60 - 65 Jahre,221,96,125
False,8127100,Rosengarten,65 - 75 Jahre,382,169,213
False,8127100,Rosengarten,75 und mehr Jahre,324,93,231
False,8127100,Rosengarten,Insgesamt,4799,2331,2468
False,8127101,Kreßberg,unter 3 Jahre,150,78,72
False,8127101,Kreßberg,3 -  6 Jahre,171,92,79
False,8127101,Kreßberg,6 - 10 Jahre,259,136,123
False,8127101,Kreßberg,10 - 15 Jahre,260,133,127
False,8127101,Kreßberg,15 - 18 Jahre,132,62,70
False,8127101,Kreßberg,18 - 20 Jahre,89,47,42
False,8127101,Kreßberg,20 - 25 Jahre,212,104,108
False,8127101,Kreßberg,25 - 30 Jahre,285,139,146
False,8127101,Kreßberg,30 - 35 Jahre,341,173,168
False,8127101,Kreßberg,35 - 40 Jahre,338,183,155
False,8127101,Kreßberg,40 - 45 Jahre,272,131,141
False,8127101,Kreßberg,45 - 50 Jahre,249,141,108
False,8127101,Kreßberg,50 - 55 Jahre,155,82,73
False,8127101,Kreßberg,55 - 60 Jahre,223,113,110
False,8127101,Kreßberg,60 - 65 Jahre,188,91,97
False,8127101,Kreßberg,65 - 75 Jahre,333,154,179
False,8127101,Kreßberg,75 und mehr Jahre,211,73,138
False,8127101,Kreßberg,Insgesamt,3868,1932,1936
False,8127102,Fichtenau,unter 3 Jahre,183,100,83
False,8127102,Fichtenau,3 -  6 Jahre,200,112,88
False,8127102,Fichtenau,6 - 10 Jahre,235,114,121
False,8127102,Fichtenau,10 - 15 Jahre,338,187,151
False,8127102,Fichtenau,15 - 18 Jahre,186,88,98
False,8127102,Fichtenau,18 - 20 Jahre,125,73,52
False,8127102,Fichtenau,20 - 25 Jahre,315,154,161
False,8127102,Fichtenau,25 - 30 Jahre,395,198,197
False,8127102,Fichtenau,30 - 35 Jahre,418,243,175
False,8127102,Fichtenau,35 - 40 Jahre,377,193,184
False,8127102,Fichtenau,40 - 45 Jahre,321,160,161
False,8127102,Fichtenau,45 - 50 Jahre,274,151,123
False,8127102,Fichtenau,50 - 55 Jahre,211,112,99
False,8127102,Fichtenau,55 - 60 Jahre,274,130,144
False,8127102,Fichtenau,60 - 65 Jahre,220,107,113
False,8127102,Fichtenau,65 - 75 Jahre,378,157,221
False,8127102,Fichtenau,75 und mehr Jahre,213,57,156
False,8127102,Fichtenau,Insgesamt,4663,2336,2327
False,8127103,Frankenhardt,unter 3 Jahre,192,86,106
False,8127103,Frankenhardt,3 -  6 Jahre,203,113,90
False,8127103,Frankenhardt,6 - 10 Jahre,274,150,124
False,8127103,Frankenhardt,10 - 15 Jahre,322,184,138
False,8127103,Frankenhardt,15 - 18 Jahre,182,106,76
False,8127103,Frankenhardt,18 - 20 Jahre,103,52,51
False,8127103,Frankenhardt,20 - 25 Jahre,263,137,126
False,8127103,Frankenhardt,25 - 30 Jahre,290,157,133
False,8127103,Frankenhardt,30 - 35 Jahre,368,182,186
False,8127103,Frankenhardt,35 - 40 Jahre,401,211,190
False,8127103,Frankenhardt,40 - 45 Jahre,350,178,172
False,8127103,Frankenhardt,45 - 50 Jahre,250,143,107
False,8127103,Frankenhardt,50 - 55 Jahre,198,103,95
False,8127103,Frankenhardt,55 - 60 Jahre,238,117,121
False,8127103,Frankenhardt,60 - 65 Jahre,243,118,125
False,8127103,Frankenhardt,65 - 75 Jahre,347,157,190
False,8127103,Frankenhardt,75 und mehr Jahre,268,98,170
False,8127103,Frankenhardt,Insgesamt,4492,2292,2200
False,8127104,Stimpfach,unter 3 Jahre,139,71,68
False,8127104,Stimpfach,3 -  6 Jahre,135,84,51
False,8127104,Stimpfach,6 - 10 Jahre,177,77,100
False,8127104,Stimpfach,10 - 15 Jahre,256,124,132
False,8127104,Stimpfach,15 - 18 Jahre,108,62,46
False,8127104,Stimpfach,18 - 20 Jahre,71,42,29
False,8127104,Stimpfach,20 - 25 Jahre,201,105,96
False,8127104,Stimpfach,25 - 30 Jahre,275,152,123
False,8127104,Stimpfach,30 - 35 Jahre,286,152,134
False,8127104,Stimpfach,35 - 40 Jahre,259,131,128
False,8127104,Stimpfach,40 - 45 Jahre,218,114,104
False,8127104,Stimpfach,45 - 50 Jahre,187,103,84
False,8127104,Stimpfach,50 - 55 Jahre,126,68,58
False,8127104,Stimpfach,55 - 60 Jahre,174,83,91
False,8127104,Stimpfach,60 - 65 Jahre,125,58,67
False,8127104,Stimpfach,65 - 75 Jahre,231,98,133
False,8127104,Stimpfach,75 und mehr Jahre,140,46,94
False,8127104,Stimpfach,Insgesamt,3108,1570,1538
False,8128,Landkreis Main-Tauber-Kreis,unter 3 Jahre,4603,2377,2226
False,8128,Landkreis Main-Tauber-Kreis,3 -  6 Jahre,4902,2588,2314
False,8128,Landkreis Main-Tauber-Kreis,6 - 10 Jahre,6781,3416,3365
False,8128,Landkreis Main-Tauber-Kreis,10 - 15 Jahre,8230,4313,3917
False,8128,Landkreis Main-Tauber-Kreis,15 - 18 Jahre,4747,2427,2320
False,8128,Landkreis Main-Tauber-Kreis,18 - 20 Jahre,3173,1560,1613
False,8128,Landkreis Main-Tauber-Kreis,20 - 25 Jahre,8395,4343,4052
False,8128,Landkreis Main-Tauber-Kreis,25 - 30 Jahre,10763,5716,5047
False,8128,Landkreis Main-Tauber-Kreis,30 - 35 Jahre,11664,6103,5561
False,8128,Landkreis Main-Tauber-Kreis,35 - 40 Jahre,10485,5408,5077
False,8128,Landkreis Main-Tauber-Kreis,40 - 45 Jahre,9455,4806,4649
False,8128,Landkreis Main-Tauber-Kreis,45 - 50 Jahre,8102,4186,3916
False,8128,Landkreis Main-Tauber-Kreis,50 - 55 Jahre,6921,3535,3386
False,8128,Landkreis Main-Tauber-Kreis,55 - 60 Jahre,9035,4595,4440
False,8128,Landkreis Main-Tauber-Kreis,60 - 65 Jahre,6882,3361,3521
False,8128,Landkreis Main-Tauber-Kreis,65 - 75 Jahre,13341,5501,7840
False,8128,Landkreis Main-Tauber-Kreis,75 und mehr Jahre,9440,2923,6517
False,8128,Landkreis Main-Tauber-Kreis,Insgesamt,136919,67158,69761
False,8128006,Assamstadt,unter 3 Jahre,87,46,41
False,8128006,Assamstadt,3 -  6 Jahre,99,57,42
False,8128006,Assamstadt,6 - 10 Jahre,120,56,64
False,8128006,Assamstadt,10 - 15 Jahre,169,85,84
False,8128006,Assamstadt,15 - 18 Jahre,78,39,39
False,8128006,Assamstadt,18 - 20 Jahre,52,21,31
False,8128006,Assamstadt,20 - 25 Jahre,148,69,79
False,8128006,Assamstadt,25 - 30 Jahre,166,96,70
False,8128006,Assamstadt,30 - 35 Jahre,190,81,109
False,8128006,Assamstadt,35 - 40 Jahre,179,100,79
False,8128006,Assamstadt,40 - 45 Jahre,140,78,62
False,8128006,Assamstadt,45 - 50 Jahre,118,61,57
False,8128006,Assamstadt,50 - 55 Jahre,79,41,38
False,8128006,Assamstadt,55 - 60 Jahre,103,50,53
False,8128006,Assamstadt,60 - 65 Jahre,91,48,43
False,8128006,Assamstadt,65 - 75 Jahre,175,68,107
False,8128006,Assamstadt,75 und mehr Jahre,82,31,51
False,8128006,Assamstadt,Insgesamt,2076,1027,1049
False,8128007,"Bad Mergentheim, Stadt",unter 3 Jahre,671,326,345
False,8128007,"Bad Mergentheim, Stadt",3 -  6 Jahre,660,354,306
False,8128007,"Bad Mergentheim, Stadt",6 - 10 Jahre,1038,507,531
False,8128007,"Bad Mergentheim, Stadt",10 - 15 Jahre,1227,646,581
False,8128007,"Bad Mergentheim, Stadt",15 - 18 Jahre,776,427,349
False,8128007,"Bad Mergentheim, Stadt",18 - 20 Jahre,508,233,275
False,8128007,"Bad Mergentheim, Stadt",20 - 25 Jahre,1404,708,696
False,8128007,"Bad Mergentheim, Stadt",25 - 30 Jahre,1696,859,837
False,8128007,"Bad Mergentheim, Stadt",30 - 35 Jahre,1759,896,863
False,8128007,"Bad Mergentheim, Stadt",35 - 40 Jahre,1618,758,860
False,8128007,"Bad Mergentheim, Stadt",40 - 45 Jahre,1570,788,782
False,8128007,"Bad Mergentheim, Stadt",45 - 50 Jahre,1319,622,697
False,8128007,"Bad Mergentheim, Stadt",50 - 55 Jahre,1219,594,625
False,8128007,"Bad Mergentheim, Stadt",55 - 60 Jahre,1507,716,791
False,8128007,"Bad Mergentheim, Stadt",60 - 65 Jahre,1132,513,619
False,8128007,"Bad Mergentheim, Stadt",65 - 75 Jahre,2327,914,1413
False,8128007,"Bad Mergentheim, Stadt",75 und mehr Jahre,2137,635,1502
False,8128007,"Bad Mergentheim, Stadt",Insgesamt,22568,10496,12072
False,8128014,"Boxberg, Stadt",unter 3 Jahre,256,129,127
False,8128014,"Boxberg, Stadt",3 -  6 Jahre,279,133,146
False,8128014,"Boxberg, Stadt",6 - 10 Jahre,414,220,194
False,8128014,"Boxberg, Stadt",10 - 15 Jahre,444,235,209
False,8128014,"Boxberg, Stadt",15 - 18 Jahre,258,127,131
False,8128014,"Boxberg, Stadt",18 - 20 Jahre,198,90,108
False,8128014,"Boxberg, Stadt",20 - 25 Jahre,439,231,208
False,8128014,"Boxberg, Stadt",25 - 30 Jahre,579,294,285
False,8128014,"Boxberg, Stadt",30 - 35 Jahre,623,319,304
False,8128014,"Boxberg, Stadt",35 - 40 Jahre,569,308,261
False,8128014,"Boxberg, Stadt",40 - 45 Jahre,555,267,288
False,8128014,"Boxberg, Stadt",45 - 50 Jahre,439,242,197
False,8128014,"Boxberg, Stadt",50 - 55 Jahre,331,178,153
False,8128014,"Boxberg, Stadt",55 - 60 Jahre,473,254,219
False,8128014,"Boxberg, Stadt",60 - 65 Jahre,315,152,163
False,8128014,"Boxberg, Stadt",65 - 75 Jahre,667,274,393
False,8128014,"Boxberg, Stadt",75 und mehr Jahre,464,135,329
False,8128014,"Boxberg, Stadt",Insgesamt,7303,3588,3715
False,8128020,"Creglingen, Stadt",unter 3 Jahre,191,106,85
False,8128020,"Creglingen, Stadt",3 -  6 Jahre,187,92,95
False,8128020,"Creglingen, Stadt",6 - 10 Jahre,213,92,121
False,8128020,"Creglingen, Stadt",10 - 15 Jahre,291,143,148
False,8128020,"Creglingen, Stadt",15 - 18 Jahre,175,83,92
False,8128020,"Creglingen, Stadt",18 - 20 Jahre,127,72,55
False,8128020,"Creglingen, Stadt",20 - 25 Jahre,324,171,153
False,8128020,"Creglingen, Stadt",25 - 30 Jahre,367,215,152
False,8128020,"Creglingen, Stadt",30 - 35 Jahre,369,193,176
False,8128020,"Creglingen, Stadt",35 - 40 Jahre,364,185,179
False,8128020,"Creglingen, Stadt",40 - 45 Jahre,321,174,147
False,8128020,"Creglingen, Stadt",45 - 50 Jahre,278,162,116
False,8128020,"Creglingen, Stadt",50 - 55 Jahre,212,100,112
False,8128020,"Creglingen, Stadt",55 - 60 Jahre,355,186,169
False,8128020,"Creglingen, Stadt",60 - 65 Jahre,333,167,166
False,8128020,"Creglingen, Stadt",65 - 75 Jahre,552,248,304
False,8128020,"Creglingen, Stadt",75 und mehr Jahre,382,125,257
False,8128020,"Creglingen, Stadt",Insgesamt,5041,2514,2527
False,8128039,"Freudenberg, Stadt",unter 3 Jahre,135,64,71
False,8128039,"Freudenberg, Stadt",3 -  6 Jahre,135,66,69
False,8128039,"Freudenberg, Stadt",6 - 10 Jahre,186,96,90
False,8128039,"Freudenberg, Stadt",10 - 15 Jahre,271,141,130
False,8128039,"Freudenberg, Stadt",15 - 18 Jahre,174,91,83
False,8128039,"Freudenberg, Stadt",18 - 20 Jahre,90,40,50
False,8128039,"Freudenberg, Stadt",20 - 25 Jahre,259,127,132
False,8128039,"Freudenberg, Stadt",25 - 30 Jahre,297,164,133
False,8128039,"Freudenberg, Stadt",30 - 35 Jahre,349,185,164
False,8128039,"Freudenberg, Stadt",35 - 40 Jahre,288,147,141
False,8128039,"Freudenberg, Stadt",40 - 45 Jahre,311,161,150
False,8128039,"Freudenberg, Stadt",45 - 50 Jahre,216,121,95
False,8128039,"Freudenberg, Stadt",50 - 55 Jahre,191,96,95
False,8128039,"Freudenberg, Stadt",55 - 60 Jahre,308,149,159
False,8128039,"Freudenberg, Stadt",60 - 65 Jahre,225,118,107
False,8128039,"Freudenberg, Stadt",65 - 75 Jahre,432,186,246
False,8128039,"Freudenberg, Stadt",75 und mehr Jahre,257,77,180
False,8128039,"Freudenberg, Stadt",Insgesamt,4124,2029,2095
False,8128045,Großrinderfeld,unter 3 Jahre,171,95,76
False,8128045,Großrinderfeld,3 -  6 Jahre,200,112,88
False,8128045,Großrinderfeld,6 - 10 Jahre,254,123,131
False,8128045,Großrinderfeld,10 - 15 Jahre,272,138,134
False,8128045,Großrinderfeld,15 - 18 Jahre,136,77,59
False,8128045,Großrinderfeld,18 - 20 Jahre,103,44,59
False,8128045,Großrinderfeld,20 - 25 Jahre,244,119,125
False,8128045,Großrinderfeld,25 - 30 Jahre,348,191,157
False,8128045,Großrinderfeld,30 - 35 Jahre,414,203,211
False,8128045,Großrinderfeld,35 - 40 Jahre,357,187,170
False,8128045,Großrinderfeld,40 - 45 Jahre,287,151,136
False,8128045,Großrinderfeld,45 - 50 Jahre,266,142,124
False,8128045,Großrinderfeld,50 - 55 Jahre,147,73,74
False,8128045,Großrinderfeld,55 - 60 Jahre,231,124,107
False,8128045,Großrinderfeld,60 - 65 Jahre,164,78,86
False,8128045,Großrinderfeld,65 - 75 Jahre,313,133,180
False,8128045,Großrinderfeld,75 und mehr Jahre,200,67,133
False,8128045,Großrinderfeld,Insgesamt,4107,2057,2050
False,8128047,"Grünsfeld, Stadt",unter 3 Jahre,159,85,74
False,8128047,"Grünsfeld, Stadt",3 -  6 Jahre,155,94,61
False,8128047,"Grünsfeld, Stadt",6 - 10 Jahre,212,116,96
False,8128047,"Grünsfeld, Stadt",10 - 15 Jahre,235,125,110
False,8128047,"Grünsfeld, Stadt",15 - 18 Jahre,108,50,58
False,8128047,"Grünsfeld, Stadt",18 - 20 Jahre,72,36,36
False,8128047,"Grünsfeld, Stadt",20 - 25 Jahre,193,94,99
False,8128047,"Grünsfeld, Stadt",25 - 30 Jahre,296,144,152
False,8128047,"Grünsfeld, Stadt",30 - 35 Jahre,401,221,180
False,8128047,"Grünsfeld, Stadt",35 - 40 Jahre,307,170,137
False,8128047,"Grünsfeld, Stadt",40 - 45 Jahre,250,133,117
False,8128047,"Grünsfeld, Stadt",45 - 50 Jahre,196,103,93
False,8128047,"Grünsfeld, Stadt",50 - 55 Jahre,159,89,70
False,8128047,"Grünsfeld, Stadt",55 - 60 Jahre,249,122,127
False,8128047,"Grünsfeld, Stadt",60 - 65 Jahre,205,101,104
False,8128047,"Grünsfeld, Stadt",65 - 75 Jahre,395,172,223
False,8128047,"Grünsfeld, Stadt",75 und mehr Jahre,193,62,131
False,8128047,"Grünsfeld, Stadt",Insgesamt,3785,1917,1868
False,8128058,Igersheim,unter 3 Jahre,216,107,109
False,8128058,Igersheim,3 -  6 Jahre,195,89,106
False,8128058,Igersheim,6 - 10 Jahre,302,149,153
False,8128058,Igersheim,10 - 15 Jahre,341,177,164
False,8128058,Igersheim,15 - 18 Jahre,181,91,90
False,8128058,Igersheim,18 - 20 Jahre,130,71,59
False,8128058,Igersheim,20 - 25 Jahre,324,171,153
False,8128058,Igersheim,25 - 30 Jahre,448,223,225
False,8128058,Igersheim,30 - 35 Jahre,477,228,249
False,8128058,Igersheim,35 - 40 Jahre,434,204,230
False,8128058,Igersheim,40 - 45 Jahre,431,212,219
False,8128058,Igersheim,45 - 50 Jahre,330,177,153
False,8128058,Igersheim,50 - 55 Jahre,287,155,132
False,8128058,Igersheim,55 - 60 Jahre,367,190,177
False,8128058,Igersheim,60 - 65 Jahre,230,114,116
False,8128058,Igersheim,65 - 75 Jahre,464,190,274
False,8128058,Igersheim,75 und mehr Jahre,300,117,183
False,8128058,Igersheim,Insgesamt,5457,2665,2792
False,8128061,Königheim,unter 3 Jahre,119,60,59
False,8128061,Königheim,3 -  6 Jahre,153,76,77
False,8128061,Königheim,6 - 10 Jahre,169,92,77
False,8128061,Königheim,10 - 15 Jahre,201,97,104
False,8128061,Königheim,15 - 18 Jahre,117,63,54
False,8128061,Königheim,18 - 20 Jahre,74,47,27
False,8128061,Königheim,20 - 25 Jahre,223,116,107
False,8128061,Königheim,25 - 30 Jahre,266,151,115
False,8128061,Königheim,30 - 35 Jahre,296,175,121
False,8128061,Königheim,35 - 40 Jahre,259,138,121
False,8128061,Königheim,40 - 45 Jahre,214,119,95
False,8128061,Königheim,45 - 50 Jahre,216,103,113
False,8128061,Königheim,50 - 55 Jahre,175,97,78
False,8128061,Königheim,55 - 60 Jahre,242,125,117
False,8128061,Königheim,60 - 65 Jahre,162,80,82
False,8128061,Königheim,65 - 75 Jahre,350,151,199
False,8128061,Königheim,75 und mehr Jahre,230,71,159
False,8128061,Königheim,Insgesamt,3466,1761,1705
False,8128064,"Külsheim, Stadt",unter 3 Jahre,209,102,107
False,8128064,"Külsheim, Stadt",3 -  6 Jahre,255,144,111
False,8128064,"Külsheim, Stadt",6 - 10 Jahre,332,175,157
False,8128064,"Külsheim, Stadt",10 - 15 Jahre,404,211,193
False,8128064,"Külsheim, Stadt",15 - 18 Jahre,235,119,116
False,8128064,"Külsheim, Stadt",18 - 20 Jahre,131,60,71
False,8128064,"Külsheim, Stadt",20 - 25 Jahre,345,187,158
False,8128064,"Külsheim, Stadt",25 - 30 Jahre,522,300,222
False,8128064,"Külsheim, Stadt",30 - 35 Jahre,564,325,239
False,8128064,"Külsheim, Stadt",35 - 40 Jahre,470,244,226
False,8128064,"Külsheim, Stadt",40 - 45 Jahre,409,208,201
False,8128064,"Külsheim, Stadt",45 - 50 Jahre,349,185,164
False,8128064,"Külsheim, Stadt",50 - 55 Jahre,258,142,116
False,8128064,"Külsheim, Stadt",55 - 60 Jahre,393,208,185
False,8128064,"Külsheim, Stadt",60 - 65 Jahre,251,124,127
False,8128064,"Külsheim, Stadt",65 - 75 Jahre,539,218,321
False,8128064,"Külsheim, Stadt",75 und mehr Jahre,320,103,217
False,8128064,"Külsheim, Stadt",Insgesamt,5986,3055,2931
False,8128082,"Niederstetten, Stadt",unter 3 Jahre,180,80,100
False,8128082,"Niederstetten, Stadt",3 -  6 Jahre,188,104,84
False,8128082,"Niederstetten, Stadt",6 - 10 Jahre,267,141,126
False,8128082,"Niederstetten, Stadt",10 - 15 Jahre,353,184,169
False,8128082,"Niederstetten, Stadt",15 - 18 Jahre,213,94,119
False,8128082,"Niederstetten, Stadt",18 - 20 Jahre,128,60,68
False,8128082,"Niederstetten, Stadt",20 - 25 Jahre,377,207,170
False,8128082,"Niederstetten, Stadt",25 - 30 Jahre,471,273,198
False,8128082,"Niederstetten, Stadt",30 - 35 Jahre,587,371,216
False,8128082,"Niederstetten, Stadt",35 - 40 Jahre,447,228,219
False,8128082,"Niederstetten, Stadt",40 - 45 Jahre,376,202,174
False,8128082,"Niederstetten, Stadt",45 - 50 Jahre,321,165,156
False,8128082,"Niederstetten, Stadt",50 - 55 Jahre,266,149,117
False,8128082,"Niederstetten, Stadt",55 - 60 Jahre,341,167,174
False,8128082,"Niederstetten, Stadt",60 - 65 Jahre,253,140,113
False,8128082,"Niederstetten, Stadt",65 - 75 Jahre,507,205,302
False,8128082,"Niederstetten, Stadt",75 und mehr Jahre,336,113,223
False,8128082,"Niederstetten, Stadt",Insgesamt,5611,2883,2728
False,8128115,"Tauberbischofsheim, Stadt",unter 3 Jahre,385,208,177
False,8128115,"Tauberbischofsheim, Stadt",3 -  6 Jahre,437,219,218
False,8128115,"Tauberbischofsheim, Stadt",6 - 10 Jahre,599,285,314
False,8128115,"Tauberbischofsheim, Stadt",10 - 15 Jahre,691,375,316
False,8128115,"Tauberbischofsheim, Stadt",15 - 18 Jahre,425,228,197
False,8128115,"Tauberbischofsheim, Stadt",18 - 20 Jahre,322,148,174
False,8128115,"Tauberbischofsheim, Stadt",20 - 25 Jahre,866,439,427
False,8128115,"Tauberbischofsheim, Stadt",25 - 30 Jahre,968,539,429
False,8128115,"Tauberbischofsheim, Stadt",30 - 35 Jahre,1016,538,478
False,8128115,"Tauberbischofsheim, Stadt",35 - 40 Jahre,939,475,464
False,8128115,"Tauberbischofsheim, Stadt",40 - 45 Jahre,899,452,447
False,8128115,"Tauberbischofsheim, Stadt",45 - 50 Jahre,801,405,396
False,8128115,"Tauberbischofsheim, Stadt",50 - 55 Jahre,734,379,355
False,8128115,"Tauberbischofsheim, Stadt",55 - 60 Jahre,847,438,409
False,8128115,"Tauberbischofsheim, Stadt",60 - 65 Jahre,628,291,337
False,8128115,"Tauberbischofsheim, Stadt",65 - 75 Jahre,1226,491,735
False,8128115,"Tauberbischofsheim, Stadt",75 und mehr Jahre,854,255,599
False,8128115,"Tauberbischofsheim, Stadt",Insgesamt,12637,6165,6472
False,8128126,"Weikersheim, Stadt",unter 3 Jahre,230,127,103
False,8128126,"Weikersheim, Stadt",3 -  6 Jahre,256,142,114
False,8128126,"Weikersheim, Stadt",6 - 10 Jahre,336,171,165
False,8128126,"Weikersheim, Stadt",10 - 15 Jahre,424,218,206
False,8128126,"Weikersheim, Stadt",15 - 18 Jahre,252,118,134
False,8128126,"Weikersheim, Stadt",18 - 20 Jahre,152,80,72
False,8128126,"Weikersheim, Stadt",20 - 25 Jahre,430,204,226
False,8128126,"Weikersheim, Stadt",25 - 30 Jahre,593,315,278
False,8128126,"Weikersheim, Stadt",30 - 35 Jahre,556,291,265
False,8128126,"Weikersheim, Stadt",35 - 40 Jahre,542,284,258
False,8128126,"Weikersheim, Stadt",40 - 45 Jahre,488,247,241
False,8128126,"Weikersheim, Stadt",45 - 50 Jahre,417,227,190
False,8128126,"Weikersheim, Stadt",50 - 55 Jahre,444,221,223
False,8128126,"Weikersheim, Stadt",55 - 60 Jahre,517,272,245
False,8128126,"Weikersheim, Stadt",60 - 65 Jahre,381,191,190
False,8128126,"Weikersheim, Stadt",65 - 75 Jahre,725,301,424
False,8128126,"Weikersheim, Stadt",75 und mehr Jahre,517,150,367
False,8128126,"Weikersheim, Stadt",Insgesamt,7260,3559,3701
False,8128128,Werbach,unter 3 Jahre,160,74,86
False,8128128,Werbach,3 -  6 Jahre,127,70,57
False,8128128,Werbach,6 - 10 Jahre,204,107,97
False,8128128,Werbach,10 - 15 Jahre,227,112,115
False,8128128,Werbach,15 - 18 Jahre,93,45,48
False,8128128,Werbach,18 - 20 Jahre,74,41,33
False,8128128,Werbach,20 - 25 Jahre,208,106,102
False,8128128,Werbach,25 - 30 Jahre,286,153,133
False,8128128,Werbach,30 - 35 Jahre,307,162,145
False,8128128,Werbach,35 - 40 Jahre,325,177,148
False,8128128,Werbach,40 - 45 Jahre,246,128,118
False,8128128,Werbach,45 - 50 Jahre,209,116,93
False,8128128,Werbach,50 - 55 Jahre,172,97,75
False,8128128,Werbach,55 - 60 Jahre,206,102,104
False,8128128,Werbach,60 - 65 Jahre,191,94,97
False,8128128,Werbach,65 - 75 Jahre,377,161,216
False,8128128,Werbach,75 und mehr Jahre,234,73,161
False,8128128,Werbach,Insgesamt,3646,1818,1828
False,8128131,"Wertheim, Stadt",unter 3 Jahre,835,436,399
False,8128131,"Wertheim, Stadt",3 -  6 Jahre,862,451,411
False,8128131,"Wertheim, Stadt",6 - 10 Jahre,1154,588,566
False,8128131,"Wertheim, Stadt",10 - 15 Jahre,1471,771,700
False,8128131,"Wertheim, Stadt",15 - 18 Jahre,888,450,438
False,8128131,"Wertheim, Stadt",18 - 20 Jahre,549,291,258
False,8128131,"Wertheim, Stadt",20 - 25 Jahre,1437,771,666
False,8128131,"Wertheim, Stadt",25 - 30 Jahre,1949,982,967
False,8128131,"Wertheim, Stadt",30 - 35 Jahre,2116,1081,1035
False,8128131,"Wertheim, Stadt",35 - 40 Jahre,1855,1001,854
False,8128131,"Wertheim, Stadt",40 - 45 Jahre,1627,790,837
False,8128131,"Wertheim, Stadt",45 - 50 Jahre,1432,740,692
False,8128131,"Wertheim, Stadt",50 - 55 Jahre,1202,616,586
False,8128131,"Wertheim, Stadt",55 - 60 Jahre,1538,765,773
False,8128131,"Wertheim, Stadt",60 - 65 Jahre,1344,657,687
False,8128131,"Wertheim, Stadt",65 - 75 Jahre,2439,1025,1414
False,8128131,"Wertheim, Stadt",75 und mehr Jahre,1734,529,1205
False,8128131,"Wertheim, Stadt",Insgesamt,24432,11944,12488
False,8128137,Wittighausen,unter 3 Jahre,58,32,26
False,8128137,Wittighausen,3 -  6 Jahre,78,34,44
False,8128137,Wittighausen,6 - 10 Jahre,93,34,59
False,8128137,Wittighausen,10 - 15 Jahre,115,61,54
False,8128137,Wittighausen,15 - 18 Jahre,57,31,26
False,8128137,Wittighausen,18 - 20 Jahre,51,22,29
False,8128137,Wittighausen,20 - 25 Jahre,114,61,53
False,8128137,Wittighausen,25 - 30 Jahre,146,89,57
False,8128137,Wittighausen,30 - 35 Jahre,137,69,68
False,8128137,Wittighausen,35 - 40 Jahre,154,93,61
False,8128137,Wittighausen,40 - 45 Jahre,119,69,50
False,8128137,Wittighausen,45 - 50 Jahre,105,52,53
False,8128137,Wittighausen,50 - 55 Jahre,82,39,43
False,8128137,Wittighausen,55 - 60 Jahre,121,65,56
False,8128137,Wittighausen,60 - 65 Jahre,93,46,47
False,8128137,Wittighausen,65 - 75 Jahre,158,63,95
False,8128137,Wittighausen,75 und mehr Jahre,91,31,60
False,8128137,Wittighausen,Insgesamt,1772,891,881
False,8128138,Ahorn,unter 3 Jahre,86,43,43
False,8128138,Ahorn,3 -  6 Jahre,92,55,37
False,8128138,Ahorn,6 - 10 Jahre,130,68,62
False,8128138,Ahorn,10 - 15 Jahre,124,76,48
False,8128138,Ahorn,15 - 18 Jahre,68,32,36
False,8128138,Ahorn,18 - 20 Jahre,45,24,21
False,8128138,Ahorn,20 - 25 Jahre,109,55,54
False,8128138,Ahorn,25 - 30 Jahre,180,101,79
False,8128138,Ahorn,30 - 35 Jahre,221,112,109
False,8128138,Ahorn,35 - 40 Jahre,179,99,80
False,8128138,Ahorn,40 - 45 Jahre,149,81,68
False,8128138,Ahorn,45 - 50 Jahre,144,80,64
False,8128138,Ahorn,50 - 55 Jahre,88,45,43
False,8128138,Ahorn,55 - 60 Jahre,147,75,72
False,8128138,Ahorn,60 - 65 Jahre,120,62,58
False,8128138,Ahorn,65 - 75 Jahre,265,120,145
False,8128138,Ahorn,75 und mehr Jahre,166,43,123
False,8128138,Ahorn,Insgesamt,2313,1171,1142
False,8128139,"Lauda-Königshofen, Stadt",unter 3 Jahre,455,257,198
False,8128139,"Lauda-Königshofen, Stadt",3 -  6 Jahre,544,296,248
False,8128139,"Lauda-Königshofen, Stadt",6 - 10 Jahre,758,396,362
False,8128139,"Lauda-Königshofen, Stadt",10 - 15 Jahre,970,518,452
False,8128139,"Lauda-Königshofen, Stadt",15 - 18 Jahre,513,262,251
False,8128139,"Lauda-Königshofen, Stadt",18 - 20 Jahre,367,180,187
False,8128139,"Lauda-Königshofen, Stadt",20 - 25 Jahre,951,507,444
False,8128139,"Lauda-Königshofen, Stadt",25 - 30 Jahre,1185,627,558
False,8128139,"Lauda-Königshofen, Stadt",30 - 35 Jahre,1282,653,629
False,8128139,"Lauda-Königshofen, Stadt",35 - 40 Jahre,1199,610,589
False,8128139,"Lauda-Königshofen, Stadt",40 - 45 Jahre,1063,546,517
False,8128139,"Lauda-Königshofen, Stadt",45 - 50 Jahre,946,483,463
False,8128139,"Lauda-Königshofen, Stadt",50 - 55 Jahre,875,424,451
False,8128139,"Lauda-Königshofen, Stadt",55 - 60 Jahre,1090,587,503
False,8128139,"Lauda-Königshofen, Stadt",60 - 65 Jahre,764,385,379
False,8128139,"Lauda-Königshofen, Stadt",65 - 75 Jahre,1430,581,849
False,8128139,"Lauda-Königshofen, Stadt",75 und mehr Jahre,943,306,637
False,8128139,"Lauda-Königshofen, Stadt",Insgesamt,15335,7618,7717
False,8135,Landkreis Heidenheim,unter 3 Jahre,4657,2315,2342
False,8135,Landkreis Heidenheim,3 -  6 Jahre,5020,2638,2382
False,8135,Landkreis Heidenheim,6 - 10 Jahre,6826,3556,3270
False,8135,Landkreis Heidenheim,10 - 15 Jahre,8084,4103,3981
False,8135,Landkreis Heidenheim,15 - 18 Jahre,4641,2362,2279
False,8135,Landkreis Heidenheim,18 - 20 Jahre,3037,1586,1451
False,8135,Landkreis Heidenheim,20 - 25 Jahre,8297,4261,4036
False,8135,Landkreis Heidenheim,25 - 30 Jahre,10652,5487,5165
False,8135,Landkreis Heidenheim,30 - 35 Jahre,11060,5760,5300
False,8135,Landkreis Heidenheim,35 - 40 Jahre,10374,5337,5037
False,8135,Landkreis Heidenheim,40 - 45 Jahre,8939,4571,4368
False,8135,Landkreis Heidenheim,45 - 50 Jahre,8172,4110,4062
False,8135,Landkreis Heidenheim,50 - 55 Jahre,7839,3932,3907
False,8135,Landkreis Heidenheim,55 - 60 Jahre,9693,4801,4892
False,8135,Landkreis Heidenheim,60 - 65 Jahre,7825,3811,4014
False,8135,Landkreis Heidenheim,65 - 75 Jahre,13234,5544,7690
False,8135,Landkreis Heidenheim,75 und mehr Jahre,8965,2757,6208
False,8135,Landkreis Heidenheim,Insgesamt,137315,66931,70384
False,8135010,Dischingen,unter 3 Jahre,195,109,86
False,8135010,Dischingen,3 -  6 Jahre,201,117,84
False,8135010,Dischingen,6 - 10 Jahre,255,130,125
False,8135010,Dischingen,10 - 15 Jahre,274,159,115
False,8135010,Dischingen,15 - 18 Jahre,171,80,91
False,8135010,Dischingen,18 - 20 Jahre,104,53,51
False,8135010,Dischingen,20 - 25 Jahre,285,158,127
False,8135010,Dischingen,25 - 30 Jahre,401,212,189
False,8135010,Dischingen,30 - 35 Jahre,391,207,184
False,8135010,Dischingen,35 - 40 Jahre,382,218,164
False,8135010,Dischingen,40 - 45 Jahre,327,176,151
False,8135010,Dischingen,45 - 50 Jahre,272,144,128
False,8135010,Dischingen,50 - 55 Jahre,201,114,87
False,8135010,Dischingen,55 - 60 Jahre,271,136,135
False,8135010,Dischingen,60 - 65 Jahre,269,129,140
False,8135010,Dischingen,65 - 75 Jahre,432,174,258
False,8135010,Dischingen,75 und mehr Jahre,277,106,171
False,8135010,Dischingen,Insgesamt,4708,2422,2286
False,8135015,Gerstetten,unter 3 Jahre,431,210,221
False,8135015,Gerstetten,3 -  6 Jahre,477,244,233
False,8135015,Gerstetten,6 - 10 Jahre,660,341,319
False,8135015,Gerstetten,10 - 15 Jahre,722,359,363
False,8135015,Gerstetten,15 - 18 Jahre,376,191,185
False,8135015,Gerstetten,18 - 20 Jahre,249,120,129
False,8135015,Gerstetten,20 - 25 Jahre,674,342,332
False,8135015,Gerstetten,25 - 30 Jahre,857,445,412
False,8135015,Gerstetten,30 - 35 Jahre,971,516,455
False,8135015,Gerstetten,35 - 40 Jahre,948,496,452
False,8135015,Gerstetten,40 - 45 Jahre,742,375,367
False,8135015,Gerstetten,45 - 50 Jahre,698,374,324
False,8135015,Gerstetten,50 - 55 Jahre,572,299,273
False,8135015,Gerstetten,55 - 60 Jahre,829,415,414
False,8135015,Gerstetten,60 - 65 Jahre,604,298,306
False,8135015,Gerstetten,65 - 75 Jahre,1041,437,604
False,8135015,Gerstetten,75 und mehr Jahre,747,211,536
False,8135015,Gerstetten,Insgesamt,11598,5673,5925
False,8135016,"Giengen an der Brenz, Stadt",unter 3 Jahre,666,328,338
False,8135016,"Giengen an der Brenz, Stadt",3 -  6 Jahre,707,398,309
False,8135016,"Giengen an der Brenz, Stadt",6 - 10 Jahre,1014,539,475
False,8135016,"Giengen an der Brenz, Stadt",10 - 15 Jahre,1153,579,574
False,8135016,"Giengen an der Brenz, Stadt",15 - 18 Jahre,675,336,339
False,8135016,"Giengen an der Brenz, Stadt",18 - 20 Jahre,471,242,229
False,8135016,"Giengen an der Brenz, Stadt",20 - 25 Jahre,1227,604,623
False,8135016,"Giengen an der Brenz, Stadt",25 - 30 Jahre,1658,861,797
False,8135016,"Giengen an der Brenz, Stadt",30 - 35 Jahre,1575,838,737
False,8135016,"Giengen an der Brenz, Stadt",35 - 40 Jahre,1397,733,664
False,8135016,"Giengen an der Brenz, Stadt",40 - 45 Jahre,1269,656,613
False,8135016,"Giengen an der Brenz, Stadt",45 - 50 Jahre,1147,565,582
False,8135016,"Giengen an der Brenz, Stadt",50 - 55 Jahre,1147,555,592
False,8135016,"Giengen an der Brenz, Stadt",55 - 60 Jahre,1417,711,706
False,8135016,"Giengen an der Brenz, Stadt",60 - 65 Jahre,1176,583,593
False,8135016,"Giengen an der Brenz, Stadt",65 - 75 Jahre,1899,785,1114
False,8135016,"Giengen an der Brenz, Stadt",75 und mehr Jahre,1244,373,871
False,8135016,"Giengen an der Brenz, Stadt",Insgesamt,19842,9686,10156
False,8135019,"Heidenheim an der Brenz, Stadt",unter 3 Jahre,1654,820,834
False,8135019,"Heidenheim an der Brenz, Stadt",3 -  6 Jahre,1768,928,840
False,8135019,"Heidenheim an der Brenz, Stadt",6 - 10 Jahre,2435,1240,1195
False,8135019,"Heidenheim an der Brenz, Stadt",10 - 15 Jahre,2959,1530,1429
False,8135019,"Heidenheim an der Brenz, Stadt",15 - 18 Jahre,1724,861,863
False,8135019,"Heidenheim an der Brenz, Stadt",18 - 20 Jahre,1126,592,534
False,8135019,"Heidenheim an der Brenz, Stadt",20 - 25 Jahre,3248,1681,1567
False,8135019,"Heidenheim an der Brenz, Stadt",25 - 30 Jahre,3967,2036,1931
False,8135019,"Heidenheim an der Brenz, Stadt",30 - 35 Jahre,4039,2065,1974
False,8135019,"Heidenheim an der Brenz, Stadt",35 - 40 Jahre,3787,1942,1845
False,8135019,"Heidenheim an der Brenz, Stadt",40 - 45 Jahre,3377,1706,1671
False,8135019,"Heidenheim an der Brenz, Stadt",45 - 50 Jahre,3096,1524,1572
False,8135019,"Heidenheim an der Brenz, Stadt",50 - 55 Jahre,3092,1517,1575
False,8135019,"Heidenheim an der Brenz, Stadt",55 - 60 Jahre,3798,1850,1948
False,8135019,"Heidenheim an der Brenz, Stadt",60 - 65 Jahre,3068,1462,1606
False,8135019,"Heidenheim an der Brenz, Stadt",65 - 75 Jahre,5436,2240,3196
False,8135019,"Heidenheim an der Brenz, Stadt",75 und mehr Jahre,3953,1202,2751
False,8135019,"Heidenheim an der Brenz, Stadt",Insgesamt,52527,25196,27331
False,8135020,"Herbrechtingen, Stadt",unter 3 Jahre,439,232,207
False,8135020,"Herbrechtingen, Stadt",3 -  6 Jahre,456,234,222
False,8135020,"Herbrechtingen, Stadt",6 - 10 Jahre,586,300,286
False,8135020,"Herbrechtingen, Stadt",10 - 15 Jahre,727,354,373
False,8135020,"Herbrechtingen, Stadt",15 - 18 Jahre,434,221,213
False,8135020,"Herbrechtingen, Stadt",18 - 20 Jahre,301,149,152
False,8135020,"Herbrechtingen, Stadt",20 - 25 Jahre,760,375,385
False,8135020,"Herbrechtingen, Stadt",25 - 30 Jahre,1029,539,490
False,8135020,"Herbrechtingen, Stadt",30 - 35 Jahre,1028,541,487
False,8135020,"Herbrechtingen, Stadt",35 - 40 Jahre,1034,532,502
False,8135020,"Herbrechtingen, Stadt",40 - 45 Jahre,881,444,437
False,8135020,"Herbrechtingen, Stadt",45 - 50 Jahre,814,415,399
False,8135020,"Herbrechtingen, Stadt",50 - 55 Jahre,745,377,368
False,8135020,"Herbrechtingen, Stadt",55 - 60 Jahre,870,415,455
False,8135020,"Herbrechtingen, Stadt",60 - 65 Jahre,765,390,375
False,8135020,"Herbrechtingen, Stadt",65 - 75 Jahre,1340,555,785
False,8135020,"Herbrechtingen, Stadt",75 und mehr Jahre,814,279,535
False,8135020,"Herbrechtingen, Stadt",Insgesamt,13023,6352,6671
False,8135021,Hermaringen,unter 3 Jahre,91,37,54
False,8135021,Hermaringen,3 -  6 Jahre,98,51,47
False,8135021,Hermaringen,6 - 10 Jahre,139,76,63
False,8135021,Hermaringen,10 - 15 Jahre,127,65,62
False,8135021,Hermaringen,15 - 18 Jahre,66,38,28
False,8135021,Hermaringen,18 - 20 Jahre,56,38,18
False,8135021,Hermaringen,20 - 25 Jahre,133,68,65
False,8135021,Hermaringen,25 - 30 Jahre,178,93,85
False,8135021,Hermaringen,30 - 35 Jahre,208,117,91
False,8135021,Hermaringen,35 - 40 Jahre,205,108,97
False,8135021,Hermaringen,40 - 45 Jahre,121,66,55
False,8135021,Hermaringen,45 - 50 Jahre,128,67,61
False,8135021,Hermaringen,50 - 55 Jahre,123,59,64
False,8135021,Hermaringen,55 - 60 Jahre,174,92,82
False,8135021,Hermaringen,60 - 65 Jahre,144,74,70
False,8135021,Hermaringen,65 - 75 Jahre,227,105,122
False,8135021,Hermaringen,75 und mehr Jahre,127,38,89
False,8135021,Hermaringen,Insgesamt,2345,1192,1153
False,8135025,Königsbronn,unter 3 Jahre,271,135,136
False,8135025,Königsbronn,3 -  6 Jahre,266,133,133
False,8135025,Königsbronn,6 - 10 Jahre,392,207,185
False,8135025,Königsbronn,10 - 15 Jahre,456,212,244
False,8135025,Königsbronn,15 - 18 Jahre,262,141,121
False,8135025,Königsbronn,18 - 20 Jahre,150,73,77
False,8135025,Königsbronn,20 - 25 Jahre,427,228,199
False,8135025,Königsbronn,25 - 30 Jahre,555,273,282
False,8135025,Königsbronn,30 - 35 Jahre,600,318,282
False,8135025,Königsbronn,35 - 40 Jahre,542,271,271
False,8135025,Königsbronn,40 - 45 Jahre,533,279,254
False,8135025,Königsbronn,45 - 50 Jahre,490,239,251
False,8135025,Königsbronn,50 - 55 Jahre,518,264,254
False,8135025,Königsbronn,55 - 60 Jahre,588,296,292
False,8135025,Königsbronn,60 - 65 Jahre,453,230,223
False,8135025,Königsbronn,65 - 75 Jahre,746,324,422
False,8135025,Königsbronn,75 und mehr Jahre,458,152,306
False,8135025,Königsbronn,Insgesamt,7707,3775,3932
False,8135026,Nattheim,unter 3 Jahre,247,116,131
False,8135026,Nattheim,3 -  6 Jahre,246,122,124
False,8135026,Nattheim,6 - 10 Jahre,304,183,121
False,8135026,Nattheim,10 - 15 Jahre,394,192,202
False,8135026,Nattheim,15 - 18 Jahre,197,97,100
False,8135026,Nattheim,18 - 20 Jahre,132,66,66
False,8135026,Nattheim,20 - 25 Jahre,357,185,172
False,8135026,Nattheim,25 - 30 Jahre,516,254,262
False,8135026,Nattheim,30 - 35 Jahre,582,308,274
False,8135026,Nattheim,35 - 40 Jahre,516,258,258
False,8135026,Nattheim,40 - 45 Jahre,416,215,201
False,8135026,Nattheim,45 - 50 Jahre,356,176,180
False,8135026,Nattheim,50 - 55 Jahre,373,198,175
False,8135026,Nattheim,55 - 60 Jahre,475,250,225
False,8135026,Nattheim,60 - 65 Jahre,338,164,174
False,8135026,Nattheim,65 - 75 Jahre,445,184,261
False,8135026,Nattheim,75 und mehr Jahre,281,94,187
False,8135026,Nattheim,Insgesamt,6175,3062,3113
False,8135027,"Niederstotzingen, Stadt",unter 3 Jahre,169,81,88
False,8135027,"Niederstotzingen, Stadt",3 -  6 Jahre,204,108,96
False,8135027,"Niederstotzingen, Stadt",6 - 10 Jahre,280,136,144
False,8135027,"Niederstotzingen, Stadt",10 - 15 Jahre,300,145,155
False,8135027,"Niederstotzingen, Stadt",15 - 18 Jahre,193,100,93
False,8135027,"Niederstotzingen, Stadt",18 - 20 Jahre,85,48,37
False,8135027,"Niederstotzingen, Stadt",20 - 25 Jahre,295,163,132
False,8135027,"Niederstotzingen, Stadt",25 - 30 Jahre,399,194,205
False,8135027,"Niederstotzingen, Stadt",30 - 35 Jahre,438,226,212
False,8135027,"Niederstotzingen, Stadt",35 - 40 Jahre,437,234,203
False,8135027,"Niederstotzingen, Stadt",40 - 45 Jahre,312,154,158
False,8135027,"Niederstotzingen, Stadt",45 - 50 Jahre,293,156,137
False,8135027,"Niederstotzingen, Stadt",50 - 55 Jahre,259,138,121
False,8135027,"Niederstotzingen, Stadt",55 - 60 Jahre,280,139,141
False,8135027,"Niederstotzingen, Stadt",60 - 65 Jahre,210,102,108
False,8135027,"Niederstotzingen, Stadt",65 - 75 Jahre,392,169,223
False,8135027,"Niederstotzingen, Stadt",75 und mehr Jahre,266,67,199
False,8135027,"Niederstotzingen, Stadt",Insgesamt,4812,2360,2452
False,8135031,Sontheim an der Brenz,unter 3 Jahre,183,94,89
False,8135031,Sontheim an der Brenz,3 -  6 Jahre,229,115,114
False,8135031,Sontheim an der Brenz,6 - 10 Jahre,278,164,114
False,8135031,Sontheim an der Brenz,10 - 15 Jahre,387,213,174
False,8135031,Sontheim an der Brenz,15 - 18 Jahre,195,105,90
False,8135031,Sontheim an der Brenz,18 - 20 Jahre,146,80,66
False,8135031,Sontheim an der Brenz,20 - 25 Jahre,343,177,166
False,8135031,Sontheim an der Brenz,25 - 30 Jahre,452,246,206
False,8135031,Sontheim an der Brenz,30 - 35 Jahre,517,258,259
False,8135031,Sontheim an der Brenz,35 - 40 Jahre,463,242,221
False,8135031,Sontheim an der Brenz,40 - 45 Jahre,345,186,159
False,8135031,Sontheim an der Brenz,45 - 50 Jahre,350,182,168
False,8135031,Sontheim an der Brenz,50 - 55 Jahre,295,150,145
False,8135031,Sontheim an der Brenz,55 - 60 Jahre,370,195,175
False,8135031,Sontheim an der Brenz,60 - 65 Jahre,306,148,158
False,8135031,Sontheim an der Brenz,65 - 75 Jahre,515,228,287
False,8135031,Sontheim an der Brenz,75 und mehr Jahre,328,97,231
False,8135031,Sontheim an der Brenz,Insgesamt,5702,2880,2822
False,8135032,Steinheim am Albuch,unter 3 Jahre,311,153,158
False,8135032,Steinheim am Albuch,3 -  6 Jahre,368,188,180
False,8135032,Steinheim am Albuch,6 - 10 Jahre,483,240,243
False,8135032,Steinheim am Albuch,10 - 15 Jahre,585,295,290
False,8135032,Steinheim am Albuch,15 - 18 Jahre,348,192,156
False,8135032,Steinheim am Albuch,18 - 20 Jahre,217,125,92
False,8135032,Steinheim am Albuch,20 - 25 Jahre,548,280,268
False,8135032,Steinheim am Albuch,25 - 30 Jahre,640,334,306
False,8135032,Steinheim am Albuch,30 - 35 Jahre,711,366,345
False,8135032,Steinheim am Albuch,35 - 40 Jahre,663,303,360
False,8135032,Steinheim am Albuch,40 - 45 Jahre,616,314,302
False,8135032,Steinheim am Albuch,45 - 50 Jahre,528,268,260
False,8135032,Steinheim am Albuch,50 - 55 Jahre,514,261,253
False,8135032,Steinheim am Albuch,55 - 60 Jahre,621,302,319
False,8135032,Steinheim am Albuch,60 - 65 Jahre,492,231,261
False,8135032,Steinheim am Albuch,65 - 75 Jahre,761,343,418
False,8135032,Steinheim am Albuch,75 und mehr Jahre,470,138,332
False,8135032,Steinheim am Albuch,Insgesamt,8876,4333,4543
False,8136,Landkreis Ostalbkreis,unter 3 Jahre,11236,5863,5373
False,8136,Landkreis Ostalbkreis,3 -  6 Jahre,11866,6045,5821
False,8136,Landkreis Ostalbkreis,6 - 10 Jahre,15672,8006,7666
False,8136,Landkreis Ostalbkreis,10 - 15 Jahre,18721,9501,9220
False,8136,Landkreis Ostalbkreis,15 - 18 Jahre,10959,5619,5340
False,8136,Landkreis Ostalbkreis,18 - 20 Jahre,7262,3601,3661
False,8136,Landkreis Ostalbkreis,20 - 25 Jahre,20296,10461,9835
False,8136,Landkreis Ostalbkreis,25 - 30 Jahre,25404,13310,12094
False,8136,Landkreis Ostalbkreis,30 - 35 Jahre,26464,13893,12571
False,8136,Landkreis Ostalbkreis,35 - 40 Jahre,23866,12342,11524
False,8136,Landkreis Ostalbkreis,40 - 45 Jahre,20644,10505,10139
False,8136,Landkreis Ostalbkreis,45 - 50 Jahre,18209,9310,8899
False,8136,Landkreis Ostalbkreis,50 - 55 Jahre,17428,8905,8523
False,8136,Landkreis Ostalbkreis,55 - 60 Jahre,20687,10421,10266
False,8136,Landkreis Ostalbkreis,60 - 65 Jahre,16158,8000,8158
False,8136,Landkreis Ostalbkreis,65 - 75 Jahre,27131,11278,15853
False,8136,Landkreis Ostalbkreis,75 und mehr Jahre,19107,5844,13263
False,8136,Landkreis Ostalbkreis,Insgesamt,311110,152904,158206
False,8136002,Abtsgmünd,unter 3 Jahre,256,134,122
False,8136002,Abtsgmünd,3 -  6 Jahre,307,157,150
False,8136002,Abtsgmünd,6 - 10 Jahre,401,195,206
False,8136002,Abtsgmünd,10 - 15 Jahre,426,220,206
False,8136002,Abtsgmünd,15 - 18 Jahre,265,142,123
False,8136002,Abtsgmünd,18 - 20 Jahre,137,73,64
False,8136002,Abtsgmünd,20 - 25 Jahre,455,256,199
False,8136002,Abtsgmünd,25 - 30 Jahre,617,325,292
False,8136002,Abtsgmünd,30 - 35 Jahre,629,319,310
False,8136002,Abtsgmünd,35 - 40 Jahre,596,316,280
False,8136002,Abtsgmünd,40 - 45 Jahre,462,242,220
False,8136002,Abtsgmünd,45 - 50 Jahre,357,203,154
False,8136002,Abtsgmünd,50 - 55 Jahre,352,164,188
False,8136002,Abtsgmünd,55 - 60 Jahre,457,227,230
False,8136002,Abtsgmünd,60 - 65 Jahre,322,163,159
False,8136002,Abtsgmünd,65 - 75 Jahre,636,266,370
False,8136002,Abtsgmünd,75 und mehr Jahre,363,108,255
False,8136002,Abtsgmünd,Insgesamt,7038,3510,3528
False,8136003,Adelmannsfelden,unter 3 Jahre,77,40,37
False,8136003,Adelmannsfelden,3 -  6 Jahre,82,41,41
False,8136003,Adelmannsfelden,6 - 10 Jahre,101,55,46
False,8136003,Adelmannsfelden,10 - 15 Jahre,98,46,52
False,8136003,Adelmannsfelden,15 - 18 Jahre,58,29,29
False,8136003,Adelmannsfelden,18 - 20 Jahre,32,12,20
False,8136003,Adelmannsfelden,20 - 25 Jahre,105,50,55
False,8136003,Adelmannsfelden,25 - 30 Jahre,132,76,56
False,8136003,Adelmannsfelden,30 - 35 Jahre,157,83,74
False,8136003,Adelmannsfelden,35 - 40 Jahre,170,91,79
False,8136003,Adelmannsfelden,40 - 45 Jahre,125,69,56
False,8136003,Adelmannsfelden,45 - 50 Jahre,81,41,40
False,8136003,Adelmannsfelden,50 - 55 Jahre,88,45,43
False,8136003,Adelmannsfelden,55 - 60 Jahre,121,64,57
False,8136003,Adelmannsfelden,60 - 65 Jahre,70,35,35
False,8136003,Adelmannsfelden,65 - 75 Jahre,152,58,94
False,8136003,Adelmannsfelden,75 und mehr Jahre,106,28,78
False,8136003,Adelmannsfelden,Insgesamt,1755,863,892
False,8136007,Bartholomä,unter 3 Jahre,91,49,42
False,8136007,Bartholomä,3 -  6 Jahre,91,40,51
False,8136007,Bartholomä,6 - 10 Jahre,127,58,69
False,8136007,Bartholomä,10 - 15 Jahre,138,73,65
False,8136007,Bartholomä,15 - 18 Jahre,63,33,30
False,8136007,Bartholomä,18 - 20 Jahre,51,23,28
False,8136007,Bartholomä,20 - 25 Jahre,121,63,58
False,8136007,Bartholomä,25 - 30 Jahre,139,69,70
False,8136007,Bartholomä,30 - 35 Jahre,185,95,90
False,8136007,Bartholomä,35 - 40 Jahre,167,87,80
False,8136007,Bartholomä,40 - 45 Jahre,153,81,72
False,8136007,Bartholomä,45 - 50 Jahre,131,69,62
False,8136007,Bartholomä,50 - 55 Jahre,94,51,43
False,8136007,Bartholomä,55 - 60 Jahre,121,60,61
False,8136007,Bartholomä,60 - 65 Jahre,116,59,57
False,8136007,Bartholomä,65 - 75 Jahre,159,65,94
False,8136007,Bartholomä,75 und mehr Jahre,89,24,65
False,8136007,Bartholomä,Insgesamt,2036,999,1037
False,8136009,Böbingen an der Rems,unter 3 Jahre,172,90,82
False,8136009,Böbingen an der Rems,3 -  6 Jahre,192,103,89
False,8136009,Böbingen an der Rems,6 - 10 Jahre,214,109,105
False,8136009,Böbingen an der Rems,10 - 15 Jahre,261,130,131
False,8136009,Böbingen an der Rems,15 - 18 Jahre,170,90,80
False,8136009,Böbingen an der Rems,18 - 20 Jahre,124,55,69
False,8136009,Böbingen an der Rems,20 - 25 Jahre,290,146,144
False,8136009,Böbingen an der Rems,25 - 30 Jahre,364,184,180
False,8136009,Böbingen an der Rems,30 - 35 Jahre,332,169,163
False,8136009,Böbingen an der Rems,35 - 40 Jahre,322,168,154
False,8136009,Böbingen an der Rems,40 - 45 Jahre,290,135,155
False,8136009,Böbingen an der Rems,45 - 50 Jahre,268,127,141
False,8136009,Böbingen an der Rems,50 - 55 Jahre,272,131,141
False,8136009,Böbingen an der Rems,55 - 60 Jahre,317,167,150
False,8136009,Böbingen an der Rems,60 - 65 Jahre,212,102,110
False,8136009,Böbingen an der Rems,65 - 75 Jahre,316,127,189
False,8136009,Böbingen an der Rems,75 und mehr Jahre,207,71,136
False,8136009,Böbingen an der Rems,Insgesamt,4323,2104,2219
False,8136010,"Bopfingen, Stadt",unter 3 Jahre,410,215,195
False,8136010,"Bopfingen, Stadt",3 -  6 Jahre,473,242,231
False,8136010,"Bopfingen, Stadt",6 - 10 Jahre,687,340,347
False,8136010,"Bopfingen, Stadt",10 - 15 Jahre,812,409,403
False,8136010,"Bopfingen, Stadt",15 - 18 Jahre,486,241,245
False,8136010,"Bopfingen, Stadt",18 - 20 Jahre,317,161,156
False,8136010,"Bopfingen, Stadt",20 - 25 Jahre,825,416,409
False,8136010,"Bopfingen, Stadt",25 - 30 Jahre,972,536,436
False,8136010,"Bopfingen, Stadt",30 - 35 Jahre,1007,528,479
False,8136010,"Bopfingen, Stadt",35 - 40 Jahre,926,491,435
False,8136010,"Bopfingen, Stadt",40 - 45 Jahre,853,451,402
False,8136010,"Bopfingen, Stadt",45 - 50 Jahre,783,410,373
False,8136010,"Bopfingen, Stadt",50 - 55 Jahre,630,341,289
False,8136010,"Bopfingen, Stadt",55 - 60 Jahre,808,399,409
False,8136010,"Bopfingen, Stadt",60 - 65 Jahre,639,313,326
False,8136010,"Bopfingen, Stadt",65 - 75 Jahre,1162,482,680
False,8136010,"Bopfingen, Stadt",75 und mehr Jahre,723,217,506
False,8136010,"Bopfingen, Stadt",Insgesamt,12513,6192,6321
False,8136015,Durlangen,unter 3 Jahre,118,61,57
False,8136015,Durlangen,3 -  6 Jahre,117,65,52
False,8136015,Durlangen,6 - 10 Jahre,164,72,92
False,8136015,Durlangen,10 - 15 Jahre,190,95,95
False,8136015,Durlangen,15 - 18 Jahre,113,54,59
False,8136015,Durlangen,18 - 20 Jahre,66,38,28
False,8136015,Durlangen,20 - 25 Jahre,202,92,110
False,8136015,Durlangen,25 - 30 Jahre,224,123,101
False,8136015,Durlangen,30 - 35 Jahre,241,117,124
False,8136015,Durlangen,35 - 40 Jahre,213,114,99
False,8136015,Durlangen,40 - 45 Jahre,211,104,107
False,8136015,Durlangen,45 - 50 Jahre,186,100,86
False,8136015,Durlangen,50 - 55 Jahre,164,87,77
False,8136015,Durlangen,55 - 60 Jahre,198,101,97
False,8136015,Durlangen,60 - 65 Jahre,170,97,73
False,8136015,Durlangen,65 - 75 Jahre,185,74,111
False,8136015,Durlangen,75 und mehr Jahre,111,34,77
False,8136015,Durlangen,Insgesamt,2873,1428,1445
False,8136018,Ellenberg,unter 3 Jahre,67,36,31
False,8136018,Ellenberg,3 -  6 Jahre,80,44,36
False,8136018,Ellenberg,6 - 10 Jahre,105,52,53
False,8136018,Ellenberg,10 - 15 Jahre,113,56,57
False,8136018,Ellenberg,15 - 18 Jahre,81,54,27
False,8136018,Ellenberg,18 - 20 Jahre,38,17,21
False,8136018,Ellenberg,20 - 25 Jahre,98,57,41
False,8136018,Ellenberg,25 - 30 Jahre,128,55,73
False,8136018,Ellenberg,30 - 35 Jahre,175,99,76
False,8136018,Ellenberg,35 - 40 Jahre,145,80,65
False,8136018,Ellenberg,40 - 45 Jahre,130,73,57
False,8136018,Ellenberg,45 - 50 Jahre,78,48,30
False,8136018,Ellenberg,50 - 55 Jahre,64,26,38
False,8136018,Ellenberg,55 - 60 Jahre,95,50,45
False,8136018,Ellenberg,60 - 65 Jahre,79,40,39
False,8136018,Ellenberg,65 - 75 Jahre,130,45,85
False,8136018,Ellenberg,75 und mehr Jahre,75,30,45
False,8136018,Ellenberg,Insgesamt,1681,862,819
False,8136019,"Ellwangen (Jagst), Stadt",unter 3 Jahre,879,444,435
False,8136019,"Ellwangen (Jagst), Stadt",3 -  6 Jahre,897,469,428
False,8136019,"Ellwangen (Jagst), Stadt",6 - 10 Jahre,1239,677,562
False,8136019,"Ellwangen (Jagst), Stadt",10 - 15 Jahre,1458,738,720
False,8136019,"Ellwangen (Jagst), Stadt",15 - 18 Jahre,867,442,425
False,8136019,"Ellwangen (Jagst), Stadt",18 - 20 Jahre,631,300,331
False,8136019,"Ellwangen (Jagst), Stadt",20 - 25 Jahre,1629,813,816
False,8136019,"Ellwangen (Jagst), Stadt",25 - 30 Jahre,2008,1061,947
False,8136019,"Ellwangen (Jagst), Stadt",30 - 35 Jahre,2064,1103,961
False,8136019,"Ellwangen (Jagst), Stadt",35 - 40 Jahre,1802,959,843
False,8136019,"Ellwangen (Jagst), Stadt",40 - 45 Jahre,1518,802,716
False,8136019,"Ellwangen (Jagst), Stadt",45 - 50 Jahre,1271,639,632
False,8136019,"Ellwangen (Jagst), Stadt",50 - 55 Jahre,1209,637,572
False,8136019,"Ellwangen (Jagst), Stadt",55 - 60 Jahre,1504,736,768
False,8136019,"Ellwangen (Jagst), Stadt",60 - 65 Jahre,1255,560,695
False,8136019,"Ellwangen (Jagst), Stadt",65 - 75 Jahre,2196,926,1270
False,8136019,"Ellwangen (Jagst), Stadt",75 und mehr Jahre,1726,553,1173
False,8136019,"Ellwangen (Jagst), Stadt",Insgesamt,24153,11859,12294
False,8136020,Eschach,unter 3 Jahre,70,35,35
False,8136020,Eschach,3 -  6 Jahre,93,61,32
False,8136020,Eschach,6 - 10 Jahre,84,51,33
False,8136020,Eschach,10 - 15 Jahre,95,46,49
False,8136020,Eschach,15 - 18 Jahre,61,24,37
False,8136020,Eschach,18 - 20 Jahre,36,22,14
False,8136020,Eschach,20 - 25 Jahre,95,48,47
False,8136020,Eschach,25 - 30 Jahre,131,71,60
False,8136020,Eschach,30 - 35 Jahre,153,84,69
False,8136020,Eschach,35 - 40 Jahre,126,66,60
False,8136020,Eschach,40 - 45 Jahre,111,59,52
False,8136020,Eschach,45 - 50 Jahre,80,48,32
False,8136020,Eschach,50 - 55 Jahre,76,29,47
False,8136020,Eschach,55 - 60 Jahre,93,51,42
False,8136020,Eschach,60 - 65 Jahre,97,48,49
False,8136020,Eschach,65 - 75 Jahre,145,65,80
False,8136020,Eschach,75 und mehr Jahre,95,22,73
False,8136020,Eschach,Insgesamt,1641,830,811
False,8136021,Essingen,unter 3 Jahre,224,114,110
False,8136021,Essingen,3 -  6 Jahre,248,129,119
False,8136021,Essingen,6 - 10 Jahre,352,185,167
False,8136021,Essingen,10 - 15 Jahre,372,192,180
False,8136021,Essingen,15 - 18 Jahre,228,112,116
False,8136021,Essingen,18 - 20 Jahre,167,84,83
False,8136021,Essingen,20 - 25 Jahre,390,195,195
False,8136021,Essingen,25 - 30 Jahre,478,256,222
False,8136021,Essingen,30 - 35 Jahre,569,289,280
False,8136021,Essingen,35 - 40 Jahre,511,263,248
False,8136021,Essingen,40 - 45 Jahre,433,215,218
False,8136021,Essingen,45 - 50 Jahre,397,199,198
False,8136021,Essingen,50 - 55 Jahre,351,187,164
False,8136021,Essingen,55 - 60 Jahre,371,193,178
False,8136021,Essingen,60 - 65 Jahre,286,145,141
False,8136021,Essingen,65 - 75 Jahre,439,197,242
False,8136021,Essingen,75 und mehr Jahre,222,82,140
False,8136021,Essingen,Insgesamt,6038,3037,3001
False,8136024,Göggingen,unter 3 Jahre,96,55,41
False,8136024,Göggingen,3 -  6 Jahre,97,54,43
False,8136024,Göggingen,6 - 10 Jahre,149,73,76
False,8136024,Göggingen,10 - 15 Jahre,161,70,91
False,8136024,Göggingen,15 - 18 Jahre,68,32,36
False,8136024,Göggingen,18 - 20 Jahre,51,26,25
False,8136024,Göggingen,20 - 25 Jahre,141,61,80
False,8136024,Göggingen,25 - 30 Jahre,173,90,83
False,8136024,Göggingen,30 - 35 Jahre,225,102,123
False,8136024,Göggingen,35 - 40 Jahre,219,125,94
False,8136024,Göggingen,40 - 45 Jahre,172,79,93
False,8136024,Göggingen,45 - 50 Jahre,127,67,60
False,8136024,Göggingen,50 - 55 Jahre,111,61,50
False,8136024,Göggingen,55 - 60 Jahre,146,74,72
False,8136024,Göggingen,60 - 65 Jahre,78,38,40
False,8136024,Göggingen,65 - 75 Jahre,132,57,75
False,8136024,Göggingen,75 und mehr Jahre,62,18,44
False,8136024,Göggingen,Insgesamt,2208,1082,1126
False,8136027,Gschwend,unter 3 Jahre,188,104,84
False,8136027,Gschwend,3 -  6 Jahre,203,114,89
False,8136027,Gschwend,6 - 10 Jahre,241,121,120
False,8136027,Gschwend,10 - 15 Jahre,288,142,146
False,8136027,Gschwend,15 - 18 Jahre,163,80,83
False,8136027,Gschwend,18 - 20 Jahre,93,48,45
False,8136027,Gschwend,20 - 25 Jahre,264,138,126
False,8136027,Gschwend,25 - 30 Jahre,413,219,194
False,8136027,Gschwend,30 - 35 Jahre,405,208,197
False,8136027,Gschwend,35 - 40 Jahre,436,216,220
False,8136027,Gschwend,40 - 45 Jahre,332,173,159
False,8136027,Gschwend,45 - 50 Jahre,260,145,115
False,8136027,Gschwend,50 - 55 Jahre,229,121,108
False,8136027,Gschwend,55 - 60 Jahre,327,158,169
False,8136027,Gschwend,60 - 65 Jahre,264,126,138
False,8136027,Gschwend,65 - 75 Jahre,463,194,269
False,8136027,Gschwend,75 und mehr Jahre,279,102,177
False,8136027,Gschwend,Insgesamt,4848,2409,2439
False,8136028,"Heubach, Stadt",unter 3 Jahre,343,194,149
False,8136028,"Heubach, Stadt",3 -  6 Jahre,385,196,189
False,8136028,"Heubach, Stadt",6 - 10 Jahre,508,261,247
False,8136028,"Heubach, Stadt",10 - 15 Jahre,702,376,326
False,8136028,"Heubach, Stadt",15 - 18 Jahre,378,196,182
False,8136028,"Heubach, Stadt",18 - 20 Jahre,240,122,118
False,8136028,"Heubach, Stadt",20 - 25 Jahre,644,334,310
False,8136028,"Heubach, Stadt",25 - 30 Jahre,764,388,376
False,8136028,"Heubach, Stadt",30 - 35 Jahre,883,468,415
False,8136028,"Heubach, Stadt",35 - 40 Jahre,847,419,428
False,8136028,"Heubach, Stadt",40 - 45 Jahre,686,324,362
False,8136028,"Heubach, Stadt",45 - 50 Jahre,632,316,316
False,8136028,"Heubach, Stadt",50 - 55 Jahre,606,305,301
False,8136028,"Heubach, Stadt",55 - 60 Jahre,702,371,331
False,8136028,"Heubach, Stadt",60 - 65 Jahre,547,276,271
False,8136028,"Heubach, Stadt",65 - 75 Jahre,744,309,435
False,8136028,"Heubach, Stadt",75 und mehr Jahre,562,165,397
False,8136028,"Heubach, Stadt",Insgesamt,10173,5020,5153
False,8136029,Heuchlingen,unter 3 Jahre,54,29,25
False,8136029,Heuchlingen,3 -  6 Jahre,77,41,36
False,8136029,Heuchlingen,6 - 10 Jahre,128,63,65
False,8136029,Heuchlingen,10 - 15 Jahre,109,58,51
False,8136029,Heuchlingen,15 - 18 Jahre,55,26,29
False,8136029,Heuchlingen,18 - 20 Jahre,48,26,22
False,8136029,Heuchlingen,20 - 25 Jahre,112,52,60
False,8136029,Heuchlingen,25 - 30 Jahre,169,90,79
False,8136029,Heuchlingen,30 - 35 Jahre,160,86,74
False,8136029,Heuchlingen,35 - 40 Jahre,127,69,58
False,8136029,Heuchlingen,40 - 45 Jahre,94,48,46
False,8136029,Heuchlingen,45 - 50 Jahre,85,47,38
False,8136029,Heuchlingen,50 - 55 Jahre,78,34,44
False,8136029,Heuchlingen,55 - 60 Jahre,137,66,71
False,8136029,Heuchlingen,60 - 65 Jahre,107,52,55
False,8136029,Heuchlingen,65 - 75 Jahre,137,67,70
False,8136029,Heuchlingen,75 und mehr Jahre,65,22,43
False,8136029,Heuchlingen,Insgesamt,1742,876,866
False,8136033,Hüttlingen,unter 3 Jahre,207,114,93
False,8136033,Hüttlingen,3 -  6 Jahre,240,120,120
False,8136033,Hüttlingen,6 - 10 Jahre,287,145,142
False,8136033,Hüttlingen,10 - 15 Jahre,350,185,165
False,8136033,Hüttlingen,15 - 18 Jahre,219,103,116
False,8136033,Hüttlingen,18 - 20 Jahre,128,64,64
False,8136033,Hüttlingen,20 - 25 Jahre,358,187,171
False,8136033,Hüttlingen,25 - 30 Jahre,474,242,232
False,8136033,Hüttlingen,30 - 35 Jahre,542,285,257
False,8136033,Hüttlingen,35 - 40 Jahre,460,239,221
False,8136033,Hüttlingen,40 - 45 Jahre,375,195,180
False,8136033,Hüttlingen,45 - 50 Jahre,299,147,152
False,8136033,Hüttlingen,50 - 55 Jahre,330,163,167
False,8136033,Hüttlingen,55 - 60 Jahre,390,196,194
False,8136033,Hüttlingen,60 - 65 Jahre,269,140,129
False,8136033,Hüttlingen,65 - 75 Jahre,394,159,235
False,8136033,Hüttlingen,75 und mehr Jahre,255,82,173
False,8136033,Hüttlingen,Insgesamt,5577,2766,2811
False,8136034,Iggingen,unter 3 Jahre,100,45,55
False,8136034,Iggingen,3 -  6 Jahre,121,61,60
False,8136034,Iggingen,6 - 10 Jahre,127,66,61
False,8136034,Iggingen,10 - 15 Jahre,142,79,63
False,8136034,Iggingen,15 - 18 Jahre,83,47,36
False,8136034,Iggingen,18 - 20 Jahre,52,33,19
False,8136034,Iggingen,20 - 25 Jahre,103,44,59
False,8136034,Iggingen,25 - 30 Jahre,213,117,96
False,8136034,Iggingen,30 - 35 Jahre,228,118,110
False,8136034,Iggingen,35 - 40 Jahre,202,100,102
False,8136034,Iggingen,40 - 45 Jahre,148,79,69
False,8136034,Iggingen,45 - 50 Jahre,133,69,64
False,8136034,Iggingen,50 - 55 Jahre,133,71,62
False,8136034,Iggingen,55 - 60 Jahre,139,75,64
False,8136034,Iggingen,60 - 65 Jahre,115,57,58
False,8136034,Iggingen,65 - 75 Jahre,181,84,97
False,8136034,Iggingen,75 und mehr Jahre,105,30,75
False,8136034,Iggingen,Insgesamt,2325,1175,1150
False,8136035,Jagstzell,unter 3 Jahre,84,40,44
False,8136035,Jagstzell,3 -  6 Jahre,104,55,49
False,8136035,Jagstzell,6 - 10 Jahre,166,82,84
False,8136035,Jagstzell,10 - 15 Jahre,172,78,94
False,8136035,Jagstzell,15 - 18 Jahre,104,55,49
False,8136035,Jagstzell,18 - 20 Jahre,66,37,29
False,8136035,Jagstzell,20 - 25 Jahre,152,89,63
False,8136035,Jagstzell,25 - 30 Jahre,198,104,94
False,8136035,Jagstzell,30 - 35 Jahre,213,107,106
False,8136035,Jagstzell,35 - 40 Jahre,205,113,92
False,8136035,Jagstzell,40 - 45 Jahre,166,85,81
False,8136035,Jagstzell,45 - 50 Jahre,126,63,63
False,8136035,Jagstzell,50 - 55 Jahre,89,43,46
False,8136035,Jagstzell,55 - 60 Jahre,135,77,58
False,8136035,Jagstzell,60 - 65 Jahre,126,61,65
False,8136035,Jagstzell,65 - 75 Jahre,205,94,111
False,8136035,Jagstzell,75 und mehr Jahre,115,32,83
False,8136035,Jagstzell,Insgesamt,2426,1215,1211
False,8136037,Kirchheim am Ries,unter 3 Jahre,70,40,30
False,8136037,Kirchheim am Ries,3 -  6 Jahre,79,35,44
False,8136037,Kirchheim am Ries,6 - 10 Jahre,108,53,55
False,8136037,Kirchheim am Ries,10 - 15 Jahre,131,77,54
False,8136037,Kirchheim am Ries,15 - 18 Jahre,72,37,35
False,8136037,Kirchheim am Ries,18 - 20 Jahre,48,22,26
False,8136037,Kirchheim am Ries,20 - 25 Jahre,128,68,60
False,8136037,Kirchheim am Ries,25 - 30 Jahre,131,82,49
False,8136037,Kirchheim am Ries,30 - 35 Jahre,154,80,74
False,8136037,Kirchheim am Ries,35 - 40 Jahre,140,75,65
False,8136037,Kirchheim am Ries,40 - 45 Jahre,124,67,57
False,8136037,Kirchheim am Ries,45 - 50 Jahre,107,51,56
False,8136037,Kirchheim am Ries,50 - 55 Jahre,100,50,50
False,8136037,Kirchheim am Ries,55 - 60 Jahre,127,69,58
False,8136037,Kirchheim am Ries,60 - 65 Jahre,86,43,43
False,8136037,Kirchheim am Ries,65 - 75 Jahre,146,60,86
False,8136037,Kirchheim am Ries,75 und mehr Jahre,133,30,103
False,8136037,Kirchheim am Ries,Insgesamt,1884,939,945
False,8136038,"Lauchheim, Stadt",unter 3 Jahre,175,93,82
False,8136038,"Lauchheim, Stadt",3 -  6 Jahre,181,84,97
False,8136038,"Lauchheim, Stadt",6 - 10 Jahre,246,119,127
False,8136038,"Lauchheim, Stadt",10 - 15 Jahre,284,142,142
False,8136038,"Lauchheim, Stadt",15 - 18 Jahre,171,86,85
False,8136038,"Lauchheim, Stadt",18 - 20 Jahre,94,43,51
False,8136038,"Lauchheim, Stadt",20 - 25 Jahre,276,136,140
False,8136038,"Lauchheim, Stadt",25 - 30 Jahre,303,162,141
False,8136038,"Lauchheim, Stadt",30 - 35 Jahre,348,175,173
False,8136038,"Lauchheim, Stadt",35 - 40 Jahre,375,194,181
False,8136038,"Lauchheim, Stadt",40 - 45 Jahre,317,165,152
False,8136038,"Lauchheim, Stadt",45 - 50 Jahre,243,137,106
False,8136038,"Lauchheim, Stadt",50 - 55 Jahre,208,106,102
False,8136038,"Lauchheim, Stadt",55 - 60 Jahre,235,111,124
False,8136038,"Lauchheim, Stadt",60 - 65 Jahre,178,98,80
False,8136038,"Lauchheim, Stadt",65 - 75 Jahre,302,114,188
False,8136038,"Lauchheim, Stadt",75 und mehr Jahre,216,76,140
False,8136038,"Lauchheim, Stadt",Insgesamt,4152,2041,2111
False,8136040,Leinzell,unter 3 Jahre,94,43,51
False,8136040,Leinzell,3 -  6 Jahre,106,52,54
False,8136040,Leinzell,6 - 10 Jahre,131,70,61
False,8136040,Leinzell,10 - 15 Jahre,144,76,68
False,8136040,Leinzell,15 - 18 Jahre,83,48,35
False,8136040,Leinzell,18 - 20 Jahre,48,27,21
False,8136040,Leinzell,20 - 25 Jahre,156,75,81
False,8136040,Leinzell,25 - 30 Jahre,206,96,110
False,8136040,Leinzell,30 - 35 Jahre,239,128,111
False,8136040,Leinzell,35 - 40 Jahre,213,104,109
False,8136040,Leinzell,40 - 45 Jahre,162,79,83
False,8136040,Leinzell,45 - 50 Jahre,166,89,77
False,8136040,Leinzell,50 - 55 Jahre,127,72,55
False,8136040,Leinzell,55 - 60 Jahre,152,68,84
False,8136040,Leinzell,60 - 65 Jahre,135,68,67
False,8136040,Leinzell,65 - 75 Jahre,215,96,119
False,8136040,Leinzell,75 und mehr Jahre,125,37,88
False,8136040,Leinzell,Insgesamt,2502,1228,1274
False,8136042,"Lorch, Stadt",unter 3 Jahre,418,217,201
False,8136042,"Lorch, Stadt",3 -  6 Jahre,392,179,213
False,8136042,"Lorch, Stadt",6 - 10 Jahre,560,276,284
False,8136042,"Lorch, Stadt",10 - 15 Jahre,622,318,304
False,8136042,"Lorch, Stadt",15 - 18 Jahre,356,211,145
False,8136042,"Lorch, Stadt",18 - 20 Jahre,205,105,100
False,8136042,"Lorch, Stadt",20 - 25 Jahre,608,316,292
False,8136042,"Lorch, Stadt",25 - 30 Jahre,868,442,426
False,8136042,"Lorch, Stadt",30 - 35 Jahre,991,537,454
False,8136042,"Lorch, Stadt",35 - 40 Jahre,878,439,439
False,8136042,"Lorch, Stadt",40 - 45 Jahre,783,409,374
False,8136042,"Lorch, Stadt",45 - 50 Jahre,709,371,338
False,8136042,"Lorch, Stadt",50 - 55 Jahre,660,342,318
False,8136042,"Lorch, Stadt",55 - 60 Jahre,774,404,370
False,8136042,"Lorch, Stadt",60 - 65 Jahre,589,290,299
False,8136042,"Lorch, Stadt",65 - 75 Jahre,912,392,520
False,8136042,"Lorch, Stadt",75 und mehr Jahre,714,198,516
False,8136042,"Lorch, Stadt",Insgesamt,11039,5446,5593
False,8136043,Mögglingen,unter 3 Jahre,161,80,81
False,8136043,Mögglingen,3 -  6 Jahre,139,69,70
False,8136043,Mögglingen,6 - 10 Jahre,185,89,96
False,8136043,Mögglingen,10 - 15 Jahre,229,107,122
False,8136043,Mögglingen,15 - 18 Jahre,106,56,50
False,8136043,Mögglingen,18 - 20 Jahre,93,47,46
False,8136043,Mögglingen,20 - 25 Jahre,239,127,112
False,8136043,Mögglingen,25 - 30 Jahre,315,183,132
False,8136043,Mögglingen,30 - 35 Jahre,325,145,180
False,8136043,Mögglingen,35 - 40 Jahre,315,174,141
False,8136043,Mögglingen,40 - 45 Jahre,224,110,114
False,8136043,Mögglingen,45 - 50 Jahre,250,122,128
False,8136043,Mögglingen,50 - 55 Jahre,231,129,102
False,8136043,Mögglingen,55 - 60 Jahre,242,114,128
False,8136043,Mögglingen,60 - 65 Jahre,192,93,99
False,8136043,Mögglingen,65 - 75 Jahre,260,112,148
False,8136043,Mögglingen,75 und mehr Jahre,222,83,139
False,8136043,Mögglingen,Insgesamt,3728,1840,1888
False,8136044,Mutlangen,unter 3 Jahre,215,114,101
False,8136044,Mutlangen,3 -  6 Jahre,238,116,122
False,8136044,Mutlangen,6 - 10 Jahre,283,126,157
False,8136044,Mutlangen,10 - 15 Jahre,308,162,146
False,8136044,Mutlangen,15 - 18 Jahre,216,101,115
False,8136044,Mutlangen,18 - 20 Jahre,134,68,66
False,8136044,Mutlangen,20 - 25 Jahre,361,197,164
False,8136044,Mutlangen,25 - 30 Jahre,454,213,241
False,8136044,Mutlangen,30 - 35 Jahre,484,218,266
False,8136044,Mutlangen,35 - 40 Jahre,482,259,223
False,8136044,Mutlangen,40 - 45 Jahre,418,210,208
False,8136044,Mutlangen,45 - 50 Jahre,362,184,178
False,8136044,Mutlangen,50 - 55 Jahre,341,161,180
False,8136044,Mutlangen,55 - 60 Jahre,334,154,180
False,8136044,Mutlangen,60 - 65 Jahre,268,131,137
False,8136044,Mutlangen,65 - 75 Jahre,468,214,254
False,8136044,Mutlangen,75 und mehr Jahre,232,76,156
False,8136044,Mutlangen,Insgesamt,5598,2704,2894
False,8136045,"Neresheim, Stadt",unter 3 Jahre,319,172,147
False,8136045,"Neresheim, Stadt",3 -  6 Jahre,361,177,184
False,8136045,"Neresheim, Stadt",6 - 10 Jahre,437,217,220
False,8136045,"Neresheim, Stadt",10 - 15 Jahre,528,266,262
False,8136045,"Neresheim, Stadt",15 - 18 Jahre,330,179,151
False,8136045,"Neresheim, Stadt",18 - 20 Jahre,206,102,104
False,8136045,"Neresheim, Stadt",20 - 25 Jahre,583,300,283
False,8136045,"Neresheim, Stadt",25 - 30 Jahre,678,364,314
False,8136045,"Neresheim, Stadt",30 - 35 Jahre,686,365,321
False,8136045,"Neresheim, Stadt",35 - 40 Jahre,654,355,299
False,8136045,"Neresheim, Stadt",40 - 45 Jahre,610,312,298
False,8136045,"Neresheim, Stadt",45 - 50 Jahre,471,270,201
False,8136045,"Neresheim, Stadt",50 - 55 Jahre,387,216,171
False,8136045,"Neresheim, Stadt",55 - 60 Jahre,444,231,213
False,8136045,"Neresheim, Stadt",60 - 65 Jahre,394,191,203
False,8136045,"Neresheim, Stadt",65 - 75 Jahre,669,308,361
False,8136045,"Neresheim, Stadt",75 und mehr Jahre,434,132,302
False,8136045,"Neresheim, Stadt",Insgesamt,8191,4157,4034
False,8136046,Neuler,unter 3 Jahre,126,57,69
False,8136046,Neuler,3 -  6 Jahre,152,87,65
False,8136046,Neuler,6 - 10 Jahre,184,97,87
False,8136046,Neuler,10 - 15 Jahre,211,120,91
False,8136046,Neuler,15 - 18 Jahre,116,59,57
False,8136046,Neuler,18 - 20 Jahre,85,48,37
False,8136046,Neuler,20 - 25 Jahre,220,121,99
False,8136046,Neuler,25 - 30 Jahre,243,124,119
False,8136046,Neuler,30 - 35 Jahre,281,144,137
False,8136046,Neuler,35 - 40 Jahre,235,121,114
False,8136046,Neuler,40 - 45 Jahre,200,101,99
False,8136046,Neuler,45 - 50 Jahre,181,101,80
False,8136046,Neuler,50 - 55 Jahre,130,69,61
False,8136046,Neuler,55 - 60 Jahre,168,86,82
False,8136046,Neuler,60 - 65 Jahre,107,61,46
False,8136046,Neuler,65 - 75 Jahre,199,86,113
False,8136046,Neuler,75 und mehr Jahre,124,50,74
False,8136046,Neuler,Insgesamt,2962,1532,1430
False,8136049,Obergröningen,unter 3 Jahre,8,4,4
False,8136049,Obergröningen,3 -  6 Jahre,9,6,3
False,8136049,Obergröningen,6 - 10 Jahre,24,9,15
False,8136049,Obergröningen,10 - 15 Jahre,14,2,12
False,8136049,Obergröningen,15 - 18 Jahre,25,12,13
False,8136049,Obergröningen,18 - 20 Jahre,9,5,4
False,8136049,Obergröningen,20 - 25 Jahre,32,19,13
False,8136049,Obergröningen,25 - 30 Jahre,27,16,11
False,8136049,Obergröningen,30 - 35 Jahre,40,26,14
False,8136049,Obergröningen,35 - 40 Jahre,35,21,14
False,8136049,Obergröningen,40 - 45 Jahre,17,7,10
False,8136049,Obergröningen,45 - 50 Jahre,39,19,20
False,8136049,Obergröningen,50 - 55 Jahre,26,17,9
False,8136049,Obergröningen,55 - 60 Jahre,32,18,14
False,8136049,Obergröningen,60 - 65 Jahre,28,16,12
False,8136049,Obergröningen,65 - 75 Jahre,33,16,17
False,8136049,Obergröningen,75 und mehr Jahre,29,5,24
False,8136049,Obergröningen,Insgesamt,427,218,209
False,8136050,"Oberkochen, Stadt",unter 3 Jahre,244,123,121
False,8136050,"Oberkochen, Stadt",3 -  6 Jahre,295,137,158
False,8136050,"Oberkochen, Stadt",6 - 10 Jahre,395,223,172
False,8136050,"Oberkochen, Stadt",10 - 15 Jahre,468,246,222
False,8136050,"Oberkochen, Stadt",15 - 18 Jahre,258,123,135
False,8136050,"Oberkochen, Stadt",18 - 20 Jahre,175,90,85
False,8136050,"Oberkochen, Stadt",20 - 25 Jahre,419,221,198
False,8136050,"Oberkochen, Stadt",25 - 30 Jahre,621,325,296
False,8136050,"Oberkochen, Stadt",30 - 35 Jahre,663,346,317
False,8136050,"Oberkochen, Stadt",35 - 40 Jahre,635,347,288
False,8136050,"Oberkochen, Stadt",40 - 45 Jahre,553,289,264
False,8136050,"Oberkochen, Stadt",45 - 50 Jahre,462,221,241
False,8136050,"Oberkochen, Stadt",50 - 55 Jahre,546,270,276
False,8136050,"Oberkochen, Stadt",55 - 60 Jahre,674,331,343
False,8136050,"Oberkochen, Stadt",60 - 65 Jahre,582,288,294
False,8136050,"Oberkochen, Stadt",65 - 75 Jahre,977,414,563
False,8136050,"Oberkochen, Stadt",75 und mehr Jahre,625,202,423
False,8136050,"Oberkochen, Stadt",Insgesamt,8592,4196,4396
False,8136060,Rosenberg,unter 3 Jahre,127,69,58
False,8136060,Rosenberg,3 -  6 Jahre,121,66,55
False,8136060,Rosenberg,6 - 10 Jahre,150,77,73
False,8136060,Rosenberg,10 - 15 Jahre,201,96,105
False,8136060,Rosenberg,15 - 18 Jahre,101,51,50
False,8136060,Rosenberg,18 - 20 Jahre,68,30,38
False,8136060,Rosenberg,20 - 25 Jahre,148,91,57
False,8136060,Rosenberg,25 - 30 Jahre,207,103,104
False,8136060,Rosenberg,30 - 35 Jahre,252,145,107
False,8136060,Rosenberg,35 - 40 Jahre,218,119,99
False,8136060,Rosenberg,40 - 45 Jahre,196,108,88
False,8136060,Rosenberg,45 - 50 Jahre,129,73,56
False,8136060,Rosenberg,50 - 55 Jahre,111,59,52
False,8136060,Rosenberg,55 - 60 Jahre,135,74,61
False,8136060,Rosenberg,60 - 65 Jahre,111,59,52
False,8136060,Rosenberg,65 - 75 Jahre,224,89,135
False,8136060,Rosenberg,75 und mehr Jahre,158,49,109
False,8136060,Rosenberg,Insgesamt,2657,1358,1299
False,8136061,Ruppertshofen,unter 3 Jahre,78,43,35
False,8136061,Ruppertshofen,3 -  6 Jahre,78,46,32
False,8136061,Ruppertshofen,6 - 10 Jahre,113,53,60
False,8136061,Ruppertshofen,10 - 15 Jahre,127,60,67
False,8136061,Ruppertshofen,15 - 18 Jahre,80,41,39
False,8136061,Ruppertshofen,18 - 20 Jahre,57,18,39
False,8136061,Ruppertshofen,20 - 25 Jahre,111,52,59
False,8136061,Ruppertshofen,25 - 30 Jahre,118,56,62
False,8136061,Ruppertshofen,30 - 35 Jahre,155,80,75
False,8136061,Ruppertshofen,35 - 40 Jahre,162,87,75
False,8136061,Ruppertshofen,40 - 45 Jahre,129,71,58
False,8136061,Ruppertshofen,45 - 50 Jahre,79,45,34
False,8136061,Ruppertshofen,50 - 55 Jahre,59,23,36
False,8136061,Ruppertshofen,55 - 60 Jahre,85,43,42
False,8136061,Ruppertshofen,60 - 65 Jahre,82,42,40
False,8136061,Ruppertshofen,65 - 75 Jahre,100,36,64
False,8136061,Ruppertshofen,75 und mehr Jahre,76,30,46
False,8136061,Ruppertshofen,Insgesamt,1689,826,863
False,8136062,Schechingen,unter 3 Jahre,107,53,54
False,8136062,Schechingen,3 -  6 Jahre,124,58,66
False,8136062,Schechingen,6 - 10 Jahre,144,72,72
False,8136062,Schechingen,10 - 15 Jahre,180,99,81
False,8136062,Schechingen,15 - 18 Jahre,88,36,52
False,8136062,Schechingen,18 - 20 Jahre,40,16,24
False,8136062,Schechingen,20 - 25 Jahre,132,69,63
False,8136062,Schechingen,25 - 30 Jahre,198,91,107
False,8136062,Schechingen,30 - 35 Jahre,227,116,111
False,8136062,Schechingen,35 - 40 Jahre,206,109,97
False,8136062,Schechingen,40 - 45 Jahre,180,96,84
False,8136062,Schechingen,45 - 50 Jahre,137,79,58
False,8136062,Schechingen,50 - 55 Jahre,85,46,39
False,8136062,Schechingen,55 - 60 Jahre,118,60,58
False,8136062,Schechingen,60 - 65 Jahre,97,47,50
False,8136062,Schechingen,65 - 75 Jahre,156,52,104
False,8136062,Schechingen,75 und mehr Jahre,84,25,59
False,8136062,Schechingen,Insgesamt,2303,1124,1179
False,8136065,"Schwäbisch Gmünd, Stadt",unter 3 Jahre,2154,1135,1019
False,8136065,"Schwäbisch Gmünd, Stadt",3 -  6 Jahre,2200,1112,1088
False,8136065,"Schwäbisch Gmünd, Stadt",6 - 10 Jahre,2944,1495,1449
False,8136065,"Schwäbisch Gmünd, Stadt",10 - 15 Jahre,3731,1889,1842
False,8136065,"Schwäbisch Gmünd, Stadt",15 - 18 Jahre,2155,1107,1048
False,8136065,"Schwäbisch Gmünd, Stadt",18 - 20 Jahre,1433,695,738
False,8136065,"Schwäbisch Gmünd, Stadt",20 - 25 Jahre,4303,2222,2081
False,8136065,"Schwäbisch Gmünd, Stadt",25 - 30 Jahre,5136,2704,2432
False,8136065,"Schwäbisch Gmünd, Stadt",30 - 35 Jahre,5133,2699,2434
False,8136065,"Schwäbisch Gmünd, Stadt",35 - 40 Jahre,4637,2311,2326
False,8136065,"Schwäbisch Gmünd, Stadt",40 - 45 Jahre,4024,2000,2024
False,8136065,"Schwäbisch Gmünd, Stadt",45 - 50 Jahre,3783,1892,1891
False,8136065,"Schwäbisch Gmünd, Stadt",50 - 55 Jahre,3851,1950,1901
False,8136065,"Schwäbisch Gmünd, Stadt",55 - 60 Jahre,4320,2131,2189
False,8136065,"Schwäbisch Gmünd, Stadt",60 - 65 Jahre,3304,1642,1662
False,8136065,"Schwäbisch Gmünd, Stadt",65 - 75 Jahre,5881,2331,3550
False,8136065,"Schwäbisch Gmünd, Stadt",75 und mehr Jahre,4745,1366,3379
False,8136065,"Schwäbisch Gmünd, Stadt",Insgesamt,63734,30681,33053
False,8136066,Spraitbach,unter 3 Jahre,114,62,52
False,8136066,Spraitbach,3 -  6 Jahre,144,78,66
False,8136066,Spraitbach,6 - 10 Jahre,207,104,103
False,8136066,Spraitbach,10 - 15 Jahre,247,129,118
False,8136066,Spraitbach,15 - 18 Jahre,111,48,63
False,8136066,Spraitbach,18 - 20 Jahre,87,43,44
False,8136066,Spraitbach,20 - 25 Jahre,228,120,108
False,8136066,Spraitbach,25 - 30 Jahre,300,147,153
False,8136066,Spraitbach,30 - 35 Jahre,324,177,147
False,8136066,Spraitbach,35 - 40 Jahre,347,166,181
False,8136066,Spraitbach,40 - 45 Jahre,238,127,111
False,8136066,Spraitbach,45 - 50 Jahre,228,114,114
False,8136066,Spraitbach,50 - 55 Jahre,212,107,105
False,8136066,Spraitbach,55 - 60 Jahre,229,117,112
False,8136066,Spraitbach,60 - 65 Jahre,219,110,109
False,8136066,Spraitbach,65 - 75 Jahre,233,104,129
False,8136066,Spraitbach,75 und mehr Jahre,117,29,88
False,8136066,Spraitbach,Insgesamt,3585,1782,1803
False,8136068,Stödtlen,unter 3 Jahre,81,53,28
False,8136068,Stödtlen,3 -  6 Jahre,76,35,41
False,8136068,Stödtlen,6 - 10 Jahre,119,64,55
False,8136068,Stödtlen,10 - 15 Jahre,115,61,54
False,8136068,Stödtlen,15 - 18 Jahre,84,42,42
False,8136068,Stödtlen,18 - 20 Jahre,50,29,21
False,8136068,Stödtlen,20 - 25 Jahre,140,71,69
False,8136068,Stödtlen,25 - 30 Jahre,166,78,88
False,8136068,Stödtlen,30 - 35 Jahre,167,87,80
False,8136068,Stödtlen,35 - 40 Jahre,142,84,58
False,8136068,Stödtlen,40 - 45 Jahre,122,57,65
False,8136068,Stödtlen,45 - 50 Jahre,121,65,56
False,8136068,Stödtlen,50 - 55 Jahre,79,41,38
False,8136068,Stödtlen,55 - 60 Jahre,98,62,36
False,8136068,Stödtlen,60 - 65 Jahre,97,47,50
False,8136068,Stödtlen,65 - 75 Jahre,147,67,80
False,8136068,Stödtlen,75 und mehr Jahre,117,35,82
False,8136068,Stödtlen,Insgesamt,1921,978,943
False,8136070,Täferrot,unter 3 Jahre,49,25,24
False,8136070,Täferrot,3 -  6 Jahre,37,17,20
False,8136070,Täferrot,6 - 10 Jahre,45,22,23
False,8136070,Täferrot,10 - 15 Jahre,67,32,35
False,8136070,Täferrot,15 - 18 Jahre,25,16,9
False,8136070,Täferrot,18 - 20 Jahre,37,19,18
False,8136070,Täferrot,20 - 25 Jahre,78,38,40
False,8136070,Täferrot,25 - 30 Jahre,82,48,34
False,8136070,Täferrot,30 - 35 Jahre,89,38,51
False,8136070,Täferrot,35 - 40 Jahre,77,40,37
False,8136070,Täferrot,40 - 45 Jahre,68,33,35
False,8136070,Täferrot,45 - 50 Jahre,70,38,32
False,8136070,Täferrot,50 - 55 Jahre,62,33,29
False,8136070,Täferrot,55 - 60 Jahre,57,35,22
False,8136070,Täferrot,60 - 65 Jahre,55,24,31
False,8136070,Täferrot,65 - 75 Jahre,75,34,41
False,8136070,Täferrot,75 und mehr Jahre,37,10,27
False,8136070,Täferrot,Insgesamt,1010,502,508
False,8136071,Tannhausen,unter 3 Jahre,61,33,28
False,8136071,Tannhausen,3 -  6 Jahre,86,43,43
False,8136071,Tannhausen,6 - 10 Jahre,109,58,51
False,8136071,Tannhausen,10 - 15 Jahre,118,62,56
False,8136071,Tannhausen,15 - 18 Jahre,68,35,33
False,8136071,Tannhausen,18 - 20 Jahre,48,24,24
False,8136071,Tannhausen,20 - 25 Jahre,99,54,45
False,8136071,Tannhausen,25 - 30 Jahre,127,67,60
False,8136071,Tannhausen,30 - 35 Jahre,166,91,75
False,8136071,Tannhausen,35 - 40 Jahre,120,60,60
False,8136071,Tannhausen,40 - 45 Jahre,115,56,59
False,8136071,Tannhausen,45 - 50 Jahre,96,56,40
False,8136071,Tannhausen,50 - 55 Jahre,89,51,38
False,8136071,Tannhausen,55 - 60 Jahre,130,74,56
False,8136071,Tannhausen,60 - 65 Jahre,81,36,45
False,8136071,Tannhausen,65 - 75 Jahre,192,76,116
False,8136071,Tannhausen,75 und mehr Jahre,113,26,87
False,8136071,Tannhausen,Insgesamt,1818,902,916
False,8136075,Unterschneidheim,unter 3 Jahre,147,79,68
False,8136075,Unterschneidheim,3 -  6 Jahre,201,119,82
False,8136075,Unterschneidheim,6 - 10 Jahre,284,144,140
False,8136075,Unterschneidheim,10 - 15 Jahre,331,169,162
False,8136075,Unterschneidheim,15 - 18 Jahre,214,103,111
False,8136075,Unterschneidheim,18 - 20 Jahre,121,65,56
False,8136075,Unterschneidheim,20 - 25 Jahre,338,173,165
False,8136075,Unterschneidheim,25 - 30 Jahre,358,209,149
False,8136075,Unterschneidheim,30 - 35 Jahre,377,194,183
False,8136075,Unterschneidheim,35 - 40 Jahre,350,185,165
False,8136075,Unterschneidheim,40 - 45 Jahre,315,176,139
False,8136075,Unterschneidheim,45 - 50 Jahre,233,119,114
False,8136075,Unterschneidheim,50 - 55 Jahre,211,110,101
False,8136075,Unterschneidheim,55 - 60 Jahre,254,136,118
False,8136075,Unterschneidheim,60 - 65 Jahre,190,98,92
False,8136075,Unterschneidheim,65 - 75 Jahre,346,148,198
False,8136075,Unterschneidheim,75 und mehr Jahre,211,67,144
False,8136075,Unterschneidheim,Insgesamt,4481,2294,2187
False,8136079,Waldstetten,unter 3 Jahre,231,104,127
False,8136079,Waldstetten,3 -  6 Jahre,251,129,122
False,8136079,Waldstetten,6 - 10 Jahre,327,168,159
False,8136079,Waldstetten,10 - 15 Jahre,448,227,221
False,8136079,Waldstetten,15 - 18 Jahre,224,119,105
False,8136079,Waldstetten,18 - 20 Jahre,141,63,78
False,8136079,Waldstetten,20 - 25 Jahre,452,228,224
False,8136079,Waldstetten,25 - 30 Jahre,579,327,252
False,8136079,Waldstetten,30 - 35 Jahre,569,294,275
False,8136079,Waldstetten,35 - 40 Jahre,515,247,268
False,8136079,Waldstetten,40 - 45 Jahre,524,268,256
False,8136079,Waldstetten,45 - 50 Jahre,462,224,238
False,8136079,Waldstetten,50 - 55 Jahre,425,210,215
False,8136079,Waldstetten,55 - 60 Jahre,500,241,259
False,8136079,Waldstetten,60 - 65 Jahre,333,183,150
False,8136079,Waldstetten,65 - 75 Jahre,576,251,325
False,8136079,Waldstetten,75 und mehr Jahre,386,117,269
False,8136079,Waldstetten,Insgesamt,6943,3400,3543
False,8136082,Westhausen,unter 3 Jahre,248,138,110
False,8136082,Westhausen,3 -  6 Jahre,218,113,105
False,8136082,Westhausen,6 - 10 Jahre,288,151,137
False,8136082,Westhausen,10 - 15 Jahre,346,174,172
False,8136082,Westhausen,15 - 18 Jahre,202,104,98
False,8136082,Westhausen,18 - 20 Jahre,153,76,77
False,8136082,Westhausen,20 - 25 Jahre,415,200,215
False,8136082,Westhausen,25 - 30 Jahre,496,247,249
False,8136082,Westhausen,30 - 35 Jahre,486,249,237
False,8136082,Westhausen,35 - 40 Jahre,421,224,197
False,8136082,Westhausen,40 - 45 Jahre,387,197,190
False,8136082,Westhausen,45 - 50 Jahre,325,146,179
False,8136082,Westhausen,50 - 55 Jahre,350,190,160
False,8136082,Westhausen,55 - 60 Jahre,392,211,181
False,8136082,Westhausen,60 - 65 Jahre,260,146,114
False,8136082,Westhausen,65 - 75 Jahre,407,168,239
False,8136082,Westhausen,75 und mehr Jahre,261,82,179
False,8136082,Westhausen,Insgesamt,5655,2816,2839
False,8136084,Wört,unter 3 Jahre,53,26,27
False,8136084,Wört,3 -  6 Jahre,55,26,29
False,8136084,Wört,6 - 10 Jahre,85,47,38
False,8136084,Wört,10 - 15 Jahre,127,60,67
False,8136084,Wört,15 - 18 Jahre,61,29,32
False,8136084,Wört,18 - 20 Jahre,49,22,27
False,8136084,Wört,20 - 25 Jahre,131,67,64
False,8136084,Wört,25 - 30 Jahre,112,55,57
False,8136084,Wört,30 - 35 Jahre,110,60,50
False,8136084,Wört,35 - 40 Jahre,110,65,45
False,8136084,Wört,40 - 45 Jahre,89,44,45
False,8136084,Wört,45 - 50 Jahre,81,43,38
False,8136084,Wört,50 - 55 Jahre,53,26,27
False,8136084,Wört,55 - 60 Jahre,78,42,36
False,8136084,Wört,60 - 65 Jahre,78,45,33
False,8136084,Wört,65 - 75 Jahre,83,34,49
False,8136084,Wört,75 und mehr Jahre,64,19,45
False,8136084,Wört,Insgesamt,1419,710,709
False,8136087,Riesbürg,unter 3 Jahre,79,40,39
False,8136087,Riesbürg,3 -  6 Jahre,94,44,50
False,8136087,Riesbürg,6 - 10 Jahre,108,50,58
False,8136087,Riesbürg,10 - 15 Jahre,136,74,62
False,8136087,Riesbürg,15 - 18 Jahre,82,36,46
False,8136087,Riesbürg,18 - 20 Jahre,53,33,20
False,8136087,Riesbürg,20 - 25 Jahre,127,68,59
False,8136087,Riesbürg,25 - 30 Jahre,171,85,86
False,8136087,Riesbürg,30 - 35 Jahre,178,91,87
False,8136087,Riesbürg,35 - 40 Jahre,167,89,78
False,8136087,Riesbürg,40 - 45 Jahre,150,84,66
False,8136087,Riesbürg,45 - 50 Jahre,131,74,57
False,8136087,Riesbürg,50 - 55 Jahre,125,61,64
False,8136087,Riesbürg,55 - 60 Jahre,123,59,64
False,8136087,Riesbürg,60 - 65 Jahre,119,56,63
False,8136087,Riesbürg,65 - 75 Jahre,222,92,130
False,8136087,Riesbürg,75 und mehr Jahre,131,45,86
False,8136087,Riesbürg,Insgesamt,2196,1081,1115
False,8136088,"Aalen, Stadt",unter 3 Jahre,2294,1189,1105
False,8136088,"Aalen, Stadt",3 -  6 Jahre,2279,1159,1120
False,8136088,"Aalen, Stadt",6 - 10 Jahre,2947,1542,1405
False,8136088,"Aalen, Stadt",10 - 15 Jahre,3510,1762,1748
False,8136088,"Aalen, Stadt",15 - 18 Jahre,2139,1107,1032
False,8136088,"Aalen, Stadt",18 - 20 Jahre,1480,728,752
False,8136088,"Aalen, Stadt",20 - 25 Jahre,4384,2264,2120
False,8136088,"Aalen, Stadt",25 - 30 Jahre,5674,2967,2707
False,8136088,"Aalen, Stadt",30 - 35 Jahre,5524,2983,2541
False,8136088,"Aalen, Stadt",35 - 40 Jahre,4726,2418,2308
False,8136088,"Aalen, Stadt",40 - 45 Jahre,4223,2108,2115
False,8136088,"Aalen, Stadt",45 - 50 Jahre,3878,1953,1925
False,8136088,"Aalen, Stadt",50 - 55 Jahre,3960,1999,1961
False,8136088,"Aalen, Stadt",55 - 60 Jahre,4757,2405,2352
False,8136088,"Aalen, Stadt",60 - 65 Jahre,3676,1792,1884
False,8136088,"Aalen, Stadt",65 - 75 Jahre,6323,2622,3701
False,8136088,"Aalen, Stadt",75 und mehr Jahre,4460,1399,3061
False,8136088,"Aalen, Stadt",Insgesamt,66234,32397,33837
False,8136089,Rainau,unter 3 Jahre,147,72,75
False,8136089,Rainau,3 -  6 Jahre,143,66,77
False,8136089,Rainau,6 - 10 Jahre,169,75,94
False,8136089,Rainau,10 - 15 Jahre,211,98,113
False,8136089,Rainau,15 - 18 Jahre,130,73,57
False,8136089,Rainau,18 - 20 Jahre,71,42,29
False,8136089,Rainau,20 - 25 Jahre,204,123,81
False,8136089,Rainau,25 - 30 Jahre,237,113,124
False,8136089,Rainau,30 - 35 Jahre,328,165,163
False,8136089,Rainau,35 - 40 Jahre,232,133,99
False,8136089,Rainau,40 - 45 Jahre,217,117,100
False,8136089,Rainau,45 - 50 Jahre,172,86,86
False,8136089,Rainau,50 - 55 Jahre,124,71,53
False,8136089,Rainau,55 - 60 Jahre,168,80,88
False,8136089,Rainau,60 - 65 Jahre,145,82,63
False,8136089,Rainau,65 - 75 Jahre,209,93,116
False,8136089,Rainau,75 und mehr Jahre,133,36,97
False,8136089,Rainau,Insgesamt,3040,1525,1515
False,82,Regierungsbezirk Karlsruhe,unter 3 Jahre,83473,43126,40347
False,82,Regierungsbezirk Karlsruhe,3 -  6 Jahre,88650,45495,43155
False,82,Regierungsbezirk Karlsruhe,6 - 10 Jahre,115467,59363,56104
False,82,Regierungsbezirk Karlsruhe,10 - 15 Jahre,135154,69105,66049
False,82,Regierungsbezirk Karlsruhe,15 - 18 Jahre,78193,40103,38090
False,82,Regierungsbezirk Karlsruhe,18 - 20 Jahre,52364,26562,25802
False,82,Regierungsbezirk Karlsruhe,20 - 25 Jahre,158421,79378,79043
False,82,Regierungsbezirk Karlsruhe,25 - 30 Jahre,229346,118308,111038
False,82,Regierungsbezirk Karlsruhe,30 - 35 Jahre,245535,127521,118014
False,82,Regierungsbezirk Karlsruhe,35 - 40 Jahre,212122,109541,102581
False,82,Regierungsbezirk Karlsruhe,40 - 45 Jahre,183384,92744,90640
False,82,Regierungsbezirk Karlsruhe,45 - 50 Jahre,167509,84625,82884
False,82,Regierungsbezirk Karlsruhe,50 - 55 Jahre,158390,80488,77902
False,82,Regierungsbezirk Karlsruhe,55 - 60 Jahre,187491,93952,93539
False,82,Regierungsbezirk Karlsruhe,60 - 65 Jahre,141431,69225,72206
False,82,Regierungsbezirk Karlsruhe,65 - 75 Jahre,238505,98837,139668
False,82,Regierungsbezirk Karlsruhe,75 und mehr Jahre,168995,49873,119122
False,82,Regierungsbezirk Karlsruhe,Insgesamt,2644430,1288246,1356184
False,8211,Stadtkreis Baden-Baden,unter 3 Jahre,1327,695,632
False,8211,Stadtkreis Baden-Baden,3 -  6 Jahre,1413,733,680
False,8211,Stadtkreis Baden-Baden,6 - 10 Jahre,1826,938,888
False,8211,Stadtkreis Baden-Baden,10 - 15 Jahre,2217,1162,1055
False,8211,Stadtkreis Baden-Baden,15 - 18 Jahre,1424,723,701
False,8211,Stadtkreis Baden-Baden,18 - 20 Jahre,890,428,462
False,8211,Stadtkreis Baden-Baden,20 - 25 Jahre,2671,1243,1428
False,8211,Stadtkreis Baden-Baden,25 - 30 Jahre,4001,1924,2077
False,8211,Stadtkreis Baden-Baden,30 - 35 Jahre,4122,2013,2109
False,8211,Stadtkreis Baden-Baden,35 - 40 Jahre,3762,1843,1919
False,8211,Stadtkreis Baden-Baden,40 - 45 Jahre,3358,1622,1736
False,8211,Stadtkreis Baden-Baden,45 - 50 Jahre,3350,1599,1751
False,8211,Stadtkreis Baden-Baden,50 - 55 Jahre,3286,1550,1736
False,8211,Stadtkreis Baden-Baden,55 - 60 Jahre,4108,1917,2191
False,8211,Stadtkreis Baden-Baden,60 - 65 Jahre,3060,1412,1648
False,8211,Stadtkreis Baden-Baden,65 - 75 Jahre,6370,2480,3890
False,8211,Stadtkreis Baden-Baden,75 und mehr Jahre,5560,1554,4006
False,8211,Stadtkreis Baden-Baden,Insgesamt,52745,23836,28909
False,8211000,"Baden-Baden, Stadt",unter 3 Jahre,1327,695,632
False,8211000,"Baden-Baden, Stadt",3 -  6 Jahre,1413,733,680
False,8211000,"Baden-Baden, Stadt",6 - 10 Jahre,1826,938,888
False,8211000,"Baden-Baden, Stadt",10 - 15 Jahre,2217,1162,1055
False,8211000,"Baden-Baden, Stadt",15 - 18 Jahre,1424,723,701
False,8211000,"Baden-Baden, Stadt",18 - 20 Jahre,890,428,462
False,8211000,"Baden-Baden, Stadt",20 - 25 Jahre,2671,1243,1428
False,8211000,"Baden-Baden, Stadt",25 - 30 Jahre,4001,1924,2077
False,8211000,"Baden-Baden, Stadt",30 - 35 Jahre,4122,2013,2109
False,8211000,"Baden-Baden, Stadt",35 - 40 Jahre,3762,1843,1919
False,8211000,"Baden-Baden, Stadt",40 - 45 Jahre,3358,1622,1736
False,8211000,"Baden-Baden, Stadt",45 - 50 Jahre,3350,1599,1751
False,8211000,"Baden-Baden, Stadt",50 - 55 Jahre,3286,1550,1736
False,8211000,"Baden-Baden, Stadt",55 - 60 Jahre,4108,1917,2191
False,8211000,"Baden-Baden, Stadt",60 - 65 Jahre,3060,1412,1648
False,8211000,"Baden-Baden, Stadt",65 - 75 Jahre,6370,2480,3890
False,8211000,"Baden-Baden, Stadt",75 und mehr Jahre,5560,1554,4006
False,8211000,"Baden-Baden, Stadt",Insgesamt,52745,23836,28909
False,8212,Stadtkreis Karlsruhe,unter 3 Jahre,7497,3881,3616
False,8212,Stadtkreis Karlsruhe,3 -  6 Jahre,7660,3973,3687
False,8212,Stadtkreis Karlsruhe,6 - 10 Jahre,9614,4859,4755
False,8212,Stadtkreis Karlsruhe,10 - 15 Jahre,11240,5746,5494
False,8212,Stadtkreis Karlsruhe,15 - 18 Jahre,6497,3278,3219
False,8212,Stadtkreis Karlsruhe,18 - 20 Jahre,4689,2214,2475
False,8212,Stadtkreis Karlsruhe,20 - 25 Jahre,18091,9434,8657
False,8212,Stadtkreis Karlsruhe,25 - 30 Jahre,27755,15113,12642
False,8212,Stadtkreis Karlsruhe,30 - 35 Jahre,26518,14117,12401
False,8212,Stadtkreis Karlsruhe,35 - 40 Jahre,21519,11370,10149
False,8212,Stadtkreis Karlsruhe,40 - 45 Jahre,18123,9127,8996
False,8212,Stadtkreis Karlsruhe,45 - 50 Jahre,16823,8382,8441
False,8212,Stadtkreis Karlsruhe,50 - 55 Jahre,17019,8484,8535
False,8212,Stadtkreis Karlsruhe,55 - 60 Jahre,19468,9492,9976
False,8212,Stadtkreis Karlsruhe,60 - 65 Jahre,14626,6973,7653
False,8212,Stadtkreis Karlsruhe,65 - 75 Jahre,26939,10731,16208
False,8212,Stadtkreis Karlsruhe,75 und mehr Jahre,21612,6162,15450
False,8212,Stadtkreis Karlsruhe,Insgesamt,275690,133336,142354
False,8212000,"Karlsruhe, Stadt",unter 3 Jahre,7497,3881,3616
False,8212000,"Karlsruhe, Stadt",3 -  6 Jahre,7660,3973,3687
False,8212000,"Karlsruhe, Stadt",6 - 10 Jahre,9614,4859,4755
False,8212000,"Karlsruhe, Stadt",10 - 15 Jahre,11240,5746,5494
False,8212000,"Karlsruhe, Stadt",15 - 18 Jahre,6497,3278,3219
False,8212000,"Karlsruhe, Stadt",18 - 20 Jahre,4689,2214,2475
False,8212000,"Karlsruhe, Stadt",20 - 25 Jahre,18091,9434,8657
False,8212000,"Karlsruhe, Stadt",25 - 30 Jahre,27755,15113,12642
False,8212000,"Karlsruhe, Stadt",30 - 35 Jahre,26518,14117,12401
False,8212000,"Karlsruhe, Stadt",35 - 40 Jahre,21519,11370,10149
False,8212000,"Karlsruhe, Stadt",40 - 45 Jahre,18123,9127,8996
False,8212000,"Karlsruhe, Stadt",45 - 50 Jahre,16823,8382,8441
False,8212000,"Karlsruhe, Stadt",50 - 55 Jahre,17019,8484,8535
False,8212000,"Karlsruhe, Stadt",55 - 60 Jahre,19468,9492,9976
False,8212000,"Karlsruhe, Stadt",60 - 65 Jahre,14626,6973,7653
False,8212000,"Karlsruhe, Stadt",65 - 75 Jahre,26939,10731,16208
False,8212000,"Karlsruhe, Stadt",75 und mehr Jahre,21612,6162,15450
False,8212000,"Karlsruhe, Stadt",Insgesamt,275690,133336,142354
False,8215,Landkreis Karlsruhe,unter 3 Jahre,13577,7075,6502
False,8215,Landkreis Karlsruhe,3 -  6 Jahre,14446,7449,6997
False,8215,Landkreis Karlsruhe,6 - 10 Jahre,18728,9658,9070
False,8215,Landkreis Karlsruhe,10 - 15 Jahre,22216,11500,10716
False,8215,Landkreis Karlsruhe,15 - 18 Jahre,12684,6524,6160
False,8215,Landkreis Karlsruhe,18 - 20 Jahre,8280,4210,4070
False,8215,Landkreis Karlsruhe,20 - 25 Jahre,23193,11857,11336
False,8215,Landkreis Karlsruhe,25 - 30 Jahre,32478,16643,15835
False,8215,Landkreis Karlsruhe,30 - 35 Jahre,36768,19091,17677
False,8215,Landkreis Karlsruhe,35 - 40 Jahre,33335,17115,16220
False,8215,Landkreis Karlsruhe,40 - 45 Jahre,29833,15090,14743
False,8215,Landkreis Karlsruhe,45 - 50 Jahre,27145,13823,13322
False,8215,Landkreis Karlsruhe,50 - 55 Jahre,24587,12587,12000
False,8215,Landkreis Karlsruhe,55 - 60 Jahre,29567,14995,14572
False,8215,Landkreis Karlsruhe,60 - 65 Jahre,21946,10902,11044
False,8215,Landkreis Karlsruhe,65 - 75 Jahre,35350,14980,20370
False,8215,Landkreis Karlsruhe,75 und mehr Jahre,21662,6448,15214
False,8215,Landkreis Karlsruhe,Insgesamt,405795,199947,205848
False,8215007,"Bretten, Stadt",unter 3 Jahre,899,484,415
False,8215007,"Bretten, Stadt",3 -  6 Jahre,874,483,391
False,8215007,"Bretten, Stadt",6 - 10 Jahre,1188,585,603
False,8215007,"Bretten, Stadt",10 - 15 Jahre,1453,764,689
False,8215007,"Bretten, Stadt",15 - 18 Jahre,943,447,496
False,8215007,"Bretten, Stadt",18 - 20 Jahre,597,296,301
False,8215007,"Bretten, Stadt",20 - 25 Jahre,1605,786,819
False,8215007,"Bretten, Stadt",25 - 30 Jahre,1999,1046,953
False,8215007,"Bretten, Stadt",30 - 35 Jahre,2133,1129,1004
False,8215007,"Bretten, Stadt",35 - 40 Jahre,1955,993,962
False,8215007,"Bretten, Stadt",40 - 45 Jahre,1961,989,972
False,8215007,"Bretten, Stadt",45 - 50 Jahre,1699,863,836
False,8215007,"Bretten, Stadt",50 - 55 Jahre,1575,827,748
False,8215007,"Bretten, Stadt",55 - 60 Jahre,1845,919,926
False,8215007,"Bretten, Stadt",60 - 65 Jahre,1373,697,676
False,8215007,"Bretten, Stadt",65 - 75 Jahre,2339,1000,1339
False,8215007,"Bretten, Stadt",75 und mehr Jahre,1603,453,1150
False,8215007,"Bretten, Stadt",Insgesamt,26041,12761,13280
False,8215009,"Bruchsal, Stadt",unter 3 Jahre,1256,643,613
False,8215009,"Bruchsal, Stadt",3 -  6 Jahre,1307,670,637
False,8215009,"Bruchsal, Stadt",6 - 10 Jahre,1706,893,813
False,8215009,"Bruchsal, Stadt",10 - 15 Jahre,1936,993,943
False,8215009,"Bruchsal, Stadt",15 - 18 Jahre,1211,609,602
False,8215009,"Bruchsal, Stadt",18 - 20 Jahre,882,430,452
False,8215009,"Bruchsal, Stadt",20 - 25 Jahre,2528,1266,1262
False,8215009,"Bruchsal, Stadt",25 - 30 Jahre,3428,1773,1655
False,8215009,"Bruchsal, Stadt",30 - 35 Jahre,3642,1948,1694
False,8215009,"Bruchsal, Stadt",35 - 40 Jahre,3223,1741,1482
False,8215009,"Bruchsal, Stadt",40 - 45 Jahre,2924,1524,1400
False,8215009,"Bruchsal, Stadt",45 - 50 Jahre,2651,1376,1275
False,8215009,"Bruchsal, Stadt",50 - 55 Jahre,2387,1255,1132
False,8215009,"Bruchsal, Stadt",55 - 60 Jahre,2885,1409,1476
False,8215009,"Bruchsal, Stadt",60 - 65 Jahre,2223,1065,1158
False,8215009,"Bruchsal, Stadt",65 - 75 Jahre,3674,1483,2191
False,8215009,"Bruchsal, Stadt",75 und mehr Jahre,2550,722,1828
False,8215009,"Bruchsal, Stadt",Insgesamt,40413,19800,20613
False,8215017,"Ettlingen, Stadt",unter 3 Jahre,1167,626,541
False,8215017,"Ettlingen, Stadt",3 -  6 Jahre,1279,654,625
False,8215017,"Ettlingen, Stadt",6 - 10 Jahre,1524,779,745
False,8215017,"Ettlingen, Stadt",10 - 15 Jahre,1795,890,905
False,8215017,"Ettlingen, Stadt",15 - 18 Jahre,1111,614,497
False,8215017,"Ettlingen, Stadt",18 - 20 Jahre,747,398,349
False,8215017,"Ettlingen, Stadt",20 - 25 Jahre,1990,1003,987
False,8215017,"Ettlingen, Stadt",25 - 30 Jahre,2923,1489,1434
False,8215017,"Ettlingen, Stadt",30 - 35 Jahre,3261,1636,1625
False,8215017,"Ettlingen, Stadt",35 - 40 Jahre,2923,1495,1428
False,8215017,"Ettlingen, Stadt",40 - 45 Jahre,2699,1278,1421
False,8215017,"Ettlingen, Stadt",45 - 50 Jahre,2651,1301,1350
False,8215017,"Ettlingen, Stadt",50 - 55 Jahre,2797,1371,1426
False,8215017,"Ettlingen, Stadt",55 - 60 Jahre,3120,1566,1554
False,8215017,"Ettlingen, Stadt",60 - 65 Jahre,2336,1171,1165
False,8215017,"Ettlingen, Stadt",65 - 75 Jahre,3729,1593,2136
False,8215017,"Ettlingen, Stadt",75 und mehr Jahre,2494,762,1732
False,8215017,"Ettlingen, Stadt",Insgesamt,38546,18626,19920
False,8215021,Forst,unter 3 Jahre,231,116,115
False,8215021,Forst,3 -  6 Jahre,251,147,104
False,8215021,Forst,6 - 10 Jahre,280,151,129
False,8215021,Forst,10 - 15 Jahre,353,194,159
False,8215021,Forst,15 - 18 Jahre,216,107,109
False,8215021,Forst,18 - 20 Jahre,154,85,69
False,8215021,Forst,20 - 25 Jahre,436,214,222
False,8215021,Forst,25 - 30 Jahre,648,343,305
False,8215021,Forst,30 - 35 Jahre,728,390,338
False,8215021,Forst,35 - 40 Jahre,580,296,284
False,8215021,Forst,40 - 45 Jahre,518,262,256
False,8215021,Forst,45 - 50 Jahre,544,284,260
False,8215021,Forst,50 - 55 Jahre,432,212,220
False,8215021,Forst,55 - 60 Jahre,515,277,238
False,8215021,Forst,60 - 65 Jahre,347,166,181
False,8215021,Forst,65 - 75 Jahre,568,247,321
False,8215021,Forst,75 und mehr Jahre,337,101,236
False,8215021,Forst,Insgesamt,7138,3592,3546
False,8215025,Gondelsheim,unter 3 Jahre,113,48,65
False,8215025,Gondelsheim,3 -  6 Jahre,121,62,59
False,8215025,Gondelsheim,6 - 10 Jahre,167,86,81
False,8215025,Gondelsheim,10 - 15 Jahre,182,96,86
False,8215025,Gondelsheim,15 - 18 Jahre,109,54,55
False,8215025,Gondelsheim,18 - 20 Jahre,57,38,19
False,8215025,Gondelsheim,20 - 25 Jahre,149,75,74
False,8215025,Gondelsheim,25 - 30 Jahre,245,128,117
False,8215025,Gondelsheim,30 - 35 Jahre,274,135,139
False,8215025,Gondelsheim,35 - 40 Jahre,269,143,126
False,8215025,Gondelsheim,40 - 45 Jahre,228,112,116
False,8215025,Gondelsheim,45 - 50 Jahre,188,99,89
False,8215025,Gondelsheim,50 - 55 Jahre,166,79,87
False,8215025,Gondelsheim,55 - 60 Jahre,204,105,99
False,8215025,Gondelsheim,60 - 65 Jahre,124,67,57
False,8215025,Gondelsheim,65 - 75 Jahre,194,78,116
False,8215025,Gondelsheim,75 und mehr Jahre,150,48,102
False,8215025,Gondelsheim,Insgesamt,2940,1453,1487
False,8215029,Hambrücken,unter 3 Jahre,195,99,96
False,8215029,Hambrücken,3 -  6 Jahre,206,97,109
False,8215029,Hambrücken,6 - 10 Jahre,258,152,106
False,8215029,Hambrücken,10 - 15 Jahre,288,143,145
False,8215029,Hambrücken,15 - 18 Jahre,156,81,75
False,8215029,Hambrücken,18 - 20 Jahre,108,48,60
False,8215029,Hambrücken,20 - 25 Jahre,298,141,157
False,8215029,Hambrücken,25 - 30 Jahre,420,204,216
False,8215029,Hambrücken,30 - 35 Jahre,474,241,233
False,8215029,Hambrücken,35 - 40 Jahre,476,251,225
False,8215029,Hambrücken,40 - 45 Jahre,354,179,175
False,8215029,Hambrücken,45 - 50 Jahre,300,163,137
False,8215029,Hambrücken,50 - 55 Jahre,208,113,95
False,8215029,Hambrücken,55 - 60 Jahre,325,159,166
False,8215029,Hambrücken,60 - 65 Jahre,226,118,108
False,8215029,Hambrücken,65 - 75 Jahre,357,158,199
False,8215029,Hambrücken,75 und mehr Jahre,175,55,120
False,8215029,Hambrücken,Insgesamt,4824,2402,2422
False,8215039,Kronau,unter 3 Jahre,205,108,97
False,8215039,Kronau,3 -  6 Jahre,234,125,109
False,8215039,Kronau,6 - 10 Jahre,288,164,124
False,8215039,Kronau,10 - 15 Jahre,349,180,169
False,8215039,Kronau,15 - 18 Jahre,202,106,96
False,8215039,Kronau,18 - 20 Jahre,132,68,64
False,8215039,Kronau,20 - 25 Jahre,301,143,158
False,8215039,Kronau,25 - 30 Jahre,447,211,236
False,8215039,Kronau,30 - 35 Jahre,481,251,230
False,8215039,Kronau,35 - 40 Jahre,471,230,241
False,8215039,Kronau,40 - 45 Jahre,435,220,215
False,8215039,Kronau,45 - 50 Jahre,349,191,158
False,8215039,Kronau,50 - 55 Jahre,228,118,110
False,8215039,Kronau,55 - 60 Jahre,354,176,178
False,8215039,Kronau,60 - 65 Jahre,263,134,129
False,8215039,Kronau,65 - 75 Jahre,393,155,238
False,8215039,Kronau,75 und mehr Jahre,178,41,137
False,8215039,Kronau,Insgesamt,5310,2621,2689
False,8215040,Kürnbach,unter 3 Jahre,78,48,30
False,8215040,Kürnbach,3 -  6 Jahre,84,45,39
False,8215040,Kürnbach,6 - 10 Jahre,115,62,53
False,8215040,Kürnbach,10 - 15 Jahre,174,104,70
False,8215040,Kürnbach,15 - 18 Jahre,71,40,31
False,8215040,Kürnbach,18 - 20 Jahre,58,26,32
False,8215040,Kürnbach,20 - 25 Jahre,125,64,61
False,8215040,Kürnbach,25 - 30 Jahre,189,110,79
False,8215040,Kürnbach,30 - 35 Jahre,199,95,104
False,8215040,Kürnbach,35 - 40 Jahre,188,102,86
False,8215040,Kürnbach,40 - 45 Jahre,174,83,91
False,8215040,Kürnbach,45 - 50 Jahre,145,78,67
False,8215040,Kürnbach,50 - 55 Jahre,133,69,64
False,8215040,Kürnbach,55 - 60 Jahre,171,87,84
False,8215040,Kürnbach,60 - 65 Jahre,152,69,83
False,8215040,Kürnbach,65 - 75 Jahre,241,110,131
False,8215040,Kürnbach,75 und mehr Jahre,173,44,129
False,8215040,Kürnbach,Insgesamt,2470,1236,1234
False,8215046,Malsch,unter 3 Jahre,438,232,206
False,8215046,Malsch,3 -  6 Jahre,461,250,211
False,8215046,Malsch,6 - 10 Jahre,622,300,322
False,8215046,Malsch,10 - 15 Jahre,718,378,340
False,8215046,Malsch,15 - 18 Jahre,386,205,181
False,8215046,Malsch,18 - 20 Jahre,243,120,123
False,8215046,Malsch,20 - 25 Jahre,676,341,335
False,8215046,Malsch,25 - 30 Jahre,1004,502,502
False,8215046,Malsch,30 - 35 Jahre,1226,616,610
False,8215046,Malsch,35 - 40 Jahre,1122,582,540
False,8215046,Malsch,40 - 45 Jahre,964,479,485
False,8215046,Malsch,45 - 50 Jahre,916,466,450
False,8215046,Malsch,50 - 55 Jahre,757,377,380
False,8215046,Malsch,55 - 60 Jahre,956,492,464
False,8215046,Malsch,60 - 65 Jahre,706,337,369
False,8215046,Malsch,65 - 75 Jahre,1245,532,713
False,8215046,Malsch,75 und mehr Jahre,741,238,503
False,8215046,Malsch,Insgesamt,13181,6447,6734
False,8215047,Marxzell,unter 3 Jahre,196,112,84
False,8215047,Marxzell,3 -  6 Jahre,211,104,107
False,8215047,Marxzell,6 - 10 Jahre,270,145,125
False,8215047,Marxzell,10 - 15 Jahre,256,122,134
False,8215047,Marxzell,15 - 18 Jahre,145,72,73
False,8215047,Marxzell,18 - 20 Jahre,99,54,45
False,8215047,Marxzell,20 - 25 Jahre,240,137,103
False,8215047,Marxzell,25 - 30 Jahre,349,177,172
False,8215047,Marxzell,30 - 35 Jahre,489,236,253
False,8215047,Marxzell,35 - 40 Jahre,460,230,230
False,8215047,Marxzell,40 - 45 Jahre,376,197,179
False,8215047,Marxzell,45 - 50 Jahre,308,157,151
False,8215047,Marxzell,50 - 55 Jahre,288,167,121
False,8215047,Marxzell,55 - 60 Jahre,405,193,212
False,8215047,Marxzell,60 - 65 Jahre,295,155,140
False,8215047,Marxzell,65 - 75 Jahre,492,210,282
False,8215047,Marxzell,75 und mehr Jahre,448,129,319
False,8215047,Marxzell,Insgesamt,5327,2597,2730
False,8215059,Oberderdingen,unter 3 Jahre,371,206,165
False,8215059,Oberderdingen,3 -  6 Jahre,405,219,186
False,8215059,Oberderdingen,6 - 10 Jahre,518,268,250
False,8215059,Oberderdingen,10 - 15 Jahre,609,298,311
False,8215059,Oberderdingen,15 - 18 Jahre,353,179,174
False,8215059,Oberderdingen,18 - 20 Jahre,218,116,102
False,8215059,Oberderdingen,20 - 25 Jahre,684,390,294
False,8215059,Oberderdingen,25 - 30 Jahre,884,456,428
False,8215059,Oberderdingen,30 - 35 Jahre,875,477,398
False,8215059,Oberderdingen,35 - 40 Jahre,759,399,360
False,8215059,Oberderdingen,40 - 45 Jahre,673,347,326
False,8215059,Oberderdingen,45 - 50 Jahre,552,271,281
False,8215059,Oberderdingen,50 - 55 Jahre,509,265,244
False,8215059,Oberderdingen,55 - 60 Jahre,596,311,285
False,8215059,Oberderdingen,60 - 65 Jahre,501,222,279
False,8215059,Oberderdingen,65 - 75 Jahre,792,350,442
False,8215059,Oberderdingen,75 und mehr Jahre,416,123,293
False,8215059,Oberderdingen,Insgesamt,9715,4897,4818
False,8215064,"Östringen, Stadt",unter 3 Jahre,432,223,209
False,8215064,"Östringen, Stadt",3 -  6 Jahre,488,266,222
False,8215064,"Östringen, Stadt",6 - 10 Jahre,615,323,292
False,8215064,"Östringen, Stadt",10 - 15 Jahre,740,379,361
False,8215064,"Östringen, Stadt",15 - 18 Jahre,417,224,193
False,8215064,"Östringen, Stadt",18 - 20 Jahre,246,134,112
False,8215064,"Östringen, Stadt",20 - 25 Jahre,777,413,364
False,8215064,"Östringen, Stadt",25 - 30 Jahre,990,520,470
False,8215064,"Östringen, Stadt",30 - 35 Jahre,1138,596,542
False,8215064,"Östringen, Stadt",35 - 40 Jahre,995,504,491
False,8215064,"Östringen, Stadt",40 - 45 Jahre,871,454,417
False,8215064,"Östringen, Stadt",45 - 50 Jahre,842,441,401
False,8215064,"Östringen, Stadt",50 - 55 Jahre,622,324,298
False,8215064,"Östringen, Stadt",55 - 60 Jahre,831,447,384
False,8215064,"Östringen, Stadt",60 - 65 Jahre,683,340,343
False,8215064,"Östringen, Stadt",65 - 75 Jahre,1068,443,625
False,8215064,"Östringen, Stadt",75 und mehr Jahre,619,189,430
False,8215064,"Östringen, Stadt",Insgesamt,12374,6220,6154
False,8215066,"Philippsburg, Stadt",unter 3 Jahre,415,230,185
False,8215066,"Philippsburg, Stadt",3 -  6 Jahre,496,263,233
False,8215066,"Philippsburg, Stadt",6 - 10 Jahre,588,304,284
False,8215066,"Philippsburg, Stadt",10 - 15 Jahre,808,431,377
False,8215066,"Philippsburg, Stadt",15 - 18 Jahre,495,250,245
False,8215066,"Philippsburg, Stadt",18 - 20 Jahre,321,168,153
False,8215066,"Philippsburg, Stadt",20 - 25 Jahre,812,417,395
False,8215066,"Philippsburg, Stadt",25 - 30 Jahre,954,493,461
False,8215066,"Philippsburg, Stadt",30 - 35 Jahre,1048,553,495
False,8215066,"Philippsburg, Stadt",35 - 40 Jahre,968,485,483
False,8215066,"Philippsburg, Stadt",40 - 45 Jahre,936,450,486
False,8215066,"Philippsburg, Stadt",45 - 50 Jahre,824,448,376
False,8215066,"Philippsburg, Stadt",50 - 55 Jahre,732,368,364
False,8215066,"Philippsburg, Stadt",55 - 60 Jahre,809,449,360
False,8215066,"Philippsburg, Stadt",60 - 65 Jahre,636,312,324
False,8215066,"Philippsburg, Stadt",65 - 75 Jahre,996,405,591
False,8215066,"Philippsburg, Stadt",75 und mehr Jahre,527,133,394
False,8215066,"Philippsburg, Stadt",Insgesamt,12365,6159,6206
False,8215082,Sulzfeld,unter 3 Jahre,162,85,77
False,8215082,Sulzfeld,3 -  6 Jahre,160,72,88
False,8215082,Sulzfeld,6 - 10 Jahre,207,104,103
False,8215082,Sulzfeld,10 - 15 Jahre,247,136,111
False,8215082,Sulzfeld,15 - 18 Jahre,114,71,43
False,8215082,Sulzfeld,18 - 20 Jahre,90,45,45
False,8215082,Sulzfeld,20 - 25 Jahre,205,123,82
False,8215082,Sulzfeld,25 - 30 Jahre,341,176,165
False,8215082,Sulzfeld,30 - 35 Jahre,419,217,202
False,8215082,Sulzfeld,35 - 40 Jahre,324,188,136
False,8215082,Sulzfeld,40 - 45 Jahre,268,141,127
False,8215082,Sulzfeld,45 - 50 Jahre,249,120,129
False,8215082,Sulzfeld,50 - 55 Jahre,265,132,133
False,8215082,Sulzfeld,55 - 60 Jahre,328,164,164
False,8215082,Sulzfeld,60 - 65 Jahre,276,141,135
False,8215082,Sulzfeld,65 - 75 Jahre,387,172,215
False,8215082,Sulzfeld,75 und mehr Jahre,205,55,150
False,8215082,Sulzfeld,Insgesamt,4247,2142,2105
False,8215084,Ubstadt-Weiher,unter 3 Jahre,432,229,203
False,8215084,Ubstadt-Weiher,3 -  6 Jahre,460,245,215
False,8215084,Ubstadt-Weiher,6 - 10 Jahre,647,334,313
False,8215084,Ubstadt-Weiher,10 - 15 Jahre,660,320,340
False,8215084,Ubstadt-Weiher,15 - 18 Jahre,357,192,165
False,8215084,Ubstadt-Weiher,18 - 20 Jahre,244,131,113
False,8215084,Ubstadt-Weiher,20 - 25 Jahre,681,370,311
False,8215084,Ubstadt-Weiher,25 - 30 Jahre,998,526,472
False,8215084,Ubstadt-Weiher,30 - 35 Jahre,1189,618,571
False,8215084,Ubstadt-Weiher,35 - 40 Jahre,1055,553,502
False,8215084,Ubstadt-Weiher,40 - 45 Jahre,868,439,429
False,8215084,Ubstadt-Weiher,45 - 50 Jahre,676,358,318
False,8215084,Ubstadt-Weiher,50 - 55 Jahre,656,335,321
False,8215084,Ubstadt-Weiher,55 - 60 Jahre,768,380,388
False,8215084,Ubstadt-Weiher,60 - 65 Jahre,648,325,323
False,8215084,Ubstadt-Weiher,65 - 75 Jahre,1020,431,589
False,8215084,Ubstadt-Weiher,75 und mehr Jahre,527,159,368
False,8215084,Ubstadt-Weiher,Insgesamt,11886,5945,5941
False,8215089,Walzbachtal,unter 3 Jahre,333,172,161
False,8215089,Walzbachtal,3 -  6 Jahre,335,169,166
False,8215089,Walzbachtal,6 - 10 Jahre,399,209,190
False,8215089,Walzbachtal,10 - 15 Jahre,428,236,192
False,8215089,Walzbachtal,15 - 18 Jahre,243,139,104
False,8215089,Walzbachtal,18 - 20 Jahre,151,72,79
False,8215089,Walzbachtal,20 - 25 Jahre,406,206,200
False,8215089,Walzbachtal,25 - 30 Jahre,670,318,352
False,8215089,Walzbachtal,30 - 35 Jahre,731,365,366
False,8215089,Walzbachtal,35 - 40 Jahre,709,350,359
False,8215089,Walzbachtal,40 - 45 Jahre,623,322,301
False,8215089,Walzbachtal,45 - 50 Jahre,535,263,272
False,8215089,Walzbachtal,50 - 55 Jahre,494,255,239
False,8215089,Walzbachtal,55 - 60 Jahre,606,312,294
False,8215089,Walzbachtal,60 - 65 Jahre,464,231,233
False,8215089,Walzbachtal,65 - 75 Jahre,768,329,439
False,8215089,Walzbachtal,75 und mehr Jahre,420,129,291
False,8215089,Walzbachtal,Insgesamt,8315,4077,4238
False,8215090,Weingarten (Baden),unter 3 Jahre,268,139,129
False,8215090,Weingarten (Baden),3 -  6 Jahre,291,146,145
False,8215090,Weingarten (Baden),6 - 10 Jahre,355,195,160
False,8215090,Weingarten (Baden),10 - 15 Jahre,442,233,209
False,8215090,Weingarten (Baden),15 - 18 Jahre,247,113,134
False,8215090,Weingarten (Baden),18 - 20 Jahre,135,68,67
False,8215090,Weingarten (Baden),20 - 25 Jahre,470,230,240
False,8215090,Weingarten (Baden),25 - 30 Jahre,667,348,319
False,8215090,Weingarten (Baden),30 - 35 Jahre,836,424,412
False,8215090,Weingarten (Baden),35 - 40 Jahre,641,305,336
False,8215090,Weingarten (Baden),40 - 45 Jahre,634,326,308
False,8215090,Weingarten (Baden),45 - 50 Jahre,552,273,279
False,8215090,Weingarten (Baden),50 - 55 Jahre,567,285,282
False,8215090,Weingarten (Baden),55 - 60 Jahre,655,331,324
False,8215090,Weingarten (Baden),60 - 65 Jahre,511,248,263
False,8215090,Weingarten (Baden),65 - 75 Jahre,858,345,513
False,8215090,Weingarten (Baden),75 und mehr Jahre,616,226,390
False,8215090,Weingarten (Baden),Insgesamt,8745,4235,4510
False,8215094,Zaisenhausen,unter 3 Jahre,50,30,20
False,8215094,Zaisenhausen,3 -  6 Jahre,63,35,28
False,8215094,Zaisenhausen,6 - 10 Jahre,84,46,38
False,8215094,Zaisenhausen,10 - 15 Jahre,97,54,43
False,8215094,Zaisenhausen,15 - 18 Jahre,47,22,25
False,8215094,Zaisenhausen,18 - 20 Jahre,18,13,5
False,8215094,Zaisenhausen,20 - 25 Jahre,71,41,30
False,8215094,Zaisenhausen,25 - 30 Jahre,123,73,50
False,8215094,Zaisenhausen,30 - 35 Jahre,138,64,74
False,8215094,Zaisenhausen,35 - 40 Jahre,132,65,67
False,8215094,Zaisenhausen,40 - 45 Jahre,85,43,42
False,8215094,Zaisenhausen,45 - 50 Jahre,91,49,42
False,8215094,Zaisenhausen,50 - 55 Jahre,95,51,44
False,8215094,Zaisenhausen,55 - 60 Jahre,128,60,68
False,8215094,Zaisenhausen,60 - 65 Jahre,95,47,48
False,8215094,Zaisenhausen,65 - 75 Jahre,122,52,70
False,8215094,Zaisenhausen,75 und mehr Jahre,75,19,56
False,8215094,Zaisenhausen,Insgesamt,1514,764,750
False,8215096,Karlsbad,unter 3 Jahre,552,279,273
False,8215096,Karlsbad,3 -  6 Jahre,601,292,309
False,8215096,Karlsbad,6 - 10 Jahre,776,419,357
False,8215096,Karlsbad,10 - 15 Jahre,979,491,488
False,8215096,Karlsbad,15 - 18 Jahre,544,272,272
False,8215096,Karlsbad,18 - 20 Jahre,327,170,157
False,8215096,Karlsbad,20 - 25 Jahre,923,431,492
False,8215096,Karlsbad,25 - 30 Jahre,1237,616,621
False,8215096,Karlsbad,30 - 35 Jahre,1435,717,718
False,8215096,Karlsbad,35 - 40 Jahre,1376,683,693
False,8215096,Karlsbad,40 - 45 Jahre,1220,597,623
False,8215096,Karlsbad,45 - 50 Jahre,1100,600,500
False,8215096,Karlsbad,50 - 55 Jahre,927,457,470
False,8215096,Karlsbad,55 - 60 Jahre,1098,563,535
False,8215096,Karlsbad,60 - 65 Jahre,794,388,406
False,8215096,Karlsbad,65 - 75 Jahre,1224,493,731
False,8215096,Karlsbad,75 und mehr Jahre,807,260,547
False,8215096,Karlsbad,Insgesamt,15920,7728,8192
False,8215097,"Kraichtal, Stadt",unter 3 Jahre,543,289,254
False,8215097,"Kraichtal, Stadt",3 -  6 Jahre,551,275,276
False,8215097,"Kraichtal, Stadt",6 - 10 Jahre,756,356,400
False,8215097,"Kraichtal, Stadt",10 - 15 Jahre,871,462,409
False,8215097,"Kraichtal, Stadt",15 - 18 Jahre,479,262,217
False,8215097,"Kraichtal, Stadt",18 - 20 Jahre,330,174,156
False,8215097,"Kraichtal, Stadt",20 - 25 Jahre,886,478,408
False,8215097,"Kraichtal, Stadt",25 - 30 Jahre,1148,596,552
False,8215097,"Kraichtal, Stadt",30 - 35 Jahre,1328,715,613
False,8215097,"Kraichtal, Stadt",35 - 40 Jahre,1181,617,564
False,8215097,"Kraichtal, Stadt",40 - 45 Jahre,950,504,446
False,8215097,"Kraichtal, Stadt",45 - 50 Jahre,877,424,453
False,8215097,"Kraichtal, Stadt",50 - 55 Jahre,745,398,347
False,8215097,"Kraichtal, Stadt",55 - 60 Jahre,965,495,470
False,8215097,"Kraichtal, Stadt",60 - 65 Jahre,722,364,358
False,8215097,"Kraichtal, Stadt",65 - 75 Jahre,1165,479,686
False,8215097,"Kraichtal, Stadt",75 und mehr Jahre,794,238,556
False,8215097,"Kraichtal, Stadt",Insgesamt,14291,7126,7165
False,8215099,Graben-Neudorf,unter 3 Jahre,372,186,186
False,8215099,Graben-Neudorf,3 -  6 Jahre,458,251,207
False,8215099,Graben-Neudorf,6 - 10 Jahre,562,282,280
False,8215099,Graben-Neudorf,10 - 15 Jahre,656,363,293
False,8215099,Graben-Neudorf,15 - 18 Jahre,395,211,184
False,8215099,Graben-Neudorf,18 - 20 Jahre,229,122,107
False,8215099,Graben-Neudorf,20 - 25 Jahre,611,319,292
False,8215099,Graben-Neudorf,25 - 30 Jahre,857,432,425
False,8215099,Graben-Neudorf,30 - 35 Jahre,1019,544,475
False,8215099,Graben-Neudorf,35 - 40 Jahre,1025,506,519
False,8215099,Graben-Neudorf,40 - 45 Jahre,845,441,404
False,8215099,Graben-Neudorf,45 - 50 Jahre,705,386,319
False,8215099,Graben-Neudorf,50 - 55 Jahre,577,303,274
False,8215099,Graben-Neudorf,55 - 60 Jahre,747,372,375
False,8215099,Graben-Neudorf,60 - 65 Jahre,543,262,281
False,8215099,Graben-Neudorf,65 - 75 Jahre,894,367,527
False,8215099,Graben-Neudorf,75 und mehr Jahre,448,123,325
False,8215099,Graben-Neudorf,Insgesamt,10943,5470,5473
False,8215100,Bad Schönborn,unter 3 Jahre,379,208,171
False,8215100,Bad Schönborn,3 -  6 Jahre,367,173,194
False,8215100,Bad Schönborn,6 - 10 Jahre,494,250,244
False,8215100,Bad Schönborn,10 - 15 Jahre,598,294,304
False,8215100,Bad Schönborn,15 - 18 Jahre,278,135,143
False,8215100,Bad Schönborn,18 - 20 Jahre,194,93,101
False,8215100,Bad Schönborn,20 - 25 Jahre,565,285,280
False,8215100,Bad Schönborn,25 - 30 Jahre,833,453,380
False,8215100,Bad Schönborn,30 - 35 Jahre,972,510,462
False,8215100,Bad Schönborn,35 - 40 Jahre,855,462,393
False,8215100,Bad Schönborn,40 - 45 Jahre,757,404,353
False,8215100,Bad Schönborn,45 - 50 Jahre,654,340,314
False,8215100,Bad Schönborn,50 - 55 Jahre,582,309,273
False,8215100,Bad Schönborn,55 - 60 Jahre,643,334,309
False,8215100,Bad Schönborn,60 - 65 Jahre,528,264,264
False,8215100,Bad Schönborn,65 - 75 Jahre,884,372,512
False,8215100,Bad Schönborn,75 und mehr Jahre,734,193,541
False,8215100,Bad Schönborn,Insgesamt,10317,5079,5238
False,8215101,Pfinztal,unter 3 Jahre,563,282,281
False,8215101,Pfinztal,3 -  6 Jahre,601,285,316
False,8215101,Pfinztal,6 - 10 Jahre,799,421,378
False,8215101,Pfinztal,10 - 15 Jahre,883,469,414
False,8215101,Pfinztal,15 - 18 Jahre,498,274,224
False,8215101,Pfinztal,18 - 20 Jahre,305,147,158
False,8215101,Pfinztal,20 - 25 Jahre,861,449,412
False,8215101,Pfinztal,25 - 30 Jahre,1406,721,685
False,8215101,Pfinztal,30 - 35 Jahre,1545,806,739
False,8215101,Pfinztal,35 - 40 Jahre,1391,704,687
False,8215101,Pfinztal,40 - 45 Jahre,1283,679,604
False,8215101,Pfinztal,45 - 50 Jahre,1160,572,588
False,8215101,Pfinztal,50 - 55 Jahre,1020,492,528
False,8215101,Pfinztal,55 - 60 Jahre,1276,644,632
False,8215101,Pfinztal,60 - 65 Jahre,930,460,470
False,8215101,Pfinztal,65 - 75 Jahre,1645,700,945
False,8215101,Pfinztal,75 und mehr Jahre,1028,325,703
False,8215101,Pfinztal,Insgesamt,17194,8430,8764
False,8215102,Eggenstein-Leopoldshafen,unter 3 Jahre,428,222,206
False,8215102,Eggenstein-Leopoldshafen,3 -  6 Jahre,464,243,221
False,8215102,Eggenstein-Leopoldshafen,6 - 10 Jahre,550,257,293
False,8215102,Eggenstein-Leopoldshafen,10 - 15 Jahre,697,345,352
False,8215102,Eggenstein-Leopoldshafen,15 - 18 Jahre,388,182,206
False,8215102,Eggenstein-Leopoldshafen,18 - 20 Jahre,265,128,137
False,8215102,Eggenstein-Leopoldshafen,20 - 25 Jahre,756,353,403
False,8215102,Eggenstein-Leopoldshafen,25 - 30 Jahre,1260,655,605
False,8215102,Eggenstein-Leopoldshafen,30 - 35 Jahre,1287,692,595
False,8215102,Eggenstein-Leopoldshafen,35 - 40 Jahre,1163,581,582
False,8215102,Eggenstein-Leopoldshafen,40 - 45 Jahre,1062,538,524
False,8215102,Eggenstein-Leopoldshafen,45 - 50 Jahre,1019,475,544
False,8215102,Eggenstein-Leopoldshafen,50 - 55 Jahre,1016,504,512
False,8215102,Eggenstein-Leopoldshafen,55 - 60 Jahre,1165,570,595
False,8215102,Eggenstein-Leopoldshafen,60 - 65 Jahre,773,413,360
False,8215102,Eggenstein-Leopoldshafen,65 - 75 Jahre,1095,504,591
False,8215102,Eggenstein-Leopoldshafen,75 und mehr Jahre,514,165,349
False,8215102,Eggenstein-Leopoldshafen,Insgesamt,13902,6827,7075
False,8215103,Karlsdorf-Neuthard,unter 3 Jahre,317,172,145
False,8215103,Karlsdorf-Neuthard,3 -  6 Jahre,304,152,152
False,8215103,Karlsdorf-Neuthard,6 - 10 Jahre,409,215,194
False,8215103,Karlsdorf-Neuthard,10 - 15 Jahre,519,265,254
False,8215103,Karlsdorf-Neuthard,15 - 18 Jahre,266,144,122
False,8215103,Karlsdorf-Neuthard,18 - 20 Jahre,183,92,91
False,8215103,Karlsdorf-Neuthard,20 - 25 Jahre,532,277,255
False,8215103,Karlsdorf-Neuthard,25 - 30 Jahre,784,399,385
False,8215103,Karlsdorf-Neuthard,30 - 35 Jahre,823,426,397
False,8215103,Karlsdorf-Neuthard,35 - 40 Jahre,774,404,370
False,8215103,Karlsdorf-Neuthard,40 - 45 Jahre,641,333,308
False,8215103,Karlsdorf-Neuthard,45 - 50 Jahre,626,314,312
False,8215103,Karlsdorf-Neuthard,50 - 55 Jahre,534,294,240
False,8215103,Karlsdorf-Neuthard,55 - 60 Jahre,688,349,339
False,8215103,Karlsdorf-Neuthard,60 - 65 Jahre,457,221,236
False,8215103,Karlsdorf-Neuthard,65 - 75 Jahre,647,282,365
False,8215103,Karlsdorf-Neuthard,75 und mehr Jahre,352,85,267
False,8215103,Karlsdorf-Neuthard,Insgesamt,8856,4424,4432
False,8215105,Linkenheim-Hochstetten,unter 3 Jahre,373,190,183
False,8215105,Linkenheim-Hochstetten,3 -  6 Jahre,392,194,198
False,8215105,Linkenheim-Hochstetten,6 - 10 Jahre,529,270,259
False,8215105,Linkenheim-Hochstetten,10 - 15 Jahre,625,313,312
False,8215105,Linkenheim-Hochstetten,15 - 18 Jahre,365,181,184
False,8215105,Linkenheim-Hochstetten,18 - 20 Jahre,178,89,89
False,8215105,Linkenheim-Hochstetten,20 - 25 Jahre,585,296,289
False,8215105,Linkenheim-Hochstetten,25 - 30 Jahre,860,441,419
False,8215105,Linkenheim-Hochstetten,30 - 35 Jahre,975,494,481
False,8215105,Linkenheim-Hochstetten,35 - 40 Jahre,962,483,479
False,8215105,Linkenheim-Hochstetten,40 - 45 Jahre,827,430,397
False,8215105,Linkenheim-Hochstetten,45 - 50 Jahre,757,380,377
False,8215105,Linkenheim-Hochstetten,50 - 55 Jahre,650,351,299
False,8215105,Linkenheim-Hochstetten,55 - 60 Jahre,753,377,376
False,8215105,Linkenheim-Hochstetten,60 - 65 Jahre,597,314,283
False,8215105,Linkenheim-Hochstetten,65 - 75 Jahre,831,363,468
False,8215105,Linkenheim-Hochstetten,75 und mehr Jahre,532,171,361
False,8215105,Linkenheim-Hochstetten,Insgesamt,10791,5337,5454
False,8215106,"Waghäusel, Stadt",unter 3 Jahre,644,339,305
False,8215106,"Waghäusel, Stadt",3 -  6 Jahre,621,300,321
False,8215106,"Waghäusel, Stadt",6 - 10 Jahre,903,476,427
False,8215106,"Waghäusel, Stadt",10 - 15 Jahre,1085,553,532
False,8215106,"Waghäusel, Stadt",15 - 18 Jahre,612,321,291
False,8215106,"Waghäusel, Stadt",18 - 20 Jahre,377,185,192
False,8215106,"Waghäusel, Stadt",20 - 25 Jahre,1278,690,588
False,8215106,"Waghäusel, Stadt",25 - 30 Jahre,1613,821,792
False,8215106,"Waghäusel, Stadt",30 - 35 Jahre,1719,900,819
False,8215106,"Waghäusel, Stadt",35 - 40 Jahre,1539,782,757
False,8215106,"Waghäusel, Stadt",40 - 45 Jahre,1451,744,707
False,8215106,"Waghäusel, Stadt",45 - 50 Jahre,1252,631,621
False,8215106,"Waghäusel, Stadt",50 - 55 Jahre,1108,553,555
False,8215106,"Waghäusel, Stadt",55 - 60 Jahre,1444,758,686
False,8215106,"Waghäusel, Stadt",60 - 65 Jahre,974,485,489
False,8215106,"Waghäusel, Stadt",65 - 75 Jahre,1719,705,1014
False,8215106,"Waghäusel, Stadt",75 und mehr Jahre,937,270,667
False,8215106,"Waghäusel, Stadt",Insgesamt,19276,9513,9763
False,8215107,Oberhausen-Rheinhausen,unter 3 Jahre,262,116,146
False,8215107,Oberhausen-Rheinhausen,3 -  6 Jahre,324,166,158
False,8215107,Oberhausen-Rheinhausen,6 - 10 Jahre,433,230,203
False,8215107,Oberhausen-Rheinhausen,10 - 15 Jahre,507,278,229
False,8215107,Oberhausen-Rheinhausen,15 - 18 Jahre,268,141,127
False,8215107,Oberhausen-Rheinhausen,18 - 20 Jahre,198,90,108
False,8215107,Oberhausen-Rheinhausen,20 - 25 Jahre,490,252,238
False,8215107,Oberhausen-Rheinhausen,25 - 30 Jahre,666,355,311
False,8215107,Oberhausen-Rheinhausen,30 - 35 Jahre,813,419,394
False,8215107,Oberhausen-Rheinhausen,35 - 40 Jahre,844,447,397
False,8215107,Oberhausen-Rheinhausen,40 - 45 Jahre,671,330,341
False,8215107,Oberhausen-Rheinhausen,45 - 50 Jahre,627,322,305
False,8215107,Oberhausen-Rheinhausen,50 - 55 Jahre,512,294,218
False,8215107,Oberhausen-Rheinhausen,55 - 60 Jahre,677,337,340
False,8215107,Oberhausen-Rheinhausen,60 - 65 Jahre,579,286,293
False,8215107,Oberhausen-Rheinhausen,65 - 75 Jahre,843,369,474
False,8215107,Oberhausen-Rheinhausen,75 und mehr Jahre,418,125,293
False,8215107,Oberhausen-Rheinhausen,Insgesamt,9132,4557,4575
False,8215108,"Rheinstetten, Stadt",unter 3 Jahre,663,338,325
False,8215108,"Rheinstetten, Stadt",3 -  6 Jahre,687,372,315
False,8215108,"Rheinstetten, Stadt",6 - 10 Jahre,879,432,447
False,8215108,"Rheinstetten, Stadt",10 - 15 Jahre,1050,560,490
False,8215108,"Rheinstetten, Stadt",15 - 18 Jahre,561,267,294
False,8215108,"Rheinstetten, Stadt",18 - 20 Jahre,370,198,172
False,8215108,"Rheinstetten, Stadt",20 - 25 Jahre,1036,509,527
False,8215108,"Rheinstetten, Stadt",25 - 30 Jahre,1584,798,786
False,8215108,"Rheinstetten, Stadt",30 - 35 Jahre,1882,975,907
False,8215108,"Rheinstetten, Stadt",35 - 40 Jahre,1613,821,792
False,8215108,"Rheinstetten, Stadt",40 - 45 Jahre,1460,737,723
False,8215108,"Rheinstetten, Stadt",45 - 50 Jahre,1420,686,734
False,8215108,"Rheinstetten, Stadt",50 - 55 Jahre,1413,697,716
False,8215108,"Rheinstetten, Stadt",55 - 60 Jahre,1612,807,805
False,8215108,"Rheinstetten, Stadt",60 - 65 Jahre,1107,551,556
False,8215108,"Rheinstetten, Stadt",65 - 75 Jahre,1764,770,994
False,8215108,"Rheinstetten, Stadt",75 und mehr Jahre,945,283,662
False,8215108,"Rheinstetten, Stadt",Insgesamt,20046,9801,10245
False,8215109,"Stutensee, Stadt",unter 3 Jahre,638,323,315
False,8215109,"Stutensee, Stadt",3 -  6 Jahre,684,355,329
False,8215109,"Stutensee, Stadt",6 - 10 Jahre,907,473,434
False,8215109,"Stutensee, Stadt",10 - 15 Jahre,1165,629,536
False,8215109,"Stutensee, Stadt",15 - 18 Jahre,640,315,325
False,8215109,"Stutensee, Stadt",18 - 20 Jahre,457,217,240
False,8215109,"Stutensee, Stadt",20 - 25 Jahre,1133,610,523
False,8215109,"Stutensee, Stadt",25 - 30 Jahre,1565,785,780
False,8215109,"Stutensee, Stadt",30 - 35 Jahre,1988,1035,953
False,8215109,"Stutensee, Stadt",35 - 40 Jahre,1750,888,862
False,8215109,"Stutensee, Stadt",40 - 45 Jahre,1685,826,859
False,8215109,"Stutensee, Stadt",45 - 50 Jahre,1573,813,760
False,8215109,"Stutensee, Stadt",50 - 55 Jahre,1378,723,655
False,8215109,"Stutensee, Stadt",55 - 60 Jahre,1505,774,731
False,8215109,"Stutensee, Stadt",60 - 65 Jahre,990,499,491
False,8215109,"Stutensee, Stadt",65 - 75 Jahre,1648,712,936
False,8215109,"Stutensee, Stadt",75 und mehr Jahre,883,267,616
False,8215109,"Stutensee, Stadt",Insgesamt,20589,10244,10345
False,8215110,Waldbronn,unter 3 Jahre,385,187,198
False,8215110,Waldbronn,3 -  6 Jahre,408,205,203
False,8215110,Waldbronn,6 - 10 Jahre,511,283,228
False,8215110,Waldbronn,10 - 15 Jahre,671,330,341
False,8215110,Waldbronn,15 - 18 Jahre,360,193,167
False,8215110,Waldbronn,18 - 20 Jahre,251,133,118
False,8215110,Waldbronn,20 - 25 Jahre,704,340,364
False,8215110,Waldbronn,25 - 30 Jahre,951,477,474
False,8215110,Waldbronn,30 - 35 Jahre,1073,561,512
False,8215110,Waldbronn,35 - 40 Jahre,974,478,496
False,8215110,Waldbronn,40 - 45 Jahre,858,421,437
False,8215110,Waldbronn,45 - 50 Jahre,818,412,406
False,8215110,Waldbronn,50 - 55 Jahre,853,416,437
False,8215110,Waldbronn,55 - 60 Jahre,1049,547,502
False,8215110,Waldbronn,60 - 65 Jahre,777,383,394
False,8215110,Waldbronn,65 - 75 Jahre,1176,530,646
False,8215110,Waldbronn,75 und mehr Jahre,708,218,490
False,8215110,Waldbronn,Insgesamt,12527,6114,6413
False,8215111,Dettenheim,unter 3 Jahre,217,114,103
False,8215111,Dettenheim,3 -  6 Jahre,258,134,124
False,8215111,Dettenheim,6 - 10 Jahre,389,194,195
False,8215111,Dettenheim,10 - 15 Jahre,375,197,178
False,8215111,Dettenheim,15 - 18 Jahre,207,101,106
False,8215111,Dettenheim,18 - 20 Jahre,116,62,54
False,8215111,Dettenheim,20 - 25 Jahre,379,208,171
False,8215111,Dettenheim,25 - 30 Jahre,435,201,234
False,8215111,Dettenheim,30 - 35 Jahre,628,306,322
False,8215111,Dettenheim,35 - 40 Jahre,638,347,291
False,8215111,Dettenheim,40 - 45 Jahre,532,261,271
False,8215111,Dettenheim,45 - 50 Jahre,485,267,218
False,8215111,Dettenheim,50 - 55 Jahre,361,193,168
False,8215111,Dettenheim,55 - 60 Jahre,444,231,213
False,8215111,Dettenheim,60 - 65 Jahre,316,167,149
False,8215111,Dettenheim,65 - 75 Jahre,572,241,331
False,8215111,Dettenheim,75 und mehr Jahre,308,99,209
False,8215111,Dettenheim,Insgesamt,6660,3323,3337
False,8216,Landkreis Rastatt,unter 3 Jahre,7025,3603,3422
False,8216,Landkreis Rastatt,3 -  6 Jahre,7722,3949,3773
False,8216,Landkreis Rastatt,6 - 10 Jahre,10111,5187,4924
False,8216,Landkreis Rastatt,10 - 15 Jahre,11936,6102,5834
False,8216,Landkreis Rastatt,15 - 18 Jahre,6923,3551,3372
False,8216,Landkreis Rastatt,18 - 20 Jahre,4362,2283,2079
False,8216,Landkreis Rastatt,20 - 25 Jahre,12062,6157,5905
False,8216,Landkreis Rastatt,25 - 30 Jahre,17153,8855,8298
False,8216,Landkreis Rastatt,30 - 35 Jahre,19357,10005,9352
False,8216,Landkreis Rastatt,35 - 40 Jahre,17940,9283,8657
False,8216,Landkreis Rastatt,40 - 45 Jahre,15997,8103,7894
False,8216,Landkreis Rastatt,45 - 50 Jahre,13704,7029,6675
False,8216,Landkreis Rastatt,50 - 55 Jahre,12614,6490,6124
False,8216,Landkreis Rastatt,55 - 60 Jahre,16128,8011,8117
False,8216,Landkreis Rastatt,60 - 65 Jahre,12316,6051,6265
False,8216,Landkreis Rastatt,65 - 75 Jahre,20444,8537,11907
False,8216,Landkreis Rastatt,75 und mehr Jahre,13188,3983,9205
False,8216,Landkreis Rastatt,Insgesamt,218982,107179,111803
False,8216002,Au am Rhein,unter 3 Jahre,127,62,65
False,8216002,Au am Rhein,3 -  6 Jahre,116,52,64
False,8216002,Au am Rhein,6 - 10 Jahre,149,83,66
False,8216002,Au am Rhein,10 - 15 Jahre,168,95,73
False,8216002,Au am Rhein,15 - 18 Jahre,94,54,40
False,8216002,Au am Rhein,18 - 20 Jahre,60,30,30
False,8216002,Au am Rhein,20 - 25 Jahre,141,72,69
False,8216002,Au am Rhein,25 - 30 Jahre,268,142,126
False,8216002,Au am Rhein,30 - 35 Jahre,334,159,175
False,8216002,Au am Rhein,35 - 40 Jahre,282,159,123
False,8216002,Au am Rhein,40 - 45 Jahre,226,120,106
False,8216002,Au am Rhein,45 - 50 Jahre,189,107,82
False,8216002,Au am Rhein,50 - 55 Jahre,136,63,73
False,8216002,Au am Rhein,55 - 60 Jahre,247,112,135
False,8216002,Au am Rhein,60 - 65 Jahre,180,96,84
False,8216002,Au am Rhein,65 - 75 Jahre,242,108,134
False,8216002,Au am Rhein,75 und mehr Jahre,149,39,110
False,8216002,Au am Rhein,Insgesamt,3108,1553,1555
False,8216005,Bietigheim,unter 3 Jahre,154,65,89
False,8216005,Bietigheim,3 -  6 Jahre,192,89,103
False,8216005,Bietigheim,6 - 10 Jahre,246,143,103
False,8216005,Bietigheim,10 - 15 Jahre,320,142,178
False,8216005,Bietigheim,15 - 18 Jahre,165,82,83
False,8216005,Bietigheim,18 - 20 Jahre,94,56,38
False,8216005,Bietigheim,20 - 25 Jahre,280,142,138
False,8216005,Bietigheim,25 - 30 Jahre,437,232,205
False,8216005,Bietigheim,30 - 35 Jahre,513,256,257
False,8216005,Bietigheim,35 - 40 Jahre,461,228,233
False,8216005,Bietigheim,40 - 45 Jahre,433,225,208
False,8216005,Bietigheim,45 - 50 Jahre,407,210,197
False,8216005,Bietigheim,50 - 55 Jahre,306,148,158
False,8216005,Bietigheim,55 - 60 Jahre,398,204,194
False,8216005,Bietigheim,60 - 65 Jahre,308,152,156
False,8216005,Bietigheim,65 - 75 Jahre,553,235,318
False,8216005,Bietigheim,75 und mehr Jahre,345,114,231
False,8216005,Bietigheim,Insgesamt,5612,2723,2889
False,8216006,Bischweier,unter 3 Jahre,77,34,43
False,8216006,Bischweier,3 -  6 Jahre,73,34,39
False,8216006,Bischweier,6 - 10 Jahre,126,68,58
False,8216006,Bischweier,10 - 15 Jahre,137,72,65
False,8216006,Bischweier,15 - 18 Jahre,97,62,35
False,8216006,Bischweier,18 - 20 Jahre,47,24,23
False,8216006,Bischweier,20 - 25 Jahre,154,78,76
False,8216006,Bischweier,25 - 30 Jahre,242,119,123
False,8216006,Bischweier,30 - 35 Jahre,250,122,128
False,8216006,Bischweier,35 - 40 Jahre,196,100,96
False,8216006,Bischweier,40 - 45 Jahre,206,100,106
False,8216006,Bischweier,45 - 50 Jahre,182,92,90
False,8216006,Bischweier,50 - 55 Jahre,178,98,80
False,8216006,Bischweier,55 - 60 Jahre,226,110,116
False,8216006,Bischweier,60 - 65 Jahre,167,94,73
False,8216006,Bischweier,65 - 75 Jahre,227,99,128
False,8216006,Bischweier,75 und mehr Jahre,114,35,79
False,8216006,Bischweier,Insgesamt,2699,1341,1358
False,8216007,"Bühl, Stadt",unter 3 Jahre,992,508,484
False,8216007,"Bühl, Stadt",3 -  6 Jahre,1023,551,472
False,8216007,"Bühl, Stadt",6 - 10 Jahre,1244,633,611
False,8216007,"Bühl, Stadt",10 - 15 Jahre,1531,808,723
False,8216007,"Bühl, Stadt",15 - 18 Jahre,854,478,376
False,8216007,"Bühl, Stadt",18 - 20 Jahre,522,267,255
False,8216007,"Bühl, Stadt",20 - 25 Jahre,1556,757,799
False,8216007,"Bühl, Stadt",25 - 30 Jahre,2137,1073,1064
False,8216007,"Bühl, Stadt",30 - 35 Jahre,2507,1299,1208
False,8216007,"Bühl, Stadt",35 - 40 Jahre,2206,1120,1086
False,8216007,"Bühl, Stadt",40 - 45 Jahre,1961,972,989
False,8216007,"Bühl, Stadt",45 - 50 Jahre,1724,888,836
False,8216007,"Bühl, Stadt",50 - 55 Jahre,1569,798,771
False,8216007,"Bühl, Stadt",55 - 60 Jahre,1781,881,900
False,8216007,"Bühl, Stadt",60 - 65 Jahre,1366,651,715
False,8216007,"Bühl, Stadt",65 - 75 Jahre,2404,984,1420
False,8216007,"Bühl, Stadt",75 und mehr Jahre,1711,493,1218
False,8216007,"Bühl, Stadt",Insgesamt,27088,13161,13927
False,8216008,Bühlertal,unter 3 Jahre,258,125,133
False,8216008,Bühlertal,3 -  6 Jahre,281,140,141
False,8216008,Bühlertal,6 - 10 Jahre,347,166,181
False,8216008,Bühlertal,10 - 15 Jahre,464,258,206
False,8216008,Bühlertal,15 - 18 Jahre,232,123,109
False,8216008,Bühlertal,18 - 20 Jahre,179,100,79
False,8216008,Bühlertal,20 - 25 Jahre,480,250,230
False,8216008,Bühlertal,25 - 30 Jahre,702,375,327
False,8216008,Bühlertal,30 - 35 Jahre,816,435,381
False,8216008,Bühlertal,35 - 40 Jahre,652,328,324
False,8216008,Bühlertal,40 - 45 Jahre,634,323,311
False,8216008,Bühlertal,45 - 50 Jahre,477,259,218
False,8216008,Bühlertal,50 - 55 Jahre,417,220,197
False,8216008,Bühlertal,55 - 60 Jahre,668,312,356
False,8216008,Bühlertal,60 - 65 Jahre,511,259,252
False,8216008,Bühlertal,65 - 75 Jahre,838,333,505
False,8216008,Bühlertal,75 und mehr Jahre,436,151,285
False,8216008,Bühlertal,Insgesamt,8392,4157,4235
False,8216009,Durmersheim,unter 3 Jahre,331,186,145
False,8216009,Durmersheim,3 -  6 Jahre,352,199,153
False,8216009,Durmersheim,6 - 10 Jahre,480,221,259
False,8216009,Durmersheim,10 - 15 Jahre,585,289,296
False,8216009,Durmersheim,15 - 18 Jahre,300,154,146
False,8216009,Durmersheim,18 - 20 Jahre,202,106,96
False,8216009,Durmersheim,20 - 25 Jahre,638,323,315
False,8216009,Durmersheim,25 - 30 Jahre,860,441,419
False,8216009,Durmersheim,30 - 35 Jahre,1055,536,519
False,8216009,Durmersheim,35 - 40 Jahre,1000,512,488
False,8216009,Durmersheim,40 - 45 Jahre,796,393,403
False,8216009,Durmersheim,45 - 50 Jahre,777,395,382
False,8216009,Durmersheim,50 - 55 Jahre,723,373,350
False,8216009,Durmersheim,55 - 60 Jahre,797,419,378
False,8216009,Durmersheim,60 - 65 Jahre,611,321,290
False,8216009,Durmersheim,65 - 75 Jahre,965,420,545
False,8216009,Durmersheim,75 und mehr Jahre,508,159,349
False,8216009,Durmersheim,Insgesamt,10980,5447,5533
False,8216012,Elchesheim-Illingen,unter 3 Jahre,98,51,47
False,8216012,Elchesheim-Illingen,3 -  6 Jahre,107,53,54
False,8216012,Elchesheim-Illingen,6 - 10 Jahre,131,72,59
False,8216012,Elchesheim-Illingen,10 - 15 Jahre,180,92,88
False,8216012,Elchesheim-Illingen,15 - 18 Jahre,83,39,44
False,8216012,Elchesheim-Illingen,18 - 20 Jahre,59,35,24
False,8216012,Elchesheim-Illingen,20 - 25 Jahre,155,79,76
False,8216012,Elchesheim-Illingen,25 - 30 Jahre,229,114,115
False,8216012,Elchesheim-Illingen,30 - 35 Jahre,250,137,113
False,8216012,Elchesheim-Illingen,35 - 40 Jahre,298,135,163
False,8216012,Elchesheim-Illingen,40 - 45 Jahre,230,130,100
False,8216012,Elchesheim-Illingen,45 - 50 Jahre,204,110,94
False,8216012,Elchesheim-Illingen,50 - 55 Jahre,191,96,95
False,8216012,Elchesheim-Illingen,55 - 60 Jahre,199,100,99
False,8216012,Elchesheim-Illingen,60 - 65 Jahre,172,85,87
False,8216012,Elchesheim-Illingen,65 - 75 Jahre,270,127,143
False,8216012,Elchesheim-Illingen,75 und mehr Jahre,141,41,100
False,8216012,Elchesheim-Illingen,Insgesamt,2997,1496,1501
False,8216013,Forbach,unter 3 Jahre,176,87,89
False,8216013,Forbach,3 -  6 Jahre,211,115,96
False,8216013,Forbach,6 - 10 Jahre,259,131,128
False,8216013,Forbach,10 - 15 Jahre,301,137,164
False,8216013,Forbach,15 - 18 Jahre,193,94,99
False,8216013,Forbach,18 - 20 Jahre,121,62,59
False,8216013,Forbach,20 - 25 Jahre,349,172,177
False,8216013,Forbach,25 - 30 Jahre,442,235,207
False,8216013,Forbach,30 - 35 Jahre,521,285,236
False,8216013,Forbach,35 - 40 Jahre,454,241,213
False,8216013,Forbach,40 - 45 Jahre,416,216,200
False,8216013,Forbach,45 - 50 Jahre,324,176,148
False,8216013,Forbach,50 - 55 Jahre,308,156,152
False,8216013,Forbach,55 - 60 Jahre,460,238,222
False,8216013,Forbach,60 - 65 Jahre,392,173,219
False,8216013,Forbach,65 - 75 Jahre,623,261,362
False,8216013,Forbach,75 und mehr Jahre,349,104,245
False,8216013,Forbach,Insgesamt,5899,2883,3016
False,8216015,"Gaggenau, Stadt",unter 3 Jahre,905,475,430
False,8216015,"Gaggenau, Stadt",3 -  6 Jahre,947,469,478
False,8216015,"Gaggenau, Stadt",6 - 10 Jahre,1206,612,594
False,8216015,"Gaggenau, Stadt",10 - 15 Jahre,1468,756,712
False,8216015,"Gaggenau, Stadt",15 - 18 Jahre,926,478,448
False,8216015,"Gaggenau, Stadt",18 - 20 Jahre,619,324,295
False,8216015,"Gaggenau, Stadt",20 - 25 Jahre,1594,830,764
False,8216015,"Gaggenau, Stadt",25 - 30 Jahre,2164,1119,1045
False,8216015,"Gaggenau, Stadt",30 - 35 Jahre,2482,1280,1202
False,8216015,"Gaggenau, Stadt",35 - 40 Jahre,2104,1072,1032
False,8216015,"Gaggenau, Stadt",40 - 45 Jahre,2074,1014,1060
False,8216015,"Gaggenau, Stadt",45 - 50 Jahre,2031,1040,991
False,8216015,"Gaggenau, Stadt",50 - 55 Jahre,1913,957,956
False,8216015,"Gaggenau, Stadt",55 - 60 Jahre,2469,1242,1227
False,8216015,"Gaggenau, Stadt",60 - 65 Jahre,1769,885,884
False,8216015,"Gaggenau, Stadt",65 - 75 Jahre,2881,1223,1658
False,8216015,"Gaggenau, Stadt",75 und mehr Jahre,1979,590,1389
False,8216015,"Gaggenau, Stadt",Insgesamt,29531,14366,15165
False,8216017,"Gernsbach, Stadt",unter 3 Jahre,419,197,222
False,8216017,"Gernsbach, Stadt",3 -  6 Jahre,472,245,227
False,8216017,"Gernsbach, Stadt",6 - 10 Jahre,624,339,285
False,8216017,"Gernsbach, Stadt",10 - 15 Jahre,783,420,363
False,8216017,"Gernsbach, Stadt",15 - 18 Jahre,458,234,224
False,8216017,"Gernsbach, Stadt",18 - 20 Jahre,285,145,140
False,8216017,"Gernsbach, Stadt",20 - 25 Jahre,805,415,390
False,8216017,"Gernsbach, Stadt",25 - 30 Jahre,1042,533,509
False,8216017,"Gernsbach, Stadt",30 - 35 Jahre,1183,638,545
False,8216017,"Gernsbach, Stadt",35 - 40 Jahre,1164,611,553
False,8216017,"Gernsbach, Stadt",40 - 45 Jahre,1045,532,513
False,8216017,"Gernsbach, Stadt",45 - 50 Jahre,904,448,456
False,8216017,"Gernsbach, Stadt",50 - 55 Jahre,900,483,417
False,8216017,"Gernsbach, Stadt",55 - 60 Jahre,1119,534,585
False,8216017,"Gernsbach, Stadt",60 - 65 Jahre,838,409,429
False,8216017,"Gernsbach, Stadt",65 - 75 Jahre,1533,645,888
False,8216017,"Gernsbach, Stadt",75 und mehr Jahre,1056,324,732
False,8216017,"Gernsbach, Stadt",Insgesamt,14630,7152,7478
False,8216022,Hügelsheim,unter 3 Jahre,182,94,88
False,8216022,Hügelsheim,3 -  6 Jahre,183,103,80
False,8216022,Hügelsheim,6 - 10 Jahre,234,125,109
False,8216022,Hügelsheim,10 - 15 Jahre,265,137,128
False,8216022,Hügelsheim,15 - 18 Jahre,126,63,63
False,8216022,Hügelsheim,18 - 20 Jahre,56,27,29
False,8216022,Hügelsheim,20 - 25 Jahre,240,99,141
False,8216022,Hügelsheim,25 - 30 Jahre,404,201,203
False,8216022,Hügelsheim,30 - 35 Jahre,460,235,225
False,8216022,Hügelsheim,35 - 40 Jahre,376,192,184
False,8216022,Hügelsheim,40 - 45 Jahre,286,149,137
False,8216022,Hügelsheim,45 - 50 Jahre,161,92,69
False,8216022,Hügelsheim,50 - 55 Jahre,130,80,50
False,8216022,Hügelsheim,55 - 60 Jahre,166,74,92
False,8216022,Hügelsheim,60 - 65 Jahre,124,59,65
False,8216022,Hügelsheim,65 - 75 Jahre,184,72,112
False,8216022,Hügelsheim,75 und mehr Jahre,112,38,74
False,8216022,Hügelsheim,Insgesamt,3689,1840,1849
False,8216023,Iffezheim,unter 3 Jahre,169,76,93
False,8216023,Iffezheim,3 -  6 Jahre,186,95,91
False,8216023,Iffezheim,6 - 10 Jahre,262,131,131
False,8216023,Iffezheim,10 - 15 Jahre,283,139,144
False,8216023,Iffezheim,15 - 18 Jahre,158,83,75
False,8216023,Iffezheim,18 - 20 Jahre,81,47,34
False,8216023,Iffezheim,20 - 25 Jahre,237,118,119
False,8216023,Iffezheim,25 - 30 Jahre,386,197,189
False,8216023,Iffezheim,30 - 35 Jahre,459,220,239
False,8216023,Iffezheim,35 - 40 Jahre,426,229,197
False,8216023,Iffezheim,40 - 45 Jahre,389,209,180
False,8216023,Iffezheim,45 - 50 Jahre,251,134,117
False,8216023,Iffezheim,50 - 55 Jahre,225,114,111
False,8216023,Iffezheim,55 - 60 Jahre,295,150,145
False,8216023,Iffezheim,60 - 65 Jahre,229,115,114
False,8216023,Iffezheim,65 - 75 Jahre,382,154,228
False,8216023,Iffezheim,75 und mehr Jahre,179,57,122
False,8216023,Iffezheim,Insgesamt,4597,2268,2329
False,8216024,"Kuppenheim, Stadt",unter 3 Jahre,224,112,112
False,8216024,"Kuppenheim, Stadt",3 -  6 Jahre,245,125,120
False,8216024,"Kuppenheim, Stadt",6 - 10 Jahre,349,171,178
False,8216024,"Kuppenheim, Stadt",10 - 15 Jahre,382,180,202
False,8216024,"Kuppenheim, Stadt",15 - 18 Jahre,237,133,104
False,8216024,"Kuppenheim, Stadt",18 - 20 Jahre,149,84,65
False,8216024,"Kuppenheim, Stadt",20 - 25 Jahre,443,227,216
False,8216024,"Kuppenheim, Stadt",25 - 30 Jahre,584,316,268
False,8216024,"Kuppenheim, Stadt",30 - 35 Jahre,627,336,291
False,8216024,"Kuppenheim, Stadt",35 - 40 Jahre,558,275,283
False,8216024,"Kuppenheim, Stadt",40 - 45 Jahre,560,288,272
False,8216024,"Kuppenheim, Stadt",45 - 50 Jahre,520,252,268
False,8216024,"Kuppenheim, Stadt",50 - 55 Jahre,504,256,248
False,8216024,"Kuppenheim, Stadt",55 - 60 Jahre,592,299,293
False,8216024,"Kuppenheim, Stadt",60 - 65 Jahre,421,218,203
False,8216024,"Kuppenheim, Stadt",65 - 75 Jahre,635,271,364
False,8216024,"Kuppenheim, Stadt",75 und mehr Jahre,443,121,322
False,8216024,"Kuppenheim, Stadt",Insgesamt,7473,3664,3809
False,8216028,"Lichtenau, Stadt",unter 3 Jahre,188,106,82
False,8216028,"Lichtenau, Stadt",3 -  6 Jahre,212,113,99
False,8216028,"Lichtenau, Stadt",6 - 10 Jahre,242,127,115
False,8216028,"Lichtenau, Stadt",10 - 15 Jahre,287,146,141
False,8216028,"Lichtenau, Stadt",15 - 18 Jahre,152,82,70
False,8216028,"Lichtenau, Stadt",18 - 20 Jahre,93,51,42
False,8216028,"Lichtenau, Stadt",20 - 25 Jahre,283,149,134
False,8216028,"Lichtenau, Stadt",25 - 30 Jahre,391,190,201
False,8216028,"Lichtenau, Stadt",30 - 35 Jahre,477,238,239
False,8216028,"Lichtenau, Stadt",35 - 40 Jahre,432,232,200
False,8216028,"Lichtenau, Stadt",40 - 45 Jahre,304,153,151
False,8216028,"Lichtenau, Stadt",45 - 50 Jahre,296,155,141
False,8216028,"Lichtenau, Stadt",50 - 55 Jahre,248,124,124
False,8216028,"Lichtenau, Stadt",55 - 60 Jahre,310,166,144
False,8216028,"Lichtenau, Stadt",60 - 65 Jahre,264,139,125
False,8216028,"Lichtenau, Stadt",65 - 75 Jahre,367,153,214
False,8216028,"Lichtenau, Stadt",75 und mehr Jahre,279,87,192
False,8216028,"Lichtenau, Stadt",Insgesamt,4825,2411,2414
False,8216029,Loffenau,unter 3 Jahre,94,46,48
False,8216029,Loffenau,3 -  6 Jahre,120,63,57
False,8216029,Loffenau,6 - 10 Jahre,158,80,78
False,8216029,Loffenau,10 - 15 Jahre,155,74,81
False,8216029,Loffenau,15 - 18 Jahre,69,36,33
False,8216029,Loffenau,18 - 20 Jahre,45,26,19
False,8216029,Loffenau,20 - 25 Jahre,163,89,74
False,8216029,Loffenau,25 - 30 Jahre,259,137,122
False,8216029,Loffenau,30 - 35 Jahre,281,153,128
False,8216029,Loffenau,35 - 40 Jahre,246,141,105
False,8216029,Loffenau,40 - 45 Jahre,180,91,89
False,8216029,Loffenau,45 - 50 Jahre,169,93,76
False,8216029,Loffenau,50 - 55 Jahre,141,70,71
False,8216029,Loffenau,55 - 60 Jahre,224,118,106
False,8216029,Loffenau,60 - 65 Jahre,138,68,70
False,8216029,Loffenau,65 - 75 Jahre,226,93,133
False,8216029,Loffenau,75 und mehr Jahre,125,37,88
False,8216029,Loffenau,Insgesamt,2793,1415,1378
False,8216033,Muggensturm,unter 3 Jahre,163,82,81
False,8216033,Muggensturm,3 -  6 Jahre,215,111,104
False,8216033,Muggensturm,6 - 10 Jahre,276,137,139
False,8216033,Muggensturm,10 - 15 Jahre,311,174,137
False,8216033,Muggensturm,15 - 18 Jahre,183,90,93
False,8216033,Muggensturm,18 - 20 Jahre,116,69,47
False,8216033,Muggensturm,20 - 25 Jahre,273,141,132
False,8216033,Muggensturm,25 - 30 Jahre,450,229,221
False,8216033,Muggensturm,30 - 35 Jahre,470,226,244
False,8216033,Muggensturm,35 - 40 Jahre,511,267,244
False,8216033,Muggensturm,40 - 45 Jahre,464,246,218
False,8216033,Muggensturm,45 - 50 Jahre,391,213,178
False,8216033,Muggensturm,50 - 55 Jahre,351,200,151
False,8216033,Muggensturm,55 - 60 Jahre,409,201,208
False,8216033,Muggensturm,60 - 65 Jahre,322,163,159
False,8216033,Muggensturm,65 - 75 Jahre,513,221,292
False,8216033,Muggensturm,75 und mehr Jahre,263,72,191
False,8216033,Muggensturm,Insgesamt,5681,2842,2839
False,8216039,Ötigheim,unter 3 Jahre,154,87,67
False,8216039,Ötigheim,3 -  6 Jahre,147,76,71
False,8216039,Ötigheim,6 - 10 Jahre,179,83,96
False,8216039,Ötigheim,10 - 15 Jahre,242,129,113
False,8216039,Ötigheim,15 - 18 Jahre,141,79,62
False,8216039,Ötigheim,18 - 20 Jahre,79,43,36
False,8216039,Ötigheim,20 - 25 Jahre,216,115,101
False,8216039,Ötigheim,25 - 30 Jahre,345,170,175
False,8216039,Ötigheim,30 - 35 Jahre,345,165,180
False,8216039,Ötigheim,35 - 40 Jahre,376,189,187
False,8216039,Ötigheim,40 - 45 Jahre,349,166,183
False,8216039,Ötigheim,45 - 50 Jahre,292,153,139
False,8216039,Ötigheim,50 - 55 Jahre,250,128,122
False,8216039,Ötigheim,55 - 60 Jahre,293,145,148
False,8216039,Ötigheim,60 - 65 Jahre,229,121,108
False,8216039,Ötigheim,65 - 75 Jahre,371,161,210
False,8216039,Ötigheim,75 und mehr Jahre,223,75,148
False,8216039,Ötigheim,Insgesamt,4231,2085,2146
False,8216041,Ottersweier,unter 3 Jahre,210,105,105
False,8216041,Ottersweier,3 -  6 Jahre,240,117,123
False,8216041,Ottersweier,6 - 10 Jahre,347,189,158
False,8216041,Ottersweier,10 - 15 Jahre,307,142,165
False,8216041,Ottersweier,15 - 18 Jahre,204,100,104
False,8216041,Ottersweier,18 - 20 Jahre,112,60,52
False,8216041,Ottersweier,20 - 25 Jahre,345,184,161
False,8216041,Ottersweier,25 - 30 Jahre,484,259,225
False,8216041,Ottersweier,30 - 35 Jahre,537,262,275
False,8216041,Ottersweier,35 - 40 Jahre,522,272,250
False,8216041,Ottersweier,40 - 45 Jahre,445,248,197
False,8216041,Ottersweier,45 - 50 Jahre,384,190,194
False,8216041,Ottersweier,50 - 55 Jahre,346,193,153
False,8216041,Ottersweier,55 - 60 Jahre,428,240,188
False,8216041,Ottersweier,60 - 65 Jahre,344,167,177
False,8216041,Ottersweier,65 - 75 Jahre,608,276,332
False,8216041,Ottersweier,75 und mehr Jahre,376,113,263
False,8216041,Ottersweier,Insgesamt,6239,3117,3122
False,8216043,"Rastatt, Stadt",unter 3 Jahre,1303,666,637
False,8216043,"Rastatt, Stadt",3 -  6 Jahre,1523,775,748
False,8216043,"Rastatt, Stadt",6 - 10 Jahre,2166,1124,1042
False,8216043,"Rastatt, Stadt",10 - 15 Jahre,2531,1277,1254
False,8216043,"Rastatt, Stadt",15 - 18 Jahre,1558,771,787
False,8216043,"Rastatt, Stadt",18 - 20 Jahre,1040,531,509
False,8216043,"Rastatt, Stadt",20 - 25 Jahre,2596,1371,1225
False,8216043,"Rastatt, Stadt",25 - 30 Jahre,3449,1833,1616
False,8216043,"Rastatt, Stadt",30 - 35 Jahre,3659,1925,1734
False,8216043,"Rastatt, Stadt",35 - 40 Jahre,3801,1997,1804
False,8216043,"Rastatt, Stadt",40 - 45 Jahre,3355,1695,1660
False,8216043,"Rastatt, Stadt",45 - 50 Jahre,2738,1335,1403
False,8216043,"Rastatt, Stadt",50 - 55 Jahre,2665,1344,1321
False,8216043,"Rastatt, Stadt",55 - 60 Jahre,3542,1729,1813
False,8216043,"Rastatt, Stadt",60 - 65 Jahre,2824,1342,1482
False,8216043,"Rastatt, Stadt",65 - 75 Jahre,4829,1951,2878
False,8216043,"Rastatt, Stadt",75 und mehr Jahre,3278,975,2303
False,8216043,"Rastatt, Stadt",Insgesamt,46857,22641,24216
False,8216049,Sinzheim,unter 3 Jahre,364,199,165
False,8216049,Sinzheim,3 -  6 Jahre,416,202,214
False,8216049,Sinzheim,6 - 10 Jahre,471,217,254
False,8216049,Sinzheim,10 - 15 Jahre,533,282,251
False,8216049,Sinzheim,15 - 18 Jahre,273,119,154
False,8216049,Sinzheim,18 - 20 Jahre,164,77,87
False,8216049,Sinzheim,20 - 25 Jahre,484,229,255
False,8216049,Sinzheim,25 - 30 Jahre,885,442,443
False,8216049,Sinzheim,30 - 35 Jahre,1011,514,497
False,8216049,Sinzheim,35 - 40 Jahre,886,436,450
False,8216049,Sinzheim,40 - 45 Jahre,774,393,381
False,8216049,Sinzheim,45 - 50 Jahre,642,343,299
False,8216049,Sinzheim,50 - 55 Jahre,558,299,259
False,8216049,Sinzheim,55 - 60 Jahre,682,335,347
False,8216049,Sinzheim,60 - 65 Jahre,503,227,276
False,8216049,Sinzheim,65 - 75 Jahre,840,356,484
False,8216049,Sinzheim,75 und mehr Jahre,548,176,372
False,8216049,Sinzheim,Insgesamt,10034,4846,5188
False,8216052,Steinmauern,unter 3 Jahre,103,67,36
False,8216052,Steinmauern,3 -  6 Jahre,109,50,59
False,8216052,Steinmauern,6 - 10 Jahre,138,77,61
False,8216052,Steinmauern,10 - 15 Jahre,148,78,70
False,8216052,Steinmauern,15 - 18 Jahre,100,44,56
False,8216052,Steinmauern,18 - 20 Jahre,47,27,20
False,8216052,Steinmauern,20 - 25 Jahre,124,69,55
False,8216052,Steinmauern,25 - 30 Jahre,173,86,87
False,8216052,Steinmauern,30 - 35 Jahre,247,126,121
False,8216052,Steinmauern,35 - 40 Jahre,241,123,118
False,8216052,Steinmauern,40 - 45 Jahre,190,106,84
False,8216052,Steinmauern,45 - 50 Jahre,159,81,78
False,8216052,Steinmauern,50 - 55 Jahre,132,64,68
False,8216052,Steinmauern,55 - 60 Jahre,179,88,91
False,8216052,Steinmauern,60 - 65 Jahre,152,73,79
False,8216052,Steinmauern,65 - 75 Jahre,224,91,133
False,8216052,Steinmauern,75 und mehr Jahre,134,51,83
False,8216052,Steinmauern,Insgesamt,2600,1301,1299
False,8216059,Weisenbach,unter 3 Jahre,74,34,40
False,8216059,Weisenbach,3 -  6 Jahre,104,54,50
False,8216059,Weisenbach,6 - 10 Jahre,124,65,59
False,8216059,Weisenbach,10 - 15 Jahre,141,73,68
False,8216059,Weisenbach,15 - 18 Jahre,83,44,39
False,8216059,Weisenbach,18 - 20 Jahre,59,24,35
False,8216059,Weisenbach,20 - 25 Jahre,137,69,68
False,8216059,Weisenbach,25 - 30 Jahre,216,100,116
False,8216059,Weisenbach,30 - 35 Jahre,223,117,106
False,8216059,Weisenbach,35 - 40 Jahre,223,131,92
False,8216059,Weisenbach,40 - 45 Jahre,183,77,106
False,8216059,Weisenbach,45 - 50 Jahre,148,87,61
False,8216059,Weisenbach,50 - 55 Jahre,109,53,56
False,8216059,Weisenbach,55 - 60 Jahre,214,99,115
False,8216059,Weisenbach,60 - 65 Jahre,166,90,76
False,8216059,Weisenbach,65 - 75 Jahre,248,105,143
False,8216059,Weisenbach,75 und mehr Jahre,156,54,102
False,8216059,Weisenbach,Insgesamt,2608,1276,1332
False,8216063,Rheinmünster,unter 3 Jahre,260,139,121
False,8216063,Rheinmünster,3 -  6 Jahre,248,118,130
False,8216063,Rheinmünster,6 - 10 Jahre,353,193,160
False,8216063,Rheinmünster,10 - 15 Jahre,414,202,212
False,8216063,Rheinmünster,15 - 18 Jahre,237,109,128
False,8216063,Rheinmünster,18 - 20 Jahre,133,68,65
False,8216063,Rheinmünster,20 - 25 Jahre,369,179,190
False,8216063,Rheinmünster,25 - 30 Jahre,604,312,292
False,8216063,Rheinmünster,30 - 35 Jahre,650,341,309
False,8216063,Rheinmünster,35 - 40 Jahre,525,293,232
False,8216063,Rheinmünster,40 - 45 Jahre,497,257,240
False,8216063,Rheinmünster,45 - 50 Jahre,334,176,158
False,8216063,Rheinmünster,50 - 55 Jahre,314,173,141
False,8216063,Rheinmünster,55 - 60 Jahre,430,215,215
False,8216063,Rheinmünster,60 - 65 Jahre,286,144,142
False,8216063,Rheinmünster,65 - 75 Jahre,481,198,283
False,8216063,Rheinmünster,75 und mehr Jahre,284,77,207
False,8216063,Rheinmünster,Insgesamt,6419,3194,3225
False,8221,Stadtkreis Heidelberg,unter 3 Jahre,3723,1960,1763
False,8221,Stadtkreis Heidelberg,3 -  6 Jahre,3655,1936,1719
False,8221,Stadtkreis Heidelberg,6 - 10 Jahre,4725,2379,2346
False,8221,Stadtkreis Heidelberg,10 - 15 Jahre,5356,2745,2611
False,8221,Stadtkreis Heidelberg,15 - 18 Jahre,3152,1602,1550
False,8221,Stadtkreis Heidelberg,18 - 20 Jahre,2322,1084,1238
False,8221,Stadtkreis Heidelberg,20 - 25 Jahre,10940,4731,6209
False,8221,Stadtkreis Heidelberg,25 - 30 Jahre,16856,8099,8757
False,8221,Stadtkreis Heidelberg,30 - 35 Jahre,15657,7942,7715
False,8221,Stadtkreis Heidelberg,35 - 40 Jahre,11650,5992,5658
False,8221,Stadtkreis Heidelberg,40 - 45 Jahre,9467,4780,4687
False,8221,Stadtkreis Heidelberg,45 - 50 Jahre,8147,4112,4035
False,8221,Stadtkreis Heidelberg,50 - 55 Jahre,7674,3854,3820
False,8221,Stadtkreis Heidelberg,55 - 60 Jahre,8110,3973,4137
False,8221,Stadtkreis Heidelberg,60 - 65 Jahre,5992,2832,3160
False,8221,Stadtkreis Heidelberg,65 - 75 Jahre,11387,4458,6929
False,8221,Stadtkreis Heidelberg,75 und mehr Jahre,9968,2743,7225
False,8221,Stadtkreis Heidelberg,Insgesamt,138781,65222,73559
False,8221000,"Heidelberg, Stadt",unter 3 Jahre,3723,1960,1763
False,8221000,"Heidelberg, Stadt",3 -  6 Jahre,3655,1936,1719
False,8221000,"Heidelberg, Stadt",6 - 10 Jahre,4725,2379,2346
False,8221000,"Heidelberg, Stadt",10 - 15 Jahre,5356,2745,2611
False,8221000,"Heidelberg, Stadt",15 - 18 Jahre,3152,1602,1550
False,8221000,"Heidelberg, Stadt",18 - 20 Jahre,2322,1084,1238
False,8221000,"Heidelberg, Stadt",20 - 25 Jahre,10940,4731,6209
False,8221000,"Heidelberg, Stadt",25 - 30 Jahre,16856,8099,8757
False,8221000,"Heidelberg, Stadt",30 - 35 Jahre,15657,7942,7715
False,8221000,"Heidelberg, Stadt",35 - 40 Jahre,11650,5992,5658
False,8221000,"Heidelberg, Stadt",40 - 45 Jahre,9467,4780,4687
False,8221000,"Heidelberg, Stadt",45 - 50 Jahre,8147,4112,4035
False,8221000,"Heidelberg, Stadt",50 - 55 Jahre,7674,3854,3820
False,8221000,"Heidelberg, Stadt",55 - 60 Jahre,8110,3973,4137
False,8221000,"Heidelberg, Stadt",60 - 65 Jahre,5992,2832,3160
False,8221000,"Heidelberg, Stadt",65 - 75 Jahre,11387,4458,6929
False,8221000,"Heidelberg, Stadt",75 und mehr Jahre,9968,2743,7225
False,8221000,"Heidelberg, Stadt",Insgesamt,138781,65222,73559
False,8222,Stadtkreis Mannheim,unter 3 Jahre,8800,4626,4174
False,8222,Stadtkreis Mannheim,3 -  6 Jahre,9070,4608,4462
False,8222,Stadtkreis Mannheim,6 - 10 Jahre,11541,5971,5570
False,8222,Stadtkreis Mannheim,10 - 15 Jahre,13481,6854,6627
False,8222,Stadtkreis Mannheim,15 - 18 Jahre,8126,4150,3976
False,8222,Stadtkreis Mannheim,18 - 20 Jahre,5738,2890,2848
False,8222,Stadtkreis Mannheim,20 - 25 Jahre,19254,9384,9870
False,8222,Stadtkreis Mannheim,25 - 30 Jahre,29070,14988,14082
False,8222,Stadtkreis Mannheim,30 - 35 Jahre,31360,16661,14699
False,8222,Stadtkreis Mannheim,35 - 40 Jahre,24817,13300,11517
False,8222,Stadtkreis Mannheim,40 - 45 Jahre,20669,10603,10066
False,8222,Stadtkreis Mannheim,45 - 50 Jahre,20093,10171,9922
False,8222,Stadtkreis Mannheim,50 - 55 Jahre,19370,10022,9348
False,8222,Stadtkreis Mannheim,55 - 60 Jahre,22157,11365,10792
False,8222,Stadtkreis Mannheim,60 - 65 Jahre,17066,8359,8707
False,8222,Stadtkreis Mannheim,65 - 75 Jahre,29035,11970,17065
False,8222,Stadtkreis Mannheim,75 und mehr Jahre,21645,6360,15285
False,8222,Stadtkreis Mannheim,Insgesamt,311292,152282,159010
False,8222000,"Mannheim, Universitätsstadt",unter 3 Jahre,8800,4626,4174
False,8222000,"Mannheim, Universitätsstadt",3 -  6 Jahre,9070,4608,4462
False,8222000,"Mannheim, Universitätsstadt",6 - 10 Jahre,11541,5971,5570
False,8222000,"Mannheim, Universitätsstadt",10 - 15 Jahre,13481,6854,6627
False,8222000,"Mannheim, Universitätsstadt",15 - 18 Jahre,8126,4150,3976
False,8222000,"Mannheim, Universitätsstadt",18 - 20 Jahre,5738,2890,2848
False,8222000,"Mannheim, Universitätsstadt",20 - 25 Jahre,19254,9384,9870
False,8222000,"Mannheim, Universitätsstadt",25 - 30 Jahre,29070,14988,14082
False,8222000,"Mannheim, Universitätsstadt",30 - 35 Jahre,31360,16661,14699
False,8222000,"Mannheim, Universitätsstadt",35 - 40 Jahre,24817,13300,11517
False,8222000,"Mannheim, Universitätsstadt",40 - 45 Jahre,20669,10603,10066
False,8222000,"Mannheim, Universitätsstadt",45 - 50 Jahre,20093,10171,9922
False,8222000,"Mannheim, Universitätsstadt",50 - 55 Jahre,19370,10022,9348
False,8222000,"Mannheim, Universitätsstadt",55 - 60 Jahre,22157,11365,10792
False,8222000,"Mannheim, Universitätsstadt",60 - 65 Jahre,17066,8359,8707
False,8222000,"Mannheim, Universitätsstadt",65 - 75 Jahre,29035,11970,17065
False,8222000,"Mannheim, Universitätsstadt",75 und mehr Jahre,21645,6360,15285
False,8222000,"Mannheim, Universitätsstadt",Insgesamt,311292,152282,159010
False,8225,Landkreis Neckar-Odenwald-Kreis,unter 3 Jahre,4781,2461,2320
False,8225,Landkreis Neckar-Odenwald-Kreis,3 -  6 Jahre,5424,2720,2704
False,8225,Landkreis Neckar-Odenwald-Kreis,6 - 10 Jahre,7303,3712,3591
False,8225,Landkreis Neckar-Odenwald-Kreis,10 - 15 Jahre,8812,4462,4350
False,8225,Landkreis Neckar-Odenwald-Kreis,15 - 18 Jahre,5077,2618,2459
False,8225,Landkreis Neckar-Odenwald-Kreis,18 - 20 Jahre,3373,1822,1551
False,8225,Landkreis Neckar-Odenwald-Kreis,20 - 25 Jahre,8847,4634,4213
False,8225,Landkreis Neckar-Odenwald-Kreis,25 - 30 Jahre,11948,6535,5413
False,8225,Landkreis Neckar-Odenwald-Kreis,30 - 35 Jahre,13073,6942,6131
False,8225,Landkreis Neckar-Odenwald-Kreis,35 - 40 Jahre,11651,5948,5703
False,8225,Landkreis Neckar-Odenwald-Kreis,40 - 45 Jahre,10073,5172,4901
False,8225,Landkreis Neckar-Odenwald-Kreis,45 - 50 Jahre,8890,4601,4289
False,8225,Landkreis Neckar-Odenwald-Kreis,50 - 55 Jahre,7642,3934,3708
False,8225,Landkreis Neckar-Odenwald-Kreis,55 - 60 Jahre,9865,5037,4828
False,8225,Landkreis Neckar-Odenwald-Kreis,60 - 65 Jahre,7634,3780,3854
False,8225,Landkreis Neckar-Odenwald-Kreis,65 - 75 Jahre,13327,5587,7740
False,8225,Landkreis Neckar-Odenwald-Kreis,75 und mehr Jahre,9062,2685,6377
False,8225,Landkreis Neckar-Odenwald-Kreis,Insgesamt,146782,72650,74132
False,8225001,"Adelsheim, Stadt",unter 3 Jahre,154,76,78
False,8225001,"Adelsheim, Stadt",3 -  6 Jahre,163,77,86
False,8225001,"Adelsheim, Stadt",6 - 10 Jahre,248,127,121
False,8225001,"Adelsheim, Stadt",10 - 15 Jahre,314,158,156
False,8225001,"Adelsheim, Stadt",15 - 18 Jahre,172,79,93
False,8225001,"Adelsheim, Stadt",18 - 20 Jahre,120,63,57
False,8225001,"Adelsheim, Stadt",20 - 25 Jahre,348,183,165
False,8225001,"Adelsheim, Stadt",25 - 30 Jahre,702,518,184
False,8225001,"Adelsheim, Stadt",30 - 35 Jahre,463,238,225
False,8225001,"Adelsheim, Stadt",35 - 40 Jahre,386,223,163
False,8225001,"Adelsheim, Stadt",40 - 45 Jahre,332,173,159
False,8225001,"Adelsheim, Stadt",45 - 50 Jahre,304,158,146
False,8225001,"Adelsheim, Stadt",50 - 55 Jahre,253,128,125
False,8225001,"Adelsheim, Stadt",55 - 60 Jahre,401,197,204
False,8225001,"Adelsheim, Stadt",60 - 65 Jahre,298,148,150
False,8225001,"Adelsheim, Stadt",65 - 75 Jahre,530,231,299
False,8225001,"Adelsheim, Stadt",75 und mehr Jahre,323,88,235
False,8225001,"Adelsheim, Stadt",Insgesamt,5511,2865,2646
False,8225002,Aglasterhausen,unter 3 Jahre,147,83,64
False,8225002,Aglasterhausen,3 -  6 Jahre,175,85,90
False,8225002,Aglasterhausen,6 - 10 Jahre,202,115,87
False,8225002,Aglasterhausen,10 - 15 Jahre,270,131,139
False,8225002,Aglasterhausen,15 - 18 Jahre,160,82,78
False,8225002,Aglasterhausen,18 - 20 Jahre,106,57,49
False,8225002,Aglasterhausen,20 - 25 Jahre,235,120,115
False,8225002,Aglasterhausen,25 - 30 Jahre,356,192,164
False,8225002,Aglasterhausen,30 - 35 Jahre,331,159,172
False,8225002,Aglasterhausen,35 - 40 Jahre,373,193,180
False,8225002,Aglasterhausen,40 - 45 Jahre,300,138,162
False,8225002,Aglasterhausen,45 - 50 Jahre,278,150,128
False,8225002,Aglasterhausen,50 - 55 Jahre,213,115,98
False,8225002,Aglasterhausen,55 - 60 Jahre,305,149,156
False,8225002,Aglasterhausen,60 - 65 Jahre,241,118,123
False,8225002,Aglasterhausen,65 - 75 Jahre,389,167,222
False,8225002,Aglasterhausen,75 und mehr Jahre,293,83,210
False,8225002,Aglasterhausen,Insgesamt,4374,2137,2237
False,8225009,Billigheim,unter 3 Jahre,195,102,93
False,8225009,Billigheim,3 -  6 Jahre,213,104,109
False,8225009,Billigheim,6 - 10 Jahre,316,161,155
False,8225009,Billigheim,10 - 15 Jahre,368,193,175
False,8225009,Billigheim,15 - 18 Jahre,195,103,92
False,8225009,Billigheim,18 - 20 Jahre,128,73,55
False,8225009,Billigheim,20 - 25 Jahre,311,168,143
False,8225009,Billigheim,25 - 30 Jahre,486,265,221
False,8225009,Billigheim,30 - 35 Jahre,504,256,248
False,8225009,Billigheim,35 - 40 Jahre,521,288,233
False,8225009,Billigheim,40 - 45 Jahre,379,200,179
False,8225009,Billigheim,45 - 50 Jahre,332,164,168
False,8225009,Billigheim,50 - 55 Jahre,297,159,138
False,8225009,Billigheim,55 - 60 Jahre,389,204,185
False,8225009,Billigheim,60 - 65 Jahre,303,147,156
False,8225009,Billigheim,65 - 75 Jahre,520,217,303
False,8225009,Billigheim,75 und mehr Jahre,291,91,200
False,8225009,Billigheim,Insgesamt,5748,2895,2853
False,8225010,Binau,unter 3 Jahre,33,19,14
False,8225010,Binau,3 -  6 Jahre,47,26,21
False,8225010,Binau,6 - 10 Jahre,59,29,30
False,8225010,Binau,10 - 15 Jahre,62,34,28
False,8225010,Binau,15 - 18 Jahre,36,15,21
False,8225010,Binau,18 - 20 Jahre,35,22,13
False,8225010,Binau,20 - 25 Jahre,79,46,33
False,8225010,Binau,25 - 30 Jahre,96,56,40
False,8225010,Binau,30 - 35 Jahre,113,53,60
False,8225010,Binau,35 - 40 Jahre,106,52,54
False,8225010,Binau,40 - 45 Jahre,95,48,47
False,8225010,Binau,45 - 50 Jahre,91,47,44
False,8225010,Binau,50 - 55 Jahre,99,52,47
False,8225010,Binau,55 - 60 Jahre,91,48,43
False,8225010,Binau,60 - 65 Jahre,66,38,28
False,8225010,Binau,65 - 75 Jahre,106,51,55
False,8225010,Binau,75 und mehr Jahre,94,23,71
False,8225010,Binau,Insgesamt,1308,659,649
False,8225014,"Buchen (Odenwald), Stadt",unter 3 Jahre,637,337,300
False,8225014,"Buchen (Odenwald), Stadt",3 -  6 Jahre,722,359,363
False,8225014,"Buchen (Odenwald), Stadt",6 - 10 Jahre,945,487,458
False,8225014,"Buchen (Odenwald), Stadt",10 - 15 Jahre,1195,605,590
False,8225014,"Buchen (Odenwald), Stadt",15 - 18 Jahre,666,340,326
False,8225014,"Buchen (Odenwald), Stadt",18 - 20 Jahre,433,231,202
False,8225014,"Buchen (Odenwald), Stadt",20 - 25 Jahre,1028,542,486
False,8225014,"Buchen (Odenwald), Stadt",25 - 30 Jahre,1295,695,600
False,8225014,"Buchen (Odenwald), Stadt",30 - 35 Jahre,1536,777,759
False,8225014,"Buchen (Odenwald), Stadt",35 - 40 Jahre,1437,727,710
False,8225014,"Buchen (Odenwald), Stadt",40 - 45 Jahre,1251,633,618
False,8225014,"Buchen (Odenwald), Stadt",45 - 50 Jahre,1118,592,526
False,8225014,"Buchen (Odenwald), Stadt",50 - 55 Jahre,906,462,444
False,8225014,"Buchen (Odenwald), Stadt",55 - 60 Jahre,1217,630,587
False,8225014,"Buchen (Odenwald), Stadt",60 - 65 Jahre,950,468,482
False,8225014,"Buchen (Odenwald), Stadt",65 - 75 Jahre,1583,682,901
False,8225014,"Buchen (Odenwald), Stadt",75 und mehr Jahre,1172,342,830
False,8225014,"Buchen (Odenwald), Stadt",Insgesamt,18091,8909,9182
False,8225024,Fahrenbach,unter 3 Jahre,86,45,41
False,8225024,Fahrenbach,3 -  6 Jahre,100,45,55
False,8225024,Fahrenbach,6 - 10 Jahre,162,81,81
False,8225024,Fahrenbach,10 - 15 Jahre,175,82,93
False,8225024,Fahrenbach,15 - 18 Jahre,112,56,56
False,8225024,Fahrenbach,18 - 20 Jahre,71,39,32
False,8225024,Fahrenbach,20 - 25 Jahre,156,81,75
False,8225024,Fahrenbach,25 - 30 Jahre,210,101,109
False,8225024,Fahrenbach,30 - 35 Jahre,254,129,125
False,8225024,Fahrenbach,35 - 40 Jahre,239,126,113
False,8225024,Fahrenbach,40 - 45 Jahre,195,114,81
False,8225024,Fahrenbach,45 - 50 Jahre,170,81,89
False,8225024,Fahrenbach,50 - 55 Jahre,147,81,66
False,8225024,Fahrenbach,55 - 60 Jahre,178,85,93
False,8225024,Fahrenbach,60 - 65 Jahre,158,83,75
False,8225024,Fahrenbach,65 - 75 Jahre,259,112,147
False,8225024,Fahrenbach,75 und mehr Jahre,171,47,124
False,8225024,Fahrenbach,Insgesamt,2843,1388,1455
False,8225032,Hardheim,unter 3 Jahre,265,140,125
False,8225032,Hardheim,3 -  6 Jahre,298,150,148
False,8225032,Hardheim,6 - 10 Jahre,427,226,201
False,8225032,Hardheim,10 - 15 Jahre,449,231,218
False,8225032,Hardheim,15 - 18 Jahre,248,131,117
False,8225032,Hardheim,18 - 20 Jahre,185,100,85
False,8225032,Hardheim,20 - 25 Jahre,477,271,206
False,8225032,Hardheim,25 - 30 Jahre,671,352,319
False,8225032,Hardheim,30 - 35 Jahre,707,390,317
False,8225032,Hardheim,35 - 40 Jahre,615,316,299
False,8225032,Hardheim,40 - 45 Jahre,518,272,246
False,8225032,Hardheim,45 - 50 Jahre,416,218,198
False,8225032,Hardheim,50 - 55 Jahre,332,163,169
False,8225032,Hardheim,55 - 60 Jahre,463,239,224
False,8225032,Hardheim,60 - 65 Jahre,379,191,188
False,8225032,Hardheim,65 - 75 Jahre,706,284,422
False,8225032,Hardheim,75 und mehr Jahre,477,146,331
False,8225032,Hardheim,Insgesamt,7633,3820,3813
False,8225033,Haßmersheim,unter 3 Jahre,140,70,70
False,8225033,Haßmersheim,3 -  6 Jahre,201,102,99
False,8225033,Haßmersheim,6 - 10 Jahre,257,136,121
False,8225033,Haßmersheim,10 - 15 Jahre,294,155,139
False,8225033,Haßmersheim,15 - 18 Jahre,163,87,76
False,8225033,Haßmersheim,18 - 20 Jahre,113,55,58
False,8225033,Haßmersheim,20 - 25 Jahre,256,110,146
False,8225033,Haßmersheim,25 - 30 Jahre,392,194,198
False,8225033,Haßmersheim,30 - 35 Jahre,406,225,181
False,8225033,Haßmersheim,35 - 40 Jahre,413,197,216
False,8225033,Haßmersheim,40 - 45 Jahre,328,173,155
False,8225033,Haßmersheim,45 - 50 Jahre,268,134,134
False,8225033,Haßmersheim,50 - 55 Jahre,283,145,138
False,8225033,Haßmersheim,55 - 60 Jahre,325,170,155
False,8225033,Haßmersheim,60 - 65 Jahre,269,137,132
False,8225033,Haßmersheim,65 - 75 Jahre,417,156,261
False,8225033,Haßmersheim,75 und mehr Jahre,243,79,164
False,8225033,Haßmersheim,Insgesamt,4768,2325,2443
False,8225039,Höpfingen,unter 3 Jahre,124,56,68
False,8225039,Höpfingen,3 -  6 Jahre,102,49,53
False,8225039,Höpfingen,6 - 10 Jahre,167,91,76
False,8225039,Höpfingen,10 - 15 Jahre,171,77,94
False,8225039,Höpfingen,15 - 18 Jahre,99,51,48
False,8225039,Höpfingen,18 - 20 Jahre,54,25,29
False,8225039,Höpfingen,20 - 25 Jahre,183,100,83
False,8225039,Höpfingen,25 - 30 Jahre,251,134,117
False,8225039,Höpfingen,30 - 35 Jahre,258,138,120
False,8225039,Höpfingen,35 - 40 Jahre,275,152,123
False,8225039,Höpfingen,40 - 45 Jahre,193,102,91
False,8225039,Höpfingen,45 - 50 Jahre,177,91,86
False,8225039,Höpfingen,50 - 55 Jahre,129,71,58
False,8225039,Höpfingen,55 - 60 Jahre,217,110,107
False,8225039,Höpfingen,60 - 65 Jahre,174,85,89
False,8225039,Höpfingen,65 - 75 Jahre,288,126,162
False,8225039,Höpfingen,75 und mehr Jahre,160,45,115
False,8225039,Höpfingen,Insgesamt,3022,1503,1519
False,8225042,Hüffenhardt,unter 3 Jahre,58,27,31
False,8225042,Hüffenhardt,3 -  6 Jahre,87,40,47
False,8225042,Hüffenhardt,6 - 10 Jahre,111,51,60
False,8225042,Hüffenhardt,10 - 15 Jahre,97,46,51
False,8225042,Hüffenhardt,15 - 18 Jahre,65,33,32
False,8225042,Hüffenhardt,18 - 20 Jahre,40,22,18
False,8225042,Hüffenhardt,20 - 25 Jahre,101,42,59
False,8225042,Hüffenhardt,25 - 30 Jahre,146,71,75
False,8225042,Hüffenhardt,30 - 35 Jahre,185,105,80
False,8225042,Hüffenhardt,35 - 40 Jahre,149,75,74
False,8225042,Hüffenhardt,40 - 45 Jahre,146,64,82
False,8225042,Hüffenhardt,45 - 50 Jahre,116,71,45
False,8225042,Hüffenhardt,50 - 55 Jahre,112,57,55
False,8225042,Hüffenhardt,55 - 60 Jahre,122,54,68
False,8225042,Hüffenhardt,60 - 65 Jahre,116,55,61
False,8225042,Hüffenhardt,65 - 75 Jahre,192,83,109
False,8225042,Hüffenhardt,75 und mehr Jahre,178,49,129
False,8225042,Hüffenhardt,Insgesamt,2021,945,1076
False,8225052,Limbach,unter 3 Jahre,166,90,76
False,8225052,Limbach,3 -  6 Jahre,191,84,107
False,8225052,Limbach,6 - 10 Jahre,265,138,127
False,8225052,Limbach,10 - 15 Jahre,303,153,150
False,8225052,Limbach,15 - 18 Jahre,162,81,81
False,8225052,Limbach,18 - 20 Jahre,96,51,45
False,8225052,Limbach,20 - 25 Jahre,262,148,114
False,8225052,Limbach,25 - 30 Jahre,365,201,164
False,8225052,Limbach,30 - 35 Jahre,419,205,214
False,8225052,Limbach,35 - 40 Jahre,396,197,199
False,8225052,Limbach,40 - 45 Jahre,337,187,150
False,8225052,Limbach,45 - 50 Jahre,241,139,102
False,8225052,Limbach,50 - 55 Jahre,205,101,104
False,8225052,Limbach,55 - 60 Jahre,289,159,130
False,8225052,Limbach,60 - 65 Jahre,230,100,130
False,8225052,Limbach,65 - 75 Jahre,463,202,261
False,8225052,Limbach,75 und mehr Jahre,271,93,178
False,8225052,Limbach,Insgesamt,4661,2329,2332
False,8225058,"Mosbach, Stadt",unter 3 Jahre,722,382,340
False,8225058,"Mosbach, Stadt",3 -  6 Jahre,799,424,375
False,8225058,"Mosbach, Stadt",6 - 10 Jahre,1164,560,604
False,8225058,"Mosbach, Stadt",10 - 15 Jahre,1321,671,650
False,8225058,"Mosbach, Stadt",15 - 18 Jahre,845,430,415
False,8225058,"Mosbach, Stadt",18 - 20 Jahre,654,371,283
False,8225058,"Mosbach, Stadt",20 - 25 Jahre,1695,893,802
False,8225058,"Mosbach, Stadt",25 - 30 Jahre,2037,1115,922
False,8225058,"Mosbach, Stadt",30 - 35 Jahre,2207,1190,1017
False,8225058,"Mosbach, Stadt",35 - 40 Jahre,1810,895,915
False,8225058,"Mosbach, Stadt",40 - 45 Jahre,1699,832,867
False,8225058,"Mosbach, Stadt",45 - 50 Jahre,1614,796,818
False,8225058,"Mosbach, Stadt",50 - 55 Jahre,1521,783,738
False,8225058,"Mosbach, Stadt",55 - 60 Jahre,1692,850,842
False,8225058,"Mosbach, Stadt",60 - 65 Jahre,1259,632,627
False,8225058,"Mosbach, Stadt",65 - 75 Jahre,2278,924,1354
False,8225058,"Mosbach, Stadt",75 und mehr Jahre,1651,484,1167
False,8225058,"Mosbach, Stadt",Insgesamt,24968,12232,12736
False,8225060,Mudau,unter 3 Jahre,185,91,94
False,8225060,Mudau,3 -  6 Jahre,224,112,112
False,8225060,Mudau,6 - 10 Jahre,275,145,130
False,8225060,Mudau,10 - 15 Jahre,343,188,155
False,8225060,Mudau,15 - 18 Jahre,185,98,87
False,8225060,Mudau,18 - 20 Jahre,113,56,57
False,8225060,Mudau,20 - 25 Jahre,295,159,136
False,8225060,Mudau,25 - 30 Jahre,420,229,191
False,8225060,Mudau,30 - 35 Jahre,491,261,230
False,8225060,Mudau,35 - 40 Jahre,458,233,225
False,8225060,Mudau,40 - 45 Jahre,383,222,161
False,8225060,Mudau,45 - 50 Jahre,260,149,111
False,8225060,Mudau,50 - 55 Jahre,205,99,106
False,8225060,Mudau,55 - 60 Jahre,294,150,144
False,8225060,Mudau,60 - 65 Jahre,253,124,129
False,8225060,Mudau,65 - 75 Jahre,510,216,294
False,8225060,Mudau,75 und mehr Jahre,276,70,206
False,8225060,Mudau,Insgesamt,5170,2602,2568
False,8225064,Neckargerach,unter 3 Jahre,92,52,40
False,8225064,Neckargerach,3 -  6 Jahre,102,48,54
False,8225064,Neckargerach,6 - 10 Jahre,134,66,68
False,8225064,Neckargerach,10 - 15 Jahre,120,52,68
False,8225064,Neckargerach,15 - 18 Jahre,62,33,29
False,8225064,Neckargerach,18 - 20 Jahre,49,27,22
False,8225064,Neckargerach,20 - 25 Jahre,129,69,60
False,8225064,Neckargerach,25 - 30 Jahre,198,102,96
False,8225064,Neckargerach,30 - 35 Jahre,218,112,106
False,8225064,Neckargerach,35 - 40 Jahre,167,97,70
False,8225064,Neckargerach,40 - 45 Jahre,168,78,90
False,8225064,Neckargerach,45 - 50 Jahre,140,66,74
False,8225064,Neckargerach,50 - 55 Jahre,134,63,71
False,8225064,Neckargerach,55 - 60 Jahre,187,106,81
False,8225064,Neckargerach,60 - 65 Jahre,120,57,63
False,8225064,Neckargerach,65 - 75 Jahre,235,88,147
False,8225064,Neckargerach,75 und mehr Jahre,145,44,101
False,8225064,Neckargerach,Insgesamt,2400,1160,1240
False,8225067,Neckarzimmern,unter 3 Jahre,65,28,37
False,8225067,Neckarzimmern,3 -  6 Jahre,78,48,30
False,8225067,Neckarzimmern,6 - 10 Jahre,58,27,31
False,8225067,Neckarzimmern,10 - 15 Jahre,87,41,46
False,8225067,Neckarzimmern,15 - 18 Jahre,59,26,33
False,8225067,Neckarzimmern,18 - 20 Jahre,37,16,21
False,8225067,Neckarzimmern,20 - 25 Jahre,124,62,62
False,8225067,Neckarzimmern,25 - 30 Jahre,171,97,74
False,8225067,Neckarzimmern,30 - 35 Jahre,142,71,71
False,8225067,Neckarzimmern,35 - 40 Jahre,117,57,60
False,8225067,Neckarzimmern,40 - 45 Jahre,115,54,61
False,8225067,Neckarzimmern,45 - 50 Jahre,117,49,68
False,8225067,Neckarzimmern,50 - 55 Jahre,104,61,43
False,8225067,Neckarzimmern,55 - 60 Jahre,117,67,50
False,8225067,Neckarzimmern,60 - 65 Jahre,62,26,36
False,8225067,Neckarzimmern,65 - 75 Jahre,120,47,73
False,8225067,Neckarzimmern,75 und mehr Jahre,87,25,62
False,8225067,Neckarzimmern,Insgesamt,1660,802,858
False,8225068,Neunkirchen,unter 3 Jahre,64,35,29
False,8225068,Neunkirchen,3 -  6 Jahre,78,33,45
False,8225068,Neunkirchen,6 - 10 Jahre,76,37,39
False,8225068,Neunkirchen,10 - 15 Jahre,115,59,56
False,8225068,Neunkirchen,15 - 18 Jahre,43,23,20
False,8225068,Neunkirchen,18 - 20 Jahre,32,19,13
False,8225068,Neunkirchen,20 - 25 Jahre,80,50,30
False,8225068,Neunkirchen,25 - 30 Jahre,120,57,63
False,8225068,Neunkirchen,30 - 35 Jahre,177,92,85
False,8225068,Neunkirchen,35 - 40 Jahre,132,68,64
False,8225068,Neunkirchen,40 - 45 Jahre,110,61,49
False,8225068,Neunkirchen,45 - 50 Jahre,84,43,41
False,8225068,Neunkirchen,50 - 55 Jahre,83,39,44
False,8225068,Neunkirchen,55 - 60 Jahre,118,61,57
False,8225068,Neunkirchen,60 - 65 Jahre,111,52,59
False,8225068,Neunkirchen,65 - 75 Jahre,147,63,84
False,8225068,Neunkirchen,75 und mehr Jahre,110,29,81
False,8225068,Neunkirchen,Insgesamt,1680,821,859
False,8225074,Obrigheim,unter 3 Jahre,175,81,94
False,8225074,Obrigheim,3 -  6 Jahre,202,92,110
False,8225074,Obrigheim,6 - 10 Jahre,244,101,143
False,8225074,Obrigheim,10 - 15 Jahre,296,141,155
False,8225074,Obrigheim,15 - 18 Jahre,194,98,96
False,8225074,Obrigheim,18 - 20 Jahre,114,65,49
False,8225074,Obrigheim,20 - 25 Jahre,341,181,160
False,8225074,Obrigheim,25 - 30 Jahre,414,232,182
False,8225074,Obrigheim,30 - 35 Jahre,437,246,191
False,8225074,Obrigheim,35 - 40 Jahre,403,201,202
False,8225074,Obrigheim,40 - 45 Jahre,377,193,184
False,8225074,Obrigheim,45 - 50 Jahre,377,178,199
False,8225074,Obrigheim,50 - 55 Jahre,376,197,179
False,8225074,Obrigheim,55 - 60 Jahre,383,194,189
False,8225074,Obrigheim,60 - 65 Jahre,315,154,161
False,8225074,Obrigheim,65 - 75 Jahre,474,200,274
False,8225074,Obrigheim,75 und mehr Jahre,274,90,184
False,8225074,Obrigheim,Insgesamt,5396,2644,2752
False,8225075,"Osterburken, Stadt",unter 3 Jahre,178,101,77
False,8225075,"Osterburken, Stadt",3 -  6 Jahre,188,102,86
False,8225075,"Osterburken, Stadt",6 - 10 Jahre,265,143,122
False,8225075,"Osterburken, Stadt",10 - 15 Jahre,342,181,161
False,8225075,"Osterburken, Stadt",15 - 18 Jahre,207,114,93
False,8225075,"Osterburken, Stadt",18 - 20 Jahre,157,79,78
False,8225075,"Osterburken, Stadt",20 - 25 Jahre,385,205,180
False,8225075,"Osterburken, Stadt",25 - 30 Jahre,468,236,232
False,8225075,"Osterburken, Stadt",30 - 35 Jahre,500,268,232
False,8225075,"Osterburken, Stadt",35 - 40 Jahre,411,221,190
False,8225075,"Osterburken, Stadt",40 - 45 Jahre,412,212,200
False,8225075,"Osterburken, Stadt",45 - 50 Jahre,353,185,168
False,8225075,"Osterburken, Stadt",50 - 55 Jahre,280,150,130
False,8225075,"Osterburken, Stadt",55 - 60 Jahre,398,196,202
False,8225075,"Osterburken, Stadt",60 - 65 Jahre,313,154,159
False,8225075,"Osterburken, Stadt",65 - 75 Jahre,516,220,296
False,8225075,"Osterburken, Stadt",75 und mehr Jahre,447,141,306
False,8225075,"Osterburken, Stadt",Insgesamt,5820,2908,2912
False,8225082,Rosenberg,unter 3 Jahre,62,27,35
False,8225082,Rosenberg,3 -  6 Jahre,81,44,37
False,8225082,Rosenberg,6 - 10 Jahre,107,55,52
False,8225082,Rosenberg,10 - 15 Jahre,133,62,71
False,8225082,Rosenberg,15 - 18 Jahre,64,34,30
False,8225082,Rosenberg,18 - 20 Jahre,39,26,13
False,8225082,Rosenberg,20 - 25 Jahre,140,71,69
False,8225082,Rosenberg,25 - 30 Jahre,156,82,74
False,8225082,Rosenberg,30 - 35 Jahre,199,112,87
False,8225082,Rosenberg,35 - 40 Jahre,150,71,79
False,8225082,Rosenberg,40 - 45 Jahre,150,64,86
False,8225082,Rosenberg,45 - 50 Jahre,143,81,62
False,8225082,Rosenberg,50 - 55 Jahre,92,50,42
False,8225082,Rosenberg,55 - 60 Jahre,166,81,85
False,8225082,Rosenberg,60 - 65 Jahre,113,58,55
False,8225082,Rosenberg,65 - 75 Jahre,253,120,133
False,8225082,Rosenberg,75 und mehr Jahre,154,41,113
False,8225082,Rosenberg,Insgesamt,2202,1079,1123
False,8225091,Seckach,unter 3 Jahre,137,66,71
False,8225091,Seckach,3 -  6 Jahre,163,79,84
False,8225091,Seckach,6 - 10 Jahre,247,135,112
False,8225091,Seckach,10 - 15 Jahre,365,201,164
False,8225091,Seckach,15 - 18 Jahre,194,102,92
False,8225091,Seckach,18 - 20 Jahre,104,67,37
False,8225091,Seckach,20 - 25 Jahre,261,131,130
False,8225091,Seckach,25 - 30 Jahre,340,179,161
False,8225091,Seckach,30 - 35 Jahre,402,220,182
False,8225091,Seckach,35 - 40 Jahre,335,170,165
False,8225091,Seckach,40 - 45 Jahre,306,151,155
False,8225091,Seckach,45 - 50 Jahre,240,126,114
False,8225091,Seckach,50 - 55 Jahre,187,91,96
False,8225091,Seckach,55 - 60 Jahre,256,127,129
False,8225091,Seckach,60 - 65 Jahre,204,102,102
False,8225091,Seckach,65 - 75 Jahre,372,150,222
False,8225091,Seckach,75 und mehr Jahre,231,78,153
False,8225091,Seckach,Insgesamt,4344,2175,2169
False,8225109,"Walldürn, Stadt",unter 3 Jahre,363,183,180
False,8225109,"Walldürn, Stadt",3 -  6 Jahre,389,199,190
False,8225109,"Walldürn, Stadt",6 - 10 Jahre,499,249,250
False,8225109,"Walldürn, Stadt",10 - 15 Jahre,679,340,339
False,8225109,"Walldürn, Stadt",15 - 18 Jahre,387,202,185
False,8225109,"Walldürn, Stadt",18 - 20 Jahre,263,134,129
False,8225109,"Walldürn, Stadt",20 - 25 Jahre,658,329,329
False,8225109,"Walldürn, Stadt",25 - 30 Jahre,910,509,401
False,8225109,"Walldürn, Stadt",30 - 35 Jahre,1008,542,466
False,8225109,"Walldürn, Stadt",35 - 40 Jahre,900,446,454
False,8225109,"Walldürn, Stadt",40 - 45 Jahre,773,399,374
False,8225109,"Walldürn, Stadt",45 - 50 Jahre,696,363,333
False,8225109,"Walldürn, Stadt",50 - 55 Jahre,608,310,298
False,8225109,"Walldürn, Stadt",55 - 60 Jahre,865,438,427
False,8225109,"Walldürn, Stadt",60 - 65 Jahre,575,280,295
False,8225109,"Walldürn, Stadt",65 - 75 Jahre,1095,438,657
False,8225109,"Walldürn, Stadt",75 und mehr Jahre,736,208,528
False,8225109,"Walldürn, Stadt",Insgesamt,11404,5569,5835
False,8225113,Zwingenberg,unter 3 Jahre,21,11,10
False,8225113,Zwingenberg,3 -  6 Jahre,23,9,14
False,8225113,Zwingenberg,6 - 10 Jahre,34,15,19
False,8225113,Zwingenberg,10 - 15 Jahre,59,24,35
False,8225113,Zwingenberg,15 - 18 Jahre,26,12,14
False,8225113,Zwingenberg,18 - 20 Jahre,14,6,8
False,8225113,Zwingenberg,20 - 25 Jahre,52,34,18
False,8225113,Zwingenberg,25 - 30 Jahre,29,23,6
False,8225113,Zwingenberg,30 - 35 Jahre,50,23,27
False,8225113,Zwingenberg,35 - 40 Jahre,70,32,38
False,8225113,Zwingenberg,40 - 45 Jahre,48,20,28
False,8225113,Zwingenberg,45 - 50 Jahre,50,31,19
False,8225113,Zwingenberg,50 - 55 Jahre,45,18,27
False,8225113,Zwingenberg,55 - 60 Jahre,38,22,16
False,8225113,Zwingenberg,60 - 65 Jahre,44,22,22
False,8225113,Zwingenberg,65 - 75 Jahre,78,35,43
False,8225113,Zwingenberg,75 und mehr Jahre,50,15,35
False,8225113,Zwingenberg,Insgesamt,731,352,379
False,8225114,"Ravenstein, Stadt",unter 3 Jahre,100,53,47
False,8225114,"Ravenstein, Stadt",3 -  6 Jahre,122,67,55
False,8225114,"Ravenstein, Stadt",6 - 10 Jahre,166,94,72
False,8225114,"Ravenstein, Stadt",10 - 15 Jahre,204,95,109
False,8225114,"Ravenstein, Stadt",15 - 18 Jahre,121,70,51
False,8225114,"Ravenstein, Stadt",18 - 20 Jahre,52,25,27
False,8225114,"Ravenstein, Stadt",20 - 25 Jahre,186,92,94
False,8225114,"Ravenstein, Stadt",25 - 30 Jahre,243,132,111
False,8225114,"Ravenstein, Stadt",30 - 35 Jahre,257,148,109
False,8225114,"Ravenstein, Stadt",35 - 40 Jahre,250,113,137
False,8225114,"Ravenstein, Stadt",40 - 45 Jahre,180,103,77
False,8225114,"Ravenstein, Stadt",45 - 50 Jahre,152,76,76
False,8225114,"Ravenstein, Stadt",50 - 55 Jahre,146,74,72
False,8225114,"Ravenstein, Stadt",55 - 60 Jahre,186,101,85
False,8225114,"Ravenstein, Stadt",60 - 65 Jahre,176,86,90
False,8225114,"Ravenstein, Stadt",65 - 75 Jahre,265,115,150
False,8225114,"Ravenstein, Stadt",75 und mehr Jahre,198,65,133
False,8225114,"Ravenstein, Stadt",Insgesamt,3004,1509,1495
False,8225115,Schefflenz,unter 3 Jahre,137,70,67
False,8225115,Schefflenz,3 -  6 Jahre,199,88,111
False,8225115,Schefflenz,6 - 10 Jahre,247,124,123
False,8225115,Schefflenz,10 - 15 Jahre,273,146,127
False,8225115,Schefflenz,15 - 18 Jahre,157,75,82
False,8225115,Schefflenz,18 - 20 Jahre,81,40,41
False,8225115,Schefflenz,20 - 25 Jahre,238,131,107
False,8225115,Schefflenz,25 - 30 Jahre,297,141,156
False,8225115,Schefflenz,30 - 35 Jahre,414,210,204
False,8225115,Schefflenz,35 - 40 Jahre,363,193,170
False,8225115,Schefflenz,40 - 45 Jahre,310,156,154
False,8225115,Schefflenz,45 - 50 Jahre,279,150,129
False,8225115,Schefflenz,50 - 55 Jahre,218,110,108
False,8225115,Schefflenz,55 - 60 Jahre,282,151,131
False,8225115,Schefflenz,60 - 65 Jahre,222,111,111
False,8225115,Schefflenz,65 - 75 Jahre,423,175,248
False,8225115,Schefflenz,75 und mehr Jahre,279,83,196
False,8225115,Schefflenz,Insgesamt,4419,2154,2265
False,8225116,Schwarzach,unter 3 Jahre,87,44,43
False,8225116,Schwarzach,3 -  6 Jahre,85,49,36
False,8225116,Schwarzach,6 - 10 Jahre,120,60,60
False,8225116,Schwarzach,10 - 15 Jahre,165,85,80
False,8225116,Schwarzach,15 - 18 Jahre,104,64,40
False,8225116,Schwarzach,18 - 20 Jahre,67,41,26
False,8225116,Schwarzach,20 - 25 Jahre,229,118,111
False,8225116,Schwarzach,25 - 30 Jahre,380,216,164
False,8225116,Schwarzach,30 - 35 Jahre,486,295,191
False,8225116,Schwarzach,35 - 40 Jahre,307,177,130
False,8225116,Schwarzach,40 - 45 Jahre,229,127,102
False,8225116,Schwarzach,45 - 50 Jahre,200,110,90
False,8225116,Schwarzach,50 - 55 Jahre,139,80,59
False,8225116,Schwarzach,55 - 60 Jahre,159,70,89
False,8225116,Schwarzach,60 - 65 Jahre,106,55,51
False,8225116,Schwarzach,65 - 75 Jahre,176,82,94
False,8225116,Schwarzach,75 und mehr Jahre,155,32,123
False,8225116,Schwarzach,Insgesamt,3194,1705,1489
False,8225117,Elztal,unter 3 Jahre,222,114,108
False,8225117,Elztal,3 -  6 Jahre,221,124,97
False,8225117,Elztal,6 - 10 Jahre,278,144,134
False,8225117,Elztal,10 - 15 Jahre,351,168,183
False,8225117,Elztal,15 - 18 Jahre,219,109,110
False,8225117,Elztal,18 - 20 Jahre,132,70,62
False,8225117,Elztal,20 - 25 Jahre,338,170,168
False,8225117,Elztal,25 - 30 Jahre,431,221,210
False,8225117,Elztal,30 - 35 Jahre,513,263,250
False,8225117,Elztal,35 - 40 Jahre,472,239,233
False,8225117,Elztal,40 - 45 Jahre,389,206,183
False,8225117,Elztal,45 - 50 Jahre,398,199,199
False,8225117,Elztal,50 - 55 Jahre,292,160,132
False,8225117,Elztal,55 - 60 Jahre,384,191,193
False,8225117,Elztal,60 - 65 Jahre,310,173,137
False,8225117,Elztal,65 - 75 Jahre,473,209,264
False,8225117,Elztal,75 und mehr Jahre,255,88,167
False,8225117,Elztal,Insgesamt,5678,2848,2830
False,8225118,Waldbrunn,unter 3 Jahre,166,78,88
False,8225118,Waldbrunn,3 -  6 Jahre,171,81,90
False,8225118,Waldbrunn,6 - 10 Jahre,230,115,115
False,8225118,Waldbrunn,10 - 15 Jahre,261,143,118
False,8225118,Waldbrunn,15 - 18 Jahre,132,70,62
False,8225118,Waldbrunn,18 - 20 Jahre,84,42,42
False,8225118,Waldbrunn,20 - 25 Jahre,260,128,132
False,8225118,Waldbrunn,25 - 30 Jahre,364,185,179
False,8225118,Waldbrunn,30 - 35 Jahre,396,214,182
False,8225118,Waldbrunn,35 - 40 Jahre,396,189,207
False,8225118,Waldbrunn,40 - 45 Jahre,350,190,160
False,8225118,Waldbrunn,45 - 50 Jahre,276,154,122
False,8225118,Waldbrunn,50 - 55 Jahre,236,115,121
False,8225118,Waldbrunn,55 - 60 Jahre,343,187,156
False,8225118,Waldbrunn,60 - 65 Jahre,267,124,143
False,8225118,Waldbrunn,65 - 75 Jahre,459,194,265
False,8225118,Waldbrunn,75 und mehr Jahre,341,106,235
False,8225118,Waldbrunn,Insgesamt,4732,2315,2417
False,8226,Landkreis Rhein-Neckar-Kreis,unter 3 Jahre,16282,8306,7976
False,8226,Landkreis Rhein-Neckar-Kreis,3 -  6 Jahre,17267,8895,8372
False,8226,Landkreis Rhein-Neckar-Kreis,6 - 10 Jahre,22832,11811,11021
False,8226,Landkreis Rhein-Neckar-Kreis,10 - 15 Jahre,26868,13692,13176
False,8226,Landkreis Rhein-Neckar-Kreis,15 - 18 Jahre,15535,8080,7455
False,8226,Landkreis Rhein-Neckar-Kreis,18 - 20 Jahre,10131,5200,4931
False,8226,Landkreis Rhein-Neckar-Kreis,20 - 25 Jahre,28088,14219,13869
False,8226,Landkreis Rhein-Neckar-Kreis,25 - 30 Jahre,42316,21716,20600
False,8226,Landkreis Rhein-Neckar-Kreis,30 - 35 Jahre,46941,24017,22924
False,8226,Landkreis Rhein-Neckar-Kreis,35 - 40 Jahre,42079,21418,20661
False,8226,Landkreis Rhein-Neckar-Kreis,40 - 45 Jahre,36428,18205,18223
False,8226,Landkreis Rhein-Neckar-Kreis,45 - 50 Jahre,34710,17362,17348
False,8226,Landkreis Rhein-Neckar-Kreis,50 - 55 Jahre,32495,16505,15990
False,8226,Landkreis Rhein-Neckar-Kreis,55 - 60 Jahre,37466,19016,18450
False,8226,Landkreis Rhein-Neckar-Kreis,60 - 65 Jahre,27718,13787,13931
False,8226,Landkreis Rhein-Neckar-Kreis,65 - 75 Jahre,45495,19455,26040
False,8226,Landkreis Rhein-Neckar-Kreis,75 und mehr Jahre,29794,9127,20667
False,8226,Landkreis Rhein-Neckar-Kreis,Insgesamt,512445,250811,261634
False,8226003,Altlußheim,unter 3 Jahre,189,89,100
False,8226003,Altlußheim,3 -  6 Jahre,219,104,115
False,8226003,Altlußheim,6 - 10 Jahre,240,121,119
False,8226003,Altlußheim,10 - 15 Jahre,273,135,138
False,8226003,Altlußheim,15 - 18 Jahre,137,78,59
False,8226003,Altlußheim,18 - 20 Jahre,88,49,39
False,8226003,Altlußheim,20 - 25 Jahre,271,141,130
False,8226003,Altlußheim,25 - 30 Jahre,434,212,222
False,8226003,Altlußheim,30 - 35 Jahre,508,240,268
False,8226003,Altlußheim,35 - 40 Jahre,424,230,194
False,8226003,Altlußheim,40 - 45 Jahre,390,204,186
False,8226003,Altlußheim,45 - 50 Jahre,331,174,157
False,8226003,Altlußheim,50 - 55 Jahre,378,184,194
False,8226003,Altlußheim,55 - 60 Jahre,408,210,198
False,8226003,Altlußheim,60 - 65 Jahre,284,156,128
False,8226003,Altlußheim,65 - 75 Jahre,448,182,266
False,8226003,Altlußheim,75 und mehr Jahre,324,96,228
False,8226003,Altlußheim,Insgesamt,5346,2605,2741
False,8226006,Bammental,unter 3 Jahre,185,99,86
False,8226006,Bammental,3 -  6 Jahre,221,118,103
False,8226006,Bammental,6 - 10 Jahre,322,168,154
False,8226006,Bammental,10 - 15 Jahre,379,197,182
False,8226006,Bammental,15 - 18 Jahre,254,138,116
False,8226006,Bammental,18 - 20 Jahre,168,96,72
False,8226006,Bammental,20 - 25 Jahre,354,202,152
False,8226006,Bammental,25 - 30 Jahre,400,221,179
False,8226006,Bammental,30 - 35 Jahre,552,270,282
False,8226006,Bammental,35 - 40 Jahre,543,260,283
False,8226006,Bammental,40 - 45 Jahre,520,258,262
False,8226006,Bammental,45 - 50 Jahre,414,223,191
False,8226006,Bammental,50 - 55 Jahre,397,203,194
False,8226006,Bammental,55 - 60 Jahre,452,225,227
False,8226006,Bammental,60 - 65 Jahre,296,135,161
False,8226006,Bammental,65 - 75 Jahre,560,229,331
False,8226006,Bammental,75 und mehr Jahre,380,102,278
False,8226006,Bammental,Insgesamt,6397,3144,3253
False,8226009,Brühl,unter 3 Jahre,376,185,191
False,8226009,Brühl,3 -  6 Jahre,447,219,228
False,8226009,Brühl,6 - 10 Jahre,574,298,276
False,8226009,Brühl,10 - 15 Jahre,720,389,331
False,8226009,Brühl,15 - 18 Jahre,412,202,210
False,8226009,Brühl,18 - 20 Jahre,284,146,138
False,8226009,Brühl,20 - 25 Jahre,639,326,313
False,8226009,Brühl,25 - 30 Jahre,1033,529,504
False,8226009,Brühl,30 - 35 Jahre,1170,564,606
False,8226009,Brühl,35 - 40 Jahre,1258,611,647
False,8226009,Brühl,40 - 45 Jahre,1081,536,545
False,8226009,Brühl,45 - 50 Jahre,1149,590,559
False,8226009,Brühl,50 - 55 Jahre,999,494,505
False,8226009,Brühl,55 - 60 Jahre,1056,541,515
False,8226009,Brühl,60 - 65 Jahre,776,389,387
False,8226009,Brühl,65 - 75 Jahre,1300,565,735
False,8226009,Brühl,75 und mehr Jahre,803,254,549
False,8226009,Brühl,Insgesamt,14077,6838,7239
False,8226010,Dielheim,unter 3 Jahre,311,158,153
False,8226010,Dielheim,3 -  6 Jahre,325,155,170
False,8226010,Dielheim,6 - 10 Jahre,443,233,210
False,8226010,Dielheim,10 - 15 Jahre,493,251,242
False,8226010,Dielheim,15 - 18 Jahre,213,115,98
False,8226010,Dielheim,18 - 20 Jahre,162,91,71
False,8226010,Dielheim,20 - 25 Jahre,406,203,203
False,8226010,Dielheim,25 - 30 Jahre,687,356,331
False,8226010,Dielheim,30 - 35 Jahre,808,383,425
False,8226010,Dielheim,35 - 40 Jahre,716,354,362
False,8226010,Dielheim,40 - 45 Jahre,579,297,282
False,8226010,Dielheim,45 - 50 Jahre,563,297,266
False,8226010,Dielheim,50 - 55 Jahre,460,254,206
False,8226010,Dielheim,55 - 60 Jahre,586,287,299
False,8226010,Dielheim,60 - 65 Jahre,410,199,211
False,8226010,Dielheim,65 - 75 Jahre,664,286,378
False,8226010,Dielheim,75 und mehr Jahre,320,104,216
False,8226010,Dielheim,Insgesamt,8146,4023,4123
False,8226012,Dossenheim,unter 3 Jahre,399,204,195
False,8226012,Dossenheim,3 -  6 Jahre,393,204,189
False,8226012,Dossenheim,6 - 10 Jahre,474,244,230
False,8226012,Dossenheim,10 - 15 Jahre,515,267,248
False,8226012,Dossenheim,15 - 18 Jahre,242,135,107
False,8226012,Dossenheim,18 - 20 Jahre,185,82,103
False,8226012,Dossenheim,20 - 25 Jahre,746,336,410
False,8226012,Dossenheim,25 - 30 Jahre,1252,601,651
False,8226012,Dossenheim,30 - 35 Jahre,1378,702,676
False,8226012,Dossenheim,35 - 40 Jahre,1119,562,557
False,8226012,Dossenheim,40 - 45 Jahre,834,404,430
False,8226012,Dossenheim,45 - 50 Jahre,715,374,341
False,8226012,Dossenheim,50 - 55 Jahre,594,287,307
False,8226012,Dossenheim,55 - 60 Jahre,712,361,351
False,8226012,Dossenheim,60 - 65 Jahre,515,249,266
False,8226012,Dossenheim,65 - 75 Jahre,851,337,514
False,8226012,Dossenheim,75 und mehr Jahre,583,189,394
False,8226012,Dossenheim,Insgesamt,11507,5538,5969
False,8226013,"Eberbach, Stadt",unter 3 Jahre,496,260,236
False,8226013,"Eberbach, Stadt",3 -  6 Jahre,494,261,233
False,8226013,"Eberbach, Stadt",6 - 10 Jahre,688,378,310
False,8226013,"Eberbach, Stadt",10 - 15 Jahre,761,376,385
False,8226013,"Eberbach, Stadt",15 - 18 Jahre,494,248,246
False,8226013,"Eberbach, Stadt",18 - 20 Jahre,299,143,156
False,8226013,"Eberbach, Stadt",20 - 25 Jahre,854,407,447
False,8226013,"Eberbach, Stadt",25 - 30 Jahre,1234,624,610
False,8226013,"Eberbach, Stadt",30 - 35 Jahre,1220,613,607
False,8226013,"Eberbach, Stadt",35 - 40 Jahre,1107,569,538
False,8226013,"Eberbach, Stadt",40 - 45 Jahre,984,484,500
False,8226013,"Eberbach, Stadt",45 - 50 Jahre,949,453,496
False,8226013,"Eberbach, Stadt",50 - 55 Jahre,907,431,476
False,8226013,"Eberbach, Stadt",55 - 60 Jahre,1235,637,598
False,8226013,"Eberbach, Stadt",60 - 65 Jahre,956,465,491
False,8226013,"Eberbach, Stadt",65 - 75 Jahre,1702,713,989
False,8226013,"Eberbach, Stadt",75 und mehr Jahre,1360,389,971
False,8226013,"Eberbach, Stadt",Insgesamt,15740,7451,8289
False,8226017,Epfenbach,unter 3 Jahre,74,41,33
False,8226017,Epfenbach,3 -  6 Jahre,79,39,40
False,8226017,Epfenbach,6 - 10 Jahre,114,66,48
False,8226017,Epfenbach,10 - 15 Jahre,145,61,84
False,8226017,Epfenbach,15 - 18 Jahre,90,45,45
False,8226017,Epfenbach,18 - 20 Jahre,56,32,24
False,8226017,Epfenbach,20 - 25 Jahre,124,70,54
False,8226017,Epfenbach,25 - 30 Jahre,177,93,84
False,8226017,Epfenbach,30 - 35 Jahre,205,119,86
False,8226017,Epfenbach,35 - 40 Jahre,190,98,92
False,8226017,Epfenbach,40 - 45 Jahre,190,89,101
False,8226017,Epfenbach,45 - 50 Jahre,177,103,74
False,8226017,Epfenbach,50 - 55 Jahre,129,58,71
False,8226017,Epfenbach,55 - 60 Jahre,143,88,55
False,8226017,Epfenbach,60 - 65 Jahre,144,68,76
False,8226017,Epfenbach,65 - 75 Jahre,201,88,113
False,8226017,Epfenbach,75 und mehr Jahre,116,37,79
False,8226017,Epfenbach,Insgesamt,2354,1195,1159
False,8226018,"Eppelheim, Stadt",unter 3 Jahre,394,207,187
False,8226018,"Eppelheim, Stadt",3 -  6 Jahre,425,232,193
False,8226018,"Eppelheim, Stadt",6 - 10 Jahre,522,265,257
False,8226018,"Eppelheim, Stadt",10 - 15 Jahre,582,291,291
False,8226018,"Eppelheim, Stadt",15 - 18 Jahre,321,175,146
False,8226018,"Eppelheim, Stadt",18 - 20 Jahre,229,130,99
False,8226018,"Eppelheim, Stadt",20 - 25 Jahre,785,376,409
False,8226018,"Eppelheim, Stadt",25 - 30 Jahre,1359,706,653
False,8226018,"Eppelheim, Stadt",30 - 35 Jahre,1397,713,684
False,8226018,"Eppelheim, Stadt",35 - 40 Jahre,1065,547,518
False,8226018,"Eppelheim, Stadt",40 - 45 Jahre,936,435,501
False,8226018,"Eppelheim, Stadt",45 - 50 Jahre,898,466,432
False,8226018,"Eppelheim, Stadt",50 - 55 Jahre,882,433,449
False,8226018,"Eppelheim, Stadt",55 - 60 Jahre,1035,512,523
False,8226018,"Eppelheim, Stadt",60 - 65 Jahre,699,382,317
False,8226018,"Eppelheim, Stadt",65 - 75 Jahre,1154,467,687
False,8226018,"Eppelheim, Stadt",75 und mehr Jahre,677,218,459
False,8226018,"Eppelheim, Stadt",Insgesamt,13360,6555,6805
False,8226020,Eschelbronn,unter 3 Jahre,84,41,43
False,8226020,Eschelbronn,3 -  6 Jahre,106,57,49
False,8226020,Eschelbronn,6 - 10 Jahre,129,65,64
False,8226020,Eschelbronn,10 - 15 Jahre,156,71,85
False,8226020,Eschelbronn,15 - 18 Jahre,88,46,42
False,8226020,Eschelbronn,18 - 20 Jahre,62,37,25
False,8226020,Eschelbronn,20 - 25 Jahre,131,63,68
False,8226020,Eschelbronn,25 - 30 Jahre,192,94,98
False,8226020,Eschelbronn,30 - 35 Jahre,218,112,106
False,8226020,Eschelbronn,35 - 40 Jahre,177,93,84
False,8226020,Eschelbronn,40 - 45 Jahre,199,89,110
False,8226020,Eschelbronn,45 - 50 Jahre,155,84,71
False,8226020,Eschelbronn,50 - 55 Jahre,113,59,54
False,8226020,Eschelbronn,55 - 60 Jahre,165,91,74
False,8226020,Eschelbronn,60 - 65 Jahre,123,64,59
False,8226020,Eschelbronn,65 - 75 Jahre,221,89,132
False,8226020,Eschelbronn,75 und mehr Jahre,115,34,81
False,8226020,Eschelbronn,Insgesamt,2434,1189,1245
False,8226022,Gaiberg,unter 3 Jahre,89,40,49
False,8226022,Gaiberg,3 -  6 Jahre,98,59,39
False,8226022,Gaiberg,6 - 10 Jahre,118,62,56
False,8226022,Gaiberg,10 - 15 Jahre,141,79,62
False,8226022,Gaiberg,15 - 18 Jahre,56,28,28
False,8226022,Gaiberg,18 - 20 Jahre,48,25,23
False,8226022,Gaiberg,20 - 25 Jahre,95,53,42
False,8226022,Gaiberg,25 - 30 Jahre,133,63,70
False,8226022,Gaiberg,30 - 35 Jahre,195,90,105
False,8226022,Gaiberg,35 - 40 Jahre,199,113,86
False,8226022,Gaiberg,40 - 45 Jahre,173,81,92
False,8226022,Gaiberg,45 - 50 Jahre,191,80,111
False,8226022,Gaiberg,50 - 55 Jahre,168,89,79
False,8226022,Gaiberg,55 - 60 Jahre,168,87,81
False,8226022,Gaiberg,60 - 65 Jahre,131,60,71
False,8226022,Gaiberg,65 - 75 Jahre,211,101,110
False,8226022,Gaiberg,75 und mehr Jahre,133,42,91
False,8226022,Gaiberg,Insgesamt,2347,1152,1195
False,8226027,Heddesbach,unter 3 Jahre,20,14,6
False,8226027,Heddesbach,3 -  6 Jahre,28,16,12
False,8226027,Heddesbach,6 - 10 Jahre,34,19,15
False,8226027,Heddesbach,10 - 15 Jahre,23,6,17
False,8226027,Heddesbach,15 - 18 Jahre,7,1,6
False,8226027,Heddesbach,18 - 20 Jahre,14,6,8
False,8226027,Heddesbach,20 - 25 Jahre,25,13,12
False,8226027,Heddesbach,25 - 30 Jahre,40,19,21
False,8226027,Heddesbach,30 - 35 Jahre,51,27,24
False,8226027,Heddesbach,35 - 40 Jahre,51,27,24
False,8226027,Heddesbach,40 - 45 Jahre,27,15,12
False,8226027,Heddesbach,45 - 50 Jahre,32,16,16
False,8226027,Heddesbach,50 - 55 Jahre,37,25,12
False,8226027,Heddesbach,55 - 60 Jahre,30,13,17
False,8226027,Heddesbach,60 - 65 Jahre,26,13,13
False,8226027,Heddesbach,65 - 75 Jahre,56,25,31
False,8226027,Heddesbach,75 und mehr Jahre,33,8,25
False,8226027,Heddesbach,Insgesamt,534,263,271
False,8226028,Heddesheim,unter 3 Jahre,318,160,158
False,8226028,Heddesheim,3 -  6 Jahre,350,192,158
False,8226028,Heddesheim,6 - 10 Jahre,481,253,228
False,8226028,Heddesheim,10 - 15 Jahre,575,282,293
False,8226028,Heddesheim,15 - 18 Jahre,306,177,129
False,8226028,Heddesheim,18 - 20 Jahre,182,88,94
False,8226028,Heddesheim,20 - 25 Jahre,555,286,269
False,8226028,Heddesheim,25 - 30 Jahre,870,459,411
False,8226028,Heddesheim,30 - 35 Jahre,969,481,488
False,8226028,Heddesheim,35 - 40 Jahre,966,491,475
False,8226028,Heddesheim,40 - 45 Jahre,836,407,429
False,8226028,Heddesheim,45 - 50 Jahre,867,444,423
False,8226028,Heddesheim,50 - 55 Jahre,751,375,376
False,8226028,Heddesheim,55 - 60 Jahre,869,436,433
False,8226028,Heddesheim,60 - 65 Jahre,630,316,314
False,8226028,Heddesheim,65 - 75 Jahre,1025,465,560
False,8226028,Heddesheim,75 und mehr Jahre,521,157,364
False,8226028,Heddesheim,Insgesamt,11071,5469,5602
False,8226029,Heiligkreuzsteinach,unter 3 Jahre,89,52,37
False,8226029,Heiligkreuzsteinach,3 -  6 Jahre,107,54,53
False,8226029,Heiligkreuzsteinach,6 - 10 Jahre,149,71,78
False,8226029,Heiligkreuzsteinach,10 - 15 Jahre,157,81,76
False,8226029,Heiligkreuzsteinach,15 - 18 Jahre,67,40,27
False,8226029,Heiligkreuzsteinach,18 - 20 Jahre,47,18,29
False,8226029,Heiligkreuzsteinach,20 - 25 Jahre,131,64,67
False,8226029,Heiligkreuzsteinach,25 - 30 Jahre,250,139,111
False,8226029,Heiligkreuzsteinach,30 - 35 Jahre,258,121,137
False,8226029,Heiligkreuzsteinach,35 - 40 Jahre,232,134,98
False,8226029,Heiligkreuzsteinach,40 - 45 Jahre,199,107,92
False,8226029,Heiligkreuzsteinach,45 - 50 Jahre,175,89,86
False,8226029,Heiligkreuzsteinach,50 - 55 Jahre,182,97,85
False,8226029,Heiligkreuzsteinach,55 - 60 Jahre,236,125,111
False,8226029,Heiligkreuzsteinach,60 - 65 Jahre,149,85,64
False,8226029,Heiligkreuzsteinach,65 - 75 Jahre,252,114,138
False,8226029,Heiligkreuzsteinach,75 und mehr Jahre,193,63,130
False,8226029,Heiligkreuzsteinach,Insgesamt,2873,1454,1419
False,8226031,"Hemsbach, Stadt",unter 3 Jahre,383,188,195
False,8226031,"Hemsbach, Stadt",3 -  6 Jahre,372,207,165
False,8226031,"Hemsbach, Stadt",6 - 10 Jahre,534,267,267
False,8226031,"Hemsbach, Stadt",10 - 15 Jahre,668,334,334
False,8226031,"Hemsbach, Stadt",15 - 18 Jahre,388,214,174
False,8226031,"Hemsbach, Stadt",18 - 20 Jahre,258,137,121
False,8226031,"Hemsbach, Stadt",20 - 25 Jahre,747,400,347
False,8226031,"Hemsbach, Stadt",25 - 30 Jahre,1024,552,472
False,8226031,"Hemsbach, Stadt",30 - 35 Jahre,1155,611,544
False,8226031,"Hemsbach, Stadt",35 - 40 Jahre,1000,511,489
False,8226031,"Hemsbach, Stadt",40 - 45 Jahre,845,424,421
False,8226031,"Hemsbach, Stadt",45 - 50 Jahre,865,425,440
False,8226031,"Hemsbach, Stadt",50 - 55 Jahre,898,452,446
False,8226031,"Hemsbach, Stadt",55 - 60 Jahre,1087,557,530
False,8226031,"Hemsbach, Stadt",60 - 65 Jahre,749,362,387
False,8226031,"Hemsbach, Stadt",65 - 75 Jahre,1027,463,564
False,8226031,"Hemsbach, Stadt",75 und mehr Jahre,689,224,465
False,8226031,"Hemsbach, Stadt",Insgesamt,12689,6328,6361
False,8226032,"Hockenheim, Stadt",unter 3 Jahre,594,297,297
False,8226032,"Hockenheim, Stadt",3 -  6 Jahre,601,305,296
False,8226032,"Hockenheim, Stadt",6 - 10 Jahre,857,448,409
False,8226032,"Hockenheim, Stadt",10 - 15 Jahre,977,530,447
False,8226032,"Hockenheim, Stadt",15 - 18 Jahre,583,310,273
False,8226032,"Hockenheim, Stadt",18 - 20 Jahre,360,170,190
False,8226032,"Hockenheim, Stadt",20 - 25 Jahre,984,524,460
False,8226032,"Hockenheim, Stadt",25 - 30 Jahre,1541,800,741
False,8226032,"Hockenheim, Stadt",30 - 35 Jahre,1767,923,844
False,8226032,"Hockenheim, Stadt",35 - 40 Jahre,1606,809,797
False,8226032,"Hockenheim, Stadt",40 - 45 Jahre,1365,693,672
False,8226032,"Hockenheim, Stadt",45 - 50 Jahre,1279,668,611
False,8226032,"Hockenheim, Stadt",50 - 55 Jahre,1163,613,550
False,8226032,"Hockenheim, Stadt",55 - 60 Jahre,1325,667,658
False,8226032,"Hockenheim, Stadt",60 - 65 Jahre,981,502,479
False,8226032,"Hockenheim, Stadt",65 - 75 Jahre,1654,674,980
False,8226032,"Hockenheim, Stadt",75 und mehr Jahre,1137,366,771
False,8226032,"Hockenheim, Stadt",Insgesamt,18774,9299,9475
False,8226036,Ilvesheim,unter 3 Jahre,177,94,83
False,8226036,Ilvesheim,3 -  6 Jahre,184,96,88
False,8226036,Ilvesheim,6 - 10 Jahre,269,137,132
False,8226036,Ilvesheim,10 - 15 Jahre,329,163,166
False,8226036,Ilvesheim,15 - 18 Jahre,161,86,75
False,8226036,Ilvesheim,18 - 20 Jahre,117,59,58
False,8226036,Ilvesheim,20 - 25 Jahre,296,146,150
False,8226036,Ilvesheim,25 - 30 Jahre,500,252,248
False,8226036,Ilvesheim,30 - 35 Jahre,547,282,265
False,8226036,Ilvesheim,35 - 40 Jahre,565,277,288
False,8226036,Ilvesheim,40 - 45 Jahre,509,254,255
False,8226036,Ilvesheim,45 - 50 Jahre,506,258,248
False,8226036,Ilvesheim,50 - 55 Jahre,473,239,234
False,8226036,Ilvesheim,55 - 60 Jahre,522,258,264
False,8226036,Ilvesheim,60 - 65 Jahre,457,211,246
False,8226036,Ilvesheim,65 - 75 Jahre,885,408,477
False,8226036,Ilvesheim,75 und mehr Jahre,527,188,339
False,8226036,Ilvesheim,Insgesamt,7024,3408,3616
False,8226037,Ketsch,unter 3 Jahre,324,165,159
False,8226037,Ketsch,3 -  6 Jahre,370,187,183
False,8226037,Ketsch,6 - 10 Jahre,496,254,242
False,8226037,Ketsch,10 - 15 Jahre,647,323,324
False,8226037,Ketsch,15 - 18 Jahre,389,183,206
False,8226037,Ketsch,18 - 20 Jahre,237,114,123
False,8226037,Ketsch,20 - 25 Jahre,611,320,291
False,8226037,Ketsch,25 - 30 Jahre,994,519,475
False,8226037,Ketsch,30 - 35 Jahre,1041,558,483
False,8226037,Ketsch,35 - 40 Jahre,1003,514,489
False,8226037,Ketsch,40 - 45 Jahre,894,454,440
False,8226037,Ketsch,45 - 50 Jahre,962,474,488
False,8226037,Ketsch,50 - 55 Jahre,976,505,471
False,8226037,Ketsch,55 - 60 Jahre,1048,541,507
False,8226037,Ketsch,60 - 65 Jahre,691,359,332
False,8226037,Ketsch,65 - 75 Jahre,1124,490,634
False,8226037,Ketsch,75 und mehr Jahre,706,222,484
False,8226037,Ketsch,Insgesamt,12513,6182,6331
False,8226038,"Ladenburg, Stadt",unter 3 Jahre,376,198,178
False,8226038,"Ladenburg, Stadt",3 -  6 Jahre,343,161,182
False,8226038,"Ladenburg, Stadt",6 - 10 Jahre,491,262,229
False,8226038,"Ladenburg, Stadt",10 - 15 Jahre,609,314,295
False,8226038,"Ladenburg, Stadt",15 - 18 Jahre,359,186,173
False,8226038,"Ladenburg, Stadt",18 - 20 Jahre,237,121,116
False,8226038,"Ladenburg, Stadt",20 - 25 Jahre,605,306,299
False,8226038,"Ladenburg, Stadt",25 - 30 Jahre,813,404,409
False,8226038,"Ladenburg, Stadt",30 - 35 Jahre,938,458,480
False,8226038,"Ladenburg, Stadt",35 - 40 Jahre,925,466,459
False,8226038,"Ladenburg, Stadt",40 - 45 Jahre,945,450,495
False,8226038,"Ladenburg, Stadt",45 - 50 Jahre,825,397,428
False,8226038,"Ladenburg, Stadt",50 - 55 Jahre,871,422,449
False,8226038,"Ladenburg, Stadt",55 - 60 Jahre,1027,533,494
False,8226038,"Ladenburg, Stadt",60 - 65 Jahre,698,367,331
False,8226038,"Ladenburg, Stadt",65 - 75 Jahre,1019,449,570
False,8226038,"Ladenburg, Stadt",75 und mehr Jahre,720,207,513
False,8226038,"Ladenburg, Stadt",Insgesamt,11801,5701,6100
False,8226040,Laudenbach,unter 3 Jahre,215,106,109
False,8226040,Laudenbach,3 -  6 Jahre,213,119,94
False,8226040,Laudenbach,6 - 10 Jahre,244,117,127
False,8226040,Laudenbach,10 - 15 Jahre,321,155,166
False,8226040,Laudenbach,15 - 18 Jahre,186,93,93
False,8226040,Laudenbach,18 - 20 Jahre,141,70,71
False,8226040,Laudenbach,20 - 25 Jahre,309,166,143
False,8226040,Laudenbach,25 - 30 Jahre,466,247,219
False,8226040,Laudenbach,30 - 35 Jahre,444,219,225
False,8226040,Laudenbach,35 - 40 Jahre,473,213,260
False,8226040,Laudenbach,40 - 45 Jahre,415,211,204
False,8226040,Laudenbach,45 - 50 Jahre,437,191,246
False,8226040,Laudenbach,50 - 55 Jahre,459,238,221
False,8226040,Laudenbach,55 - 60 Jahre,387,216,171
False,8226040,Laudenbach,60 - 65 Jahre,302,150,152
False,8226040,Laudenbach,65 - 75 Jahre,429,178,251
False,8226040,Laudenbach,75 und mehr Jahre,290,94,196
False,8226040,Laudenbach,Insgesamt,5731,2783,2948
False,8226041,"Leimen, Stadt",unter 3 Jahre,798,370,428
False,8226041,"Leimen, Stadt",3 -  6 Jahre,810,414,396
False,8226041,"Leimen, Stadt",6 - 10 Jahre,1111,575,536
False,8226041,"Leimen, Stadt",10 - 15 Jahre,1318,666,652
False,8226041,"Leimen, Stadt",15 - 18 Jahre,794,443,351
False,8226041,"Leimen, Stadt",18 - 20 Jahre,457,235,222
False,8226041,"Leimen, Stadt",20 - 25 Jahre,1534,724,810
False,8226041,"Leimen, Stadt",25 - 30 Jahre,2414,1226,1188
False,8226041,"Leimen, Stadt",30 - 35 Jahre,2428,1246,1182
False,8226041,"Leimen, Stadt",35 - 40 Jahre,2180,1101,1079
False,8226041,"Leimen, Stadt",40 - 45 Jahre,1816,905,911
False,8226041,"Leimen, Stadt",45 - 50 Jahre,1589,800,789
False,8226041,"Leimen, Stadt",50 - 55 Jahre,1429,735,694
False,8226041,"Leimen, Stadt",55 - 60 Jahre,1636,825,811
False,8226041,"Leimen, Stadt",60 - 65 Jahre,1193,590,603
False,8226041,"Leimen, Stadt",65 - 75 Jahre,1862,809,1053
False,8226041,"Leimen, Stadt",75 und mehr Jahre,1252,383,869
False,8226041,"Leimen, Stadt",Insgesamt,24621,12047,12574
False,8226046,Malsch,unter 3 Jahre,113,61,52
False,8226046,Malsch,3 -  6 Jahre,133,68,65
False,8226046,Malsch,6 - 10 Jahre,176,96,80
False,8226046,Malsch,10 - 15 Jahre,193,93,100
False,8226046,Malsch,15 - 18 Jahre,85,43,42
False,8226046,Malsch,18 - 20 Jahre,53,24,29
False,8226046,Malsch,20 - 25 Jahre,133,74,59
False,8226046,Malsch,25 - 30 Jahre,224,101,123
False,8226046,Malsch,30 - 35 Jahre,354,175,179
False,8226046,Malsch,35 - 40 Jahre,316,164,152
False,8226046,Malsch,40 - 45 Jahre,223,117,106
False,8226046,Malsch,45 - 50 Jahre,191,105,86
False,8226046,Malsch,50 - 55 Jahre,175,97,78
False,8226046,Malsch,55 - 60 Jahre,203,108,95
False,8226046,Malsch,60 - 65 Jahre,163,77,86
False,8226046,Malsch,65 - 75 Jahre,245,100,145
False,8226046,Malsch,75 und mehr Jahre,167,55,112
False,8226046,Malsch,Insgesamt,3147,1558,1589
False,8226048,Mauer,unter 3 Jahre,94,36,58
False,8226048,Mauer,3 -  6 Jahre,123,66,57
False,8226048,Mauer,6 - 10 Jahre,195,92,103
False,8226048,Mauer,10 - 15 Jahre,233,105,128
False,8226048,Mauer,15 - 18 Jahre,107,63,44
False,8226048,Mauer,18 - 20 Jahre,84,45,39
False,8226048,Mauer,20 - 25 Jahre,174,84,90
False,8226048,Mauer,25 - 30 Jahre,274,141,133
False,8226048,Mauer,30 - 35 Jahre,269,136,133
False,8226048,Mauer,35 - 40 Jahre,293,148,145
False,8226048,Mauer,40 - 45 Jahre,262,142,120
False,8226048,Mauer,45 - 50 Jahre,237,119,118
False,8226048,Mauer,50 - 55 Jahre,224,113,111
False,8226048,Mauer,55 - 60 Jahre,221,124,97
False,8226048,Mauer,60 - 65 Jahre,176,83,93
False,8226048,Mauer,65 - 75 Jahre,279,122,157
False,8226048,Mauer,75 und mehr Jahre,145,51,94
False,8226048,Mauer,Insgesamt,3390,1670,1720
False,8226049,Meckesheim,unter 3 Jahre,166,84,82
False,8226049,Meckesheim,3 -  6 Jahre,195,95,100
False,8226049,Meckesheim,6 - 10 Jahre,253,148,105
False,8226049,Meckesheim,10 - 15 Jahre,294,130,164
False,8226049,Meckesheim,15 - 18 Jahre,176,90,86
False,8226049,Meckesheim,18 - 20 Jahre,91,53,38
False,8226049,Meckesheim,20 - 25 Jahre,376,202,174
False,8226049,Meckesheim,25 - 30 Jahre,501,284,217
False,8226049,Meckesheim,30 - 35 Jahre,439,235,204
False,8226049,Meckesheim,35 - 40 Jahre,443,236,207
False,8226049,Meckesheim,40 - 45 Jahre,365,179,186
False,8226049,Meckesheim,45 - 50 Jahre,417,204,213
False,8226049,Meckesheim,50 - 55 Jahre,338,197,141
False,8226049,Meckesheim,55 - 60 Jahre,358,177,181
False,8226049,Meckesheim,60 - 65 Jahre,277,133,144
False,8226049,Meckesheim,65 - 75 Jahre,470,201,269
False,8226049,Meckesheim,75 und mehr Jahre,293,96,197
False,8226049,Meckesheim,Insgesamt,5452,2744,2708
False,8226054,Mühlhausen,unter 3 Jahre,323,187,136
False,8226054,Mühlhausen,3 -  6 Jahre,311,157,154
False,8226054,Mühlhausen,6 - 10 Jahre,379,190,189
False,8226054,Mühlhausen,10 - 15 Jahre,456,251,205
False,8226054,Mühlhausen,15 - 18 Jahre,230,132,98
False,8226054,Mühlhausen,18 - 20 Jahre,126,65,61
False,8226054,Mühlhausen,20 - 25 Jahre,412,205,207
False,8226054,Mühlhausen,25 - 30 Jahre,631,314,317
False,8226054,Mühlhausen,30 - 35 Jahre,764,403,361
False,8226054,Mühlhausen,35 - 40 Jahre,660,345,315
False,8226054,Mühlhausen,40 - 45 Jahre,515,249,266
False,8226054,Mühlhausen,45 - 50 Jahre,456,233,223
False,8226054,Mühlhausen,50 - 55 Jahre,370,193,177
False,8226054,Mühlhausen,55 - 60 Jahre,445,242,203
False,8226054,Mühlhausen,60 - 65 Jahre,350,164,186
False,8226054,Mühlhausen,65 - 75 Jahre,565,235,330
False,8226054,Mühlhausen,75 und mehr Jahre,285,97,188
False,8226054,Mühlhausen,Insgesamt,7278,3662,3616
False,8226055,"Neckarbischofsheim, Stadt",unter 3 Jahre,118,67,51
False,8226055,"Neckarbischofsheim, Stadt",3 -  6 Jahre,149,84,65
False,8226055,"Neckarbischofsheim, Stadt",6 - 10 Jahre,204,101,103
False,8226055,"Neckarbischofsheim, Stadt",10 - 15 Jahre,261,142,119
False,8226055,"Neckarbischofsheim, Stadt",15 - 18 Jahre,150,70,80
False,8226055,"Neckarbischofsheim, Stadt",18 - 20 Jahre,86,46,40
False,8226055,"Neckarbischofsheim, Stadt",20 - 25 Jahre,228,137,91
False,8226055,"Neckarbischofsheim, Stadt",25 - 30 Jahre,296,160,136
False,8226055,"Neckarbischofsheim, Stadt",30 - 35 Jahre,378,191,187
False,8226055,"Neckarbischofsheim, Stadt",35 - 40 Jahre,316,165,151
False,8226055,"Neckarbischofsheim, Stadt",40 - 45 Jahre,247,128,119
False,8226055,"Neckarbischofsheim, Stadt",45 - 50 Jahre,241,127,114
False,8226055,"Neckarbischofsheim, Stadt",50 - 55 Jahre,194,106,88
False,8226055,"Neckarbischofsheim, Stadt",55 - 60 Jahre,247,117,130
False,8226055,"Neckarbischofsheim, Stadt",60 - 65 Jahre,205,103,102
False,8226055,"Neckarbischofsheim, Stadt",65 - 75 Jahre,372,168,204
False,8226055,"Neckarbischofsheim, Stadt",75 und mehr Jahre,240,61,179
False,8226055,"Neckarbischofsheim, Stadt",Insgesamt,3932,1973,1959
False,8226056,"Neckargemünd, Stadt",unter 3 Jahre,378,227,151
False,8226056,"Neckargemünd, Stadt",3 -  6 Jahre,391,191,200
False,8226056,"Neckargemünd, Stadt",6 - 10 Jahre,565,267,298
False,8226056,"Neckargemünd, Stadt",10 - 15 Jahre,690,375,315
False,8226056,"Neckargemünd, Stadt",15 - 18 Jahre,545,320,225
False,8226056,"Neckargemünd, Stadt",18 - 20 Jahre,464,285,179
False,8226056,"Neckargemünd, Stadt",20 - 25 Jahre,1044,570,474
False,8226056,"Neckargemünd, Stadt",25 - 30 Jahre,1241,668,573
False,8226056,"Neckargemünd, Stadt",30 - 35 Jahre,1249,628,621
False,8226056,"Neckargemünd, Stadt",35 - 40 Jahre,1100,554,546
False,8226056,"Neckargemünd, Stadt",40 - 45 Jahre,1036,528,508
False,8226056,"Neckargemünd, Stadt",45 - 50 Jahre,910,408,502
False,8226056,"Neckargemünd, Stadt",50 - 55 Jahre,1005,483,522
False,8226056,"Neckargemünd, Stadt",55 - 60 Jahre,1010,488,522
False,8226056,"Neckargemünd, Stadt",60 - 65 Jahre,710,364,346
False,8226056,"Neckargemünd, Stadt",65 - 75 Jahre,1221,512,709
False,8226056,"Neckargemünd, Stadt",75 und mehr Jahre,1000,286,714
False,8226056,"Neckargemünd, Stadt",Insgesamt,14559,7154,7405
False,8226058,Neidenstein,unter 3 Jahre,72,35,37
False,8226058,Neidenstein,3 -  6 Jahre,73,34,39
False,8226058,Neidenstein,6 - 10 Jahre,78,40,38
False,8226058,Neidenstein,10 - 15 Jahre,70,42,28
False,8226058,Neidenstein,15 - 18 Jahre,56,25,31
False,8226058,Neidenstein,18 - 20 Jahre,28,18,10
False,8226058,Neidenstein,20 - 25 Jahre,81,37,44
False,8226058,Neidenstein,25 - 30 Jahre,139,77,62
False,8226058,Neidenstein,30 - 35 Jahre,167,81,86
False,8226058,Neidenstein,35 - 40 Jahre,132,65,67
False,8226058,Neidenstein,40 - 45 Jahre,117,56,61
False,8226058,Neidenstein,45 - 50 Jahre,106,54,52
False,8226058,Neidenstein,50 - 55 Jahre,93,55,38
False,8226058,Neidenstein,55 - 60 Jahre,122,62,60
False,8226058,Neidenstein,60 - 65 Jahre,83,42,41
False,8226058,Neidenstein,65 - 75 Jahre,144,65,79
False,8226058,Neidenstein,75 und mehr Jahre,104,30,74
False,8226058,Neidenstein,Insgesamt,1665,818,847
False,8226059,Neulußheim,unter 3 Jahre,177,96,81
False,8226059,Neulußheim,3 -  6 Jahre,187,96,91
False,8226059,Neulußheim,6 - 10 Jahre,268,136,132
False,8226059,Neulußheim,10 - 15 Jahre,282,149,133
False,8226059,Neulußheim,15 - 18 Jahre,162,77,85
False,8226059,Neulußheim,18 - 20 Jahre,92,44,48
False,8226059,Neulußheim,20 - 25 Jahre,292,143,149
False,8226059,Neulußheim,25 - 30 Jahre,478,245,233
False,8226059,Neulußheim,30 - 35 Jahre,473,234,239
False,8226059,Neulußheim,35 - 40 Jahre,497,244,253
False,8226059,Neulußheim,40 - 45 Jahre,387,189,198
False,8226059,Neulußheim,45 - 50 Jahre,383,189,194
False,8226059,Neulußheim,50 - 55 Jahre,344,183,161
False,8226059,Neulußheim,55 - 60 Jahre,396,198,198
False,8226059,Neulußheim,60 - 65 Jahre,318,159,159
False,8226059,Neulußheim,65 - 75 Jahre,480,203,277
False,8226059,Neulußheim,75 und mehr Jahre,302,93,209
False,8226059,Neulußheim,Insgesamt,5518,2678,2840
False,8226060,Nußloch,unter 3 Jahre,352,182,170
False,8226060,Nußloch,3 -  6 Jahre,366,186,180
False,8226060,Nußloch,6 - 10 Jahre,471,232,239
False,8226060,Nußloch,10 - 15 Jahre,546,275,271
False,8226060,Nußloch,15 - 18 Jahre,284,144,140
False,8226060,Nußloch,18 - 20 Jahre,215,96,119
False,8226060,Nußloch,20 - 25 Jahre,560,282,278
False,8226060,Nußloch,25 - 30 Jahre,976,470,506
False,8226060,Nußloch,30 - 35 Jahre,927,461,466
False,8226060,Nußloch,35 - 40 Jahre,839,418,421
False,8226060,Nußloch,40 - 45 Jahre,766,386,380
False,8226060,Nußloch,45 - 50 Jahre,684,347,337
False,8226060,Nußloch,50 - 55 Jahre,646,332,314
False,8226060,Nußloch,55 - 60 Jahre,635,328,307
False,8226060,Nußloch,60 - 65 Jahre,537,260,277
False,8226060,Nußloch,65 - 75 Jahre,855,358,497
False,8226060,Nußloch,75 und mehr Jahre,572,159,413
False,8226060,Nußloch,Insgesamt,10231,4916,5315
False,8226062,Oftersheim,unter 3 Jahre,313,149,164
False,8226062,Oftersheim,3 -  6 Jahre,302,151,151
False,8226062,Oftersheim,6 - 10 Jahre,425,244,181
False,8226062,Oftersheim,10 - 15 Jahre,542,266,276
False,8226062,Oftersheim,15 - 18 Jahre,317,169,148
False,8226062,Oftersheim,18 - 20 Jahre,185,85,100
False,8226062,Oftersheim,20 - 25 Jahre,511,247,264
False,8226062,Oftersheim,25 - 30 Jahre,838,405,433
False,8226062,Oftersheim,30 - 35 Jahre,915,445,470
False,8226062,Oftersheim,35 - 40 Jahre,749,367,382
False,8226062,Oftersheim,40 - 45 Jahre,730,345,385
False,8226062,Oftersheim,45 - 50 Jahre,779,387,392
False,8226062,Oftersheim,50 - 55 Jahre,677,350,327
False,8226062,Oftersheim,55 - 60 Jahre,839,412,427
False,8226062,Oftersheim,60 - 65 Jahre,639,324,315
False,8226062,Oftersheim,65 - 75 Jahre,1057,451,606
False,8226062,Oftersheim,75 und mehr Jahre,667,223,444
False,8226062,Oftersheim,Insgesamt,10485,5020,5465
False,8226063,Plankstadt,unter 3 Jahre,309,151,158
False,8226063,Plankstadt,3 -  6 Jahre,287,156,131
False,8226063,Plankstadt,6 - 10 Jahre,410,211,199
False,8226063,Plankstadt,10 - 15 Jahre,454,231,223
False,8226063,Plankstadt,15 - 18 Jahre,262,138,124
False,8226063,Plankstadt,18 - 20 Jahre,146,63,83
False,8226063,Plankstadt,20 - 25 Jahre,481,255,226
False,8226063,Plankstadt,25 - 30 Jahre,789,389,400
False,8226063,Plankstadt,30 - 35 Jahre,865,463,402
False,8226063,Plankstadt,35 - 40 Jahre,743,392,351
False,8226063,Plankstadt,40 - 45 Jahre,684,314,370
False,8226063,Plankstadt,45 - 50 Jahre,665,333,332
False,8226063,Plankstadt,50 - 55 Jahre,599,310,289
False,8226063,Plankstadt,55 - 60 Jahre,774,387,387
False,8226063,Plankstadt,60 - 65 Jahre,561,281,280
False,8226063,Plankstadt,65 - 75 Jahre,900,384,516
False,8226063,Plankstadt,75 und mehr Jahre,815,220,595
False,8226063,Plankstadt,Insgesamt,9744,4678,5066
False,8226065,"Rauenberg, Stadt",unter 3 Jahre,253,115,138
False,8226065,"Rauenberg, Stadt",3 -  6 Jahre,247,119,128
False,8226065,"Rauenberg, Stadt",6 - 10 Jahre,315,169,146
False,8226065,"Rauenberg, Stadt",10 - 15 Jahre,387,184,203
False,8226065,"Rauenberg, Stadt",15 - 18 Jahre,235,128,107
False,8226065,"Rauenberg, Stadt",18 - 20 Jahre,121,63,58
False,8226065,"Rauenberg, Stadt",20 - 25 Jahre,371,174,197
False,8226065,"Rauenberg, Stadt",25 - 30 Jahre,610,300,310
False,8226065,"Rauenberg, Stadt",30 - 35 Jahre,742,403,339
False,8226065,"Rauenberg, Stadt",35 - 40 Jahre,631,330,301
False,8226065,"Rauenberg, Stadt",40 - 45 Jahre,513,261,252
False,8226065,"Rauenberg, Stadt",45 - 50 Jahre,441,233,208
False,8226065,"Rauenberg, Stadt",50 - 55 Jahre,373,203,170
False,8226065,"Rauenberg, Stadt",55 - 60 Jahre,458,230,228
False,8226065,"Rauenberg, Stadt",60 - 65 Jahre,358,169,189
False,8226065,"Rauenberg, Stadt",65 - 75 Jahre,569,252,317
False,8226065,"Rauenberg, Stadt",75 und mehr Jahre,290,78,212
False,8226065,"Rauenberg, Stadt",Insgesamt,6914,3411,3503
False,8226066,Reichartshausen,unter 3 Jahre,52,24,28
False,8226066,Reichartshausen,3 -  6 Jahre,77,37,40
False,8226066,Reichartshausen,6 - 10 Jahre,112,61,51
False,8226066,Reichartshausen,10 - 15 Jahre,115,52,63
False,8226066,Reichartshausen,15 - 18 Jahre,70,42,28
False,8226066,Reichartshausen,18 - 20 Jahre,31,13,18
False,8226066,Reichartshausen,20 - 25 Jahre,105,57,48
False,8226066,Reichartshausen,25 - 30 Jahre,120,60,60
False,8226066,Reichartshausen,30 - 35 Jahre,176,89,87
False,8226066,Reichartshausen,35 - 40 Jahre,165,92,73
False,8226066,Reichartshausen,40 - 45 Jahre,125,62,63
False,8226066,Reichartshausen,45 - 50 Jahre,97,50,47
False,8226066,Reichartshausen,50 - 55 Jahre,93,47,46
False,8226066,Reichartshausen,55 - 60 Jahre,129,68,61
False,8226066,Reichartshausen,60 - 65 Jahre,106,53,53
False,8226066,Reichartshausen,65 - 75 Jahre,165,73,92
False,8226066,Reichartshausen,75 und mehr Jahre,73,19,54
False,8226066,Reichartshausen,Insgesamt,1811,899,912
False,8226068,Reilingen,unter 3 Jahre,221,117,104
False,8226068,Reilingen,3 -  6 Jahre,252,128,124
False,8226068,Reilingen,6 - 10 Jahre,325,155,170
False,8226068,Reilingen,10 - 15 Jahre,406,210,196
False,8226068,Reilingen,15 - 18 Jahre,221,117,104
False,8226068,Reilingen,18 - 20 Jahre,153,71,82
False,8226068,Reilingen,20 - 25 Jahre,407,209,198
False,8226068,Reilingen,25 - 30 Jahre,553,263,290
False,8226068,Reilingen,30 - 35 Jahre,628,324,304
False,8226068,Reilingen,35 - 40 Jahre,582,309,273
False,8226068,Reilingen,40 - 45 Jahre,517,263,254
False,8226068,Reilingen,45 - 50 Jahre,507,247,260
False,8226068,Reilingen,50 - 55 Jahre,439,237,202
False,8226068,Reilingen,55 - 60 Jahre,480,239,241
False,8226068,Reilingen,60 - 65 Jahre,374,190,184
False,8226068,Reilingen,65 - 75 Jahre,604,267,337
False,8226068,Reilingen,75 und mehr Jahre,311,98,213
False,8226068,Reilingen,Insgesamt,6980,3444,3536
False,8226076,Sandhausen,unter 3 Jahre,449,227,222
False,8226076,Sandhausen,3 -  6 Jahre,462,241,221
False,8226076,Sandhausen,6 - 10 Jahre,590,304,286
False,8226076,Sandhausen,10 - 15 Jahre,728,391,337
False,8226076,Sandhausen,15 - 18 Jahre,351,171,180
False,8226076,Sandhausen,18 - 20 Jahre,259,131,128
False,8226076,Sandhausen,20 - 25 Jahre,731,350,381
False,8226076,Sandhausen,25 - 30 Jahre,1196,633,563
False,8226076,Sandhausen,30 - 35 Jahre,1306,651,655
False,8226076,Sandhausen,35 - 40 Jahre,1132,559,573
False,8226076,Sandhausen,40 - 45 Jahre,997,509,488
False,8226076,Sandhausen,45 - 50 Jahre,1011,482,529
False,8226076,Sandhausen,50 - 55 Jahre,902,458,444
False,8226076,Sandhausen,55 - 60 Jahre,1025,507,518
False,8226076,Sandhausen,60 - 65 Jahre,750,365,385
False,8226076,Sandhausen,65 - 75 Jahre,1174,526,648
False,8226076,Sandhausen,75 und mehr Jahre,639,189,450
False,8226076,Sandhausen,Insgesamt,13702,6694,7008
False,8226080,"Schönau, Stadt",unter 3 Jahre,157,80,77
False,8226080,"Schönau, Stadt",3 -  6 Jahre,141,80,61
False,8226080,"Schönau, Stadt",6 - 10 Jahre,205,113,92
False,8226080,"Schönau, Stadt",10 - 15 Jahre,217,111,106
False,8226080,"Schönau, Stadt",15 - 18 Jahre,131,69,62
False,8226080,"Schönau, Stadt",18 - 20 Jahre,69,41,28
False,8226080,"Schönau, Stadt",20 - 25 Jahre,218,102,116
False,8226080,"Schönau, Stadt",25 - 30 Jahre,357,194,163
False,8226080,"Schönau, Stadt",30 - 35 Jahre,389,198,191
False,8226080,"Schönau, Stadt",35 - 40 Jahre,356,189,167
False,8226080,"Schönau, Stadt",40 - 45 Jahre,319,155,164
False,8226080,"Schönau, Stadt",45 - 50 Jahre,296,145,151
False,8226080,"Schönau, Stadt",50 - 55 Jahre,294,146,148
False,8226080,"Schönau, Stadt",55 - 60 Jahre,356,176,180
False,8226080,"Schönau, Stadt",60 - 65 Jahre,253,123,130
False,8226080,"Schönau, Stadt",65 - 75 Jahre,502,215,287
False,8226080,"Schönau, Stadt",75 und mehr Jahre,359,105,254
False,8226080,"Schönau, Stadt",Insgesamt,4619,2242,2377
False,8226081,Schönbrunn,unter 3 Jahre,111,49,62
False,8226081,Schönbrunn,3 -  6 Jahre,117,68,49
False,8226081,Schönbrunn,6 - 10 Jahre,176,103,73
False,8226081,Schönbrunn,10 - 15 Jahre,192,100,92
False,8226081,Schönbrunn,15 - 18 Jahre,96,46,50
False,8226081,Schönbrunn,18 - 20 Jahre,53,26,27
False,8226081,Schönbrunn,20 - 25 Jahre,137,72,65
False,8226081,Schönbrunn,25 - 30 Jahre,240,133,107
False,8226081,Schönbrunn,30 - 35 Jahre,253,129,124
False,8226081,Schönbrunn,35 - 40 Jahre,277,138,139
False,8226081,Schönbrunn,40 - 45 Jahre,225,115,110
False,8226081,Schönbrunn,45 - 50 Jahre,203,101,102
False,8226081,Schönbrunn,50 - 55 Jahre,179,94,85
False,8226081,Schönbrunn,55 - 60 Jahre,200,119,81
False,8226081,Schönbrunn,60 - 65 Jahre,152,76,76
False,8226081,Schönbrunn,65 - 75 Jahre,262,124,138
False,8226081,Schönbrunn,75 und mehr Jahre,168,52,116
False,8226081,Schönbrunn,Insgesamt,3041,1545,1496
False,8226082,"Schriesheim, Stadt",unter 3 Jahre,399,218,181
False,8226082,"Schriesheim, Stadt",3 -  6 Jahre,380,208,172
False,8226082,"Schriesheim, Stadt",6 - 10 Jahre,495,266,229
False,8226082,"Schriesheim, Stadt",10 - 15 Jahre,669,355,314
False,8226082,"Schriesheim, Stadt",15 - 18 Jahre,397,193,204
False,8226082,"Schriesheim, Stadt",18 - 20 Jahre,248,125,123
False,8226082,"Schriesheim, Stadt",20 - 25 Jahre,728,362,366
False,8226082,"Schriesheim, Stadt",25 - 30 Jahre,1073,563,510
False,8226082,"Schriesheim, Stadt",30 - 35 Jahre,1221,607,614
False,8226082,"Schriesheim, Stadt",35 - 40 Jahre,1078,538,540
False,8226082,"Schriesheim, Stadt",40 - 45 Jahre,1022,501,521
False,8226082,"Schriesheim, Stadt",45 - 50 Jahre,996,498,498
False,8226082,"Schriesheim, Stadt",50 - 55 Jahre,988,508,480
False,8226082,"Schriesheim, Stadt",55 - 60 Jahre,947,489,458
False,8226082,"Schriesheim, Stadt",60 - 65 Jahre,692,360,332
False,8226082,"Schriesheim, Stadt",65 - 75 Jahre,1151,472,679
False,8226082,"Schriesheim, Stadt",75 und mehr Jahre,931,274,657
False,8226082,"Schriesheim, Stadt",Insgesamt,13415,6537,6878
False,8226084,"Schwetzingen, Stadt",unter 3 Jahre,730,346,384
False,8226084,"Schwetzingen, Stadt",3 -  6 Jahre,767,395,372
False,8226084,"Schwetzingen, Stadt",6 - 10 Jahre,1008,528,480
False,8226084,"Schwetzingen, Stadt",10 - 15 Jahre,1019,523,496
False,8226084,"Schwetzingen, Stadt",15 - 18 Jahre,574,292,282
False,8226084,"Schwetzingen, Stadt",18 - 20 Jahre,423,241,182
False,8226084,"Schwetzingen, Stadt",20 - 25 Jahre,1227,602,625
False,8226084,"Schwetzingen, Stadt",25 - 30 Jahre,2127,1058,1069
False,8226084,"Schwetzingen, Stadt",30 - 35 Jahre,2405,1263,1142
False,8226084,"Schwetzingen, Stadt",35 - 40 Jahre,1903,975,928
False,8226084,"Schwetzingen, Stadt",40 - 45 Jahre,1475,754,721
False,8226084,"Schwetzingen, Stadt",45 - 50 Jahre,1420,749,671
False,8226084,"Schwetzingen, Stadt",50 - 55 Jahre,1312,660,652
False,8226084,"Schwetzingen, Stadt",55 - 60 Jahre,1432,710,722
False,8226084,"Schwetzingen, Stadt",60 - 65 Jahre,1005,472,533
False,8226084,"Schwetzingen, Stadt",65 - 75 Jahre,1819,723,1096
False,8226084,"Schwetzingen, Stadt",75 und mehr Jahre,1226,366,860
False,8226084,"Schwetzingen, Stadt",Insgesamt,21872,10657,11215
False,8226085,"Sinsheim, Stadt",unter 3 Jahre,1149,587,562
False,8226085,"Sinsheim, Stadt",3 -  6 Jahre,1289,642,647
False,8226085,"Sinsheim, Stadt",6 - 10 Jahre,1657,865,792
False,8226085,"Sinsheim, Stadt",10 - 15 Jahre,1898,930,968
False,8226085,"Sinsheim, Stadt",15 - 18 Jahre,1112,586,526
False,8226085,"Sinsheim, Stadt",18 - 20 Jahre,749,402,347
False,8226085,"Sinsheim, Stadt",20 - 25 Jahre,2068,1058,1010
False,8226085,"Sinsheim, Stadt",25 - 30 Jahre,2637,1380,1257
False,8226085,"Sinsheim, Stadt",30 - 35 Jahre,2989,1559,1430
False,8226085,"Sinsheim, Stadt",35 - 40 Jahre,2675,1356,1319
False,8226085,"Sinsheim, Stadt",40 - 45 Jahre,2392,1197,1195
False,8226085,"Sinsheim, Stadt",45 - 50 Jahre,2147,1114,1033
False,8226085,"Sinsheim, Stadt",50 - 55 Jahre,1847,948,899
False,8226085,"Sinsheim, Stadt",55 - 60 Jahre,2176,1097,1079
False,8226085,"Sinsheim, Stadt",60 - 65 Jahre,1621,768,853
False,8226085,"Sinsheim, Stadt",65 - 75 Jahre,2690,1129,1561
False,8226085,"Sinsheim, Stadt",75 und mehr Jahre,1732,493,1239
False,8226085,"Sinsheim, Stadt",Insgesamt,32828,16111,16717
False,8226086,Spechbach,unter 3 Jahre,59,35,24
False,8226086,Spechbach,3 -  6 Jahre,67,37,30
False,8226086,Spechbach,6 - 10 Jahre,98,63,35
False,8226086,Spechbach,10 - 15 Jahre,81,43,38
False,8226086,Spechbach,15 - 18 Jahre,61,25,36
False,8226086,Spechbach,18 - 20 Jahre,19,10,9
False,8226086,Spechbach,20 - 25 Jahre,69,38,31
False,8226086,Spechbach,25 - 30 Jahre,131,65,66
False,8226086,Spechbach,30 - 35 Jahre,132,68,64
False,8226086,Spechbach,35 - 40 Jahre,141,66,75
False,8226086,Spechbach,40 - 45 Jahre,104,60,44
False,8226086,Spechbach,45 - 50 Jahre,98,52,46
False,8226086,Spechbach,50 - 55 Jahre,85,40,45
False,8226086,Spechbach,55 - 60 Jahre,112,54,58
False,8226086,Spechbach,60 - 65 Jahre,92,43,49
False,8226086,Spechbach,65 - 75 Jahre,137,60,77
False,8226086,Spechbach,75 und mehr Jahre,108,30,78
False,8226086,Spechbach,Insgesamt,1594,789,805
False,8226091,"Waibstadt, Stadt",unter 3 Jahre,193,103,90
False,8226091,"Waibstadt, Stadt",3 -  6 Jahre,216,118,98
False,8226091,"Waibstadt, Stadt",6 - 10 Jahre,303,147,156
False,8226091,"Waibstadt, Stadt",10 - 15 Jahre,350,177,173
False,8226091,"Waibstadt, Stadt",15 - 18 Jahre,175,102,73
False,8226091,"Waibstadt, Stadt",18 - 20 Jahre,120,64,56
False,8226091,"Waibstadt, Stadt",20 - 25 Jahre,303,160,143
False,8226091,"Waibstadt, Stadt",25 - 30 Jahre,443,237,206
False,8226091,"Waibstadt, Stadt",30 - 35 Jahre,472,239,233
False,8226091,"Waibstadt, Stadt",35 - 40 Jahre,425,207,218
False,8226091,"Waibstadt, Stadt",40 - 45 Jahre,399,201,198
False,8226091,"Waibstadt, Stadt",45 - 50 Jahre,368,197,171
False,8226091,"Waibstadt, Stadt",50 - 55 Jahre,303,163,140
False,8226091,"Waibstadt, Stadt",55 - 60 Jahre,435,216,219
False,8226091,"Waibstadt, Stadt",60 - 65 Jahre,298,154,144
False,8226091,"Waibstadt, Stadt",65 - 75 Jahre,485,203,282
False,8226091,"Waibstadt, Stadt",75 und mehr Jahre,312,86,226
False,8226091,"Waibstadt, Stadt",Insgesamt,5600,2774,2826
False,8226095,"Walldorf, Stadt",unter 3 Jahre,425,232,193
False,8226095,"Walldorf, Stadt",3 -  6 Jahre,482,245,237
False,8226095,"Walldorf, Stadt",6 - 10 Jahre,639,334,305
False,8226095,"Walldorf, Stadt",10 - 15 Jahre,760,372,388
False,8226095,"Walldorf, Stadt",15 - 18 Jahre,445,214,231
False,8226095,"Walldorf, Stadt",18 - 20 Jahre,297,149,148
False,8226095,"Walldorf, Stadt",20 - 25 Jahre,755,405,350
False,8226095,"Walldorf, Stadt",25 - 30 Jahre,1160,613,547
False,8226095,"Walldorf, Stadt",30 - 35 Jahre,1323,691,632
False,8226095,"Walldorf, Stadt",35 - 40 Jahre,1111,579,532
False,8226095,"Walldorf, Stadt",40 - 45 Jahre,953,482,471
False,8226095,"Walldorf, Stadt",45 - 50 Jahre,957,467,490
False,8226095,"Walldorf, Stadt",50 - 55 Jahre,890,436,454
False,8226095,"Walldorf, Stadt",55 - 60 Jahre,1125,569,556
False,8226095,"Walldorf, Stadt",60 - 65 Jahre,793,407,386
False,8226095,"Walldorf, Stadt",65 - 75 Jahre,1235,551,684
False,8226095,"Walldorf, Stadt",75 und mehr Jahre,635,199,436
False,8226095,"Walldorf, Stadt",Insgesamt,13985,6945,7040
False,8226096,"Weinheim, Stadt",unter 3 Jahre,1210,628,582
False,8226096,"Weinheim, Stadt",3 -  6 Jahre,1307,702,605
False,8226096,"Weinheim, Stadt",6 - 10 Jahre,1626,819,807
False,8226096,"Weinheim, Stadt",10 - 15 Jahre,2035,1048,987
False,8226096,"Weinheim, Stadt",15 - 18 Jahre,1238,624,614
False,8226096,"Weinheim, Stadt",18 - 20 Jahre,837,414,423
False,8226096,"Weinheim, Stadt",20 - 25 Jahre,2321,1150,1171
False,8226096,"Weinheim, Stadt",25 - 30 Jahre,3196,1676,1520
False,8226096,"Weinheim, Stadt",30 - 35 Jahre,3542,1831,1711
False,8226096,"Weinheim, Stadt",35 - 40 Jahre,3136,1635,1501
False,8226096,"Weinheim, Stadt",40 - 45 Jahre,2726,1365,1361
False,8226096,"Weinheim, Stadt",45 - 50 Jahre,2786,1336,1450
False,8226096,"Weinheim, Stadt",50 - 55 Jahre,3056,1526,1530
False,8226096,"Weinheim, Stadt",55 - 60 Jahre,3554,1780,1774
False,8226096,"Weinheim, Stadt",60 - 65 Jahre,2616,1290,1326
False,8226096,"Weinheim, Stadt",65 - 75 Jahre,4404,1901,2503
False,8226096,"Weinheim, Stadt",75 und mehr Jahre,3222,1023,2199
False,8226096,"Weinheim, Stadt",Insgesamt,42812,20748,22064
False,8226097,Wiesenbach,unter 3 Jahre,111,56,55
False,8226097,Wiesenbach,3 -  6 Jahre,126,59,67
False,8226097,Wiesenbach,6 - 10 Jahre,126,70,56
False,8226097,Wiesenbach,10 - 15 Jahre,165,85,80
False,8226097,Wiesenbach,15 - 18 Jahre,98,54,44
False,8226097,Wiesenbach,18 - 20 Jahre,78,40,38
False,8226097,Wiesenbach,20 - 25 Jahre,143,74,69
False,8226097,Wiesenbach,25 - 30 Jahre,216,106,110
False,8226097,Wiesenbach,30 - 35 Jahre,241,112,129
False,8226097,Wiesenbach,35 - 40 Jahre,247,121,126
False,8226097,Wiesenbach,40 - 45 Jahre,205,95,110
False,8226097,Wiesenbach,45 - 50 Jahre,184,81,103
False,8226097,Wiesenbach,50 - 55 Jahre,228,116,112
False,8226097,Wiesenbach,55 - 60 Jahre,226,105,121
False,8226097,Wiesenbach,60 - 65 Jahre,172,96,76
False,8226097,Wiesenbach,65 - 75 Jahre,242,110,132
False,8226097,Wiesenbach,75 und mehr Jahre,141,48,93
False,8226097,Wiesenbach,Insgesamt,2949,1428,1521
False,8226098,"Wiesloch, Stadt",unter 3 Jahre,753,384,369
False,8226098,"Wiesloch, Stadt",3 -  6 Jahre,847,408,439
False,8226098,"Wiesloch, Stadt",6 - 10 Jahre,1144,583,561
False,8226098,"Wiesloch, Stadt",10 - 15 Jahre,1289,661,628
False,8226098,"Wiesloch, Stadt",15 - 18 Jahre,760,368,392
False,8226098,"Wiesloch, Stadt",18 - 20 Jahre,524,260,264
False,8226098,"Wiesloch, Stadt",20 - 25 Jahre,1336,683,653
False,8226098,"Wiesloch, Stadt",25 - 30 Jahre,2030,1067,963
False,8226098,"Wiesloch, Stadt",30 - 35 Jahre,2296,1170,1126
False,8226098,"Wiesloch, Stadt",35 - 40 Jahre,2113,1085,1028
False,8226098,"Wiesloch, Stadt",40 - 45 Jahre,1860,971,889
False,8226098,"Wiesloch, Stadt",45 - 50 Jahre,1635,818,817
False,8226098,"Wiesloch, Stadt",50 - 55 Jahre,1492,774,718
False,8226098,"Wiesloch, Stadt",55 - 60 Jahre,1707,875,832
False,8226098,"Wiesloch, Stadt",60 - 65 Jahre,1313,672,641
False,8226098,"Wiesloch, Stadt",65 - 75 Jahre,2181,884,1297
False,8226098,"Wiesloch, Stadt",75 und mehr Jahre,1367,426,941
False,8226098,"Wiesloch, Stadt",Insgesamt,24647,12089,12558
False,8226099,Wilhelmsfeld,unter 3 Jahre,105,53,52
False,8226099,Wilhelmsfeld,3 -  6 Jahre,120,58,62
False,8226099,Wilhelmsfeld,6 - 10 Jahre,154,75,79
False,8226099,Wilhelmsfeld,10 - 15 Jahre,156,78,78
False,8226099,Wilhelmsfeld,15 - 18 Jahre,83,42,41
False,8226099,Wilhelmsfeld,18 - 20 Jahre,66,35,31
False,8226099,Wilhelmsfeld,20 - 25 Jahre,160,79,81
False,8226099,Wilhelmsfeld,25 - 30 Jahre,296,153,143
False,8226099,Wilhelmsfeld,30 - 35 Jahre,292,152,140
False,8226099,Wilhelmsfeld,35 - 40 Jahre,275,148,127
False,8226099,Wilhelmsfeld,40 - 45 Jahre,241,130,111
False,8226099,Wilhelmsfeld,45 - 50 Jahre,216,118,98
False,8226099,Wilhelmsfeld,50 - 55 Jahre,195,85,110
False,8226099,Wilhelmsfeld,55 - 60 Jahre,252,134,118
False,8226099,Wilhelmsfeld,60 - 65 Jahre,194,102,92
False,8226099,Wilhelmsfeld,65 - 75 Jahre,284,126,158
False,8226099,Wilhelmsfeld,75 und mehr Jahre,208,71,137
False,8226099,Wilhelmsfeld,Insgesamt,3297,1639,1658
False,8226101,Zuzenhausen,unter 3 Jahre,73,34,39
False,8226101,Zuzenhausen,3 -  6 Jahre,76,42,34
False,8226101,Zuzenhausen,6 - 10 Jahre,87,42,45
False,8226101,Zuzenhausen,10 - 15 Jahre,106,58,48
False,8226101,Zuzenhausen,15 - 18 Jahre,66,28,38
False,8226101,Zuzenhausen,18 - 20 Jahre,41,17,24
False,8226101,Zuzenhausen,20 - 25 Jahre,122,66,56
False,8226101,Zuzenhausen,25 - 30 Jahre,178,93,85
False,8226101,Zuzenhausen,30 - 35 Jahre,183,95,88
False,8226101,Zuzenhausen,35 - 40 Jahre,144,78,66
False,8226101,Zuzenhausen,40 - 45 Jahre,113,51,62
False,8226101,Zuzenhausen,45 - 50 Jahre,116,55,61
False,8226101,Zuzenhausen,50 - 55 Jahre,122,62,60
False,8226101,Zuzenhausen,55 - 60 Jahre,136,67,69
False,8226101,Zuzenhausen,60 - 65 Jahre,119,55,64
False,8226101,Zuzenhausen,65 - 75 Jahre,180,79,101
False,8226101,Zuzenhausen,75 und mehr Jahre,85,17,68
False,8226101,Zuzenhausen,Insgesamt,1947,939,1008
False,8226102,Angelbachtal,unter 3 Jahre,171,74,97
False,8226102,Angelbachtal,3 -  6 Jahre,193,103,90
False,8226102,Angelbachtal,6 - 10 Jahre,222,116,106
False,8226102,Angelbachtal,10 - 15 Jahre,245,131,114
False,8226102,Angelbachtal,15 - 18 Jahre,125,71,54
False,8226102,Angelbachtal,18 - 20 Jahre,81,39,42
False,8226102,Angelbachtal,20 - 25 Jahre,247,129,118
False,8226102,Angelbachtal,25 - 30 Jahre,367,188,179
False,8226102,Angelbachtal,30 - 35 Jahre,470,249,221
False,8226102,Angelbachtal,35 - 40 Jahre,359,195,164
False,8226102,Angelbachtal,40 - 45 Jahre,288,153,135
False,8226102,Angelbachtal,45 - 50 Jahre,278,138,140
False,8226102,Angelbachtal,50 - 55 Jahre,243,126,117
False,8226102,Angelbachtal,55 - 60 Jahre,294,149,145
False,8226102,Angelbachtal,60 - 65 Jahre,207,98,109
False,8226102,Angelbachtal,65 - 75 Jahre,353,155,198
False,8226102,Angelbachtal,75 und mehr Jahre,284,66,218
False,8226102,Angelbachtal,Insgesamt,4427,2180,2247
False,8226103,St. Leon-Rot,unter 3 Jahre,444,232,212
False,8226103,St. Leon-Rot,3 -  6 Jahre,505,269,236
False,8226103,St. Leon-Rot,6 - 10 Jahre,625,312,313
False,8226103,St. Leon-Rot,10 - 15 Jahre,717,362,355
False,8226103,St. Leon-Rot,15 - 18 Jahre,389,208,181
False,8226103,St. Leon-Rot,18 - 20 Jahre,208,112,96
False,8226103,St. Leon-Rot,20 - 25 Jahre,607,326,281
False,8226103,St. Leon-Rot,25 - 30 Jahre,946,449,497
False,8226103,St. Leon-Rot,30 - 35 Jahre,1175,626,549
False,8226103,St. Leon-Rot,35 - 40 Jahre,1096,557,539
False,8226103,St. Leon-Rot,40 - 45 Jahre,827,429,398
False,8226103,St. Leon-Rot,45 - 50 Jahre,752,384,368
False,8226103,St. Leon-Rot,50 - 55 Jahre,571,291,280
False,8226103,St. Leon-Rot,55 - 60 Jahre,786,418,368
False,8226103,St. Leon-Rot,60 - 65 Jahre,662,328,334
False,8226103,St. Leon-Rot,65 - 75 Jahre,911,386,525
False,8226103,St. Leon-Rot,75 und mehr Jahre,422,129,293
False,8226103,St. Leon-Rot,Insgesamt,11643,5818,5825
False,8226104,Lobbach,unter 3 Jahre,88,44,44
False,8226104,Lobbach,3 -  6 Jahre,80,39,41
False,8226104,Lobbach,6 - 10 Jahre,124,61,63
False,8226104,Lobbach,10 - 15 Jahre,135,76,59
False,8226104,Lobbach,15 - 18 Jahre,102,50,52
False,8226104,Lobbach,18 - 20 Jahre,43,24,19
False,8226104,Lobbach,20 - 25 Jahre,118,52,66
False,8226104,Lobbach,25 - 30 Jahre,191,102,89
False,8226104,Lobbach,30 - 35 Jahre,195,94,101
False,8226104,Lobbach,35 - 40 Jahre,206,106,100
False,8226104,Lobbach,40 - 45 Jahre,210,111,99
False,8226104,Lobbach,45 - 50 Jahre,152,80,72
False,8226104,Lobbach,50 - 55 Jahre,133,65,68
False,8226104,Lobbach,55 - 60 Jahre,156,91,65
False,8226104,Lobbach,60 - 65 Jahre,104,50,54
False,8226104,Lobbach,65 - 75 Jahre,214,92,122
False,8226104,Lobbach,75 und mehr Jahre,131,33,98
False,8226104,Lobbach,Insgesamt,2382,1170,1212
False,8226105,Edingen-Neckarhausen,unter 3 Jahre,413,206,207
False,8226105,Edingen-Neckarhausen,3 -  6 Jahre,405,202,203
False,8226105,Edingen-Neckarhausen,6 - 10 Jahre,512,263,249
False,8226105,Edingen-Neckarhausen,10 - 15 Jahre,669,361,308
False,8226105,Edingen-Neckarhausen,15 - 18 Jahre,432,211,221
False,8226105,Edingen-Neckarhausen,18 - 20 Jahre,230,112,118
False,8226105,Edingen-Neckarhausen,20 - 25 Jahre,669,339,330
False,8226105,Edingen-Neckarhausen,25 - 30 Jahre,1027,483,544
False,8226105,Edingen-Neckarhausen,30 - 35 Jahre,1220,641,579
False,8226105,Edingen-Neckarhausen,35 - 40 Jahre,1076,545,531
False,8226105,Edingen-Neckarhausen,40 - 45 Jahre,958,479,479
False,8226105,Edingen-Neckarhausen,45 - 50 Jahre,965,456,509
False,8226105,Edingen-Neckarhausen,50 - 55 Jahre,920,447,473
False,8226105,Edingen-Neckarhausen,55 - 60 Jahre,1077,552,525
False,8226105,Edingen-Neckarhausen,60 - 65 Jahre,851,419,432
False,8226105,Edingen-Neckarhausen,65 - 75 Jahre,1454,636,818
False,8226105,Edingen-Neckarhausen,75 und mehr Jahre,956,329,627
False,8226105,Edingen-Neckarhausen,Insgesamt,13834,6681,7153
False,8226106,Helmstadt-Bargen,unter 3 Jahre,146,73,73
False,8226106,Helmstadt-Bargen,3 -  6 Jahre,172,95,77
False,8226106,Helmstadt-Bargen,6 - 10 Jahre,220,119,101
False,8226106,Helmstadt-Bargen,10 - 15 Jahre,251,131,120
False,8226106,Helmstadt-Bargen,15 - 18 Jahre,148,64,84
False,8226106,Helmstadt-Bargen,18 - 20 Jahre,78,38,40
False,8226106,Helmstadt-Bargen,20 - 25 Jahre,187,103,84
False,8226106,Helmstadt-Bargen,25 - 30 Jahre,262,125,137
False,8226106,Helmstadt-Bargen,30 - 35 Jahre,333,176,157
False,8226106,Helmstadt-Bargen,35 - 40 Jahre,362,177,185
False,8226106,Helmstadt-Bargen,40 - 45 Jahre,258,132,126
False,8226106,Helmstadt-Bargen,45 - 50 Jahre,227,115,112
False,8226106,Helmstadt-Bargen,50 - 55 Jahre,178,106,72
False,8226106,Helmstadt-Bargen,55 - 60 Jahre,242,123,119
False,8226106,Helmstadt-Bargen,60 - 65 Jahre,200,97,103
False,8226106,Helmstadt-Bargen,65 - 75 Jahre,328,143,185
False,8226106,Helmstadt-Bargen,75 und mehr Jahre,170,56,114
False,8226106,Helmstadt-Bargen,Insgesamt,3762,1873,1889
False,8226107,Hirschberg an der Bergstraße,unter 3 Jahre,264,146,118
False,8226107,Hirschberg an der Bergstraße,3 -  6 Jahre,237,117,120
False,8226107,Hirschberg an der Bergstraße,6 - 10 Jahre,355,183,172
False,8226107,Hirschberg an der Bergstraße,10 - 15 Jahre,468,223,245
False,8226107,Hirschberg an der Bergstraße,15 - 18 Jahre,305,161,144
False,8226107,Hirschberg an der Bergstraße,18 - 20 Jahre,202,100,102
False,8226107,Hirschberg an der Bergstraße,20 - 25 Jahre,565,267,298
False,8226107,Hirschberg an der Bergstraße,25 - 30 Jahre,760,405,355
False,8226107,Hirschberg an der Bergstraße,30 - 35 Jahre,909,466,443
False,8226107,Hirschberg an der Bergstraße,35 - 40 Jahre,702,355,347
False,8226107,Hirschberg an der Bergstraße,40 - 45 Jahre,632,299,333
False,8226107,Hirschberg an der Bergstraße,45 - 50 Jahre,710,334,376
False,8226107,Hirschberg an der Bergstraße,50 - 55 Jahre,721,355,366
False,8226107,Hirschberg an der Bergstraße,55 - 60 Jahre,784,395,389
False,8226107,Hirschberg an der Bergstraße,60 - 65 Jahre,557,288,269
False,8226107,Hirschberg an der Bergstraße,65 - 75 Jahre,918,417,501
False,8226107,Hirschberg an der Bergstraße,75 und mehr Jahre,555,192,363
False,8226107,Hirschberg an der Bergstraße,Insgesamt,9644,4703,4941
False,8231,Stadtkreis Pforzheim,unter 3 Jahre,3643,1874,1769
False,8231,Stadtkreis Pforzheim,3 -  6 Jahre,3783,1914,1869
False,8231,Stadtkreis Pforzheim,6 - 10 Jahre,4939,2575,2364
False,8231,Stadtkreis Pforzheim,10 - 15 Jahre,6073,3069,3004
False,8231,Stadtkreis Pforzheim,15 - 18 Jahre,3492,1732,1760
False,8231,Stadtkreis Pforzheim,18 - 20 Jahre,2501,1241,1260
False,8231,Stadtkreis Pforzheim,20 - 25 Jahre,7376,3624,3752
False,8231,Stadtkreis Pforzheim,25 - 30 Jahre,9873,5062,4811
False,8231,Stadtkreis Pforzheim,30 - 35 Jahre,10370,5432,4938
False,8231,Stadtkreis Pforzheim,35 - 40 Jahre,8901,4571,4330
False,8231,Stadtkreis Pforzheim,40 - 45 Jahre,7707,3839,3868
False,8231,Stadtkreis Pforzheim,45 - 50 Jahre,7130,3455,3675
False,8231,Stadtkreis Pforzheim,50 - 55 Jahre,7195,3467,3728
False,8231,Stadtkreis Pforzheim,55 - 60 Jahre,8658,4200,4458
False,8231,Stadtkreis Pforzheim,60 - 65 Jahre,6712,3135,3577
False,8231,Stadtkreis Pforzheim,65 - 75 Jahre,11446,4506,6940
False,8231,Stadtkreis Pforzheim,75 und mehr Jahre,8964,2556,6408
False,8231,Stadtkreis Pforzheim,Insgesamt,118763,56252,62511
False,8231000,"Pforzheim, Stadt",unter 3 Jahre,3643,1874,1769
False,8231000,"Pforzheim, Stadt",3 -  6 Jahre,3783,1914,1869
False,8231000,"Pforzheim, Stadt",6 - 10 Jahre,4939,2575,2364
False,8231000,"Pforzheim, Stadt",10 - 15 Jahre,6073,3069,3004
False,8231000,"Pforzheim, Stadt",15 - 18 Jahre,3492,1732,1760
False,8231000,"Pforzheim, Stadt",18 - 20 Jahre,2501,1241,1260
False,8231000,"Pforzheim, Stadt",20 - 25 Jahre,7376,3624,3752
False,8231000,"Pforzheim, Stadt",25 - 30 Jahre,9873,5062,4811
False,8231000,"Pforzheim, Stadt",30 - 35 Jahre,10370,5432,4938
False,8231000,"Pforzheim, Stadt",35 - 40 Jahre,8901,4571,4330
False,8231000,"Pforzheim, Stadt",40 - 45 Jahre,7707,3839,3868
False,8231000,"Pforzheim, Stadt",45 - 50 Jahre,7130,3455,3675
False,8231000,"Pforzheim, Stadt",50 - 55 Jahre,7195,3467,3728
False,8231000,"Pforzheim, Stadt",55 - 60 Jahre,8658,4200,4458
False,8231000,"Pforzheim, Stadt",60 - 65 Jahre,6712,3135,3577
False,8231000,"Pforzheim, Stadt",65 - 75 Jahre,11446,4506,6940
False,8231000,"Pforzheim, Stadt",75 und mehr Jahre,8964,2556,6408
False,8231000,"Pforzheim, Stadt",Insgesamt,118763,56252,62511
False,8235,Landkreis Calw,unter 3 Jahre,5662,2909,2753
False,8235,Landkreis Calw,3 -  6 Jahre,6218,3180,3038
False,8235,Landkreis Calw,6 - 10 Jahre,8266,4265,4001
False,8235,Landkreis Calw,10 - 15 Jahre,9312,4787,4525
False,8235,Landkreis Calw,15 - 18 Jahre,5251,2674,2577
False,8235,Landkreis Calw,18 - 20 Jahre,3588,1862,1726
False,8235,Landkreis Calw,20 - 25 Jahre,9776,4993,4783
False,8235,Landkreis Calw,25 - 30 Jahre,13012,6667,6345
False,8235,Landkreis Calw,30 - 35 Jahre,13973,7247,6726
False,8235,Landkreis Calw,35 - 40 Jahre,12244,6263,5981
False,8235,Landkreis Calw,40 - 45 Jahre,10737,5464,5273
False,8235,Landkreis Calw,45 - 50 Jahre,9258,4770,4488
False,8235,Landkreis Calw,50 - 55 Jahre,8558,4429,4129
False,8235,Landkreis Calw,55 - 60 Jahre,10460,5076,5384
False,8235,Landkreis Calw,60 - 65 Jahre,8116,4050,4066
False,8235,Landkreis Calw,65 - 75 Jahre,13127,5371,7756
False,8235,Landkreis Calw,75 und mehr Jahre,9619,2874,6745
False,8235,Landkreis Calw,Insgesamt,157177,76881,80296
False,8235006,"Altensteig, Stadt",unter 3 Jahre,377,182,195
False,8235006,"Altensteig, Stadt",3 -  6 Jahre,450,210,240
False,8235006,"Altensteig, Stadt",6 - 10 Jahre,616,321,295
False,8235006,"Altensteig, Stadt",10 - 15 Jahre,728,351,377
False,8235006,"Altensteig, Stadt",15 - 18 Jahre,425,211,214
False,8235006,"Altensteig, Stadt",18 - 20 Jahre,316,173,143
False,8235006,"Altensteig, Stadt",20 - 25 Jahre,734,389,345
False,8235006,"Altensteig, Stadt",25 - 30 Jahre,857,443,414
False,8235006,"Altensteig, Stadt",30 - 35 Jahre,869,460,409
False,8235006,"Altensteig, Stadt",35 - 40 Jahre,781,389,392
False,8235006,"Altensteig, Stadt",40 - 45 Jahre,685,349,336
False,8235006,"Altensteig, Stadt",45 - 50 Jahre,598,331,267
False,8235006,"Altensteig, Stadt",50 - 55 Jahre,537,268,269
False,8235006,"Altensteig, Stadt",55 - 60 Jahre,686,353,333
False,8235006,"Altensteig, Stadt",60 - 65 Jahre,575,283,292
False,8235006,"Altensteig, Stadt",65 - 75 Jahre,918,375,543
False,8235006,"Altensteig, Stadt",75 und mehr Jahre,677,182,495
False,8235006,"Altensteig, Stadt",Insgesamt,10829,5270,5559
False,8235007,Althengstett,unter 3 Jahre,337,173,164
False,8235007,Althengstett,3 -  6 Jahre,364,172,192
False,8235007,Althengstett,6 - 10 Jahre,474,235,239
False,8235007,Althengstett,10 - 15 Jahre,494,251,243
False,8235007,Althengstett,15 - 18 Jahre,286,145,141
False,8235007,Althengstett,18 - 20 Jahre,168,83,85
False,8235007,Althengstett,20 - 25 Jahre,473,234,239
False,8235007,Althengstett,25 - 30 Jahre,600,286,314
False,8235007,Althengstett,30 - 35 Jahre,759,385,374
False,8235007,Althengstett,35 - 40 Jahre,653,326,327
False,8235007,Althengstett,40 - 45 Jahre,604,295,309
False,8235007,Althengstett,45 - 50 Jahre,492,263,229
False,8235007,Althengstett,50 - 55 Jahre,394,208,186
False,8235007,Althengstett,55 - 60 Jahre,405,223,182
False,8235007,Althengstett,60 - 65 Jahre,293,143,150
False,8235007,Althengstett,65 - 75 Jahre,452,198,254
False,8235007,Althengstett,75 und mehr Jahre,285,105,180
False,8235007,Althengstett,Insgesamt,7533,3725,3808
False,8235008,"Bad Liebenzell, Stadt",unter 3 Jahre,294,154,140
False,8235008,"Bad Liebenzell, Stadt",3 -  6 Jahre,314,183,131
False,8235008,"Bad Liebenzell, Stadt",6 - 10 Jahre,441,247,194
False,8235008,"Bad Liebenzell, Stadt",10 - 15 Jahre,539,290,249
False,8235008,"Bad Liebenzell, Stadt",15 - 18 Jahre,266,134,132
False,8235008,"Bad Liebenzell, Stadt",18 - 20 Jahre,200,100,100
False,8235008,"Bad Liebenzell, Stadt",20 - 25 Jahre,552,246,306
False,8235008,"Bad Liebenzell, Stadt",25 - 30 Jahre,780,401,379
False,8235008,"Bad Liebenzell, Stadt",30 - 35 Jahre,825,416,409
False,8235008,"Bad Liebenzell, Stadt",35 - 40 Jahre,722,345,377
False,8235008,"Bad Liebenzell, Stadt",40 - 45 Jahre,619,330,289
False,8235008,"Bad Liebenzell, Stadt",45 - 50 Jahre,512,251,261
False,8235008,"Bad Liebenzell, Stadt",50 - 55 Jahre,486,233,253
False,8235008,"Bad Liebenzell, Stadt",55 - 60 Jahre,545,225,320
False,8235008,"Bad Liebenzell, Stadt",60 - 65 Jahre,409,179,230
False,8235008,"Bad Liebenzell, Stadt",65 - 75 Jahre,888,346,542
False,8235008,"Bad Liebenzell, Stadt",75 und mehr Jahre,657,237,420
False,8235008,"Bad Liebenzell, Stadt",Insgesamt,9049,4317,4732
False,8235018,Dobel,unter 3 Jahre,66,35,31
False,8235018,Dobel,3 -  6 Jahre,80,40,40
False,8235018,Dobel,6 - 10 Jahre,125,59,66
False,8235018,Dobel,10 - 15 Jahre,137,81,56
False,8235018,Dobel,15 - 18 Jahre,56,22,34
False,8235018,Dobel,18 - 20 Jahre,31,20,11
False,8235018,Dobel,20 - 25 Jahre,106,44,62
False,8235018,Dobel,25 - 30 Jahre,167,71,96
False,8235018,Dobel,30 - 35 Jahre,206,106,100
False,8235018,Dobel,35 - 40 Jahre,183,91,92
False,8235018,Dobel,40 - 45 Jahre,150,86,64
False,8235018,Dobel,45 - 50 Jahre,125,65,60
False,8235018,Dobel,50 - 55 Jahre,97,42,55
False,8235018,Dobel,55 - 60 Jahre,149,84,65
False,8235018,Dobel,60 - 65 Jahre,125,55,70
False,8235018,Dobel,65 - 75 Jahre,244,96,148
False,8235018,Dobel,75 und mehr Jahre,203,72,131
False,8235018,Dobel,Insgesamt,2250,1069,1181
False,8235020,Ebhausen,unter 3 Jahre,228,119,109
False,8235020,Ebhausen,3 -  6 Jahre,241,123,118
False,8235020,Ebhausen,6 - 10 Jahre,260,116,144
False,8235020,Ebhausen,10 - 15 Jahre,302,160,142
False,8235020,Ebhausen,15 - 18 Jahre,181,89,92
False,8235020,Ebhausen,18 - 20 Jahre,76,39,37
False,8235020,Ebhausen,20 - 25 Jahre,254,139,115
False,8235020,Ebhausen,25 - 30 Jahre,375,197,178
False,8235020,Ebhausen,30 - 35 Jahre,398,205,193
False,8235020,Ebhausen,35 - 40 Jahre,344,192,152
False,8235020,Ebhausen,40 - 45 Jahre,275,141,134
False,8235020,Ebhausen,45 - 50 Jahre,233,126,107
False,8235020,Ebhausen,50 - 55 Jahre,215,105,110
False,8235020,Ebhausen,55 - 60 Jahre,280,144,136
False,8235020,Ebhausen,60 - 65 Jahre,218,112,106
False,8235020,Ebhausen,65 - 75 Jahre,330,137,193
False,8235020,Ebhausen,75 und mehr Jahre,188,46,142
False,8235020,Ebhausen,Insgesamt,4398,2190,2208
False,8235022,Egenhausen,unter 3 Jahre,79,41,38
False,8235022,Egenhausen,3 -  6 Jahre,96,43,53
False,8235022,Egenhausen,6 - 10 Jahre,116,53,63
False,8235022,Egenhausen,10 - 15 Jahre,124,63,61
False,8235022,Egenhausen,15 - 18 Jahre,71,32,39
False,8235022,Egenhausen,18 - 20 Jahre,39,18,21
False,8235022,Egenhausen,20 - 25 Jahre,107,52,55
False,8235022,Egenhausen,25 - 30 Jahre,157,82,75
False,8235022,Egenhausen,30 - 35 Jahre,162,86,76
False,8235022,Egenhausen,35 - 40 Jahre,137,70,67
False,8235022,Egenhausen,40 - 45 Jahre,99,49,50
False,8235022,Egenhausen,45 - 50 Jahre,99,53,46
False,8235022,Egenhausen,50 - 55 Jahre,98,51,47
False,8235022,Egenhausen,55 - 60 Jahre,130,62,68
False,8235022,Egenhausen,60 - 65 Jahre,87,43,44
False,8235022,Egenhausen,65 - 75 Jahre,141,62,79
False,8235022,Egenhausen,75 und mehr Jahre,72,22,50
False,8235022,Egenhausen,Insgesamt,1814,882,932
False,8235025,Enzklösterle,unter 3 Jahre,46,18,28
False,8235025,Enzklösterle,3 -  6 Jahre,56,32,24
False,8235025,Enzklösterle,6 - 10 Jahre,67,38,29
False,8235025,Enzklösterle,10 - 15 Jahre,72,40,32
False,8235025,Enzklösterle,15 - 18 Jahre,49,20,29
False,8235025,Enzklösterle,18 - 20 Jahre,33,19,14
False,8235025,Enzklösterle,20 - 25 Jahre,79,39,40
False,8235025,Enzklösterle,25 - 30 Jahre,112,48,64
False,8235025,Enzklösterle,30 - 35 Jahre,105,60,45
False,8235025,Enzklösterle,35 - 40 Jahre,87,47,40
False,8235025,Enzklösterle,40 - 45 Jahre,72,30,42
False,8235025,Enzklösterle,45 - 50 Jahre,90,46,44
False,8235025,Enzklösterle,50 - 55 Jahre,70,36,34
False,8235025,Enzklösterle,55 - 60 Jahre,105,50,55
False,8235025,Enzklösterle,60 - 65 Jahre,85,44,41
False,8235025,Enzklösterle,65 - 75 Jahre,155,57,98
False,8235025,Enzklösterle,75 und mehr Jahre,108,30,78
False,8235025,Enzklösterle,Insgesamt,1391,654,737
False,8235029,Gechingen,unter 3 Jahre,150,78,72
False,8235029,Gechingen,3 -  6 Jahre,164,83,81
False,8235029,Gechingen,6 - 10 Jahre,221,101,120
False,8235029,Gechingen,10 - 15 Jahre,222,105,117
False,8235029,Gechingen,15 - 18 Jahre,130,67,63
False,8235029,Gechingen,18 - 20 Jahre,80,39,41
False,8235029,Gechingen,20 - 25 Jahre,215,116,99
False,8235029,Gechingen,25 - 30 Jahre,324,163,161
False,8235029,Gechingen,30 - 35 Jahre,374,186,188
False,8235029,Gechingen,35 - 40 Jahre,322,167,155
False,8235029,Gechingen,40 - 45 Jahre,293,147,146
False,8235029,Gechingen,45 - 50 Jahre,222,103,119
False,8235029,Gechingen,50 - 55 Jahre,229,121,108
False,8235029,Gechingen,55 - 60 Jahre,257,132,125
False,8235029,Gechingen,60 - 65 Jahre,168,95,73
False,8235029,Gechingen,65 - 75 Jahre,253,104,149
False,8235029,Gechingen,75 und mehr Jahre,150,51,99
False,8235029,Gechingen,Insgesamt,3774,1858,1916
False,8235032,"Haiterbach, Stadt",unter 3 Jahre,245,117,128
False,8235032,"Haiterbach, Stadt",3 -  6 Jahre,250,123,127
False,8235032,"Haiterbach, Stadt",6 - 10 Jahre,313,160,153
False,8235032,"Haiterbach, Stadt",10 - 15 Jahre,352,183,169
False,8235032,"Haiterbach, Stadt",15 - 18 Jahre,203,107,96
False,8235032,"Haiterbach, Stadt",18 - 20 Jahre,157,84,73
False,8235032,"Haiterbach, Stadt",20 - 25 Jahre,416,229,187
False,8235032,"Haiterbach, Stadt",25 - 30 Jahre,438,223,215
False,8235032,"Haiterbach, Stadt",30 - 35 Jahre,512,279,233
False,8235032,"Haiterbach, Stadt",35 - 40 Jahre,438,231,207
False,8235032,"Haiterbach, Stadt",40 - 45 Jahre,406,208,198
False,8235032,"Haiterbach, Stadt",45 - 50 Jahre,329,171,158
False,8235032,"Haiterbach, Stadt",50 - 55 Jahre,297,148,149
False,8235032,"Haiterbach, Stadt",55 - 60 Jahre,351,171,180
False,8235032,"Haiterbach, Stadt",60 - 65 Jahre,297,165,132
False,8235032,"Haiterbach, Stadt",65 - 75 Jahre,375,157,218
False,8235032,"Haiterbach, Stadt",75 und mehr Jahre,304,79,225
False,8235032,"Haiterbach, Stadt",Insgesamt,5683,2835,2848
False,8235033,"Bad Herrenalb, Stadt",unter 3 Jahre,210,110,100
False,8235033,"Bad Herrenalb, Stadt",3 -  6 Jahre,214,112,102
False,8235033,"Bad Herrenalb, Stadt",6 - 10 Jahre,297,143,154
False,8235033,"Bad Herrenalb, Stadt",10 - 15 Jahre,305,144,161
False,8235033,"Bad Herrenalb, Stadt",15 - 18 Jahre,191,86,105
False,8235033,"Bad Herrenalb, Stadt",18 - 20 Jahre,152,74,78
False,8235033,"Bad Herrenalb, Stadt",20 - 25 Jahre,349,156,193
False,8235033,"Bad Herrenalb, Stadt",25 - 30 Jahre,558,286,272
False,8235033,"Bad Herrenalb, Stadt",30 - 35 Jahre,587,286,301
False,8235033,"Bad Herrenalb, Stadt",35 - 40 Jahre,507,262,245
False,8235033,"Bad Herrenalb, Stadt",40 - 45 Jahre,447,240,207
False,8235033,"Bad Herrenalb, Stadt",45 - 50 Jahre,417,214,203
False,8235033,"Bad Herrenalb, Stadt",50 - 55 Jahre,366,180,186
False,8235033,"Bad Herrenalb, Stadt",55 - 60 Jahre,518,215,303
False,8235033,"Bad Herrenalb, Stadt",60 - 65 Jahre,421,196,225
False,8235033,"Bad Herrenalb, Stadt",65 - 75 Jahre,933,356,577
False,8235033,"Bad Herrenalb, Stadt",75 und mehr Jahre,795,274,521
False,8235033,"Bad Herrenalb, Stadt",Insgesamt,7267,3334,3933
False,8235035,Höfen an der Enz,unter 3 Jahre,49,26,23
False,8235035,Höfen an der Enz,3 -  6 Jahre,55,27,28
False,8235035,Höfen an der Enz,6 - 10 Jahre,77,34,43
False,8235035,Höfen an der Enz,10 - 15 Jahre,101,50,51
False,8235035,Höfen an der Enz,15 - 18 Jahre,46,28,18
False,8235035,Höfen an der Enz,18 - 20 Jahre,32,17,15
False,8235035,Höfen an der Enz,20 - 25 Jahre,114,55,59
False,8235035,Höfen an der Enz,25 - 30 Jahre,140,81,59
False,8235035,Höfen an der Enz,30 - 35 Jahre,155,70,85
False,8235035,Höfen an der Enz,35 - 40 Jahre,151,82,69
False,8235035,Höfen an der Enz,40 - 45 Jahre,105,59,46
False,8235035,Höfen an der Enz,45 - 50 Jahre,105,58,47
False,8235035,Höfen an der Enz,50 - 55 Jahre,93,43,50
False,8235035,Höfen an der Enz,55 - 60 Jahre,113,52,61
False,8235035,Höfen an der Enz,60 - 65 Jahre,117,53,64
False,8235035,Höfen an der Enz,65 - 75 Jahre,123,52,71
False,8235035,Höfen an der Enz,75 und mehr Jahre,115,21,94
False,8235035,Höfen an der Enz,Insgesamt,1691,808,883
False,8235046,"Nagold, Stadt",unter 3 Jahre,744,385,359
False,8235046,"Nagold, Stadt",3 -  6 Jahre,811,414,397
False,8235046,"Nagold, Stadt",6 - 10 Jahre,1067,537,530
False,8235046,"Nagold, Stadt",10 - 15 Jahre,1253,647,606
False,8235046,"Nagold, Stadt",15 - 18 Jahre,774,402,372
False,8235046,"Nagold, Stadt",18 - 20 Jahre,554,248,306
False,8235046,"Nagold, Stadt",20 - 25 Jahre,1621,824,797
False,8235046,"Nagold, Stadt",25 - 30 Jahre,1969,1000,969
False,8235046,"Nagold, Stadt",30 - 35 Jahre,1869,933,936
False,8235046,"Nagold, Stadt",35 - 40 Jahre,1606,807,799
False,8235046,"Nagold, Stadt",40 - 45 Jahre,1610,797,813
False,8235046,"Nagold, Stadt",45 - 50 Jahre,1374,691,683
False,8235046,"Nagold, Stadt",50 - 55 Jahre,1259,669,590
False,8235046,"Nagold, Stadt",55 - 60 Jahre,1498,758,740
False,8235046,"Nagold, Stadt",60 - 65 Jahre,1195,615,580
False,8235046,"Nagold, Stadt",65 - 75 Jahre,1704,681,1023
False,8235046,"Nagold, Stadt",75 und mehr Jahre,1337,385,952
False,8235046,"Nagold, Stadt",Insgesamt,22245,10793,11452
False,8235047,"Neubulach, Stadt",unter 3 Jahre,246,129,117
False,8235047,"Neubulach, Stadt",3 -  6 Jahre,244,120,124
False,8235047,"Neubulach, Stadt",6 - 10 Jahre,289,155,134
False,8235047,"Neubulach, Stadt",10 - 15 Jahre,314,168,146
False,8235047,"Neubulach, Stadt",15 - 18 Jahre,161,86,75
False,8235047,"Neubulach, Stadt",18 - 20 Jahre,116,57,59
False,8235047,"Neubulach, Stadt",20 - 25 Jahre,294,153,141
False,8235047,"Neubulach, Stadt",25 - 30 Jahre,417,221,196
False,8235047,"Neubulach, Stadt",30 - 35 Jahre,450,244,206
False,8235047,"Neubulach, Stadt",35 - 40 Jahre,368,187,181
False,8235047,"Neubulach, Stadt",40 - 45 Jahre,372,199,173
False,8235047,"Neubulach, Stadt",45 - 50 Jahre,251,129,122
False,8235047,"Neubulach, Stadt",50 - 55 Jahre,227,119,108
False,8235047,"Neubulach, Stadt",55 - 60 Jahre,320,159,161
False,8235047,"Neubulach, Stadt",60 - 65 Jahre,245,119,126
False,8235047,"Neubulach, Stadt",65 - 75 Jahre,470,198,272
False,8235047,"Neubulach, Stadt",75 und mehr Jahre,240,69,171
False,8235047,"Neubulach, Stadt",Insgesamt,5024,2512,2512
False,8235050,Neuweiler,unter 3 Jahre,122,63,59
False,8235050,Neuweiler,3 -  6 Jahre,167,91,76
False,8235050,Neuweiler,6 - 10 Jahre,203,119,84
False,8235050,Neuweiler,10 - 15 Jahre,193,97,96
False,8235050,Neuweiler,15 - 18 Jahre,99,58,41
False,8235050,Neuweiler,18 - 20 Jahre,56,33,23
False,8235050,Neuweiler,20 - 25 Jahre,160,77,83
False,8235050,Neuweiler,25 - 30 Jahre,243,130,113
False,8235050,Neuweiler,30 - 35 Jahre,308,161,147
False,8235050,Neuweiler,35 - 40 Jahre,256,128,128
False,8235050,Neuweiler,40 - 45 Jahre,183,91,92
False,8235050,Neuweiler,45 - 50 Jahre,144,75,69
False,8235050,Neuweiler,50 - 55 Jahre,154,93,61
False,8235050,Neuweiler,55 - 60 Jahre,209,107,102
False,8235050,Neuweiler,60 - 65 Jahre,182,89,93
False,8235050,Neuweiler,65 - 75 Jahre,242,98,144
False,8235050,Neuweiler,75 und mehr Jahre,147,40,107
False,8235050,Neuweiler,Insgesamt,3068,1550,1518
False,8235055,Oberreichenbach,unter 3 Jahre,107,53,54
False,8235055,Oberreichenbach,3 -  6 Jahre,115,62,53
False,8235055,Oberreichenbach,6 - 10 Jahre,166,87,79
False,8235055,Oberreichenbach,10 - 15 Jahre,199,109,90
False,8235055,Oberreichenbach,15 - 18 Jahre,105,71,34
False,8235055,Oberreichenbach,18 - 20 Jahre,68,44,24
False,8235055,Oberreichenbach,20 - 25 Jahre,145,68,77
False,8235055,Oberreichenbach,25 - 30 Jahre,240,115,125
False,8235055,Oberreichenbach,30 - 35 Jahre,266,125,141
False,8235055,Oberreichenbach,35 - 40 Jahre,234,117,117
False,8235055,Oberreichenbach,40 - 45 Jahre,192,101,91
False,8235055,Oberreichenbach,45 - 50 Jahre,183,87,96
False,8235055,Oberreichenbach,50 - 55 Jahre,135,74,61
False,8235055,Oberreichenbach,55 - 60 Jahre,186,87,99
False,8235055,Oberreichenbach,60 - 65 Jahre,128,61,67
False,8235055,Oberreichenbach,65 - 75 Jahre,215,91,124
False,8235055,Oberreichenbach,75 und mehr Jahre,155,49,106
False,8235055,Oberreichenbach,Insgesamt,2839,1401,1438
False,8235057,Ostelsheim,unter 3 Jahre,84,50,34
False,8235057,Ostelsheim,3 -  6 Jahre,83,47,36
False,8235057,Ostelsheim,6 - 10 Jahre,140,66,74
False,8235057,Ostelsheim,10 - 15 Jahre,135,75,60
False,8235057,Ostelsheim,15 - 18 Jahre,76,39,37
False,8235057,Ostelsheim,18 - 20 Jahre,46,25,21
False,8235057,Ostelsheim,20 - 25 Jahre,133,77,56
False,8235057,Ostelsheim,25 - 30 Jahre,161,81,80
False,8235057,Ostelsheim,30 - 35 Jahre,198,99,99
False,8235057,Ostelsheim,35 - 40 Jahre,219,111,108
False,8235057,Ostelsheim,40 - 45 Jahre,149,80,69
False,8235057,Ostelsheim,45 - 50 Jahre,122,54,68
False,8235057,Ostelsheim,50 - 55 Jahre,127,64,63
False,8235057,Ostelsheim,55 - 60 Jahre,166,83,83
False,8235057,Ostelsheim,60 - 65 Jahre,123,68,55
False,8235057,Ostelsheim,65 - 75 Jahre,119,54,65
False,8235057,Ostelsheim,75 und mehr Jahre,93,27,66
False,8235057,Ostelsheim,Insgesamt,2174,1100,1074
False,8235060,Rohrdorf,unter 3 Jahre,71,32,39
False,8235060,Rohrdorf,3 -  6 Jahre,66,38,28
False,8235060,Rohrdorf,6 - 10 Jahre,94,50,44
False,8235060,Rohrdorf,10 - 15 Jahre,102,56,46
False,8235060,Rohrdorf,15 - 18 Jahre,61,25,36
False,8235060,Rohrdorf,18 - 20 Jahre,49,30,19
False,8235060,Rohrdorf,20 - 25 Jahre,121,48,73
False,8235060,Rohrdorf,25 - 30 Jahre,172,85,87
False,8235060,Rohrdorf,30 - 35 Jahre,166,99,67
False,8235060,Rohrdorf,35 - 40 Jahre,146,67,79
False,8235060,Rohrdorf,40 - 45 Jahre,118,60,58
False,8235060,Rohrdorf,45 - 50 Jahre,132,63,69
False,8235060,Rohrdorf,50 - 55 Jahre,109,61,48
False,8235060,Rohrdorf,55 - 60 Jahre,134,65,69
False,8235060,Rohrdorf,60 - 65 Jahre,111,51,60
False,8235060,Rohrdorf,65 - 75 Jahre,151,68,83
False,8235060,Rohrdorf,75 und mehr Jahre,128,39,89
False,8235060,Rohrdorf,Insgesamt,1931,937,994
False,8235065,Schömberg,unter 3 Jahre,261,132,129
False,8235065,Schömberg,3 -  6 Jahre,287,153,134
False,8235065,Schömberg,6 - 10 Jahre,434,250,184
False,8235065,Schömberg,10 - 15 Jahre,453,242,211
False,8235065,Schömberg,15 - 18 Jahre,244,126,118
False,8235065,Schömberg,18 - 20 Jahre,177,77,100
False,8235065,Schömberg,20 - 25 Jahre,418,211,207
False,8235065,Schömberg,25 - 30 Jahre,783,421,362
False,8235065,Schömberg,30 - 35 Jahre,1049,632,417
False,8235065,Schömberg,35 - 40 Jahre,796,458,338
False,8235065,Schömberg,40 - 45 Jahre,616,321,295
False,8235065,Schömberg,45 - 50 Jahre,510,287,223
False,8235065,Schömberg,50 - 55 Jahre,433,230,203
False,8235065,Schömberg,55 - 60 Jahre,583,272,311
False,8235065,Schömberg,60 - 65 Jahre,460,254,206
False,8235065,Schömberg,65 - 75 Jahre,754,297,457
False,8235065,Schömberg,75 und mehr Jahre,563,168,395
False,8235065,Schömberg,Insgesamt,8821,4531,4290
False,8235066,Simmersfeld,unter 3 Jahre,74,41,33
False,8235066,Simmersfeld,3 -  6 Jahre,104,59,45
False,8235066,Simmersfeld,6 - 10 Jahre,137,68,69
False,8235066,Simmersfeld,10 - 15 Jahre,143,79,64
False,8235066,Simmersfeld,15 - 18 Jahre,71,34,37
False,8235066,Simmersfeld,18 - 20 Jahre,42,22,20
False,8235066,Simmersfeld,20 - 25 Jahre,125,69,56
False,8235066,Simmersfeld,25 - 30 Jahre,195,108,87
False,8235066,Simmersfeld,30 - 35 Jahre,203,108,95
False,8235066,Simmersfeld,35 - 40 Jahre,179,89,90
False,8235066,Simmersfeld,40 - 45 Jahre,136,77,59
False,8235066,Simmersfeld,45 - 50 Jahre,117,65,52
False,8235066,Simmersfeld,50 - 55 Jahre,110,56,54
False,8235066,Simmersfeld,55 - 60 Jahre,121,59,62
False,8235066,Simmersfeld,60 - 65 Jahre,97,48,49
False,8235066,Simmersfeld,65 - 75 Jahre,153,63,90
False,8235066,Simmersfeld,75 und mehr Jahre,99,35,64
False,8235066,Simmersfeld,Insgesamt,2106,1080,1026
False,8235067,Simmozheim,unter 3 Jahre,117,59,58
False,8235067,Simmozheim,3 -  6 Jahre,121,59,62
False,8235067,Simmozheim,6 - 10 Jahre,166,85,81
False,8235067,Simmozheim,10 - 15 Jahre,160,72,88
False,8235067,Simmozheim,15 - 18 Jahre,98,46,52
False,8235067,Simmozheim,18 - 20 Jahre,61,34,27
False,8235067,Simmozheim,20 - 25 Jahre,170,94,76
False,8235067,Simmozheim,25 - 30 Jahre,219,115,104
False,8235067,Simmozheim,30 - 35 Jahre,241,114,127
False,8235067,Simmozheim,35 - 40 Jahre,234,123,111
False,8235067,Simmozheim,40 - 45 Jahre,222,109,113
False,8235067,Simmozheim,45 - 50 Jahre,170,97,73
False,8235067,Simmozheim,50 - 55 Jahre,144,71,73
False,8235067,Simmozheim,55 - 60 Jahre,170,84,86
False,8235067,Simmozheim,60 - 65 Jahre,95,50,45
False,8235067,Simmozheim,65 - 75 Jahre,141,58,83
False,8235067,Simmozheim,75 und mehr Jahre,101,33,68
False,8235067,Simmozheim,Insgesamt,2630,1303,1327
False,8235073,Unterreichenbach,unter 3 Jahre,83,38,45
False,8235073,Unterreichenbach,3 -  6 Jahre,83,43,40
False,8235073,Unterreichenbach,6 - 10 Jahre,125,56,69
False,8235073,Unterreichenbach,10 - 15 Jahre,147,81,66
False,8235073,Unterreichenbach,15 - 18 Jahre,79,47,32
False,8235073,Unterreichenbach,18 - 20 Jahre,43,27,16
False,8235073,Unterreichenbach,20 - 25 Jahre,116,58,58
False,8235073,Unterreichenbach,25 - 30 Jahre,210,101,109
False,8235073,Unterreichenbach,30 - 35 Jahre,193,98,95
False,8235073,Unterreichenbach,35 - 40 Jahre,184,100,84
False,8235073,Unterreichenbach,40 - 45 Jahre,150,69,81
False,8235073,Unterreichenbach,45 - 50 Jahre,144,73,71
False,8235073,Unterreichenbach,50 - 55 Jahre,132,66,66
False,8235073,Unterreichenbach,55 - 60 Jahre,165,79,86
False,8235073,Unterreichenbach,60 - 65 Jahre,95,48,47
False,8235073,Unterreichenbach,65 - 75 Jahre,224,90,134
False,8235073,Unterreichenbach,75 und mehr Jahre,173,58,115
False,8235073,Unterreichenbach,Insgesamt,2346,1132,1214
False,8235079,"Bad Wildbad, Stadt",unter 3 Jahre,319,156,163
False,8235079,"Bad Wildbad, Stadt",3 -  6 Jahre,400,196,204
False,8235079,"Bad Wildbad, Stadt",6 - 10 Jahre,547,262,285
False,8235079,"Bad Wildbad, Stadt",10 - 15 Jahre,582,299,283
False,8235079,"Bad Wildbad, Stadt",15 - 18 Jahre,319,150,169
False,8235079,"Bad Wildbad, Stadt",18 - 20 Jahre,207,104,103
False,8235079,"Bad Wildbad, Stadt",20 - 25 Jahre,696,340,356
False,8235079,"Bad Wildbad, Stadt",25 - 30 Jahre,979,513,466
False,8235079,"Bad Wildbad, Stadt",30 - 35 Jahre,1001,525,476
False,8235079,"Bad Wildbad, Stadt",35 - 40 Jahre,899,451,448
False,8235079,"Bad Wildbad, Stadt",40 - 45 Jahre,725,389,336
False,8235079,"Bad Wildbad, Stadt",45 - 50 Jahre,625,302,323
False,8235079,"Bad Wildbad, Stadt",50 - 55 Jahre,657,326,331
False,8235079,"Bad Wildbad, Stadt",55 - 60 Jahre,888,383,505
False,8235079,"Bad Wildbad, Stadt",60 - 65 Jahre,753,366,387
False,8235079,"Bad Wildbad, Stadt",65 - 75 Jahre,1219,490,729
False,8235079,"Bad Wildbad, Stadt",75 und mehr Jahre,851,237,614
False,8235079,"Bad Wildbad, Stadt",Insgesamt,11667,5489,6178
False,8235080,"Wildberg, Stadt",unter 3 Jahre,418,224,194
False,8235080,"Wildberg, Stadt",3 -  6 Jahre,477,246,231
False,8235080,"Wildberg, Stadt",6 - 10 Jahre,545,271,274
False,8235080,"Wildberg, Stadt",10 - 15 Jahre,669,347,322
False,8235080,"Wildberg, Stadt",15 - 18 Jahre,356,163,193
False,8235080,"Wildberg, Stadt",18 - 20 Jahre,226,122,104
False,8235080,"Wildberg, Stadt",20 - 25 Jahre,603,313,290
False,8235080,"Wildberg, Stadt",25 - 30 Jahre,784,398,386
False,8235080,"Wildberg, Stadt",30 - 35 Jahre,895,450,445
False,8235080,"Wildberg, Stadt",35 - 40 Jahre,821,425,396
False,8235080,"Wildberg, Stadt",40 - 45 Jahre,775,382,393
False,8235080,"Wildberg, Stadt",45 - 50 Jahre,618,319,299
False,8235080,"Wildberg, Stadt",50 - 55 Jahre,566,303,263
False,8235080,"Wildberg, Stadt",55 - 60 Jahre,699,355,344
False,8235080,"Wildberg, Stadt",60 - 65 Jahre,455,227,228
False,8235080,"Wildberg, Stadt",65 - 75 Jahre,738,327,411
False,8235080,"Wildberg, Stadt",75 und mehr Jahre,508,138,370
False,8235080,"Wildberg, Stadt",Insgesamt,10153,5010,5143
False,8235084,"Bad Teinach-Zavelstein, Stadt",unter 3 Jahre,112,58,54
False,8235084,"Bad Teinach-Zavelstein, Stadt",3 -  6 Jahre,103,58,45
False,8235084,"Bad Teinach-Zavelstein, Stadt",6 - 10 Jahre,140,60,80
False,8235084,"Bad Teinach-Zavelstein, Stadt",10 - 15 Jahre,194,94,100
False,8235084,"Bad Teinach-Zavelstein, Stadt",15 - 18 Jahre,64,38,26
False,8235084,"Bad Teinach-Zavelstein, Stadt",18 - 20 Jahre,52,30,22
False,8235084,"Bad Teinach-Zavelstein, Stadt",20 - 25 Jahre,144,70,74
False,8235084,"Bad Teinach-Zavelstein, Stadt",25 - 30 Jahre,205,107,98
False,8235084,"Bad Teinach-Zavelstein, Stadt",30 - 35 Jahre,264,129,135
False,8235084,"Bad Teinach-Zavelstein, Stadt",35 - 40 Jahre,227,125,102
False,8235084,"Bad Teinach-Zavelstein, Stadt",40 - 45 Jahre,181,83,98
False,8235084,"Bad Teinach-Zavelstein, Stadt",45 - 50 Jahre,145,76,69
False,8235084,"Bad Teinach-Zavelstein, Stadt",50 - 55 Jahre,124,68,56
False,8235084,"Bad Teinach-Zavelstein, Stadt",55 - 60 Jahre,181,85,96
False,8235084,"Bad Teinach-Zavelstein, Stadt",60 - 65 Jahre,187,89,98
False,8235084,"Bad Teinach-Zavelstein, Stadt",65 - 75 Jahre,284,127,157
False,8235084,"Bad Teinach-Zavelstein, Stadt",75 und mehr Jahre,178,57,121
False,8235084,"Bad Teinach-Zavelstein, Stadt",Insgesamt,2785,1354,1431
False,8235085,"Calw, Stadt",unter 3 Jahre,823,436,387
False,8235085,"Calw, Stadt",3 -  6 Jahre,873,446,427
False,8235085,"Calw, Stadt",6 - 10 Jahre,1206,692,514
False,8235085,"Calw, Stadt",10 - 15 Jahre,1392,703,689
False,8235085,"Calw, Stadt",15 - 18 Jahre,840,448,392
False,8235085,"Calw, Stadt",18 - 20 Jahre,607,343,264
False,8235085,"Calw, Stadt",20 - 25 Jahre,1631,892,739
False,8235085,"Calw, Stadt",25 - 30 Jahre,1927,991,936
False,8235085,"Calw, Stadt",30 - 35 Jahre,1918,991,927
False,8235085,"Calw, Stadt",35 - 40 Jahre,1750,873,877
False,8235085,"Calw, Stadt",40 - 45 Jahre,1553,772,781
False,8235085,"Calw, Stadt",45 - 50 Jahre,1501,771,730
False,8235085,"Calw, Stadt",50 - 55 Jahre,1499,794,705
False,8235085,"Calw, Stadt",55 - 60 Jahre,1601,789,812
False,8235085,"Calw, Stadt",60 - 65 Jahre,1195,597,598
False,8235085,"Calw, Stadt",65 - 75 Jahre,1901,789,1112
False,8235085,"Calw, Stadt",75 und mehr Jahre,1492,420,1072
False,8235085,"Calw, Stadt",Insgesamt,23709,11747,11962
False,8236,Landkreis Enzkreis,unter 3 Jahre,6725,3420,3305
False,8236,Landkreis Enzkreis,3 -  6 Jahre,7372,3817,3555
False,8236,Landkreis Enzkreis,6 - 10 Jahre,9450,4899,4551
False,8236,Landkreis Enzkreis,10 - 15 Jahre,10810,5452,5358
False,8236,Landkreis Enzkreis,15 - 18 Jahre,6044,3127,2917
False,8236,Landkreis Enzkreis,18 - 20 Jahre,3799,1960,1839
False,8236,Landkreis Enzkreis,20 - 25 Jahre,10278,5214,5064
False,8236,Landkreis Enzkreis,25 - 30 Jahre,14713,7481,7232
False,8236,Landkreis Enzkreis,30 - 35 Jahre,16906,8658,8248
False,8236,Landkreis Enzkreis,35 - 40 Jahre,15116,7745,7371
False,8236,Landkreis Enzkreis,40 - 45 Jahre,13126,6632,6494
False,8236,Landkreis Enzkreis,45 - 50 Jahre,11652,5896,5756
False,8236,Landkreis Enzkreis,50 - 55 Jahre,11702,6062,5640
False,8236,Landkreis Enzkreis,55 - 60 Jahre,13296,6792,6504
False,8236,Landkreis Enzkreis,60 - 65 Jahre,10056,4961,5095
False,8236,Landkreis Enzkreis,65 - 75 Jahre,15453,6657,8796
False,8236,Landkreis Enzkreis,75 und mehr Jahre,10314,3138,7176
False,8236,Landkreis Enzkreis,Insgesamt,186812,91911,94901
False,8236004,Birkenfeld,unter 3 Jahre,321,173,148
False,8236004,Birkenfeld,3 -  6 Jahre,389,195,194
False,8236004,Birkenfeld,6 - 10 Jahre,463,236,227
False,8236004,Birkenfeld,10 - 15 Jahre,535,272,263
False,8236004,Birkenfeld,15 - 18 Jahre,262,112,150
False,8236004,Birkenfeld,18 - 20 Jahre,190,89,101
False,8236004,Birkenfeld,20 - 25 Jahre,506,259,247
False,8236004,Birkenfeld,25 - 30 Jahre,707,377,330
False,8236004,Birkenfeld,30 - 35 Jahre,829,404,425
False,8236004,Birkenfeld,35 - 40 Jahre,787,405,382
False,8236004,Birkenfeld,40 - 45 Jahre,722,365,357
False,8236004,Birkenfeld,45 - 50 Jahre,553,259,294
False,8236004,Birkenfeld,50 - 55 Jahre,617,308,309
False,8236004,Birkenfeld,55 - 60 Jahre,767,385,382
False,8236004,Birkenfeld,60 - 65 Jahre,612,309,303
False,8236004,Birkenfeld,65 - 75 Jahre,940,411,529
False,8236004,Birkenfeld,75 und mehr Jahre,716,216,500
False,8236004,Birkenfeld,Insgesamt,9916,4775,5141
False,8236011,Eisingen,unter 3 Jahre,153,73,80
False,8236011,Eisingen,3 -  6 Jahre,167,88,79
False,8236011,Eisingen,6 - 10 Jahre,206,111,95
False,8236011,Eisingen,10 - 15 Jahre,277,139,138
False,8236011,Eisingen,15 - 18 Jahre,143,72,71
False,8236011,Eisingen,18 - 20 Jahre,102,47,55
False,8236011,Eisingen,20 - 25 Jahre,255,123,132
False,8236011,Eisingen,25 - 30 Jahre,371,189,182
False,8236011,Eisingen,30 - 35 Jahre,410,194,216
False,8236011,Eisingen,35 - 40 Jahre,349,176,173
False,8236011,Eisingen,40 - 45 Jahre,291,135,156
False,8236011,Eisingen,45 - 50 Jahre,280,138,142
False,8236011,Eisingen,50 - 55 Jahre,303,151,152
False,8236011,Eisingen,55 - 60 Jahre,310,159,151
False,8236011,Eisingen,60 - 65 Jahre,218,113,105
False,8236011,Eisingen,65 - 75 Jahre,313,134,179
False,8236011,Eisingen,75 und mehr Jahre,187,67,120
False,8236011,Eisingen,Insgesamt,4335,2109,2226
False,8236013,Engelsbrand,unter 3 Jahre,110,51,59
False,8236013,Engelsbrand,3 -  6 Jahre,157,76,81
False,8236013,Engelsbrand,6 - 10 Jahre,211,119,92
False,8236013,Engelsbrand,10 - 15 Jahre,239,109,130
False,8236013,Engelsbrand,15 - 18 Jahre,141,66,75
False,8236013,Engelsbrand,18 - 20 Jahre,83,47,36
False,8236013,Engelsbrand,20 - 25 Jahre,213,111,102
False,8236013,Engelsbrand,25 - 30 Jahre,274,139,135
False,8236013,Engelsbrand,30 - 35 Jahre,335,169,166
False,8236013,Engelsbrand,35 - 40 Jahre,329,160,169
False,8236013,Engelsbrand,40 - 45 Jahre,297,135,162
False,8236013,Engelsbrand,45 - 50 Jahre,307,157,150
False,8236013,Engelsbrand,50 - 55 Jahre,309,155,154
False,8236013,Engelsbrand,55 - 60 Jahre,353,190,163
False,8236013,Engelsbrand,60 - 65 Jahre,252,118,134
False,8236013,Engelsbrand,65 - 75 Jahre,401,183,218
False,8236013,Engelsbrand,75 und mehr Jahre,278,78,200
False,8236013,Engelsbrand,Insgesamt,4289,2063,2226
False,8236019,Friolzheim,unter 3 Jahre,132,67,65
False,8236019,Friolzheim,3 -  6 Jahre,169,93,76
False,8236019,Friolzheim,6 - 10 Jahre,212,101,111
False,8236019,Friolzheim,10 - 15 Jahre,239,115,124
False,8236019,Friolzheim,15 - 18 Jahre,131,77,54
False,8236019,Friolzheim,18 - 20 Jahre,71,34,37
False,8236019,Friolzheim,20 - 25 Jahre,182,83,99
False,8236019,Friolzheim,25 - 30 Jahre,279,137,142
False,8236019,Friolzheim,30 - 35 Jahre,304,163,141
False,8236019,Friolzheim,35 - 40 Jahre,297,146,151
False,8236019,Friolzheim,40 - 45 Jahre,285,140,145
False,8236019,Friolzheim,45 - 50 Jahre,246,133,113
False,8236019,Friolzheim,50 - 55 Jahre,204,116,88
False,8236019,Friolzheim,55 - 60 Jahre,221,114,107
False,8236019,Friolzheim,60 - 65 Jahre,160,77,83
False,8236019,Friolzheim,65 - 75 Jahre,204,92,112
False,8236019,Friolzheim,75 und mehr Jahre,112,25,87
False,8236019,Friolzheim,Insgesamt,3448,1713,1735
False,8236025,"Heimsheim, Stadt",unter 3 Jahre,178,105,73
False,8236025,"Heimsheim, Stadt",3 -  6 Jahre,184,103,81
False,8236025,"Heimsheim, Stadt",6 - 10 Jahre,233,126,107
False,8236025,"Heimsheim, Stadt",10 - 15 Jahre,252,123,129
False,8236025,"Heimsheim, Stadt",15 - 18 Jahre,164,81,83
False,8236025,"Heimsheim, Stadt",18 - 20 Jahre,83,41,42
False,8236025,"Heimsheim, Stadt",20 - 25 Jahre,268,123,145
False,8236025,"Heimsheim, Stadt",25 - 30 Jahre,407,200,207
False,8236025,"Heimsheim, Stadt",30 - 35 Jahre,540,327,213
False,8236025,"Heimsheim, Stadt",35 - 40 Jahre,499,328,171
False,8236025,"Heimsheim, Stadt",40 - 45 Jahre,402,243,159
False,8236025,"Heimsheim, Stadt",45 - 50 Jahre,391,216,175
False,8236025,"Heimsheim, Stadt",50 - 55 Jahre,369,234,135
False,8236025,"Heimsheim, Stadt",55 - 60 Jahre,345,198,147
False,8236025,"Heimsheim, Stadt",60 - 65 Jahre,232,121,111
False,8236025,"Heimsheim, Stadt",65 - 75 Jahre,310,151,159
False,8236025,"Heimsheim, Stadt",75 und mehr Jahre,159,60,99
False,8236025,"Heimsheim, Stadt",Insgesamt,5016,2780,2236
False,8236028,Illingen,unter 3 Jahre,239,123,116
False,8236028,Illingen,3 -  6 Jahre,268,142,126
False,8236028,Illingen,6 - 10 Jahre,343,188,155
False,8236028,Illingen,10 - 15 Jahre,414,192,222
False,8236028,Illingen,15 - 18 Jahre,216,117,99
False,8236028,Illingen,18 - 20 Jahre,150,68,82
False,8236028,Illingen,20 - 25 Jahre,417,221,196
False,8236028,Illingen,25 - 30 Jahre,521,263,258
False,8236028,Illingen,30 - 35 Jahre,591,307,284
False,8236028,Illingen,35 - 40 Jahre,544,268,276
False,8236028,Illingen,40 - 45 Jahre,490,253,237
False,8236028,Illingen,45 - 50 Jahre,496,256,240
False,8236028,Illingen,50 - 55 Jahre,499,261,238
False,8236028,Illingen,55 - 60 Jahre,493,263,230
False,8236028,Illingen,60 - 65 Jahre,379,181,198
False,8236028,Illingen,65 - 75 Jahre,640,274,366
False,8236028,Illingen,75 und mehr Jahre,359,107,252
False,8236028,Illingen,Insgesamt,7059,3484,3575
False,8236030,Ispringen,unter 3 Jahre,207,92,115
False,8236030,Ispringen,3 -  6 Jahre,214,106,108
False,8236030,Ispringen,6 - 10 Jahre,287,156,131
False,8236030,Ispringen,10 - 15 Jahre,316,161,155
False,8236030,Ispringen,15 - 18 Jahre,159,93,66
False,8236030,Ispringen,18 - 20 Jahre,97,37,60
False,8236030,Ispringen,20 - 25 Jahre,311,168,143
False,8236030,Ispringen,25 - 30 Jahre,530,260,270
False,8236030,Ispringen,30 - 35 Jahre,564,313,251
False,8236030,Ispringen,35 - 40 Jahre,464,240,224
False,8236030,Ispringen,40 - 45 Jahre,399,200,199
False,8236030,Ispringen,45 - 50 Jahre,362,192,170
False,8236030,Ispringen,50 - 55 Jahre,372,176,196
False,8236030,Ispringen,55 - 60 Jahre,504,250,254
False,8236030,Ispringen,60 - 65 Jahre,426,199,227
False,8236030,Ispringen,65 - 75 Jahre,594,273,321
False,8236030,Ispringen,75 und mehr Jahre,385,121,264
False,8236030,Ispringen,Insgesamt,6191,3037,3154
False,8236031,Kieselbronn,unter 3 Jahre,86,41,45
False,8236031,Kieselbronn,3 -  6 Jahre,87,43,44
False,8236031,Kieselbronn,6 - 10 Jahre,136,62,74
False,8236031,Kieselbronn,10 - 15 Jahre,153,72,81
False,8236031,Kieselbronn,15 - 18 Jahre,70,37,33
False,8236031,Kieselbronn,18 - 20 Jahre,65,33,32
False,8236031,Kieselbronn,20 - 25 Jahre,135,67,68
False,8236031,Kieselbronn,25 - 30 Jahre,183,76,107
False,8236031,Kieselbronn,30 - 35 Jahre,233,120,113
False,8236031,Kieselbronn,35 - 40 Jahre,206,106,100
False,8236031,Kieselbronn,40 - 45 Jahre,188,88,100
False,8236031,Kieselbronn,45 - 50 Jahre,166,103,63
False,8236031,Kieselbronn,50 - 55 Jahre,160,84,76
False,8236031,Kieselbronn,55 - 60 Jahre,174,79,95
False,8236031,Kieselbronn,60 - 65 Jahre,139,81,58
False,8236031,Kieselbronn,65 - 75 Jahre,221,105,116
False,8236031,Kieselbronn,75 und mehr Jahre,175,50,125
False,8236031,Kieselbronn,Insgesamt,2577,1247,1330
False,8236033,"Knittlingen, Stadt",unter 3 Jahre,321,167,154
False,8236033,"Knittlingen, Stadt",3 -  6 Jahre,323,166,157
False,8236033,"Knittlingen, Stadt",6 - 10 Jahre,372,194,178
False,8236033,"Knittlingen, Stadt",10 - 15 Jahre,429,224,205
False,8236033,"Knittlingen, Stadt",15 - 18 Jahre,249,131,118
False,8236033,"Knittlingen, Stadt",18 - 20 Jahre,158,76,82
False,8236033,"Knittlingen, Stadt",20 - 25 Jahre,457,225,232
False,8236033,"Knittlingen, Stadt",25 - 30 Jahre,602,298,304
False,8236033,"Knittlingen, Stadt",30 - 35 Jahre,695,363,332
False,8236033,"Knittlingen, Stadt",35 - 40 Jahre,565,294,271
False,8236033,"Knittlingen, Stadt",40 - 45 Jahre,490,226,264
False,8236033,"Knittlingen, Stadt",45 - 50 Jahre,433,214,219
False,8236033,"Knittlingen, Stadt",50 - 55 Jahre,406,221,185
False,8236033,"Knittlingen, Stadt",55 - 60 Jahre,500,247,253
False,8236033,"Knittlingen, Stadt",60 - 65 Jahre,381,189,192
False,8236033,"Knittlingen, Stadt",65 - 75 Jahre,546,241,305
False,8236033,"Knittlingen, Stadt",75 und mehr Jahre,321,94,227
False,8236033,"Knittlingen, Stadt",Insgesamt,7248,3570,3678
False,8236038,"Maulbronn, Stadt",unter 3 Jahre,233,109,124
False,8236038,"Maulbronn, Stadt",3 -  6 Jahre,252,118,134
False,8236038,"Maulbronn, Stadt",6 - 10 Jahre,339,183,156
False,8236038,"Maulbronn, Stadt",10 - 15 Jahre,378,188,190
False,8236038,"Maulbronn, Stadt",15 - 18 Jahre,245,107,138
False,8236038,"Maulbronn, Stadt",18 - 20 Jahre,146,82,64
False,8236038,"Maulbronn, Stadt",20 - 25 Jahre,398,217,181
False,8236038,"Maulbronn, Stadt",25 - 30 Jahre,481,260,221
False,8236038,"Maulbronn, Stadt",30 - 35 Jahre,564,287,277
False,8236038,"Maulbronn, Stadt",35 - 40 Jahre,513,246,267
False,8236038,"Maulbronn, Stadt",40 - 45 Jahre,419,221,198
False,8236038,"Maulbronn, Stadt",45 - 50 Jahre,316,163,153
False,8236038,"Maulbronn, Stadt",50 - 55 Jahre,419,213,206
False,8236038,"Maulbronn, Stadt",55 - 60 Jahre,498,255,243
False,8236038,"Maulbronn, Stadt",60 - 65 Jahre,368,197,171
False,8236038,"Maulbronn, Stadt",65 - 75 Jahre,517,223,294
False,8236038,"Maulbronn, Stadt",75 und mehr Jahre,325,106,219
False,8236038,"Maulbronn, Stadt",Insgesamt,6411,3175,3236
False,8236039,Mönsheim,unter 3 Jahre,107,58,49
False,8236039,Mönsheim,3 -  6 Jahre,79,42,37
False,8236039,Mönsheim,6 - 10 Jahre,127,67,60
False,8236039,Mönsheim,10 - 15 Jahre,126,65,61
False,8236039,Mönsheim,15 - 18 Jahre,94,47,47
False,8236039,Mönsheim,18 - 20 Jahre,61,37,24
False,8236039,Mönsheim,20 - 25 Jahre,141,66,75
False,8236039,Mönsheim,25 - 30 Jahre,189,109,80
False,8236039,Mönsheim,30 - 35 Jahre,218,102,116
False,8236039,Mönsheim,35 - 40 Jahre,184,86,98
False,8236039,Mönsheim,40 - 45 Jahre,174,84,90
False,8236039,Mönsheim,45 - 50 Jahre,160,81,79
False,8236039,Mönsheim,50 - 55 Jahre,165,89,76
False,8236039,Mönsheim,55 - 60 Jahre,197,98,99
False,8236039,Mönsheim,60 - 65 Jahre,147,79,68
False,8236039,Mönsheim,65 - 75 Jahre,187,81,106
False,8236039,Mönsheim,75 und mehr Jahre,113,40,73
False,8236039,Mönsheim,Insgesamt,2469,1231,1238
False,8236040,"Mühlacker, Stadt",unter 3 Jahre,856,437,419
False,8236040,"Mühlacker, Stadt",3 -  6 Jahre,956,476,480
False,8236040,"Mühlacker, Stadt",6 - 10 Jahre,1280,664,616
False,8236040,"Mühlacker, Stadt",10 - 15 Jahre,1450,747,703
False,8236040,"Mühlacker, Stadt",15 - 18 Jahre,878,470,408
False,8236040,"Mühlacker, Stadt",18 - 20 Jahre,564,289,275
False,8236040,"Mühlacker, Stadt",20 - 25 Jahre,1491,786,705
False,8236040,"Mühlacker, Stadt",25 - 30 Jahre,2037,1037,1000
False,8236040,"Mühlacker, Stadt",30 - 35 Jahre,2209,1169,1040
False,8236040,"Mühlacker, Stadt",35 - 40 Jahre,1886,964,922
False,8236040,"Mühlacker, Stadt",40 - 45 Jahre,1677,839,838
False,8236040,"Mühlacker, Stadt",45 - 50 Jahre,1548,762,786
False,8236040,"Mühlacker, Stadt",50 - 55 Jahre,1652,875,777
False,8236040,"Mühlacker, Stadt",55 - 60 Jahre,1924,1000,924
False,8236040,"Mühlacker, Stadt",60 - 65 Jahre,1439,706,733
False,8236040,"Mühlacker, Stadt",65 - 75 Jahre,2287,939,1348
False,8236040,"Mühlacker, Stadt",75 und mehr Jahre,1464,454,1010
False,8236040,"Mühlacker, Stadt",Insgesamt,25598,12614,12984
False,8236043,"Neuenbürg, Stadt",unter 3 Jahre,227,110,117
False,8236043,"Neuenbürg, Stadt",3 -  6 Jahre,310,187,123
False,8236043,"Neuenbürg, Stadt",6 - 10 Jahre,370,199,171
False,8236043,"Neuenbürg, Stadt",10 - 15 Jahre,415,205,210
False,8236043,"Neuenbürg, Stadt",15 - 18 Jahre,228,117,111
False,8236043,"Neuenbürg, Stadt",18 - 20 Jahre,134,77,57
False,8236043,"Neuenbürg, Stadt",20 - 25 Jahre,411,202,209
False,8236043,"Neuenbürg, Stadt",25 - 30 Jahre,645,339,306
False,8236043,"Neuenbürg, Stadt",30 - 35 Jahre,716,333,383
False,8236043,"Neuenbürg, Stadt",35 - 40 Jahre,591,318,273
False,8236043,"Neuenbürg, Stadt",40 - 45 Jahre,509,271,238
False,8236043,"Neuenbürg, Stadt",45 - 50 Jahre,433,190,243
False,8236043,"Neuenbürg, Stadt",50 - 55 Jahre,465,235,230
False,8236043,"Neuenbürg, Stadt",55 - 60 Jahre,573,266,307
False,8236043,"Neuenbürg, Stadt",60 - 65 Jahre,404,213,191
False,8236043,"Neuenbürg, Stadt",65 - 75 Jahre,681,295,386
False,8236043,"Neuenbürg, Stadt",75 und mehr Jahre,539,163,376
False,8236043,"Neuenbürg, Stadt",Insgesamt,7651,3720,3931
False,8236044,Neuhausen,unter 3 Jahre,224,96,128
False,8236044,Neuhausen,3 -  6 Jahre,251,120,131
False,8236044,Neuhausen,6 - 10 Jahre,276,156,120
False,8236044,Neuhausen,10 - 15 Jahre,347,194,153
False,8236044,Neuhausen,15 - 18 Jahre,167,77,90
False,8236044,Neuhausen,18 - 20 Jahre,104,56,48
False,8236044,Neuhausen,20 - 25 Jahre,264,124,140
False,8236044,Neuhausen,25 - 30 Jahre,415,214,201
False,8236044,Neuhausen,30 - 35 Jahre,507,262,245
False,8236044,Neuhausen,35 - 40 Jahre,433,223,210
False,8236044,Neuhausen,40 - 45 Jahre,378,190,188
False,8236044,Neuhausen,45 - 50 Jahre,334,173,161
False,8236044,Neuhausen,50 - 55 Jahre,306,154,152
False,8236044,Neuhausen,55 - 60 Jahre,301,165,136
False,8236044,Neuhausen,60 - 65 Jahre,261,126,135
False,8236044,Neuhausen,65 - 75 Jahre,382,172,210
False,8236044,Neuhausen,75 und mehr Jahre,231,77,154
False,8236044,Neuhausen,Insgesamt,5181,2579,2602
False,8236046,Niefern-Öschelbronn,unter 3 Jahre,392,201,191
False,8236046,Niefern-Öschelbronn,3 -  6 Jahre,455,226,229
False,8236046,Niefern-Öschelbronn,6 - 10 Jahre,519,270,249
False,8236046,Niefern-Öschelbronn,10 - 15 Jahre,605,309,296
False,8236046,Niefern-Öschelbronn,15 - 18 Jahre,355,173,182
False,8236046,Niefern-Öschelbronn,18 - 20 Jahre,222,120,102
False,8236046,Niefern-Öschelbronn,20 - 25 Jahre,647,308,339
False,8236046,Niefern-Öschelbronn,25 - 30 Jahre,903,436,467
False,8236046,Niefern-Öschelbronn,30 - 35 Jahre,1009,521,488
False,8236046,Niefern-Öschelbronn,35 - 40 Jahre,913,469,444
False,8236046,Niefern-Öschelbronn,40 - 45 Jahre,733,350,383
False,8236046,Niefern-Öschelbronn,45 - 50 Jahre,667,328,339
False,8236046,Niefern-Öschelbronn,50 - 55 Jahre,682,323,359
False,8236046,Niefern-Öschelbronn,55 - 60 Jahre,826,411,415
False,8236046,Niefern-Öschelbronn,60 - 65 Jahre,589,286,303
False,8236046,Niefern-Öschelbronn,65 - 75 Jahre,1006,432,574
False,8236046,Niefern-Öschelbronn,75 und mehr Jahre,895,234,661
False,8236046,Niefern-Öschelbronn,Insgesamt,11418,5397,6021
False,8236050,Ötisheim,unter 3 Jahre,186,105,81
False,8236050,Ötisheim,3 -  6 Jahre,159,78,81
False,8236050,Ötisheim,6 - 10 Jahre,239,114,125
False,8236050,Ötisheim,10 - 15 Jahre,289,144,145
False,8236050,Ötisheim,15 - 18 Jahre,180,90,90
False,8236050,Ötisheim,18 - 20 Jahre,102,50,52
False,8236050,Ötisheim,20 - 25 Jahre,262,128,134
False,8236050,Ötisheim,25 - 30 Jahre,374,192,182
False,8236050,Ötisheim,30 - 35 Jahre,412,215,197
False,8236050,Ötisheim,35 - 40 Jahre,370,171,199
False,8236050,Ötisheim,40 - 45 Jahre,373,207,166
False,8236050,Ötisheim,45 - 50 Jahre,262,142,120
False,8236050,Ötisheim,50 - 55 Jahre,306,157,149
False,8236050,Ötisheim,55 - 60 Jahre,358,188,170
False,8236050,Ötisheim,60 - 65 Jahre,239,116,123
False,8236050,Ötisheim,65 - 75 Jahre,403,173,230
False,8236050,Ötisheim,75 und mehr Jahre,245,63,182
False,8236050,Ötisheim,Insgesamt,4759,2333,2426
False,8236061,Sternenfels,unter 3 Jahre,107,54,53
False,8236061,Sternenfels,3 -  6 Jahre,132,74,58
False,8236061,Sternenfels,6 - 10 Jahre,163,82,81
False,8236061,Sternenfels,10 - 15 Jahre,149,82,67
False,8236061,Sternenfels,15 - 18 Jahre,72,39,33
False,8236061,Sternenfels,18 - 20 Jahre,63,37,26
False,8236061,Sternenfels,20 - 25 Jahre,166,90,76
False,8236061,Sternenfels,25 - 30 Jahre,202,104,98
False,8236061,Sternenfels,30 - 35 Jahre,278,148,130
False,8236061,Sternenfels,35 - 40 Jahre,238,122,116
False,8236061,Sternenfels,40 - 45 Jahre,224,118,106
False,8236061,Sternenfels,45 - 50 Jahre,167,83,84
False,8236061,Sternenfels,50 - 55 Jahre,170,88,82
False,8236061,Sternenfels,55 - 60 Jahre,148,78,70
False,8236061,Sternenfels,60 - 65 Jahre,132,63,69
False,8236061,Sternenfels,65 - 75 Jahre,256,104,152
False,8236061,Sternenfels,75 und mehr Jahre,104,29,75
False,8236061,Sternenfels,Insgesamt,2771,1395,1376
False,8236062,Tiefenbronn,unter 3 Jahre,197,98,99
False,8236062,Tiefenbronn,3 -  6 Jahre,233,124,109
False,8236062,Tiefenbronn,6 - 10 Jahre,288,151,137
False,8236062,Tiefenbronn,10 - 15 Jahre,299,162,137
False,8236062,Tiefenbronn,15 - 18 Jahre,167,79,88
False,8236062,Tiefenbronn,18 - 20 Jahre,106,46,60
False,8236062,Tiefenbronn,20 - 25 Jahre,244,120,124
False,8236062,Tiefenbronn,25 - 30 Jahre,376,197,179
False,8236062,Tiefenbronn,30 - 35 Jahre,441,211,230
False,8236062,Tiefenbronn,35 - 40 Jahre,462,236,226
False,8236062,Tiefenbronn,40 - 45 Jahre,402,222,180
False,8236062,Tiefenbronn,45 - 50 Jahre,368,188,180
False,8236062,Tiefenbronn,50 - 55 Jahre,362,201,161
False,8236062,Tiefenbronn,55 - 60 Jahre,329,156,173
False,8236062,Tiefenbronn,60 - 65 Jahre,245,126,119
False,8236062,Tiefenbronn,65 - 75 Jahre,349,154,195
False,8236062,Tiefenbronn,75 und mehr Jahre,230,72,158
False,8236062,Tiefenbronn,Insgesamt,5098,2543,2555
False,8236065,Wiernsheim,unter 3 Jahre,274,145,129
False,8236065,Wiernsheim,3 -  6 Jahre,277,159,118
False,8236065,Wiernsheim,6 - 10 Jahre,373,176,197
False,8236065,Wiernsheim,10 - 15 Jahre,377,190,187
False,8236065,Wiernsheim,15 - 18 Jahre,208,105,103
False,8236065,Wiernsheim,18 - 20 Jahre,127,64,63
False,8236065,Wiernsheim,20 - 25 Jahre,354,192,162
False,8236065,Wiernsheim,25 - 30 Jahre,569,290,279
False,8236065,Wiernsheim,30 - 35 Jahre,641,313,328
False,8236065,Wiernsheim,35 - 40 Jahre,568,286,282
False,8236065,Wiernsheim,40 - 45 Jahre,475,253,222
False,8236065,Wiernsheim,45 - 50 Jahre,416,216,200
False,8236065,Wiernsheim,50 - 55 Jahre,372,204,168
False,8236065,Wiernsheim,55 - 60 Jahre,383,192,191
False,8236065,Wiernsheim,60 - 65 Jahre,283,134,149
False,8236065,Wiernsheim,65 - 75 Jahre,405,176,229
False,8236065,Wiernsheim,75 und mehr Jahre,230,78,152
False,8236065,Wiernsheim,Insgesamt,6332,3173,3159
False,8236067,Wimsheim,unter 3 Jahre,115,53,62
False,8236067,Wimsheim,3 -  6 Jahre,112,52,60
False,8236067,Wimsheim,6 - 10 Jahre,144,73,71
False,8236067,Wimsheim,10 - 15 Jahre,144,76,68
False,8236067,Wimsheim,15 - 18 Jahre,79,42,37
False,8236067,Wimsheim,18 - 20 Jahre,48,22,26
False,8236067,Wimsheim,20 - 25 Jahre,129,64,65
False,8236067,Wimsheim,25 - 30 Jahre,190,98,92
False,8236067,Wimsheim,30 - 35 Jahre,247,129,118
False,8236067,Wimsheim,35 - 40 Jahre,223,120,103
False,8236067,Wimsheim,40 - 45 Jahre,200,92,108
False,8236067,Wimsheim,45 - 50 Jahre,150,84,66
False,8236067,Wimsheim,50 - 55 Jahre,131,76,55
False,8236067,Wimsheim,55 - 60 Jahre,140,67,73
False,8236067,Wimsheim,60 - 65 Jahre,126,61,65
False,8236067,Wimsheim,65 - 75 Jahre,190,83,107
False,8236067,Wimsheim,75 und mehr Jahre,77,17,60
False,8236067,Wimsheim,Insgesamt,2445,1209,1236
False,8236068,Wurmberg,unter 3 Jahre,110,48,62
False,8236068,Wurmberg,3 -  6 Jahre,120,60,60
False,8236068,Wurmberg,6 - 10 Jahre,176,76,100
False,8236068,Wurmberg,10 - 15 Jahre,182,95,87
False,8236068,Wurmberg,15 - 18 Jahre,85,41,44
False,8236068,Wurmberg,18 - 20 Jahre,51,26,25
False,8236068,Wurmberg,20 - 25 Jahre,126,65,61
False,8236068,Wurmberg,25 - 30 Jahre,189,109,80
False,8236068,Wurmberg,30 - 35 Jahre,247,132,115
False,8236068,Wurmberg,35 - 40 Jahre,214,108,106
False,8236068,Wurmberg,40 - 45 Jahre,158,83,75
False,8236068,Wurmberg,45 - 50 Jahre,132,68,64
False,8236068,Wurmberg,50 - 55 Jahre,148,63,85
False,8236068,Wurmberg,55 - 60 Jahre,177,94,83
False,8236068,Wurmberg,60 - 65 Jahre,151,73,78
False,8236068,Wurmberg,65 - 75 Jahre,226,100,126
False,8236068,Wurmberg,75 und mehr Jahre,128,39,89
False,8236068,Wurmberg,Insgesamt,2620,1280,1340
False,8236070,Keltern,unter 3 Jahre,316,164,152
False,8236070,Keltern,3 -  6 Jahre,291,146,145
False,8236070,Keltern,6 - 10 Jahre,409,219,190
False,8236070,Keltern,10 - 15 Jahre,434,225,209
False,8236070,Keltern,15 - 18 Jahre,288,155,133
False,8236070,Keltern,18 - 20 Jahre,162,95,67
False,8236070,Keltern,20 - 25 Jahre,459,218,241
False,8236070,Keltern,25 - 30 Jahre,665,341,324
False,8236070,Keltern,30 - 35 Jahre,815,401,414
False,8236070,Keltern,35 - 40 Jahre,698,347,351
False,8236070,Keltern,40 - 45 Jahre,593,296,297
False,8236070,Keltern,45 - 50 Jahre,567,283,284
False,8236070,Keltern,50 - 55 Jahre,571,295,276
False,8236070,Keltern,55 - 60 Jahre,594,297,297
False,8236070,Keltern,60 - 65 Jahre,469,221,248
False,8236070,Keltern,65 - 75 Jahre,775,337,438
False,8236070,Keltern,75 und mehr Jahre,551,177,374
False,8236070,Keltern,Insgesamt,8657,4217,4440
False,8236071,Remchingen,unter 3 Jahre,402,201,201
False,8236071,Remchingen,3 -  6 Jahre,430,213,217
False,8236071,Remchingen,6 - 10 Jahre,626,341,285
False,8236071,Remchingen,10 - 15 Jahre,728,366,362
False,8236071,Remchingen,15 - 18 Jahre,412,237,175
False,8236071,Remchingen,18 - 20 Jahre,240,129,111
False,8236071,Remchingen,20 - 25 Jahre,586,298,288
False,8236071,Remchingen,25 - 30 Jahre,889,421,468
False,8236071,Remchingen,30 - 35 Jahre,992,512,480
False,8236071,Remchingen,35 - 40 Jahre,871,435,436
False,8236071,Remchingen,40 - 45 Jahre,855,417,438
False,8236071,Remchingen,45 - 50 Jahre,749,379,370
False,8236071,Remchingen,50 - 55 Jahre,641,325,316
False,8236071,Remchingen,55 - 60 Jahre,772,403,369
False,8236071,Remchingen,60 - 65 Jahre,550,265,285
False,8236071,Remchingen,65 - 75 Jahre,801,336,465
False,8236071,Remchingen,75 und mehr Jahre,566,175,391
False,8236071,Remchingen,Insgesamt,11110,5453,5657
False,8236072,Straubenhardt,unter 3 Jahre,380,200,180
False,8236072,Straubenhardt,3 -  6 Jahre,416,228,188
False,8236072,Straubenhardt,6 - 10 Jahre,522,281,241
False,8236072,Straubenhardt,10 - 15 Jahre,599,290,309
False,8236072,Straubenhardt,15 - 18 Jahre,288,141,147
False,8236072,Straubenhardt,18 - 20 Jahre,185,106,79
False,8236072,Straubenhardt,20 - 25 Jahre,557,302,255
False,8236072,Straubenhardt,25 - 30 Jahre,793,413,380
False,8236072,Straubenhardt,30 - 35 Jahre,919,452,467
False,8236072,Straubenhardt,35 - 40 Jahre,874,464,410
False,8236072,Straubenhardt,40 - 45 Jahre,684,345,339
False,8236072,Straubenhardt,45 - 50 Jahre,649,330,319
False,8236072,Straubenhardt,50 - 55 Jahre,601,323,278
False,8236072,Straubenhardt,55 - 60 Jahre,680,352,328
False,8236072,Straubenhardt,60 - 65 Jahre,507,252,255
False,8236072,Straubenhardt,65 - 75 Jahre,837,341,496
False,8236072,Straubenhardt,75 und mehr Jahre,575,177,398
False,8236072,Straubenhardt,Insgesamt,10066,4997,5069
False,8236073,Neulingen,unter 3 Jahre,218,112,106
False,8236073,Neulingen,3 -  6 Jahre,233,134,99
False,8236073,Neulingen,6 - 10 Jahre,320,152,168
False,8236073,Neulingen,10 - 15 Jahre,361,181,180
False,8236073,Neulingen,15 - 18 Jahre,175,96,79
False,8236073,Neulingen,18 - 20 Jahre,114,54,60
False,8236073,Neulingen,20 - 25 Jahre,245,130,115
False,8236073,Neulingen,25 - 30 Jahre,418,196,222
False,8236073,Neulingen,30 - 35 Jahre,510,252,258
False,8236073,Neulingen,35 - 40 Jahre,527,265,262
False,8236073,Neulingen,40 - 45 Jahre,404,201,203
False,8236073,Neulingen,45 - 50 Jahre,338,184,154
False,8236073,Neulingen,50 - 55 Jahre,299,153,146
False,8236073,Neulingen,55 - 60 Jahre,328,170,158
False,8236073,Neulingen,60 - 65 Jahre,283,124,159
False,8236073,Neulingen,65 - 75 Jahre,422,177,245
False,8236073,Neulingen,75 und mehr Jahre,373,114,259
False,8236073,Neulingen,Insgesamt,5568,2695,2873
False,8236074,Kämpfelbach,unter 3 Jahre,199,108,91
False,8236074,Kämpfelbach,3 -  6 Jahre,214,109,105
False,8236074,Kämpfelbach,6 - 10 Jahre,242,111,131
False,8236074,Kämpfelbach,10 - 15 Jahre,326,144,182
False,8236074,Kämpfelbach,15 - 18 Jahre,182,103,79
False,8236074,Kämpfelbach,18 - 20 Jahre,120,74,46
False,8236074,Kämpfelbach,20 - 25 Jahre,330,150,180
False,8236074,Kämpfelbach,25 - 30 Jahre,495,281,214
False,8236074,Kämpfelbach,30 - 35 Jahre,559,285,274
False,8236074,Kämpfelbach,35 - 40 Jahre,507,257,250
False,8236074,Kämpfelbach,40 - 45 Jahre,380,190,190
False,8236074,Kämpfelbach,45 - 50 Jahre,365,187,178
False,8236074,Kämpfelbach,50 - 55 Jahre,355,180,175
False,8236074,Kämpfelbach,55 - 60 Jahre,445,214,231
False,8236074,Kämpfelbach,60 - 65 Jahre,351,167,184
False,8236074,Kämpfelbach,65 - 75 Jahre,539,228,311
False,8236074,Kämpfelbach,75 und mehr Jahre,347,117,230
False,8236074,Kämpfelbach,Insgesamt,5956,2905,3051
False,8236075,Ölbronn-Dürrn,unter 3 Jahre,122,62,60
False,8236075,Ölbronn-Dürrn,3 -  6 Jahre,137,79,58
False,8236075,Ölbronn-Dürrn,6 - 10 Jahre,195,112,83
False,8236075,Ölbronn-Dürrn,10 - 15 Jahre,216,107,109
False,8236075,Ölbronn-Dürrn,15 - 18 Jahre,114,61,53
False,8236075,Ölbronn-Dürrn,18 - 20 Jahre,66,38,28
False,8236075,Ölbronn-Dürrn,20 - 25 Jahre,173,100,73
False,8236075,Ölbronn-Dürrn,25 - 30 Jahre,237,114,123
False,8236075,Ölbronn-Dürrn,30 - 35 Jahre,293,154,139
False,8236075,Ölbronn-Dürrn,35 - 40 Jahre,273,136,137
False,8236075,Ölbronn-Dürrn,40 - 45 Jahre,240,118,122
False,8236075,Ölbronn-Dürrn,45 - 50 Jahre,187,108,79
False,8236075,Ölbronn-Dürrn,50 - 55 Jahre,171,81,90
False,8236075,Ölbronn-Dürrn,55 - 60 Jahre,229,120,109
False,8236075,Ölbronn-Dürrn,60 - 65 Jahre,200,102,98
False,8236075,Ölbronn-Dürrn,65 - 75 Jahre,284,127,157
False,8236075,Ölbronn-Dürrn,75 und mehr Jahre,152,51,101
False,8236075,Ölbronn-Dürrn,Insgesamt,3289,1670,1619
False,8236076,Königsbach-Stein,unter 3 Jahre,313,167,146
False,8236076,Königsbach-Stein,3 -  6 Jahre,357,180,177
False,8236076,Königsbach-Stein,6 - 10 Jahre,379,179,200
False,8236076,Königsbach-Stein,10 - 15 Jahre,531,275,256
False,8236076,Königsbach-Stein,15 - 18 Jahre,292,161,131
False,8236076,Königsbach-Stein,18 - 20 Jahre,185,86,99
False,8236076,Königsbach-Stein,20 - 25 Jahre,551,274,277
False,8236076,Königsbach-Stein,25 - 30 Jahre,772,391,381
False,8236076,Königsbach-Stein,30 - 35 Jahre,828,420,408
False,8236076,Königsbach-Stein,35 - 40 Jahre,731,369,362
False,8236076,Königsbach-Stein,40 - 45 Jahre,684,350,334
False,8236076,Königsbach-Stein,45 - 50 Jahre,610,279,331
False,8236076,Königsbach-Stein,50 - 55 Jahre,647,321,326
False,8236076,Königsbach-Stein,55 - 60 Jahre,727,381,346
False,8236076,Königsbach-Stein,60 - 65 Jahre,513,262,251
False,8236076,Königsbach-Stein,65 - 75 Jahre,737,315,422
False,8236076,Königsbach-Stein,75 und mehr Jahre,477,137,340
False,8236076,Königsbach-Stein,Insgesamt,9334,4547,4787
False,8237,Landkreis Freudenstadt,unter 3 Jahre,4431,2316,2115
False,8237,Landkreis Freudenstadt,3 -  6 Jahre,4620,2321,2299
False,8237,Landkreis Freudenstadt,6 - 10 Jahre,6132,3109,3023
False,8237,Landkreis Freudenstadt,10 - 15 Jahre,6833,3534,3299
False,8237,Landkreis Freudenstadt,15 - 18 Jahre,3988,2044,1944
False,8237,Landkreis Freudenstadt,18 - 20 Jahre,2691,1368,1323
False,8237,Landkreis Freudenstadt,20 - 25 Jahre,7845,3888,3957
False,8237,Landkreis Freudenstadt,25 - 30 Jahre,10171,5225,4946
False,8237,Landkreis Freudenstadt,30 - 35 Jahre,10490,5396,5094
False,8237,Landkreis Freudenstadt,35 - 40 Jahre,9108,4693,4415
False,8237,Landkreis Freudenstadt,40 - 45 Jahre,7866,4107,3759
False,8237,Landkreis Freudenstadt,45 - 50 Jahre,6607,3425,3182
False,8237,Landkreis Freudenstadt,50 - 55 Jahre,6248,3104,3144
False,8237,Landkreis Freudenstadt,55 - 60 Jahre,8208,4078,4130
False,8237,Landkreis Freudenstadt,60 - 65 Jahre,6189,2983,3206
False,8237,Landkreis Freudenstadt,65 - 75 Jahre,10132,4105,6027
False,8237,Landkreis Freudenstadt,75 und mehr Jahre,7607,2243,5364
False,8237,Landkreis Freudenstadt,Insgesamt,119166,57939,61227
False,8237002,"Alpirsbach, Stadt",unter 3 Jahre,227,116,111
False,8237002,"Alpirsbach, Stadt",3 -  6 Jahre,246,115,131
False,8237002,"Alpirsbach, Stadt",6 - 10 Jahre,359,187,172
False,8237002,"Alpirsbach, Stadt",10 - 15 Jahre,371,184,187
False,8237002,"Alpirsbach, Stadt",15 - 18 Jahre,187,106,81
False,8237002,"Alpirsbach, Stadt",18 - 20 Jahre,148,82,66
False,8237002,"Alpirsbach, Stadt",20 - 25 Jahre,374,184,190
False,8237002,"Alpirsbach, Stadt",25 - 30 Jahre,561,284,277
False,8237002,"Alpirsbach, Stadt",30 - 35 Jahre,615,316,299
False,8237002,"Alpirsbach, Stadt",35 - 40 Jahre,513,267,246
False,8237002,"Alpirsbach, Stadt",40 - 45 Jahre,435,239,196
False,8237002,"Alpirsbach, Stadt",45 - 50 Jahre,411,213,198
False,8237002,"Alpirsbach, Stadt",50 - 55 Jahre,401,220,181
False,8237002,"Alpirsbach, Stadt",55 - 60 Jahre,503,259,244
False,8237002,"Alpirsbach, Stadt",60 - 65 Jahre,427,215,212
False,8237002,"Alpirsbach, Stadt",65 - 75 Jahre,667,265,402
False,8237002,"Alpirsbach, Stadt",75 und mehr Jahre,521,156,365
False,8237002,"Alpirsbach, Stadt",Insgesamt,6966,3408,3558
False,8237004,Baiersbronn,unter 3 Jahre,571,290,281
False,8237004,Baiersbronn,3 -  6 Jahre,586,307,279
False,8237004,Baiersbronn,6 - 10 Jahre,772,369,403
False,8237004,Baiersbronn,10 - 15 Jahre,891,458,433
False,8237004,Baiersbronn,15 - 18 Jahre,505,268,237
False,8237004,Baiersbronn,18 - 20 Jahre,414,197,217
False,8237004,Baiersbronn,20 - 25 Jahre,1331,646,685
False,8237004,Baiersbronn,25 - 30 Jahre,1682,807,875
False,8237004,Baiersbronn,30 - 35 Jahre,1463,755,708
False,8237004,Baiersbronn,35 - 40 Jahre,1157,617,540
False,8237004,Baiersbronn,40 - 45 Jahre,949,494,455
False,8237004,Baiersbronn,45 - 50 Jahre,768,384,384
False,8237004,Baiersbronn,50 - 55 Jahre,818,392,426
False,8237004,Baiersbronn,55 - 60 Jahre,1182,583,599
False,8237004,Baiersbronn,60 - 65 Jahre,883,421,462
False,8237004,Baiersbronn,65 - 75 Jahre,1436,609,827
False,8237004,Baiersbronn,75 und mehr Jahre,1238,378,860
False,8237004,Baiersbronn,Insgesamt,16646,7975,8671
False,8237019,"Dornstetten, Stadt",unter 3 Jahre,261,145,116
False,8237019,"Dornstetten, Stadt",3 -  6 Jahre,276,139,137
False,8237019,"Dornstetten, Stadt",6 - 10 Jahre,401,189,212
False,8237019,"Dornstetten, Stadt",10 - 15 Jahre,450,231,219
False,8237019,"Dornstetten, Stadt",15 - 18 Jahre,267,127,140
False,8237019,"Dornstetten, Stadt",18 - 20 Jahre,154,93,61
False,8237019,"Dornstetten, Stadt",20 - 25 Jahre,487,258,229
False,8237019,"Dornstetten, Stadt",25 - 30 Jahre,561,284,277
False,8237019,"Dornstetten, Stadt",30 - 35 Jahre,677,338,339
False,8237019,"Dornstetten, Stadt",35 - 40 Jahre,585,292,293
False,8237019,"Dornstetten, Stadt",40 - 45 Jahre,559,292,267
False,8237019,"Dornstetten, Stadt",45 - 50 Jahre,457,256,201
False,8237019,"Dornstetten, Stadt",50 - 55 Jahre,374,184,190
False,8237019,"Dornstetten, Stadt",55 - 60 Jahre,476,244,232
False,8237019,"Dornstetten, Stadt",60 - 65 Jahre,356,157,199
False,8237019,"Dornstetten, Stadt",65 - 75 Jahre,580,235,345
False,8237019,"Dornstetten, Stadt",75 und mehr Jahre,380,117,263
False,8237019,"Dornstetten, Stadt",Insgesamt,7301,3581,3720
False,8237024,Empfingen,unter 3 Jahre,186,103,83
False,8237024,Empfingen,3 -  6 Jahre,220,95,125
False,8237024,Empfingen,6 - 10 Jahre,253,148,105
False,8237024,Empfingen,10 - 15 Jahre,155,99,56
False,8237024,Empfingen,15 - 18 Jahre,148,37,111
False,8237024,Empfingen,18 - 20 Jahre,103,61,42
False,8237024,Empfingen,20 - 25 Jahre,355,186,169
False,8237024,Empfingen,25 - 30 Jahre,390,204,186
False,8237024,Empfingen,30 - 35 Jahre,370,190,180
False,8237024,Empfingen,35 - 40 Jahre,356,191,165
False,8237024,Empfingen,40 - 45 Jahre,265,120,145
False,8237024,Empfingen,45 - 50 Jahre,222,95,127
False,8237024,Empfingen,50 - 55 Jahre,185,96,89
False,8237024,Empfingen,55 - 60 Jahre,263,126,137
False,8237024,Empfingen,60 - 65 Jahre,214,95,119
False,8237024,Empfingen,65 - 75 Jahre,294,122,172
False,8237024,Empfingen,75 und mehr Jahre,177,34,143
False,8237024,Empfingen,Insgesamt,4156,2002,2154
False,8237027,Eutingen im Gäu,unter 3 Jahre,238,117,121
False,8237027,Eutingen im Gäu,3 -  6 Jahre,217,115,102
False,8237027,Eutingen im Gäu,6 - 10 Jahre,304,146,158
False,8237027,Eutingen im Gäu,10 - 15 Jahre,297,143,154
False,8237027,Eutingen im Gäu,15 - 18 Jahre,162,85,77
False,8237027,Eutingen im Gäu,18 - 20 Jahre,118,51,67
False,8237027,Eutingen im Gäu,20 - 25 Jahre,317,149,168
False,8237027,Eutingen im Gäu,25 - 30 Jahre,443,230,213
False,8237027,Eutingen im Gäu,30 - 35 Jahre,485,261,224
False,8237027,Eutingen im Gäu,35 - 40 Jahre,394,202,192
False,8237027,Eutingen im Gäu,40 - 45 Jahre,332,169,163
False,8237027,Eutingen im Gäu,45 - 50 Jahre,278,152,126
False,8237027,Eutingen im Gäu,50 - 55 Jahre,252,140,112
False,8237027,Eutingen im Gäu,55 - 60 Jahre,305,152,153
False,8237027,Eutingen im Gäu,60 - 65 Jahre,245,115,130
False,8237027,Eutingen im Gäu,65 - 75 Jahre,305,136,169
False,8237027,Eutingen im Gäu,75 und mehr Jahre,176,55,121
False,8237027,Eutingen im Gäu,Insgesamt,4868,2418,2450
False,8237028,"Freudenstadt, Stadt",unter 3 Jahre,724,376,348
False,8237028,"Freudenstadt, Stadt",3 -  6 Jahre,796,394,402
False,8237028,"Freudenstadt, Stadt",6 - 10 Jahre,1005,523,482
False,8237028,"Freudenstadt, Stadt",10 - 15 Jahre,1239,628,611
False,8237028,"Freudenstadt, Stadt",15 - 18 Jahre,767,387,380
False,8237028,"Freudenstadt, Stadt",18 - 20 Jahre,540,247,293
False,8237028,"Freudenstadt, Stadt",20 - 25 Jahre,1371,658,713
False,8237028,"Freudenstadt, Stadt",25 - 30 Jahre,1926,928,998
False,8237028,"Freudenstadt, Stadt",30 - 35 Jahre,1939,981,958
False,8237028,"Freudenstadt, Stadt",35 - 40 Jahre,1736,852,884
False,8237028,"Freudenstadt, Stadt",40 - 45 Jahre,1571,806,765
False,8237028,"Freudenstadt, Stadt",45 - 50 Jahre,1389,711,678
False,8237028,"Freudenstadt, Stadt",50 - 55 Jahre,1364,644,720
False,8237028,"Freudenstadt, Stadt",55 - 60 Jahre,1705,818,887
False,8237028,"Freudenstadt, Stadt",60 - 65 Jahre,1271,606,665
False,8237028,"Freudenstadt, Stadt",65 - 75 Jahre,2342,860,1482
False,8237028,"Freudenstadt, Stadt",75 und mehr Jahre,2124,632,1492
False,8237028,"Freudenstadt, Stadt",Insgesamt,23809,11051,12758
False,8237030,Glatten,unter 3 Jahre,95,54,41
False,8237030,Glatten,3 -  6 Jahre,101,44,57
False,8237030,Glatten,6 - 10 Jahre,128,60,68
False,8237030,Glatten,10 - 15 Jahre,174,89,85
False,8237030,Glatten,15 - 18 Jahre,101,59,42
False,8237030,Glatten,18 - 20 Jahre,60,32,28
False,8237030,Glatten,20 - 25 Jahre,124,61,63
False,8237030,Glatten,25 - 30 Jahre,165,99,66
False,8237030,Glatten,30 - 35 Jahre,201,96,105
False,8237030,Glatten,35 - 40 Jahre,187,89,98
False,8237030,Glatten,40 - 45 Jahre,192,104,88
False,8237030,Glatten,45 - 50 Jahre,139,69,70
False,8237030,Glatten,50 - 55 Jahre,135,60,75
False,8237030,Glatten,55 - 60 Jahre,176,90,86
False,8237030,Glatten,60 - 65 Jahre,135,62,73
False,8237030,Glatten,65 - 75 Jahre,231,90,141
False,8237030,Glatten,75 und mehr Jahre,133,50,83
False,8237030,Glatten,Insgesamt,2477,1208,1269
False,8237032,Grömbach,unter 3 Jahre,30,19,11
False,8237032,Grömbach,3 -  6 Jahre,28,11,17
False,8237032,Grömbach,6 - 10 Jahre,42,25,17
False,8237032,Grömbach,10 - 15 Jahre,48,30,18
False,8237032,Grömbach,15 - 18 Jahre,20,13,7
False,8237032,Grömbach,18 - 20 Jahre,14,7,7
False,8237032,Grömbach,20 - 25 Jahre,46,28,18
False,8237032,Grömbach,25 - 30 Jahre,64,29,35
False,8237032,Grömbach,30 - 35 Jahre,60,32,28
False,8237032,Grömbach,35 - 40 Jahre,38,18,20
False,8237032,Grömbach,40 - 45 Jahre,48,29,19
False,8237032,Grömbach,45 - 50 Jahre,38,17,21
False,8237032,Grömbach,50 - 55 Jahre,29,14,15
False,8237032,Grömbach,55 - 60 Jahre,39,23,16
False,8237032,Grömbach,60 - 65 Jahre,24,12,12
False,8237032,Grömbach,65 - 75 Jahre,41,15,26
False,8237032,Grömbach,75 und mehr Jahre,45,9,36
False,8237032,Grömbach,Insgesamt,654,331,323
False,8237040,"Horb am Neckar, Stadt",unter 3 Jahre,973,529,444
False,8237040,"Horb am Neckar, Stadt",3 -  6 Jahre,1006,523,483
False,8237040,"Horb am Neckar, Stadt",6 - 10 Jahre,1422,697,725
False,8237040,"Horb am Neckar, Stadt",10 - 15 Jahre,1521,776,745
False,8237040,"Horb am Neckar, Stadt",15 - 18 Jahre,897,468,429
False,8237040,"Horb am Neckar, Stadt",18 - 20 Jahre,528,281,247
False,8237040,"Horb am Neckar, Stadt",20 - 25 Jahre,1731,875,856
False,8237040,"Horb am Neckar, Stadt",25 - 30 Jahre,2162,1168,994
False,8237040,"Horb am Neckar, Stadt",30 - 35 Jahre,2215,1158,1057
False,8237040,"Horb am Neckar, Stadt",35 - 40 Jahre,1962,1014,948
False,8237040,"Horb am Neckar, Stadt",40 - 45 Jahre,1728,901,827
False,8237040,"Horb am Neckar, Stadt",45 - 50 Jahre,1471,772,699
False,8237040,"Horb am Neckar, Stadt",50 - 55 Jahre,1310,675,635
False,8237040,"Horb am Neckar, Stadt",55 - 60 Jahre,1639,828,811
False,8237040,"Horb am Neckar, Stadt",60 - 65 Jahre,1200,605,595
False,8237040,"Horb am Neckar, Stadt",65 - 75 Jahre,1885,774,1111
False,8237040,"Horb am Neckar, Stadt",75 und mehr Jahre,1246,351,895
False,8237040,"Horb am Neckar, Stadt",Insgesamt,24896,12395,12501
False,8237045,Loßburg,unter 3 Jahre,272,153,119
False,8237045,Loßburg,3 -  6 Jahre,304,170,134
False,8237045,Loßburg,6 - 10 Jahre,404,216,188
False,8237045,Loßburg,10 - 15 Jahre,502,248,254
False,8237045,Loßburg,15 - 18 Jahre,259,146,113
False,8237045,Loßburg,18 - 20 Jahre,152,77,75
False,8237045,Loßburg,20 - 25 Jahre,408,199,209
False,8237045,Loßburg,25 - 30 Jahre,598,328,270
False,8237045,Loßburg,30 - 35 Jahre,699,366,333
False,8237045,Loßburg,35 - 40 Jahre,621,327,294
False,8237045,Loßburg,40 - 45 Jahre,472,256,216
False,8237045,Loßburg,45 - 50 Jahre,396,214,182
False,8237045,Loßburg,50 - 55 Jahre,402,195,207
False,8237045,Loßburg,55 - 60 Jahre,555,278,277
False,8237045,Loßburg,60 - 65 Jahre,427,205,222
False,8237045,Loßburg,65 - 75 Jahre,650,279,371
False,8237045,Loßburg,75 und mehr Jahre,440,128,312
False,8237045,Loßburg,Insgesamt,7561,3785,3776
False,8237054,Pfalzgrafenweiler,unter 3 Jahre,284,149,135
False,8237054,Pfalzgrafenweiler,3 -  6 Jahre,297,145,152
False,8237054,Pfalzgrafenweiler,6 - 10 Jahre,358,192,166
False,8237054,Pfalzgrafenweiler,10 - 15 Jahre,410,224,186
False,8237054,Pfalzgrafenweiler,15 - 18 Jahre,211,108,103
False,8237054,Pfalzgrafenweiler,18 - 20 Jahre,164,77,87
False,8237054,Pfalzgrafenweiler,20 - 25 Jahre,435,225,210
False,8237054,Pfalzgrafenweiler,25 - 30 Jahre,559,299,260
False,8237054,Pfalzgrafenweiler,30 - 35 Jahre,576,300,276
False,8237054,Pfalzgrafenweiler,35 - 40 Jahre,498,246,252
False,8237054,Pfalzgrafenweiler,40 - 45 Jahre,448,233,215
False,8237054,Pfalzgrafenweiler,45 - 50 Jahre,328,169,159
False,8237054,Pfalzgrafenweiler,50 - 55 Jahre,290,146,144
False,8237054,Pfalzgrafenweiler,55 - 60 Jahre,457,225,232
False,8237054,Pfalzgrafenweiler,60 - 65 Jahre,325,171,154
False,8237054,Pfalzgrafenweiler,65 - 75 Jahre,523,228,295
False,8237054,Pfalzgrafenweiler,75 und mehr Jahre,377,98,279
False,8237054,Pfalzgrafenweiler,Insgesamt,6540,3235,3305
False,8237061,Schopfloch,unter 3 Jahre,103,50,53
False,8237061,Schopfloch,3 -  6 Jahre,115,55,60
False,8237061,Schopfloch,6 - 10 Jahre,149,62,87
False,8237061,Schopfloch,10 - 15 Jahre,126,67,59
False,8237061,Schopfloch,15 - 18 Jahre,87,41,46
False,8237061,Schopfloch,18 - 20 Jahre,46,24,22
False,8237061,Schopfloch,20 - 25 Jahre,155,68,87
False,8237061,Schopfloch,25 - 30 Jahre,200,105,95
False,8237061,Schopfloch,30 - 35 Jahre,195,103,92
False,8237061,Schopfloch,35 - 40 Jahre,178,92,86
False,8237061,Schopfloch,40 - 45 Jahre,161,92,69
False,8237061,Schopfloch,45 - 50 Jahre,120,62,58
False,8237061,Schopfloch,50 - 55 Jahre,128,66,62
False,8237061,Schopfloch,55 - 60 Jahre,163,76,87
False,8237061,Schopfloch,60 - 65 Jahre,120,58,62
False,8237061,Schopfloch,65 - 75 Jahre,204,92,112
False,8237061,Schopfloch,75 und mehr Jahre,123,36,87
False,8237061,Schopfloch,Insgesamt,2373,1149,1224
False,8237072,Wörnersberg,unter 3 Jahre,13,9,4
False,8237072,Wörnersberg,3 -  6 Jahre,11,6,5
False,8237072,Wörnersberg,6 - 10 Jahre,12,7,5
False,8237072,Wörnersberg,10 - 15 Jahre,16,11,5
False,8237072,Wörnersberg,15 - 18 Jahre,5,3,2
False,8237072,Wörnersberg,18 - 20 Jahre,4,1,3
False,8237072,Wörnersberg,20 - 25 Jahre,16,5,11
False,8237072,Wörnersberg,25 - 30 Jahre,22,9,13
False,8237072,Wörnersberg,30 - 35 Jahre,27,13,14
False,8237072,Wörnersberg,35 - 40 Jahre,17,7,10
False,8237072,Wörnersberg,40 - 45 Jahre,15,10,5
False,8237072,Wörnersberg,45 - 50 Jahre,8,5,3
False,8237072,Wörnersberg,50 - 55 Jahre,10,5,5
False,8237072,Wörnersberg,55 - 60 Jahre,9,5,4
False,8237072,Wörnersberg,60 - 65 Jahre,10,5,5
False,8237072,Wörnersberg,65 - 75 Jahre,19,4,15
False,8237072,Wörnersberg,75 und mehr Jahre,7,1,6
False,8237072,Wörnersberg,Insgesamt,221,106,115
False,8237073,Seewald,unter 3 Jahre,104,50,54
False,8237073,Seewald,3 -  6 Jahre,84,39,45
False,8237073,Seewald,6 - 10 Jahre,115,64,51
False,8237073,Seewald,10 - 15 Jahre,132,69,63
False,8237073,Seewald,15 - 18 Jahre,76,39,37
False,8237073,Seewald,18 - 20 Jahre,42,22,20
False,8237073,Seewald,20 - 25 Jahre,132,67,65
False,8237073,Seewald,25 - 30 Jahre,170,105,65
False,8237073,Seewald,30 - 35 Jahre,227,107,120
False,8237073,Seewald,35 - 40 Jahre,189,105,84
False,8237073,Seewald,40 - 45 Jahre,135,70,65
False,8237073,Seewald,45 - 50 Jahre,113,62,51
False,8237073,Seewald,50 - 55 Jahre,123,57,66
False,8237073,Seewald,55 - 60 Jahre,196,92,104
False,8237073,Seewald,60 - 65 Jahre,139,69,70
False,8237073,Seewald,65 - 75 Jahre,215,103,112
False,8237073,Seewald,75 und mehr Jahre,204,57,147
False,8237073,Seewald,Insgesamt,2396,1177,1219
False,8237074,Waldachtal,unter 3 Jahre,250,113,137
False,8237074,Waldachtal,3 -  6 Jahre,251,122,129
False,8237074,Waldachtal,6 - 10 Jahre,313,177,136
False,8237074,Waldachtal,10 - 15 Jahre,352,199,153
False,8237074,Waldachtal,15 - 18 Jahre,205,111,94
False,8237074,Waldachtal,18 - 20 Jahre,145,82,63
False,8237074,Waldachtal,20 - 25 Jahre,395,190,205
False,8237074,Waldachtal,25 - 30 Jahre,477,234,243
False,8237074,Waldachtal,30 - 35 Jahre,530,272,258
False,8237074,Waldachtal,35 - 40 Jahre,507,275,232
False,8237074,Waldachtal,40 - 45 Jahre,427,223,204
False,8237074,Waldachtal,45 - 50 Jahre,343,179,164
False,8237074,Waldachtal,50 - 55 Jahre,303,157,146
False,8237074,Waldachtal,55 - 60 Jahre,356,186,170
False,8237074,Waldachtal,60 - 65 Jahre,272,112,160
False,8237074,Waldachtal,65 - 75 Jahre,485,180,305
False,8237074,Waldachtal,75 und mehr Jahre,244,85,159
False,8237074,Waldachtal,Insgesamt,5855,2897,2958
False,8237075,Bad Rippoldsau-Schapbach,unter 3 Jahre,100,43,57
False,8237075,Bad Rippoldsau-Schapbach,3 -  6 Jahre,82,41,41
False,8237075,Bad Rippoldsau-Schapbach,6 - 10 Jahre,95,47,48
False,8237075,Bad Rippoldsau-Schapbach,10 - 15 Jahre,149,78,71
False,8237075,Bad Rippoldsau-Schapbach,15 - 18 Jahre,91,46,45
False,8237075,Bad Rippoldsau-Schapbach,18 - 20 Jahre,59,34,25
False,8237075,Bad Rippoldsau-Schapbach,20 - 25 Jahre,168,89,79
False,8237075,Bad Rippoldsau-Schapbach,25 - 30 Jahre,191,112,79
False,8237075,Bad Rippoldsau-Schapbach,30 - 35 Jahre,211,108,103
False,8237075,Bad Rippoldsau-Schapbach,35 - 40 Jahre,170,99,71
False,8237075,Bad Rippoldsau-Schapbach,40 - 45 Jahre,129,69,60
False,8237075,Bad Rippoldsau-Schapbach,45 - 50 Jahre,126,65,61
False,8237075,Bad Rippoldsau-Schapbach,50 - 55 Jahre,124,53,71
False,8237075,Bad Rippoldsau-Schapbach,55 - 60 Jahre,184,93,91
False,8237075,Bad Rippoldsau-Schapbach,60 - 65 Jahre,141,75,66
False,8237075,Bad Rippoldsau-Schapbach,65 - 75 Jahre,255,113,142
False,8237075,Bad Rippoldsau-Schapbach,75 und mehr Jahre,172,56,116
False,8237075,Bad Rippoldsau-Schapbach,Insgesamt,2447,1221,1226
False,83,Regierungsbezirk Freiburg,unter 3 Jahre,70222,36227,33995
False,83,Regierungsbezirk Freiburg,3 -  6 Jahre,74883,38184,36699
False,83,Regierungsbezirk Freiburg,6 - 10 Jahre,99260,50517,48743
False,83,Regierungsbezirk Freiburg,10 - 15 Jahre,115816,59414,56402
False,83,Regierungsbezirk Freiburg,15 - 18 Jahre,65840,33673,32167
False,83,Regierungsbezirk Freiburg,18 - 20 Jahre,43760,22353,21407
False,83,Regierungsbezirk Freiburg,20 - 25 Jahre,128289,64751,63538
False,83,Regierungsbezirk Freiburg,25 - 30 Jahre,178898,91193,87705
False,83,Regierungsbezirk Freiburg,30 - 35 Jahre,190026,97763,92263
False,83,Regierungsbezirk Freiburg,35 - 40 Jahre,166331,85323,81008
False,83,Regierungsbezirk Freiburg,40 - 45 Jahre,143743,72537,71206
False,83,Regierungsbezirk Freiburg,45 - 50 Jahre,123210,62380,60830
False,83,Regierungsbezirk Freiburg,50 - 55 Jahre,117323,58574,58749
False,83,Regierungsbezirk Freiburg,55 - 60 Jahre,143460,71242,72218
False,83,Regierungsbezirk Freiburg,60 - 65 Jahre,108566,52971,55595
False,83,Regierungsbezirk Freiburg,65 - 75 Jahre,183362,76319,107043
False,83,Regierungsbezirk Freiburg,75 und mehr Jahre,134053,39493,94560
False,83,Regierungsbezirk Freiburg,Insgesamt,2087042,1012914,1074128
False,8311,Stadtkreis Freiburg im Breisgau,unter 3 Jahre,5683,2935,2748
False,8311,Stadtkreis Freiburg im Breisgau,3 -  6 Jahre,5655,2829,2826
False,8311,Stadtkreis Freiburg im Breisgau,6 - 10 Jahre,7216,3703,3513
False,8311,Stadtkreis Freiburg im Breisgau,10 - 15 Jahre,8370,4238,4132
False,8311,Stadtkreis Freiburg im Breisgau,15 - 18 Jahre,4760,2484,2276
False,8311,Stadtkreis Freiburg im Breisgau,18 - 20 Jahre,3554,1653,1901
False,8311,Stadtkreis Freiburg im Breisgau,20 - 25 Jahre,16712,7713,8999
False,8311,Stadtkreis Freiburg im Breisgau,25 - 30 Jahre,22831,11169,11662
False,8311,Stadtkreis Freiburg im Breisgau,30 - 35 Jahre,22309,11428,10881
False,8311,Stadtkreis Freiburg im Breisgau,35 - 40 Jahre,17375,9064,8311
False,8311,Stadtkreis Freiburg im Breisgau,40 - 45 Jahre,13409,6771,6638
False,8311,Stadtkreis Freiburg im Breisgau,45 - 50 Jahre,10887,5389,5498
False,8311,Stadtkreis Freiburg im Breisgau,50 - 55 Jahre,10548,5111,5437
False,8311,Stadtkreis Freiburg im Breisgau,55 - 60 Jahre,11185,5268,5917
False,8311,Stadtkreis Freiburg im Breisgau,60 - 65 Jahre,8485,3839,4646
False,8311,Stadtkreis Freiburg im Breisgau,65 - 75 Jahre,16035,6185,9850
False,8311,Stadtkreis Freiburg im Breisgau,75 und mehr Jahre,14259,3843,10416
False,8311,Stadtkreis Freiburg im Breisgau,Insgesamt,199273,93622,105651
False,8311000,"Freiburg im Breisgau, Stadt",unter 3 Jahre,5683,2935,2748
False,8311000,"Freiburg im Breisgau, Stadt",3 -  6 Jahre,5655,2829,2826
False,8311000,"Freiburg im Breisgau, Stadt",6 - 10 Jahre,7216,3703,3513
False,8311000,"Freiburg im Breisgau, Stadt",10 - 15 Jahre,8370,4238,4132
False,8311000,"Freiburg im Breisgau, Stadt",15 - 18 Jahre,4760,2484,2276
False,8311000,"Freiburg im Breisgau, Stadt",18 - 20 Jahre,3554,1653,1901
False,8311000,"Freiburg im Breisgau, Stadt",20 - 25 Jahre,16712,7713,8999
False,8311000,"Freiburg im Breisgau, Stadt",25 - 30 Jahre,22831,11169,11662
False,8311000,"Freiburg im Breisgau, Stadt",30 - 35 Jahre,22309,11428,10881
False,8311000,"Freiburg im Breisgau, Stadt",35 - 40 Jahre,17375,9064,8311
False,8311000,"Freiburg im Breisgau, Stadt",40 - 45 Jahre,13409,6771,6638
False,8311000,"Freiburg im Breisgau, Stadt",45 - 50 Jahre,10887,5389,5498
False,8311000,"Freiburg im Breisgau, Stadt",50 - 55 Jahre,10548,5111,5437
False,8311000,"Freiburg im Breisgau, Stadt",55 - 60 Jahre,11185,5268,5917
False,8311000,"Freiburg im Breisgau, Stadt",60 - 65 Jahre,8485,3839,4646
False,8311000,"Freiburg im Breisgau, Stadt",65 - 75 Jahre,16035,6185,9850
False,8311000,"Freiburg im Breisgau, Stadt",75 und mehr Jahre,14259,3843,10416
False,8311000,"Freiburg im Breisgau, Stadt",Insgesamt,199273,93622,105651
False,8315,Landkreis Breisgau-Hochschwarzwald,unter 3 Jahre,8156,4262,3894
False,8315,Landkreis Breisgau-Hochschwarzwald,3 -  6 Jahre,8425,4341,4084
False,8315,Landkreis Breisgau-Hochschwarzwald,6 - 10 Jahre,11161,5596,5565
False,8315,Landkreis Breisgau-Hochschwarzwald,10 - 15 Jahre,12976,6621,6355
False,8315,Landkreis Breisgau-Hochschwarzwald,15 - 18 Jahre,7536,3882,3654
False,8315,Landkreis Breisgau-Hochschwarzwald,18 - 20 Jahre,5216,2616,2600
False,8315,Landkreis Breisgau-Hochschwarzwald,20 - 25 Jahre,14238,7113,7125
False,8315,Landkreis Breisgau-Hochschwarzwald,25 - 30 Jahre,19515,9806,9709
False,8315,Landkreis Breisgau-Hochschwarzwald,30 - 35 Jahre,20804,10622,10182
False,8315,Landkreis Breisgau-Hochschwarzwald,35 - 40 Jahre,18423,9371,9052
False,8315,Landkreis Breisgau-Hochschwarzwald,40 - 45 Jahre,16711,8248,8463
False,8315,Landkreis Breisgau-Hochschwarzwald,45 - 50 Jahre,14340,7206,7134
False,8315,Landkreis Breisgau-Hochschwarzwald,50 - 55 Jahre,13441,6702,6739
False,8315,Landkreis Breisgau-Hochschwarzwald,55 - 60 Jahre,15455,7652,7803
False,8315,Landkreis Breisgau-Hochschwarzwald,60 - 65 Jahre,11186,5429,5757
False,8315,Landkreis Breisgau-Hochschwarzwald,65 - 75 Jahre,19278,8197,11081
False,8315,Landkreis Breisgau-Hochschwarzwald,75 und mehr Jahre,13978,4497,9481
False,8315,Landkreis Breisgau-Hochschwarzwald,Insgesamt,230839,112161,118678
False,8315003,Au,unter 3 Jahre,47,29,18
False,8315003,Au,3 -  6 Jahre,31,19,12
False,8315003,Au,6 - 10 Jahre,54,34,20
False,8315003,Au,10 - 15 Jahre,65,32,33
False,8315003,Au,15 - 18 Jahre,37,24,13
False,8315003,Au,18 - 20 Jahre,29,14,15
False,8315003,Au,20 - 25 Jahre,69,37,32
False,8315003,Au,25 - 30 Jahre,105,48,57
False,8315003,Au,30 - 35 Jahre,112,52,60
False,8315003,Au,35 - 40 Jahre,107,53,54
False,8315003,Au,40 - 45 Jahre,80,39,41
False,8315003,Au,45 - 50 Jahre,78,39,39
False,8315003,Au,50 - 55 Jahre,89,41,48
False,8315003,Au,55 - 60 Jahre,83,43,40
False,8315003,Au,60 - 65 Jahre,48,24,24
False,8315003,Au,65 - 75 Jahre,98,45,53
False,8315003,Au,75 und mehr Jahre,42,18,24
False,8315003,Au,Insgesamt,1174,591,583
False,8315004,Auggen,unter 3 Jahre,66,32,34
False,8315004,Auggen,3 -  6 Jahre,67,38,29
False,8315004,Auggen,6 - 10 Jahre,93,41,52
False,8315004,Auggen,10 - 15 Jahre,127,61,66
False,8315004,Auggen,15 - 18 Jahre,68,36,32
False,8315004,Auggen,18 - 20 Jahre,58,31,27
False,8315004,Auggen,20 - 25 Jahre,130,68,62
False,8315004,Auggen,25 - 30 Jahre,166,77,89
False,8315004,Auggen,30 - 35 Jahre,155,99,56
False,8315004,Auggen,35 - 40 Jahre,137,73,64
False,8315004,Auggen,40 - 45 Jahre,170,70,100
False,8315004,Auggen,45 - 50 Jahre,148,86,62
False,8315004,Auggen,50 - 55 Jahre,148,77,71
False,8315004,Auggen,55 - 60 Jahre,167,85,82
False,8315004,Auggen,60 - 65 Jahre,87,40,47
False,8315004,Auggen,65 - 75 Jahre,215,91,124
False,8315004,Auggen,75 und mehr Jahre,130,41,89
False,8315004,Auggen,Insgesamt,2132,1046,1086
False,8315006,"Bad Krozingen, Stadt",unter 3 Jahre,428,215,213
False,8315006,"Bad Krozingen, Stadt",3 -  6 Jahre,456,213,243
False,8315006,"Bad Krozingen, Stadt",6 - 10 Jahre,577,296,281
False,8315006,"Bad Krozingen, Stadt",10 - 15 Jahre,602,316,286
False,8315006,"Bad Krozingen, Stadt",15 - 18 Jahre,381,174,207
False,8315006,"Bad Krozingen, Stadt",18 - 20 Jahre,312,154,158
False,8315006,"Bad Krozingen, Stadt",20 - 25 Jahre,744,355,389
False,8315006,"Bad Krozingen, Stadt",25 - 30 Jahre,1009,512,497
False,8315006,"Bad Krozingen, Stadt",30 - 35 Jahre,1138,570,568
False,8315006,"Bad Krozingen, Stadt",35 - 40 Jahre,997,514,483
False,8315006,"Bad Krozingen, Stadt",40 - 45 Jahre,947,433,514
False,8315006,"Bad Krozingen, Stadt",45 - 50 Jahre,867,419,448
False,8315006,"Bad Krozingen, Stadt",50 - 55 Jahre,804,391,413
False,8315006,"Bad Krozingen, Stadt",55 - 60 Jahre,923,447,476
False,8315006,"Bad Krozingen, Stadt",60 - 65 Jahre,661,291,370
False,8315006,"Bad Krozingen, Stadt",65 - 75 Jahre,1487,591,896
False,8315006,"Bad Krozingen, Stadt",75 und mehr Jahre,1574,508,1066
False,8315006,"Bad Krozingen, Stadt",Insgesamt,13907,6399,7508
False,8315007,Badenweiler,unter 3 Jahre,115,64,51
False,8315007,Badenweiler,3 -  6 Jahre,95,49,46
False,8315007,Badenweiler,6 - 10 Jahre,131,60,71
False,8315007,Badenweiler,10 - 15 Jahre,130,64,66
False,8315007,Badenweiler,15 - 18 Jahre,87,43,44
False,8315007,Badenweiler,18 - 20 Jahre,93,31,62
False,8315007,Badenweiler,20 - 25 Jahre,216,106,110
False,8315007,Badenweiler,25 - 30 Jahre,268,130,138
False,8315007,Badenweiler,30 - 35 Jahre,252,132,120
False,8315007,Badenweiler,35 - 40 Jahre,228,128,100
False,8315007,Badenweiler,40 - 45 Jahre,240,120,120
False,8315007,Badenweiler,45 - 50 Jahre,212,97,115
False,8315007,Badenweiler,50 - 55 Jahre,238,129,109
False,8315007,Badenweiler,55 - 60 Jahre,281,130,151
False,8315007,Badenweiler,60 - 65 Jahre,228,102,126
False,8315007,Badenweiler,65 - 75 Jahre,468,182,286
False,8315007,Badenweiler,75 und mehr Jahre,497,184,313
False,8315007,Badenweiler,Insgesamt,3779,1751,2028
False,8315008,Ballrechten-Dottingen,unter 3 Jahre,88,50,38
False,8315008,Ballrechten-Dottingen,3 -  6 Jahre,87,42,45
False,8315008,Ballrechten-Dottingen,6 - 10 Jahre,126,61,65
False,8315008,Ballrechten-Dottingen,10 - 15 Jahre,124,65,59
False,8315008,Ballrechten-Dottingen,15 - 18 Jahre,87,49,38
False,8315008,Ballrechten-Dottingen,18 - 20 Jahre,44,24,20
False,8315008,Ballrechten-Dottingen,20 - 25 Jahre,129,67,62
False,8315008,Ballrechten-Dottingen,25 - 30 Jahre,177,91,86
False,8315008,Ballrechten-Dottingen,30 - 35 Jahre,186,96,90
False,8315008,Ballrechten-Dottingen,35 - 40 Jahre,150,70,80
False,8315008,Ballrechten-Dottingen,40 - 45 Jahre,161,76,85
False,8315008,Ballrechten-Dottingen,45 - 50 Jahre,145,77,68
False,8315008,Ballrechten-Dottingen,50 - 55 Jahre,107,55,52
False,8315008,Ballrechten-Dottingen,55 - 60 Jahre,91,49,42
False,8315008,Ballrechten-Dottingen,60 - 65 Jahre,61,30,31
False,8315008,Ballrechten-Dottingen,65 - 75 Jahre,118,50,68
False,8315008,Ballrechten-Dottingen,75 und mehr Jahre,90,33,57
False,8315008,Ballrechten-Dottingen,Insgesamt,1971,985,986
False,8315013,Bötzingen,unter 3 Jahre,231,119,112
False,8315013,Bötzingen,3 -  6 Jahre,213,114,99
False,8315013,Bötzingen,6 - 10 Jahre,266,143,123
False,8315013,Bötzingen,10 - 15 Jahre,280,142,138
False,8315013,Bötzingen,15 - 18 Jahre,154,86,68
False,8315013,Bötzingen,18 - 20 Jahre,123,69,54
False,8315013,Bötzingen,20 - 25 Jahre,345,170,175
False,8315013,Bötzingen,25 - 30 Jahre,501,255,246
False,8315013,Bötzingen,30 - 35 Jahre,507,273,234
False,8315013,Bötzingen,35 - 40 Jahre,368,195,173
False,8315013,Bötzingen,40 - 45 Jahre,355,169,186
False,8315013,Bötzingen,45 - 50 Jahre,295,143,152
False,8315013,Bötzingen,50 - 55 Jahre,309,171,138
False,8315013,Bötzingen,55 - 60 Jahre,328,167,161
False,8315013,Bötzingen,60 - 65 Jahre,240,127,113
False,8315013,Bötzingen,65 - 75 Jahre,328,141,187
False,8315013,Bötzingen,75 und mehr Jahre,209,59,150
False,8315013,Bötzingen,Insgesamt,5052,2543,2509
False,8315014,Bollschweil,unter 3 Jahre,94,52,42
False,8315014,Bollschweil,3 -  6 Jahre,92,54,38
False,8315014,Bollschweil,6 - 10 Jahre,130,55,75
False,8315014,Bollschweil,10 - 15 Jahre,131,65,66
False,8315014,Bollschweil,15 - 18 Jahre,76,24,52
False,8315014,Bollschweil,18 - 20 Jahre,47,21,26
False,8315014,Bollschweil,20 - 25 Jahre,115,62,53
False,8315014,Bollschweil,25 - 30 Jahre,181,102,79
False,8315014,Bollschweil,30 - 35 Jahre,216,111,105
False,8315014,Bollschweil,35 - 40 Jahre,204,103,101
False,8315014,Bollschweil,40 - 45 Jahre,181,88,93
False,8315014,Bollschweil,45 - 50 Jahre,147,66,81
False,8315014,Bollschweil,50 - 55 Jahre,133,74,59
False,8315014,Bollschweil,55 - 60 Jahre,165,77,88
False,8315014,Bollschweil,60 - 65 Jahre,106,59,47
False,8315014,Bollschweil,65 - 75 Jahre,158,74,84
False,8315014,Bollschweil,75 und mehr Jahre,103,38,65
False,8315014,Bollschweil,Insgesamt,2279,1125,1154
False,8315015,"Breisach am Rhein, Stadt",unter 3 Jahre,421,204,217
False,8315015,"Breisach am Rhein, Stadt",3 -  6 Jahre,439,234,205
False,8315015,"Breisach am Rhein, Stadt",6 - 10 Jahre,580,294,286
False,8315015,"Breisach am Rhein, Stadt",10 - 15 Jahre,743,395,348
False,8315015,"Breisach am Rhein, Stadt",15 - 18 Jahre,452,265,187
False,8315015,"Breisach am Rhein, Stadt",18 - 20 Jahre,274,142,132
False,8315015,"Breisach am Rhein, Stadt",20 - 25 Jahre,734,375,359
False,8315015,"Breisach am Rhein, Stadt",25 - 30 Jahre,968,525,443
False,8315015,"Breisach am Rhein, Stadt",30 - 35 Jahre,994,483,511
False,8315015,"Breisach am Rhein, Stadt",35 - 40 Jahre,1042,510,532
False,8315015,"Breisach am Rhein, Stadt",40 - 45 Jahre,940,493,447
False,8315015,"Breisach am Rhein, Stadt",45 - 50 Jahre,813,415,398
False,8315015,"Breisach am Rhein, Stadt",50 - 55 Jahre,654,333,321
False,8315015,"Breisach am Rhein, Stadt",55 - 60 Jahre,775,381,394
False,8315015,"Breisach am Rhein, Stadt",60 - 65 Jahre,571,284,287
False,8315015,"Breisach am Rhein, Stadt",65 - 75 Jahre,901,365,536
False,8315015,"Breisach am Rhein, Stadt",75 und mehr Jahre,551,154,397
False,8315015,"Breisach am Rhein, Stadt",Insgesamt,11852,5852,6000
False,8315016,Breitnau,unter 3 Jahre,39,21,18
False,8315016,Breitnau,3 -  6 Jahre,47,29,18
False,8315016,Breitnau,6 - 10 Jahre,72,34,38
False,8315016,Breitnau,10 - 15 Jahre,99,49,50
False,8315016,Breitnau,15 - 18 Jahre,100,50,50
False,8315016,Breitnau,18 - 20 Jahre,103,46,57
False,8315016,Breitnau,20 - 25 Jahre,212,93,119
False,8315016,Breitnau,25 - 30 Jahre,188,115,73
False,8315016,Breitnau,30 - 35 Jahre,144,78,66
False,8315016,Breitnau,35 - 40 Jahre,120,72,48
False,8315016,Breitnau,40 - 45 Jahre,102,51,51
False,8315016,Breitnau,45 - 50 Jahre,88,45,43
False,8315016,Breitnau,50 - 55 Jahre,82,46,36
False,8315016,Breitnau,55 - 60 Jahre,109,52,57
False,8315016,Breitnau,60 - 65 Jahre,66,34,32
False,8315016,Breitnau,65 - 75 Jahre,133,59,74
False,8315016,Breitnau,75 und mehr Jahre,115,37,78
False,8315016,Breitnau,Insgesamt,1819,911,908
False,8315020,Buchenbach,unter 3 Jahre,138,76,62
False,8315020,Buchenbach,3 -  6 Jahre,147,75,72
False,8315020,Buchenbach,6 - 10 Jahre,161,81,80
False,8315020,Buchenbach,10 - 15 Jahre,176,86,90
False,8315020,Buchenbach,15 - 18 Jahre,102,55,47
False,8315020,Buchenbach,18 - 20 Jahre,76,44,32
False,8315020,Buchenbach,20 - 25 Jahre,203,109,94
False,8315020,Buchenbach,25 - 30 Jahre,296,153,143
False,8315020,Buchenbach,30 - 35 Jahre,310,153,157
False,8315020,Buchenbach,35 - 40 Jahre,264,140,124
False,8315020,Buchenbach,40 - 45 Jahre,207,96,111
False,8315020,Buchenbach,45 - 50 Jahre,197,99,98
False,8315020,Buchenbach,50 - 55 Jahre,194,93,101
False,8315020,Buchenbach,55 - 60 Jahre,199,94,105
False,8315020,Buchenbach,60 - 65 Jahre,143,77,66
False,8315020,Buchenbach,65 - 75 Jahre,207,87,120
False,8315020,Buchenbach,75 und mehr Jahre,122,45,77
False,8315020,Buchenbach,Insgesamt,3142,1563,1579
False,8315022,Buggingen,unter 3 Jahre,142,70,72
False,8315022,Buggingen,3 -  6 Jahre,124,58,66
False,8315022,Buggingen,6 - 10 Jahre,183,108,75
False,8315022,Buggingen,10 - 15 Jahre,229,120,109
False,8315022,Buggingen,15 - 18 Jahre,135,73,62
False,8315022,Buggingen,18 - 20 Jahre,67,44,23
False,8315022,Buggingen,20 - 25 Jahre,237,131,106
False,8315022,Buggingen,25 - 30 Jahre,295,165,130
False,8315022,Buggingen,30 - 35 Jahre,340,175,165
False,8315022,Buggingen,35 - 40 Jahre,291,146,145
False,8315022,Buggingen,40 - 45 Jahre,281,146,135
False,8315022,Buggingen,45 - 50 Jahre,220,114,106
False,8315022,Buggingen,50 - 55 Jahre,202,104,98
False,8315022,Buggingen,55 - 60 Jahre,216,128,88
False,8315022,Buggingen,60 - 65 Jahre,191,89,102
False,8315022,Buggingen,65 - 75 Jahre,303,130,173
False,8315022,Buggingen,75 und mehr Jahre,187,76,111
False,8315022,Buggingen,Insgesamt,3643,1877,1766
False,8315028,Ebringen,unter 3 Jahre,90,34,56
False,8315028,Ebringen,3 -  6 Jahre,103,55,48
False,8315028,Ebringen,6 - 10 Jahre,135,80,55
False,8315028,Ebringen,10 - 15 Jahre,150,74,76
False,8315028,Ebringen,15 - 18 Jahre,70,39,31
False,8315028,Ebringen,18 - 20 Jahre,45,20,25
False,8315028,Ebringen,20 - 25 Jahre,139,63,76
False,8315028,Ebringen,25 - 30 Jahre,191,97,94
False,8315028,Ebringen,30 - 35 Jahre,259,130,129
False,8315028,Ebringen,35 - 40 Jahre,214,107,107
False,8315028,Ebringen,40 - 45 Jahre,186,103,83
False,8315028,Ebringen,45 - 50 Jahre,161,80,81
False,8315028,Ebringen,50 - 55 Jahre,135,67,68
False,8315028,Ebringen,55 - 60 Jahre,146,72,74
False,8315028,Ebringen,60 - 65 Jahre,115,52,63
False,8315028,Ebringen,65 - 75 Jahre,195,83,112
False,8315028,Ebringen,75 und mehr Jahre,124,55,69
False,8315028,Ebringen,Insgesamt,2458,1211,1247
False,8315030,Eichstetten am Kaiserstuhl,unter 3 Jahre,128,67,61
False,8315030,Eichstetten am Kaiserstuhl,3 -  6 Jahre,137,72,65
False,8315030,Eichstetten am Kaiserstuhl,6 - 10 Jahre,205,106,99
False,8315030,Eichstetten am Kaiserstuhl,10 - 15 Jahre,214,104,110
False,8315030,Eichstetten am Kaiserstuhl,15 - 18 Jahre,97,48,49
False,8315030,Eichstetten am Kaiserstuhl,18 - 20 Jahre,81,43,38
False,8315030,Eichstetten am Kaiserstuhl,20 - 25 Jahre,175,89,86
False,8315030,Eichstetten am Kaiserstuhl,25 - 30 Jahre,240,114,126
False,8315030,Eichstetten am Kaiserstuhl,30 - 35 Jahre,271,132,139
False,8315030,Eichstetten am Kaiserstuhl,35 - 40 Jahre,258,143,115
False,8315030,Eichstetten am Kaiserstuhl,40 - 45 Jahre,232,117,115
False,8315030,Eichstetten am Kaiserstuhl,45 - 50 Jahre,170,90,80
False,8315030,Eichstetten am Kaiserstuhl,50 - 55 Jahre,132,70,62
False,8315030,Eichstetten am Kaiserstuhl,55 - 60 Jahre,143,72,71
False,8315030,Eichstetten am Kaiserstuhl,60 - 65 Jahre,128,65,63
False,8315030,Eichstetten am Kaiserstuhl,65 - 75 Jahre,213,84,129
False,8315030,Eichstetten am Kaiserstuhl,75 und mehr Jahre,137,52,85
False,8315030,Eichstetten am Kaiserstuhl,Insgesamt,2961,1468,1493
False,8315031,Eisenbach (Hochschwarzwald),unter 3 Jahre,118,64,54
False,8315031,Eisenbach (Hochschwarzwald),3 -  6 Jahre,95,48,47
False,8315031,Eisenbach (Hochschwarzwald),6 - 10 Jahre,124,64,60
False,8315031,Eisenbach (Hochschwarzwald),10 - 15 Jahre,129,84,45
False,8315031,Eisenbach (Hochschwarzwald),15 - 18 Jahre,79,40,39
False,8315031,Eisenbach (Hochschwarzwald),18 - 20 Jahre,59,33,26
False,8315031,Eisenbach (Hochschwarzwald),20 - 25 Jahre,140,77,63
False,8315031,Eisenbach (Hochschwarzwald),25 - 30 Jahre,168,81,87
False,8315031,Eisenbach (Hochschwarzwald),30 - 35 Jahre,240,126,114
False,8315031,Eisenbach (Hochschwarzwald),35 - 40 Jahre,170,99,71
False,8315031,Eisenbach (Hochschwarzwald),40 - 45 Jahre,134,67,67
False,8315031,Eisenbach (Hochschwarzwald),45 - 50 Jahre,136,71,65
False,8315031,Eisenbach (Hochschwarzwald),50 - 55 Jahre,145,82,63
False,8315031,Eisenbach (Hochschwarzwald),55 - 60 Jahre,188,94,94
False,8315031,Eisenbach (Hochschwarzwald),60 - 65 Jahre,116,53,63
False,8315031,Eisenbach (Hochschwarzwald),65 - 75 Jahre,202,88,114
False,8315031,Eisenbach (Hochschwarzwald),75 und mehr Jahre,162,62,100
False,8315031,Eisenbach (Hochschwarzwald),Insgesamt,2405,1233,1172
False,8315033,Eschbach,unter 3 Jahre,81,42,39
False,8315033,Eschbach,3 -  6 Jahre,75,43,32
False,8315033,Eschbach,6 - 10 Jahre,100,54,46
False,8315033,Eschbach,10 - 15 Jahre,102,61,41
False,8315033,Eschbach,15 - 18 Jahre,62,34,28
False,8315033,Eschbach,18 - 20 Jahre,40,21,19
False,8315033,Eschbach,20 - 25 Jahre,109,49,60
False,8315033,Eschbach,25 - 30 Jahre,220,126,94
False,8315033,Eschbach,30 - 35 Jahre,196,110,86
False,8315033,Eschbach,35 - 40 Jahre,186,92,94
False,8315033,Eschbach,40 - 45 Jahre,128,79,49
False,8315033,Eschbach,45 - 50 Jahre,106,54,52
False,8315033,Eschbach,50 - 55 Jahre,81,42,39
False,8315033,Eschbach,55 - 60 Jahre,80,46,34
False,8315033,Eschbach,60 - 65 Jahre,61,24,37
False,8315033,Eschbach,65 - 75 Jahre,98,52,46
False,8315033,Eschbach,75 und mehr Jahre,54,18,36
False,8315033,Eschbach,Insgesamt,1779,947,832
False,8315037,Feldberg (Schwarzwald),unter 3 Jahre,44,22,22
False,8315037,Feldberg (Schwarzwald),3 -  6 Jahre,47,21,26
False,8315037,Feldberg (Schwarzwald),6 - 10 Jahre,73,44,29
False,8315037,Feldberg (Schwarzwald),10 - 15 Jahre,74,39,35
False,8315037,Feldberg (Schwarzwald),15 - 18 Jahre,44,23,21
False,8315037,Feldberg (Schwarzwald),18 - 20 Jahre,28,4,24
False,8315037,Feldberg (Schwarzwald),20 - 25 Jahre,172,77,95
False,8315037,Feldberg (Schwarzwald),25 - 30 Jahre,160,81,79
False,8315037,Feldberg (Schwarzwald),30 - 35 Jahre,169,101,68
False,8315037,Feldberg (Schwarzwald),35 - 40 Jahre,137,63,74
False,8315037,Feldberg (Schwarzwald),40 - 45 Jahre,105,47,58
False,8315037,Feldberg (Schwarzwald),45 - 50 Jahre,92,46,46
False,8315037,Feldberg (Schwarzwald),50 - 55 Jahre,84,44,40
False,8315037,Feldberg (Schwarzwald),55 - 60 Jahre,118,51,67
False,8315037,Feldberg (Schwarzwald),60 - 65 Jahre,93,44,49
False,8315037,Feldberg (Schwarzwald),65 - 75 Jahre,182,85,97
False,8315037,Feldberg (Schwarzwald),75 und mehr Jahre,111,40,71
False,8315037,Feldberg (Schwarzwald),Insgesamt,1733,832,901
False,8315039,Friedenweiler,unter 3 Jahre,77,46,31
False,8315039,Friedenweiler,3 -  6 Jahre,78,35,43
False,8315039,Friedenweiler,6 - 10 Jahre,110,59,51
False,8315039,Friedenweiler,10 - 15 Jahre,131,62,69
False,8315039,Friedenweiler,15 - 18 Jahre,68,32,36
False,8315039,Friedenweiler,18 - 20 Jahre,37,23,14
False,8315039,Friedenweiler,20 - 25 Jahre,130,60,70
False,8315039,Friedenweiler,25 - 30 Jahre,131,60,71
False,8315039,Friedenweiler,30 - 35 Jahre,166,85,81
False,8315039,Friedenweiler,35 - 40 Jahre,137,70,67
False,8315039,Friedenweiler,40 - 45 Jahre,151,73,78
False,8315039,Friedenweiler,45 - 50 Jahre,107,58,49
False,8315039,Friedenweiler,50 - 55 Jahre,88,39,49
False,8315039,Friedenweiler,55 - 60 Jahre,104,51,53
False,8315039,Friedenweiler,60 - 65 Jahre,97,49,48
False,8315039,Friedenweiler,65 - 75 Jahre,182,72,110
False,8315039,Friedenweiler,75 und mehr Jahre,208,68,140
False,8315039,Friedenweiler,Insgesamt,2002,942,1060
False,8315041,Glottertal,unter 3 Jahre,116,63,53
False,8315041,Glottertal,3 -  6 Jahre,127,55,72
False,8315041,Glottertal,6 - 10 Jahre,122,53,69
False,8315041,Glottertal,10 - 15 Jahre,162,80,82
False,8315041,Glottertal,15 - 18 Jahre,87,38,49
False,8315041,Glottertal,18 - 20 Jahre,67,33,34
False,8315041,Glottertal,20 - 25 Jahre,181,88,93
False,8315041,Glottertal,25 - 30 Jahre,265,123,142
False,8315041,Glottertal,30 - 35 Jahre,301,166,135
False,8315041,Glottertal,35 - 40 Jahre,218,113,105
False,8315041,Glottertal,40 - 45 Jahre,190,100,90
False,8315041,Glottertal,45 - 50 Jahre,165,84,81
False,8315041,Glottertal,50 - 55 Jahre,130,77,53
False,8315041,Glottertal,55 - 60 Jahre,166,85,81
False,8315041,Glottertal,60 - 65 Jahre,169,84,85
False,8315041,Glottertal,65 - 75 Jahre,281,121,160
False,8315041,Glottertal,75 und mehr Jahre,146,42,104
False,8315041,Glottertal,Insgesamt,2893,1405,1488
False,8315043,Gottenheim,unter 3 Jahre,73,37,36
False,8315043,Gottenheim,3 -  6 Jahre,98,48,50
False,8315043,Gottenheim,6 - 10 Jahre,124,54,70
False,8315043,Gottenheim,10 - 15 Jahre,143,77,66
False,8315043,Gottenheim,15 - 18 Jahre,86,38,48
False,8315043,Gottenheim,18 - 20 Jahre,50,29,21
False,8315043,Gottenheim,20 - 25 Jahre,138,76,62
False,8315043,Gottenheim,25 - 30 Jahre,213,122,91
False,8315043,Gottenheim,30 - 35 Jahre,215,109,106
False,8315043,Gottenheim,35 - 40 Jahre,206,102,104
False,8315043,Gottenheim,40 - 45 Jahre,198,96,102
False,8315043,Gottenheim,45 - 50 Jahre,151,80,71
False,8315043,Gottenheim,50 - 55 Jahre,125,65,60
False,8315043,Gottenheim,55 - 60 Jahre,137,77,60
False,8315043,Gottenheim,60 - 65 Jahre,133,67,66
False,8315043,Gottenheim,65 - 75 Jahre,191,85,106
False,8315043,Gottenheim,75 und mehr Jahre,145,44,101
False,8315043,Gottenheim,Insgesamt,2426,1206,1220
False,8315047,Gundelfingen,unter 3 Jahre,329,173,156
False,8315047,Gundelfingen,3 -  6 Jahre,296,162,134
False,8315047,Gundelfingen,6 - 10 Jahre,401,189,212
False,8315047,Gundelfingen,10 - 15 Jahre,492,244,248
False,8315047,Gundelfingen,15 - 18 Jahre,328,170,158
False,8315047,Gundelfingen,18 - 20 Jahre,210,108,102
False,8315047,Gundelfingen,20 - 25 Jahre,610,286,324
False,8315047,Gundelfingen,25 - 30 Jahre,970,489,481
False,8315047,Gundelfingen,30 - 35 Jahre,1067,541,526
False,8315047,Gundelfingen,35 - 40 Jahre,897,468,429
False,8315047,Gundelfingen,40 - 45 Jahre,869,400,469
False,8315047,Gundelfingen,45 - 50 Jahre,768,355,413
False,8315047,Gundelfingen,50 - 55 Jahre,775,377,398
False,8315047,Gundelfingen,55 - 60 Jahre,786,395,391
False,8315047,Gundelfingen,60 - 65 Jahre,586,270,316
False,8315047,Gundelfingen,65 - 75 Jahre,872,377,495
False,8315047,Gundelfingen,75 und mehr Jahre,550,192,358
False,8315047,Gundelfingen,Insgesamt,10806,5196,5610
False,8315048,Hartheim,unter 3 Jahre,161,84,77
False,8315048,Hartheim,3 -  6 Jahre,184,97,87
False,8315048,Hartheim,6 - 10 Jahre,214,122,92
False,8315048,Hartheim,10 - 15 Jahre,261,126,135
False,8315048,Hartheim,15 - 18 Jahre,143,71,72
False,8315048,Hartheim,18 - 20 Jahre,99,55,44
False,8315048,Hartheim,20 - 25 Jahre,263,142,121
False,8315048,Hartheim,25 - 30 Jahre,371,182,189
False,8315048,Hartheim,30 - 35 Jahre,423,216,207
False,8315048,Hartheim,35 - 40 Jahre,364,194,170
False,8315048,Hartheim,40 - 45 Jahre,356,180,176
False,8315048,Hartheim,45 - 50 Jahre,266,150,116
False,8315048,Hartheim,50 - 55 Jahre,205,106,99
False,8315048,Hartheim,55 - 60 Jahre,217,123,94
False,8315048,Hartheim,60 - 65 Jahre,144,67,77
False,8315048,Hartheim,65 - 75 Jahre,216,101,115
False,8315048,Hartheim,75 und mehr Jahre,110,34,76
False,8315048,Hartheim,Insgesamt,3997,2050,1947
False,8315050,"Heitersheim, Stadt",unter 3 Jahre,205,109,96
False,8315050,"Heitersheim, Stadt",3 -  6 Jahre,202,103,99
False,8315050,"Heitersheim, Stadt",6 - 10 Jahre,247,139,108
False,8315050,"Heitersheim, Stadt",10 - 15 Jahre,323,155,168
False,8315050,"Heitersheim, Stadt",15 - 18 Jahre,179,97,82
False,8315050,"Heitersheim, Stadt",18 - 20 Jahre,107,53,54
False,8315050,"Heitersheim, Stadt",20 - 25 Jahre,284,139,145
False,8315050,"Heitersheim, Stadt",25 - 30 Jahre,481,246,235
False,8315050,"Heitersheim, Stadt",30 - 35 Jahre,455,227,228
False,8315050,"Heitersheim, Stadt",35 - 40 Jahre,445,232,213
False,8315050,"Heitersheim, Stadt",40 - 45 Jahre,356,190,166
False,8315050,"Heitersheim, Stadt",45 - 50 Jahre,314,146,168
False,8315050,"Heitersheim, Stadt",50 - 55 Jahre,289,145,144
False,8315050,"Heitersheim, Stadt",55 - 60 Jahre,318,171,147
False,8315050,"Heitersheim, Stadt",60 - 65 Jahre,240,114,126
False,8315050,"Heitersheim, Stadt",65 - 75 Jahre,379,162,217
False,8315050,"Heitersheim, Stadt",75 und mehr Jahre,317,67,250
False,8315050,"Heitersheim, Stadt",Insgesamt,5141,2495,2646
False,8315051,Heuweiler,unter 3 Jahre,30,18,12
False,8315051,Heuweiler,3 -  6 Jahre,40,19,21
False,8315051,Heuweiler,6 - 10 Jahre,57,22,35
False,8315051,Heuweiler,10 - 15 Jahre,48,26,22
False,8315051,Heuweiler,15 - 18 Jahre,30,13,17
False,8315051,Heuweiler,18 - 20 Jahre,24,11,13
False,8315051,Heuweiler,20 - 25 Jahre,67,32,35
False,8315051,Heuweiler,25 - 30 Jahre,103,56,47
False,8315051,Heuweiler,30 - 35 Jahre,99,46,53
False,8315051,Heuweiler,35 - 40 Jahre,82,31,51
False,8315051,Heuweiler,40 - 45 Jahre,81,46,35
False,8315051,Heuweiler,45 - 50 Jahre,61,38,23
False,8315051,Heuweiler,50 - 55 Jahre,46,22,24
False,8315051,Heuweiler,55 - 60 Jahre,56,26,30
False,8315051,Heuweiler,60 - 65 Jahre,43,21,22
False,8315051,Heuweiler,65 - 75 Jahre,82,38,44
False,8315051,Heuweiler,75 und mehr Jahre,48,16,32
False,8315051,Heuweiler,Insgesamt,997,481,516
False,8315052,Hinterzarten,unter 3 Jahre,74,44,30
False,8315052,Hinterzarten,3 -  6 Jahre,67,32,35
False,8315052,Hinterzarten,6 - 10 Jahre,90,43,47
False,8315052,Hinterzarten,10 - 15 Jahre,122,61,61
False,8315052,Hinterzarten,15 - 18 Jahre,70,39,31
False,8315052,Hinterzarten,18 - 20 Jahre,93,48,45
False,8315052,Hinterzarten,20 - 25 Jahre,256,102,154
False,8315052,Hinterzarten,25 - 30 Jahre,241,101,140
False,8315052,Hinterzarten,30 - 35 Jahre,206,102,104
False,8315052,Hinterzarten,35 - 40 Jahre,147,70,77
False,8315052,Hinterzarten,40 - 45 Jahre,118,43,75
False,8315052,Hinterzarten,45 - 50 Jahre,130,66,64
False,8315052,Hinterzarten,50 - 55 Jahre,145,61,84
False,8315052,Hinterzarten,55 - 60 Jahre,161,81,80
False,8315052,Hinterzarten,60 - 65 Jahre,131,63,68
False,8315052,Hinterzarten,65 - 75 Jahre,209,82,127
False,8315052,Hinterzarten,75 und mehr Jahre,194,68,126
False,8315052,Hinterzarten,Insgesamt,2454,1106,1348
False,8315056,Horben,unter 3 Jahre,32,17,15
False,8315056,Horben,3 -  6 Jahre,36,19,17
False,8315056,Horben,6 - 10 Jahre,41,18,23
False,8315056,Horben,10 - 15 Jahre,37,19,18
False,8315056,Horben,15 - 18 Jahre,21,13,8
False,8315056,Horben,18 - 20 Jahre,22,8,14
False,8315056,Horben,20 - 25 Jahre,57,29,28
False,8315056,Horben,25 - 30 Jahre,90,49,41
False,8315056,Horben,30 - 35 Jahre,87,46,41
False,8315056,Horben,35 - 40 Jahre,86,51,35
False,8315056,Horben,40 - 45 Jahre,58,31,27
False,8315056,Horben,45 - 50 Jahre,43,22,21
False,8315056,Horben,50 - 55 Jahre,58,27,31
False,8315056,Horben,55 - 60 Jahre,70,34,36
False,8315056,Horben,60 - 65 Jahre,57,24,33
False,8315056,Horben,65 - 75 Jahre,69,36,33
False,8315056,Horben,75 und mehr Jahre,33,11,22
False,8315056,Horben,Insgesamt,897,454,443
False,8315059,Ihringen,unter 3 Jahre,206,107,99
False,8315059,Ihringen,3 -  6 Jahre,224,112,112
False,8315059,Ihringen,6 - 10 Jahre,281,136,145
False,8315059,Ihringen,10 - 15 Jahre,322,166,156
False,8315059,Ihringen,15 - 18 Jahre,174,89,85
False,8315059,Ihringen,18 - 20 Jahre,111,58,53
False,8315059,Ihringen,20 - 25 Jahre,329,184,145
False,8315059,Ihringen,25 - 30 Jahre,504,239,265
False,8315059,Ihringen,30 - 35 Jahre,505,261,244
False,8315059,Ihringen,35 - 40 Jahre,510,272,238
False,8315059,Ihringen,40 - 45 Jahre,402,196,206
False,8315059,Ihringen,45 - 50 Jahre,309,145,164
False,8315059,Ihringen,50 - 55 Jahre,286,141,145
False,8315059,Ihringen,55 - 60 Jahre,376,181,195
False,8315059,Ihringen,60 - 65 Jahre,298,149,149
False,8315059,Ihringen,65 - 75 Jahre,492,205,287
False,8315059,Ihringen,75 und mehr Jahre,262,69,193
False,8315059,Ihringen,Insgesamt,5591,2710,2881
False,8315064,Kirchzarten,unter 3 Jahre,291,162,129
False,8315064,Kirchzarten,3 -  6 Jahre,315,163,152
False,8315064,Kirchzarten,6 - 10 Jahre,427,208,219
False,8315064,Kirchzarten,10 - 15 Jahre,520,278,242
False,8315064,Kirchzarten,15 - 18 Jahre,295,158,137
False,8315064,Kirchzarten,18 - 20 Jahre,224,117,107
False,8315064,Kirchzarten,20 - 25 Jahre,563,279,284
False,8315064,Kirchzarten,25 - 30 Jahre,741,355,386
False,8315064,Kirchzarten,30 - 35 Jahre,771,375,396
False,8315064,Kirchzarten,35 - 40 Jahre,767,378,389
False,8315064,Kirchzarten,40 - 45 Jahre,704,337,367
False,8315064,Kirchzarten,45 - 50 Jahre,563,268,295
False,8315064,Kirchzarten,50 - 55 Jahre,646,295,351
False,8315064,Kirchzarten,55 - 60 Jahre,680,340,340
False,8315064,Kirchzarten,60 - 65 Jahre,475,227,248
False,8315064,Kirchzarten,65 - 75 Jahre,786,305,481
False,8315064,Kirchzarten,75 und mehr Jahre,622,201,421
False,8315064,Kirchzarten,Insgesamt,9390,4446,4944
False,8315068,Lenzkirch,unter 3 Jahre,148,79,69
False,8315068,Lenzkirch,3 -  6 Jahre,151,84,67
False,8315068,Lenzkirch,6 - 10 Jahre,213,104,109
False,8315068,Lenzkirch,10 - 15 Jahre,274,149,125
False,8315068,Lenzkirch,15 - 18 Jahre,167,80,87
False,8315068,Lenzkirch,18 - 20 Jahre,122,59,63
False,8315068,Lenzkirch,20 - 25 Jahre,278,126,152
False,8315068,Lenzkirch,25 - 30 Jahre,458,191,267
False,8315068,Lenzkirch,30 - 35 Jahre,416,243,173
False,8315068,Lenzkirch,35 - 40 Jahre,349,184,165
False,8315068,Lenzkirch,40 - 45 Jahre,295,138,157
False,8315068,Lenzkirch,45 - 50 Jahre,292,157,135
False,8315068,Lenzkirch,50 - 55 Jahre,253,118,135
False,8315068,Lenzkirch,55 - 60 Jahre,351,169,182
False,8315068,Lenzkirch,60 - 65 Jahre,264,111,153
False,8315068,Lenzkirch,65 - 75 Jahre,502,225,277
False,8315068,Lenzkirch,75 und mehr Jahre,391,122,269
False,8315068,Lenzkirch,Insgesamt,4924,2339,2585
False,8315070,"Löffingen, Stadt",unter 3 Jahre,228,122,106
False,8315070,"Löffingen, Stadt",3 -  6 Jahre,250,137,113
False,8315070,"Löffingen, Stadt",6 - 10 Jahre,391,181,210
False,8315070,"Löffingen, Stadt",10 - 15 Jahre,454,248,206
False,8315070,"Löffingen, Stadt",15 - 18 Jahre,245,127,118
False,8315070,"Löffingen, Stadt",18 - 20 Jahre,160,81,79
False,8315070,"Löffingen, Stadt",20 - 25 Jahre,447,238,209
False,8315070,"Löffingen, Stadt",25 - 30 Jahre,629,336,293
False,8315070,"Löffingen, Stadt",30 - 35 Jahre,601,315,286
False,8315070,"Löffingen, Stadt",35 - 40 Jahre,569,289,280
False,8315070,"Löffingen, Stadt",40 - 45 Jahre,524,260,264
False,8315070,"Löffingen, Stadt",45 - 50 Jahre,413,218,195
False,8315070,"Löffingen, Stadt",50 - 55 Jahre,374,194,180
False,8315070,"Löffingen, Stadt",55 - 60 Jahre,456,223,233
False,8315070,"Löffingen, Stadt",60 - 65 Jahre,398,188,210
False,8315070,"Löffingen, Stadt",65 - 75 Jahre,651,308,343
False,8315070,"Löffingen, Stadt",75 und mehr Jahre,376,104,272
False,8315070,"Löffingen, Stadt",Insgesamt,7166,3569,3597
False,8315072,Merdingen,unter 3 Jahre,85,34,51
False,8315072,Merdingen,3 -  6 Jahre,90,48,42
False,8315072,Merdingen,6 - 10 Jahre,141,55,86
False,8315072,Merdingen,10 - 15 Jahre,143,77,66
False,8315072,Merdingen,15 - 18 Jahre,78,48,30
False,8315072,Merdingen,18 - 20 Jahre,57,23,34
False,8315072,Merdingen,20 - 25 Jahre,171,83,88
False,8315072,Merdingen,25 - 30 Jahre,219,114,105
False,8315072,Merdingen,30 - 35 Jahre,258,135,123
False,8315072,Merdingen,35 - 40 Jahre,218,113,105
False,8315072,Merdingen,40 - 45 Jahre,196,93,103
False,8315072,Merdingen,45 - 50 Jahre,154,78,76
False,8315072,Merdingen,50 - 55 Jahre,114,63,51
False,8315072,Merdingen,55 - 60 Jahre,161,86,75
False,8315072,Merdingen,60 - 65 Jahre,109,50,59
False,8315072,Merdingen,65 - 75 Jahre,161,72,89
False,8315072,Merdingen,75 und mehr Jahre,114,32,82
False,8315072,Merdingen,Insgesamt,2469,1204,1265
False,8315073,Merzhausen,unter 3 Jahre,127,71,56
False,8315073,Merzhausen,3 -  6 Jahre,121,57,64
False,8315073,Merzhausen,6 - 10 Jahre,139,70,69
False,8315073,Merzhausen,10 - 15 Jahre,235,99,136
False,8315073,Merzhausen,15 - 18 Jahre,163,83,80
False,8315073,Merzhausen,18 - 20 Jahre,115,46,69
False,8315073,Merzhausen,20 - 25 Jahre,345,170,175
False,8315073,Merzhausen,25 - 30 Jahre,363,183,180
False,8315073,Merzhausen,30 - 35 Jahre,420,201,219
False,8315073,Merzhausen,35 - 40 Jahre,300,157,143
False,8315073,Merzhausen,40 - 45 Jahre,297,122,175
False,8315073,Merzhausen,45 - 50 Jahre,330,146,184
False,8315073,Merzhausen,50 - 55 Jahre,393,183,210
False,8315073,Merzhausen,55 - 60 Jahre,380,165,215
False,8315073,Merzhausen,60 - 65 Jahre,230,125,105
False,8315073,Merzhausen,65 - 75 Jahre,403,180,223
False,8315073,Merzhausen,75 und mehr Jahre,299,95,204
False,8315073,Merzhausen,Insgesamt,4660,2153,2507
False,8315074,"Müllheim, Stadt",unter 3 Jahre,585,297,288
False,8315074,"Müllheim, Stadt",3 -  6 Jahre,602,324,278
False,8315074,"Müllheim, Stadt",6 - 10 Jahre,859,427,432
False,8315074,"Müllheim, Stadt",10 - 15 Jahre,970,461,509
False,8315074,"Müllheim, Stadt",15 - 18 Jahre,536,259,277
False,8315074,"Müllheim, Stadt",18 - 20 Jahre,339,156,183
False,8315074,"Müllheim, Stadt",20 - 25 Jahre,965,485,480
False,8315074,"Müllheim, Stadt",25 - 30 Jahre,1240,614,626
False,8315074,"Müllheim, Stadt",30 - 35 Jahre,1399,694,705
False,8315074,"Müllheim, Stadt",35 - 40 Jahre,1263,618,645
False,8315074,"Müllheim, Stadt",40 - 45 Jahre,1136,547,589
False,8315074,"Müllheim, Stadt",45 - 50 Jahre,959,471,488
False,8315074,"Müllheim, Stadt",50 - 55 Jahre,951,484,467
False,8315074,"Müllheim, Stadt",55 - 60 Jahre,1058,488,570
False,8315074,"Müllheim, Stadt",60 - 65 Jahre,821,380,441
False,8315074,"Müllheim, Stadt",65 - 75 Jahre,1490,598,892
False,8315074,"Müllheim, Stadt",75 und mehr Jahre,1288,394,894
False,8315074,"Müllheim, Stadt",Insgesamt,16461,7697,8764
False,8315076,"Neuenburg am Rhein, Stadt",unter 3 Jahre,424,221,203
False,8315076,"Neuenburg am Rhein, Stadt",3 -  6 Jahre,450,214,236
False,8315076,"Neuenburg am Rhein, Stadt",6 - 10 Jahre,520,261,259
False,8315076,"Neuenburg am Rhein, Stadt",10 - 15 Jahre,618,320,298
False,8315076,"Neuenburg am Rhein, Stadt",15 - 18 Jahre,370,173,197
False,8315076,"Neuenburg am Rhein, Stadt",18 - 20 Jahre,200,94,106
False,8315076,"Neuenburg am Rhein, Stadt",20 - 25 Jahre,643,311,332
False,8315076,"Neuenburg am Rhein, Stadt",25 - 30 Jahre,895,458,437
False,8315076,"Neuenburg am Rhein, Stadt",30 - 35 Jahre,1007,516,491
False,8315076,"Neuenburg am Rhein, Stadt",35 - 40 Jahre,891,458,433
False,8315076,"Neuenburg am Rhein, Stadt",40 - 45 Jahre,765,399,366
False,8315076,"Neuenburg am Rhein, Stadt",45 - 50 Jahre,654,337,317
False,8315076,"Neuenburg am Rhein, Stadt",50 - 55 Jahre,577,297,280
False,8315076,"Neuenburg am Rhein, Stadt",55 - 60 Jahre,630,314,316
False,8315076,"Neuenburg am Rhein, Stadt",60 - 65 Jahre,437,210,227
False,8315076,"Neuenburg am Rhein, Stadt",65 - 75 Jahre,710,325,385
False,8315076,"Neuenburg am Rhein, Stadt",75 und mehr Jahre,381,137,244
False,8315076,"Neuenburg am Rhein, Stadt",Insgesamt,10172,5045,5127
False,8315084,Oberried,unter 3 Jahre,111,57,54
False,8315084,Oberried,3 -  6 Jahre,89,46,43
False,8315084,Oberried,6 - 10 Jahre,127,59,68
False,8315084,Oberried,10 - 15 Jahre,145,68,77
False,8315084,Oberried,15 - 18 Jahre,74,45,29
False,8315084,Oberried,18 - 20 Jahre,66,38,28
False,8315084,Oberried,20 - 25 Jahre,178,93,85
False,8315084,Oberried,25 - 30 Jahre,267,130,137
False,8315084,Oberried,30 - 35 Jahre,253,133,120
False,8315084,Oberried,35 - 40 Jahre,193,104,89
False,8315084,Oberried,40 - 45 Jahre,172,88,84
False,8315084,Oberried,45 - 50 Jahre,157,78,79
False,8315084,Oberried,50 - 55 Jahre,162,78,84
False,8315084,Oberried,55 - 60 Jahre,198,99,99
False,8315084,Oberried,60 - 65 Jahre,118,63,55
False,8315084,Oberried,65 - 75 Jahre,201,99,102
False,8315084,Oberried,75 und mehr Jahre,100,36,64
False,8315084,Oberried,Insgesamt,2611,1314,1297
False,8315089,Pfaffenweiler,unter 3 Jahre,83,44,39
False,8315089,Pfaffenweiler,3 -  6 Jahre,96,53,43
False,8315089,Pfaffenweiler,6 - 10 Jahre,138,66,72
False,8315089,Pfaffenweiler,10 - 15 Jahre,152,71,81
False,8315089,Pfaffenweiler,15 - 18 Jahre,92,52,40
False,8315089,Pfaffenweiler,18 - 20 Jahre,66,33,33
False,8315089,Pfaffenweiler,20 - 25 Jahre,149,68,81
False,8315089,Pfaffenweiler,25 - 30 Jahre,246,130,116
False,8315089,Pfaffenweiler,30 - 35 Jahre,234,124,110
False,8315089,Pfaffenweiler,35 - 40 Jahre,199,93,106
False,8315089,Pfaffenweiler,40 - 45 Jahre,210,106,104
False,8315089,Pfaffenweiler,45 - 50 Jahre,186,100,86
False,8315089,Pfaffenweiler,50 - 55 Jahre,193,96,97
False,8315089,Pfaffenweiler,55 - 60 Jahre,188,91,97
False,8315089,Pfaffenweiler,60 - 65 Jahre,110,56,54
False,8315089,Pfaffenweiler,65 - 75 Jahre,171,84,87
False,8315089,Pfaffenweiler,75 und mehr Jahre,102,32,70
False,8315089,Pfaffenweiler,Insgesamt,2615,1299,1316
False,8315094,St. Märgen,unter 3 Jahre,88,48,40
False,8315094,St. Märgen,3 -  6 Jahre,88,45,43
False,8315094,St. Märgen,6 - 10 Jahre,106,57,49
False,8315094,St. Märgen,10 - 15 Jahre,113,59,54
False,8315094,St. Märgen,15 - 18 Jahre,58,24,34
False,8315094,St. Märgen,18 - 20 Jahre,52,27,25
False,8315094,St. Märgen,20 - 25 Jahre,122,74,48
False,8315094,St. Märgen,25 - 30 Jahre,166,88,78
False,8315094,St. Märgen,30 - 35 Jahre,162,85,77
False,8315094,St. Märgen,35 - 40 Jahre,143,76,67
False,8315094,St. Märgen,40 - 45 Jahre,118,67,51
False,8315094,St. Märgen,45 - 50 Jahre,99,48,51
False,8315094,St. Märgen,50 - 55 Jahre,85,46,39
False,8315094,St. Märgen,55 - 60 Jahre,111,58,53
False,8315094,St. Märgen,60 - 65 Jahre,78,36,42
False,8315094,St. Märgen,65 - 75 Jahre,178,78,100
False,8315094,St. Märgen,75 und mehr Jahre,118,39,79
False,8315094,St. Märgen,Insgesamt,1885,955,930
False,8315095,St. Peter,unter 3 Jahre,101,55,46
False,8315095,St. Peter,3 -  6 Jahre,94,66,28
False,8315095,St. Peter,6 - 10 Jahre,138,71,67
False,8315095,St. Peter,10 - 15 Jahre,140,73,67
False,8315095,St. Peter,15 - 18 Jahre,79,38,41
False,8315095,St. Peter,18 - 20 Jahre,50,23,27
False,8315095,St. Peter,20 - 25 Jahre,159,72,87
False,8315095,St. Peter,25 - 30 Jahre,196,102,94
False,8315095,St. Peter,30 - 35 Jahre,240,139,101
False,8315095,St. Peter,35 - 40 Jahre,189,108,81
False,8315095,St. Peter,40 - 45 Jahre,134,73,61
False,8315095,St. Peter,45 - 50 Jahre,121,62,59
False,8315095,St. Peter,50 - 55 Jahre,123,58,65
False,8315095,St. Peter,55 - 60 Jahre,145,67,78
False,8315095,St. Peter,60 - 65 Jahre,137,75,62
False,8315095,St. Peter,65 - 75 Jahre,201,89,112
False,8315095,St. Peter,75 und mehr Jahre,115,40,75
False,8315095,St. Peter,Insgesamt,2362,1211,1151
False,8315098,Schallstadt,unter 3 Jahre,196,98,98
False,8315098,Schallstadt,3 -  6 Jahre,226,111,115
False,8315098,Schallstadt,6 - 10 Jahre,289,128,161
False,8315098,Schallstadt,10 - 15 Jahre,334,162,172
False,8315098,Schallstadt,15 - 18 Jahre,175,75,100
False,8315098,Schallstadt,18 - 20 Jahre,118,58,60
False,8315098,Schallstadt,20 - 25 Jahre,344,176,168
False,8315098,Schallstadt,25 - 30 Jahre,465,225,240
False,8315098,Schallstadt,30 - 35 Jahre,510,248,262
False,8315098,Schallstadt,35 - 40 Jahre,492,240,252
False,8315098,Schallstadt,40 - 45 Jahre,463,227,236
False,8315098,Schallstadt,45 - 50 Jahre,412,197,215
False,8315098,Schallstadt,50 - 55 Jahre,350,196,154
False,8315098,Schallstadt,55 - 60 Jahre,417,211,206
False,8315098,Schallstadt,60 - 65 Jahre,234,129,105
False,8315098,Schallstadt,65 - 75 Jahre,408,180,228
False,8315098,Schallstadt,75 und mehr Jahre,206,70,136
False,8315098,Schallstadt,Insgesamt,5639,2731,2908
False,8315102,Schluchsee,unter 3 Jahre,79,37,42
False,8315102,Schluchsee,3 -  6 Jahre,79,41,38
False,8315102,Schluchsee,6 - 10 Jahre,87,47,40
False,8315102,Schluchsee,10 - 15 Jahre,130,60,70
False,8315102,Schluchsee,15 - 18 Jahre,76,40,36
False,8315102,Schluchsee,18 - 20 Jahre,70,31,39
False,8315102,Schluchsee,20 - 25 Jahre,204,102,102
False,8315102,Schluchsee,25 - 30 Jahre,271,120,151
False,8315102,Schluchsee,30 - 35 Jahre,215,114,101
False,8315102,Schluchsee,35 - 40 Jahre,176,99,77
False,8315102,Schluchsee,40 - 45 Jahre,161,77,84
False,8315102,Schluchsee,45 - 50 Jahre,154,79,75
False,8315102,Schluchsee,50 - 55 Jahre,134,68,66
False,8315102,Schluchsee,55 - 60 Jahre,178,87,91
False,8315102,Schluchsee,60 - 65 Jahre,123,54,69
False,8315102,Schluchsee,65 - 75 Jahre,246,100,146
False,8315102,Schluchsee,75 und mehr Jahre,170,62,108
False,8315102,Schluchsee,Insgesamt,2553,1218,1335
False,8315107,Sölden,unter 3 Jahre,26,11,15
False,8315107,Sölden,3 -  6 Jahre,41,26,15
False,8315107,Sölden,6 - 10 Jahre,72,40,32
False,8315107,Sölden,10 - 15 Jahre,75,40,35
False,8315107,Sölden,15 - 18 Jahre,40,19,21
False,8315107,Sölden,18 - 20 Jahre,17,10,7
False,8315107,Sölden,20 - 25 Jahre,77,37,40
False,8315107,Sölden,25 - 30 Jahre,48,34,14
False,8315107,Sölden,30 - 35 Jahre,86,38,48
False,8315107,Sölden,35 - 40 Jahre,127,55,72
False,8315107,Sölden,40 - 45 Jahre,109,57,52
False,8315107,Sölden,45 - 50 Jahre,82,45,37
False,8315107,Sölden,50 - 55 Jahre,77,36,41
False,8315107,Sölden,55 - 60 Jahre,54,28,26
False,8315107,Sölden,60 - 65 Jahre,46,27,19
False,8315107,Sölden,65 - 75 Jahre,81,37,44
False,8315107,Sölden,75 und mehr Jahre,30,10,20
False,8315107,Sölden,Insgesamt,1088,550,538
False,8315108,"Staufen im Breisgau, Stadt",unter 3 Jahre,204,101,103
False,8315108,"Staufen im Breisgau, Stadt",3 -  6 Jahre,226,118,108
False,8315108,"Staufen im Breisgau, Stadt",6 - 10 Jahre,336,170,166
False,8315108,"Staufen im Breisgau, Stadt",10 - 15 Jahre,350,166,184
False,8315108,"Staufen im Breisgau, Stadt",15 - 18 Jahre,220,136,84
False,8315108,"Staufen im Breisgau, Stadt",18 - 20 Jahre,170,91,79
False,8315108,"Staufen im Breisgau, Stadt",20 - 25 Jahre,380,206,174
False,8315108,"Staufen im Breisgau, Stadt",25 - 30 Jahre,595,281,314
False,8315108,"Staufen im Breisgau, Stadt",30 - 35 Jahre,626,290,336
False,8315108,"Staufen im Breisgau, Stadt",35 - 40 Jahre,548,256,292
False,8315108,"Staufen im Breisgau, Stadt",40 - 45 Jahre,522,262,260
False,8315108,"Staufen im Breisgau, Stadt",45 - 50 Jahre,512,259,253
False,8315108,"Staufen im Breisgau, Stadt",50 - 55 Jahre,489,255,234
False,8315108,"Staufen im Breisgau, Stadt",55 - 60 Jahre,492,227,265
False,8315108,"Staufen im Breisgau, Stadt",60 - 65 Jahre,328,171,157
False,8315108,"Staufen im Breisgau, Stadt",65 - 75 Jahre,657,249,408
False,8315108,"Staufen im Breisgau, Stadt",75 und mehr Jahre,582,177,405
False,8315108,"Staufen im Breisgau, Stadt",Insgesamt,7237,3415,3822
False,8315109,Stegen,unter 3 Jahre,160,86,74
False,8315109,Stegen,3 -  6 Jahre,169,85,84
False,8315109,Stegen,6 - 10 Jahre,241,116,125
False,8315109,Stegen,10 - 15 Jahre,316,187,129
False,8315109,Stegen,15 - 18 Jahre,160,81,79
False,8315109,Stegen,18 - 20 Jahre,103,51,52
False,8315109,Stegen,20 - 25 Jahre,254,135,119
False,8315109,Stegen,25 - 30 Jahre,311,159,152
False,8315109,Stegen,30 - 35 Jahre,346,162,184
False,8315109,Stegen,35 - 40 Jahre,320,162,158
False,8315109,Stegen,40 - 45 Jahre,279,134,145
False,8315109,Stegen,45 - 50 Jahre,237,117,120
False,8315109,Stegen,50 - 55 Jahre,207,100,107
False,8315109,Stegen,55 - 60 Jahre,360,166,194
False,8315109,Stegen,60 - 65 Jahre,212,105,107
False,8315109,Stegen,65 - 75 Jahre,285,141,144
False,8315109,Stegen,75 und mehr Jahre,193,67,126
False,8315109,Stegen,Insgesamt,4153,2054,2099
False,8315111,"Sulzburg, Stadt",unter 3 Jahre,88,49,39
False,8315111,"Sulzburg, Stadt",3 -  6 Jahre,122,65,57
False,8315111,"Sulzburg, Stadt",6 - 10 Jahre,120,47,73
False,8315111,"Sulzburg, Stadt",10 - 15 Jahre,169,81,88
False,8315111,"Sulzburg, Stadt",15 - 18 Jahre,87,44,43
False,8315111,"Sulzburg, Stadt",18 - 20 Jahre,57,28,29
False,8315111,"Sulzburg, Stadt",20 - 25 Jahre,131,66,65
False,8315111,"Sulzburg, Stadt",25 - 30 Jahre,207,92,115
False,8315111,"Sulzburg, Stadt",30 - 35 Jahre,204,102,102
False,8315111,"Sulzburg, Stadt",35 - 40 Jahre,212,106,106
False,8315111,"Sulzburg, Stadt",40 - 45 Jahre,193,99,94
False,8315111,"Sulzburg, Stadt",45 - 50 Jahre,150,64,86
False,8315111,"Sulzburg, Stadt",50 - 55 Jahre,144,65,79
False,8315111,"Sulzburg, Stadt",55 - 60 Jahre,175,92,83
False,8315111,"Sulzburg, Stadt",60 - 65 Jahre,128,63,65
False,8315111,"Sulzburg, Stadt",65 - 75 Jahre,233,95,138
False,8315111,"Sulzburg, Stadt",75 und mehr Jahre,165,64,101
False,8315111,"Sulzburg, Stadt",Insgesamt,2585,1222,1363
False,8315113,"Titisee-Neustadt, Stadt",unter 3 Jahre,394,212,182
False,8315113,"Titisee-Neustadt, Stadt",3 -  6 Jahre,393,183,210
False,8315113,"Titisee-Neustadt, Stadt",6 - 10 Jahre,505,262,243
False,8315113,"Titisee-Neustadt, Stadt",10 - 15 Jahre,647,332,315
False,8315113,"Titisee-Neustadt, Stadt",15 - 18 Jahre,428,221,207
False,8315113,"Titisee-Neustadt, Stadt",18 - 20 Jahre,313,153,160
False,8315113,"Titisee-Neustadt, Stadt",20 - 25 Jahre,875,435,440
False,8315113,"Titisee-Neustadt, Stadt",25 - 30 Jahre,1042,526,516
False,8315113,"Titisee-Neustadt, Stadt",30 - 35 Jahre,947,464,483
False,8315113,"Titisee-Neustadt, Stadt",35 - 40 Jahre,880,447,433
False,8315113,"Titisee-Neustadt, Stadt",40 - 45 Jahre,835,433,402
False,8315113,"Titisee-Neustadt, Stadt",45 - 50 Jahre,715,365,350
False,8315113,"Titisee-Neustadt, Stadt",50 - 55 Jahre,600,292,308
False,8315113,"Titisee-Neustadt, Stadt",55 - 60 Jahre,782,369,413
False,8315113,"Titisee-Neustadt, Stadt",60 - 65 Jahre,594,281,313
False,8315113,"Titisee-Neustadt, Stadt",65 - 75 Jahre,1244,527,717
False,8315113,"Titisee-Neustadt, Stadt",75 und mehr Jahre,989,305,684
False,8315113,"Titisee-Neustadt, Stadt",Insgesamt,12183,5807,6376
False,8315115,Umkirch,unter 3 Jahre,174,93,81
False,8315115,Umkirch,3 -  6 Jahre,164,81,83
False,8315115,Umkirch,6 - 10 Jahre,262,148,114
False,8315115,Umkirch,10 - 15 Jahre,301,161,140
False,8315115,Umkirch,15 - 18 Jahre,173,93,80
False,8315115,Umkirch,18 - 20 Jahre,120,55,65
False,8315115,Umkirch,20 - 25 Jahre,269,129,140
False,8315115,Umkirch,25 - 30 Jahre,386,185,201
False,8315115,Umkirch,30 - 35 Jahre,488,253,235
False,8315115,Umkirch,35 - 40 Jahre,410,206,204
False,8315115,Umkirch,40 - 45 Jahre,419,202,217
False,8315115,Umkirch,45 - 50 Jahre,372,187,185
False,8315115,Umkirch,50 - 55 Jahre,347,165,182
False,8315115,Umkirch,55 - 60 Jahre,385,193,192
False,8315115,Umkirch,60 - 65 Jahre,227,116,111
False,8315115,Umkirch,65 - 75 Jahre,276,118,158
False,8315115,Umkirch,75 und mehr Jahre,177,51,126
False,8315115,Umkirch,Insgesamt,4950,2436,2514
False,8315125,Wittnau,unter 3 Jahre,37,22,15
False,8315125,Wittnau,3 -  6 Jahre,47,20,27
False,8315125,Wittnau,6 - 10 Jahre,67,37,30
False,8315125,Wittnau,10 - 15 Jahre,70,35,35
False,8315125,Wittnau,15 - 18 Jahre,40,18,22
False,8315125,Wittnau,18 - 20 Jahre,37,22,15
False,8315125,Wittnau,20 - 25 Jahre,86,52,34
False,8315125,Wittnau,25 - 30 Jahre,103,46,57
False,8315125,Wittnau,30 - 35 Jahre,92,51,41
False,8315125,Wittnau,35 - 40 Jahre,109,58,51
False,8315125,Wittnau,40 - 45 Jahre,97,46,51
False,8315125,Wittnau,45 - 50 Jahre,82,35,47
False,8315125,Wittnau,50 - 55 Jahre,97,49,48
False,8315125,Wittnau,55 - 60 Jahre,82,49,33
False,8315125,Wittnau,60 - 65 Jahre,58,30,28
False,8315125,Wittnau,65 - 75 Jahre,102,48,54
False,8315125,Wittnau,75 und mehr Jahre,50,19,31
False,8315125,Wittnau,Insgesamt,1256,637,619
False,8315130,Münstertal/Schwarzwald,unter 3 Jahre,215,113,102
False,8315130,Münstertal/Schwarzwald,3 -  6 Jahre,212,104,108
False,8315130,Münstertal/Schwarzwald,6 - 10 Jahre,221,119,102
False,8315130,Münstertal/Schwarzwald,10 - 15 Jahre,266,155,111
False,8315130,Münstertal/Schwarzwald,15 - 18 Jahre,145,83,62
False,8315130,Münstertal/Schwarzwald,18 - 20 Jahre,95,53,42
False,8315130,Münstertal/Schwarzwald,20 - 25 Jahre,295,135,160
False,8315130,Münstertal/Schwarzwald,25 - 30 Jahre,438,215,223
False,8315130,Münstertal/Schwarzwald,30 - 35 Jahre,512,282,230
False,8315130,Münstertal/Schwarzwald,35 - 40 Jahre,356,184,172
False,8315130,Münstertal/Schwarzwald,40 - 45 Jahre,334,172,162
False,8315130,Münstertal/Schwarzwald,45 - 50 Jahre,245,140,105
False,8315130,Münstertal/Schwarzwald,50 - 55 Jahre,245,108,137
False,8315130,Münstertal/Schwarzwald,55 - 60 Jahre,395,203,192
False,8315130,Münstertal/Schwarzwald,60 - 65 Jahre,275,124,151
False,8315130,Münstertal/Schwarzwald,65 - 75 Jahre,456,191,265
False,8315130,Münstertal/Schwarzwald,75 und mehr Jahre,353,111,242
False,8315130,Münstertal/Schwarzwald,Insgesamt,5058,2492,2566
False,8315131,Ehrenkirchen,unter 3 Jahre,245,112,133
False,8315131,Ehrenkirchen,3 -  6 Jahre,248,144,104
False,8315131,Ehrenkirchen,6 - 10 Jahre,318,161,157
False,8315131,Ehrenkirchen,10 - 15 Jahre,316,150,166
False,8315131,Ehrenkirchen,15 - 18 Jahre,171,99,72
False,8315131,Ehrenkirchen,18 - 20 Jahre,108,59,49
False,8315131,Ehrenkirchen,20 - 25 Jahre,333,163,170
False,8315131,Ehrenkirchen,25 - 30 Jahre,559,287,272
False,8315131,Ehrenkirchen,30 - 35 Jahre,644,333,311
False,8315131,Ehrenkirchen,35 - 40 Jahre,562,290,272
False,8315131,Ehrenkirchen,40 - 45 Jahre,408,198,210
False,8315131,Ehrenkirchen,45 - 50 Jahre,368,198,170
False,8315131,Ehrenkirchen,50 - 55 Jahre,383,184,199
False,8315131,Ehrenkirchen,55 - 60 Jahre,422,225,197
False,8315131,Ehrenkirchen,60 - 65 Jahre,300,152,148
False,8315131,Ehrenkirchen,65 - 75 Jahre,521,239,282
False,8315131,Ehrenkirchen,75 und mehr Jahre,280,89,191
False,8315131,Ehrenkirchen,Insgesamt,6186,3083,3103
False,8315132,March,unter 3 Jahre,290,156,134
False,8315132,March,3 -  6 Jahre,326,165,161
False,8315132,March,6 - 10 Jahre,461,233,228
False,8315132,March,10 - 15 Jahre,477,234,243
False,8315132,March,15 - 18 Jahre,259,125,134
False,8315132,March,18 - 20 Jahre,146,74,72
False,8315132,March,20 - 25 Jahre,481,239,242
False,8315132,March,25 - 30 Jahre,699,358,341
False,8315132,March,30 - 35 Jahre,863,444,419
False,8315132,March,35 - 40 Jahre,778,387,391
False,8315132,March,40 - 45 Jahre,720,360,360
False,8315132,March,45 - 50 Jahre,540,279,261
False,8315132,March,50 - 55 Jahre,521,247,274
False,8315132,March,55 - 60 Jahre,549,292,257
False,8315132,March,60 - 65 Jahre,346,183,163
False,8315132,March,65 - 75 Jahre,562,241,321
False,8315132,March,75 und mehr Jahre,336,107,229
False,8315132,March,Insgesamt,8354,4124,4230
False,8315133,"Vogtsburg im Kaiserstuhl, Stadt",unter 3 Jahre,204,123,81
False,8315133,"Vogtsburg im Kaiserstuhl, Stadt",3 -  6 Jahre,219,115,104
False,8315133,"Vogtsburg im Kaiserstuhl, Stadt",6 - 10 Jahre,286,139,147
False,8315133,"Vogtsburg im Kaiserstuhl, Stadt",10 - 15 Jahre,345,182,163
False,8315133,"Vogtsburg im Kaiserstuhl, Stadt",15 - 18 Jahre,188,98,90
False,8315133,"Vogtsburg im Kaiserstuhl, Stadt",18 - 20 Jahre,112,67,45
False,8315133,"Vogtsburg im Kaiserstuhl, Stadt",20 - 25 Jahre,305,173,132
False,8315133,"Vogtsburg im Kaiserstuhl, Stadt",25 - 30 Jahre,469,238,231
False,8315133,"Vogtsburg im Kaiserstuhl, Stadt",30 - 35 Jahre,497,261,236
False,8315133,"Vogtsburg im Kaiserstuhl, Stadt",35 - 40 Jahre,407,192,215
False,8315133,"Vogtsburg im Kaiserstuhl, Stadt",40 - 45 Jahre,392,202,190
False,8315133,"Vogtsburg im Kaiserstuhl, Stadt",45 - 50 Jahre,354,193,161
False,8315133,"Vogtsburg im Kaiserstuhl, Stadt",50 - 55 Jahre,292,146,146
False,8315133,"Vogtsburg im Kaiserstuhl, Stadt",55 - 60 Jahre,403,198,205
False,8315133,"Vogtsburg im Kaiserstuhl, Stadt",60 - 65 Jahre,325,170,155
False,8315133,"Vogtsburg im Kaiserstuhl, Stadt",65 - 75 Jahre,474,182,292
False,8315133,"Vogtsburg im Kaiserstuhl, Stadt",75 und mehr Jahre,320,102,218
False,8315133,"Vogtsburg im Kaiserstuhl, Stadt",Insgesamt,5592,2781,2811
False,8316,Landkreis Emmendingen,unter 3 Jahre,5063,2586,2477
False,8316,Landkreis Emmendingen,3 -  6 Jahre,5360,2687,2673
False,8316,Landkreis Emmendingen,6 - 10 Jahre,7271,3771,3500
False,8316,Landkreis Emmendingen,10 - 15 Jahre,8607,4448,4159
False,8316,Landkreis Emmendingen,15 - 18 Jahre,4787,2446,2341
False,8316,Landkreis Emmendingen,18 - 20 Jahre,3070,1558,1512
False,8316,Landkreis Emmendingen,20 - 25 Jahre,8547,4371,4176
False,8316,Landkreis Emmendingen,25 - 30 Jahre,12018,6256,5762
False,8316,Landkreis Emmendingen,30 - 35 Jahre,13083,6686,6397
False,8316,Landkreis Emmendingen,35 - 40 Jahre,12011,6044,5967
False,8316,Landkreis Emmendingen,40 - 45 Jahre,10678,5429,5249
False,8316,Landkreis Emmendingen,45 - 50 Jahre,9053,4639,4414
False,8316,Landkreis Emmendingen,50 - 55 Jahre,8367,4130,4237
False,8316,Landkreis Emmendingen,55 - 60 Jahre,10101,5088,5013
False,8316,Landkreis Emmendingen,60 - 65 Jahre,7504,3684,3820
False,8316,Landkreis Emmendingen,65 - 75 Jahre,12387,5203,7184
False,8316,Landkreis Emmendingen,75 und mehr Jahre,8511,2498,6013
False,8316,Landkreis Emmendingen,Insgesamt,146418,71524,74894
False,8316002,Bahlingen am Kaiserstuhl,unter 3 Jahre,102,49,53
False,8316002,Bahlingen am Kaiserstuhl,3 -  6 Jahre,142,72,70
False,8316002,Bahlingen am Kaiserstuhl,6 - 10 Jahre,200,94,106
False,8316002,Bahlingen am Kaiserstuhl,10 - 15 Jahre,212,116,96
False,8316002,Bahlingen am Kaiserstuhl,15 - 18 Jahre,153,76,77
False,8316002,Bahlingen am Kaiserstuhl,18 - 20 Jahre,82,39,43
False,8316002,Bahlingen am Kaiserstuhl,20 - 25 Jahre,174,95,79
False,8316002,Bahlingen am Kaiserstuhl,25 - 30 Jahre,242,129,113
False,8316002,Bahlingen am Kaiserstuhl,30 - 35 Jahre,321,160,161
False,8316002,Bahlingen am Kaiserstuhl,35 - 40 Jahre,326,148,178
False,8316002,Bahlingen am Kaiserstuhl,40 - 45 Jahre,294,148,146
False,8316002,Bahlingen am Kaiserstuhl,45 - 50 Jahre,212,128,84
False,8316002,Bahlingen am Kaiserstuhl,50 - 55 Jahre,164,86,78
False,8316002,Bahlingen am Kaiserstuhl,55 - 60 Jahre,219,112,107
False,8316002,Bahlingen am Kaiserstuhl,60 - 65 Jahre,177,86,91
False,8316002,Bahlingen am Kaiserstuhl,65 - 75 Jahre,302,136,166
False,8316002,Bahlingen am Kaiserstuhl,75 und mehr Jahre,154,43,111
False,8316002,Bahlingen am Kaiserstuhl,Insgesamt,3476,1717,1759
False,8316003,Biederbach,unter 3 Jahre,64,29,35
False,8316003,Biederbach,3 -  6 Jahre,72,37,35
False,8316003,Biederbach,6 - 10 Jahre,83,45,38
False,8316003,Biederbach,10 - 15 Jahre,103,52,51
False,8316003,Biederbach,15 - 18 Jahre,50,25,25
False,8316003,Biederbach,18 - 20 Jahre,44,20,24
False,8316003,Biederbach,20 - 25 Jahre,128,67,61
False,8316003,Biederbach,25 - 30 Jahre,141,74,67
False,8316003,Biederbach,30 - 35 Jahre,142,81,61
False,8316003,Biederbach,35 - 40 Jahre,118,68,50
False,8316003,Biederbach,40 - 45 Jahre,97,45,52
False,8316003,Biederbach,45 - 50 Jahre,79,42,37
False,8316003,Biederbach,50 - 55 Jahre,71,38,33
False,8316003,Biederbach,55 - 60 Jahre,100,55,45
False,8316003,Biederbach,60 - 65 Jahre,69,35,34
False,8316003,Biederbach,65 - 75 Jahre,142,59,83
False,8316003,Biederbach,75 und mehr Jahre,87,39,48
False,8316003,Biederbach,Insgesamt,1590,811,779
False,8316009,Denzlingen,unter 3 Jahre,389,202,187
False,8316009,Denzlingen,3 -  6 Jahre,410,201,209
False,8316009,Denzlingen,6 - 10 Jahre,538,277,261
False,8316009,Denzlingen,10 - 15 Jahre,658,377,281
False,8316009,Denzlingen,15 - 18 Jahre,381,191,190
False,8316009,Denzlingen,18 - 20 Jahre,238,125,113
False,8316009,Denzlingen,20 - 25 Jahre,700,355,345
False,8316009,Denzlingen,25 - 30 Jahre,1005,517,488
False,8316009,Denzlingen,30 - 35 Jahre,1106,542,564
False,8316009,Denzlingen,35 - 40 Jahre,968,462,506
False,8316009,Denzlingen,40 - 45 Jahre,906,436,470
False,8316009,Denzlingen,45 - 50 Jahre,900,432,468
False,8316009,Denzlingen,50 - 55 Jahre,876,422,454
False,8316009,Denzlingen,55 - 60 Jahre,873,418,455
False,8316009,Denzlingen,60 - 65 Jahre,561,278,283
False,8316009,Denzlingen,65 - 75 Jahre,1018,433,585
False,8316009,Denzlingen,75 und mehr Jahre,776,277,499
False,8316009,Denzlingen,Insgesamt,12303,5945,6358
False,8316010,"Elzach, Stadt",unter 3 Jahre,251,112,139
False,8316010,"Elzach, Stadt",3 -  6 Jahre,256,125,131
False,8316010,"Elzach, Stadt",6 - 10 Jahre,369,181,188
False,8316010,"Elzach, Stadt",10 - 15 Jahre,392,212,180
False,8316010,"Elzach, Stadt",15 - 18 Jahre,224,104,120
False,8316010,"Elzach, Stadt",18 - 20 Jahre,149,78,71
False,8316010,"Elzach, Stadt",20 - 25 Jahre,429,231,198
False,8316010,"Elzach, Stadt",25 - 30 Jahre,547,288,259
False,8316010,"Elzach, Stadt",30 - 35 Jahre,600,327,273
False,8316010,"Elzach, Stadt",35 - 40 Jahre,524,289,235
False,8316010,"Elzach, Stadt",40 - 45 Jahre,471,251,220
False,8316010,"Elzach, Stadt",45 - 50 Jahre,357,178,179
False,8316010,"Elzach, Stadt",50 - 55 Jahre,305,159,146
False,8316010,"Elzach, Stadt",55 - 60 Jahre,469,246,223
False,8316010,"Elzach, Stadt",60 - 65 Jahre,389,196,193
False,8316010,"Elzach, Stadt",65 - 75 Jahre,609,251,358
False,8316010,"Elzach, Stadt",75 und mehr Jahre,387,125,262
False,8316010,"Elzach, Stadt",Insgesamt,6728,3353,3375
False,8316011,"Emmendingen, Stadt",unter 3 Jahre,818,421,397
False,8316011,"Emmendingen, Stadt",3 -  6 Jahre,850,424,426
False,8316011,"Emmendingen, Stadt",6 - 10 Jahre,1096,574,522
False,8316011,"Emmendingen, Stadt",10 - 15 Jahre,1317,669,648
False,8316011,"Emmendingen, Stadt",15 - 18 Jahre,746,374,372
False,8316011,"Emmendingen, Stadt",18 - 20 Jahre,480,229,251
False,8316011,"Emmendingen, Stadt",20 - 25 Jahre,1400,720,680
False,8316011,"Emmendingen, Stadt",25 - 30 Jahre,2143,1118,1025
False,8316011,"Emmendingen, Stadt",30 - 35 Jahre,2142,1072,1070
False,8316011,"Emmendingen, Stadt",35 - 40 Jahre,2013,975,1038
False,8316011,"Emmendingen, Stadt",40 - 45 Jahre,1848,918,930
False,8316011,"Emmendingen, Stadt",45 - 50 Jahre,1584,770,814
False,8316011,"Emmendingen, Stadt",50 - 55 Jahre,1594,767,827
False,8316011,"Emmendingen, Stadt",55 - 60 Jahre,1820,921,899
False,8316011,"Emmendingen, Stadt",60 - 65 Jahre,1203,585,618
False,8316011,"Emmendingen, Stadt",65 - 75 Jahre,2153,887,1266
False,8316011,"Emmendingen, Stadt",75 und mehr Jahre,1589,454,1135
False,8316011,"Emmendingen, Stadt",Insgesamt,24796,11878,12918
False,8316012,"Endingen am Kaiserstuhl, Stadt",unter 3 Jahre,305,144,161
False,8316012,"Endingen am Kaiserstuhl, Stadt",3 -  6 Jahre,323,151,172
False,8316012,"Endingen am Kaiserstuhl, Stadt",6 - 10 Jahre,482,251,231
False,8316012,"Endingen am Kaiserstuhl, Stadt",10 - 15 Jahre,535,281,254
False,8316012,"Endingen am Kaiserstuhl, Stadt",15 - 18 Jahre,337,184,153
False,8316012,"Endingen am Kaiserstuhl, Stadt",18 - 20 Jahre,194,101,93
False,8316012,"Endingen am Kaiserstuhl, Stadt",20 - 25 Jahre,516,263,253
False,8316012,"Endingen am Kaiserstuhl, Stadt",25 - 30 Jahre,683,345,338
False,8316012,"Endingen am Kaiserstuhl, Stadt",30 - 35 Jahre,760,404,356
False,8316012,"Endingen am Kaiserstuhl, Stadt",35 - 40 Jahre,699,346,353
False,8316012,"Endingen am Kaiserstuhl, Stadt",40 - 45 Jahre,654,349,305
False,8316012,"Endingen am Kaiserstuhl, Stadt",45 - 50 Jahre,503,258,245
False,8316012,"Endingen am Kaiserstuhl, Stadt",50 - 55 Jahre,410,206,204
False,8316012,"Endingen am Kaiserstuhl, Stadt",55 - 60 Jahre,526,265,261
False,8316012,"Endingen am Kaiserstuhl, Stadt",60 - 65 Jahre,450,221,229
False,8316012,"Endingen am Kaiserstuhl, Stadt",65 - 75 Jahre,676,269,407
False,8316012,"Endingen am Kaiserstuhl, Stadt",75 und mehr Jahre,502,136,366
False,8316012,"Endingen am Kaiserstuhl, Stadt",Insgesamt,8555,4174,4381
False,8316013,Forchheim,unter 3 Jahre,46,25,21
False,8316013,Forchheim,3 -  6 Jahre,51,24,27
False,8316013,Forchheim,6 - 10 Jahre,80,41,39
False,8316013,Forchheim,10 - 15 Jahre,80,35,45
False,8316013,Forchheim,15 - 18 Jahre,42,24,18
False,8316013,Forchheim,18 - 20 Jahre,34,17,17
False,8316013,Forchheim,20 - 25 Jahre,55,36,19
False,8316013,Forchheim,25 - 30 Jahre,85,47,38
False,8316013,Forchheim,30 - 35 Jahre,116,70,46
False,8316013,Forchheim,35 - 40 Jahre,90,43,47
False,8316013,Forchheim,40 - 45 Jahre,83,41,42
False,8316013,Forchheim,45 - 50 Jahre,67,35,32
False,8316013,Forchheim,50 - 55 Jahre,44,18,26
False,8316013,Forchheim,55 - 60 Jahre,67,32,35
False,8316013,Forchheim,60 - 65 Jahre,61,36,25
False,8316013,Forchheim,65 - 75 Jahre,110,40,70
False,8316013,Forchheim,75 und mehr Jahre,50,17,33
False,8316013,Forchheim,Insgesamt,1161,581,580
False,8316014,Gutach im Breisgau,unter 3 Jahre,155,80,75
False,8316014,Gutach im Breisgau,3 -  6 Jahre,152,86,66
False,8316014,Gutach im Breisgau,6 - 10 Jahre,199,114,85
False,8316014,Gutach im Breisgau,10 - 15 Jahre,240,109,131
False,8316014,Gutach im Breisgau,15 - 18 Jahre,131,61,70
False,8316014,Gutach im Breisgau,18 - 20 Jahre,87,47,40
False,8316014,Gutach im Breisgau,20 - 25 Jahre,233,125,108
False,8316014,Gutach im Breisgau,25 - 30 Jahre,327,160,167
False,8316014,Gutach im Breisgau,30 - 35 Jahre,414,214,200
False,8316014,Gutach im Breisgau,35 - 40 Jahre,339,154,185
False,8316014,Gutach im Breisgau,40 - 45 Jahre,320,169,151
False,8316014,Gutach im Breisgau,45 - 50 Jahre,221,132,89
False,8316014,Gutach im Breisgau,50 - 55 Jahre,186,84,102
False,8316014,Gutach im Breisgau,55 - 60 Jahre,269,137,132
False,8316014,Gutach im Breisgau,60 - 65 Jahre,216,105,111
False,8316014,Gutach im Breisgau,65 - 75 Jahre,303,130,173
False,8316014,Gutach im Breisgau,75 und mehr Jahre,227,91,136
False,8316014,Gutach im Breisgau,Insgesamt,4019,1998,2021
False,8316017,"Herbolzheim, Stadt",unter 3 Jahre,293,171,122
False,8316017,"Herbolzheim, Stadt",3 -  6 Jahre,315,160,155
False,8316017,"Herbolzheim, Stadt",6 - 10 Jahre,466,257,209
False,8316017,"Herbolzheim, Stadt",10 - 15 Jahre,542,272,270
False,8316017,"Herbolzheim, Stadt",15 - 18 Jahre,281,136,145
False,8316017,"Herbolzheim, Stadt",18 - 20 Jahre,207,102,105
False,8316017,"Herbolzheim, Stadt",20 - 25 Jahre,589,300,289
False,8316017,"Herbolzheim, Stadt",25 - 30 Jahre,689,382,307
False,8316017,"Herbolzheim, Stadt",30 - 35 Jahre,739,377,362
False,8316017,"Herbolzheim, Stadt",35 - 40 Jahre,693,368,325
False,8316017,"Herbolzheim, Stadt",40 - 45 Jahre,576,303,273
False,8316017,"Herbolzheim, Stadt",45 - 50 Jahre,519,254,265
False,8316017,"Herbolzheim, Stadt",50 - 55 Jahre,481,255,226
False,8316017,"Herbolzheim, Stadt",55 - 60 Jahre,570,283,287
False,8316017,"Herbolzheim, Stadt",60 - 65 Jahre,483,223,260
False,8316017,"Herbolzheim, Stadt",65 - 75 Jahre,737,313,424
False,8316017,"Herbolzheim, Stadt",75 und mehr Jahre,499,135,364
False,8316017,"Herbolzheim, Stadt",Insgesamt,8679,4291,4388
False,8316020,"Kenzingen, Stadt",unter 3 Jahre,307,151,156
False,8316020,"Kenzingen, Stadt",3 -  6 Jahre,313,156,157
False,8316020,"Kenzingen, Stadt",6 - 10 Jahre,465,217,248
False,8316020,"Kenzingen, Stadt",10 - 15 Jahre,535,269,266
False,8316020,"Kenzingen, Stadt",15 - 18 Jahre,292,140,152
False,8316020,"Kenzingen, Stadt",18 - 20 Jahre,174,95,79
False,8316020,"Kenzingen, Stadt",20 - 25 Jahre,492,242,250
False,8316020,"Kenzingen, Stadt",25 - 30 Jahre,628,319,309
False,8316020,"Kenzingen, Stadt",30 - 35 Jahre,726,363,363
False,8316020,"Kenzingen, Stadt",35 - 40 Jahre,765,385,380
False,8316020,"Kenzingen, Stadt",40 - 45 Jahre,621,310,311
False,8316020,"Kenzingen, Stadt",45 - 50 Jahre,519,275,244
False,8316020,"Kenzingen, Stadt",50 - 55 Jahre,474,249,225
False,8316020,"Kenzingen, Stadt",55 - 60 Jahre,533,268,265
False,8316020,"Kenzingen, Stadt",60 - 65 Jahre,377,194,183
False,8316020,"Kenzingen, Stadt",65 - 75 Jahre,748,281,467
False,8316020,"Kenzingen, Stadt",75 und mehr Jahre,557,158,399
False,8316020,"Kenzingen, Stadt",Insgesamt,8526,4072,4454
False,8316024,Malterdingen,unter 3 Jahre,91,45,46
False,8316024,Malterdingen,3 -  6 Jahre,81,42,39
False,8316024,Malterdingen,6 - 10 Jahre,148,86,62
False,8316024,Malterdingen,10 - 15 Jahre,130,64,66
False,8316024,Malterdingen,15 - 18 Jahre,77,43,34
False,8316024,Malterdingen,18 - 20 Jahre,39,22,17
False,8316024,Malterdingen,20 - 25 Jahre,149,75,74
False,8316024,Malterdingen,25 - 30 Jahre,208,119,89
False,8316024,Malterdingen,30 - 35 Jahre,211,106,105
False,8316024,Malterdingen,35 - 40 Jahre,214,114,100
False,8316024,Malterdingen,40 - 45 Jahre,185,101,84
False,8316024,Malterdingen,45 - 50 Jahre,156,79,77
False,8316024,Malterdingen,50 - 55 Jahre,112,51,61
False,8316024,Malterdingen,55 - 60 Jahre,155,83,72
False,8316024,Malterdingen,60 - 65 Jahre,132,63,69
False,8316024,Malterdingen,65 - 75 Jahre,203,83,120
False,8316024,Malterdingen,75 und mehr Jahre,135,40,95
False,8316024,Malterdingen,Insgesamt,2426,1216,1210
False,8316036,Reute,unter 3 Jahre,110,52,58
False,8316036,Reute,3 -  6 Jahre,113,50,63
False,8316036,Reute,6 - 10 Jahre,172,87,85
False,8316036,Reute,10 - 15 Jahre,204,101,103
False,8316036,Reute,15 - 18 Jahre,101,50,51
False,8316036,Reute,18 - 20 Jahre,50,20,30
False,8316036,Reute,20 - 25 Jahre,176,88,88
False,8316036,Reute,25 - 30 Jahre,251,125,126
False,8316036,Reute,30 - 35 Jahre,305,156,149
False,8316036,Reute,35 - 40 Jahre,228,114,114
False,8316036,Reute,40 - 45 Jahre,210,96,114
False,8316036,Reute,45 - 50 Jahre,196,102,94
False,8316036,Reute,50 - 55 Jahre,153,85,68
False,8316036,Reute,55 - 60 Jahre,187,92,95
False,8316036,Reute,60 - 65 Jahre,111,62,49
False,8316036,Reute,65 - 75 Jahre,140,60,80
False,8316036,Reute,75 und mehr Jahre,99,18,81
False,8316036,Reute,Insgesamt,2806,1358,1448
False,8316037,Riegel am Kaiserstuhl,unter 3 Jahre,125,63,62
False,8316037,Riegel am Kaiserstuhl,3 -  6 Jahre,132,70,62
False,8316037,Riegel am Kaiserstuhl,6 - 10 Jahre,184,94,90
False,8316037,Riegel am Kaiserstuhl,10 - 15 Jahre,232,130,102
False,8316037,Riegel am Kaiserstuhl,15 - 18 Jahre,121,66,55
False,8316037,Riegel am Kaiserstuhl,18 - 20 Jahre,61,32,29
False,8316037,Riegel am Kaiserstuhl,20 - 25 Jahre,153,55,98
False,8316037,Riegel am Kaiserstuhl,25 - 30 Jahre,309,165,144
False,8316037,Riegel am Kaiserstuhl,30 - 35 Jahre,332,157,175
False,8316037,Riegel am Kaiserstuhl,35 - 40 Jahre,305,164,141
False,8316037,Riegel am Kaiserstuhl,40 - 45 Jahre,250,135,115
False,8316037,Riegel am Kaiserstuhl,45 - 50 Jahre,193,91,102
False,8316037,Riegel am Kaiserstuhl,50 - 55 Jahre,206,98,108
False,8316037,Riegel am Kaiserstuhl,55 - 60 Jahre,179,94,85
False,8316037,Riegel am Kaiserstuhl,60 - 65 Jahre,137,67,70
False,8316037,Riegel am Kaiserstuhl,65 - 75 Jahre,213,102,111
False,8316037,Riegel am Kaiserstuhl,75 und mehr Jahre,129,42,87
False,8316037,Riegel am Kaiserstuhl,Insgesamt,3261,1625,1636
False,8316038,Sasbach am Kaiserstuhl,unter 3 Jahre,102,44,58
False,8316038,Sasbach am Kaiserstuhl,3 -  6 Jahre,127,62,65
False,8316038,Sasbach am Kaiserstuhl,6 - 10 Jahre,162,86,76
False,8316038,Sasbach am Kaiserstuhl,10 - 15 Jahre,229,101,128
False,8316038,Sasbach am Kaiserstuhl,15 - 18 Jahre,99,45,54
False,8316038,Sasbach am Kaiserstuhl,18 - 20 Jahre,73,32,41
False,8316038,Sasbach am Kaiserstuhl,20 - 25 Jahre,181,91,90
False,8316038,Sasbach am Kaiserstuhl,25 - 30 Jahre,248,135,113
False,8316038,Sasbach am Kaiserstuhl,30 - 35 Jahre,265,145,120
False,8316038,Sasbach am Kaiserstuhl,35 - 40 Jahre,262,126,136
False,8316038,Sasbach am Kaiserstuhl,40 - 45 Jahre,218,112,106
False,8316038,Sasbach am Kaiserstuhl,45 - 50 Jahre,209,110,99
False,8316038,Sasbach am Kaiserstuhl,50 - 55 Jahre,152,76,76
False,8316038,Sasbach am Kaiserstuhl,55 - 60 Jahre,200,99,101
False,8316038,Sasbach am Kaiserstuhl,60 - 65 Jahre,172,95,77
False,8316038,Sasbach am Kaiserstuhl,65 - 75 Jahre,255,116,139
False,8316038,Sasbach am Kaiserstuhl,75 und mehr Jahre,153,40,113
False,8316038,Sasbach am Kaiserstuhl,Insgesamt,3107,1515,1592
False,8316039,Sexau,unter 3 Jahre,111,55,56
False,8316039,Sexau,3 -  6 Jahre,103,58,45
False,8316039,Sexau,6 - 10 Jahre,135,65,70
False,8316039,Sexau,10 - 15 Jahre,173,86,87
False,8316039,Sexau,15 - 18 Jahre,99,51,48
False,8316039,Sexau,18 - 20 Jahre,54,36,18
False,8316039,Sexau,20 - 25 Jahre,168,83,85
False,8316039,Sexau,25 - 30 Jahre,256,135,121
False,8316039,Sexau,30 - 35 Jahre,295,135,160
False,8316039,Sexau,35 - 40 Jahre,269,141,128
False,8316039,Sexau,40 - 45 Jahre,231,124,107
False,8316039,Sexau,45 - 50 Jahre,224,110,114
False,8316039,Sexau,50 - 55 Jahre,195,104,91
False,8316039,Sexau,55 - 60 Jahre,218,106,112
False,8316039,Sexau,60 - 65 Jahre,155,82,73
False,8316039,Sexau,65 - 75 Jahre,251,117,134
False,8316039,Sexau,75 und mehr Jahre,135,45,90
False,8316039,Sexau,Insgesamt,3072,1533,1539
False,8316042,Simonswald,unter 3 Jahre,121,59,62
False,8316042,Simonswald,3 -  6 Jahre,108,50,58
False,8316042,Simonswald,6 - 10 Jahre,153,83,70
False,8316042,Simonswald,10 - 15 Jahre,198,107,91
False,8316042,Simonswald,15 - 18 Jahre,112,54,58
False,8316042,Simonswald,18 - 20 Jahre,69,38,31
False,8316042,Simonswald,20 - 25 Jahre,212,102,110
False,8316042,Simonswald,25 - 30 Jahre,283,151,132
False,8316042,Simonswald,30 - 35 Jahre,294,162,132
False,8316042,Simonswald,35 - 40 Jahre,221,114,107
False,8316042,Simonswald,40 - 45 Jahre,214,124,90
False,8316042,Simonswald,45 - 50 Jahre,173,86,87
False,8316042,Simonswald,50 - 55 Jahre,150,75,75
False,8316042,Simonswald,55 - 60 Jahre,201,110,91
False,8316042,Simonswald,60 - 65 Jahre,129,58,71
False,8316042,Simonswald,65 - 75 Jahre,289,131,158
False,8316042,Simonswald,75 und mehr Jahre,165,51,114
False,8316042,Simonswald,Insgesamt,3092,1555,1537
False,8316043,Teningen,unter 3 Jahre,376,206,170
False,8316043,Teningen,3 -  6 Jahre,388,206,182
False,8316043,Teningen,6 - 10 Jahre,506,254,252
False,8316043,Teningen,10 - 15 Jahre,612,307,305
False,8316043,Teningen,15 - 18 Jahre,354,192,162
False,8316043,Teningen,18 - 20 Jahre,257,141,116
False,8316043,Teningen,20 - 25 Jahre,667,353,314
False,8316043,Teningen,25 - 30 Jahre,937,490,447
False,8316043,Teningen,30 - 35 Jahre,974,514,460
False,8316043,Teningen,35 - 40 Jahre,908,450,458
False,8316043,Teningen,40 - 45 Jahre,871,439,432
False,8316043,Teningen,45 - 50 Jahre,738,400,338
False,8316043,Teningen,50 - 55 Jahre,696,349,347
False,8316043,Teningen,55 - 60 Jahre,952,476,476
False,8316043,Teningen,60 - 65 Jahre,609,295,314
False,8316043,Teningen,65 - 75 Jahre,993,443,550
False,8316043,Teningen,75 und mehr Jahre,615,181,434
False,8316043,Teningen,Insgesamt,11453,5696,5757
False,8316045,Vörstetten,unter 3 Jahre,88,48,40
False,8316045,Vörstetten,3 -  6 Jahre,117,72,45
False,8316045,Vörstetten,6 - 10 Jahre,120,57,63
False,8316045,Vörstetten,10 - 15 Jahre,152,67,85
False,8316045,Vörstetten,15 - 18 Jahre,71,37,34
False,8316045,Vörstetten,18 - 20 Jahre,43,24,19
False,8316045,Vörstetten,20 - 25 Jahre,113,62,51
False,8316045,Vörstetten,25 - 30 Jahre,195,91,104
False,8316045,Vörstetten,30 - 35 Jahre,212,108,104
False,8316045,Vörstetten,35 - 40 Jahre,228,107,121
False,8316045,Vörstetten,40 - 45 Jahre,210,96,114
False,8316045,Vörstetten,45 - 50 Jahre,167,97,70
False,8316045,Vörstetten,50 - 55 Jahre,163,82,81
False,8316045,Vörstetten,55 - 60 Jahre,174,85,89
False,8316045,Vörstetten,60 - 65 Jahre,105,52,53
False,8316045,Vörstetten,65 - 75 Jahre,175,76,99
False,8316045,Vörstetten,75 und mehr Jahre,96,28,68
False,8316045,Vörstetten,Insgesamt,2429,1189,1240
False,8316049,Weisweil,unter 3 Jahre,70,27,43
False,8316049,Weisweil,3 -  6 Jahre,83,35,48
False,8316049,Weisweil,6 - 10 Jahre,126,66,60
False,8316049,Weisweil,10 - 15 Jahre,120,71,49
False,8316049,Weisweil,15 - 18 Jahre,77,38,39
False,8316049,Weisweil,18 - 20 Jahre,51,27,24
False,8316049,Weisweil,20 - 25 Jahre,108,49,59
False,8316049,Weisweil,25 - 30 Jahre,155,75,80
False,8316049,Weisweil,30 - 35 Jahre,186,92,94
False,8316049,Weisweil,35 - 40 Jahre,213,114,99
False,8316049,Weisweil,40 - 45 Jahre,135,76,59
False,8316049,Weisweil,45 - 50 Jahre,118,63,55
False,8316049,Weisweil,50 - 55 Jahre,85,43,42
False,8316049,Weisweil,55 - 60 Jahre,131,59,72
False,8316049,Weisweil,60 - 65 Jahre,87,43,44
False,8316049,Weisweil,65 - 75 Jahre,123,57,66
False,8316049,Weisweil,75 und mehr Jahre,71,16,55
False,8316049,Weisweil,Insgesamt,1939,951,988
False,8316051,Wyhl am Kaiserstuhl,unter 3 Jahre,130,63,67
False,8316051,Wyhl am Kaiserstuhl,3 -  6 Jahre,153,76,77
False,8316051,Wyhl am Kaiserstuhl,6 - 10 Jahre,170,92,78
False,8316051,Wyhl am Kaiserstuhl,10 - 15 Jahre,245,136,109
False,8316051,Wyhl am Kaiserstuhl,15 - 18 Jahre,130,70,60
False,8316051,Wyhl am Kaiserstuhl,18 - 20 Jahre,63,27,36
False,8316051,Wyhl am Kaiserstuhl,20 - 25 Jahre,195,106,89
False,8316051,Wyhl am Kaiserstuhl,25 - 30 Jahre,326,164,162
False,8316051,Wyhl am Kaiserstuhl,30 - 35 Jahre,325,168,157
False,8316051,Wyhl am Kaiserstuhl,35 - 40 Jahre,352,176,176
False,8316051,Wyhl am Kaiserstuhl,40 - 45 Jahre,249,143,106
False,8316051,Wyhl am Kaiserstuhl,45 - 50 Jahre,180,92,88
False,8316051,Wyhl am Kaiserstuhl,50 - 55 Jahre,158,80,78
False,8316051,Wyhl am Kaiserstuhl,55 - 60 Jahre,184,98,86
False,8316051,Wyhl am Kaiserstuhl,60 - 65 Jahre,146,67,79
False,8316051,Wyhl am Kaiserstuhl,65 - 75 Jahre,234,102,132
False,8316051,Wyhl am Kaiserstuhl,75 und mehr Jahre,138,34,104
False,8316051,Wyhl am Kaiserstuhl,Insgesamt,3378,1694,1684
False,8316053,Rheinhausen,unter 3 Jahre,113,58,55
False,8316053,Rheinhausen,3 -  6 Jahre,119,57,62
False,8316053,Rheinhausen,6 - 10 Jahre,168,102,66
False,8316053,Rheinhausen,10 - 15 Jahre,170,82,88
False,8316053,Rheinhausen,15 - 18 Jahre,97,49,48
False,8316053,Rheinhausen,18 - 20 Jahre,82,38,44
False,8316053,Rheinhausen,20 - 25 Jahre,185,96,89
False,8316053,Rheinhausen,25 - 30 Jahre,273,144,129
False,8316053,Rheinhausen,30 - 35 Jahre,318,174,144
False,8316053,Rheinhausen,35 - 40 Jahre,250,129,121
False,8316053,Rheinhausen,40 - 45 Jahre,209,116,93
False,8316053,Rheinhausen,45 - 50 Jahre,196,110,86
False,8316053,Rheinhausen,50 - 55 Jahre,166,78,88
False,8316053,Rheinhausen,55 - 60 Jahre,230,107,123
False,8316053,Rheinhausen,60 - 65 Jahre,186,96,90
False,8316053,Rheinhausen,65 - 75 Jahre,261,102,159
False,8316053,Rheinhausen,75 und mehr Jahre,139,36,103
False,8316053,Rheinhausen,Insgesamt,3162,1574,1588
False,8316054,Freiamt,unter 3 Jahre,146,80,66
False,8316054,Freiamt,3 -  6 Jahre,163,85,78
False,8316054,Freiamt,6 - 10 Jahre,209,113,96
False,8316054,Freiamt,10 - 15 Jahre,232,115,117
False,8316054,Freiamt,15 - 18 Jahre,139,72,67
False,8316054,Freiamt,18 - 20 Jahre,79,41,38
False,8316054,Freiamt,20 - 25 Jahre,259,132,127
False,8316054,Freiamt,25 - 30 Jahre,352,195,157
False,8316054,Freiamt,30 - 35 Jahre,378,191,187
False,8316054,Freiamt,35 - 40 Jahre,334,178,156
False,8316054,Freiamt,40 - 45 Jahre,298,151,147
False,8316054,Freiamt,45 - 50 Jahre,236,128,108
False,8316054,Freiamt,50 - 55 Jahre,204,100,104
False,8316054,Freiamt,55 - 60 Jahre,276,150,126
False,8316054,Freiamt,60 - 65 Jahre,239,113,126
False,8316054,Freiamt,65 - 75 Jahre,382,169,213
False,8316054,Freiamt,75 und mehr Jahre,221,72,149
False,8316054,Freiamt,Insgesamt,4147,2085,2062
False,8316055,Winden im Elztal,unter 3 Jahre,99,45,54
False,8316055,Winden im Elztal,3 -  6 Jahre,98,44,54
False,8316055,Winden im Elztal,6 - 10 Jahre,141,76,65
False,8316055,Winden im Elztal,10 - 15 Jahre,184,95,89
False,8316055,Winden im Elztal,15 - 18 Jahre,94,55,39
False,8316055,Winden im Elztal,18 - 20 Jahre,49,28,21
False,8316055,Winden im Elztal,20 - 25 Jahre,160,84,76
False,8316055,Winden im Elztal,25 - 30 Jahre,222,116,106
False,8316055,Winden im Elztal,30 - 35 Jahre,253,135,118
False,8316055,Winden im Elztal,35 - 40 Jahre,244,132,112
False,8316055,Winden im Elztal,40 - 45 Jahre,207,108,99
False,8316055,Winden im Elztal,45 - 50 Jahre,150,84,66
False,8316055,Winden im Elztal,50 - 55 Jahre,111,60,51
False,8316055,Winden im Elztal,55 - 60 Jahre,165,79,86
False,8316055,Winden im Elztal,60 - 65 Jahre,150,71,79
False,8316055,Winden im Elztal,65 - 75 Jahre,220,96,124
False,8316055,Winden im Elztal,75 und mehr Jahre,149,47,102
False,8316055,Winden im Elztal,Insgesamt,2696,1355,1341
False,8316056,"Waldkirch, Stadt",unter 3 Jahre,651,357,294
False,8316056,"Waldkirch, Stadt",3 -  6 Jahre,691,344,347
False,8316056,"Waldkirch, Stadt",6 - 10 Jahre,899,459,440
False,8316056,"Waldkirch, Stadt",10 - 15 Jahre,1112,594,518
False,8316056,"Waldkirch, Stadt",15 - 18 Jahre,579,309,270
False,8316056,"Waldkirch, Stadt",18 - 20 Jahre,411,199,212
False,8316056,"Waldkirch, Stadt",20 - 25 Jahre,1105,561,544
False,8316056,"Waldkirch, Stadt",25 - 30 Jahre,1513,772,741
False,8316056,"Waldkirch, Stadt",30 - 35 Jahre,1669,833,836
False,8316056,"Waldkirch, Stadt",35 - 40 Jahre,1448,747,701
False,8316056,"Waldkirch, Stadt",40 - 45 Jahre,1321,638,683
False,8316056,"Waldkirch, Stadt",45 - 50 Jahre,1156,583,573
False,8316056,"Waldkirch, Stadt",50 - 55 Jahre,1211,565,646
False,8316056,"Waldkirch, Stadt",55 - 60 Jahre,1403,713,690
False,8316056,"Waldkirch, Stadt",60 - 65 Jahre,1160,561,599
False,8316056,"Waldkirch, Stadt",65 - 75 Jahre,1850,750,1100
False,8316056,"Waldkirch, Stadt",75 und mehr Jahre,1438,373,1065
False,8316056,"Waldkirch, Stadt",Insgesamt,19617,9358,10259
False,8317,Landkreis Ortenaukreis,unter 3 Jahre,13860,7049,6811
False,8317,Landkreis Ortenaukreis,3 -  6 Jahre,14816,7542,7274
False,8317,Landkreis Ortenaukreis,6 - 10 Jahre,20194,10378,9816
False,8317,Landkreis Ortenaukreis,10 - 15 Jahre,23084,11916,11168
False,8317,Landkreis Ortenaukreis,15 - 18 Jahre,13201,6693,6508
False,8317,Landkreis Ortenaukreis,18 - 20 Jahre,8803,4545,4258
False,8317,Landkreis Ortenaukreis,20 - 25 Jahre,23858,12293,11565
False,8317,Landkreis Ortenaukreis,25 - 30 Jahre,32960,17036,15924
False,8317,Landkreis Ortenaukreis,30 - 35 Jahre,34989,18087,16902
False,8317,Landkreis Ortenaukreis,35 - 40 Jahre,31497,16162,15335
False,8317,Landkreis Ortenaukreis,40 - 45 Jahre,28040,14296,13744
False,8317,Landkreis Ortenaukreis,45 - 50 Jahre,23371,11985,11386
False,8317,Landkreis Ortenaukreis,50 - 55 Jahre,20997,10573,10424
False,8317,Landkreis Ortenaukreis,55 - 60 Jahre,27720,13833,13887
False,8317,Landkreis Ortenaukreis,60 - 65 Jahre,20794,10232,10562
False,8317,Landkreis Ortenaukreis,65 - 75 Jahre,36005,14667,21338
False,8317,Landkreis Ortenaukreis,75 und mehr Jahre,24944,7345,17599
False,8317,Landkreis Ortenaukreis,Insgesamt,399133,194632,204501
False,8317001,"Achern, Stadt",unter 3 Jahre,832,418,414
False,8317001,"Achern, Stadt",3 -  6 Jahre,878,461,417
False,8317001,"Achern, Stadt",6 - 10 Jahre,1147,610,537
False,8317001,"Achern, Stadt",10 - 15 Jahre,1361,702,659
False,8317001,"Achern, Stadt",15 - 18 Jahre,728,371,357
False,8317001,"Achern, Stadt",18 - 20 Jahre,480,260,220
False,8317001,"Achern, Stadt",20 - 25 Jahre,1320,690,630
False,8317001,"Achern, Stadt",25 - 30 Jahre,1825,911,914
False,8317001,"Achern, Stadt",30 - 35 Jahre,1903,975,928
False,8317001,"Achern, Stadt",35 - 40 Jahre,1761,857,904
False,8317001,"Achern, Stadt",40 - 45 Jahre,1602,845,757
False,8317001,"Achern, Stadt",45 - 50 Jahre,1305,661,644
False,8317001,"Achern, Stadt",50 - 55 Jahre,1225,584,641
False,8317001,"Achern, Stadt",55 - 60 Jahre,1495,756,739
False,8317001,"Achern, Stadt",60 - 65 Jahre,1150,546,604
False,8317001,"Achern, Stadt",65 - 75 Jahre,2072,817,1255
False,8317001,"Achern, Stadt",75 und mehr Jahre,1574,511,1063
False,8317001,"Achern, Stadt",Insgesamt,22658,10975,11683
False,8317005,Appenweier,unter 3 Jahre,319,166,153
False,8317005,Appenweier,3 -  6 Jahre,362,184,178
False,8317005,Appenweier,6 - 10 Jahre,479,247,232
False,8317005,Appenweier,10 - 15 Jahre,549,284,265
False,8317005,Appenweier,15 - 18 Jahre,313,151,162
False,8317005,Appenweier,18 - 20 Jahre,211,100,111
False,8317005,Appenweier,20 - 25 Jahre,519,274,245
False,8317005,Appenweier,25 - 30 Jahre,757,389,368
False,8317005,Appenweier,30 - 35 Jahre,873,443,430
False,8317005,Appenweier,35 - 40 Jahre,804,413,391
False,8317005,Appenweier,40 - 45 Jahre,737,369,368
False,8317005,Appenweier,45 - 50 Jahre,621,318,303
False,8317005,Appenweier,50 - 55 Jahre,502,259,243
False,8317005,Appenweier,55 - 60 Jahre,653,340,313
False,8317005,Appenweier,60 - 65 Jahre,420,219,201
False,8317005,Appenweier,65 - 75 Jahre,769,291,478
False,8317005,Appenweier,75 und mehr Jahre,460,152,308
False,8317005,Appenweier,Insgesamt,9348,4599,4749
False,8317008,Bad Peterstal-Griesbach,unter 3 Jahre,89,48,41
False,8317008,Bad Peterstal-Griesbach,3 -  6 Jahre,108,58,50
False,8317008,Bad Peterstal-Griesbach,6 - 10 Jahre,150,67,83
False,8317008,Bad Peterstal-Griesbach,10 - 15 Jahre,179,82,97
False,8317008,Bad Peterstal-Griesbach,15 - 18 Jahre,110,53,57
False,8317008,Bad Peterstal-Griesbach,18 - 20 Jahre,100,48,52
False,8317008,Bad Peterstal-Griesbach,20 - 25 Jahre,209,110,99
False,8317008,Bad Peterstal-Griesbach,25 - 30 Jahre,269,155,114
False,8317008,Bad Peterstal-Griesbach,30 - 35 Jahre,240,116,124
False,8317008,Bad Peterstal-Griesbach,35 - 40 Jahre,217,103,114
False,8317008,Bad Peterstal-Griesbach,40 - 45 Jahre,176,98,78
False,8317008,Bad Peterstal-Griesbach,45 - 50 Jahre,162,74,88
False,8317008,Bad Peterstal-Griesbach,50 - 55 Jahre,144,64,80
False,8317008,Bad Peterstal-Griesbach,55 - 60 Jahre,259,134,125
False,8317008,Bad Peterstal-Griesbach,60 - 65 Jahre,178,87,91
False,8317008,Bad Peterstal-Griesbach,65 - 75 Jahre,331,124,207
False,8317008,Bad Peterstal-Griesbach,75 und mehr Jahre,227,72,155
False,8317008,Bad Peterstal-Griesbach,Insgesamt,3148,1493,1655
False,8317009,Berghaupten,unter 3 Jahre,79,43,36
False,8317009,Berghaupten,3 -  6 Jahre,91,46,45
False,8317009,Berghaupten,6 - 10 Jahre,135,76,59
False,8317009,Berghaupten,10 - 15 Jahre,132,65,67
False,8317009,Berghaupten,15 - 18 Jahre,63,29,34
False,8317009,Berghaupten,18 - 20 Jahre,51,23,28
False,8317009,Berghaupten,20 - 25 Jahre,132,76,56
False,8317009,Berghaupten,25 - 30 Jahre,213,118,95
False,8317009,Berghaupten,30 - 35 Jahre,223,113,110
False,8317009,Berghaupten,35 - 40 Jahre,187,102,85
False,8317009,Berghaupten,40 - 45 Jahre,169,84,85
False,8317009,Berghaupten,45 - 50 Jahre,162,81,81
False,8317009,Berghaupten,50 - 55 Jahre,111,53,58
False,8317009,Berghaupten,55 - 60 Jahre,161,82,79
False,8317009,Berghaupten,60 - 65 Jahre,104,52,52
False,8317009,Berghaupten,65 - 75 Jahre,203,87,116
False,8317009,Berghaupten,75 und mehr Jahre,118,39,79
False,8317009,Berghaupten,Insgesamt,2334,1169,1165
False,8317011,Biberach,unter 3 Jahre,136,79,57
False,8317011,Biberach,3 -  6 Jahre,146,70,76
False,8317011,Biberach,6 - 10 Jahre,160,77,83
False,8317011,Biberach,10 - 15 Jahre,199,115,84
False,8317011,Biberach,15 - 18 Jahre,105,59,46
False,8317011,Biberach,18 - 20 Jahre,60,25,35
False,8317011,Biberach,20 - 25 Jahre,184,82,102
False,8317011,Biberach,25 - 30 Jahre,265,157,108
False,8317011,Biberach,30 - 35 Jahre,274,134,140
False,8317011,Biberach,35 - 40 Jahre,279,143,136
False,8317011,Biberach,40 - 45 Jahre,233,129,104
False,8317011,Biberach,45 - 50 Jahre,154,81,73
False,8317011,Biberach,50 - 55 Jahre,143,71,72
False,8317011,Biberach,55 - 60 Jahre,209,106,103
False,8317011,Biberach,60 - 65 Jahre,172,91,81
False,8317011,Biberach,65 - 75 Jahre,281,100,181
False,8317011,Biberach,75 und mehr Jahre,173,62,111
False,8317011,Biberach,Insgesamt,3173,1581,1592
False,8317021,Durbach,unter 3 Jahre,122,67,55
False,8317021,Durbach,3 -  6 Jahre,144,75,69
False,8317021,Durbach,6 - 10 Jahre,202,114,88
False,8317021,Durbach,10 - 15 Jahre,233,115,118
False,8317021,Durbach,15 - 18 Jahre,105,48,57
False,8317021,Durbach,18 - 20 Jahre,86,46,40
False,8317021,Durbach,20 - 25 Jahre,216,106,110
False,8317021,Durbach,25 - 30 Jahre,283,149,134
False,8317021,Durbach,30 - 35 Jahre,337,190,147
False,8317021,Durbach,35 - 40 Jahre,315,164,151
False,8317021,Durbach,40 - 45 Jahre,310,150,160
False,8317021,Durbach,45 - 50 Jahre,253,142,111
False,8317021,Durbach,50 - 55 Jahre,216,99,117
False,8317021,Durbach,55 - 60 Jahre,281,139,142
False,8317021,Durbach,60 - 65 Jahre,180,101,79
False,8317021,Durbach,65 - 75 Jahre,345,145,200
False,8317021,Durbach,75 und mehr Jahre,187,54,133
False,8317021,Durbach,Insgesamt,3815,1904,1911
False,8317026,"Ettenheim, Stadt",unter 3 Jahre,396,182,214
False,8317026,"Ettenheim, Stadt",3 -  6 Jahre,444,211,233
False,8317026,"Ettenheim, Stadt",6 - 10 Jahre,587,295,292
False,8317026,"Ettenheim, Stadt",10 - 15 Jahre,670,348,322
False,8317026,"Ettenheim, Stadt",15 - 18 Jahre,420,229,191
False,8317026,"Ettenheim, Stadt",18 - 20 Jahre,278,159,119
False,8317026,"Ettenheim, Stadt",20 - 25 Jahre,743,410,333
False,8317026,"Ettenheim, Stadt",25 - 30 Jahre,991,496,495
False,8317026,"Ettenheim, Stadt",30 - 35 Jahre,994,502,492
False,8317026,"Ettenheim, Stadt",35 - 40 Jahre,960,478,482
False,8317026,"Ettenheim, Stadt",40 - 45 Jahre,765,387,378
False,8317026,"Ettenheim, Stadt",45 - 50 Jahre,624,330,294
False,8317026,"Ettenheim, Stadt",50 - 55 Jahre,532,276,256
False,8317026,"Ettenheim, Stadt",55 - 60 Jahre,777,379,398
False,8317026,"Ettenheim, Stadt",60 - 65 Jahre,536,284,252
False,8317026,"Ettenheim, Stadt",65 - 75 Jahre,979,384,595
False,8317026,"Ettenheim, Stadt",75 und mehr Jahre,551,156,395
False,8317026,"Ettenheim, Stadt",Insgesamt,11247,5506,5741
False,8317029,Fischerbach,unter 3 Jahre,65,37,28
False,8317029,Fischerbach,3 -  6 Jahre,70,32,38
False,8317029,Fischerbach,6 - 10 Jahre,95,61,34
False,8317029,Fischerbach,10 - 15 Jahre,99,55,44
False,8317029,Fischerbach,15 - 18 Jahre,54,27,27
False,8317029,Fischerbach,18 - 20 Jahre,29,19,10
False,8317029,Fischerbach,20 - 25 Jahre,86,44,42
False,8317029,Fischerbach,25 - 30 Jahre,152,76,76
False,8317029,Fischerbach,30 - 35 Jahre,166,83,83
False,8317029,Fischerbach,35 - 40 Jahre,144,79,65
False,8317029,Fischerbach,40 - 45 Jahre,84,43,41
False,8317029,Fischerbach,45 - 50 Jahre,84,39,45
False,8317029,Fischerbach,50 - 55 Jahre,83,40,43
False,8317029,Fischerbach,55 - 60 Jahre,144,76,68
False,8317029,Fischerbach,60 - 65 Jahre,73,36,37
False,8317029,Fischerbach,65 - 75 Jahre,147,68,79
False,8317029,Fischerbach,75 und mehr Jahre,74,26,48
False,8317029,Fischerbach,Insgesamt,1649,841,808
False,8317031,Friesenheim,unter 3 Jahre,457,246,211
False,8317031,Friesenheim,3 -  6 Jahre,482,239,243
False,8317031,Friesenheim,6 - 10 Jahre,621,326,295
False,8317031,Friesenheim,10 - 15 Jahre,738,376,362
False,8317031,Friesenheim,15 - 18 Jahre,364,178,186
False,8317031,Friesenheim,18 - 20 Jahre,238,134,104
False,8317031,Friesenheim,20 - 25 Jahre,630,321,309
False,8317031,Friesenheim,25 - 30 Jahre,1056,525,531
False,8317031,Friesenheim,30 - 35 Jahre,1181,598,583
False,8317031,Friesenheim,35 - 40 Jahre,1105,556,549
False,8317031,Friesenheim,40 - 45 Jahre,883,448,435
False,8317031,Friesenheim,45 - 50 Jahre,700,359,341
False,8317031,Friesenheim,50 - 55 Jahre,634,322,312
False,8317031,Friesenheim,55 - 60 Jahre,762,375,387
False,8317031,Friesenheim,60 - 65 Jahre,580,284,296
False,8317031,Friesenheim,65 - 75 Jahre,1069,468,601
False,8317031,Friesenheim,75 und mehr Jahre,783,225,558
False,8317031,Friesenheim,Insgesamt,12283,5980,6303
False,8317034,"Gengenbach, Stadt",unter 3 Jahre,286,146,140
False,8317034,"Gengenbach, Stadt",3 -  6 Jahre,330,157,173
False,8317034,"Gengenbach, Stadt",6 - 10 Jahre,447,224,223
False,8317034,"Gengenbach, Stadt",10 - 15 Jahre,549,285,264
False,8317034,"Gengenbach, Stadt",15 - 18 Jahre,324,162,162
False,8317034,"Gengenbach, Stadt",18 - 20 Jahre,264,110,154
False,8317034,"Gengenbach, Stadt",20 - 25 Jahre,666,328,338
False,8317034,"Gengenbach, Stadt",25 - 30 Jahre,879,410,469
False,8317034,"Gengenbach, Stadt",30 - 35 Jahre,865,447,418
False,8317034,"Gengenbach, Stadt",35 - 40 Jahre,708,344,364
False,8317034,"Gengenbach, Stadt",40 - 45 Jahre,736,358,378
False,8317034,"Gengenbach, Stadt",45 - 50 Jahre,617,318,299
False,8317034,"Gengenbach, Stadt",50 - 55 Jahre,586,295,291
False,8317034,"Gengenbach, Stadt",55 - 60 Jahre,737,370,367
False,8317034,"Gengenbach, Stadt",60 - 65 Jahre,624,320,304
False,8317034,"Gengenbach, Stadt",65 - 75 Jahre,1089,427,662
False,8317034,"Gengenbach, Stadt",75 und mehr Jahre,896,224,672
False,8317034,"Gengenbach, Stadt",Insgesamt,10603,4925,5678
False,8317039,Gutach (Schwarzwaldbahn),unter 3 Jahre,73,39,34
False,8317039,Gutach (Schwarzwaldbahn),3 -  6 Jahre,63,26,37
False,8317039,Gutach (Schwarzwaldbahn),6 - 10 Jahre,83,39,44
False,8317039,Gutach (Schwarzwaldbahn),10 - 15 Jahre,126,57,69
False,8317039,Gutach (Schwarzwaldbahn),15 - 18 Jahre,64,34,30
False,8317039,Gutach (Schwarzwaldbahn),18 - 20 Jahre,46,24,22
False,8317039,Gutach (Schwarzwaldbahn),20 - 25 Jahre,136,76,60
False,8317039,Gutach (Schwarzwaldbahn),25 - 30 Jahre,172,102,70
False,8317039,Gutach (Schwarzwaldbahn),30 - 35 Jahre,158,81,77
False,8317039,Gutach (Schwarzwaldbahn),35 - 40 Jahre,145,68,77
False,8317039,Gutach (Schwarzwaldbahn),40 - 45 Jahre,145,76,69
False,8317039,Gutach (Schwarzwaldbahn),45 - 50 Jahre,119,60,59
False,8317039,Gutach (Schwarzwaldbahn),50 - 55 Jahre,135,67,68
False,8317039,Gutach (Schwarzwaldbahn),55 - 60 Jahre,177,94,83
False,8317039,Gutach (Schwarzwaldbahn),60 - 65 Jahre,135,67,68
False,8317039,Gutach (Schwarzwaldbahn),65 - 75 Jahre,238,94,144
False,8317039,Gutach (Schwarzwaldbahn),75 und mehr Jahre,156,49,107
False,8317039,Gutach (Schwarzwaldbahn),Insgesamt,2171,1053,1118
False,8317040,"Haslach im Kinzigtal, Stadt",unter 3 Jahre,243,113,130
False,8317040,"Haslach im Kinzigtal, Stadt",3 -  6 Jahre,226,108,118
False,8317040,"Haslach im Kinzigtal, Stadt",6 - 10 Jahre,362,200,162
False,8317040,"Haslach im Kinzigtal, Stadt",10 - 15 Jahre,375,192,183
False,8317040,"Haslach im Kinzigtal, Stadt",15 - 18 Jahre,228,114,114
False,8317040,"Haslach im Kinzigtal, Stadt",18 - 20 Jahre,146,70,76
False,8317040,"Haslach im Kinzigtal, Stadt",20 - 25 Jahre,401,231,170
False,8317040,"Haslach im Kinzigtal, Stadt",25 - 30 Jahre,531,264,267
False,8317040,"Haslach im Kinzigtal, Stadt",30 - 35 Jahre,594,303,291
False,8317040,"Haslach im Kinzigtal, Stadt",35 - 40 Jahre,539,268,271
False,8317040,"Haslach im Kinzigtal, Stadt",40 - 45 Jahre,460,244,216
False,8317040,"Haslach im Kinzigtal, Stadt",45 - 50 Jahre,351,181,170
False,8317040,"Haslach im Kinzigtal, Stadt",50 - 55 Jahre,342,168,174
False,8317040,"Haslach im Kinzigtal, Stadt",55 - 60 Jahre,489,233,256
False,8317040,"Haslach im Kinzigtal, Stadt",60 - 65 Jahre,369,204,165
False,8317040,"Haslach im Kinzigtal, Stadt",65 - 75 Jahre,612,224,388
False,8317040,"Haslach im Kinzigtal, Stadt",75 und mehr Jahre,554,157,397
False,8317040,"Haslach im Kinzigtal, Stadt",Insgesamt,6822,3274,3548
False,8317041,"Hausach, Stadt",unter 3 Jahre,163,92,71
False,8317041,"Hausach, Stadt",3 -  6 Jahre,194,94,100
False,8317041,"Hausach, Stadt",6 - 10 Jahre,277,137,140
False,8317041,"Hausach, Stadt",10 - 15 Jahre,366,187,179
False,8317041,"Hausach, Stadt",15 - 18 Jahre,216,112,104
False,8317041,"Hausach, Stadt",18 - 20 Jahre,122,63,59
False,8317041,"Hausach, Stadt",20 - 25 Jahre,313,173,140
False,8317041,"Hausach, Stadt",25 - 30 Jahre,389,216,173
False,8317041,"Hausach, Stadt",30 - 35 Jahre,454,228,226
False,8317041,"Hausach, Stadt",35 - 40 Jahre,438,230,208
False,8317041,"Hausach, Stadt",40 - 45 Jahre,408,211,197
False,8317041,"Hausach, Stadt",45 - 50 Jahre,314,160,154
False,8317041,"Hausach, Stadt",50 - 55 Jahre,278,140,138
False,8317041,"Hausach, Stadt",55 - 60 Jahre,390,199,191
False,8317041,"Hausach, Stadt",60 - 65 Jahre,335,166,169
False,8317041,"Hausach, Stadt",65 - 75 Jahre,520,212,308
False,8317041,"Hausach, Stadt",75 und mehr Jahre,391,107,284
False,8317041,"Hausach, Stadt",Insgesamt,5568,2727,2841
False,8317046,Hofstetten,unter 3 Jahre,59,28,31
False,8317046,Hofstetten,3 -  6 Jahre,58,31,27
False,8317046,Hofstetten,6 - 10 Jahre,83,43,40
False,8317046,Hofstetten,10 - 15 Jahre,122,70,52
False,8317046,Hofstetten,15 - 18 Jahre,58,30,28
False,8317046,Hofstetten,18 - 20 Jahre,47,25,22
False,8317046,Hofstetten,20 - 25 Jahre,109,63,46
False,8317046,Hofstetten,25 - 30 Jahre,141,81,60
False,8317046,Hofstetten,30 - 35 Jahre,154,81,73
False,8317046,Hofstetten,35 - 40 Jahre,118,60,58
False,8317046,Hofstetten,40 - 45 Jahre,108,60,48
False,8317046,Hofstetten,45 - 50 Jahre,98,51,47
False,8317046,Hofstetten,50 - 55 Jahre,94,44,50
False,8317046,Hofstetten,55 - 60 Jahre,99,56,43
False,8317046,Hofstetten,60 - 65 Jahre,58,29,29
False,8317046,Hofstetten,65 - 75 Jahre,93,47,46
False,8317046,Hofstetten,75 und mehr Jahre,71,20,51
False,8317046,Hofstetten,Insgesamt,1570,819,751
False,8317047,Hohberg,unter 3 Jahre,292,160,132
False,8317047,Hohberg,3 -  6 Jahre,289,137,152
False,8317047,Hohberg,6 - 10 Jahre,411,213,198
False,8317047,Hohberg,10 - 15 Jahre,407,228,179
False,8317047,Hohberg,15 - 18 Jahre,226,115,111
False,8317047,Hohberg,18 - 20 Jahre,130,69,61
False,8317047,Hohberg,20 - 25 Jahre,401,199,202
False,8317047,Hohberg,25 - 30 Jahre,651,331,320
False,8317047,Hohberg,30 - 35 Jahre,684,349,335
False,8317047,Hohberg,35 - 40 Jahre,631,338,293
False,8317047,Hohberg,40 - 45 Jahre,563,281,282
False,8317047,Hohberg,45 - 50 Jahre,459,236,223
False,8317047,Hohberg,50 - 55 Jahre,372,194,178
False,8317047,Hohberg,55 - 60 Jahre,466,235,231
False,8317047,Hohberg,60 - 65 Jahre,382,182,200
False,8317047,Hohberg,65 - 75 Jahre,616,259,357
False,8317047,Hohberg,75 und mehr Jahre,425,129,296
False,8317047,Hohberg,Insgesamt,7405,3655,3750
False,8317051,"Hornberg, Stadt",unter 3 Jahre,153,82,71
False,8317051,"Hornberg, Stadt",3 -  6 Jahre,177,89,88
False,8317051,"Hornberg, Stadt",6 - 10 Jahre,222,110,112
False,8317051,"Hornberg, Stadt",10 - 15 Jahre,252,139,113
False,8317051,"Hornberg, Stadt",15 - 18 Jahre,168,84,84
False,8317051,"Hornberg, Stadt",18 - 20 Jahre,111,51,60
False,8317051,"Hornberg, Stadt",20 - 25 Jahre,276,160,116
False,8317051,"Hornberg, Stadt",25 - 30 Jahre,390,189,201
False,8317051,"Hornberg, Stadt",30 - 35 Jahre,384,205,179
False,8317051,"Hornberg, Stadt",35 - 40 Jahre,381,193,188
False,8317051,"Hornberg, Stadt",40 - 45 Jahre,341,187,154
False,8317051,"Hornberg, Stadt",45 - 50 Jahre,284,158,126
False,8317051,"Hornberg, Stadt",50 - 55 Jahre,242,114,128
False,8317051,"Hornberg, Stadt",55 - 60 Jahre,349,173,176
False,8317051,"Hornberg, Stadt",60 - 65 Jahre,268,122,146
False,8317051,"Hornberg, Stadt",65 - 75 Jahre,529,217,312
False,8317051,"Hornberg, Stadt",75 und mehr Jahre,313,86,227
False,8317051,"Hornberg, Stadt",Insgesamt,4840,2359,2481
False,8317056,Kappelrodeck,unter 3 Jahre,210,111,99
False,8317056,Kappelrodeck,3 -  6 Jahre,230,129,101
False,8317056,Kappelrodeck,6 - 10 Jahre,314,160,154
False,8317056,Kappelrodeck,10 - 15 Jahre,350,179,171
False,8317056,Kappelrodeck,15 - 18 Jahre,201,106,95
False,8317056,Kappelrodeck,18 - 20 Jahre,146,67,79
False,8317056,Kappelrodeck,20 - 25 Jahre,369,178,191
False,8317056,Kappelrodeck,25 - 30 Jahre,461,253,208
False,8317056,Kappelrodeck,30 - 35 Jahre,470,250,220
False,8317056,Kappelrodeck,35 - 40 Jahre,474,252,222
False,8317056,Kappelrodeck,40 - 45 Jahre,386,207,179
False,8317056,Kappelrodeck,45 - 50 Jahre,340,171,169
False,8317056,Kappelrodeck,50 - 55 Jahre,277,132,145
False,8317056,Kappelrodeck,55 - 60 Jahre,418,222,196
False,8317056,Kappelrodeck,60 - 65 Jahre,333,159,174
False,8317056,Kappelrodeck,65 - 75 Jahre,557,230,327
False,8317056,Kappelrodeck,75 und mehr Jahre,362,118,244
False,8317056,Kappelrodeck,Insgesamt,5898,2924,2974
False,8317057,"Kehl, Stadt",unter 3 Jahre,1036,520,516
False,8317057,"Kehl, Stadt",3 -  6 Jahre,1149,584,565
False,8317057,"Kehl, Stadt",6 - 10 Jahre,1671,846,825
False,8317057,"Kehl, Stadt",10 - 15 Jahre,1853,977,876
False,8317057,"Kehl, Stadt",15 - 18 Jahre,1119,564,555
False,8317057,"Kehl, Stadt",18 - 20 Jahre,759,421,338
False,8317057,"Kehl, Stadt",20 - 25 Jahre,2145,1143,1002
False,8317057,"Kehl, Stadt",25 - 30 Jahre,2900,1512,1388
False,8317057,"Kehl, Stadt",30 - 35 Jahre,2639,1364,1275
False,8317057,"Kehl, Stadt",35 - 40 Jahre,2562,1316,1246
False,8317057,"Kehl, Stadt",40 - 45 Jahre,2403,1217,1186
False,8317057,"Kehl, Stadt",45 - 50 Jahre,2084,1046,1038
False,8317057,"Kehl, Stadt",50 - 55 Jahre,1935,1015,920
False,8317057,"Kehl, Stadt",55 - 60 Jahre,2314,1139,1175
False,8317057,"Kehl, Stadt",60 - 65 Jahre,1773,883,890
False,8317057,"Kehl, Stadt",65 - 75 Jahre,2943,1249,1694
False,8317057,"Kehl, Stadt",75 und mehr Jahre,1852,526,1326
False,8317057,"Kehl, Stadt",Insgesamt,33137,16322,16815
False,8317059,Kippenheim,unter 3 Jahre,196,104,92
False,8317059,Kippenheim,3 -  6 Jahre,198,100,98
False,8317059,Kippenheim,6 - 10 Jahre,275,134,141
False,8317059,Kippenheim,10 - 15 Jahre,311,155,156
False,8317059,Kippenheim,15 - 18 Jahre,181,86,95
False,8317059,Kippenheim,18 - 20 Jahre,139,71,68
False,8317059,Kippenheim,20 - 25 Jahre,329,173,156
False,8317059,Kippenheim,25 - 30 Jahre,417,228,189
False,8317059,Kippenheim,30 - 35 Jahre,466,222,244
False,8317059,Kippenheim,35 - 40 Jahre,395,211,184
False,8317059,Kippenheim,40 - 45 Jahre,398,212,186
False,8317059,Kippenheim,45 - 50 Jahre,303,165,138
False,8317059,Kippenheim,50 - 55 Jahre,276,139,137
False,8317059,Kippenheim,55 - 60 Jahre,357,185,172
False,8317059,Kippenheim,60 - 65 Jahre,287,134,153
False,8317059,Kippenheim,65 - 75 Jahre,421,180,241
False,8317059,Kippenheim,75 und mehr Jahre,235,61,174
False,8317059,Kippenheim,Insgesamt,5184,2560,2624
False,8317065,"Lahr/Schwarzwald, Stadt",unter 3 Jahre,1427,702,725
False,8317065,"Lahr/Schwarzwald, Stadt",3 -  6 Jahre,1483,753,730
False,8317065,"Lahr/Schwarzwald, Stadt",6 - 10 Jahre,2065,1028,1037
False,8317065,"Lahr/Schwarzwald, Stadt",10 - 15 Jahre,2474,1237,1237
False,8317065,"Lahr/Schwarzwald, Stadt",15 - 18 Jahre,1486,730,756
False,8317065,"Lahr/Schwarzwald, Stadt",18 - 20 Jahre,953,472,481
False,8317065,"Lahr/Schwarzwald, Stadt",20 - 25 Jahre,2674,1358,1316
False,8317065,"Lahr/Schwarzwald, Stadt",25 - 30 Jahre,3559,1839,1720
False,8317065,"Lahr/Schwarzwald, Stadt",30 - 35 Jahre,3600,1904,1696
False,8317065,"Lahr/Schwarzwald, Stadt",35 - 40 Jahre,3135,1598,1537
False,8317065,"Lahr/Schwarzwald, Stadt",40 - 45 Jahre,2829,1428,1401
False,8317065,"Lahr/Schwarzwald, Stadt",45 - 50 Jahre,2385,1207,1178
False,8317065,"Lahr/Schwarzwald, Stadt",50 - 55 Jahre,2177,1086,1091
False,8317065,"Lahr/Schwarzwald, Stadt",55 - 60 Jahre,2876,1411,1465
False,8317065,"Lahr/Schwarzwald, Stadt",60 - 65 Jahre,2153,1025,1128
False,8317065,"Lahr/Schwarzwald, Stadt",65 - 75 Jahre,3830,1510,2320
False,8317065,"Lahr/Schwarzwald, Stadt",75 und mehr Jahre,2915,828,2087
False,8317065,"Lahr/Schwarzwald, Stadt",Insgesamt,42021,20116,21905
False,8317067,Lautenbach,unter 3 Jahre,61,31,30
False,8317067,Lautenbach,3 -  6 Jahre,47,26,21
False,8317067,Lautenbach,6 - 10 Jahre,88,49,39
False,8317067,Lautenbach,10 - 15 Jahre,125,68,57
False,8317067,Lautenbach,15 - 18 Jahre,62,38,24
False,8317067,Lautenbach,18 - 20 Jahre,46,22,24
False,8317067,Lautenbach,20 - 25 Jahre,113,66,47
False,8317067,Lautenbach,25 - 30 Jahre,165,95,70
False,8317067,Lautenbach,30 - 35 Jahre,159,77,82
False,8317067,Lautenbach,35 - 40 Jahre,148,79,69
False,8317067,Lautenbach,40 - 45 Jahre,122,61,61
False,8317067,Lautenbach,45 - 50 Jahre,128,74,54
False,8317067,Lautenbach,50 - 55 Jahre,89,41,48
False,8317067,Lautenbach,55 - 60 Jahre,139,70,69
False,8317067,Lautenbach,60 - 65 Jahre,131,61,70
False,8317067,Lautenbach,65 - 75 Jahre,143,67,76
False,8317067,Lautenbach,75 und mehr Jahre,111,37,74
False,8317067,Lautenbach,Insgesamt,1877,962,915
False,8317068,Lauf,unter 3 Jahre,149,78,71
False,8317068,Lauf,3 -  6 Jahre,149,82,67
False,8317068,Lauf,6 - 10 Jahre,192,104,88
False,8317068,Lauf,10 - 15 Jahre,214,119,95
False,8317068,Lauf,15 - 18 Jahre,128,68,60
False,8317068,Lauf,18 - 20 Jahre,81,41,40
False,8317068,Lauf,20 - 25 Jahre,230,113,117
False,8317068,Lauf,25 - 30 Jahre,266,135,131
False,8317068,Lauf,30 - 35 Jahre,346,174,172
False,8317068,Lauf,35 - 40 Jahre,307,149,158
False,8317068,Lauf,40 - 45 Jahre,292,140,152
False,8317068,Lauf,45 - 50 Jahre,241,121,120
False,8317068,Lauf,50 - 55 Jahre,213,106,107
False,8317068,Lauf,55 - 60 Jahre,284,148,136
False,8317068,Lauf,60 - 65 Jahre,194,80,114
False,8317068,Lauf,65 - 75 Jahre,420,179,241
False,8317068,Lauf,75 und mehr Jahre,223,55,168
False,8317068,Lauf,Insgesamt,3929,1892,2037
False,8317073,"Mahlberg, Stadt",unter 3 Jahre,178,103,75
False,8317073,"Mahlberg, Stadt",3 -  6 Jahre,203,91,112
False,8317073,"Mahlberg, Stadt",6 - 10 Jahre,271,133,138
False,8317073,"Mahlberg, Stadt",10 - 15 Jahre,291,153,138
False,8317073,"Mahlberg, Stadt",15 - 18 Jahre,154,76,78
False,8317073,"Mahlberg, Stadt",18 - 20 Jahre,100,50,50
False,8317073,"Mahlberg, Stadt",20 - 25 Jahre,253,116,137
False,8317073,"Mahlberg, Stadt",25 - 30 Jahre,375,186,189
False,8317073,"Mahlberg, Stadt",30 - 35 Jahre,482,241,241
False,8317073,"Mahlberg, Stadt",35 - 40 Jahre,409,207,202
False,8317073,"Mahlberg, Stadt",40 - 45 Jahre,298,161,137
False,8317073,"Mahlberg, Stadt",45 - 50 Jahre,252,129,123
False,8317073,"Mahlberg, Stadt",50 - 55 Jahre,193,106,87
False,8317073,"Mahlberg, Stadt",55 - 60 Jahre,252,108,144
False,8317073,"Mahlberg, Stadt",60 - 65 Jahre,170,83,87
False,8317073,"Mahlberg, Stadt",65 - 75 Jahre,317,133,184
False,8317073,"Mahlberg, Stadt",75 und mehr Jahre,184,58,126
False,8317073,"Mahlberg, Stadt",Insgesamt,4382,2134,2248
False,8317075,Meißenheim,unter 3 Jahre,132,62,70
False,8317075,Meißenheim,3 -  6 Jahre,145,78,67
False,8317075,Meißenheim,6 - 10 Jahre,191,99,92
False,8317075,Meißenheim,10 - 15 Jahre,184,84,100
False,8317075,Meißenheim,15 - 18 Jahre,113,63,50
False,8317075,Meißenheim,18 - 20 Jahre,61,37,24
False,8317075,Meißenheim,20 - 25 Jahre,163,86,77
False,8317075,Meißenheim,25 - 30 Jahre,331,187,144
False,8317075,Meißenheim,30 - 35 Jahre,324,171,153
False,8317075,Meißenheim,35 - 40 Jahre,296,148,148
False,8317075,Meißenheim,40 - 45 Jahre,263,136,127
False,8317075,Meißenheim,45 - 50 Jahre,216,111,105
False,8317075,Meißenheim,50 - 55 Jahre,175,91,84
False,8317075,Meißenheim,55 - 60 Jahre,243,117,126
False,8317075,Meißenheim,60 - 65 Jahre,188,92,96
False,8317075,Meißenheim,65 - 75 Jahre,321,130,191
False,8317075,Meißenheim,75 und mehr Jahre,191,55,136
False,8317075,Meißenheim,Insgesamt,3537,1747,1790
False,8317078,Mühlenbach,unter 3 Jahre,65,28,37
False,8317078,Mühlenbach,3 -  6 Jahre,71,41,30
False,8317078,Mühlenbach,6 - 10 Jahre,101,41,60
False,8317078,Mühlenbach,10 - 15 Jahre,105,51,54
False,8317078,Mühlenbach,15 - 18 Jahre,63,30,33
False,8317078,Mühlenbach,18 - 20 Jahre,39,22,17
False,8317078,Mühlenbach,20 - 25 Jahre,127,69,58
False,8317078,Mühlenbach,25 - 30 Jahre,145,73,72
False,8317078,Mühlenbach,30 - 35 Jahre,140,72,68
False,8317078,Mühlenbach,35 - 40 Jahre,118,73,45
False,8317078,Mühlenbach,40 - 45 Jahre,103,59,44
False,8317078,Mühlenbach,45 - 50 Jahre,67,32,35
False,8317078,Mühlenbach,50 - 55 Jahre,55,27,28
False,8317078,Mühlenbach,55 - 60 Jahre,113,56,57
False,8317078,Mühlenbach,60 - 65 Jahre,82,47,35
False,8317078,Mühlenbach,65 - 75 Jahre,131,60,71
False,8317078,Mühlenbach,75 und mehr Jahre,76,21,55
False,8317078,Mühlenbach,Insgesamt,1601,802,799
False,8317085,Nordrach,unter 3 Jahre,76,38,38
False,8317085,Nordrach,3 -  6 Jahre,68,33,35
False,8317085,Nordrach,6 - 10 Jahre,94,52,42
False,8317085,Nordrach,10 - 15 Jahre,113,68,45
False,8317085,Nordrach,15 - 18 Jahre,53,25,28
False,8317085,Nordrach,18 - 20 Jahre,42,21,21
False,8317085,Nordrach,20 - 25 Jahre,103,51,52
False,8317085,Nordrach,25 - 30 Jahre,180,100,80
False,8317085,Nordrach,30 - 35 Jahre,158,84,74
False,8317085,Nordrach,35 - 40 Jahre,168,94,74
False,8317085,Nordrach,40 - 45 Jahre,127,69,58
False,8317085,Nordrach,45 - 50 Jahre,122,59,63
False,8317085,Nordrach,50 - 55 Jahre,110,61,49
False,8317085,Nordrach,55 - 60 Jahre,180,91,89
False,8317085,Nordrach,60 - 65 Jahre,117,67,50
False,8317085,Nordrach,65 - 75 Jahre,180,79,101
False,8317085,Nordrach,75 und mehr Jahre,107,43,64
False,8317085,Nordrach,Insgesamt,1998,1035,963
False,8317088,Oberharmersbach,unter 3 Jahre,112,57,55
False,8317088,Oberharmersbach,3 -  6 Jahre,133,64,69
False,8317088,Oberharmersbach,6 - 10 Jahre,168,87,81
False,8317088,Oberharmersbach,10 - 15 Jahre,164,91,73
False,8317088,Oberharmersbach,15 - 18 Jahre,73,33,40
False,8317088,Oberharmersbach,18 - 20 Jahre,54,35,19
False,8317088,Oberharmersbach,20 - 25 Jahre,161,67,94
False,8317088,Oberharmersbach,25 - 30 Jahre,219,113,106
False,8317088,Oberharmersbach,30 - 35 Jahre,255,136,119
False,8317088,Oberharmersbach,35 - 40 Jahre,198,110,88
False,8317088,Oberharmersbach,40 - 45 Jahre,157,88,69
False,8317088,Oberharmersbach,45 - 50 Jahre,122,61,61
False,8317088,Oberharmersbach,50 - 55 Jahre,90,46,44
False,8317088,Oberharmersbach,55 - 60 Jahre,172,85,87
False,8317088,Oberharmersbach,60 - 65 Jahre,127,62,65
False,8317088,Oberharmersbach,65 - 75 Jahre,206,82,124
False,8317088,Oberharmersbach,75 und mehr Jahre,130,42,88
False,8317088,Oberharmersbach,Insgesamt,2541,1259,1282
False,8317089,"Oberkirch, Stadt",unter 3 Jahre,709,358,351
False,8317089,"Oberkirch, Stadt",3 -  6 Jahre,842,440,402
False,8317089,"Oberkirch, Stadt",6 - 10 Jahre,1118,567,551
False,8317089,"Oberkirch, Stadt",10 - 15 Jahre,1205,634,571
False,8317089,"Oberkirch, Stadt",15 - 18 Jahre,619,323,296
False,8317089,"Oberkirch, Stadt",18 - 20 Jahre,396,197,199
False,8317089,"Oberkirch, Stadt",20 - 25 Jahre,1072,521,551
False,8317089,"Oberkirch, Stadt",25 - 30 Jahre,1538,766,772
False,8317089,"Oberkirch, Stadt",30 - 35 Jahre,1654,844,810
False,8317089,"Oberkirch, Stadt",35 - 40 Jahre,1497,782,715
False,8317089,"Oberkirch, Stadt",40 - 45 Jahre,1292,668,624
False,8317089,"Oberkirch, Stadt",45 - 50 Jahre,1037,538,499
False,8317089,"Oberkirch, Stadt",50 - 55 Jahre,924,475,449
False,8317089,"Oberkirch, Stadt",55 - 60 Jahre,1222,612,610
False,8317089,"Oberkirch, Stadt",60 - 65 Jahre,972,481,491
False,8317089,"Oberkirch, Stadt",65 - 75 Jahre,1716,697,1019
False,8317089,"Oberkirch, Stadt",75 und mehr Jahre,1122,357,765
False,8317089,"Oberkirch, Stadt",Insgesamt,18935,9260,9675
False,8317093,Oberwolfach,unter 3 Jahre,113,61,52
False,8317093,Oberwolfach,3 -  6 Jahre,76,42,34
False,8317093,Oberwolfach,6 - 10 Jahre,114,50,64
False,8317093,Oberwolfach,10 - 15 Jahre,203,104,99
False,8317093,Oberwolfach,15 - 18 Jahre,105,48,57
False,8317093,Oberwolfach,18 - 20 Jahre,70,42,28
False,8317093,Oberwolfach,20 - 25 Jahre,176,97,79
False,8317093,Oberwolfach,25 - 30 Jahre,217,112,105
False,8317093,Oberwolfach,30 - 35 Jahre,232,136,96
False,8317093,Oberwolfach,35 - 40 Jahre,178,80,98
False,8317093,Oberwolfach,40 - 45 Jahre,153,75,78
False,8317093,Oberwolfach,45 - 50 Jahre,127,67,60
False,8317093,Oberwolfach,50 - 55 Jahre,153,84,69
False,8317093,Oberwolfach,55 - 60 Jahre,187,97,90
False,8317093,Oberwolfach,60 - 65 Jahre,145,72,73
False,8317093,Oberwolfach,65 - 75 Jahre,252,116,136
False,8317093,Oberwolfach,75 und mehr Jahre,156,46,110
False,8317093,Oberwolfach,Insgesamt,2657,1329,1328
False,8317096,"Offenburg, Stadt",unter 3 Jahre,1854,970,884
False,8317096,"Offenburg, Stadt",3 -  6 Jahre,1906,1002,904
False,8317096,"Offenburg, Stadt",6 - 10 Jahre,2528,1343,1185
False,8317096,"Offenburg, Stadt",10 - 15 Jahre,2828,1443,1385
False,8317096,"Offenburg, Stadt",15 - 18 Jahre,1787,901,886
False,8317096,"Offenburg, Stadt",18 - 20 Jahre,1238,616,622
False,8317096,"Offenburg, Stadt",20 - 25 Jahre,3433,1706,1727
False,8317096,"Offenburg, Stadt",25 - 30 Jahre,4527,2334,2193
False,8317096,"Offenburg, Stadt",30 - 35 Jahre,4687,2380,2307
False,8317096,"Offenburg, Stadt",35 - 40 Jahre,4268,2163,2105
False,8317096,"Offenburg, Stadt",40 - 45 Jahre,3901,1921,1980
False,8317096,"Offenburg, Stadt",45 - 50 Jahre,3392,1673,1719
False,8317096,"Offenburg, Stadt",50 - 55 Jahre,3334,1657,1677
False,8317096,"Offenburg, Stadt",55 - 60 Jahre,4046,1974,2072
False,8317096,"Offenburg, Stadt",60 - 65 Jahre,2954,1405,1549
False,8317096,"Offenburg, Stadt",65 - 75 Jahre,5363,2138,3225
False,8317096,"Offenburg, Stadt",75 und mehr Jahre,3999,1188,2811
False,8317096,"Offenburg, Stadt",Insgesamt,56045,26814,29231
False,8317097,Ohlsbach,unter 3 Jahre,94,48,46
False,8317097,Ohlsbach,3 -  6 Jahre,99,54,45
False,8317097,Ohlsbach,6 - 10 Jahre,136,71,65
False,8317097,Ohlsbach,10 - 15 Jahre,155,88,67
False,8317097,Ohlsbach,15 - 18 Jahre,78,41,37
False,8317097,Ohlsbach,18 - 20 Jahre,53,23,30
False,8317097,Ohlsbach,20 - 25 Jahre,155,75,80
False,8317097,Ohlsbach,25 - 30 Jahre,257,136,121
False,8317097,Ohlsbach,30 - 35 Jahre,242,121,121
False,8317097,Ohlsbach,35 - 40 Jahre,220,122,98
False,8317097,Ohlsbach,40 - 45 Jahre,192,91,101
False,8317097,Ohlsbach,45 - 50 Jahre,167,83,84
False,8317097,Ohlsbach,50 - 55 Jahre,149,80,69
False,8317097,Ohlsbach,55 - 60 Jahre,183,92,91
False,8317097,Ohlsbach,60 - 65 Jahre,141,70,71
False,8317097,Ohlsbach,65 - 75 Jahre,223,107,116
False,8317097,Ohlsbach,75 und mehr Jahre,152,52,100
False,8317097,Ohlsbach,Insgesamt,2696,1354,1342
False,8317098,"Oppenau, Stadt",unter 3 Jahre,185,97,88
False,8317098,"Oppenau, Stadt",3 -  6 Jahre,215,107,108
False,8317098,"Oppenau, Stadt",6 - 10 Jahre,291,144,147
False,8317098,"Oppenau, Stadt",10 - 15 Jahre,313,171,142
False,8317098,"Oppenau, Stadt",15 - 18 Jahre,167,85,82
False,8317098,"Oppenau, Stadt",18 - 20 Jahre,115,66,49
False,8317098,"Oppenau, Stadt",20 - 25 Jahre,291,158,133
False,8317098,"Oppenau, Stadt",25 - 30 Jahre,429,244,185
False,8317098,"Oppenau, Stadt",30 - 35 Jahre,441,227,214
False,8317098,"Oppenau, Stadt",35 - 40 Jahre,375,188,187
False,8317098,"Oppenau, Stadt",40 - 45 Jahre,360,192,168
False,8317098,"Oppenau, Stadt",45 - 50 Jahre,283,148,135
False,8317098,"Oppenau, Stadt",50 - 55 Jahre,223,109,114
False,8317098,"Oppenau, Stadt",55 - 60 Jahre,399,201,198
False,8317098,"Oppenau, Stadt",60 - 65 Jahre,277,139,138
False,8317098,"Oppenau, Stadt",65 - 75 Jahre,540,220,320
False,8317098,"Oppenau, Stadt",75 und mehr Jahre,419,108,311
False,8317098,"Oppenau, Stadt",Insgesamt,5323,2604,2719
False,8317100,Ortenberg,unter 3 Jahre,102,57,45
False,8317100,Ortenberg,3 -  6 Jahre,96,42,54
False,8317100,Ortenberg,6 - 10 Jahre,138,64,74
False,8317100,Ortenberg,10 - 15 Jahre,144,75,69
False,8317100,Ortenberg,15 - 18 Jahre,88,42,46
False,8317100,Ortenberg,18 - 20 Jahre,68,31,37
False,8317100,Ortenberg,20 - 25 Jahre,154,64,90
False,8317100,Ortenberg,25 - 30 Jahre,249,141,108
False,8317100,Ortenberg,30 - 35 Jahre,292,152,140
False,8317100,Ortenberg,35 - 40 Jahre,217,122,95
False,8317100,Ortenberg,40 - 45 Jahre,230,107,123
False,8317100,Ortenberg,45 - 50 Jahre,167,84,83
False,8317100,Ortenberg,50 - 55 Jahre,170,87,83
False,8317100,Ortenberg,55 - 60 Jahre,218,103,115
False,8317100,Ortenberg,60 - 65 Jahre,175,87,88
False,8317100,Ortenberg,65 - 75 Jahre,312,127,185
False,8317100,Ortenberg,75 und mehr Jahre,202,67,135
False,8317100,Ortenberg,Insgesamt,3022,1452,1570
False,8317102,Ottenhöfen im Schwarzwald,unter 3 Jahre,126,64,62
False,8317102,Ottenhöfen im Schwarzwald,3 -  6 Jahre,140,64,76
False,8317102,Ottenhöfen im Schwarzwald,6 - 10 Jahre,189,106,83
False,8317102,Ottenhöfen im Schwarzwald,10 - 15 Jahre,224,107,117
False,8317102,Ottenhöfen im Schwarzwald,15 - 18 Jahre,117,60,57
False,8317102,Ottenhöfen im Schwarzwald,18 - 20 Jahre,67,45,22
False,8317102,Ottenhöfen im Schwarzwald,20 - 25 Jahre,179,88,91
False,8317102,Ottenhöfen im Schwarzwald,25 - 30 Jahre,289,155,134
False,8317102,Ottenhöfen im Schwarzwald,30 - 35 Jahre,302,160,142
False,8317102,Ottenhöfen im Schwarzwald,35 - 40 Jahre,236,130,106
False,8317102,Ottenhöfen im Schwarzwald,40 - 45 Jahre,173,89,84
False,8317102,Ottenhöfen im Schwarzwald,45 - 50 Jahre,172,87,85
False,8317102,Ottenhöfen im Schwarzwald,50 - 55 Jahre,161,79,82
False,8317102,Ottenhöfen im Schwarzwald,55 - 60 Jahre,242,116,126
False,8317102,Ottenhöfen im Schwarzwald,60 - 65 Jahre,174,90,84
False,8317102,Ottenhöfen im Schwarzwald,65 - 75 Jahre,338,138,200
False,8317102,Ottenhöfen im Schwarzwald,75 und mehr Jahre,227,69,158
False,8317102,Ottenhöfen im Schwarzwald,Insgesamt,3356,1647,1709
False,8317110,"Renchen, Stadt",unter 3 Jahre,266,118,148
False,8317110,"Renchen, Stadt",3 -  6 Jahre,270,132,138
False,8317110,"Renchen, Stadt",6 - 10 Jahre,385,191,194
False,8317110,"Renchen, Stadt",10 - 15 Jahre,397,210,187
False,8317110,"Renchen, Stadt",15 - 18 Jahre,199,99,100
False,8317110,"Renchen, Stadt",18 - 20 Jahre,139,82,57
False,8317110,"Renchen, Stadt",20 - 25 Jahre,381,187,194
False,8317110,"Renchen, Stadt",25 - 30 Jahre,555,278,277
False,8317110,"Renchen, Stadt",30 - 35 Jahre,644,321,323
False,8317110,"Renchen, Stadt",35 - 40 Jahre,554,283,271
False,8317110,"Renchen, Stadt",40 - 45 Jahre,489,248,241
False,8317110,"Renchen, Stadt",45 - 50 Jahre,369,199,170
False,8317110,"Renchen, Stadt",50 - 55 Jahre,327,169,158
False,8317110,"Renchen, Stadt",55 - 60 Jahre,423,202,221
False,8317110,"Renchen, Stadt",60 - 65 Jahre,341,173,168
False,8317110,"Renchen, Stadt",65 - 75 Jahre,593,245,348
False,8317110,"Renchen, Stadt",75 und mehr Jahre,378,119,259
False,8317110,"Renchen, Stadt",Insgesamt,6710,3256,3454
False,8317113,Ringsheim,unter 3 Jahre,61,33,28
False,8317113,Ringsheim,3 -  6 Jahre,62,31,31
False,8317113,Ringsheim,6 - 10 Jahre,102,51,51
False,8317113,Ringsheim,10 - 15 Jahre,128,58,70
False,8317113,Ringsheim,15 - 18 Jahre,70,34,36
False,8317113,Ringsheim,18 - 20 Jahre,51,25,26
False,8317113,Ringsheim,20 - 25 Jahre,115,55,60
False,8317113,Ringsheim,25 - 30 Jahre,175,89,86
False,8317113,Ringsheim,30 - 35 Jahre,192,104,88
False,8317113,Ringsheim,35 - 40 Jahre,162,84,78
False,8317113,Ringsheim,40 - 45 Jahre,165,89,76
False,8317113,Ringsheim,45 - 50 Jahre,128,65,63
False,8317113,Ringsheim,50 - 55 Jahre,105,54,51
False,8317113,Ringsheim,55 - 60 Jahre,184,94,90
False,8317113,Ringsheim,60 - 65 Jahre,117,56,61
False,8317113,Ringsheim,65 - 75 Jahre,186,71,115
False,8317113,Ringsheim,75 und mehr Jahre,123,44,79
False,8317113,Ringsheim,Insgesamt,2126,1037,1089
False,8317114,Rust,unter 3 Jahre,116,55,61
False,8317114,Rust,3 -  6 Jahre,115,65,50
False,8317114,Rust,6 - 10 Jahre,162,82,80
False,8317114,Rust,10 - 15 Jahre,201,100,101
False,8317114,Rust,15 - 18 Jahre,116,62,54
False,8317114,Rust,18 - 20 Jahre,75,30,45
False,8317114,Rust,20 - 25 Jahre,207,108,99
False,8317114,Rust,25 - 30 Jahre,296,150,146
False,8317114,Rust,30 - 35 Jahre,293,142,151
False,8317114,Rust,35 - 40 Jahre,262,142,120
False,8317114,Rust,40 - 45 Jahre,210,113,97
False,8317114,Rust,45 - 50 Jahre,218,122,96
False,8317114,Rust,50 - 55 Jahre,150,83,67
False,8317114,Rust,55 - 60 Jahre,174,83,91
False,8317114,Rust,60 - 65 Jahre,169,84,85
False,8317114,Rust,65 - 75 Jahre,224,84,140
False,8317114,Rust,75 und mehr Jahre,134,42,92
False,8317114,Rust,Insgesamt,3122,1547,1575
False,8317116,Sasbach,unter 3 Jahre,161,84,77
False,8317116,Sasbach,3 -  6 Jahre,180,85,95
False,8317116,Sasbach,6 - 10 Jahre,268,144,124
False,8317116,Sasbach,10 - 15 Jahre,319,172,147
False,8317116,Sasbach,15 - 18 Jahre,224,135,89
False,8317116,Sasbach,18 - 20 Jahre,127,77,50
False,8317116,Sasbach,20 - 25 Jahre,353,199,154
False,8317116,Sasbach,25 - 30 Jahre,478,273,205
False,8317116,Sasbach,30 - 35 Jahre,490,284,206
False,8317116,Sasbach,35 - 40 Jahre,386,206,180
False,8317116,Sasbach,40 - 45 Jahre,354,180,174
False,8317116,Sasbach,45 - 50 Jahre,298,150,148
False,8317116,Sasbach,50 - 55 Jahre,263,123,140
False,8317116,Sasbach,55 - 60 Jahre,334,166,168
False,8317116,Sasbach,60 - 65 Jahre,263,119,144
False,8317116,Sasbach,65 - 75 Jahre,490,198,292
False,8317116,Sasbach,75 und mehr Jahre,340,58,282
False,8317116,Sasbach,Insgesamt,5328,2653,2675
False,8317118,Sasbachwalden,unter 3 Jahre,83,38,45
False,8317118,Sasbachwalden,3 -  6 Jahre,73,39,34
False,8317118,Sasbachwalden,6 - 10 Jahre,100,53,47
False,8317118,Sasbachwalden,10 - 15 Jahre,104,49,55
False,8317118,Sasbachwalden,15 - 18 Jahre,65,30,35
False,8317118,Sasbachwalden,18 - 20 Jahre,45,21,24
False,8317118,Sasbachwalden,20 - 25 Jahre,131,76,55
False,8317118,Sasbachwalden,25 - 30 Jahre,229,114,115
False,8317118,Sasbachwalden,30 - 35 Jahre,205,106,99
False,8317118,Sasbachwalden,35 - 40 Jahre,183,97,86
False,8317118,Sasbachwalden,40 - 45 Jahre,174,83,91
False,8317118,Sasbachwalden,45 - 50 Jahre,147,73,74
False,8317118,Sasbachwalden,50 - 55 Jahre,129,60,69
False,8317118,Sasbachwalden,55 - 60 Jahre,203,102,101
False,8317118,Sasbachwalden,60 - 65 Jahre,125,62,63
False,8317118,Sasbachwalden,65 - 75 Jahre,221,84,137
False,8317118,Sasbachwalden,75 und mehr Jahre,156,55,101
False,8317118,Sasbachwalden,Insgesamt,2373,1142,1231
False,8317121,Schuttertal,unter 3 Jahre,143,79,64
False,8317121,Schuttertal,3 -  6 Jahre,140,68,72
False,8317121,Schuttertal,6 - 10 Jahre,212,114,98
False,8317121,Schuttertal,10 - 15 Jahre,208,118,90
False,8317121,Schuttertal,15 - 18 Jahre,112,59,53
False,8317121,Schuttertal,18 - 20 Jahre,77,33,44
False,8317121,Schuttertal,20 - 25 Jahre,208,110,98
False,8317121,Schuttertal,25 - 30 Jahre,313,172,141
False,8317121,Schuttertal,30 - 35 Jahre,360,197,163
False,8317121,Schuttertal,35 - 40 Jahre,279,151,128
False,8317121,Schuttertal,40 - 45 Jahre,192,108,84
False,8317121,Schuttertal,45 - 50 Jahre,160,95,65
False,8317121,Schuttertal,50 - 55 Jahre,138,65,73
False,8317121,Schuttertal,55 - 60 Jahre,222,106,116
False,8317121,Schuttertal,60 - 65 Jahre,179,97,82
False,8317121,Schuttertal,65 - 75 Jahre,294,117,177
False,8317121,Schuttertal,75 und mehr Jahre,178,52,126
False,8317121,Schuttertal,Insgesamt,3415,1741,1674
False,8317122,Schutterwald,unter 3 Jahre,249,134,115
False,8317122,Schutterwald,3 -  6 Jahre,279,156,123
False,8317122,Schutterwald,6 - 10 Jahre,328,186,142
False,8317122,Schutterwald,10 - 15 Jahre,376,203,173
False,8317122,Schutterwald,15 - 18 Jahre,172,102,70
False,8317122,Schutterwald,18 - 20 Jahre,132,71,61
False,8317122,Schutterwald,20 - 25 Jahre,389,194,195
False,8317122,Schutterwald,25 - 30 Jahre,536,279,257
False,8317122,Schutterwald,30 - 35 Jahre,633,317,316
False,8317122,Schutterwald,35 - 40 Jahre,589,324,265
False,8317122,Schutterwald,40 - 45 Jahre,508,245,263
False,8317122,Schutterwald,45 - 50 Jahre,439,233,206
False,8317122,Schutterwald,50 - 55 Jahre,380,191,189
False,8317122,Schutterwald,55 - 60 Jahre,537,277,260
False,8317122,Schutterwald,60 - 65 Jahre,378,196,182
False,8317122,Schutterwald,65 - 75 Jahre,544,237,307
False,8317122,Schutterwald,75 und mehr Jahre,375,114,261
False,8317122,Schutterwald,Insgesamt,6844,3459,3385
False,8317126,Seebach,unter 3 Jahre,57,39,18
False,8317126,Seebach,3 -  6 Jahre,55,21,34
False,8317126,Seebach,6 - 10 Jahre,71,32,39
False,8317126,Seebach,10 - 15 Jahre,90,46,44
False,8317126,Seebach,15 - 18 Jahre,56,27,29
False,8317126,Seebach,18 - 20 Jahre,37,20,17
False,8317126,Seebach,20 - 25 Jahre,93,49,44
False,8317126,Seebach,25 - 30 Jahre,132,75,57
False,8317126,Seebach,30 - 35 Jahre,140,67,73
False,8317126,Seebach,35 - 40 Jahre,110,63,47
False,8317126,Seebach,40 - 45 Jahre,94,55,39
False,8317126,Seebach,45 - 50 Jahre,70,32,38
False,8317126,Seebach,50 - 55 Jahre,54,29,25
False,8317126,Seebach,55 - 60 Jahre,119,61,58
False,8317126,Seebach,60 - 65 Jahre,92,38,54
False,8317126,Seebach,65 - 75 Jahre,127,61,66
False,8317126,Seebach,75 und mehr Jahre,89,22,67
False,8317126,Seebach,Insgesamt,1486,737,749
False,8317127,Seelbach,unter 3 Jahre,166,69,97
False,8317127,Seelbach,3 -  6 Jahre,162,82,80
False,8317127,Seelbach,6 - 10 Jahre,259,135,124
False,8317127,Seelbach,10 - 15 Jahre,294,147,147
False,8317127,Seelbach,15 - 18 Jahre,194,92,102
False,8317127,Seelbach,18 - 20 Jahre,122,68,54
False,8317127,Seelbach,20 - 25 Jahre,280,166,114
False,8317127,Seelbach,25 - 30 Jahre,293,134,159
False,8317127,Seelbach,30 - 35 Jahre,452,237,215
False,8317127,Seelbach,35 - 40 Jahre,394,194,200
False,8317127,Seelbach,40 - 45 Jahre,341,169,172
False,8317127,Seelbach,45 - 50 Jahre,327,175,152
False,8317127,Seelbach,50 - 55 Jahre,292,159,133
False,8317127,Seelbach,55 - 60 Jahre,388,193,195
False,8317127,Seelbach,60 - 65 Jahre,254,121,133
False,8317127,Seelbach,65 - 75 Jahre,473,197,276
False,8317127,Seelbach,75 und mehr Jahre,302,101,201
False,8317127,Seelbach,Insgesamt,4993,2439,2554
False,8317129,Steinach,unter 3 Jahre,143,72,71
False,8317129,Steinach,3 -  6 Jahre,144,74,70
False,8317129,Steinach,6 - 10 Jahre,226,114,112
False,8317129,Steinach,10 - 15 Jahre,230,117,113
False,8317129,Steinach,15 - 18 Jahre,127,64,63
False,8317129,Steinach,18 - 20 Jahre,82,46,36
False,8317129,Steinach,20 - 25 Jahre,247,129,118
False,8317129,Steinach,25 - 30 Jahre,304,169,135
False,8317129,Steinach,30 - 35 Jahre,381,198,183
False,8317129,Steinach,35 - 40 Jahre,314,176,138
False,8317129,Steinach,40 - 45 Jahre,267,133,134
False,8317129,Steinach,45 - 50 Jahre,175,97,78
False,8317129,Steinach,50 - 55 Jahre,165,86,79
False,8317129,Steinach,55 - 60 Jahre,268,137,131
False,8317129,Steinach,60 - 65 Jahre,190,89,101
False,8317129,Steinach,65 - 75 Jahre,340,142,198
False,8317129,Steinach,75 und mehr Jahre,204,67,137
False,8317129,Steinach,Insgesamt,3807,1910,1897
False,8317141,Willstätt,unter 3 Jahre,306,155,151
False,8317141,Willstätt,3 -  6 Jahre,343,182,161
False,8317141,Willstätt,6 - 10 Jahre,449,240,209
False,8317141,Willstätt,10 - 15 Jahre,522,248,274
False,8317141,Willstätt,15 - 18 Jahre,257,127,130
False,8317141,Willstätt,18 - 20 Jahre,151,84,67
False,8317141,Willstätt,20 - 25 Jahre,545,284,261
False,8317141,Willstätt,25 - 30 Jahre,703,357,346
False,8317141,Willstätt,30 - 35 Jahre,800,443,357
False,8317141,Willstätt,35 - 40 Jahre,736,365,371
False,8317141,Willstätt,40 - 45 Jahre,704,365,339
False,8317141,Willstätt,45 - 50 Jahre,550,289,261
False,8317141,Willstätt,50 - 55 Jahre,461,232,229
False,8317141,Willstätt,55 - 60 Jahre,567,297,270
False,8317141,Willstätt,60 - 65 Jahre,468,243,225
False,8317141,Willstätt,65 - 75 Jahre,640,274,366
False,8317141,Willstätt,75 und mehr Jahre,372,117,255
False,8317141,Willstätt,Insgesamt,8574,4302,4272
False,8317145,"Wolfach, Stadt",unter 3 Jahre,176,93,83
False,8317145,"Wolfach, Stadt",3 -  6 Jahre,217,108,109
False,8317145,"Wolfach, Stadt",6 - 10 Jahre,262,132,130
False,8317145,"Wolfach, Stadt",10 - 15 Jahre,291,154,137
False,8317145,"Wolfach, Stadt",15 - 18 Jahre,199,90,109
False,8317145,"Wolfach, Stadt",18 - 20 Jahre,128,61,67
False,8317145,"Wolfach, Stadt",20 - 25 Jahre,348,197,151
False,8317145,"Wolfach, Stadt",25 - 30 Jahre,446,226,220
False,8317145,"Wolfach, Stadt",30 - 35 Jahre,547,326,221
False,8317145,"Wolfach, Stadt",35 - 40 Jahre,438,229,209
False,8317145,"Wolfach, Stadt",40 - 45 Jahre,419,203,216
False,8317145,"Wolfach, Stadt",45 - 50 Jahre,341,186,155
False,8317145,"Wolfach, Stadt",50 - 55 Jahre,336,162,174
False,8317145,"Wolfach, Stadt",55 - 60 Jahre,461,241,220
False,8317145,"Wolfach, Stadt",60 - 65 Jahre,332,160,172
False,8317145,"Wolfach, Stadt",65 - 75 Jahre,630,256,374
False,8317145,"Wolfach, Stadt",75 und mehr Jahre,499,151,348
False,8317145,"Wolfach, Stadt",Insgesamt,6070,2975,3095
False,8317146,"Zell am Harmersbach, Stadt",unter 3 Jahre,256,109,147
False,8317146,"Zell am Harmersbach, Stadt",3 -  6 Jahre,304,160,144
False,8317146,"Zell am Harmersbach, Stadt",6 - 10 Jahre,419,212,207
False,8317146,"Zell am Harmersbach, Stadt",10 - 15 Jahre,469,232,237
False,8317146,"Zell am Harmersbach, Stadt",15 - 18 Jahre,302,158,144
False,8317146,"Zell am Harmersbach, Stadt",18 - 20 Jahre,159,67,92
False,8317146,"Zell am Harmersbach, Stadt",20 - 25 Jahre,482,245,237
False,8317146,"Zell am Harmersbach, Stadt",25 - 30 Jahre,618,314,304
False,8317146,"Zell am Harmersbach, Stadt",30 - 35 Jahre,700,366,334
False,8317146,"Zell am Harmersbach, Stadt",35 - 40 Jahre,602,301,301
False,8317146,"Zell am Harmersbach, Stadt",40 - 45 Jahre,562,291,271
False,8317146,"Zell am Harmersbach, Stadt",45 - 50 Jahre,435,223,212
False,8317146,"Zell am Harmersbach, Stadt",50 - 55 Jahre,423,212,211
False,8317146,"Zell am Harmersbach, Stadt",55 - 60 Jahre,503,250,253
False,8317146,"Zell am Harmersbach, Stadt",60 - 65 Jahre,355,185,170
False,8317146,"Zell am Harmersbach, Stadt",65 - 75 Jahre,651,267,384
False,8317146,"Zell am Harmersbach, Stadt",75 und mehr Jahre,535,160,375
False,8317146,"Zell am Harmersbach, Stadt",Insgesamt,7775,3752,4023
False,8317150,Schwanau,unter 3 Jahre,203,91,112
False,8317150,Schwanau,3 -  6 Jahre,232,106,126
False,8317150,Schwanau,6 - 10 Jahre,324,153,171
False,8317150,Schwanau,10 - 15 Jahre,382,196,186
False,8317150,Schwanau,15 - 18 Jahre,205,104,101
False,8317150,Schwanau,18 - 20 Jahre,142,78,64
False,8317150,Schwanau,20 - 25 Jahre,325,142,183
False,8317150,Schwanau,25 - 30 Jahre,522,278,244
False,8317150,Schwanau,30 - 35 Jahre,579,300,279
False,8317150,Schwanau,35 - 40 Jahre,476,236,240
False,8317150,Schwanau,40 - 45 Jahre,440,227,213
False,8317150,Schwanau,45 - 50 Jahre,361,193,168
False,8317150,Schwanau,50 - 55 Jahre,295,152,143
False,8317150,Schwanau,55 - 60 Jahre,462,227,235
False,8317150,Schwanau,60 - 65 Jahre,358,175,183
False,8317150,Schwanau,65 - 75 Jahre,532,216,316
False,8317150,Schwanau,75 und mehr Jahre,461,89,372
False,8317150,Schwanau,Insgesamt,6299,2963,3336
False,8317151,Neuried,unter 3 Jahre,305,162,143
False,8317151,Neuried,3 -  6 Jahre,347,172,175
False,8317151,Neuried,6 - 10 Jahre,454,229,225
False,8317151,Neuried,10 - 15 Jahre,532,270,262
False,8317151,Neuried,15 - 18 Jahre,273,134,139
False,8317151,Neuried,18 - 20 Jahre,179,94,85
False,8317151,Neuried,20 - 25 Jahre,469,247,222
False,8317151,Neuried,25 - 30 Jahre,707,361,346
False,8317151,Neuried,30 - 35 Jahre,819,422,397
False,8317151,Neuried,35 - 40 Jahre,770,397,373
False,8317151,Neuried,40 - 45 Jahre,607,308,299
False,8317151,Neuried,45 - 50 Jahre,525,271,254
False,8317151,Neuried,50 - 55 Jahre,405,201,204
False,8317151,Neuried,55 - 60 Jahre,570,300,270
False,8317151,Neuried,60 - 65 Jahre,444,221,223
False,8317151,Neuried,65 - 75 Jahre,738,300,438
False,8317151,Neuried,75 und mehr Jahre,432,120,312
False,8317151,Neuried,Insgesamt,8576,4209,4367
False,8317152,Kappel-Grafenhausen,unter 3 Jahre,196,105,91
False,8317152,Kappel-Grafenhausen,3 -  6 Jahre,184,86,98
False,8317152,Kappel-Grafenhausen,6 - 10 Jahre,237,116,121
False,8317152,Kappel-Grafenhausen,10 - 15 Jahre,262,138,124
False,8317152,Kappel-Grafenhausen,15 - 18 Jahre,150,86,64
False,8317152,Kappel-Grafenhausen,18 - 20 Jahre,110,66,44
False,8317152,Kappel-Grafenhausen,20 - 25 Jahre,257,136,121
False,8317152,Kappel-Grafenhausen,25 - 30 Jahre,386,191,195
False,8317152,Kappel-Grafenhausen,30 - 35 Jahre,421,211,210
False,8317152,Kappel-Grafenhausen,35 - 40 Jahre,366,195,171
False,8317152,Kappel-Grafenhausen,40 - 45 Jahre,318,176,142
False,8317152,Kappel-Grafenhausen,45 - 50 Jahre,245,121,124
False,8317152,Kappel-Grafenhausen,50 - 55 Jahre,201,106,95
False,8317152,Kappel-Grafenhausen,55 - 60 Jahre,285,142,143
False,8317152,Kappel-Grafenhausen,60 - 65 Jahre,195,104,91
False,8317152,Kappel-Grafenhausen,65 - 75 Jahre,306,125,181
False,8317152,Kappel-Grafenhausen,75 und mehr Jahre,212,62,150
False,8317152,Kappel-Grafenhausen,Insgesamt,4331,2166,2165
False,8317153,"Rheinau, Stadt",unter 3 Jahre,384,178,206
False,8317153,"Rheinau, Stadt",3 -  6 Jahre,397,225,172
False,8317153,"Rheinau, Stadt",6 - 10 Jahre,531,277,254
False,8317153,"Rheinau, Stadt",10 - 15 Jahre,666,354,312
False,8317153,"Rheinau, Stadt",15 - 18 Jahre,340,175,165
False,8317153,"Rheinau, Stadt",18 - 20 Jahre,221,117,104
False,8317153,"Rheinau, Stadt",20 - 25 Jahre,560,297,263
False,8317153,"Rheinau, Stadt",25 - 30 Jahre,779,398,381
False,8317153,"Rheinau, Stadt",30 - 35 Jahre,960,483,477
False,8317153,"Rheinau, Stadt",35 - 40 Jahre,943,499,444
False,8317153,"Rheinau, Stadt",40 - 45 Jahre,797,412,385
False,8317153,"Rheinau, Stadt",45 - 50 Jahre,671,356,315
False,8317153,"Rheinau, Stadt",50 - 55 Jahre,530,278,252
False,8317153,"Rheinau, Stadt",55 - 60 Jahre,727,381,346
False,8317153,"Rheinau, Stadt",60 - 65 Jahre,577,282,295
False,8317153,"Rheinau, Stadt",65 - 75 Jahre,910,387,523
False,8317153,"Rheinau, Stadt",75 und mehr Jahre,538,172,366
False,8317153,"Rheinau, Stadt",Insgesamt,10531,5271,5260
False,8325,Landkreis Rottweil,unter 3 Jahre,5142,2660,2482
False,8325,Landkreis Rottweil,3 -  6 Jahre,5412,2785,2627
False,8325,Landkreis Rottweil,6 - 10 Jahre,7076,3459,3617
False,8325,Landkreis Rottweil,10 - 15 Jahre,8262,4224,4038
False,8325,Landkreis Rottweil,15 - 18 Jahre,4652,2381,2271
False,8325,Landkreis Rottweil,18 - 20 Jahre,3062,1620,1442
False,8325,Landkreis Rottweil,20 - 25 Jahre,8147,4330,3817
False,8325,Landkreis Rottweil,25 - 30 Jahre,11031,5812,5219
False,8325,Landkreis Rottweil,30 - 35 Jahre,11660,6039,5621
False,8325,Landkreis Rottweil,35 - 40 Jahre,10462,5424,5038
False,8325,Landkreis Rottweil,40 - 45 Jahre,8943,4519,4424
False,8325,Landkreis Rottweil,45 - 50 Jahre,7919,4020,3899
False,8325,Landkreis Rottweil,50 - 55 Jahre,7892,4047,3845
False,8325,Landkreis Rottweil,55 - 60 Jahre,9999,5028,4971
False,8325,Landkreis Rottweil,60 - 65 Jahre,7417,3616,3801
False,8325,Landkreis Rottweil,65 - 75 Jahre,12386,5139,7247
False,8325,Landkreis Rottweil,75 und mehr Jahre,9482,2723,6759
False,8325,Landkreis Rottweil,Insgesamt,138944,67826,71118
False,8325001,Aichhalden,unter 3 Jahre,157,79,78
False,8325001,Aichhalden,3 -  6 Jahre,185,96,89
False,8325001,Aichhalden,6 - 10 Jahre,224,115,109
False,8325001,Aichhalden,10 - 15 Jahre,259,153,106
False,8325001,Aichhalden,15 - 18 Jahre,137,66,71
False,8325001,Aichhalden,18 - 20 Jahre,99,52,47
False,8325001,Aichhalden,20 - 25 Jahre,230,133,97
False,8325001,Aichhalden,25 - 30 Jahre,306,160,146
False,8325001,Aichhalden,30 - 35 Jahre,343,172,171
False,8325001,Aichhalden,35 - 40 Jahre,331,171,160
False,8325001,Aichhalden,40 - 45 Jahre,233,121,112
False,8325001,Aichhalden,45 - 50 Jahre,236,122,114
False,8325001,Aichhalden,50 - 55 Jahre,228,116,112
False,8325001,Aichhalden,55 - 60 Jahre,302,159,143
False,8325001,Aichhalden,60 - 65 Jahre,222,113,109
False,8325001,Aichhalden,65 - 75 Jahre,348,134,214
False,8325001,Aichhalden,75 und mehr Jahre,241,82,159
False,8325001,Aichhalden,Insgesamt,4081,2044,2037
False,8325009,Bösingen,unter 3 Jahre,166,83,83
False,8325009,Bösingen,3 -  6 Jahre,158,72,86
False,8325009,Bösingen,6 - 10 Jahre,197,105,92
False,8325009,Bösingen,10 - 15 Jahre,217,106,111
False,8325009,Bösingen,15 - 18 Jahre,120,68,52
False,8325009,Bösingen,18 - 20 Jahre,81,46,35
False,8325009,Bösingen,20 - 25 Jahre,228,123,105
False,8325009,Bösingen,25 - 30 Jahre,300,171,129
False,8325009,Bösingen,30 - 35 Jahre,305,158,147
False,8325009,Bösingen,35 - 40 Jahre,269,142,127
False,8325009,Bösingen,40 - 45 Jahre,202,110,92
False,8325009,Bösingen,45 - 50 Jahre,174,87,87
False,8325009,Bösingen,50 - 55 Jahre,166,90,76
False,8325009,Bösingen,55 - 60 Jahre,190,91,99
False,8325009,Bösingen,60 - 65 Jahre,153,84,69
False,8325009,Bösingen,65 - 75 Jahre,212,91,121
False,8325009,Bösingen,75 und mehr Jahre,126,40,86
False,8325009,Bösingen,Insgesamt,3264,1667,1597
False,8325011,Dietingen,unter 3 Jahre,164,79,85
False,8325011,Dietingen,3 -  6 Jahre,182,94,88
False,8325011,Dietingen,6 - 10 Jahre,207,99,108
False,8325011,Dietingen,10 - 15 Jahre,222,104,118
False,8325011,Dietingen,15 - 18 Jahre,124,58,66
False,8325011,Dietingen,18 - 20 Jahre,94,46,48
False,8325011,Dietingen,20 - 25 Jahre,266,128,138
False,8325011,Dietingen,25 - 30 Jahre,326,167,159
False,8325011,Dietingen,30 - 35 Jahre,349,186,163
False,8325011,Dietingen,35 - 40 Jahre,291,151,140
False,8325011,Dietingen,40 - 45 Jahre,232,127,105
False,8325011,Dietingen,45 - 50 Jahre,213,101,112
False,8325011,Dietingen,50 - 55 Jahre,193,92,101
False,8325011,Dietingen,55 - 60 Jahre,272,137,135
False,8325011,Dietingen,60 - 65 Jahre,222,111,111
False,8325011,Dietingen,65 - 75 Jahre,310,140,170
False,8325011,Dietingen,75 und mehr Jahre,186,47,139
False,8325011,Dietingen,Insgesamt,3853,1867,1986
False,8325012,"Dornhan, Stadt",unter 3 Jahre,234,116,118
False,8325012,"Dornhan, Stadt",3 -  6 Jahre,221,101,120
False,8325012,"Dornhan, Stadt",6 - 10 Jahre,331,171,160
False,8325012,"Dornhan, Stadt",10 - 15 Jahre,351,202,149
False,8325012,"Dornhan, Stadt",15 - 18 Jahre,207,113,94
False,8325012,"Dornhan, Stadt",18 - 20 Jahre,136,71,65
False,8325012,"Dornhan, Stadt",20 - 25 Jahre,381,212,169
False,8325012,"Dornhan, Stadt",25 - 30 Jahre,437,237,200
False,8325012,"Dornhan, Stadt",30 - 35 Jahre,555,296,259
False,8325012,"Dornhan, Stadt",35 - 40 Jahre,443,219,224
False,8325012,"Dornhan, Stadt",40 - 45 Jahre,378,196,182
False,8325012,"Dornhan, Stadt",45 - 50 Jahre,364,198,166
False,8325012,"Dornhan, Stadt",50 - 55 Jahre,320,165,155
False,8325012,"Dornhan, Stadt",55 - 60 Jahre,466,234,232
False,8325012,"Dornhan, Stadt",60 - 65 Jahre,328,174,154
False,8325012,"Dornhan, Stadt",65 - 75 Jahre,546,204,342
False,8325012,"Dornhan, Stadt",75 und mehr Jahre,350,104,246
False,8325012,"Dornhan, Stadt",Insgesamt,6048,3013,3035
False,8325014,Dunningen,unter 3 Jahre,233,125,108
False,8325014,Dunningen,3 -  6 Jahre,215,118,97
False,8325014,Dunningen,6 - 10 Jahre,352,173,179
False,8325014,Dunningen,10 - 15 Jahre,398,193,205
False,8325014,Dunningen,15 - 18 Jahre,215,104,111
False,8325014,Dunningen,18 - 20 Jahre,110,56,54
False,8325014,Dunningen,20 - 25 Jahre,307,172,135
False,8325014,Dunningen,25 - 30 Jahre,379,201,178
False,8325014,Dunningen,30 - 35 Jahre,422,213,209
False,8325014,Dunningen,35 - 40 Jahre,451,247,204
False,8325014,Dunningen,40 - 45 Jahre,408,208,200
False,8325014,Dunningen,45 - 50 Jahre,280,145,135
False,8325014,Dunningen,50 - 55 Jahre,251,131,120
False,8325014,Dunningen,55 - 60 Jahre,385,199,186
False,8325014,Dunningen,60 - 65 Jahre,278,135,143
False,8325014,Dunningen,65 - 75 Jahre,427,185,242
False,8325014,Dunningen,75 und mehr Jahre,271,87,184
False,8325014,Dunningen,Insgesamt,5382,2692,2690
False,8325015,Epfendorf,unter 3 Jahre,129,85,44
False,8325015,Epfendorf,3 -  6 Jahre,146,75,71
False,8325015,Epfendorf,6 - 10 Jahre,181,80,101
False,8325015,Epfendorf,10 - 15 Jahre,186,93,93
False,8325015,Epfendorf,15 - 18 Jahre,88,40,48
False,8325015,Epfendorf,18 - 20 Jahre,57,33,24
False,8325015,Epfendorf,20 - 25 Jahre,192,86,106
False,8325015,Epfendorf,25 - 30 Jahre,314,159,155
False,8325015,Epfendorf,30 - 35 Jahre,342,165,177
False,8325015,Epfendorf,35 - 40 Jahre,318,183,135
False,8325015,Epfendorf,40 - 45 Jahre,197,100,97
False,8325015,Epfendorf,45 - 50 Jahre,200,112,88
False,8325015,Epfendorf,50 - 55 Jahre,176,92,84
False,8325015,Epfendorf,55 - 60 Jahre,257,132,125
False,8325015,Epfendorf,60 - 65 Jahre,187,85,102
False,8325015,Epfendorf,65 - 75 Jahre,304,116,188
False,8325015,Epfendorf,75 und mehr Jahre,186,59,127
False,8325015,Epfendorf,Insgesamt,3460,1695,1765
False,8325024,Hardt,unter 3 Jahre,105,51,54
False,8325024,Hardt,3 -  6 Jahre,119,63,56
False,8325024,Hardt,6 - 10 Jahre,151,80,71
False,8325024,Hardt,10 - 15 Jahre,170,84,86
False,8325024,Hardt,15 - 18 Jahre,93,50,43
False,8325024,Hardt,18 - 20 Jahre,49,29,20
False,8325024,Hardt,20 - 25 Jahre,149,84,65
False,8325024,Hardt,25 - 30 Jahre,198,103,95
False,8325024,Hardt,30 - 35 Jahre,199,105,94
False,8325024,Hardt,35 - 40 Jahre,184,82,102
False,8325024,Hardt,40 - 45 Jahre,207,111,96
False,8325024,Hardt,45 - 50 Jahre,132,62,70
False,8325024,Hardt,50 - 55 Jahre,155,75,80
False,8325024,Hardt,55 - 60 Jahre,187,99,88
False,8325024,Hardt,60 - 65 Jahre,107,56,51
False,8325024,Hardt,65 - 75 Jahre,171,85,86
False,8325024,Hardt,75 und mehr Jahre,112,29,83
False,8325024,Hardt,Insgesamt,2488,1248,1240
False,8325036,Lauterbach,unter 3 Jahre,117,56,61
False,8325036,Lauterbach,3 -  6 Jahre,135,64,71
False,8325036,Lauterbach,6 - 10 Jahre,143,82,61
False,8325036,Lauterbach,10 - 15 Jahre,158,88,70
False,8325036,Lauterbach,15 - 18 Jahre,85,48,37
False,8325036,Lauterbach,18 - 20 Jahre,73,40,33
False,8325036,Lauterbach,20 - 25 Jahre,228,113,115
False,8325036,Lauterbach,25 - 30 Jahre,270,154,116
False,8325036,Lauterbach,30 - 35 Jahre,255,129,126
False,8325036,Lauterbach,35 - 40 Jahre,222,116,106
False,8325036,Lauterbach,40 - 45 Jahre,177,83,94
False,8325036,Lauterbach,45 - 50 Jahre,173,90,83
False,8325036,Lauterbach,50 - 55 Jahre,207,100,107
False,8325036,Lauterbach,55 - 60 Jahre,281,142,139
False,8325036,Lauterbach,60 - 65 Jahre,217,108,109
False,8325036,Lauterbach,65 - 75 Jahre,353,147,206
False,8325036,Lauterbach,75 und mehr Jahre,241,59,182
False,8325036,Lauterbach,Insgesamt,3335,1619,1716
False,8325045,"Oberndorf am Neckar, Stadt",unter 3 Jahre,478,247,231
False,8325045,"Oberndorf am Neckar, Stadt",3 -  6 Jahre,489,244,245
False,8325045,"Oberndorf am Neckar, Stadt",6 - 10 Jahre,641,295,346
False,8325045,"Oberndorf am Neckar, Stadt",10 - 15 Jahre,811,409,402
False,8325045,"Oberndorf am Neckar, Stadt",15 - 18 Jahre,468,238,230
False,8325045,"Oberndorf am Neckar, Stadt",18 - 20 Jahre,284,145,139
False,8325045,"Oberndorf am Neckar, Stadt",20 - 25 Jahre,859,432,427
False,8325045,"Oberndorf am Neckar, Stadt",25 - 30 Jahre,1185,635,550
False,8325045,"Oberndorf am Neckar, Stadt",30 - 35 Jahre,1219,646,573
False,8325045,"Oberndorf am Neckar, Stadt",35 - 40 Jahre,970,516,454
False,8325045,"Oberndorf am Neckar, Stadt",40 - 45 Jahre,890,438,452
False,8325045,"Oberndorf am Neckar, Stadt",45 - 50 Jahre,905,431,474
False,8325045,"Oberndorf am Neckar, Stadt",50 - 55 Jahre,940,489,451
False,8325045,"Oberndorf am Neckar, Stadt",55 - 60 Jahre,1138,578,560
False,8325045,"Oberndorf am Neckar, Stadt",60 - 65 Jahre,809,395,414
False,8325045,"Oberndorf am Neckar, Stadt",65 - 75 Jahre,1367,556,811
False,8325045,"Oberndorf am Neckar, Stadt",75 und mehr Jahre,1226,358,868
False,8325045,"Oberndorf am Neckar, Stadt",Insgesamt,14679,7052,7627
False,8325049,"Rottweil, Stadt",unter 3 Jahre,757,375,382
False,8325049,"Rottweil, Stadt",3 -  6 Jahre,831,427,404
False,8325049,"Rottweil, Stadt",6 - 10 Jahre,1146,549,597
False,8325049,"Rottweil, Stadt",10 - 15 Jahre,1386,655,731
False,8325049,"Rottweil, Stadt",15 - 18 Jahre,871,453,418
False,8325049,"Rottweil, Stadt",18 - 20 Jahre,633,337,296
False,8325049,"Rottweil, Stadt",20 - 25 Jahre,1424,787,637
False,8325049,"Rottweil, Stadt",25 - 30 Jahre,2005,1044,961
False,8325049,"Rottweil, Stadt",30 - 35 Jahre,1910,962,948
False,8325049,"Rottweil, Stadt",35 - 40 Jahre,1728,878,850
False,8325049,"Rottweil, Stadt",40 - 45 Jahre,1662,835,827
False,8325049,"Rottweil, Stadt",45 - 50 Jahre,1514,759,755
False,8325049,"Rottweil, Stadt",50 - 55 Jahre,1529,772,757
False,8325049,"Rottweil, Stadt",55 - 60 Jahre,1678,847,831
False,8325049,"Rottweil, Stadt",60 - 65 Jahre,1282,597,685
False,8325049,"Rottweil, Stadt",65 - 75 Jahre,2355,913,1442
False,8325049,"Rottweil, Stadt",75 und mehr Jahre,1945,555,1390
False,8325049,"Rottweil, Stadt",Insgesamt,24656,11745,12911
False,8325050,Schenkenzell,unter 3 Jahre,78,41,37
False,8325050,Schenkenzell,3 -  6 Jahre,81,45,36
False,8325050,Schenkenzell,6 - 10 Jahre,109,57,52
False,8325050,Schenkenzell,10 - 15 Jahre,109,66,43
False,8325050,Schenkenzell,15 - 18 Jahre,58,28,30
False,8325050,Schenkenzell,18 - 20 Jahre,35,22,13
False,8325050,Schenkenzell,20 - 25 Jahre,111,67,44
False,8325050,Schenkenzell,25 - 30 Jahre,157,74,83
False,8325050,Schenkenzell,30 - 35 Jahre,191,97,94
False,8325050,Schenkenzell,35 - 40 Jahre,149,88,61
False,8325050,Schenkenzell,40 - 45 Jahre,102,51,51
False,8325050,Schenkenzell,45 - 50 Jahre,93,54,39
False,8325050,Schenkenzell,50 - 55 Jahre,107,55,52
False,8325050,Schenkenzell,55 - 60 Jahre,146,68,78
False,8325050,Schenkenzell,60 - 65 Jahre,127,68,59
False,8325050,Schenkenzell,65 - 75 Jahre,194,90,104
False,8325050,Schenkenzell,75 und mehr Jahre,140,44,96
False,8325050,Schenkenzell,Insgesamt,1987,1015,972
False,8325051,"Schiltach, Stadt",unter 3 Jahre,152,86,66
False,8325051,"Schiltach, Stadt",3 -  6 Jahre,161,90,71
False,8325051,"Schiltach, Stadt",6 - 10 Jahre,181,93,88
False,8325051,"Schiltach, Stadt",10 - 15 Jahre,256,119,137
False,8325051,"Schiltach, Stadt",15 - 18 Jahre,125,65,60
False,8325051,"Schiltach, Stadt",18 - 20 Jahre,104,49,55
False,8325051,"Schiltach, Stadt",20 - 25 Jahre,202,99,103
False,8325051,"Schiltach, Stadt",25 - 30 Jahre,298,150,148
False,8325051,"Schiltach, Stadt",30 - 35 Jahre,351,187,164
False,8325051,"Schiltach, Stadt",35 - 40 Jahre,304,153,151
False,8325051,"Schiltach, Stadt",40 - 45 Jahre,261,132,129
False,8325051,"Schiltach, Stadt",45 - 50 Jahre,190,110,80
False,8325051,"Schiltach, Stadt",50 - 55 Jahre,225,104,121
False,8325051,"Schiltach, Stadt",55 - 60 Jahre,309,153,156
False,8325051,"Schiltach, Stadt",60 - 65 Jahre,247,115,132
False,8325051,"Schiltach, Stadt",65 - 75 Jahre,429,201,228
False,8325051,"Schiltach, Stadt",75 und mehr Jahre,335,77,258
False,8325051,"Schiltach, Stadt",Insgesamt,4130,1983,2147
False,8325053,"Schramberg, Stadt",unter 3 Jahre,876,452,424
False,8325053,"Schramberg, Stadt",3 -  6 Jahre,864,455,409
False,8325053,"Schramberg, Stadt",6 - 10 Jahre,1137,581,556
False,8325053,"Schramberg, Stadt",10 - 15 Jahre,1378,731,647
False,8325053,"Schramberg, Stadt",15 - 18 Jahre,780,409,371
False,8325053,"Schramberg, Stadt",18 - 20 Jahre,495,263,232
False,8325053,"Schramberg, Stadt",20 - 25 Jahre,1375,766,609
False,8325053,"Schramberg, Stadt",25 - 30 Jahre,1886,995,891
False,8325053,"Schramberg, Stadt",30 - 35 Jahre,1902,1009,893
False,8325053,"Schramberg, Stadt",35 - 40 Jahre,1661,871,790
False,8325053,"Schramberg, Stadt",40 - 45 Jahre,1458,726,732
False,8325053,"Schramberg, Stadt",45 - 50 Jahre,1311,643,668
False,8325053,"Schramberg, Stadt",50 - 55 Jahre,1357,684,673
False,8325053,"Schramberg, Stadt",55 - 60 Jahre,1640,816,824
False,8325053,"Schramberg, Stadt",60 - 65 Jahre,1213,563,650
False,8325053,"Schramberg, Stadt",65 - 75 Jahre,2203,914,1289
False,8325053,"Schramberg, Stadt",75 und mehr Jahre,1941,541,1400
False,8325053,"Schramberg, Stadt",Insgesamt,23477,11419,12058
False,8325057,"Sulz am Neckar, Stadt",unter 3 Jahre,480,244,236
False,8325057,"Sulz am Neckar, Stadt",3 -  6 Jahre,488,247,241
False,8325057,"Sulz am Neckar, Stadt",6 - 10 Jahre,644,299,345
False,8325057,"Sulz am Neckar, Stadt",10 - 15 Jahre,743,385,358
False,8325057,"Sulz am Neckar, Stadt",15 - 18 Jahre,414,204,210
False,8325057,"Sulz am Neckar, Stadt",18 - 20 Jahre,243,140,103
False,8325057,"Sulz am Neckar, Stadt",20 - 25 Jahre,687,350,337
False,8325057,"Sulz am Neckar, Stadt",25 - 30 Jahre,932,486,446
False,8325057,"Sulz am Neckar, Stadt",30 - 35 Jahre,1048,531,517
False,8325057,"Sulz am Neckar, Stadt",35 - 40 Jahre,975,501,474
False,8325057,"Sulz am Neckar, Stadt",40 - 45 Jahre,758,393,365
False,8325057,"Sulz am Neckar, Stadt",45 - 50 Jahre,654,333,321
False,8325057,"Sulz am Neckar, Stadt",50 - 55 Jahre,601,321,280
False,8325057,"Sulz am Neckar, Stadt",55 - 60 Jahre,849,430,419
False,8325057,"Sulz am Neckar, Stadt",60 - 65 Jahre,695,344,351
False,8325057,"Sulz am Neckar, Stadt",65 - 75 Jahre,1065,451,614
False,8325057,"Sulz am Neckar, Stadt",75 und mehr Jahre,821,220,601
False,8325057,"Sulz am Neckar, Stadt",Insgesamt,12097,5879,6218
False,8325060,Villingendorf,unter 3 Jahre,102,53,49
False,8325060,Villingendorf,3 -  6 Jahre,120,58,62
False,8325060,Villingendorf,6 - 10 Jahre,180,89,91
False,8325060,Villingendorf,10 - 15 Jahre,187,92,95
False,8325060,Villingendorf,15 - 18 Jahre,81,36,45
False,8325060,Villingendorf,18 - 20 Jahre,63,39,24
False,8325060,Villingendorf,20 - 25 Jahre,169,83,86
False,8325060,Villingendorf,25 - 30 Jahre,249,137,112
False,8325060,Villingendorf,30 - 35 Jahre,235,121,114
False,8325060,Villingendorf,35 - 40 Jahre,225,104,121
False,8325060,Villingendorf,40 - 45 Jahre,201,98,103
False,8325060,Villingendorf,45 - 50 Jahre,163,90,73
False,8325060,Villingendorf,50 - 55 Jahre,148,77,71
False,8325060,Villingendorf,55 - 60 Jahre,192,97,95
False,8325060,Villingendorf,60 - 65 Jahre,159,77,82
False,8325060,Villingendorf,65 - 75 Jahre,208,91,117
False,8325060,Villingendorf,75 und mehr Jahre,139,43,96
False,8325060,Villingendorf,Insgesamt,2821,1385,1436
False,8325061,Vöhringen,unter 3 Jahre,167,87,80
False,8325061,Vöhringen,3 -  6 Jahre,173,96,77
False,8325061,Vöhringen,6 - 10 Jahre,217,99,118
False,8325061,Vöhringen,10 - 15 Jahre,244,130,114
False,8325061,Vöhringen,15 - 18 Jahre,142,75,67
False,8325061,Vöhringen,18 - 20 Jahre,81,44,37
False,8325061,Vöhringen,20 - 25 Jahre,253,126,127
False,8325061,Vöhringen,25 - 30 Jahre,291,141,150
False,8325061,Vöhringen,30 - 35 Jahre,333,179,154
False,8325061,Vöhringen,35 - 40 Jahre,287,170,117
False,8325061,Vöhringen,40 - 45 Jahre,217,100,117
False,8325061,Vöhringen,45 - 50 Jahre,223,121,102
False,8325061,Vöhringen,50 - 55 Jahre,212,104,108
False,8325061,Vöhringen,55 - 60 Jahre,242,121,121
False,8325061,Vöhringen,60 - 65 Jahre,202,102,100
False,8325061,Vöhringen,65 - 75 Jahre,278,103,175
False,8325061,Vöhringen,75 und mehr Jahre,205,57,148
False,8325061,Vöhringen,Insgesamt,3767,1855,1912
False,8325064,Wellendingen,unter 3 Jahre,115,51,64
False,8325064,Wellendingen,3 -  6 Jahre,122,67,55
False,8325064,Wellendingen,6 - 10 Jahre,158,73,85
False,8325064,Wellendingen,10 - 15 Jahre,172,84,88
False,8325064,Wellendingen,15 - 18 Jahre,87,49,38
False,8325064,Wellendingen,18 - 20 Jahre,48,27,21
False,8325064,Wellendingen,20 - 25 Jahre,152,79,73
False,8325064,Wellendingen,25 - 30 Jahre,191,105,86
False,8325064,Wellendingen,30 - 35 Jahre,262,131,131
False,8325064,Wellendingen,35 - 40 Jahre,247,128,119
False,8325064,Wellendingen,40 - 45 Jahre,200,105,95
False,8325064,Wellendingen,45 - 50 Jahre,147,87,60
False,8325064,Wellendingen,50 - 55 Jahre,161,93,68
False,8325064,Wellendingen,55 - 60 Jahre,188,87,101
False,8325064,Wellendingen,60 - 65 Jahre,121,65,56
False,8325064,Wellendingen,65 - 75 Jahre,217,81,136
False,8325064,Wellendingen,75 und mehr Jahre,132,43,89
False,8325064,Wellendingen,Insgesamt,2720,1355,1365
False,8325069,Zimmern ob Rottweil,unter 3 Jahre,212,118,94
False,8325069,Zimmern ob Rottweil,3 -  6 Jahre,219,109,110
False,8325069,Zimmern ob Rottweil,6 - 10 Jahre,320,147,173
False,8325069,Zimmern ob Rottweil,10 - 15 Jahre,355,183,172
False,8325069,Zimmern ob Rottweil,15 - 18 Jahre,217,119,98
False,8325069,Zimmern ob Rottweil,18 - 20 Jahre,136,60,76
False,8325069,Zimmern ob Rottweil,20 - 25 Jahre,309,157,152
False,8325069,Zimmern ob Rottweil,25 - 30 Jahre,437,234,203
False,8325069,Zimmern ob Rottweil,30 - 35 Jahre,476,248,228
False,8325069,Zimmern ob Rottweil,35 - 40 Jahre,505,246,259
False,8325069,Zimmern ob Rottweil,40 - 45 Jahre,412,212,200
False,8325069,Zimmern ob Rottweil,45 - 50 Jahre,329,168,161
False,8325069,Zimmern ob Rottweil,50 - 55 Jahre,318,166,152
False,8325069,Zimmern ob Rottweil,55 - 60 Jahre,409,205,204
False,8325069,Zimmern ob Rottweil,60 - 65 Jahre,257,127,130
False,8325069,Zimmern ob Rottweil,65 - 75 Jahre,430,194,236
False,8325069,Zimmern ob Rottweil,75 und mehr Jahre,277,101,176
False,8325069,Zimmern ob Rottweil,Insgesamt,5618,2794,2824
False,8325070,Fluorn-Winzeln,unter 3 Jahre,137,80,57
False,8325070,Fluorn-Winzeln,3 -  6 Jahre,146,77,69
False,8325070,Fluorn-Winzeln,6 - 10 Jahre,155,80,75
False,8325070,Fluorn-Winzeln,10 - 15 Jahre,178,80,98
False,8325070,Fluorn-Winzeln,15 - 18 Jahre,95,48,47
False,8325070,Fluorn-Winzeln,18 - 20 Jahre,64,39,25
False,8325070,Fluorn-Winzeln,20 - 25 Jahre,196,104,92
False,8325070,Fluorn-Winzeln,25 - 30 Jahre,282,153,129
False,8325070,Fluorn-Winzeln,30 - 35 Jahre,289,161,128
False,8325070,Fluorn-Winzeln,35 - 40 Jahre,254,138,116
False,8325070,Fluorn-Winzeln,40 - 45 Jahre,173,85,88
False,8325070,Fluorn-Winzeln,45 - 50 Jahre,186,89,97
False,8325070,Fluorn-Winzeln,50 - 55 Jahre,190,110,80
False,8325070,Fluorn-Winzeln,55 - 60 Jahre,268,131,137
False,8325070,Fluorn-Winzeln,60 - 65 Jahre,168,97,71
False,8325070,Fluorn-Winzeln,65 - 75 Jahre,267,119,148
False,8325070,Fluorn-Winzeln,75 und mehr Jahre,181,45,136
False,8325070,Fluorn-Winzeln,Insgesamt,3229,1636,1593
False,8325071,Eschbronn,unter 3 Jahre,82,52,30
False,8325071,Eschbronn,3 -  6 Jahre,83,40,43
False,8325071,Eschbronn,6 - 10 Jahre,87,46,41
False,8325071,Eschbronn,10 - 15 Jahre,116,62,54
False,8325071,Eschbronn,15 - 18 Jahre,68,30,38
False,8325071,Eschbronn,18 - 20 Jahre,41,20,21
False,8325071,Eschbronn,20 - 25 Jahre,150,79,71
False,8325071,Eschbronn,25 - 30 Jahre,178,105,73
False,8325071,Eschbronn,30 - 35 Jahre,188,107,81
False,8325071,Eschbronn,35 - 40 Jahre,150,77,73
False,8325071,Eschbronn,40 - 45 Jahre,149,79,70
False,8325071,Eschbronn,45 - 50 Jahre,105,47,58
False,8325071,Eschbronn,50 - 55 Jahre,129,63,66
False,8325071,Eschbronn,55 - 60 Jahre,178,90,88
False,8325071,Eschbronn,60 - 65 Jahre,110,56,54
False,8325071,Eschbronn,65 - 75 Jahre,169,75,94
False,8325071,Eschbronn,75 und mehr Jahre,123,38,85
False,8325071,Eschbronn,Insgesamt,2106,1066,1040
False,8325072,Deißlingen,unter 3 Jahre,201,100,101
False,8325072,Deißlingen,3 -  6 Jahre,274,147,127
False,8325072,Deißlingen,6 - 10 Jahre,315,146,169
False,8325072,Deißlingen,10 - 15 Jahre,366,205,161
False,8325072,Deißlingen,15 - 18 Jahre,177,80,97
False,8325072,Deißlingen,18 - 20 Jahre,136,62,74
False,8325072,Deißlingen,20 - 25 Jahre,279,150,129
False,8325072,Deißlingen,25 - 30 Jahre,410,201,209
False,8325072,Deißlingen,30 - 35 Jahre,486,236,250
False,8325072,Deißlingen,35 - 40 Jahre,498,243,255
False,8325072,Deißlingen,40 - 45 Jahre,426,209,217
False,8325072,Deißlingen,45 - 50 Jahre,327,171,156
False,8325072,Deißlingen,50 - 55 Jahre,279,148,131
False,8325072,Deißlingen,55 - 60 Jahre,422,212,210
False,8325072,Deißlingen,60 - 65 Jahre,313,144,169
False,8325072,Deißlingen,65 - 75 Jahre,533,249,284
False,8325072,Deißlingen,75 und mehr Jahre,304,94,210
False,8325072,Deißlingen,Insgesamt,5746,2797,2949
False,8326,Landkreis Schwarzw.-Baar-Kreis,unter 3 Jahre,6875,3532,3343
False,8326,Landkreis Schwarzw.-Baar-Kreis,3 -  6 Jahre,7475,3903,3572
False,8326,Landkreis Schwarzw.-Baar-Kreis,6 - 10 Jahre,10083,5171,4912
False,8326,Landkreis Schwarzw.-Baar-Kreis,10 - 15 Jahre,11964,6114,5850
False,8326,Landkreis Schwarzw.-Baar-Kreis,15 - 18 Jahre,6801,3466,3335
False,8326,Landkreis Schwarzw.-Baar-Kreis,18 - 20 Jahre,4434,2291,2143
False,8326,Landkreis Schwarzw.-Baar-Kreis,20 - 25 Jahre,11942,6104,5838
False,8326,Landkreis Schwarzw.-Baar-Kreis,25 - 30 Jahre,16124,8344,7780
False,8326,Landkreis Schwarzw.-Baar-Kreis,30 - 35 Jahre,17162,8904,8258
False,8326,Landkreis Schwarzw.-Baar-Kreis,35 - 40 Jahre,15734,8073,7661
False,8326,Landkreis Schwarzw.-Baar-Kreis,40 - 45 Jahre,13967,6847,7120
False,8326,Landkreis Schwarzw.-Baar-Kreis,45 - 50 Jahre,12679,6396,6283
False,8326,Landkreis Schwarzw.-Baar-Kreis,50 - 55 Jahre,12330,6131,6199
False,8326,Landkreis Schwarzw.-Baar-Kreis,55 - 60 Jahre,15455,7612,7843
False,8326,Landkreis Schwarzw.-Baar-Kreis,60 - 65 Jahre,12115,5903,6212
False,8326,Landkreis Schwarzw.-Baar-Kreis,65 - 75 Jahre,19848,8342,11506
False,8326,Landkreis Schwarzw.-Baar-Kreis,75 und mehr Jahre,13840,4093,9747
False,8326,Landkreis Schwarzw.-Baar-Kreis,Insgesamt,208828,101226,107602
False,8326003,"Bad Dürrheim, Stadt",unter 3 Jahre,307,163,144
False,8326003,"Bad Dürrheim, Stadt",3 -  6 Jahre,350,173,177
False,8326003,"Bad Dürrheim, Stadt",6 - 10 Jahre,455,229,226
False,8326003,"Bad Dürrheim, Stadt",10 - 15 Jahre,546,281,265
False,8326003,"Bad Dürrheim, Stadt",15 - 18 Jahre,283,135,148
False,8326003,"Bad Dürrheim, Stadt",18 - 20 Jahre,181,88,93
False,8326003,"Bad Dürrheim, Stadt",20 - 25 Jahre,561,281,280
False,8326003,"Bad Dürrheim, Stadt",25 - 30 Jahre,773,380,393
False,8326003,"Bad Dürrheim, Stadt",30 - 35 Jahre,863,420,443
False,8326003,"Bad Dürrheim, Stadt",35 - 40 Jahre,817,408,409
False,8326003,"Bad Dürrheim, Stadt",40 - 45 Jahre,692,323,369
False,8326003,"Bad Dürrheim, Stadt",45 - 50 Jahre,660,325,335
False,8326003,"Bad Dürrheim, Stadt",50 - 55 Jahre,672,322,350
False,8326003,"Bad Dürrheim, Stadt",55 - 60 Jahre,870,382,488
False,8326003,"Bad Dürrheim, Stadt",60 - 65 Jahre,676,323,353
False,8326003,"Bad Dürrheim, Stadt",65 - 75 Jahre,1362,538,824
False,8326003,"Bad Dürrheim, Stadt",75 und mehr Jahre,1481,446,1035
False,8326003,"Bad Dürrheim, Stadt",Insgesamt,11549,5217,6332
False,8326005,"Blumberg, Stadt",unter 3 Jahre,393,210,183
False,8326005,"Blumberg, Stadt",3 -  6 Jahre,428,237,191
False,8326005,"Blumberg, Stadt",6 - 10 Jahre,558,279,279
False,8326005,"Blumberg, Stadt",10 - 15 Jahre,707,364,343
False,8326005,"Blumberg, Stadt",15 - 18 Jahre,418,208,210
False,8326005,"Blumberg, Stadt",18 - 20 Jahre,240,121,119
False,8326005,"Blumberg, Stadt",20 - 25 Jahre,683,348,335
False,8326005,"Blumberg, Stadt",25 - 30 Jahre,799,421,378
False,8326005,"Blumberg, Stadt",30 - 35 Jahre,869,461,408
False,8326005,"Blumberg, Stadt",35 - 40 Jahre,800,407,393
False,8326005,"Blumberg, Stadt",40 - 45 Jahre,689,346,343
False,8326005,"Blumberg, Stadt",45 - 50 Jahre,648,335,313
False,8326005,"Blumberg, Stadt",50 - 55 Jahre,624,345,279
False,8326005,"Blumberg, Stadt",55 - 60 Jahre,778,391,387
False,8326005,"Blumberg, Stadt",60 - 65 Jahre,571,284,287
False,8326005,"Blumberg, Stadt",65 - 75 Jahre,923,407,516
False,8326005,"Blumberg, Stadt",75 und mehr Jahre,567,159,408
False,8326005,"Blumberg, Stadt",Insgesamt,10695,5323,5372
False,8326006,"Bräunlingen, Stadt",unter 3 Jahre,249,123,126
False,8326006,"Bräunlingen, Stadt",3 -  6 Jahre,270,125,145
False,8326006,"Bräunlingen, Stadt",6 - 10 Jahre,355,183,172
False,8326006,"Bräunlingen, Stadt",10 - 15 Jahre,359,185,174
False,8326006,"Bräunlingen, Stadt",15 - 18 Jahre,201,100,101
False,8326006,"Bräunlingen, Stadt",18 - 20 Jahre,134,63,71
False,8326006,"Bräunlingen, Stadt",20 - 25 Jahre,382,201,181
False,8326006,"Bräunlingen, Stadt",25 - 30 Jahre,490,251,239
False,8326006,"Bräunlingen, Stadt",30 - 35 Jahre,588,307,281
False,8326006,"Bräunlingen, Stadt",35 - 40 Jahre,522,279,243
False,8326006,"Bräunlingen, Stadt",40 - 45 Jahre,402,217,185
False,8326006,"Bräunlingen, Stadt",45 - 50 Jahre,318,163,155
False,8326006,"Bräunlingen, Stadt",50 - 55 Jahre,265,144,121
False,8326006,"Bräunlingen, Stadt",55 - 60 Jahre,388,206,182
False,8326006,"Bräunlingen, Stadt",60 - 65 Jahre,281,132,149
False,8326006,"Bräunlingen, Stadt",65 - 75 Jahre,477,205,272
False,8326006,"Bräunlingen, Stadt",75 und mehr Jahre,276,100,176
False,8326006,"Bräunlingen, Stadt",Insgesamt,5957,2984,2973
False,8326010,Dauchingen,unter 3 Jahre,112,70,42
False,8326010,Dauchingen,3 -  6 Jahre,130,69,61
False,8326010,Dauchingen,6 - 10 Jahre,180,102,78
False,8326010,Dauchingen,10 - 15 Jahre,195,99,96
False,8326010,Dauchingen,15 - 18 Jahre,96,41,55
False,8326010,Dauchingen,18 - 20 Jahre,58,32,26
False,8326010,Dauchingen,20 - 25 Jahre,160,73,87
False,8326010,Dauchingen,25 - 30 Jahre,291,136,155
False,8326010,Dauchingen,30 - 35 Jahre,330,172,158
False,8326010,Dauchingen,35 - 40 Jahre,271,129,142
False,8326010,Dauchingen,40 - 45 Jahre,261,128,133
False,8326010,Dauchingen,45 - 50 Jahre,213,113,100
False,8326010,Dauchingen,50 - 55 Jahre,218,115,103
False,8326010,Dauchingen,55 - 60 Jahre,288,135,153
False,8326010,Dauchingen,60 - 65 Jahre,189,107,82
False,8326010,Dauchingen,65 - 75 Jahre,231,106,125
False,8326010,Dauchingen,75 und mehr Jahre,154,53,101
False,8326010,Dauchingen,Insgesamt,3377,1680,1697
False,8326012,"Donaueschingen, Stadt",unter 3 Jahre,671,346,325
False,8326012,"Donaueschingen, Stadt",3 -  6 Jahre,731,378,353
False,8326012,"Donaueschingen, Stadt",6 - 10 Jahre,1019,538,481
False,8326012,"Donaueschingen, Stadt",10 - 15 Jahre,1182,608,574
False,8326012,"Donaueschingen, Stadt",15 - 18 Jahre,728,354,374
False,8326012,"Donaueschingen, Stadt",18 - 20 Jahre,470,240,230
False,8326012,"Donaueschingen, Stadt",20 - 25 Jahre,1249,647,602
False,8326012,"Donaueschingen, Stadt",25 - 30 Jahre,1709,904,805
False,8326012,"Donaueschingen, Stadt",30 - 35 Jahre,1676,824,852
False,8326012,"Donaueschingen, Stadt",35 - 40 Jahre,1621,841,780
False,8326012,"Donaueschingen, Stadt",40 - 45 Jahre,1519,747,772
False,8326012,"Donaueschingen, Stadt",45 - 50 Jahre,1249,650,599
False,8326012,"Donaueschingen, Stadt",50 - 55 Jahre,1109,557,552
False,8326012,"Donaueschingen, Stadt",55 - 60 Jahre,1521,749,772
False,8326012,"Donaueschingen, Stadt",60 - 65 Jahre,1065,513,552
False,8326012,"Donaueschingen, Stadt",65 - 75 Jahre,1900,794,1106
False,8326012,"Donaueschingen, Stadt",75 und mehr Jahre,1297,378,919
False,8326012,"Donaueschingen, Stadt",Insgesamt,20716,10068,10648
False,8326017,"Furtwangen im Schwarzwald, Stadt",unter 3 Jahre,356,173,183
False,8326017,"Furtwangen im Schwarzwald, Stadt",3 -  6 Jahre,370,195,175
False,8326017,"Furtwangen im Schwarzwald, Stadt",6 - 10 Jahre,492,258,234
False,8326017,"Furtwangen im Schwarzwald, Stadt",10 - 15 Jahre,569,296,273
False,8326017,"Furtwangen im Schwarzwald, Stadt",15 - 18 Jahre,325,174,151
False,8326017,"Furtwangen im Schwarzwald, Stadt",18 - 20 Jahre,216,125,91
False,8326017,"Furtwangen im Schwarzwald, Stadt",20 - 25 Jahre,646,368,278
False,8326017,"Furtwangen im Schwarzwald, Stadt",25 - 30 Jahre,914,543,371
False,8326017,"Furtwangen im Schwarzwald, Stadt",30 - 35 Jahre,1002,605,397
False,8326017,"Furtwangen im Schwarzwald, Stadt",35 - 40 Jahre,798,412,386
False,8326017,"Furtwangen im Schwarzwald, Stadt",40 - 45 Jahre,588,318,270
False,8326017,"Furtwangen im Schwarzwald, Stadt",45 - 50 Jahre,538,289,249
False,8326017,"Furtwangen im Schwarzwald, Stadt",50 - 55 Jahre,496,245,251
False,8326017,"Furtwangen im Schwarzwald, Stadt",55 - 60 Jahre,698,349,349
False,8326017,"Furtwangen im Schwarzwald, Stadt",60 - 65 Jahre,564,275,289
False,8326017,"Furtwangen im Schwarzwald, Stadt",65 - 75 Jahre,926,390,536
False,8326017,"Furtwangen im Schwarzwald, Stadt",75 und mehr Jahre,557,149,408
False,8326017,"Furtwangen im Schwarzwald, Stadt",Insgesamt,10055,5164,4891
False,8326020,Gütenbach,unter 3 Jahre,51,25,26
False,8326020,Gütenbach,3 -  6 Jahre,41,29,12
False,8326020,Gütenbach,6 - 10 Jahre,73,47,26
False,8326020,Gütenbach,10 - 15 Jahre,117,53,64
False,8326020,Gütenbach,15 - 18 Jahre,41,20,21
False,8326020,Gütenbach,18 - 20 Jahre,30,10,20
False,8326020,Gütenbach,20 - 25 Jahre,74,41,33
False,8326020,Gütenbach,25 - 30 Jahre,101,46,55
False,8326020,Gütenbach,30 - 35 Jahre,124,68,56
False,8326020,Gütenbach,35 - 40 Jahre,129,65,64
False,8326020,Gütenbach,40 - 45 Jahre,100,48,52
False,8326020,Gütenbach,45 - 50 Jahre,66,41,25
False,8326020,Gütenbach,50 - 55 Jahre,81,41,40
False,8326020,Gütenbach,55 - 60 Jahre,104,49,55
False,8326020,Gütenbach,60 - 65 Jahre,100,53,47
False,8326020,Gütenbach,65 - 75 Jahre,151,66,85
False,8326020,Gütenbach,75 und mehr Jahre,82,33,49
False,8326020,Gütenbach,Insgesamt,1465,735,730
False,8326027,"Hüfingen, Stadt",unter 3 Jahre,295,143,152
False,8326027,"Hüfingen, Stadt",3 -  6 Jahre,294,145,149
False,8326027,"Hüfingen, Stadt",6 - 10 Jahre,399,236,163
False,8326027,"Hüfingen, Stadt",10 - 15 Jahre,519,273,246
False,8326027,"Hüfingen, Stadt",15 - 18 Jahre,270,155,115
False,8326027,"Hüfingen, Stadt",18 - 20 Jahre,166,79,87
False,8326027,"Hüfingen, Stadt",20 - 25 Jahre,410,229,181
False,8326027,"Hüfingen, Stadt",25 - 30 Jahre,607,315,292
False,8326027,"Hüfingen, Stadt",30 - 35 Jahre,656,354,302
False,8326027,"Hüfingen, Stadt",35 - 40 Jahre,609,298,311
False,8326027,"Hüfingen, Stadt",40 - 45 Jahre,505,250,255
False,8326027,"Hüfingen, Stadt",45 - 50 Jahre,395,207,188
False,8326027,"Hüfingen, Stadt",50 - 55 Jahre,351,184,167
False,8326027,"Hüfingen, Stadt",55 - 60 Jahre,418,210,208
False,8326027,"Hüfingen, Stadt",60 - 65 Jahre,359,184,175
False,8326027,"Hüfingen, Stadt",65 - 75 Jahre,591,266,325
False,8326027,"Hüfingen, Stadt",75 und mehr Jahre,377,117,260
False,8326027,"Hüfingen, Stadt",Insgesamt,7221,3645,3576
False,8326031,Königsfeld im Schwarzwald,unter 3 Jahre,186,95,91
False,8326031,Königsfeld im Schwarzwald,3 -  6 Jahre,226,121,105
False,8326031,Königsfeld im Schwarzwald,6 - 10 Jahre,300,165,135
False,8326031,Königsfeld im Schwarzwald,10 - 15 Jahre,360,190,170
False,8326031,Königsfeld im Schwarzwald,15 - 18 Jahre,219,118,101
False,8326031,Königsfeld im Schwarzwald,18 - 20 Jahre,185,90,95
False,8326031,Königsfeld im Schwarzwald,20 - 25 Jahre,356,165,191
False,8326031,Königsfeld im Schwarzwald,25 - 30 Jahre,437,231,206
False,8326031,Königsfeld im Schwarzwald,30 - 35 Jahre,412,194,218
False,8326031,Königsfeld im Schwarzwald,35 - 40 Jahre,438,214,224
False,8326031,Königsfeld im Schwarzwald,40 - 45 Jahre,425,204,221
False,8326031,Königsfeld im Schwarzwald,45 - 50 Jahre,362,183,179
False,8326031,Königsfeld im Schwarzwald,50 - 55 Jahre,302,144,158
False,8326031,Königsfeld im Schwarzwald,55 - 60 Jahre,347,172,175
False,8326031,Königsfeld im Schwarzwald,60 - 65 Jahre,314,146,168
False,8326031,Königsfeld im Schwarzwald,65 - 75 Jahre,597,222,375
False,8326031,Königsfeld im Schwarzwald,75 und mehr Jahre,490,141,349
False,8326031,Königsfeld im Schwarzwald,Insgesamt,5956,2795,3161
False,8326037,Mönchweiler,unter 3 Jahre,109,52,57
False,8326037,Mönchweiler,3 -  6 Jahre,101,58,43
False,8326037,Mönchweiler,6 - 10 Jahre,151,77,74
False,8326037,Mönchweiler,10 - 15 Jahre,180,92,88
False,8326037,Mönchweiler,15 - 18 Jahre,111,51,60
False,8326037,Mönchweiler,18 - 20 Jahre,67,36,31
False,8326037,Mönchweiler,20 - 25 Jahre,161,74,87
False,8326037,Mönchweiler,25 - 30 Jahre,261,145,116
False,8326037,Mönchweiler,30 - 35 Jahre,244,123,121
False,8326037,Mönchweiler,35 - 40 Jahre,258,120,138
False,8326037,Mönchweiler,40 - 45 Jahre,241,127,114
False,8326037,Mönchweiler,45 - 50 Jahre,220,103,117
False,8326037,Mönchweiler,50 - 55 Jahre,212,107,105
False,8326037,Mönchweiler,55 - 60 Jahre,259,137,122
False,8326037,Mönchweiler,60 - 65 Jahre,201,105,96
False,8326037,Mönchweiler,65 - 75 Jahre,282,115,167
False,8326037,Mönchweiler,75 und mehr Jahre,152,41,111
False,8326037,Mönchweiler,Insgesamt,3210,1563,1647
False,8326041,Niedereschach,unter 3 Jahre,201,109,92
False,8326041,Niedereschach,3 -  6 Jahre,221,108,113
False,8326041,Niedereschach,6 - 10 Jahre,326,168,158
False,8326041,Niedereschach,10 - 15 Jahre,330,153,177
False,8326041,Niedereschach,15 - 18 Jahre,194,95,99
False,8326041,Niedereschach,18 - 20 Jahre,119,63,56
False,8326041,Niedereschach,20 - 25 Jahre,286,154,132
False,8326041,Niedereschach,25 - 30 Jahre,435,214,221
False,8326041,Niedereschach,30 - 35 Jahre,547,278,269
False,8326041,Niedereschach,35 - 40 Jahre,476,242,234
False,8326041,Niedereschach,40 - 45 Jahre,443,227,216
False,8326041,Niedereschach,45 - 50 Jahre,361,198,163
False,8326041,Niedereschach,50 - 55 Jahre,324,163,161
False,8326041,Niedereschach,55 - 60 Jahre,327,172,155
False,8326041,Niedereschach,60 - 65 Jahre,276,133,143
False,8326041,Niedereschach,65 - 75 Jahre,369,168,201
False,8326041,Niedereschach,75 und mehr Jahre,186,58,128
False,8326041,Niedereschach,Insgesamt,5421,2703,2718
False,8326052,"St. Georgen im Schwarzwald, Stadt",unter 3 Jahre,482,245,237
False,8326052,"St. Georgen im Schwarzwald, Stadt",3 -  6 Jahre,507,270,237
False,8326052,"St. Georgen im Schwarzwald, Stadt",6 - 10 Jahre,652,348,304
False,8326052,"St. Georgen im Schwarzwald, Stadt",10 - 15 Jahre,808,402,406
False,8326052,"St. Georgen im Schwarzwald, Stadt",15 - 18 Jahre,464,254,210
False,8326052,"St. Georgen im Schwarzwald, Stadt",18 - 20 Jahre,305,170,135
False,8326052,"St. Georgen im Schwarzwald, Stadt",20 - 25 Jahre,795,414,381
False,8326052,"St. Georgen im Schwarzwald, Stadt",25 - 30 Jahre,1006,504,502
False,8326052,"St. Georgen im Schwarzwald, Stadt",30 - 35 Jahre,1117,558,559
False,8326052,"St. Georgen im Schwarzwald, Stadt",35 - 40 Jahre,997,538,459
False,8326052,"St. Georgen im Schwarzwald, Stadt",40 - 45 Jahre,889,395,494
False,8326052,"St. Georgen im Schwarzwald, Stadt",45 - 50 Jahre,842,420,422
False,8326052,"St. Georgen im Schwarzwald, Stadt",50 - 55 Jahre,880,427,453
False,8326052,"St. Georgen im Schwarzwald, Stadt",55 - 60 Jahre,1147,569,578
False,8326052,"St. Georgen im Schwarzwald, Stadt",60 - 65 Jahre,831,403,428
False,8326052,"St. Georgen im Schwarzwald, Stadt",65 - 75 Jahre,1438,600,838
False,8326052,"St. Georgen im Schwarzwald, Stadt",75 und mehr Jahre,1019,294,725
False,8326052,"St. Georgen im Schwarzwald, Stadt",Insgesamt,14179,6811,7368
False,8326054,Schönwald im Schwarzwald,unter 3 Jahre,83,44,39
False,8326054,Schönwald im Schwarzwald,3 -  6 Jahre,106,56,50
False,8326054,Schönwald im Schwarzwald,6 - 10 Jahre,152,88,64
False,8326054,Schönwald im Schwarzwald,10 - 15 Jahre,143,71,72
False,8326054,Schönwald im Schwarzwald,15 - 18 Jahre,85,45,40
False,8326054,Schönwald im Schwarzwald,18 - 20 Jahre,43,18,25
False,8326054,Schönwald im Schwarzwald,20 - 25 Jahre,150,78,72
False,8326054,Schönwald im Schwarzwald,25 - 30 Jahre,200,94,106
False,8326054,Schönwald im Schwarzwald,30 - 35 Jahre,250,121,129
False,8326054,Schönwald im Schwarzwald,35 - 40 Jahre,229,122,107
False,8326054,Schönwald im Schwarzwald,40 - 45 Jahre,151,83,68
False,8326054,Schönwald im Schwarzwald,45 - 50 Jahre,157,77,80
False,8326054,Schönwald im Schwarzwald,50 - 55 Jahre,156,77,79
False,8326054,Schönwald im Schwarzwald,55 - 60 Jahre,231,108,123
False,8326054,Schönwald im Schwarzwald,60 - 65 Jahre,156,82,74
False,8326054,Schönwald im Schwarzwald,65 - 75 Jahre,253,102,151
False,8326054,Schönwald im Schwarzwald,75 und mehr Jahre,161,53,108
False,8326054,Schönwald im Schwarzwald,Insgesamt,2706,1319,1387
False,8326055,Schonach im Schwarzwald,unter 3 Jahre,162,84,78
False,8326055,Schonach im Schwarzwald,3 -  6 Jahre,172,86,86
False,8326055,Schonach im Schwarzwald,6 - 10 Jahre,225,111,114
False,8326055,Schonach im Schwarzwald,10 - 15 Jahre,239,132,107
False,8326055,Schonach im Schwarzwald,15 - 18 Jahre,148,62,86
False,8326055,Schonach im Schwarzwald,18 - 20 Jahre,83,39,44
False,8326055,Schonach im Schwarzwald,20 - 25 Jahre,240,138,102
False,8326055,Schonach im Schwarzwald,25 - 30 Jahre,324,180,144
False,8326055,Schonach im Schwarzwald,30 - 35 Jahre,334,164,170
False,8326055,Schonach im Schwarzwald,35 - 40 Jahre,297,167,130
False,8326055,Schonach im Schwarzwald,40 - 45 Jahre,282,128,154
False,8326055,Schonach im Schwarzwald,45 - 50 Jahre,246,135,111
False,8326055,Schonach im Schwarzwald,50 - 55 Jahre,247,123,124
False,8326055,Schonach im Schwarzwald,55 - 60 Jahre,391,178,213
False,8326055,Schonach im Schwarzwald,60 - 65 Jahre,318,165,153
False,8326055,Schonach im Schwarzwald,65 - 75 Jahre,394,181,213
False,8326055,Schonach im Schwarzwald,75 und mehr Jahre,238,79,159
False,8326055,Schonach im Schwarzwald,Insgesamt,4340,2152,2188
False,8326060,"Triberg im Schwarzwald, Stadt",unter 3 Jahre,210,109,101
False,8326060,"Triberg im Schwarzwald, Stadt",3 -  6 Jahre,221,110,111
False,8326060,"Triberg im Schwarzwald, Stadt",6 - 10 Jahre,284,143,141
False,8326060,"Triberg im Schwarzwald, Stadt",10 - 15 Jahre,288,158,130
False,8326060,"Triberg im Schwarzwald, Stadt",15 - 18 Jahre,182,95,87
False,8326060,"Triberg im Schwarzwald, Stadt",18 - 20 Jahre,124,62,62
False,8326060,"Triberg im Schwarzwald, Stadt",20 - 25 Jahre,361,179,182
False,8326060,"Triberg im Schwarzwald, Stadt",25 - 30 Jahre,459,233,226
False,8326060,"Triberg im Schwarzwald, Stadt",30 - 35 Jahre,463,246,217
False,8326060,"Triberg im Schwarzwald, Stadt",35 - 40 Jahre,363,197,166
False,8326060,"Triberg im Schwarzwald, Stadt",40 - 45 Jahre,339,164,175
False,8326060,"Triberg im Schwarzwald, Stadt",45 - 50 Jahre,294,161,133
False,8326060,"Triberg im Schwarzwald, Stadt",50 - 55 Jahre,316,159,157
False,8326060,"Triberg im Schwarzwald, Stadt",55 - 60 Jahre,418,206,212
False,8326060,"Triberg im Schwarzwald, Stadt",60 - 65 Jahre,395,179,216
False,8326060,"Triberg im Schwarzwald, Stadt",65 - 75 Jahre,653,284,369
False,8326060,"Triberg im Schwarzwald, Stadt",75 und mehr Jahre,461,127,334
False,8326060,"Triberg im Schwarzwald, Stadt",Insgesamt,5831,2812,3019
False,8326061,Tuningen,unter 3 Jahre,94,47,47
False,8326061,Tuningen,3 -  6 Jahre,107,61,46
False,8326061,Tuningen,6 - 10 Jahre,161,78,83
False,8326061,Tuningen,10 - 15 Jahre,208,103,105
False,8326061,Tuningen,15 - 18 Jahre,77,38,39
False,8326061,Tuningen,18 - 20 Jahre,53,28,25
False,8326061,Tuningen,20 - 25 Jahre,150,69,81
False,8326061,Tuningen,25 - 30 Jahre,222,117,105
False,8326061,Tuningen,30 - 35 Jahre,262,140,122
False,8326061,Tuningen,35 - 40 Jahre,233,116,117
False,8326061,Tuningen,40 - 45 Jahre,185,98,87
False,8326061,Tuningen,45 - 50 Jahre,151,87,64
False,8326061,Tuningen,50 - 55 Jahre,145,72,73
False,8326061,Tuningen,55 - 60 Jahre,189,99,90
False,8326061,Tuningen,60 - 65 Jahre,131,63,68
False,8326061,Tuningen,65 - 75 Jahre,238,92,146
False,8326061,Tuningen,75 und mehr Jahre,129,45,84
False,8326061,Tuningen,Insgesamt,2735,1353,1382
False,8326065,Unterkirnach,unter 3 Jahre,102,62,40
False,8326065,Unterkirnach,3 -  6 Jahre,117,67,50
False,8326065,Unterkirnach,6 - 10 Jahre,214,93,121
False,8326065,Unterkirnach,10 - 15 Jahre,249,143,106
False,8326065,Unterkirnach,15 - 18 Jahre,126,72,54
False,8326065,Unterkirnach,18 - 20 Jahre,77,54,23
False,8326065,Unterkirnach,20 - 25 Jahre,192,109,83
False,8326065,Unterkirnach,25 - 30 Jahre,260,135,125
False,8326065,Unterkirnach,30 - 35 Jahre,326,168,158
False,8326065,Unterkirnach,35 - 40 Jahre,282,140,142
False,8326065,Unterkirnach,40 - 45 Jahre,249,130,119
False,8326065,Unterkirnach,45 - 50 Jahre,195,109,86
False,8326065,Unterkirnach,50 - 55 Jahre,166,80,86
False,8326065,Unterkirnach,55 - 60 Jahre,192,94,98
False,8326065,Unterkirnach,60 - 65 Jahre,182,100,82
False,8326065,Unterkirnach,65 - 75 Jahre,195,90,105
False,8326065,Unterkirnach,75 und mehr Jahre,122,38,84
False,8326065,Unterkirnach,Insgesamt,3246,1684,1562
False,8326068,"Vöhrenbach, Stadt",unter 3 Jahre,161,91,70
False,8326068,"Vöhrenbach, Stadt",3 -  6 Jahre,153,78,75
False,8326068,"Vöhrenbach, Stadt",6 - 10 Jahre,231,109,122
False,8326068,"Vöhrenbach, Stadt",10 - 15 Jahre,253,121,132
False,8326068,"Vöhrenbach, Stadt",15 - 18 Jahre,142,84,58
False,8326068,"Vöhrenbach, Stadt",18 - 20 Jahre,77,32,45
False,8326068,"Vöhrenbach, Stadt",20 - 25 Jahre,240,138,102
False,8326068,"Vöhrenbach, Stadt",25 - 30 Jahre,343,182,161
False,8326068,"Vöhrenbach, Stadt",30 - 35 Jahre,356,188,168
False,8326068,"Vöhrenbach, Stadt",35 - 40 Jahre,325,189,136
False,8326068,"Vöhrenbach, Stadt",40 - 45 Jahre,245,125,120
False,8326068,"Vöhrenbach, Stadt",45 - 50 Jahre,264,140,124
False,8326068,"Vöhrenbach, Stadt",50 - 55 Jahre,217,113,104
False,8326068,"Vöhrenbach, Stadt",55 - 60 Jahre,337,183,154
False,8326068,"Vöhrenbach, Stadt",60 - 65 Jahre,239,125,114
False,8326068,"Vöhrenbach, Stadt",65 - 75 Jahre,393,188,205
False,8326068,"Vöhrenbach, Stadt",75 und mehr Jahre,265,81,184
False,8326068,"Vöhrenbach, Stadt",Insgesamt,4241,2167,2074
False,8326074,"Villingen-Schwenningen, Stadt",unter 3 Jahre,2449,1236,1213
False,8326074,"Villingen-Schwenningen, Stadt",3 -  6 Jahre,2751,1440,1311
False,8326074,"Villingen-Schwenningen, Stadt",6 - 10 Jahre,3571,1782,1789
False,8326074,"Villingen-Schwenningen, Stadt",10 - 15 Jahre,4373,2229,2144
False,8326074,"Villingen-Schwenningen, Stadt",15 - 18 Jahre,2476,1256,1220
False,8326074,"Villingen-Schwenningen, Stadt",18 - 20 Jahre,1693,873,820
False,8326074,"Villingen-Schwenningen, Stadt",20 - 25 Jahre,4538,2251,2287
False,8326074,"Villingen-Schwenningen, Stadt",25 - 30 Jahre,6091,3120,2971
False,8326074,"Villingen-Schwenningen, Stadt",30 - 35 Jahre,6263,3276,2987
False,8326074,"Villingen-Schwenningen, Stadt",35 - 40 Jahre,5805,2952,2853
False,8326074,"Villingen-Schwenningen, Stadt",40 - 45 Jahre,5345,2589,2756
False,8326074,"Villingen-Schwenningen, Stadt",45 - 50 Jahre,5115,2466,2649
False,8326074,"Villingen-Schwenningen, Stadt",50 - 55 Jahre,5233,2555,2678
False,8326074,"Villingen-Schwenningen, Stadt",55 - 60 Jahre,6241,3055,3186
False,8326074,"Villingen-Schwenningen, Stadt",60 - 65 Jahre,5027,2414,2613
False,8326074,"Villingen-Schwenningen, Stadt",65 - 75 Jahre,8087,3357,4730
False,8326074,"Villingen-Schwenningen, Stadt",75 und mehr Jahre,5676,1652,4024
False,8326074,"Villingen-Schwenningen, Stadt",Insgesamt,80734,38503,42231
False,8326075,Brigachtal,unter 3 Jahre,202,105,97
False,8326075,Brigachtal,3 -  6 Jahre,179,97,82
False,8326075,Brigachtal,6 - 10 Jahre,285,137,148
False,8326075,Brigachtal,10 - 15 Jahre,339,161,178
False,8326075,Brigachtal,15 - 18 Jahre,215,109,106
False,8326075,Brigachtal,18 - 20 Jahre,113,68,45
False,8326075,Brigachtal,20 - 25 Jahre,308,147,161
False,8326075,Brigachtal,25 - 30 Jahre,402,193,209
False,8326075,Brigachtal,30 - 35 Jahre,480,237,243
False,8326075,Brigachtal,35 - 40 Jahre,464,237,227
False,8326075,Brigachtal,40 - 45 Jahre,417,200,217
False,8326075,Brigachtal,45 - 50 Jahre,385,194,191
False,8326075,Brigachtal,50 - 55 Jahre,316,158,158
False,8326075,Brigachtal,55 - 60 Jahre,311,168,143
False,8326075,Brigachtal,60 - 65 Jahre,240,117,123
False,8326075,Brigachtal,65 - 75 Jahre,388,171,217
False,8326075,Brigachtal,75 und mehr Jahre,150,49,101
False,8326075,Brigachtal,Insgesamt,5194,2548,2646
False,8327,Landkreis Tuttlingen,unter 3 Jahre,4571,2342,2229
False,8327,Landkreis Tuttlingen,3 -  6 Jahre,4999,2496,2503
False,8327,Landkreis Tuttlingen,6 - 10 Jahre,6698,3375,3323
False,8327,Landkreis Tuttlingen,10 - 15 Jahre,7777,4070,3707
False,8327,Landkreis Tuttlingen,15 - 18 Jahre,4689,2398,2291
False,8327,Landkreis Tuttlingen,18 - 20 Jahre,3034,1573,1461
False,8327,Landkreis Tuttlingen,20 - 25 Jahre,7989,4208,3781
False,8327,Landkreis Tuttlingen,25 - 30 Jahre,10257,5350,4907
False,8327,Landkreis Tuttlingen,30 - 35 Jahre,10945,5736,5209
False,8327,Landkreis Tuttlingen,35 - 40 Jahre,9862,4993,4869
False,8327,Landkreis Tuttlingen,40 - 45 Jahre,8788,4425,4363
False,8327,Landkreis Tuttlingen,45 - 50 Jahre,7423,3786,3637
False,8327,Landkreis Tuttlingen,50 - 55 Jahre,7194,3591,3603
False,8327,Landkreis Tuttlingen,55 - 60 Jahre,9102,4585,4517
False,8327,Landkreis Tuttlingen,60 - 65 Jahre,7030,3500,3530
False,8327,Landkreis Tuttlingen,65 - 75 Jahre,11210,4771,6439
False,8327,Landkreis Tuttlingen,75 und mehr Jahre,7923,2311,5612
False,8327,Landkreis Tuttlingen,Insgesamt,129491,63510,65981
False,8327002,Aldingen,unter 3 Jahre,249,139,110
False,8327002,Aldingen,3 -  6 Jahre,268,141,127
False,8327002,Aldingen,6 - 10 Jahre,390,200,190
False,8327002,Aldingen,10 - 15 Jahre,382,208,174
False,8327002,Aldingen,15 - 18 Jahre,248,108,140
False,8327002,Aldingen,18 - 20 Jahre,148,73,75
False,8327002,Aldingen,20 - 25 Jahre,433,201,232
False,8327002,Aldingen,25 - 30 Jahre,453,234,219
False,8327002,Aldingen,30 - 35 Jahre,548,286,262
False,8327002,Aldingen,35 - 40 Jahre,477,252,225
False,8327002,Aldingen,40 - 45 Jahre,465,235,230
False,8327002,Aldingen,45 - 50 Jahre,371,188,183
False,8327002,Aldingen,50 - 55 Jahre,354,173,181
False,8327002,Aldingen,55 - 60 Jahre,486,247,239
False,8327002,Aldingen,60 - 65 Jahre,381,187,194
False,8327002,Aldingen,65 - 75 Jahre,614,248,366
False,8327002,Aldingen,75 und mehr Jahre,371,129,242
False,8327002,Aldingen,Insgesamt,6638,3249,3389
False,8327004,Bärenthal,unter 3 Jahre,5,1,4
False,8327004,Bärenthal,3 -  6 Jahre,20,9,11
False,8327004,Bärenthal,6 - 10 Jahre,25,14,11
False,8327004,Bärenthal,10 - 15 Jahre,31,17,14
False,8327004,Bärenthal,15 - 18 Jahre,8,6,2
False,8327004,Bärenthal,18 - 20 Jahre,16,10,6
False,8327004,Bärenthal,20 - 25 Jahre,27,16,11
False,8327004,Bärenthal,25 - 30 Jahre,30,15,15
False,8327004,Bärenthal,30 - 35 Jahre,35,22,13
False,8327004,Bärenthal,35 - 40 Jahre,38,16,22
False,8327004,Bärenthal,40 - 45 Jahre,38,23,15
False,8327004,Bärenthal,45 - 50 Jahre,21,14,7
False,8327004,Bärenthal,50 - 55 Jahre,18,9,9
False,8327004,Bärenthal,55 - 60 Jahre,34,13,21
False,8327004,Bärenthal,60 - 65 Jahre,34,18,16
False,8327004,Bärenthal,65 - 75 Jahre,38,14,24
False,8327004,Bärenthal,75 und mehr Jahre,31,8,23
False,8327004,Bärenthal,Insgesamt,449,225,224
False,8327005,Balgheim,unter 3 Jahre,32,17,15
False,8327005,Balgheim,3 -  6 Jahre,40,21,19
False,8327005,Balgheim,6 - 10 Jahre,44,24,20
False,8327005,Balgheim,10 - 15 Jahre,70,36,34
False,8327005,Balgheim,15 - 18 Jahre,42,23,19
False,8327005,Balgheim,18 - 20 Jahre,15,9,6
False,8327005,Balgheim,20 - 25 Jahre,67,33,34
False,8327005,Balgheim,25 - 30 Jahre,75,37,38
False,8327005,Balgheim,30 - 35 Jahre,71,34,37
False,8327005,Balgheim,35 - 40 Jahre,68,34,34
False,8327005,Balgheim,40 - 45 Jahre,70,38,32
False,8327005,Balgheim,45 - 50 Jahre,55,26,29
False,8327005,Balgheim,50 - 55 Jahre,64,29,35
False,8327005,Balgheim,55 - 60 Jahre,67,38,29
False,8327005,Balgheim,60 - 65 Jahre,42,26,16
False,8327005,Balgheim,65 - 75 Jahre,58,26,32
False,8327005,Balgheim,75 und mehr Jahre,37,12,25
False,8327005,Balgheim,Insgesamt,917,463,454
False,8327006,Böttingen,unter 3 Jahre,69,39,30
False,8327006,Böttingen,3 -  6 Jahre,65,40,25
False,8327006,Böttingen,6 - 10 Jahre,58,30,28
False,8327006,Böttingen,10 - 15 Jahre,80,37,43
False,8327006,Böttingen,15 - 18 Jahre,46,27,19
False,8327006,Böttingen,18 - 20 Jahre,34,17,17
False,8327006,Böttingen,20 - 25 Jahre,96,51,45
False,8327006,Böttingen,25 - 30 Jahre,120,64,56
False,8327006,Böttingen,30 - 35 Jahre,146,71,75
False,8327006,Böttingen,35 - 40 Jahre,100,59,41
False,8327006,Böttingen,40 - 45 Jahre,99,47,52
False,8327006,Böttingen,45 - 50 Jahre,70,39,31
False,8327006,Böttingen,50 - 55 Jahre,55,31,24
False,8327006,Böttingen,55 - 60 Jahre,94,47,47
False,8327006,Böttingen,60 - 65 Jahre,78,33,45
False,8327006,Böttingen,65 - 75 Jahre,107,39,68
False,8327006,Böttingen,75 und mehr Jahre,61,14,47
False,8327006,Böttingen,Insgesamt,1378,685,693
False,8327007,Bubsheim,unter 3 Jahre,28,9,19
False,8327007,Bubsheim,3 -  6 Jahre,41,20,21
False,8327007,Bubsheim,6 - 10 Jahre,46,29,17
False,8327007,Bubsheim,10 - 15 Jahre,64,30,34
False,8327007,Bubsheim,15 - 18 Jahre,45,21,24
False,8327007,Bubsheim,18 - 20 Jahre,34,16,18
False,8327007,Bubsheim,20 - 25 Jahre,65,36,29
False,8327007,Bubsheim,25 - 30 Jahre,68,45,23
False,8327007,Bubsheim,30 - 35 Jahre,83,48,35
False,8327007,Bubsheim,35 - 40 Jahre,74,33,41
False,8327007,Bubsheim,40 - 45 Jahre,72,37,35
False,8327007,Bubsheim,45 - 50 Jahre,49,23,26
False,8327007,Bubsheim,50 - 55 Jahre,39,22,17
False,8327007,Bubsheim,55 - 60 Jahre,61,30,31
False,8327007,Bubsheim,60 - 65 Jahre,53,26,27
False,8327007,Bubsheim,65 - 75 Jahre,50,26,24
False,8327007,Bubsheim,75 und mehr Jahre,41,7,34
False,8327007,Bubsheim,Insgesamt,913,458,455
False,8327008,Buchheim,unter 3 Jahre,35,16,19
False,8327008,Buchheim,3 -  6 Jahre,25,12,13
False,8327008,Buchheim,6 - 10 Jahre,43,21,22
False,8327008,Buchheim,10 - 15 Jahre,59,37,22
False,8327008,Buchheim,15 - 18 Jahre,30,16,14
False,8327008,Buchheim,18 - 20 Jahre,14,9,5
False,8327008,Buchheim,20 - 25 Jahre,27,11,16
False,8327008,Buchheim,25 - 30 Jahre,41,24,17
False,8327008,Buchheim,30 - 35 Jahre,45,25,20
False,8327008,Buchheim,35 - 40 Jahre,54,29,25
False,8327008,Buchheim,40 - 45 Jahre,51,26,25
False,8327008,Buchheim,45 - 50 Jahre,35,24,11
False,8327008,Buchheim,50 - 55 Jahre,16,6,10
False,8327008,Buchheim,55 - 60 Jahre,29,15,14
False,8327008,Buchheim,60 - 65 Jahre,32,15,17
False,8327008,Buchheim,65 - 75 Jahre,67,26,41
False,8327008,Buchheim,75 und mehr Jahre,27,9,18
False,8327008,Buchheim,Insgesamt,630,321,309
False,8327009,Deilingen,unter 3 Jahre,67,37,30
False,8327009,Deilingen,3 -  6 Jahre,69,33,36
False,8327009,Deilingen,6 - 10 Jahre,90,41,49
False,8327009,Deilingen,10 - 15 Jahre,94,51,43
False,8327009,Deilingen,15 - 18 Jahre,65,31,34
False,8327009,Deilingen,18 - 20 Jahre,44,24,20
False,8327009,Deilingen,20 - 25 Jahre,104,55,49
False,8327009,Deilingen,25 - 30 Jahre,120,67,53
False,8327009,Deilingen,30 - 35 Jahre,127,68,59
False,8327009,Deilingen,35 - 40 Jahre,127,64,63
False,8327009,Deilingen,40 - 45 Jahre,108,58,50
False,8327009,Deilingen,45 - 50 Jahre,90,51,39
False,8327009,Deilingen,50 - 55 Jahre,72,37,35
False,8327009,Deilingen,55 - 60 Jahre,112,49,63
False,8327009,Deilingen,60 - 65 Jahre,91,43,48
False,8327009,Deilingen,65 - 75 Jahre,137,53,84
False,8327009,Deilingen,75 und mehr Jahre,74,22,52
False,8327009,Deilingen,Insgesamt,1591,784,807
False,8327010,Denkingen,unter 3 Jahre,94,54,40
False,8327010,Denkingen,3 -  6 Jahre,103,55,48
False,8327010,Denkingen,6 - 10 Jahre,140,66,74
False,8327010,Denkingen,10 - 15 Jahre,153,84,69
False,8327010,Denkingen,15 - 18 Jahre,83,43,40
False,8327010,Denkingen,18 - 20 Jahre,44,30,14
False,8327010,Denkingen,20 - 25 Jahre,145,80,65
False,8327010,Denkingen,25 - 30 Jahre,179,109,70
False,8327010,Denkingen,30 - 35 Jahre,208,108,100
False,8327010,Denkingen,35 - 40 Jahre,162,76,86
False,8327010,Denkingen,40 - 45 Jahre,151,73,78
False,8327010,Denkingen,45 - 50 Jahre,132,65,67
False,8327010,Denkingen,50 - 55 Jahre,115,54,61
False,8327010,Denkingen,55 - 60 Jahre,171,94,77
False,8327010,Denkingen,60 - 65 Jahre,119,60,59
False,8327010,Denkingen,65 - 75 Jahre,180,84,96
False,8327010,Denkingen,75 und mehr Jahre,104,31,73
False,8327010,Denkingen,Insgesamt,2283,1166,1117
False,8327011,Dürbheim,unter 3 Jahre,65,27,38
False,8327011,Dürbheim,3 -  6 Jahre,54,37,17
False,8327011,Dürbheim,6 - 10 Jahre,78,42,36
False,8327011,Dürbheim,10 - 15 Jahre,81,37,44
False,8327011,Dürbheim,15 - 18 Jahre,45,22,23
False,8327011,Dürbheim,18 - 20 Jahre,36,23,13
False,8327011,Dürbheim,20 - 25 Jahre,76,36,40
False,8327011,Dürbheim,25 - 30 Jahre,107,54,53
False,8327011,Dürbheim,30 - 35 Jahre,153,84,69
False,8327011,Dürbheim,35 - 40 Jahre,122,63,59
False,8327011,Dürbheim,40 - 45 Jahre,107,51,56
False,8327011,Dürbheim,45 - 50 Jahre,87,43,44
False,8327011,Dürbheim,50 - 55 Jahre,78,44,34
False,8327011,Dürbheim,55 - 60 Jahre,100,52,48
False,8327011,Dürbheim,60 - 65 Jahre,76,40,36
False,8327011,Dürbheim,65 - 75 Jahre,111,54,57
False,8327011,Dürbheim,75 und mehr Jahre,76,18,58
False,8327011,Dürbheim,Insgesamt,1452,727,725
False,8327012,Durchhausen,unter 3 Jahre,34,15,19
False,8327012,Durchhausen,3 -  6 Jahre,32,19,13
False,8327012,Durchhausen,6 - 10 Jahre,62,32,30
False,8327012,Durchhausen,10 - 15 Jahre,63,37,26
False,8327012,Durchhausen,15 - 18 Jahre,27,13,14
False,8327012,Durchhausen,18 - 20 Jahre,14,8,6
False,8327012,Durchhausen,20 - 25 Jahre,49,27,22
False,8327012,Durchhausen,25 - 30 Jahre,71,42,29
False,8327012,Durchhausen,30 - 35 Jahre,66,37,29
False,8327012,Durchhausen,35 - 40 Jahre,80,39,41
False,8327012,Durchhausen,40 - 45 Jahre,49,32,17
False,8327012,Durchhausen,45 - 50 Jahre,42,22,20
False,8327012,Durchhausen,50 - 55 Jahre,48,19,29
False,8327012,Durchhausen,55 - 60 Jahre,66,37,29
False,8327012,Durchhausen,60 - 65 Jahre,40,18,22
False,8327012,Durchhausen,65 - 75 Jahre,85,42,43
False,8327012,Durchhausen,75 und mehr Jahre,41,11,30
False,8327012,Durchhausen,Insgesamt,869,450,419
False,8327013,Egesheim,unter 3 Jahre,17,7,10
False,8327013,Egesheim,3 -  6 Jahre,23,15,8
False,8327013,Egesheim,6 - 10 Jahre,41,25,16
False,8327013,Egesheim,10 - 15 Jahre,43,23,20
False,8327013,Egesheim,15 - 18 Jahre,27,17,10
False,8327013,Egesheim,18 - 20 Jahre,19,15,4
False,8327013,Egesheim,20 - 25 Jahre,49,30,19
False,8327013,Egesheim,25 - 30 Jahre,44,27,17
False,8327013,Egesheim,30 - 35 Jahre,52,28,24
False,8327013,Egesheim,35 - 40 Jahre,48,27,21
False,8327013,Egesheim,40 - 45 Jahre,29,15,14
False,8327013,Egesheim,45 - 50 Jahre,34,15,19
False,8327013,Egesheim,50 - 55 Jahre,26,18,8
False,8327013,Egesheim,55 - 60 Jahre,40,19,21
False,8327013,Egesheim,60 - 65 Jahre,24,12,12
False,8327013,Egesheim,65 - 75 Jahre,37,15,22
False,8327013,Egesheim,75 und mehr Jahre,26,7,19
False,8327013,Egesheim,Insgesamt,579,315,264
False,8327016,"Fridingen an der Donau, Stadt",unter 3 Jahre,135,71,64
False,8327016,"Fridingen an der Donau, Stadt",3 -  6 Jahre,149,69,80
False,8327016,"Fridingen an der Donau, Stadt",6 - 10 Jahre,183,88,95
False,8327016,"Fridingen an der Donau, Stadt",10 - 15 Jahre,196,100,96
False,8327016,"Fridingen an der Donau, Stadt",15 - 18 Jahre,115,50,65
False,8327016,"Fridingen an der Donau, Stadt",18 - 20 Jahre,75,46,29
False,8327016,"Fridingen an der Donau, Stadt",20 - 25 Jahre,177,95,82
False,8327016,"Fridingen an der Donau, Stadt",25 - 30 Jahre,238,129,109
False,8327016,"Fridingen an der Donau, Stadt",30 - 35 Jahre,306,144,162
False,8327016,"Fridingen an der Donau, Stadt",35 - 40 Jahre,269,138,131
False,8327016,"Fridingen an der Donau, Stadt",40 - 45 Jahre,228,113,115
False,8327016,"Fridingen an der Donau, Stadt",45 - 50 Jahre,201,112,89
False,8327016,"Fridingen an der Donau, Stadt",50 - 55 Jahre,179,88,91
False,8327016,"Fridingen an der Donau, Stadt",55 - 60 Jahre,232,111,121
False,8327016,"Fridingen an der Donau, Stadt",60 - 65 Jahre,197,99,98
False,8327016,"Fridingen an der Donau, Stadt",65 - 75 Jahre,306,146,160
False,8327016,"Fridingen an der Donau, Stadt",75 und mehr Jahre,151,53,98
False,8327016,"Fridingen an der Donau, Stadt",Insgesamt,3337,1652,1685
False,8327017,Frittlingen,unter 3 Jahre,80,38,42
False,8327017,Frittlingen,3 -  6 Jahre,78,31,47
False,8327017,Frittlingen,6 - 10 Jahre,102,58,44
False,8327017,Frittlingen,10 - 15 Jahre,145,76,69
False,8327017,Frittlingen,15 - 18 Jahre,62,37,25
False,8327017,Frittlingen,18 - 20 Jahre,46,22,24
False,8327017,Frittlingen,20 - 25 Jahre,109,54,55
False,8327017,Frittlingen,25 - 30 Jahre,149,80,69
False,8327017,Frittlingen,30 - 35 Jahre,169,96,73
False,8327017,Frittlingen,35 - 40 Jahre,170,75,95
False,8327017,Frittlingen,40 - 45 Jahre,145,80,65
False,8327017,Frittlingen,45 - 50 Jahre,125,69,56
False,8327017,Frittlingen,50 - 55 Jahre,85,53,32
False,8327017,Frittlingen,55 - 60 Jahre,118,56,62
False,8327017,Frittlingen,60 - 65 Jahre,96,49,47
False,8327017,Frittlingen,65 - 75 Jahre,158,67,91
False,8327017,Frittlingen,75 und mehr Jahre,90,23,67
False,8327017,Frittlingen,Insgesamt,1927,964,963
False,8327018,"Geisingen, Stadt",unter 3 Jahre,228,107,121
False,8327018,"Geisingen, Stadt",3 -  6 Jahre,223,107,116
False,8327018,"Geisingen, Stadt",6 - 10 Jahre,316,166,150
False,8327018,"Geisingen, Stadt",10 - 15 Jahre,403,190,213
False,8327018,"Geisingen, Stadt",15 - 18 Jahre,230,112,118
False,8327018,"Geisingen, Stadt",18 - 20 Jahre,140,62,78
False,8327018,"Geisingen, Stadt",20 - 25 Jahre,364,186,178
False,8327018,"Geisingen, Stadt",25 - 30 Jahre,443,225,218
False,8327018,"Geisingen, Stadt",30 - 35 Jahre,484,271,213
False,8327018,"Geisingen, Stadt",35 - 40 Jahre,444,222,222
False,8327018,"Geisingen, Stadt",40 - 45 Jahre,456,247,209
False,8327018,"Geisingen, Stadt",45 - 50 Jahre,360,190,170
False,8327018,"Geisingen, Stadt",50 - 55 Jahre,323,179,144
False,8327018,"Geisingen, Stadt",55 - 60 Jahre,408,218,190
False,8327018,"Geisingen, Stadt",60 - 65 Jahre,289,144,145
False,8327018,"Geisingen, Stadt",65 - 75 Jahre,551,231,320
False,8327018,"Geisingen, Stadt",75 und mehr Jahre,450,145,305
False,8327018,"Geisingen, Stadt",Insgesamt,6112,3002,3110
False,8327019,Gosheim,unter 3 Jahre,155,79,76
False,8327019,Gosheim,3 -  6 Jahre,160,83,77
False,8327019,Gosheim,6 - 10 Jahre,212,115,97
False,8327019,Gosheim,10 - 15 Jahre,240,121,119
False,8327019,Gosheim,15 - 18 Jahre,139,77,62
False,8327019,Gosheim,18 - 20 Jahre,92,45,47
False,8327019,Gosheim,20 - 25 Jahre,227,111,116
False,8327019,Gosheim,25 - 30 Jahre,269,138,131
False,8327019,Gosheim,30 - 35 Jahre,363,184,179
False,8327019,Gosheim,35 - 40 Jahre,304,158,146
False,8327019,Gosheim,40 - 45 Jahre,231,124,107
False,8327019,Gosheim,45 - 50 Jahre,200,104,96
False,8327019,Gosheim,50 - 55 Jahre,186,84,102
False,8327019,Gosheim,55 - 60 Jahre,250,117,133
False,8327019,Gosheim,60 - 65 Jahre,230,108,122
False,8327019,Gosheim,65 - 75 Jahre,310,144,166
False,8327019,Gosheim,75 und mehr Jahre,173,45,128
False,8327019,Gosheim,Insgesamt,3741,1837,1904
False,8327020,Gunningen,unter 3 Jahre,27,12,15
False,8327020,Gunningen,3 -  6 Jahre,33,19,14
False,8327020,Gunningen,6 - 10 Jahre,39,20,19
False,8327020,Gunningen,10 - 15 Jahre,37,23,14
False,8327020,Gunningen,15 - 18 Jahre,31,18,13
False,8327020,Gunningen,18 - 20 Jahre,14,8,6
False,8327020,Gunningen,20 - 25 Jahre,48,28,20
False,8327020,Gunningen,25 - 30 Jahre,58,23,35
False,8327020,Gunningen,30 - 35 Jahre,56,29,27
False,8327020,Gunningen,35 - 40 Jahre,59,29,30
False,8327020,Gunningen,40 - 45 Jahre,54,29,25
False,8327020,Gunningen,45 - 50 Jahre,28,15,13
False,8327020,Gunningen,50 - 55 Jahre,43,24,19
False,8327020,Gunningen,55 - 60 Jahre,49,25,24
False,8327020,Gunningen,60 - 65 Jahre,14,10,4
False,8327020,Gunningen,65 - 75 Jahre,38,13,25
False,8327020,Gunningen,75 und mehr Jahre,41,19,22
False,8327020,Gunningen,Insgesamt,669,344,325
False,8327023,Hausen ob Verena,unter 3 Jahre,25,14,11
False,8327023,Hausen ob Verena,3 -  6 Jahre,32,17,15
False,8327023,Hausen ob Verena,6 - 10 Jahre,45,22,23
False,8327023,Hausen ob Verena,10 - 15 Jahre,41,18,23
False,8327023,Hausen ob Verena,15 - 18 Jahre,19,9,10
False,8327023,Hausen ob Verena,18 - 20 Jahre,20,11,9
False,8327023,Hausen ob Verena,20 - 25 Jahre,31,15,16
False,8327023,Hausen ob Verena,25 - 30 Jahre,49,22,27
False,8327023,Hausen ob Verena,30 - 35 Jahre,50,29,21
False,8327023,Hausen ob Verena,35 - 40 Jahre,51,20,31
False,8327023,Hausen ob Verena,40 - 45 Jahre,43,21,22
False,8327023,Hausen ob Verena,45 - 50 Jahre,45,24,21
False,8327023,Hausen ob Verena,50 - 55 Jahre,31,15,16
False,8327023,Hausen ob Verena,55 - 60 Jahre,68,39,29
False,8327023,Hausen ob Verena,60 - 65 Jahre,36,20,16
False,8327023,Hausen ob Verena,65 - 75 Jahre,56,20,36
False,8327023,Hausen ob Verena,75 und mehr Jahre,41,13,28
False,8327023,Hausen ob Verena,Insgesamt,683,329,354
False,8327025,Immendingen,unter 3 Jahre,190,89,101
False,8327025,Immendingen,3 -  6 Jahre,232,126,106
False,8327025,Immendingen,6 - 10 Jahre,285,145,140
False,8327025,Immendingen,10 - 15 Jahre,334,180,154
False,8327025,Immendingen,15 - 18 Jahre,176,85,91
False,8327025,Immendingen,18 - 20 Jahre,115,58,57
False,8327025,Immendingen,20 - 25 Jahre,436,263,173
False,8327025,Immendingen,25 - 30 Jahre,539,338,201
False,8327025,Immendingen,30 - 35 Jahre,551,319,232
False,8327025,Immendingen,35 - 40 Jahre,426,231,195
False,8327025,Immendingen,40 - 45 Jahre,368,181,187
False,8327025,Immendingen,45 - 50 Jahre,314,173,141
False,8327025,Immendingen,50 - 55 Jahre,280,151,129
False,8327025,Immendingen,55 - 60 Jahre,379,192,187
False,8327025,Immendingen,60 - 65 Jahre,283,146,137
False,8327025,Immendingen,65 - 75 Jahre,463,214,249
False,8327025,Immendingen,75 und mehr Jahre,266,82,184
False,8327025,Immendingen,Insgesamt,5637,2973,2664
False,8327027,Irndorf,unter 3 Jahre,33,15,18
False,8327027,Irndorf,3 -  6 Jahre,37,16,21
False,8327027,Irndorf,6 - 10 Jahre,30,9,21
False,8327027,Irndorf,10 - 15 Jahre,35,16,19
False,8327027,Irndorf,15 - 18 Jahre,30,20,10
False,8327027,Irndorf,18 - 20 Jahre,11,3,8
False,8327027,Irndorf,20 - 25 Jahre,36,20,16
False,8327027,Irndorf,25 - 30 Jahre,58,37,21
False,8327027,Irndorf,30 - 35 Jahre,66,35,31
False,8327027,Irndorf,35 - 40 Jahre,58,29,29
False,8327027,Irndorf,40 - 45 Jahre,44,25,19
False,8327027,Irndorf,45 - 50 Jahre,22,14,8
False,8327027,Irndorf,50 - 55 Jahre,35,14,21
False,8327027,Irndorf,55 - 60 Jahre,69,36,33
False,8327027,Irndorf,60 - 65 Jahre,53,31,22
False,8327027,Irndorf,65 - 75 Jahre,97,34,63
False,8327027,Irndorf,75 und mehr Jahre,36,9,27
False,8327027,Irndorf,Insgesamt,750,363,387
False,8327029,Königsheim,unter 3 Jahre,20,14,6
False,8327029,Königsheim,3 -  6 Jahre,21,9,12
False,8327029,Königsheim,6 - 10 Jahre,21,9,12
False,8327029,Königsheim,10 - 15 Jahre,27,15,12
False,8327029,Königsheim,15 - 18 Jahre,31,15,16
False,8327029,Königsheim,18 - 20 Jahre,11,6,5
False,8327029,Königsheim,20 - 25 Jahre,30,20,10
False,8327029,Königsheim,25 - 30 Jahre,42,20,22
False,8327029,Königsheim,30 - 35 Jahre,50,25,25
False,8327029,Königsheim,35 - 40 Jahre,44,24,20
False,8327029,Königsheim,40 - 45 Jahre,36,20,16
False,8327029,Königsheim,45 - 50 Jahre,20,10,10
False,8327029,Königsheim,50 - 55 Jahre,24,12,12
False,8327029,Königsheim,55 - 60 Jahre,44,23,21
False,8327029,Königsheim,60 - 65 Jahre,34,19,15
False,8327029,Königsheim,65 - 75 Jahre,44,18,26
False,8327029,Königsheim,75 und mehr Jahre,14,6,8
False,8327029,Königsheim,Insgesamt,513,265,248
False,8327030,Kolbingen,unter 3 Jahre,55,19,36
False,8327030,Kolbingen,3 -  6 Jahre,47,27,20
False,8327030,Kolbingen,6 - 10 Jahre,55,33,22
False,8327030,Kolbingen,10 - 15 Jahre,66,32,34
False,8327030,Kolbingen,15 - 18 Jahre,34,22,12
False,8327030,Kolbingen,18 - 20 Jahre,27,16,11
False,8327030,Kolbingen,20 - 25 Jahre,78,34,44
False,8327030,Kolbingen,25 - 30 Jahre,98,52,46
False,8327030,Kolbingen,30 - 35 Jahre,110,60,50
False,8327030,Kolbingen,35 - 40 Jahre,86,45,41
False,8327030,Kolbingen,40 - 45 Jahre,82,39,43
False,8327030,Kolbingen,45 - 50 Jahre,63,35,28
False,8327030,Kolbingen,50 - 55 Jahre,62,25,37
False,8327030,Kolbingen,55 - 60 Jahre,91,47,44
False,8327030,Kolbingen,60 - 65 Jahre,73,38,35
False,8327030,Kolbingen,65 - 75 Jahre,98,40,58
False,8327030,Kolbingen,75 und mehr Jahre,58,20,38
False,8327030,Kolbingen,Insgesamt,1183,584,599
False,8327033,Mahlstetten,unter 3 Jahre,24,21,3
False,8327033,Mahlstetten,3 -  6 Jahre,27,13,14
False,8327033,Mahlstetten,6 - 10 Jahre,46,23,23
False,8327033,Mahlstetten,10 - 15 Jahre,54,31,23
False,8327033,Mahlstetten,15 - 18 Jahre,19,13,6
False,8327033,Mahlstetten,18 - 20 Jahre,22,9,13
False,8327033,Mahlstetten,20 - 25 Jahre,25,15,10
False,8327033,Mahlstetten,25 - 30 Jahre,48,30,18
False,8327033,Mahlstetten,30 - 35 Jahre,60,27,33
False,8327033,Mahlstetten,35 - 40 Jahre,85,42,43
False,8327033,Mahlstetten,40 - 45 Jahre,50,30,20
False,8327033,Mahlstetten,45 - 50 Jahre,31,16,15
False,8327033,Mahlstetten,50 - 55 Jahre,26,13,13
False,8327033,Mahlstetten,55 - 60 Jahre,57,26,31
False,8327033,Mahlstetten,60 - 65 Jahre,53,29,24
False,8327033,Mahlstetten,65 - 75 Jahre,85,43,42
False,8327033,Mahlstetten,75 und mehr Jahre,30,11,19
False,8327033,Mahlstetten,Insgesamt,742,392,350
False,8327036,"Mühlheim an der Donau, Stadt",unter 3 Jahre,105,43,62
False,8327036,"Mühlheim an der Donau, Stadt",3 -  6 Jahre,110,47,63
False,8327036,"Mühlheim an der Donau, Stadt",6 - 10 Jahre,161,90,71
False,8327036,"Mühlheim an der Donau, Stadt",10 - 15 Jahre,209,112,97
False,8327036,"Mühlheim an der Donau, Stadt",15 - 18 Jahre,147,77,70
False,8327036,"Mühlheim an der Donau, Stadt",18 - 20 Jahre,79,42,37
False,8327036,"Mühlheim an der Donau, Stadt",20 - 25 Jahre,224,119,105
False,8327036,"Mühlheim an der Donau, Stadt",25 - 30 Jahre,291,153,138
False,8327036,"Mühlheim an der Donau, Stadt",30 - 35 Jahre,271,151,120
False,8327036,"Mühlheim an der Donau, Stadt",35 - 40 Jahre,245,126,119
False,8327036,"Mühlheim an der Donau, Stadt",40 - 45 Jahre,253,116,137
False,8327036,"Mühlheim an der Donau, Stadt",45 - 50 Jahre,226,109,117
False,8327036,"Mühlheim an der Donau, Stadt",50 - 55 Jahre,236,127,109
False,8327036,"Mühlheim an der Donau, Stadt",55 - 60 Jahre,259,142,117
False,8327036,"Mühlheim an der Donau, Stadt",60 - 65 Jahre,185,84,101
False,8327036,"Mühlheim an der Donau, Stadt",65 - 75 Jahre,321,144,177
False,8327036,"Mühlheim an der Donau, Stadt",75 und mehr Jahre,189,54,135
False,8327036,"Mühlheim an der Donau, Stadt",Insgesamt,3511,1736,1775
False,8327038,Neuhausen ob Eck,unter 3 Jahre,139,69,70
False,8327038,Neuhausen ob Eck,3 -  6 Jahre,153,74,79
False,8327038,Neuhausen ob Eck,6 - 10 Jahre,209,123,86
False,8327038,Neuhausen ob Eck,10 - 15 Jahre,250,139,111
False,8327038,Neuhausen ob Eck,15 - 18 Jahre,127,59,68
False,8327038,Neuhausen ob Eck,18 - 20 Jahre,66,27,39
False,8327038,Neuhausen ob Eck,20 - 25 Jahre,197,96,101
False,8327038,Neuhausen ob Eck,25 - 30 Jahre,277,150,127
False,8327038,Neuhausen ob Eck,30 - 35 Jahre,302,151,151
False,8327038,Neuhausen ob Eck,35 - 40 Jahre,307,154,153
False,8327038,Neuhausen ob Eck,40 - 45 Jahre,229,125,104
False,8327038,Neuhausen ob Eck,45 - 50 Jahre,157,86,71
False,8327038,Neuhausen ob Eck,50 - 55 Jahre,158,67,91
False,8327038,Neuhausen ob Eck,55 - 60 Jahre,233,126,107
False,8327038,Neuhausen ob Eck,60 - 65 Jahre,179,86,93
False,8327038,Neuhausen ob Eck,65 - 75 Jahre,264,115,149
False,8327038,Neuhausen ob Eck,75 und mehr Jahre,166,55,111
False,8327038,Neuhausen ob Eck,Insgesamt,3413,1702,1711
False,8327040,Reichenbach am Heuberg,unter 3 Jahre,25,8,17
False,8327040,Reichenbach am Heuberg,3 -  6 Jahre,19,11,8
False,8327040,Reichenbach am Heuberg,6 - 10 Jahre,40,20,20
False,8327040,Reichenbach am Heuberg,10 - 15 Jahre,33,14,19
False,8327040,Reichenbach am Heuberg,15 - 18 Jahre,18,9,9
False,8327040,Reichenbach am Heuberg,18 - 20 Jahre,10,7,3
False,8327040,Reichenbach am Heuberg,20 - 25 Jahre,31,18,13
False,8327040,Reichenbach am Heuberg,25 - 30 Jahre,46,29,17
False,8327040,Reichenbach am Heuberg,30 - 35 Jahre,45,23,22
False,8327040,Reichenbach am Heuberg,35 - 40 Jahre,46,25,21
False,8327040,Reichenbach am Heuberg,40 - 45 Jahre,37,22,15
False,8327040,Reichenbach am Heuberg,45 - 50 Jahre,21,10,11
False,8327040,Reichenbach am Heuberg,50 - 55 Jahre,21,8,13
False,8327040,Reichenbach am Heuberg,55 - 60 Jahre,42,19,23
False,8327040,Reichenbach am Heuberg,60 - 65 Jahre,29,15,14
False,8327040,Reichenbach am Heuberg,65 - 75 Jahre,39,17,22
False,8327040,Reichenbach am Heuberg,75 und mehr Jahre,13,3,10
False,8327040,Reichenbach am Heuberg,Insgesamt,515,258,257
False,8327041,Renquishausen,unter 3 Jahre,22,13,9
False,8327041,Renquishausen,3 -  6 Jahre,36,21,15
False,8327041,Renquishausen,6 - 10 Jahre,45,23,22
False,8327041,Renquishausen,10 - 15 Jahre,43,22,21
False,8327041,Renquishausen,15 - 18 Jahre,33,15,18
False,8327041,Renquishausen,18 - 20 Jahre,13,7,6
False,8327041,Renquishausen,20 - 25 Jahre,33,18,15
False,8327041,Renquishausen,25 - 30 Jahre,54,30,24
False,8327041,Renquishausen,30 - 35 Jahre,65,28,37
False,8327041,Renquishausen,35 - 40 Jahre,63,34,29
False,8327041,Renquishausen,40 - 45 Jahre,49,27,22
False,8327041,Renquishausen,45 - 50 Jahre,42,21,21
False,8327041,Renquishausen,50 - 55 Jahre,30,15,15
False,8327041,Renquishausen,55 - 60 Jahre,35,18,17
False,8327041,Renquishausen,60 - 65 Jahre,31,14,17
False,8327041,Renquishausen,65 - 75 Jahre,59,29,30
False,8327041,Renquishausen,75 und mehr Jahre,27,8,19
False,8327041,Renquishausen,Insgesamt,680,343,337
False,8327046,"Spaichingen, Stadt",unter 3 Jahre,404,204,200
False,8327046,"Spaichingen, Stadt",3 -  6 Jahre,463,226,237
False,8327046,"Spaichingen, Stadt",6 - 10 Jahre,600,302,298
False,8327046,"Spaichingen, Stadt",10 - 15 Jahre,699,355,344
False,8327046,"Spaichingen, Stadt",15 - 18 Jahre,420,235,185
False,8327046,"Spaichingen, Stadt",18 - 20 Jahre,265,132,133
False,8327046,"Spaichingen, Stadt",20 - 25 Jahre,716,349,367
False,8327046,"Spaichingen, Stadt",25 - 30 Jahre,884,479,405
False,8327046,"Spaichingen, Stadt",30 - 35 Jahre,948,482,466
False,8327046,"Spaichingen, Stadt",35 - 40 Jahre,872,455,417
False,8327046,"Spaichingen, Stadt",40 - 45 Jahre,884,425,459
False,8327046,"Spaichingen, Stadt",45 - 50 Jahre,677,343,334
False,8327046,"Spaichingen, Stadt",50 - 55 Jahre,688,346,342
False,8327046,"Spaichingen, Stadt",55 - 60 Jahre,854,432,422
False,8327046,"Spaichingen, Stadt",60 - 65 Jahre,673,339,334
False,8327046,"Spaichingen, Stadt",65 - 75 Jahre,1018,420,598
False,8327046,"Spaichingen, Stadt",75 und mehr Jahre,829,226,603
False,8327046,"Spaichingen, Stadt",Insgesamt,11894,5750,6144
False,8327048,Talheim,unter 3 Jahre,39,24,15
False,8327048,Talheim,3 -  6 Jahre,51,26,25
False,8327048,Talheim,6 - 10 Jahre,56,33,23
False,8327048,Talheim,10 - 15 Jahre,70,33,37
False,8327048,Talheim,15 - 18 Jahre,46,26,20
False,8327048,Talheim,18 - 20 Jahre,31,20,11
False,8327048,Talheim,20 - 25 Jahre,54,33,21
False,8327048,Talheim,25 - 30 Jahre,89,42,47
False,8327048,Talheim,30 - 35 Jahre,105,55,50
False,8327048,Talheim,35 - 40 Jahre,86,39,47
False,8327048,Talheim,40 - 45 Jahre,83,43,40
False,8327048,Talheim,45 - 50 Jahre,62,34,28
False,8327048,Talheim,50 - 55 Jahre,60,32,28
False,8327048,Talheim,55 - 60 Jahre,77,37,40
False,8327048,Talheim,60 - 65 Jahre,58,30,28
False,8327048,Talheim,65 - 75 Jahre,129,52,77
False,8327048,Talheim,75 und mehr Jahre,66,19,47
False,8327048,Talheim,Insgesamt,1162,578,584
False,8327049,"Trossingen, Stadt",unter 3 Jahre,534,281,253
False,8327049,"Trossingen, Stadt",3 -  6 Jahre,539,259,280
False,8327049,"Trossingen, Stadt",6 - 10 Jahre,741,350,391
False,8327049,"Trossingen, Stadt",10 - 15 Jahre,878,453,425
False,8327049,"Trossingen, Stadt",15 - 18 Jahre,545,272,273
False,8327049,"Trossingen, Stadt",18 - 20 Jahre,317,165,152
False,8327049,"Trossingen, Stadt",20 - 25 Jahre,933,506,427
False,8327049,"Trossingen, Stadt",25 - 30 Jahre,1209,570,639
False,8327049,"Trossingen, Stadt",30 - 35 Jahre,1179,627,552
False,8327049,"Trossingen, Stadt",35 - 40 Jahre,1038,492,546
False,8327049,"Trossingen, Stadt",40 - 45 Jahre,1015,509,506
False,8327049,"Trossingen, Stadt",45 - 50 Jahre,842,422,420
False,8327049,"Trossingen, Stadt",50 - 55 Jahre,747,375,372
False,8327049,"Trossingen, Stadt",55 - 60 Jahre,980,472,508
False,8327049,"Trossingen, Stadt",60 - 65 Jahre,742,376,366
False,8327049,"Trossingen, Stadt",65 - 75 Jahre,1265,530,735
False,8327049,"Trossingen, Stadt",75 und mehr Jahre,1003,288,715
False,8327049,"Trossingen, Stadt",Insgesamt,14507,6947,7560
False,8327050,"Tuttlingen, Stadt",unter 3 Jahre,1098,580,518
False,8327050,"Tuttlingen, Stadt",3 -  6 Jahre,1280,634,646
False,8327050,"Tuttlingen, Stadt",6 - 10 Jahre,1627,789,838
False,8327050,"Tuttlingen, Stadt",10 - 15 Jahre,1919,1046,873
False,8327050,"Tuttlingen, Stadt",15 - 18 Jahre,1271,644,627
False,8327050,"Tuttlingen, Stadt",18 - 20 Jahre,902,469,433
False,8327050,"Tuttlingen, Stadt",20 - 25 Jahre,2136,1141,995
False,8327050,"Tuttlingen, Stadt",25 - 30 Jahre,2858,1454,1404
False,8327050,"Tuttlingen, Stadt",30 - 35 Jahre,2833,1459,1374
False,8327050,"Tuttlingen, Stadt",35 - 40 Jahre,2581,1300,1281
False,8327050,"Tuttlingen, Stadt",40 - 45 Jahre,2169,1067,1102
False,8327050,"Tuttlingen, Stadt",45 - 50 Jahre,2042,988,1054
False,8327050,"Tuttlingen, Stadt",50 - 55 Jahre,2147,1074,1073
False,8327050,"Tuttlingen, Stadt",55 - 60 Jahre,2435,1199,1236
False,8327050,"Tuttlingen, Stadt",60 - 65 Jahre,1943,951,992
False,8327050,"Tuttlingen, Stadt",65 - 75 Jahre,3164,1312,1852
False,8327050,"Tuttlingen, Stadt",75 und mehr Jahre,2578,700,1878
False,8327050,"Tuttlingen, Stadt",Insgesamt,34983,16807,18176
False,8327051,Wehingen,unter 3 Jahre,114,55,59
False,8327051,Wehingen,3 -  6 Jahre,156,78,78
False,8327051,Wehingen,6 - 10 Jahre,201,88,113
False,8327051,Wehingen,10 - 15 Jahre,245,135,110
False,8327051,Wehingen,15 - 18 Jahre,153,74,79
False,8327051,Wehingen,18 - 20 Jahre,109,55,54
False,8327051,Wehingen,20 - 25 Jahre,220,106,114
False,8327051,Wehingen,25 - 30 Jahre,274,137,137
False,8327051,Wehingen,30 - 35 Jahre,312,186,126
False,8327051,Wehingen,35 - 40 Jahre,263,139,124
False,8327051,Wehingen,40 - 45 Jahre,239,119,120
False,8327051,Wehingen,45 - 50 Jahre,217,107,110
False,8327051,Wehingen,50 - 55 Jahre,194,99,95
False,8327051,Wehingen,55 - 60 Jahre,265,136,129
False,8327051,Wehingen,60 - 65 Jahre,170,81,89
False,8327051,Wehingen,65 - 75 Jahre,265,103,162
False,8327051,Wehingen,75 und mehr Jahre,158,48,110
False,8327051,Wehingen,Insgesamt,3555,1746,1809
False,8327054,Wurmlingen,unter 3 Jahre,119,55,64
False,8327054,Wurmlingen,3 -  6 Jahre,103,48,55
False,8327054,Wurmlingen,6 - 10 Jahre,176,96,80
False,8327054,Wurmlingen,10 - 15 Jahre,234,118,116
False,8327054,Wurmlingen,15 - 18 Jahre,105,55,50
False,8327054,Wurmlingen,18 - 20 Jahre,63,36,27
False,8327054,Wurmlingen,20 - 25 Jahre,203,105,98
False,8327054,Wurmlingen,25 - 30 Jahre,267,126,141
False,8327054,Wurmlingen,30 - 35 Jahre,313,149,164
False,8327054,Wurmlingen,35 - 40 Jahre,289,156,133
False,8327054,Wurmlingen,40 - 45 Jahre,251,121,130
False,8327054,Wurmlingen,45 - 50 Jahre,223,129,94
False,8327054,Wurmlingen,50 - 55 Jahre,237,108,129
False,8327054,Wurmlingen,55 - 60 Jahre,307,155,152
False,8327054,Wurmlingen,60 - 65 Jahre,232,117,115
False,8327054,Wurmlingen,65 - 75 Jahre,291,128,163
False,8327054,Wurmlingen,75 und mehr Jahre,225,67,158
False,8327054,Wurmlingen,Insgesamt,3638,1769,1869
False,8327055,Seitingen-Oberflacht,unter 3 Jahre,76,43,33
False,8327055,Seitingen-Oberflacht,3 -  6 Jahre,77,38,39
False,8327055,Seitingen-Oberflacht,6 - 10 Jahre,125,73,52
False,8327055,Seitingen-Oberflacht,10 - 15 Jahre,115,65,50
False,8327055,Seitingen-Oberflacht,15 - 18 Jahre,77,37,40
False,8327055,Seitingen-Oberflacht,18 - 20 Jahre,52,27,25
False,8327055,Seitingen-Oberflacht,20 - 25 Jahre,137,68,69
False,8327055,Seitingen-Oberflacht,25 - 30 Jahre,165,78,87
False,8327055,Seitingen-Oberflacht,30 - 35 Jahre,192,91,101
False,8327055,Seitingen-Oberflacht,35 - 40 Jahre,181,99,82
False,8327055,Seitingen-Oberflacht,40 - 45 Jahre,129,64,65
False,8327055,Seitingen-Oberflacht,45 - 50 Jahre,132,63,69
False,8327055,Seitingen-Oberflacht,50 - 55 Jahre,145,69,76
False,8327055,Seitingen-Oberflacht,55 - 60 Jahre,142,86,56
False,8327055,Seitingen-Oberflacht,60 - 65 Jahre,116,54,62
False,8327055,Seitingen-Oberflacht,65 - 75 Jahre,165,73,92
False,8327055,Seitingen-Oberflacht,75 und mehr Jahre,104,39,65
False,8327055,Seitingen-Oberflacht,Insgesamt,2130,1067,1063
False,8327056,Rietheim-Weilheim,unter 3 Jahre,79,43,36
False,8327056,Rietheim-Weilheim,3 -  6 Jahre,83,45,38
False,8327056,Rietheim-Weilheim,6 - 10 Jahre,126,69,57
False,8327056,Rietheim-Weilheim,10 - 15 Jahre,143,61,82
False,8327056,Rietheim-Weilheim,15 - 18 Jahre,66,44,22
False,8327056,Rietheim-Weilheim,18 - 20 Jahre,45,24,21
False,8327056,Rietheim-Weilheim,20 - 25 Jahre,138,78,60
False,8327056,Rietheim-Weilheim,25 - 30 Jahre,206,103,103
False,8327056,Rietheim-Weilheim,30 - 35 Jahre,204,92,112
False,8327056,Rietheim-Weilheim,35 - 40 Jahre,202,92,110
False,8327056,Rietheim-Weilheim,40 - 45 Jahre,157,74,83
False,8327056,Rietheim-Weilheim,45 - 50 Jahre,141,67,74
False,8327056,Rietheim-Weilheim,50 - 55 Jahre,150,63,87
False,8327056,Rietheim-Weilheim,55 - 60 Jahre,172,94,78
False,8327056,Rietheim-Weilheim,60 - 65 Jahre,147,73,74
False,8327056,Rietheim-Weilheim,65 - 75 Jahre,224,112,112
False,8327056,Rietheim-Weilheim,75 und mehr Jahre,152,57,95
False,8327056,Rietheim-Weilheim,Insgesamt,2435,1191,1244
False,8327057,Emmingen-Liptingen,unter 3 Jahre,150,84,66
False,8327057,Emmingen-Liptingen,3 -  6 Jahre,150,70,80
False,8327057,Emmingen-Liptingen,6 - 10 Jahre,240,107,133
False,8327057,Emmingen-Liptingen,10 - 15 Jahre,241,118,123
False,8327057,Emmingen-Liptingen,15 - 18 Jahre,129,66,63
False,8327057,Emmingen-Liptingen,18 - 20 Jahre,91,42,49
False,8327057,Emmingen-Liptingen,20 - 25 Jahre,268,154,114
False,8327057,Emmingen-Liptingen,25 - 30 Jahre,338,187,151
False,8327057,Emmingen-Liptingen,30 - 35 Jahre,377,212,165
False,8327057,Emmingen-Liptingen,35 - 40 Jahre,343,177,166
False,8327057,Emmingen-Liptingen,40 - 45 Jahre,317,169,148
False,8327057,Emmingen-Liptingen,45 - 50 Jahre,246,135,111
False,8327057,Emmingen-Liptingen,50 - 55 Jahre,222,108,114
False,8327057,Emmingen-Liptingen,55 - 60 Jahre,276,138,138
False,8327057,Emmingen-Liptingen,60 - 65 Jahre,197,109,88
False,8327057,Emmingen-Liptingen,65 - 75 Jahre,316,139,177
False,8327057,Emmingen-Liptingen,75 und mehr Jahre,174,53,121
False,8327057,Emmingen-Liptingen,Insgesamt,4075,2068,2007
False,8335,Landkreis Konstanz,unter 3 Jahre,8003,4138,3865
False,8335,Landkreis Konstanz,3 -  6 Jahre,8395,4305,4090
False,8335,Landkreis Konstanz,6 - 10 Jahre,10992,5561,5431
False,8335,Landkreis Konstanz,10 - 15 Jahre,12824,6534,6290
False,8335,Landkreis Konstanz,15 - 18 Jahre,7215,3686,3529
False,8335,Landkreis Konstanz,18 - 20 Jahre,4965,2550,2415
False,8335,Landkreis Konstanz,20 - 25 Jahre,15754,7986,7768
False,8335,Landkreis Konstanz,25 - 30 Jahre,23623,11948,11675
False,8335,Landkreis Konstanz,30 - 35 Jahre,25178,13147,12031
False,8335,Landkreis Konstanz,35 - 40 Jahre,20599,10705,9894
False,8335,Landkreis Konstanz,40 - 45 Jahre,17282,8760,8522
False,8335,Landkreis Konstanz,45 - 50 Jahre,15335,7685,7650
False,8335,Landkreis Konstanz,50 - 55 Jahre,15524,7738,7786
False,8335,Landkreis Konstanz,55 - 60 Jahre,18419,9218,9201
False,8335,Landkreis Konstanz,60 - 65 Jahre,13732,6740,6992
False,8335,Landkreis Konstanz,65 - 75 Jahre,22827,9557,13270
False,8335,Landkreis Konstanz,75 und mehr Jahre,18001,5268,12733
False,8335,Landkreis Konstanz,Insgesamt,258668,125526,133142
False,8335001,"Aach, Stadt",unter 3 Jahre,75,44,31
False,8335001,"Aach, Stadt",3 -  6 Jahre,92,53,39
False,8335001,"Aach, Stadt",6 - 10 Jahre,103,50,53
False,8335001,"Aach, Stadt",10 - 15 Jahre,115,63,52
False,8335001,"Aach, Stadt",15 - 18 Jahre,66,30,36
False,8335001,"Aach, Stadt",18 - 20 Jahre,25,12,13
False,8335001,"Aach, Stadt",20 - 25 Jahre,110,56,54
False,8335001,"Aach, Stadt",25 - 30 Jahre,189,111,78
False,8335001,"Aach, Stadt",30 - 35 Jahre,214,115,99
False,8335001,"Aach, Stadt",35 - 40 Jahre,167,90,77
False,8335001,"Aach, Stadt",40 - 45 Jahre,142,64,78
False,8335001,"Aach, Stadt",45 - 50 Jahre,120,70,50
False,8335001,"Aach, Stadt",50 - 55 Jahre,83,43,40
False,8335001,"Aach, Stadt",55 - 60 Jahre,117,59,58
False,8335001,"Aach, Stadt",60 - 65 Jahre,95,54,41
False,8335001,"Aach, Stadt",65 - 75 Jahre,162,67,95
False,8335001,"Aach, Stadt",75 und mehr Jahre,98,34,64
False,8335001,"Aach, Stadt",Insgesamt,1973,1015,958
False,8335002,Allensbach,unter 3 Jahre,235,116,119
False,8335002,Allensbach,3 -  6 Jahre,245,127,118
False,8335002,Allensbach,6 - 10 Jahre,280,128,152
False,8335002,Allensbach,10 - 15 Jahre,324,161,163
False,8335002,Allensbach,15 - 18 Jahre,167,64,103
False,8335002,Allensbach,18 - 20 Jahre,119,40,79
False,8335002,Allensbach,20 - 25 Jahre,400,186,214
False,8335002,Allensbach,25 - 30 Jahre,619,281,338
False,8335002,Allensbach,30 - 35 Jahre,691,339,352
False,8335002,Allensbach,35 - 40 Jahre,593,299,294
False,8335002,Allensbach,40 - 45 Jahre,502,261,241
False,8335002,Allensbach,45 - 50 Jahre,400,190,210
False,8335002,Allensbach,50 - 55 Jahre,463,237,226
False,8335002,Allensbach,55 - 60 Jahre,479,229,250
False,8335002,Allensbach,60 - 65 Jahre,279,123,156
False,8335002,Allensbach,65 - 75 Jahre,556,200,356
False,8335002,Allensbach,75 und mehr Jahre,467,113,354
False,8335002,Allensbach,Insgesamt,6819,3094,3725
False,8335015,Büsingen am Hochrhein,unter 3 Jahre,45,27,18
False,8335015,Büsingen am Hochrhein,3 -  6 Jahre,50,15,35
False,8335015,Büsingen am Hochrhein,6 - 10 Jahre,70,38,32
False,8335015,Büsingen am Hochrhein,10 - 15 Jahre,67,38,29
False,8335015,Büsingen am Hochrhein,15 - 18 Jahre,19,10,9
False,8335015,Büsingen am Hochrhein,18 - 20 Jahre,26,12,14
False,8335015,Büsingen am Hochrhein,20 - 25 Jahre,77,36,41
False,8335015,Büsingen am Hochrhein,25 - 30 Jahre,119,54,65
False,8335015,Büsingen am Hochrhein,30 - 35 Jahre,137,72,65
False,8335015,Büsingen am Hochrhein,35 - 40 Jahre,108,51,57
False,8335015,Büsingen am Hochrhein,40 - 45 Jahre,98,52,46
False,8335015,Büsingen am Hochrhein,45 - 50 Jahre,88,42,46
False,8335015,Büsingen am Hochrhein,50 - 55 Jahre,89,42,47
False,8335015,Büsingen am Hochrhein,55 - 60 Jahre,113,60,53
False,8335015,Büsingen am Hochrhein,60 - 65 Jahre,82,31,51
False,8335015,Büsingen am Hochrhein,65 - 75 Jahre,175,73,102
False,8335015,Büsingen am Hochrhein,75 und mehr Jahre,119,58,61
False,8335015,Büsingen am Hochrhein,Insgesamt,1482,711,771
False,8335021,Eigeltingen,unter 3 Jahre,140,71,69
False,8335021,Eigeltingen,3 -  6 Jahre,121,57,64
False,8335021,Eigeltingen,6 - 10 Jahre,170,88,82
False,8335021,Eigeltingen,10 - 15 Jahre,203,104,99
False,8335021,Eigeltingen,15 - 18 Jahre,120,59,61
False,8335021,Eigeltingen,18 - 20 Jahre,73,34,39
False,8335021,Eigeltingen,20 - 25 Jahre,159,79,80
False,8335021,Eigeltingen,25 - 30 Jahre,262,133,129
False,8335021,Eigeltingen,30 - 35 Jahre,260,124,136
False,8335021,Eigeltingen,35 - 40 Jahre,321,165,156
False,8335021,Eigeltingen,40 - 45 Jahre,221,119,102
False,8335021,Eigeltingen,45 - 50 Jahre,197,110,87
False,8335021,Eigeltingen,50 - 55 Jahre,179,89,90
False,8335021,Eigeltingen,55 - 60 Jahre,198,106,92
False,8335021,Eigeltingen,60 - 65 Jahre,172,82,90
False,8335021,Eigeltingen,65 - 75 Jahre,267,110,157
False,8335021,Eigeltingen,75 und mehr Jahre,172,57,115
False,8335021,Eigeltingen,Insgesamt,3235,1587,1648
False,8335022,"Engen, Stadt",unter 3 Jahre,348,175,173
False,8335022,"Engen, Stadt",3 -  6 Jahre,371,200,171
False,8335022,"Engen, Stadt",6 - 10 Jahre,468,245,223
False,8335022,"Engen, Stadt",10 - 15 Jahre,519,259,260
False,8335022,"Engen, Stadt",15 - 18 Jahre,291,134,157
False,8335022,"Engen, Stadt",18 - 20 Jahre,197,82,115
False,8335022,"Engen, Stadt",20 - 25 Jahre,539,269,270
False,8335022,"Engen, Stadt",25 - 30 Jahre,733,367,366
False,8335022,"Engen, Stadt",30 - 35 Jahre,896,456,440
False,8335022,"Engen, Stadt",35 - 40 Jahre,745,395,350
False,8335022,"Engen, Stadt",40 - 45 Jahre,624,318,306
False,8335022,"Engen, Stadt",45 - 50 Jahre,576,282,294
False,8335022,"Engen, Stadt",50 - 55 Jahre,540,268,272
False,8335022,"Engen, Stadt",55 - 60 Jahre,703,346,357
False,8335022,"Engen, Stadt",60 - 65 Jahre,581,283,298
False,8335022,"Engen, Stadt",65 - 75 Jahre,811,323,488
False,8335022,"Engen, Stadt",75 und mehr Jahre,610,178,432
False,8335022,"Engen, Stadt",Insgesamt,9552,4580,4972
False,8335025,Gaienhofen,unter 3 Jahre,83,50,33
False,8335025,Gaienhofen,3 -  6 Jahre,81,46,35
False,8335025,Gaienhofen,6 - 10 Jahre,140,66,74
False,8335025,Gaienhofen,10 - 15 Jahre,208,104,104
False,8335025,Gaienhofen,15 - 18 Jahre,174,95,79
False,8335025,Gaienhofen,18 - 20 Jahre,101,60,41
False,8335025,Gaienhofen,20 - 25 Jahre,189,93,96
False,8335025,Gaienhofen,25 - 30 Jahre,227,109,118
False,8335025,Gaienhofen,30 - 35 Jahre,240,126,114
False,8335025,Gaienhofen,35 - 40 Jahre,228,98,130
False,8335025,Gaienhofen,40 - 45 Jahre,213,100,113
False,8335025,Gaienhofen,45 - 50 Jahre,218,117,101
False,8335025,Gaienhofen,50 - 55 Jahre,197,96,101
False,8335025,Gaienhofen,55 - 60 Jahre,233,110,123
False,8335025,Gaienhofen,60 - 65 Jahre,172,84,88
False,8335025,Gaienhofen,65 - 75 Jahre,287,130,157
False,8335025,Gaienhofen,75 und mehr Jahre,232,82,150
False,8335025,Gaienhofen,Insgesamt,3223,1566,1657
False,8335026,Gailingen am Hochrhein,unter 3 Jahre,67,33,34
False,8335026,Gailingen am Hochrhein,3 -  6 Jahre,77,41,36
False,8335026,Gailingen am Hochrhein,6 - 10 Jahre,100,45,55
False,8335026,Gailingen am Hochrhein,10 - 15 Jahre,136,57,79
False,8335026,Gailingen am Hochrhein,15 - 18 Jahre,66,31,35
False,8335026,Gailingen am Hochrhein,18 - 20 Jahre,73,34,39
False,8335026,Gailingen am Hochrhein,20 - 25 Jahre,226,132,94
False,8335026,Gailingen am Hochrhein,25 - 30 Jahre,338,200,138
False,8335026,Gailingen am Hochrhein,30 - 35 Jahre,215,100,115
False,8335026,Gailingen am Hochrhein,35 - 40 Jahre,221,100,121
False,8335026,Gailingen am Hochrhein,40 - 45 Jahre,175,89,86
False,8335026,Gailingen am Hochrhein,45 - 50 Jahre,138,73,65
False,8335026,Gailingen am Hochrhein,50 - 55 Jahre,161,79,82
False,8335026,Gailingen am Hochrhein,55 - 60 Jahre,199,97,102
False,8335026,Gailingen am Hochrhein,60 - 65 Jahre,161,84,77
False,8335026,Gailingen am Hochrhein,65 - 75 Jahre,218,93,125
False,8335026,Gailingen am Hochrhein,75 und mehr Jahre,197,59,138
False,8335026,Gailingen am Hochrhein,Insgesamt,2768,1347,1421
False,8335028,Gottmadingen,unter 3 Jahre,330,173,157
False,8335028,Gottmadingen,3 -  6 Jahre,348,182,166
False,8335028,Gottmadingen,6 - 10 Jahre,450,229,221
False,8335028,Gottmadingen,10 - 15 Jahre,469,267,202
False,8335028,Gottmadingen,15 - 18 Jahre,309,160,149
False,8335028,Gottmadingen,18 - 20 Jahre,178,96,82
False,8335028,Gottmadingen,20 - 25 Jahre,512,265,247
False,8335028,Gottmadingen,25 - 30 Jahre,814,386,428
False,8335028,Gottmadingen,30 - 35 Jahre,896,457,439
False,8335028,Gottmadingen,35 - 40 Jahre,743,384,359
False,8335028,Gottmadingen,40 - 45 Jahre,586,314,272
False,8335028,Gottmadingen,45 - 50 Jahre,575,275,300
False,8335028,Gottmadingen,50 - 55 Jahre,581,284,297
False,8335028,Gottmadingen,55 - 60 Jahre,735,379,356
False,8335028,Gottmadingen,60 - 65 Jahre,579,280,299
False,8335028,Gottmadingen,65 - 75 Jahre,926,410,516
False,8335028,Gottmadingen,75 und mehr Jahre,733,239,494
False,8335028,Gottmadingen,Insgesamt,9764,4780,4984
False,8335035,Hilzingen,unter 3 Jahre,293,141,152
False,8335035,Hilzingen,3 -  6 Jahre,295,152,143
False,8335035,Hilzingen,6 - 10 Jahre,388,200,188
False,8335035,Hilzingen,10 - 15 Jahre,426,213,213
False,8335035,Hilzingen,15 - 18 Jahre,240,130,110
False,8335035,Hilzingen,18 - 20 Jahre,147,72,75
False,8335035,Hilzingen,20 - 25 Jahre,409,195,214
False,8335035,Hilzingen,25 - 30 Jahre,610,312,298
False,8335035,Hilzingen,30 - 35 Jahre,746,372,374
False,8335035,Hilzingen,35 - 40 Jahre,578,295,283
False,8335035,Hilzingen,40 - 45 Jahre,537,269,268
False,8335035,Hilzingen,45 - 50 Jahre,460,237,223
False,8335035,Hilzingen,50 - 55 Jahre,470,224,246
False,8335035,Hilzingen,55 - 60 Jahre,539,273,266
False,8335035,Hilzingen,60 - 65 Jahre,373,206,167
False,8335035,Hilzingen,65 - 75 Jahre,573,251,322
False,8335035,Hilzingen,75 und mehr Jahre,355,130,225
False,8335035,Hilzingen,Insgesamt,7439,3672,3767
False,8335043,"Konstanz, Universitätsstadt",unter 3 Jahre,2056,1083,973
False,8335043,"Konstanz, Universitätsstadt",3 -  6 Jahre,1971,1006,965
False,8335043,"Konstanz, Universitätsstadt",6 - 10 Jahre,2667,1330,1337
False,8335043,"Konstanz, Universitätsstadt",10 - 15 Jahre,2988,1484,1504
False,8335043,"Konstanz, Universitätsstadt",15 - 18 Jahre,1673,855,818
False,8335043,"Konstanz, Universitätsstadt",18 - 20 Jahre,1323,631,692
False,8335043,"Konstanz, Universitätsstadt",20 - 25 Jahre,5526,2778,2748
False,8335043,"Konstanz, Universitätsstadt",25 - 30 Jahre,8646,4443,4203
False,8335043,"Konstanz, Universitätsstadt",30 - 35 Jahre,8700,4710,3990
False,8335043,"Konstanz, Universitätsstadt",35 - 40 Jahre,6057,3160,2897
False,8335043,"Konstanz, Universitätsstadt",40 - 45 Jahre,4665,2338,2327
False,8335043,"Konstanz, Universitätsstadt",45 - 50 Jahre,4192,2067,2125
False,8335043,"Konstanz, Universitätsstadt",50 - 55 Jahre,4624,2261,2363
False,8335043,"Konstanz, Universitätsstadt",55 - 60 Jahre,5150,2548,2602
False,8335043,"Konstanz, Universitätsstadt",60 - 65 Jahre,3771,1823,1948
False,8335043,"Konstanz, Universitätsstadt",65 - 75 Jahre,6232,2509,3723
False,8335043,"Konstanz, Universitätsstadt",75 und mehr Jahre,5759,1635,4124
False,8335043,"Konstanz, Universitätsstadt",Insgesamt,76000,36661,39339
False,8335055,Moos,unter 3 Jahre,94,48,46
False,8335055,Moos,3 -  6 Jahre,119,59,60
False,8335055,Moos,6 - 10 Jahre,152,87,65
False,8335055,Moos,10 - 15 Jahre,167,84,83
False,8335055,Moos,15 - 18 Jahre,89,48,41
False,8335055,Moos,18 - 20 Jahre,60,27,33
False,8335055,Moos,20 - 25 Jahre,144,63,81
False,8335055,Moos,25 - 30 Jahre,204,101,103
False,8335055,Moos,30 - 35 Jahre,272,151,121
False,8335055,Moos,35 - 40 Jahre,269,125,144
False,8335055,Moos,40 - 45 Jahre,256,134,122
False,8335055,Moos,45 - 50 Jahre,213,105,108
False,8335055,Moos,50 - 55 Jahre,187,104,83
False,8335055,Moos,55 - 60 Jahre,199,102,97
False,8335055,Moos,60 - 65 Jahre,131,64,67
False,8335055,Moos,65 - 75 Jahre,258,113,145
False,8335055,Moos,75 und mehr Jahre,152,62,90
False,8335055,Moos,Insgesamt,2966,1477,1489
False,8335057,Mühlingen,unter 3 Jahre,80,43,37
False,8335057,Mühlingen,3 -  6 Jahre,71,33,38
False,8335057,Mühlingen,6 - 10 Jahre,108,51,57
False,8335057,Mühlingen,10 - 15 Jahre,143,89,54
False,8335057,Mühlingen,15 - 18 Jahre,57,29,28
False,8335057,Mühlingen,18 - 20 Jahre,43,28,15
False,8335057,Mühlingen,20 - 25 Jahre,105,43,62
False,8335057,Mühlingen,25 - 30 Jahre,178,90,88
False,8335057,Mühlingen,30 - 35 Jahre,209,111,98
False,8335057,Mühlingen,35 - 40 Jahre,165,86,79
False,8335057,Mühlingen,40 - 45 Jahre,157,76,81
False,8335057,Mühlingen,45 - 50 Jahre,101,60,41
False,8335057,Mühlingen,50 - 55 Jahre,83,44,39
False,8335057,Mühlingen,55 - 60 Jahre,117,55,62
False,8335057,Mühlingen,60 - 65 Jahre,106,51,55
False,8335057,Mühlingen,65 - 75 Jahre,182,83,99
False,8335057,Mühlingen,75 und mehr Jahre,115,31,84
False,8335057,Mühlingen,Insgesamt,2020,1003,1017
False,8335061,Öhningen,unter 3 Jahre,97,47,50
False,8335061,Öhningen,3 -  6 Jahre,117,73,44
False,8335061,Öhningen,6 - 10 Jahre,160,75,85
False,8335061,Öhningen,10 - 15 Jahre,198,106,92
False,8335061,Öhningen,15 - 18 Jahre,103,56,47
False,8335061,Öhningen,18 - 20 Jahre,67,35,32
False,8335061,Öhningen,20 - 25 Jahre,153,82,71
False,8335061,Öhningen,25 - 30 Jahre,281,140,141
False,8335061,Öhningen,30 - 35 Jahre,332,181,151
False,8335061,Öhningen,35 - 40 Jahre,275,133,142
False,8335061,Öhningen,40 - 45 Jahre,246,132,114
False,8335061,Öhningen,45 - 50 Jahre,205,98,107
False,8335061,Öhningen,50 - 55 Jahre,240,123,117
False,8335061,Öhningen,55 - 60 Jahre,262,138,124
False,8335061,Öhningen,60 - 65 Jahre,226,105,121
False,8335061,Öhningen,65 - 75 Jahre,363,163,200
False,8335061,Öhningen,75 und mehr Jahre,292,103,189
False,8335061,Öhningen,Insgesamt,3617,1790,1827
False,8335063,"Radolfzell am Bodensee, Stadt",unter 3 Jahre,857,441,416
False,8335063,"Radolfzell am Bodensee, Stadt",3 -  6 Jahre,965,490,475
False,8335063,"Radolfzell am Bodensee, Stadt",6 - 10 Jahre,1211,635,576
False,8335063,"Radolfzell am Bodensee, Stadt",10 - 15 Jahre,1377,692,685
False,8335063,"Radolfzell am Bodensee, Stadt",15 - 18 Jahre,800,427,373
False,8335063,"Radolfzell am Bodensee, Stadt",18 - 20 Jahre,549,296,253
False,8335063,"Radolfzell am Bodensee, Stadt",20 - 25 Jahre,1612,825,787
False,8335063,"Radolfzell am Bodensee, Stadt",25 - 30 Jahre,2352,1163,1189
False,8335063,"Radolfzell am Bodensee, Stadt",30 - 35 Jahre,2651,1345,1306
False,8335063,"Radolfzell am Bodensee, Stadt",35 - 40 Jahre,2243,1167,1076
False,8335063,"Radolfzell am Bodensee, Stadt",40 - 45 Jahre,2094,1063,1031
False,8335063,"Radolfzell am Bodensee, Stadt",45 - 50 Jahre,1813,922,891
False,8335063,"Radolfzell am Bodensee, Stadt",50 - 55 Jahre,1844,935,909
False,8335063,"Radolfzell am Bodensee, Stadt",55 - 60 Jahre,1968,991,977
False,8335063,"Radolfzell am Bodensee, Stadt",60 - 65 Jahre,1351,673,678
False,8335063,"Radolfzell am Bodensee, Stadt",65 - 75 Jahre,2400,988,1412
False,8335063,"Radolfzell am Bodensee, Stadt",75 und mehr Jahre,2002,585,1417
False,8335063,"Radolfzell am Bodensee, Stadt",Insgesamt,28089,13638,14451
False,8335066,Reichenau,unter 3 Jahre,165,82,83
False,8335066,Reichenau,3 -  6 Jahre,192,103,89
False,8335066,Reichenau,6 - 10 Jahre,198,105,93
False,8335066,Reichenau,10 - 15 Jahre,228,111,117
False,8335066,Reichenau,15 - 18 Jahre,111,49,62
False,8335066,Reichenau,18 - 20 Jahre,77,41,36
False,8335066,Reichenau,20 - 25 Jahre,351,172,179
False,8335066,Reichenau,25 - 30 Jahre,481,258,223
False,8335066,Reichenau,30 - 35 Jahre,506,255,251
False,8335066,Reichenau,35 - 40 Jahre,405,227,178
False,8335066,Reichenau,40 - 45 Jahre,318,162,156
False,8335066,Reichenau,45 - 50 Jahre,301,158,143
False,8335066,Reichenau,50 - 55 Jahre,246,120,126
False,8335066,Reichenau,55 - 60 Jahre,290,150,140
False,8335066,Reichenau,60 - 65 Jahre,262,133,129
False,8335066,Reichenau,65 - 75 Jahre,406,178,228
False,8335066,Reichenau,75 und mehr Jahre,271,71,200
False,8335066,Reichenau,Insgesamt,4808,2375,2433
False,8335075,"Singen (Hohentwiel), Stadt",unter 3 Jahre,1354,695,659
False,8335075,"Singen (Hohentwiel), Stadt",3 -  6 Jahre,1448,710,738
False,8335075,"Singen (Hohentwiel), Stadt",6 - 10 Jahre,1731,883,848
False,8335075,"Singen (Hohentwiel), Stadt",10 - 15 Jahre,2131,1108,1023
False,8335075,"Singen (Hohentwiel), Stadt",15 - 18 Jahre,1291,669,622
False,8335075,"Singen (Hohentwiel), Stadt",18 - 20 Jahre,882,475,407
False,8335075,"Singen (Hohentwiel), Stadt",20 - 25 Jahre,2496,1325,1171
False,8335075,"Singen (Hohentwiel), Stadt",25 - 30 Jahre,3495,1753,1742
False,8335075,"Singen (Hohentwiel), Stadt",30 - 35 Jahre,3652,1886,1766
False,8335075,"Singen (Hohentwiel), Stadt",35 - 40 Jahre,3263,1747,1516
False,8335075,"Singen (Hohentwiel), Stadt",40 - 45 Jahre,2833,1408,1425
False,8335075,"Singen (Hohentwiel), Stadt",45 - 50 Jahre,2592,1299,1293
False,8335075,"Singen (Hohentwiel), Stadt",50 - 55 Jahre,2740,1350,1390
False,8335075,"Singen (Hohentwiel), Stadt",55 - 60 Jahre,3534,1788,1746
False,8335075,"Singen (Hohentwiel), Stadt",60 - 65 Jahre,2817,1356,1461
False,8335075,"Singen (Hohentwiel), Stadt",65 - 75 Jahre,4644,1976,2668
False,8335075,"Singen (Hohentwiel), Stadt",75 und mehr Jahre,3435,949,2486
False,8335075,"Singen (Hohentwiel), Stadt",Insgesamt,44338,21377,22961
False,8335077,Steißlingen,unter 3 Jahre,156,83,73
False,8335077,Steißlingen,3 -  6 Jahre,153,77,76
False,8335077,Steißlingen,6 - 10 Jahre,215,106,109
False,8335077,Steißlingen,10 - 15 Jahre,212,107,105
False,8335077,Steißlingen,15 - 18 Jahre,103,58,45
False,8335077,Steißlingen,18 - 20 Jahre,67,38,29
False,8335077,Steißlingen,20 - 25 Jahre,207,100,107
False,8335077,Steißlingen,25 - 30 Jahre,387,188,199
False,8335077,Steißlingen,30 - 35 Jahre,407,214,193
False,8335077,Steißlingen,35 - 40 Jahre,376,196,180
False,8335077,Steißlingen,40 - 45 Jahre,260,145,115
False,8335077,Steißlingen,45 - 50 Jahre,246,117,129
False,8335077,Steißlingen,50 - 55 Jahre,231,116,115
False,8335077,Steißlingen,55 - 60 Jahre,302,151,151
False,8335077,Steißlingen,60 - 65 Jahre,208,111,97
False,8335077,Steißlingen,65 - 75 Jahre,303,133,170
False,8335077,Steißlingen,75 und mehr Jahre,179,51,128
False,8335077,Steißlingen,Insgesamt,4012,1991,2021
False,8335079,"Stockach, Stadt",unter 3 Jahre,491,250,241
False,8335079,"Stockach, Stadt",3 -  6 Jahre,574,301,273
False,8335079,"Stockach, Stadt",6 - 10 Jahre,858,425,433
False,8335079,"Stockach, Stadt",10 - 15 Jahre,1116,563,553
False,8335079,"Stockach, Stadt",15 - 18 Jahre,599,285,314
False,8335079,"Stockach, Stadt",18 - 20 Jahre,355,213,142
False,8335079,"Stockach, Stadt",20 - 25 Jahre,915,454,461
False,8335079,"Stockach, Stadt",25 - 30 Jahre,1228,627,601
False,8335079,"Stockach, Stadt",30 - 35 Jahre,1330,657,673
False,8335079,"Stockach, Stadt",35 - 40 Jahre,1295,665,630
False,8335079,"Stockach, Stadt",40 - 45 Jahre,1200,603,597
False,8335079,"Stockach, Stadt",45 - 50 Jahre,1001,515,486
False,8335079,"Stockach, Stadt",50 - 55 Jahre,853,440,413
False,8335079,"Stockach, Stadt",55 - 60 Jahre,1086,562,524
False,8335079,"Stockach, Stadt",60 - 65 Jahre,715,337,378
False,8335079,"Stockach, Stadt",65 - 75 Jahre,1420,581,839
False,8335079,"Stockach, Stadt",75 und mehr Jahre,1143,320,823
False,8335079,"Stockach, Stadt",Insgesamt,16179,7798,8381
False,8335080,"Tengen, Stadt",unter 3 Jahre,144,75,69
False,8335080,"Tengen, Stadt",3 -  6 Jahre,192,105,87
False,8335080,"Tengen, Stadt",6 - 10 Jahre,252,128,124
False,8335080,"Tengen, Stadt",10 - 15 Jahre,291,143,148
False,8335080,"Tengen, Stadt",15 - 18 Jahre,128,67,61
False,8335080,"Tengen, Stadt",18 - 20 Jahre,78,39,39
False,8335080,"Tengen, Stadt",20 - 25 Jahre,197,100,97
False,8335080,"Tengen, Stadt",25 - 30 Jahre,375,200,175
False,8335080,"Tengen, Stadt",30 - 35 Jahre,433,222,211
False,8335080,"Tengen, Stadt",35 - 40 Jahre,343,165,178
False,8335080,"Tengen, Stadt",40 - 45 Jahre,311,168,143
False,8335080,"Tengen, Stadt",45 - 50 Jahre,223,119,104
False,8335080,"Tengen, Stadt",50 - 55 Jahre,197,106,91
False,8335080,"Tengen, Stadt",55 - 60 Jahre,308,151,157
False,8335080,"Tengen, Stadt",60 - 65 Jahre,292,151,141
False,8335080,"Tengen, Stadt",65 - 75 Jahre,464,206,258
False,8335080,"Tengen, Stadt",75 und mehr Jahre,361,99,262
False,8335080,"Tengen, Stadt",Insgesamt,4589,2244,2345
False,8335081,Volkertshausen,unter 3 Jahre,94,47,47
False,8335081,Volkertshausen,3 -  6 Jahre,102,53,49
False,8335081,Volkertshausen,6 - 10 Jahre,149,74,75
False,8335081,Volkertshausen,10 - 15 Jahre,160,91,69
False,8335081,Volkertshausen,15 - 18 Jahre,90,48,42
False,8335081,Volkertshausen,18 - 20 Jahre,49,19,30
False,8335081,Volkertshausen,20 - 25 Jahre,126,67,59
False,8335081,Volkertshausen,25 - 30 Jahre,191,94,97
False,8335081,Volkertshausen,30 - 35 Jahre,256,135,121
False,8335081,Volkertshausen,35 - 40 Jahre,232,127,105
False,8335081,Volkertshausen,40 - 45 Jahre,183,89,94
False,8335081,Volkertshausen,45 - 50 Jahre,160,81,79
False,8335081,Volkertshausen,50 - 55 Jahre,124,66,58
False,8335081,Volkertshausen,55 - 60 Jahre,144,64,80
False,8335081,Volkertshausen,60 - 65 Jahre,134,67,67
False,8335081,Volkertshausen,65 - 75 Jahre,192,89,103
False,8335081,Volkertshausen,75 und mehr Jahre,114,31,83
False,8335081,Volkertshausen,Insgesamt,2500,1242,1258
False,8335096,Hohenfels,unter 3 Jahre,61,35,26
False,8335096,Hohenfels,3 -  6 Jahre,77,35,42
False,8335096,Hohenfels,6 - 10 Jahre,109,64,45
False,8335096,Hohenfels,10 - 15 Jahre,205,104,101
False,8335096,Hohenfels,15 - 18 Jahre,94,53,41
False,8335096,Hohenfels,18 - 20 Jahre,53,38,15
False,8335096,Hohenfels,20 - 25 Jahre,123,69,54
False,8335096,Hohenfels,25 - 30 Jahre,137,76,61
False,8335096,Hohenfels,30 - 35 Jahre,143,71,72
False,8335096,Hohenfels,35 - 40 Jahre,150,77,73
False,8335096,Hohenfels,40 - 45 Jahre,113,55,58
False,8335096,Hohenfels,45 - 50 Jahre,135,70,65
False,8335096,Hohenfels,50 - 55 Jahre,117,65,52
False,8335096,Hohenfels,55 - 60 Jahre,119,66,53
False,8335096,Hohenfels,60 - 65 Jahre,89,47,42
False,8335096,Hohenfels,65 - 75 Jahre,147,62,85
False,8335096,Hohenfels,75 und mehr Jahre,79,23,56
False,8335096,Hohenfels,Insgesamt,1951,1010,941
False,8335097,Mühlhausen-Ehingen,unter 3 Jahre,136,71,65
False,8335097,Mühlhausen-Ehingen,3 -  6 Jahre,142,82,60
False,8335097,Mühlhausen-Ehingen,6 - 10 Jahre,188,99,89
False,8335097,Mühlhausen-Ehingen,10 - 15 Jahre,217,117,100
False,8335097,Mühlhausen-Ehingen,15 - 18 Jahre,111,62,49
False,8335097,Mühlhausen-Ehingen,18 - 20 Jahre,77,35,42
False,8335097,Mühlhausen-Ehingen,20 - 25 Jahre,214,111,103
False,8335097,Mühlhausen-Ehingen,25 - 30 Jahre,291,158,133
False,8335097,Mühlhausen-Ehingen,30 - 35 Jahre,307,163,144
False,8335097,Mühlhausen-Ehingen,35 - 40 Jahre,294,136,158
False,8335097,Mühlhausen-Ehingen,40 - 45 Jahre,264,134,130
False,8335097,Mühlhausen-Ehingen,45 - 50 Jahre,231,118,113
False,8335097,Mühlhausen-Ehingen,50 - 55 Jahre,196,102,94
False,8335097,Mühlhausen-Ehingen,55 - 60 Jahre,255,129,126
False,8335097,Mühlhausen-Ehingen,60 - 65 Jahre,187,103,84
False,8335097,Mühlhausen-Ehingen,65 - 75 Jahre,284,131,153
False,8335097,Mühlhausen-Ehingen,75 und mehr Jahre,133,42,91
False,8335097,Mühlhausen-Ehingen,Insgesamt,3527,1793,1734
False,8335098,Bodman-Ludwigshafen,unter 3 Jahre,115,55,60
False,8335098,Bodman-Ludwigshafen,3 -  6 Jahre,98,51,47
False,8335098,Bodman-Ludwigshafen,6 - 10 Jahre,169,88,81
False,8335098,Bodman-Ludwigshafen,10 - 15 Jahre,212,102,110
False,8335098,Bodman-Ludwigshafen,15 - 18 Jahre,97,47,50
False,8335098,Bodman-Ludwigshafen,18 - 20 Jahre,81,42,39
False,8335098,Bodman-Ludwigshafen,20 - 25 Jahre,238,127,111
False,8335098,Bodman-Ludwigshafen,25 - 30 Jahre,275,119,156
False,8335098,Bodman-Ludwigshafen,30 - 35 Jahre,317,173,144
False,8335098,Bodman-Ludwigshafen,35 - 40 Jahre,309,174,135
False,8335098,Bodman-Ludwigshafen,40 - 45 Jahre,297,146,151
False,8335098,Bodman-Ludwigshafen,45 - 50 Jahre,277,140,137
False,8335098,Bodman-Ludwigshafen,50 - 55 Jahre,224,125,99
False,8335098,Bodman-Ludwigshafen,55 - 60 Jahre,301,126,175
False,8335098,Bodman-Ludwigshafen,60 - 65 Jahre,203,102,101
False,8335098,Bodman-Ludwigshafen,65 - 75 Jahre,412,186,226
False,8335098,Bodman-Ludwigshafen,75 und mehr Jahre,331,99,232
False,8335098,Bodman-Ludwigshafen,Insgesamt,3956,1902,2054
False,8335099,Orsingen-Nenzingen,unter 3 Jahre,97,51,46
False,8335099,Orsingen-Nenzingen,3 -  6 Jahre,98,50,48
False,8335099,Orsingen-Nenzingen,6 - 10 Jahre,140,66,74
False,8335099,Orsingen-Nenzingen,10 - 15 Jahre,128,64,64
False,8335099,Orsingen-Nenzingen,15 - 18 Jahre,100,56,44
False,8335099,Orsingen-Nenzingen,18 - 20 Jahre,56,26,30
False,8335099,Orsingen-Nenzingen,20 - 25 Jahre,155,75,80
False,8335099,Orsingen-Nenzingen,25 - 30 Jahre,233,119,114
False,8335099,Orsingen-Nenzingen,30 - 35 Jahre,243,117,126
False,8335099,Orsingen-Nenzingen,35 - 40 Jahre,233,141,92
False,8335099,Orsingen-Nenzingen,40 - 45 Jahre,163,88,75
False,8335099,Orsingen-Nenzingen,45 - 50 Jahre,159,91,68
False,8335099,Orsingen-Nenzingen,50 - 55 Jahre,129,65,64
False,8335099,Orsingen-Nenzingen,55 - 60 Jahre,182,90,92
False,8335099,Orsingen-Nenzingen,60 - 65 Jahre,128,69,59
False,8335099,Orsingen-Nenzingen,65 - 75 Jahre,191,85,106
False,8335099,Orsingen-Nenzingen,75 und mehr Jahre,131,44,87
False,8335099,Orsingen-Nenzingen,Insgesamt,2566,1297,1269
False,8335100,Rielasingen-Worblingen,unter 3 Jahre,390,202,188
False,8335100,Rielasingen-Worblingen,3 -  6 Jahre,396,204,192
False,8335100,Rielasingen-Worblingen,6 - 10 Jahre,516,256,260
False,8335100,Rielasingen-Worblingen,10 - 15 Jahre,584,303,281
False,8335100,Rielasingen-Worblingen,15 - 18 Jahre,317,164,153
False,8335100,Rielasingen-Worblingen,18 - 20 Jahre,209,125,84
False,8335100,Rielasingen-Worblingen,20 - 25 Jahre,571,284,287
False,8335100,Rielasingen-Worblingen,25 - 30 Jahre,958,466,492
False,8335100,Rielasingen-Worblingen,30 - 35 Jahre,1125,595,530
False,8335100,Rielasingen-Worblingen,35 - 40 Jahre,986,502,484
False,8335100,Rielasingen-Worblingen,40 - 45 Jahre,824,433,391
False,8335100,Rielasingen-Worblingen,45 - 50 Jahre,714,329,385
False,8335100,Rielasingen-Worblingen,50 - 55 Jahre,726,354,372
False,8335100,Rielasingen-Worblingen,55 - 60 Jahre,886,448,438
False,8335100,Rielasingen-Worblingen,60 - 65 Jahre,618,321,297
False,8335100,Rielasingen-Worblingen,65 - 75 Jahre,954,417,537
False,8335100,Rielasingen-Worblingen,75 und mehr Jahre,521,173,348
False,8335100,Rielasingen-Worblingen,Insgesamt,11295,5576,5719
False,8336,Landkreis Lörrach,unter 3 Jahre,7151,3736,3415
False,8336,Landkreis Lörrach,3 -  6 Jahre,8056,4110,3946
False,8336,Landkreis Lörrach,6 - 10 Jahre,10236,5193,5043
False,8336,Landkreis Lörrach,10 - 15 Jahre,11909,6070,5839
False,8336,Landkreis Lörrach,15 - 18 Jahre,6521,3334,3187
False,8336,Landkreis Lörrach,18 - 20 Jahre,4168,2146,2022
False,8336,Landkreis Lörrach,20 - 25 Jahre,11588,5893,5695
False,8336,Landkreis Lörrach,25 - 30 Jahre,17245,8722,8523
False,8336,Landkreis Lörrach,30 - 35 Jahre,19379,9689,9690
False,8336,Landkreis Lörrach,35 - 40 Jahre,17541,8891,8650
False,8336,Landkreis Lörrach,40 - 45 Jahre,14783,7598,7185
False,8336,Landkreis Lörrach,45 - 50 Jahre,12702,6402,6300
False,8336,Landkreis Lörrach,50 - 55 Jahre,12217,6089,6128
False,8336,Landkreis Lörrach,55 - 60 Jahre,15031,7454,7577
False,8336,Landkreis Lörrach,60 - 65 Jahre,11734,5798,5936
False,8336,Landkreis Lörrach,65 - 75 Jahre,18832,8101,10731
False,8336,Landkreis Lörrach,75 und mehr Jahre,13029,3844,9185
False,8336,Landkreis Lörrach,Insgesamt,212122,103070,109052
False,8336004,Aitern,unter 3 Jahre,30,17,13
False,8336004,Aitern,3 -  6 Jahre,14,10,4
False,8336004,Aitern,6 - 10 Jahre,36,21,15
False,8336004,Aitern,10 - 15 Jahre,40,16,24
False,8336004,Aitern,15 - 18 Jahre,26,17,9
False,8336004,Aitern,18 - 20 Jahre,9,6,3
False,8336004,Aitern,20 - 25 Jahre,33,16,17
False,8336004,Aitern,25 - 30 Jahre,44,15,29
False,8336004,Aitern,30 - 35 Jahre,57,31,26
False,8336004,Aitern,35 - 40 Jahre,37,20,17
False,8336004,Aitern,40 - 45 Jahre,37,19,18
False,8336004,Aitern,45 - 50 Jahre,31,18,13
False,8336004,Aitern,50 - 55 Jahre,29,14,15
False,8336004,Aitern,55 - 60 Jahre,33,12,21
False,8336004,Aitern,60 - 65 Jahre,33,20,13
False,8336004,Aitern,65 - 75 Jahre,51,20,31
False,8336004,Aitern,75 und mehr Jahre,21,9,12
False,8336004,Aitern,Insgesamt,561,281,280
False,8336006,Bad Bellingen,unter 3 Jahre,107,54,53
False,8336006,Bad Bellingen,3 -  6 Jahre,128,68,60
False,8336006,Bad Bellingen,6 - 10 Jahre,144,66,78
False,8336006,Bad Bellingen,10 - 15 Jahre,170,96,74
False,8336006,Bad Bellingen,15 - 18 Jahre,95,47,48
False,8336006,Bad Bellingen,18 - 20 Jahre,60,32,28
False,8336006,Bad Bellingen,20 - 25 Jahre,162,88,74
False,8336006,Bad Bellingen,25 - 30 Jahre,285,143,142
False,8336006,Bad Bellingen,30 - 35 Jahre,316,168,148
False,8336006,Bad Bellingen,35 - 40 Jahre,289,141,148
False,8336006,Bad Bellingen,40 - 45 Jahre,244,134,110
False,8336006,Bad Bellingen,45 - 50 Jahre,202,104,98
False,8336006,Bad Bellingen,50 - 55 Jahre,178,70,108
False,8336006,Bad Bellingen,55 - 60 Jahre,237,122,115
False,8336006,Bad Bellingen,60 - 65 Jahre,189,90,99
False,8336006,Bad Bellingen,65 - 75 Jahre,389,166,223
False,8336006,Bad Bellingen,75 und mehr Jahre,297,101,196
False,8336006,Bad Bellingen,Insgesamt,3492,1690,1802
False,8336008,Binzen,unter 3 Jahre,72,40,32
False,8336008,Binzen,3 -  6 Jahre,89,41,48
False,8336008,Binzen,6 - 10 Jahre,144,73,71
False,8336008,Binzen,10 - 15 Jahre,125,62,63
False,8336008,Binzen,15 - 18 Jahre,80,43,37
False,8336008,Binzen,18 - 20 Jahre,46,22,24
False,8336008,Binzen,20 - 25 Jahre,119,63,56
False,8336008,Binzen,25 - 30 Jahre,195,94,101
False,8336008,Binzen,30 - 35 Jahre,250,120,130
False,8336008,Binzen,35 - 40 Jahre,204,100,104
False,8336008,Binzen,40 - 45 Jahre,192,93,99
False,8336008,Binzen,45 - 50 Jahre,174,89,85
False,8336008,Binzen,50 - 55 Jahre,161,75,86
False,8336008,Binzen,55 - 60 Jahre,191,105,86
False,8336008,Binzen,60 - 65 Jahre,126,70,56
False,8336008,Binzen,65 - 75 Jahre,199,89,110
False,8336008,Binzen,75 und mehr Jahre,121,31,90
False,8336008,Binzen,Insgesamt,2488,1210,1278
False,8336010,Böllen,unter 3 Jahre,9,2,7
False,8336010,Böllen,3 -  6 Jahre,1,1,0
False,8336010,Böllen,6 - 10 Jahre,3,3,0
False,8336010,Böllen,10 - 15 Jahre,2,2,0
False,8336010,Böllen,15 - 18 Jahre,1,0,1
False,8336010,Böllen,18 - 20 Jahre,4,2,2
False,8336010,Böllen,20 - 25 Jahre,8,5,3
False,8336010,Böllen,25 - 30 Jahre,12,5,7
False,8336010,Böllen,30 - 35 Jahre,9,6,3
False,8336010,Böllen,35 - 40 Jahre,11,6,5
False,8336010,Böllen,40 - 45 Jahre,6,2,4
False,8336010,Böllen,45 - 50 Jahre,3,3,0
False,8336010,Böllen,50 - 55 Jahre,3,3,0
False,8336010,Böllen,55 - 60 Jahre,3,0,3
False,8336010,Böllen,60 - 65 Jahre,7,5,2
False,8336010,Böllen,65 - 75 Jahre,19,11,8
False,8336010,Böllen,75 und mehr Jahre,4,1,3
False,8336010,Böllen,Insgesamt,105,57,48
False,8336014,Efringen-Kirchen,unter 3 Jahre,279,150,129
False,8336014,Efringen-Kirchen,3 -  6 Jahre,350,194,156
False,8336014,Efringen-Kirchen,6 - 10 Jahre,409,194,215
False,8336014,Efringen-Kirchen,10 - 15 Jahre,492,238,254
False,8336014,Efringen-Kirchen,15 - 18 Jahre,248,120,128
False,8336014,Efringen-Kirchen,18 - 20 Jahre,145,68,77
False,8336014,Efringen-Kirchen,20 - 25 Jahre,428,214,214
False,8336014,Efringen-Kirchen,25 - 30 Jahre,610,322,288
False,8336014,Efringen-Kirchen,30 - 35 Jahre,706,338,368
False,8336014,Efringen-Kirchen,35 - 40 Jahre,705,348,357
False,8336014,Efringen-Kirchen,40 - 45 Jahre,620,314,306
False,8336014,Efringen-Kirchen,45 - 50 Jahre,445,232,213
False,8336014,Efringen-Kirchen,50 - 55 Jahre,441,223,218
False,8336014,Efringen-Kirchen,55 - 60 Jahre,522,271,251
False,8336014,Efringen-Kirchen,60 - 65 Jahre,385,190,195
False,8336014,Efringen-Kirchen,65 - 75 Jahre,620,262,358
False,8336014,Efringen-Kirchen,75 und mehr Jahre,360,126,234
False,8336014,Efringen-Kirchen,Insgesamt,7765,3804,3961
False,8336019,Eimeldingen,unter 3 Jahre,77,43,34
False,8336019,Eimeldingen,3 -  6 Jahre,90,40,50
False,8336019,Eimeldingen,6 - 10 Jahre,79,45,34
False,8336019,Eimeldingen,10 - 15 Jahre,107,61,46
False,8336019,Eimeldingen,15 - 18 Jahre,57,27,30
False,8336019,Eimeldingen,18 - 20 Jahre,36,19,17
False,8336019,Eimeldingen,20 - 25 Jahre,136,63,73
False,8336019,Eimeldingen,25 - 30 Jahre,213,106,107
False,8336019,Eimeldingen,30 - 35 Jahre,233,111,122
False,8336019,Eimeldingen,35 - 40 Jahre,185,101,84
False,8336019,Eimeldingen,40 - 45 Jahre,156,78,78
False,8336019,Eimeldingen,45 - 50 Jahre,123,62,61
False,8336019,Eimeldingen,50 - 55 Jahre,105,50,55
False,8336019,Eimeldingen,55 - 60 Jahre,110,53,57
False,8336019,Eimeldingen,60 - 65 Jahre,95,53,42
False,8336019,Eimeldingen,65 - 75 Jahre,123,56,67
False,8336019,Eimeldingen,75 und mehr Jahre,67,22,45
False,8336019,Eimeldingen,Insgesamt,1992,990,1002
False,8336024,Fischingen,unter 3 Jahre,21,10,11
False,8336024,Fischingen,3 -  6 Jahre,14,10,4
False,8336024,Fischingen,6 - 10 Jahre,26,18,8
False,8336024,Fischingen,10 - 15 Jahre,31,19,12
False,8336024,Fischingen,15 - 18 Jahre,32,15,17
False,8336024,Fischingen,18 - 20 Jahre,20,9,11
False,8336024,Fischingen,20 - 25 Jahre,30,16,14
False,8336024,Fischingen,25 - 30 Jahre,40,22,18
False,8336024,Fischingen,30 - 35 Jahre,56,30,26
False,8336024,Fischingen,35 - 40 Jahre,45,19,26
False,8336024,Fischingen,40 - 45 Jahre,50,27,23
False,8336024,Fischingen,45 - 50 Jahre,44,21,23
False,8336024,Fischingen,50 - 55 Jahre,52,27,25
False,8336024,Fischingen,55 - 60 Jahre,35,18,17
False,8336024,Fischingen,60 - 65 Jahre,35,17,18
False,8336024,Fischingen,65 - 75 Jahre,46,19,27
False,8336024,Fischingen,75 und mehr Jahre,21,10,11
False,8336024,Fischingen,Insgesamt,598,307,291
False,8336025,Fröhnd,unter 3 Jahre,19,8,11
False,8336025,Fröhnd,3 -  6 Jahre,16,10,6
False,8336025,Fröhnd,6 - 10 Jahre,28,18,10
False,8336025,Fröhnd,10 - 15 Jahre,34,16,18
False,8336025,Fröhnd,15 - 18 Jahre,17,10,7
False,8336025,Fröhnd,18 - 20 Jahre,11,5,6
False,8336025,Fröhnd,20 - 25 Jahre,19,10,9
False,8336025,Fröhnd,25 - 30 Jahre,38,19,19
False,8336025,Fröhnd,30 - 35 Jahre,46,23,23
False,8336025,Fröhnd,35 - 40 Jahre,43,23,20
False,8336025,Fröhnd,40 - 45 Jahre,35,22,13
False,8336025,Fröhnd,45 - 50 Jahre,17,11,6
False,8336025,Fröhnd,50 - 55 Jahre,13,3,10
False,8336025,Fröhnd,55 - 60 Jahre,29,17,12
False,8336025,Fröhnd,60 - 65 Jahre,34,20,14
False,8336025,Fröhnd,65 - 75 Jahre,48,20,28
False,8336025,Fröhnd,75 und mehr Jahre,18,11,7
False,8336025,Fröhnd,Insgesamt,465,246,219
False,8336034,Hasel,unter 3 Jahre,23,9,14
False,8336034,Hasel,3 -  6 Jahre,38,17,21
False,8336034,Hasel,6 - 10 Jahre,54,22,32
False,8336034,Hasel,10 - 15 Jahre,60,30,30
False,8336034,Hasel,15 - 18 Jahre,30,18,12
False,8336034,Hasel,18 - 20 Jahre,21,12,9
False,8336034,Hasel,20 - 25 Jahre,68,32,36
False,8336034,Hasel,25 - 30 Jahre,68,40,28
False,8336034,Hasel,30 - 35 Jahre,91,47,44
False,8336034,Hasel,35 - 40 Jahre,67,33,34
False,8336034,Hasel,40 - 45 Jahre,72,41,31
False,8336034,Hasel,45 - 50 Jahre,62,33,29
False,8336034,Hasel,50 - 55 Jahre,56,28,28
False,8336034,Hasel,55 - 60 Jahre,62,33,29
False,8336034,Hasel,60 - 65 Jahre,88,46,42
False,8336034,Hasel,65 - 75 Jahre,91,39,52
False,8336034,Hasel,75 und mehr Jahre,46,12,34
False,8336034,Hasel,Insgesamt,997,492,505
False,8336036,Hausen im Wiesental,unter 3 Jahre,86,45,41
False,8336036,Hausen im Wiesental,3 -  6 Jahre,92,40,52
False,8336036,Hausen im Wiesental,6 - 10 Jahre,111,58,53
False,8336036,Hausen im Wiesental,10 - 15 Jahre,138,71,67
False,8336036,Hausen im Wiesental,15 - 18 Jahre,78,42,36
False,8336036,Hausen im Wiesental,18 - 20 Jahre,70,37,33
False,8336036,Hausen im Wiesental,20 - 25 Jahre,149,84,65
False,8336036,Hausen im Wiesental,25 - 30 Jahre,192,97,95
False,8336036,Hausen im Wiesental,30 - 35 Jahre,220,124,96
False,8336036,Hausen im Wiesental,35 - 40 Jahre,175,87,88
False,8336036,Hausen im Wiesental,40 - 45 Jahre,168,80,88
False,8336036,Hausen im Wiesental,45 - 50 Jahre,153,86,67
False,8336036,Hausen im Wiesental,50 - 55 Jahre,132,65,67
False,8336036,Hausen im Wiesental,55 - 60 Jahre,174,88,86
False,8336036,Hausen im Wiesental,60 - 65 Jahre,133,77,56
False,8336036,Hausen im Wiesental,65 - 75 Jahre,199,73,126
False,8336036,Hausen im Wiesental,75 und mehr Jahre,107,35,72
False,8336036,Hausen im Wiesental,Insgesamt,2377,1189,1188
False,8336043,Inzlingen,unter 3 Jahre,80,35,45
False,8336043,Inzlingen,3 -  6 Jahre,91,45,46
False,8336043,Inzlingen,6 - 10 Jahre,107,47,60
False,8336043,Inzlingen,10 - 15 Jahre,151,80,71
False,8336043,Inzlingen,15 - 18 Jahre,72,38,34
False,8336043,Inzlingen,18 - 20 Jahre,44,24,20
False,8336043,Inzlingen,20 - 25 Jahre,117,61,56
False,8336043,Inzlingen,25 - 30 Jahre,246,105,141
False,8336043,Inzlingen,30 - 35 Jahre,233,115,118
False,8336043,Inzlingen,35 - 40 Jahre,240,115,125
False,8336043,Inzlingen,40 - 45 Jahre,195,96,99
False,8336043,Inzlingen,45 - 50 Jahre,156,77,79
False,8336043,Inzlingen,50 - 55 Jahre,163,72,91
False,8336043,Inzlingen,55 - 60 Jahre,206,110,96
False,8336043,Inzlingen,60 - 65 Jahre,161,68,93
False,8336043,Inzlingen,65 - 75 Jahre,218,113,105
False,8336043,Inzlingen,75 und mehr Jahre,136,45,91
False,8336043,Inzlingen,Insgesamt,2616,1246,1370
False,8336045,"Kandern, Stadt",unter 3 Jahre,250,126,124
False,8336045,"Kandern, Stadt",3 -  6 Jahre,278,144,134
False,8336045,"Kandern, Stadt",6 - 10 Jahre,379,166,213
False,8336045,"Kandern, Stadt",10 - 15 Jahre,477,227,250
False,8336045,"Kandern, Stadt",15 - 18 Jahre,315,167,148
False,8336045,"Kandern, Stadt",18 - 20 Jahre,138,69,69
False,8336045,"Kandern, Stadt",20 - 25 Jahre,332,150,182
False,8336045,"Kandern, Stadt",25 - 30 Jahre,591,309,282
False,8336045,"Kandern, Stadt",30 - 35 Jahre,690,350,340
False,8336045,"Kandern, Stadt",35 - 40 Jahre,654,318,336
False,8336045,"Kandern, Stadt",40 - 45 Jahre,543,287,256
False,8336045,"Kandern, Stadt",45 - 50 Jahre,416,219,197
False,8336045,"Kandern, Stadt",50 - 55 Jahre,423,214,209
False,8336045,"Kandern, Stadt",55 - 60 Jahre,504,250,254
False,8336045,"Kandern, Stadt",60 - 65 Jahre,389,201,188
False,8336045,"Kandern, Stadt",65 - 75 Jahre,721,280,441
False,8336045,"Kandern, Stadt",75 und mehr Jahre,550,174,376
False,8336045,"Kandern, Stadt",Insgesamt,7650,3651,3999
False,8336050,"Lörrach, Stadt",unter 3 Jahre,1460,763,697
False,8336050,"Lörrach, Stadt",3 -  6 Jahre,1586,789,797
False,8336050,"Lörrach, Stadt",6 - 10 Jahre,1967,1034,933
False,8336050,"Lörrach, Stadt",10 - 15 Jahre,2305,1172,1133
False,8336050,"Lörrach, Stadt",15 - 18 Jahre,1265,647,618
False,8336050,"Lörrach, Stadt",18 - 20 Jahre,828,433,395
False,8336050,"Lörrach, Stadt",20 - 25 Jahre,2432,1222,1210
False,8336050,"Lörrach, Stadt",25 - 30 Jahre,3533,1765,1768
False,8336050,"Lörrach, Stadt",30 - 35 Jahre,4082,2014,2068
False,8336050,"Lörrach, Stadt",35 - 40 Jahre,3709,1906,1803
False,8336050,"Lörrach, Stadt",40 - 45 Jahre,3105,1629,1476
False,8336050,"Lörrach, Stadt",45 - 50 Jahre,2733,1343,1390
False,8336050,"Lörrach, Stadt",50 - 55 Jahre,2550,1269,1281
False,8336050,"Lörrach, Stadt",55 - 60 Jahre,3166,1562,1604
False,8336050,"Lörrach, Stadt",60 - 65 Jahre,2459,1153,1306
False,8336050,"Lörrach, Stadt",65 - 75 Jahre,4198,1740,2458
False,8336050,"Lörrach, Stadt",75 und mehr Jahre,3239,899,2340
False,8336050,"Lörrach, Stadt",Insgesamt,44617,21340,23277
False,8336057,Maulburg,unter 3 Jahre,149,79,70
False,8336057,Maulburg,3 -  6 Jahre,176,89,87
False,8336057,Maulburg,6 - 10 Jahre,223,128,95
False,8336057,Maulburg,10 - 15 Jahre,234,131,103
False,8336057,Maulburg,15 - 18 Jahre,115,57,58
False,8336057,Maulburg,18 - 20 Jahre,75,39,36
False,8336057,Maulburg,20 - 25 Jahre,194,113,81
False,8336057,Maulburg,25 - 30 Jahre,281,138,143
False,8336057,Maulburg,30 - 35 Jahre,364,189,175
False,8336057,Maulburg,35 - 40 Jahre,356,184,172
False,8336057,Maulburg,40 - 45 Jahre,280,142,138
False,8336057,Maulburg,45 - 50 Jahre,215,115,100
False,8336057,Maulburg,50 - 55 Jahre,232,113,119
False,8336057,Maulburg,55 - 60 Jahre,261,133,128
False,8336057,Maulburg,60 - 65 Jahre,192,103,89
False,8336057,Maulburg,65 - 75 Jahre,320,135,185
False,8336057,Maulburg,75 und mehr Jahre,185,66,119
False,8336057,Maulburg,Insgesamt,3852,1954,1898
False,8336069,"Rheinfelden (Baden), Stadt",unter 3 Jahre,1062,549,513
False,8336069,"Rheinfelden (Baden), Stadt",3 -  6 Jahre,1231,624,607
False,8336069,"Rheinfelden (Baden), Stadt",6 - 10 Jahre,1479,721,758
False,8336069,"Rheinfelden (Baden), Stadt",10 - 15 Jahre,1725,897,828
False,8336069,"Rheinfelden (Baden), Stadt",15 - 18 Jahre,933,507,426
False,8336069,"Rheinfelden (Baden), Stadt",18 - 20 Jahre,643,352,291
False,8336069,"Rheinfelden (Baden), Stadt",20 - 25 Jahre,1831,992,839
False,8336069,"Rheinfelden (Baden), Stadt",25 - 30 Jahre,2711,1387,1324
False,8336069,"Rheinfelden (Baden), Stadt",30 - 35 Jahre,2911,1463,1448
False,8336069,"Rheinfelden (Baden), Stadt",35 - 40 Jahre,2599,1322,1277
False,8336069,"Rheinfelden (Baden), Stadt",40 - 45 Jahre,2042,1027,1015
False,8336069,"Rheinfelden (Baden), Stadt",45 - 50 Jahre,1788,908,880
False,8336069,"Rheinfelden (Baden), Stadt",50 - 55 Jahre,1913,937,976
False,8336069,"Rheinfelden (Baden), Stadt",55 - 60 Jahre,2289,1085,1204
False,8336069,"Rheinfelden (Baden), Stadt",60 - 65 Jahre,1743,894,849
False,8336069,"Rheinfelden (Baden), Stadt",65 - 75 Jahre,2572,1154,1418
False,8336069,"Rheinfelden (Baden), Stadt",75 und mehr Jahre,1517,448,1069
False,8336069,"Rheinfelden (Baden), Stadt",Insgesamt,30989,15267,15722
False,8336073,Rümmingen,unter 3 Jahre,51,24,27
False,8336073,Rümmingen,3 -  6 Jahre,46,27,19
False,8336073,Rümmingen,6 - 10 Jahre,61,35,26
False,8336073,Rümmingen,10 - 15 Jahre,95,40,55
False,8336073,Rümmingen,15 - 18 Jahre,57,28,29
False,8336073,Rümmingen,18 - 20 Jahre,27,9,18
False,8336073,Rümmingen,20 - 25 Jahre,69,35,34
False,8336073,Rümmingen,25 - 30 Jahre,129,55,74
False,8336073,Rümmingen,30 - 35 Jahre,159,74,85
False,8336073,Rümmingen,35 - 40 Jahre,110,65,45
False,8336073,Rümmingen,40 - 45 Jahre,104,46,58
False,8336073,Rümmingen,45 - 50 Jahre,140,69,71
False,8336073,Rümmingen,50 - 55 Jahre,107,62,45
False,8336073,Rümmingen,55 - 60 Jahre,102,52,50
False,8336073,Rümmingen,60 - 65 Jahre,58,36,22
False,8336073,Rümmingen,65 - 75 Jahre,82,38,44
False,8336073,Rümmingen,75 und mehr Jahre,56,18,38
False,8336073,Rümmingen,Insgesamt,1453,713,740
False,8336075,Schallbach,unter 3 Jahre,24,15,9
False,8336075,Schallbach,3 -  6 Jahre,25,8,17
False,8336075,Schallbach,6 - 10 Jahre,45,23,22
False,8336075,Schallbach,10 - 15 Jahre,40,16,24
False,8336075,Schallbach,15 - 18 Jahre,23,14,9
False,8336075,Schallbach,18 - 20 Jahre,16,6,10
False,8336075,Schallbach,20 - 25 Jahre,27,12,15
False,8336075,Schallbach,25 - 30 Jahre,46,22,24
False,8336075,Schallbach,30 - 35 Jahre,51,18,33
False,8336075,Schallbach,35 - 40 Jahre,49,33,16
False,8336075,Schallbach,40 - 45 Jahre,60,29,31
False,8336075,Schallbach,45 - 50 Jahre,51,21,30
False,8336075,Schallbach,50 - 55 Jahre,37,22,15
False,8336075,Schallbach,55 - 60 Jahre,40,24,16
False,8336075,Schallbach,60 - 65 Jahre,24,8,16
False,8336075,Schallbach,65 - 75 Jahre,60,29,31
False,8336075,Schallbach,75 und mehr Jahre,22,9,13
False,8336075,Schallbach,Insgesamt,640,309,331
False,8336078,Schliengen,unter 3 Jahre,162,87,75
False,8336078,Schliengen,3 -  6 Jahre,191,101,90
False,8336078,Schliengen,6 - 10 Jahre,244,136,108
False,8336078,Schliengen,10 - 15 Jahre,282,138,144
False,8336078,Schliengen,15 - 18 Jahre,140,73,67
False,8336078,Schliengen,18 - 20 Jahre,79,43,36
False,8336078,Schliengen,20 - 25 Jahre,268,132,136
False,8336078,Schliengen,25 - 30 Jahre,378,189,189
False,8336078,Schliengen,30 - 35 Jahre,358,190,168
False,8336078,Schliengen,35 - 40 Jahre,424,216,208
False,8336078,Schliengen,40 - 45 Jahre,334,170,164
False,8336078,Schliengen,45 - 50 Jahre,297,162,135
False,8336078,Schliengen,50 - 55 Jahre,239,120,119
False,8336078,Schliengen,55 - 60 Jahre,272,136,136
False,8336078,Schliengen,60 - 65 Jahre,221,105,116
False,8336078,Schliengen,65 - 75 Jahre,411,178,233
False,8336078,Schliengen,75 und mehr Jahre,294,93,201
False,8336078,Schliengen,Insgesamt,4594,2269,2325
False,8336079,"Schönau im Schwarzwald, Stadt",unter 3 Jahre,104,58,46
False,8336079,"Schönau im Schwarzwald, Stadt",3 -  6 Jahre,110,54,56
False,8336079,"Schönau im Schwarzwald, Stadt",6 - 10 Jahre,126,66,60
False,8336079,"Schönau im Schwarzwald, Stadt",10 - 15 Jahre,165,78,87
False,8336079,"Schönau im Schwarzwald, Stadt",15 - 18 Jahre,76,43,33
False,8336079,"Schönau im Schwarzwald, Stadt",18 - 20 Jahre,46,30,16
False,8336079,"Schönau im Schwarzwald, Stadt",20 - 25 Jahre,160,85,75
False,8336079,"Schönau im Schwarzwald, Stadt",25 - 30 Jahre,185,102,83
False,8336079,"Schönau im Schwarzwald, Stadt",30 - 35 Jahre,233,124,109
False,8336079,"Schönau im Schwarzwald, Stadt",35 - 40 Jahre,184,102,82
False,8336079,"Schönau im Schwarzwald, Stadt",40 - 45 Jahre,144,61,83
False,8336079,"Schönau im Schwarzwald, Stadt",45 - 50 Jahre,150,77,73
False,8336079,"Schönau im Schwarzwald, Stadt",50 - 55 Jahre,123,56,67
False,8336079,"Schönau im Schwarzwald, Stadt",55 - 60 Jahre,193,93,100
False,8336079,"Schönau im Schwarzwald, Stadt",60 - 65 Jahre,137,63,74
False,8336079,"Schönau im Schwarzwald, Stadt",65 - 75 Jahre,238,101,137
False,8336079,"Schönau im Schwarzwald, Stadt",75 und mehr Jahre,189,50,139
False,8336079,"Schönau im Schwarzwald, Stadt",Insgesamt,2563,1243,1320
False,8336080,Schönenberg,unter 3 Jahre,9,4,5
False,8336080,Schönenberg,3 -  6 Jahre,11,6,5
False,8336080,Schönenberg,6 - 10 Jahre,12,5,7
False,8336080,Schönenberg,10 - 15 Jahre,16,9,7
False,8336080,Schönenberg,15 - 18 Jahre,11,7,4
False,8336080,Schönenberg,18 - 20 Jahre,12,7,5
False,8336080,Schönenberg,20 - 25 Jahre,24,16,8
False,8336080,Schönenberg,25 - 30 Jahre,24,12,12
False,8336080,Schönenberg,30 - 35 Jahre,35,22,13
False,8336080,Schönenberg,35 - 40 Jahre,24,9,15
False,8336080,Schönenberg,40 - 45 Jahre,10,4,6
False,8336080,Schönenberg,45 - 50 Jahre,21,10,11
False,8336080,Schönenberg,50 - 55 Jahre,22,13,9
False,8336080,Schönenberg,55 - 60 Jahre,36,22,14
False,8336080,Schönenberg,60 - 65 Jahre,23,13,10
False,8336080,Schönenberg,65 - 75 Jahre,27,9,18
False,8336080,Schönenberg,75 und mehr Jahre,7,3,4
False,8336080,Schönenberg,Insgesamt,324,171,153
False,8336081,"Schopfheim, Stadt",unter 3 Jahre,603,303,300
False,8336081,"Schopfheim, Stadt",3 -  6 Jahre,682,342,340
False,8336081,"Schopfheim, Stadt",6 - 10 Jahre,917,458,459
False,8336081,"Schopfheim, Stadt",10 - 15 Jahre,1141,566,575
False,8336081,"Schopfheim, Stadt",15 - 18 Jahre,571,321,250
False,8336081,"Schopfheim, Stadt",18 - 20 Jahre,358,197,161
False,8336081,"Schopfheim, Stadt",20 - 25 Jahre,976,486,490
False,8336081,"Schopfheim, Stadt",25 - 30 Jahre,1351,707,644
False,8336081,"Schopfheim, Stadt",30 - 35 Jahre,1564,757,807
False,8336081,"Schopfheim, Stadt",35 - 40 Jahre,1493,756,737
False,8336081,"Schopfheim, Stadt",40 - 45 Jahre,1321,666,655
False,8336081,"Schopfheim, Stadt",45 - 50 Jahre,1091,555,536
False,8336081,"Schopfheim, Stadt",50 - 55 Jahre,978,477,501
False,8336081,"Schopfheim, Stadt",55 - 60 Jahre,1151,587,564
False,8336081,"Schopfheim, Stadt",60 - 65 Jahre,957,467,490
False,8336081,"Schopfheim, Stadt",65 - 75 Jahre,1661,709,952
False,8336081,"Schopfheim, Stadt",75 und mehr Jahre,1372,355,1017
False,8336081,"Schopfheim, Stadt",Insgesamt,18187,8709,9478
False,8336082,Schwörstadt,unter 3 Jahre,100,52,48
False,8336082,Schwörstadt,3 -  6 Jahre,98,40,58
False,8336082,Schwörstadt,6 - 10 Jahre,132,75,57
False,8336082,Schwörstadt,10 - 15 Jahre,161,84,77
False,8336082,Schwörstadt,15 - 18 Jahre,68,38,30
False,8336082,Schwörstadt,18 - 20 Jahre,54,30,24
False,8336082,Schwörstadt,20 - 25 Jahre,163,78,85
False,8336082,Schwörstadt,25 - 30 Jahre,234,127,107
False,8336082,Schwörstadt,30 - 35 Jahre,218,108,110
False,8336082,Schwörstadt,35 - 40 Jahre,194,100,94
False,8336082,Schwörstadt,40 - 45 Jahre,186,96,90
False,8336082,Schwörstadt,45 - 50 Jahre,145,78,67
False,8336082,Schwörstadt,50 - 55 Jahre,153,74,79
False,8336082,Schwörstadt,55 - 60 Jahre,168,93,75
False,8336082,Schwörstadt,60 - 65 Jahre,136,70,66
False,8336082,Schwörstadt,65 - 75 Jahre,215,100,115
False,8336082,Schwörstadt,75 und mehr Jahre,111,32,79
False,8336082,Schwörstadt,Insgesamt,2536,1275,1261
False,8336084,Steinen,unter 3 Jahre,371,188,183
False,8336084,Steinen,3 -  6 Jahre,424,201,223
False,8336084,Steinen,6 - 10 Jahre,541,279,262
False,8336084,Steinen,10 - 15 Jahre,582,289,293
False,8336084,Steinen,15 - 18 Jahre,282,132,150
False,8336084,Steinen,18 - 20 Jahre,186,96,90
False,8336084,Steinen,20 - 25 Jahre,461,225,236
False,8336084,Steinen,25 - 30 Jahre,842,418,424
False,8336084,Steinen,30 - 35 Jahre,988,477,511
False,8336084,Steinen,35 - 40 Jahre,892,465,427
False,8336084,Steinen,40 - 45 Jahre,741,357,384
False,8336084,Steinen,45 - 50 Jahre,617,324,293
False,8336084,Steinen,50 - 55 Jahre,555,293,262
False,8336084,Steinen,55 - 60 Jahre,695,338,357
False,8336084,Steinen,60 - 65 Jahre,584,279,305
False,8336084,Steinen,65 - 75 Jahre,844,369,475
False,8336084,Steinen,75 und mehr Jahre,528,179,349
False,8336084,Steinen,Insgesamt,10133,4909,5224
False,8336087,"Todtnau, Stadt",unter 3 Jahre,201,105,96
False,8336087,"Todtnau, Stadt",3 -  6 Jahre,188,93,95
False,8336087,"Todtnau, Stadt",6 - 10 Jahre,227,124,103
False,8336087,"Todtnau, Stadt",10 - 15 Jahre,251,136,115
False,8336087,"Todtnau, Stadt",15 - 18 Jahre,159,64,95
False,8336087,"Todtnau, Stadt",18 - 20 Jahre,109,48,61
False,8336087,"Todtnau, Stadt",20 - 25 Jahre,326,161,165
False,8336087,"Todtnau, Stadt",25 - 30 Jahre,462,231,231
False,8336087,"Todtnau, Stadt",30 - 35 Jahre,474,255,219
False,8336087,"Todtnau, Stadt",35 - 40 Jahre,359,184,175
False,8336087,"Todtnau, Stadt",40 - 45 Jahre,322,170,152
False,8336087,"Todtnau, Stadt",45 - 50 Jahre,265,134,131
False,8336087,"Todtnau, Stadt",50 - 55 Jahre,261,122,139
False,8336087,"Todtnau, Stadt",55 - 60 Jahre,358,175,183
False,8336087,"Todtnau, Stadt",60 - 65 Jahre,322,170,152
False,8336087,"Todtnau, Stadt",65 - 75 Jahre,512,220,292
False,8336087,"Todtnau, Stadt",75 und mehr Jahre,379,97,282
False,8336087,"Todtnau, Stadt",Insgesamt,5175,2489,2686
False,8336089,Tunau,unter 3 Jahre,6,4,2
False,8336089,Tunau,3 -  6 Jahre,6,5,1
False,8336089,Tunau,6 - 10 Jahre,9,4,5
False,8336089,Tunau,10 - 15 Jahre,7,1,6
False,8336089,Tunau,15 - 18 Jahre,8,3,5
False,8336089,Tunau,18 - 20 Jahre,4,0,4
False,8336089,Tunau,20 - 25 Jahre,24,17,7
False,8336089,Tunau,25 - 30 Jahre,15,10,5
False,8336089,Tunau,30 - 35 Jahre,17,8,9
False,8336089,Tunau,35 - 40 Jahre,12,3,9
False,8336089,Tunau,40 - 45 Jahre,13,9,4
False,8336089,Tunau,45 - 50 Jahre,13,8,5
False,8336089,Tunau,50 - 55 Jahre,4,2,2
False,8336089,Tunau,55 - 60 Jahre,21,8,13
False,8336089,Tunau,60 - 65 Jahre,11,7,4
False,8336089,Tunau,65 - 75 Jahre,13,5,8
False,8336089,Tunau,75 und mehr Jahre,11,2,9
False,8336089,Tunau,Insgesamt,194,96,98
False,8336090,Utzenfeld,unter 3 Jahre,24,11,13
False,8336090,Utzenfeld,3 -  6 Jahre,23,15,8
False,8336090,Utzenfeld,6 - 10 Jahre,28,15,13
False,8336090,Utzenfeld,10 - 15 Jahre,41,24,17
False,8336090,Utzenfeld,15 - 18 Jahre,25,8,17
False,8336090,Utzenfeld,18 - 20 Jahre,18,8,10
False,8336090,Utzenfeld,20 - 25 Jahre,37,21,16
False,8336090,Utzenfeld,25 - 30 Jahre,42,28,14
False,8336090,Utzenfeld,30 - 35 Jahre,58,31,27
False,8336090,Utzenfeld,35 - 40 Jahre,67,36,31
False,8336090,Utzenfeld,40 - 45 Jahre,55,30,25
False,8336090,Utzenfeld,45 - 50 Jahre,31,16,15
False,8336090,Utzenfeld,50 - 55 Jahre,45,23,22
False,8336090,Utzenfeld,55 - 60 Jahre,50,24,26
False,8336090,Utzenfeld,60 - 65 Jahre,35,15,20
False,8336090,Utzenfeld,65 - 75 Jahre,46,28,18
False,8336090,Utzenfeld,75 und mehr Jahre,31,9,22
False,8336090,Utzenfeld,Insgesamt,656,342,314
False,8336091,"Weil am Rhein, Stadt",unter 3 Jahre,842,462,380
False,8336091,"Weil am Rhein, Stadt",3 -  6 Jahre,1002,527,475
False,8336091,"Weil am Rhein, Stadt",6 - 10 Jahre,1316,659,657
False,8336091,"Weil am Rhein, Stadt",10 - 15 Jahre,1446,728,718
False,8336091,"Weil am Rhein, Stadt",15 - 18 Jahre,854,405,449
False,8336091,"Weil am Rhein, Stadt",18 - 20 Jahre,570,293,277
False,8336091,"Weil am Rhein, Stadt",20 - 25 Jahre,1555,779,776
False,8336091,"Weil am Rhein, Stadt",25 - 30 Jahre,2324,1179,1145
False,8336091,"Weil am Rhein, Stadt",30 - 35 Jahre,2455,1240,1215
False,8336091,"Weil am Rhein, Stadt",35 - 40 Jahre,2229,1120,1109
False,8336091,"Weil am Rhein, Stadt",40 - 45 Jahre,1842,950,892
False,8336091,"Weil am Rhein, Stadt",45 - 50 Jahre,1711,827,884
False,8336091,"Weil am Rhein, Stadt",50 - 55 Jahre,1759,899,860
False,8336091,"Weil am Rhein, Stadt",55 - 60 Jahre,2104,1041,1063
False,8336091,"Weil am Rhein, Stadt",60 - 65 Jahre,1611,783,828
False,8336091,"Weil am Rhein, Stadt",65 - 75 Jahre,2474,1049,1425
False,8336091,"Weil am Rhein, Stadt",75 und mehr Jahre,1816,571,1245
False,8336091,"Weil am Rhein, Stadt",Insgesamt,27910,13512,14398
False,8336094,Wembach,unter 3 Jahre,11,5,6
False,8336094,Wembach,3 -  6 Jahre,14,8,6
False,8336094,Wembach,6 - 10 Jahre,18,6,12
False,8336094,Wembach,10 - 15 Jahre,19,16,3
False,8336094,Wembach,15 - 18 Jahre,6,2,4
False,8336094,Wembach,18 - 20 Jahre,7,2,5
False,8336094,Wembach,20 - 25 Jahre,17,7,10
False,8336094,Wembach,25 - 30 Jahre,15,10,5
False,8336094,Wembach,30 - 35 Jahre,18,9,9
False,8336094,Wembach,35 - 40 Jahre,16,6,10
False,8336094,Wembach,40 - 45 Jahre,19,13,6
False,8336094,Wembach,45 - 50 Jahre,18,7,11
False,8336094,Wembach,50 - 55 Jahre,8,4,4
False,8336094,Wembach,55 - 60 Jahre,20,10,10
False,8336094,Wembach,60 - 65 Jahre,15,8,7
False,8336094,Wembach,65 - 75 Jahre,31,10,21
False,8336094,Wembach,75 und mehr Jahre,17,7,10
False,8336094,Wembach,Insgesamt,269,130,139
False,8336096,Wieden,unter 3 Jahre,26,7,19
False,8336096,Wieden,3 -  6 Jahre,29,14,15
False,8336096,Wieden,6 - 10 Jahre,46,21,25
False,8336096,Wieden,10 - 15 Jahre,39,25,14
False,8336096,Wieden,15 - 18 Jahre,23,15,8
False,8336096,Wieden,18 - 20 Jahre,22,13,9
False,8336096,Wieden,20 - 25 Jahre,32,15,17
False,8336096,Wieden,25 - 30 Jahre,46,21,25
False,8336096,Wieden,30 - 35 Jahre,51,26,25
False,8336096,Wieden,35 - 40 Jahre,48,22,26
False,8336096,Wieden,40 - 45 Jahre,40,19,21
False,8336096,Wieden,45 - 50 Jahre,27,12,15
False,8336096,Wieden,50 - 55 Jahre,36,22,14
False,8336096,Wieden,55 - 60 Jahre,26,17,9
False,8336096,Wieden,60 - 65 Jahre,22,13,9
False,8336096,Wieden,65 - 75 Jahre,45,18,27
False,8336096,Wieden,75 und mehr Jahre,28,10,18
False,8336096,Wieden,Insgesamt,586,290,296
False,8336100,Wittlingen,unter 3 Jahre,24,14,10
False,8336100,Wittlingen,3 -  6 Jahre,30,13,17
False,8336100,Wittlingen,6 - 10 Jahre,49,29,20
False,8336100,Wittlingen,10 - 15 Jahre,47,22,25
False,8336100,Wittlingen,15 - 18 Jahre,25,15,10
False,8336100,Wittlingen,18 - 20 Jahre,8,1,7
False,8336100,Wittlingen,20 - 25 Jahre,36,15,21
False,8336100,Wittlingen,25 - 30 Jahre,57,26,31
False,8336100,Wittlingen,30 - 35 Jahre,80,35,45
False,8336100,Wittlingen,35 - 40 Jahre,78,44,34
False,8336100,Wittlingen,40 - 45 Jahre,65,40,25
False,8336100,Wittlingen,45 - 50 Jahre,45,21,24
False,8336100,Wittlingen,50 - 55 Jahre,34,18,16
False,8336100,Wittlingen,55 - 60 Jahre,51,20,31
False,8336100,Wittlingen,60 - 65 Jahre,41,25,16
False,8336100,Wittlingen,65 - 75 Jahre,57,25,32
False,8336100,Wittlingen,75 und mehr Jahre,38,14,24
False,8336100,Wittlingen,Insgesamt,765,377,388
False,8336103,"Zell im Wiesental, Stadt",unter 3 Jahre,241,126,115
False,8336103,"Zell im Wiesental, Stadt",3 -  6 Jahre,296,149,147
False,8336103,"Zell im Wiesental, Stadt",6 - 10 Jahre,388,203,185
False,8336103,"Zell im Wiesental, Stadt",10 - 15 Jahre,443,247,196
False,8336103,"Zell im Wiesental, Stadt",15 - 18 Jahre,226,108,118
False,8336103,"Zell im Wiesental, Stadt",18 - 20 Jahre,144,66,78
False,8336103,"Zell im Wiesental, Stadt",20 - 25 Jahre,390,192,198
False,8336103,"Zell im Wiesental, Stadt",25 - 30 Jahre,541,264,277
False,8336103,"Zell im Wiesental, Stadt",30 - 35 Jahre,602,298,304
False,8336103,"Zell im Wiesental, Stadt",35 - 40 Jahre,518,273,245
False,8336103,"Zell im Wiesental, Stadt",40 - 45 Jahre,416,220,196
False,8336103,"Zell im Wiesental, Stadt",45 - 50 Jahre,339,179,160
False,8336103,"Zell im Wiesental, Stadt",50 - 55 Jahre,328,177,151
False,8336103,"Zell im Wiesental, Stadt",55 - 60 Jahre,430,210,220
False,8336103,"Zell im Wiesental, Stadt",60 - 65 Jahre,345,163,182
False,8336103,"Zell im Wiesental, Stadt",65 - 75 Jahre,573,240,333
False,8336103,"Zell im Wiesental, Stadt",75 und mehr Jahre,352,107,245
False,8336103,"Zell im Wiesental, Stadt",Insgesamt,6572,3222,3350
False,8336104,Malsburg-Marzell,unter 3 Jahre,67,43,24
False,8336104,Malsburg-Marzell,3 -  6 Jahre,67,37,30
False,8336104,Malsburg-Marzell,6 - 10 Jahre,98,49,49
False,8336104,Malsburg-Marzell,10 - 15 Jahre,100,47,53
False,8336104,Malsburg-Marzell,15 - 18 Jahre,78,38,40
False,8336104,Malsburg-Marzell,18 - 20 Jahre,45,25,20
False,8336104,Malsburg-Marzell,20 - 25 Jahre,72,37,35
False,8336104,Malsburg-Marzell,25 - 30 Jahre,126,54,72
False,8336104,Malsburg-Marzell,30 - 35 Jahre,126,63,63
False,8336104,Malsburg-Marzell,35 - 40 Jahre,128,65,63
False,8336104,Malsburg-Marzell,40 - 45 Jahre,107,58,49
False,8336104,Malsburg-Marzell,45 - 50 Jahre,89,40,49
False,8336104,Malsburg-Marzell,50 - 55 Jahre,78,40,38
False,8336104,Malsburg-Marzell,55 - 60 Jahre,117,58,59
False,8336104,Malsburg-Marzell,60 - 65 Jahre,87,47,40
False,8336104,Malsburg-Marzell,65 - 75 Jahre,157,68,89
False,8336104,Malsburg-Marzell,75 und mehr Jahre,105,26,79
False,8336104,Malsburg-Marzell,Insgesamt,1647,795,852
False,8336105,Grenzach-Wyhlen,unter 3 Jahre,402,206,196
False,8336105,Grenzach-Wyhlen,3 -  6 Jahre,447,253,194
False,8336105,Grenzach-Wyhlen,6 - 10 Jahre,605,305,300
False,8336105,Grenzach-Wyhlen,10 - 15 Jahre,721,371,350
False,8336105,Grenzach-Wyhlen,15 - 18 Jahre,409,207,202
False,8336105,Grenzach-Wyhlen,18 - 20 Jahre,243,111,132
False,8336105,Grenzach-Wyhlen,20 - 25 Jahre,700,346,354
False,8336105,Grenzach-Wyhlen,25 - 30 Jahre,1075,540,535
False,8336105,Grenzach-Wyhlen,30 - 35 Jahre,1258,627,631
False,8336105,Grenzach-Wyhlen,35 - 40 Jahre,1085,517,568
False,8336105,Grenzach-Wyhlen,40 - 45 Jahre,970,498,472
False,8336105,Grenzach-Wyhlen,45 - 50 Jahre,880,431,449
False,8336105,Grenzach-Wyhlen,50 - 55 Jahre,832,415,417
False,8336105,Grenzach-Wyhlen,55 - 60 Jahre,1124,569,555
False,8336105,Grenzach-Wyhlen,60 - 65 Jahre,810,400,410
False,8336105,Grenzach-Wyhlen,65 - 75 Jahre,1156,541,615
False,8336105,Grenzach-Wyhlen,75 und mehr Jahre,753,202,551
False,8336105,Grenzach-Wyhlen,Insgesamt,13470,6539,6931
False,8336106,Häg-Ehrsberg,unter 3 Jahre,34,21,13
False,8336106,Häg-Ehrsberg,3 -  6 Jahre,46,19,27
False,8336106,Häg-Ehrsberg,6 - 10 Jahre,40,10,30
False,8336106,Häg-Ehrsberg,10 - 15 Jahre,58,38,20
False,8336106,Häg-Ehrsberg,15 - 18 Jahre,34,21,13
False,8336106,Häg-Ehrsberg,18 - 20 Jahre,21,8,13
False,8336106,Häg-Ehrsberg,20 - 25 Jahre,50,26,24
False,8336106,Häg-Ehrsberg,25 - 30 Jahre,82,46,36
False,8336106,Häg-Ehrsberg,30 - 35 Jahre,83,53,30
False,8336106,Häg-Ehrsberg,35 - 40 Jahre,72,32,40
False,8336106,Häg-Ehrsberg,40 - 45 Jahre,72,46,26
False,8336106,Häg-Ehrsberg,45 - 50 Jahre,36,17,19
False,8336106,Häg-Ehrsberg,50 - 55 Jahre,23,11,12
False,8336106,Häg-Ehrsberg,55 - 60 Jahre,57,24,33
False,8336106,Häg-Ehrsberg,60 - 65 Jahre,46,23,23
False,8336106,Häg-Ehrsberg,65 - 75 Jahre,96,45,51
False,8336106,Häg-Ehrsberg,75 und mehr Jahre,67,21,46
False,8336106,Häg-Ehrsberg,Insgesamt,917,461,456
False,8336107,Kleines Wiesental,unter 3 Jahre,125,71,54
False,8336107,Kleines Wiesental,3 -  6 Jahre,127,76,51
False,8336107,Kleines Wiesental,6 - 10 Jahre,145,77,68
False,8336107,Kleines Wiesental,10 - 15 Jahre,164,77,87
False,8336107,Kleines Wiesental,15 - 18 Jahre,82,37,45
False,8336107,Kleines Wiesental,18 - 20 Jahre,49,24,25
False,8336107,Kleines Wiesental,20 - 25 Jahre,143,79,64
False,8336107,Kleines Wiesental,25 - 30 Jahre,212,114,98
False,8336107,Kleines Wiesental,30 - 35 Jahre,287,145,142
False,8336107,Kleines Wiesental,35 - 40 Jahre,240,120,120
False,8336107,Kleines Wiesental,40 - 45 Jahre,217,125,92
False,8336107,Kleines Wiesental,45 - 50 Jahre,174,93,81
False,8336107,Kleines Wiesental,50 - 55 Jahre,144,76,68
False,8336107,Kleines Wiesental,55 - 60 Jahre,194,94,100
False,8336107,Kleines Wiesental,60 - 65 Jahre,180,96,84
False,8336107,Kleines Wiesental,65 - 75 Jahre,320,142,178
False,8336107,Kleines Wiesental,75 und mehr Jahre,164,49,115
False,8336107,Kleines Wiesental,Insgesamt,2967,1495,1472
False,8337,Landkreis Waldshut,unter 3 Jahre,5718,2987,2731
False,8337,Landkreis Waldshut,3 -  6 Jahre,6290,3186,3104
False,8337,Landkreis Waldshut,6 - 10 Jahre,8333,4310,4023
False,8337,Landkreis Waldshut,10 - 15 Jahre,10043,5179,4864
False,8337,Landkreis Waldshut,15 - 18 Jahre,5678,2903,2775
False,8337,Landkreis Waldshut,18 - 20 Jahre,3454,1801,1653
False,8337,Landkreis Waldshut,20 - 25 Jahre,9514,4740,4774
False,8337,Landkreis Waldshut,25 - 30 Jahre,13294,6750,6544
False,8337,Landkreis Waldshut,30 - 35 Jahre,14517,7425,7092
False,8337,Landkreis Waldshut,35 - 40 Jahre,12827,6596,6231
False,8337,Landkreis Waldshut,40 - 45 Jahre,11142,5644,5498
False,8337,Landkreis Waldshut,45 - 50 Jahre,9501,4872,4629
False,8337,Landkreis Waldshut,50 - 55 Jahre,8813,4462,4351
False,8337,Landkreis Waldshut,55 - 60 Jahre,10993,5504,5489
False,8337,Landkreis Waldshut,60 - 65 Jahre,8569,4230,4339
False,8337,Landkreis Waldshut,65 - 75 Jahre,14554,6157,8397
False,8337,Landkreis Waldshut,75 und mehr Jahre,10086,3071,7015
False,8337,Landkreis Waldshut,Insgesamt,163326,79817,83509
False,8337002,Albbruck,unter 3 Jahre,273,145,128
False,8337002,Albbruck,3 -  6 Jahre,332,167,165
False,8337002,Albbruck,6 - 10 Jahre,423,230,193
False,8337002,Albbruck,10 - 15 Jahre,475,255,220
False,8337002,Albbruck,15 - 18 Jahre,277,133,144
False,8337002,Albbruck,18 - 20 Jahre,157,83,74
False,8337002,Albbruck,20 - 25 Jahre,372,193,179
False,8337002,Albbruck,25 - 30 Jahre,534,276,258
False,8337002,Albbruck,30 - 35 Jahre,698,356,342
False,8337002,Albbruck,35 - 40 Jahre,672,337,335
False,8337002,Albbruck,40 - 45 Jahre,520,258,262
False,8337002,Albbruck,45 - 50 Jahre,374,218,156
False,8337002,Albbruck,50 - 55 Jahre,335,153,182
False,8337002,Albbruck,55 - 60 Jahre,426,223,203
False,8337002,Albbruck,60 - 65 Jahre,358,180,178
False,8337002,Albbruck,65 - 75 Jahre,636,283,353
False,8337002,Albbruck,75 und mehr Jahre,315,89,226
False,8337002,Albbruck,Insgesamt,7177,3579,3598
False,8337013,Bernau im Schwarzwald,unter 3 Jahre,77,53,24
False,8337013,Bernau im Schwarzwald,3 -  6 Jahre,87,43,44
False,8337013,Bernau im Schwarzwald,6 - 10 Jahre,102,54,48
False,8337013,Bernau im Schwarzwald,10 - 15 Jahre,117,64,53
False,8337013,Bernau im Schwarzwald,15 - 18 Jahre,71,32,39
False,8337013,Bernau im Schwarzwald,18 - 20 Jahre,52,29,23
False,8337013,Bernau im Schwarzwald,20 - 25 Jahre,90,39,51
False,8337013,Bernau im Schwarzwald,25 - 30 Jahre,164,90,74
False,8337013,Bernau im Schwarzwald,30 - 35 Jahre,186,98,88
False,8337013,Bernau im Schwarzwald,35 - 40 Jahre,166,85,81
False,8337013,Bernau im Schwarzwald,40 - 45 Jahre,137,69,68
False,8337013,Bernau im Schwarzwald,45 - 50 Jahre,103,46,57
False,8337013,Bernau im Schwarzwald,50 - 55 Jahre,101,53,48
False,8337013,Bernau im Schwarzwald,55 - 60 Jahre,126,61,65
False,8337013,Bernau im Schwarzwald,60 - 65 Jahre,103,49,54
False,8337013,Bernau im Schwarzwald,65 - 75 Jahre,194,88,106
False,8337013,Bernau im Schwarzwald,75 und mehr Jahre,96,43,53
False,8337013,Bernau im Schwarzwald,Insgesamt,1972,996,976
False,8337022,"Bonndorf im Schwarzwald, Stadt",unter 3 Jahre,262,140,122
False,8337022,"Bonndorf im Schwarzwald, Stadt",3 -  6 Jahre,286,146,140
False,8337022,"Bonndorf im Schwarzwald, Stadt",6 - 10 Jahre,349,165,184
False,8337022,"Bonndorf im Schwarzwald, Stadt",10 - 15 Jahre,388,192,196
False,8337022,"Bonndorf im Schwarzwald, Stadt",15 - 18 Jahre,231,114,117
False,8337022,"Bonndorf im Schwarzwald, Stadt",18 - 20 Jahre,128,64,64
False,8337022,"Bonndorf im Schwarzwald, Stadt",20 - 25 Jahre,389,177,212
False,8337022,"Bonndorf im Schwarzwald, Stadt",25 - 30 Jahre,603,317,286
False,8337022,"Bonndorf im Schwarzwald, Stadt",30 - 35 Jahre,637,328,309
False,8337022,"Bonndorf im Schwarzwald, Stadt",35 - 40 Jahre,458,227,231
False,8337022,"Bonndorf im Schwarzwald, Stadt",40 - 45 Jahre,430,225,205
False,8337022,"Bonndorf im Schwarzwald, Stadt",45 - 50 Jahre,347,178,169
False,8337022,"Bonndorf im Schwarzwald, Stadt",50 - 55 Jahre,316,159,157
False,8337022,"Bonndorf im Schwarzwald, Stadt",55 - 60 Jahre,435,211,224
False,8337022,"Bonndorf im Schwarzwald, Stadt",60 - 65 Jahre,338,177,161
False,8337022,"Bonndorf im Schwarzwald, Stadt",65 - 75 Jahre,518,220,298
False,8337022,"Bonndorf im Schwarzwald, Stadt",75 und mehr Jahre,379,103,276
False,8337022,"Bonndorf im Schwarzwald, Stadt",Insgesamt,6494,3143,3351
False,8337027,Dachsberg (Südschwarzwald),unter 3 Jahre,57,28,29
False,8337027,Dachsberg (Südschwarzwald),3 -  6 Jahre,67,35,32
False,8337027,Dachsberg (Südschwarzwald),6 - 10 Jahre,84,49,35
False,8337027,Dachsberg (Südschwarzwald),10 - 15 Jahre,99,51,48
False,8337027,Dachsberg (Südschwarzwald),15 - 18 Jahre,49,33,16
False,8337027,Dachsberg (Südschwarzwald),18 - 20 Jahre,21,14,7
False,8337027,Dachsberg (Südschwarzwald),20 - 25 Jahre,48,22,26
False,8337027,Dachsberg (Südschwarzwald),25 - 30 Jahre,107,55,52
False,8337027,Dachsberg (Südschwarzwald),30 - 35 Jahre,127,60,67
False,8337027,Dachsberg (Südschwarzwald),35 - 40 Jahre,115,62,53
False,8337027,Dachsberg (Südschwarzwald),40 - 45 Jahre,85,48,37
False,8337027,Dachsberg (Südschwarzwald),45 - 50 Jahre,56,26,30
False,8337027,Dachsberg (Südschwarzwald),50 - 55 Jahre,66,31,35
False,8337027,Dachsberg (Südschwarzwald),55 - 60 Jahre,81,35,46
False,8337027,Dachsberg (Südschwarzwald),60 - 65 Jahre,85,38,47
False,8337027,Dachsberg (Südschwarzwald),65 - 75 Jahre,132,65,67
False,8337027,Dachsberg (Südschwarzwald),75 und mehr Jahre,72,21,51
False,8337027,Dachsberg (Südschwarzwald),Insgesamt,1351,673,678
False,8337030,Dettighofen,unter 3 Jahre,40,21,19
False,8337030,Dettighofen,3 -  6 Jahre,49,25,24
False,8337030,Dettighofen,6 - 10 Jahre,39,18,21
False,8337030,Dettighofen,10 - 15 Jahre,67,33,34
False,8337030,Dettighofen,15 - 18 Jahre,31,11,20
False,8337030,Dettighofen,18 - 20 Jahre,23,9,14
False,8337030,Dettighofen,20 - 25 Jahre,65,38,27
False,8337030,Dettighofen,25 - 30 Jahre,76,35,41
False,8337030,Dettighofen,30 - 35 Jahre,99,58,41
False,8337030,Dettighofen,35 - 40 Jahre,85,45,40
False,8337030,Dettighofen,40 - 45 Jahre,77,43,34
False,8337030,Dettighofen,45 - 50 Jahre,52,30,22
False,8337030,Dettighofen,50 - 55 Jahre,55,25,30
False,8337030,Dettighofen,55 - 60 Jahre,65,29,36
False,8337030,Dettighofen,60 - 65 Jahre,50,25,25
False,8337030,Dettighofen,65 - 75 Jahre,107,55,52
False,8337030,Dettighofen,75 und mehr Jahre,68,21,47
False,8337030,Dettighofen,Insgesamt,1048,521,527
False,8337032,Dogern,unter 3 Jahre,71,42,29
False,8337032,Dogern,3 -  6 Jahre,79,37,42
False,8337032,Dogern,6 - 10 Jahre,105,54,51
False,8337032,Dogern,10 - 15 Jahre,155,85,70
False,8337032,Dogern,15 - 18 Jahre,67,38,29
False,8337032,Dogern,18 - 20 Jahre,55,39,16
False,8337032,Dogern,20 - 25 Jahre,123,63,60
False,8337032,Dogern,25 - 30 Jahre,152,81,71
False,8337032,Dogern,30 - 35 Jahre,195,86,109
False,8337032,Dogern,35 - 40 Jahre,231,115,116
False,8337032,Dogern,40 - 45 Jahre,186,96,90
False,8337032,Dogern,45 - 50 Jahre,149,79,70
False,8337032,Dogern,50 - 55 Jahre,123,64,59
False,8337032,Dogern,55 - 60 Jahre,178,87,91
False,8337032,Dogern,60 - 65 Jahre,121,63,58
False,8337032,Dogern,65 - 75 Jahre,214,84,130
False,8337032,Dogern,75 und mehr Jahre,107,41,66
False,8337032,Dogern,Insgesamt,2311,1154,1157
False,8337038,Görwihl,unter 3 Jahre,168,88,80
False,8337038,Görwihl,3 -  6 Jahre,219,114,105
False,8337038,Görwihl,6 - 10 Jahre,272,133,139
False,8337038,Görwihl,10 - 15 Jahre,382,204,178
False,8337038,Görwihl,15 - 18 Jahre,206,105,101
False,8337038,Görwihl,18 - 20 Jahre,113,62,51
False,8337038,Görwihl,20 - 25 Jahre,269,137,132
False,8337038,Görwihl,25 - 30 Jahre,362,184,178
False,8337038,Görwihl,30 - 35 Jahre,432,234,198
False,8337038,Görwihl,35 - 40 Jahre,396,204,192
False,8337038,Görwihl,40 - 45 Jahre,296,142,154
False,8337038,Görwihl,45 - 50 Jahre,249,132,117
False,8337038,Görwihl,50 - 55 Jahre,225,104,121
False,8337038,Görwihl,55 - 60 Jahre,262,143,119
False,8337038,Görwihl,60 - 65 Jahre,221,112,109
False,8337038,Görwihl,65 - 75 Jahre,397,165,232
False,8337038,Görwihl,75 und mehr Jahre,248,79,169
False,8337038,Görwihl,Insgesamt,4717,2342,2375
False,8337039,Grafenhausen,unter 3 Jahre,90,44,46
False,8337039,Grafenhausen,3 -  6 Jahre,85,49,36
False,8337039,Grafenhausen,6 - 10 Jahre,125,71,54
False,8337039,Grafenhausen,10 - 15 Jahre,152,91,61
False,8337039,Grafenhausen,15 - 18 Jahre,75,36,39
False,8337039,Grafenhausen,18 - 20 Jahre,60,38,22
False,8337039,Grafenhausen,20 - 25 Jahre,144,72,72
False,8337039,Grafenhausen,25 - 30 Jahre,172,91,81
False,8337039,Grafenhausen,30 - 35 Jahre,190,92,98
False,8337039,Grafenhausen,35 - 40 Jahre,159,76,83
False,8337039,Grafenhausen,40 - 45 Jahre,167,89,78
False,8337039,Grafenhausen,45 - 50 Jahre,117,59,58
False,8337039,Grafenhausen,50 - 55 Jahre,122,67,55
False,8337039,Grafenhausen,55 - 60 Jahre,143,66,77
False,8337039,Grafenhausen,60 - 65 Jahre,125,62,63
False,8337039,Grafenhausen,65 - 75 Jahre,230,107,123
False,8337039,Grafenhausen,75 und mehr Jahre,145,43,102
False,8337039,Grafenhausen,Insgesamt,2301,1153,1148
False,8337045,Häusern,unter 3 Jahre,29,14,15
False,8337045,Häusern,3 -  6 Jahre,43,15,28
False,8337045,Häusern,6 - 10 Jahre,54,34,20
False,8337045,Häusern,10 - 15 Jahre,75,32,43
False,8337045,Häusern,15 - 18 Jahre,40,21,19
False,8337045,Häusern,18 - 20 Jahre,28,11,17
False,8337045,Häusern,20 - 25 Jahre,71,34,37
False,8337045,Häusern,25 - 30 Jahre,112,53,59
False,8337045,Häusern,30 - 35 Jahre,102,47,55
False,8337045,Häusern,35 - 40 Jahre,97,56,41
False,8337045,Häusern,40 - 45 Jahre,73,40,33
False,8337045,Häusern,45 - 50 Jahre,73,33,40
False,8337045,Häusern,50 - 55 Jahre,77,41,36
False,8337045,Häusern,55 - 60 Jahre,91,47,44
False,8337045,Häusern,60 - 65 Jahre,83,35,48
False,8337045,Häusern,65 - 75 Jahre,137,65,72
False,8337045,Häusern,75 und mehr Jahre,55,10,45
False,8337045,Häusern,Insgesamt,1240,588,652
False,8337049,Herrischried,unter 3 Jahre,73,39,34
False,8337049,Herrischried,3 -  6 Jahre,86,43,43
False,8337049,Herrischried,6 - 10 Jahre,119,68,51
False,8337049,Herrischried,10 - 15 Jahre,161,90,71
False,8337049,Herrischried,15 - 18 Jahre,73,38,35
False,8337049,Herrischried,18 - 20 Jahre,29,15,14
False,8337049,Herrischried,20 - 25 Jahre,121,57,64
False,8337049,Herrischried,25 - 30 Jahre,184,98,86
False,8337049,Herrischried,30 - 35 Jahre,214,112,102
False,8337049,Herrischried,35 - 40 Jahre,190,96,94
False,8337049,Herrischried,40 - 45 Jahre,131,79,52
False,8337049,Herrischried,45 - 50 Jahre,132,59,73
False,8337049,Herrischried,50 - 55 Jahre,131,70,61
False,8337049,Herrischried,55 - 60 Jahre,168,80,88
False,8337049,Herrischried,60 - 65 Jahre,172,87,85
False,8337049,Herrischried,65 - 75 Jahre,258,127,131
False,8337049,Herrischried,75 und mehr Jahre,208,57,151
False,8337049,Herrischried,Insgesamt,2450,1215,1235
False,8337051,Höchenschwand,unter 3 Jahre,77,48,29
False,8337051,Höchenschwand,3 -  6 Jahre,97,51,46
False,8337051,Höchenschwand,6 - 10 Jahre,106,60,46
False,8337051,Höchenschwand,10 - 15 Jahre,145,74,71
False,8337051,Höchenschwand,15 - 18 Jahre,66,40,26
False,8337051,Höchenschwand,18 - 20 Jahre,53,22,31
False,8337051,Höchenschwand,20 - 25 Jahre,126,58,68
False,8337051,Höchenschwand,25 - 30 Jahre,212,98,114
False,8337051,Höchenschwand,30 - 35 Jahre,245,115,130
False,8337051,Höchenschwand,35 - 40 Jahre,175,86,89
False,8337051,Höchenschwand,40 - 45 Jahre,158,85,73
False,8337051,Höchenschwand,45 - 50 Jahre,126,57,69
False,8337051,Höchenschwand,50 - 55 Jahre,125,53,72
False,8337051,Höchenschwand,55 - 60 Jahre,177,75,102
False,8337051,Höchenschwand,60 - 65 Jahre,135,61,74
False,8337051,Höchenschwand,65 - 75 Jahre,210,92,118
False,8337051,Höchenschwand,75 und mehr Jahre,136,41,95
False,8337051,Höchenschwand,Insgesamt,2369,1116,1253
False,8337053,Hohentengen am Hochrhein,unter 3 Jahre,133,73,60
False,8337053,Hohentengen am Hochrhein,3 -  6 Jahre,131,68,63
False,8337053,Hohentengen am Hochrhein,6 - 10 Jahre,173,95,78
False,8337053,Hohentengen am Hochrhein,10 - 15 Jahre,196,102,94
False,8337053,Hohentengen am Hochrhein,15 - 18 Jahre,118,63,55
False,8337053,Hohentengen am Hochrhein,18 - 20 Jahre,68,40,28
False,8337053,Hohentengen am Hochrhein,20 - 25 Jahre,179,75,104
False,8337053,Hohentengen am Hochrhein,25 - 30 Jahre,300,135,165
False,8337053,Hohentengen am Hochrhein,30 - 35 Jahre,305,180,125
False,8337053,Hohentengen am Hochrhein,35 - 40 Jahre,317,168,149
False,8337053,Hohentengen am Hochrhein,40 - 45 Jahre,244,122,122
False,8337053,Hohentengen am Hochrhein,45 - 50 Jahre,158,77,81
False,8337053,Hohentengen am Hochrhein,50 - 55 Jahre,150,74,76
False,8337053,Hohentengen am Hochrhein,55 - 60 Jahre,196,105,91
False,8337053,Hohentengen am Hochrhein,60 - 65 Jahre,150,69,81
False,8337053,Hohentengen am Hochrhein,65 - 75 Jahre,299,145,154
False,8337053,Hohentengen am Hochrhein,75 und mehr Jahre,169,60,109
False,8337053,Hohentengen am Hochrhein,Insgesamt,3286,1651,1635
False,8337059,Ibach,unter 3 Jahre,11,7,4
False,8337059,Ibach,3 -  6 Jahre,16,10,6
False,8337059,Ibach,6 - 10 Jahre,25,13,12
False,8337059,Ibach,10 - 15 Jahre,27,13,14
False,8337059,Ibach,15 - 18 Jahre,10,5,5
False,8337059,Ibach,18 - 20 Jahre,9,4,5
False,8337059,Ibach,20 - 25 Jahre,23,14,9
False,8337059,Ibach,25 - 30 Jahre,28,14,14
False,8337059,Ibach,30 - 35 Jahre,47,20,27
False,8337059,Ibach,35 - 40 Jahre,26,11,15
False,8337059,Ibach,40 - 45 Jahre,25,13,12
False,8337059,Ibach,45 - 50 Jahre,24,10,14
False,8337059,Ibach,50 - 55 Jahre,20,8,12
False,8337059,Ibach,55 - 60 Jahre,27,15,12
False,8337059,Ibach,60 - 65 Jahre,24,10,14
False,8337059,Ibach,65 - 75 Jahre,37,17,20
False,8337059,Ibach,75 und mehr Jahre,21,7,14
False,8337059,Ibach,Insgesamt,400,191,209
False,8337060,Jestetten,unter 3 Jahre,150,74,76
False,8337060,Jestetten,3 -  6 Jahre,194,98,96
False,8337060,Jestetten,6 - 10 Jahre,257,135,122
False,8337060,Jestetten,10 - 15 Jahre,310,163,147
False,8337060,Jestetten,15 - 18 Jahre,160,80,80
False,8337060,Jestetten,18 - 20 Jahre,88,46,42
False,8337060,Jestetten,20 - 25 Jahre,270,135,135
False,8337060,Jestetten,25 - 30 Jahre,390,185,205
False,8337060,Jestetten,30 - 35 Jahre,458,238,220
False,8337060,Jestetten,35 - 40 Jahre,379,190,189
False,8337060,Jestetten,40 - 45 Jahre,305,149,156
False,8337060,Jestetten,45 - 50 Jahre,273,127,146
False,8337060,Jestetten,50 - 55 Jahre,296,148,148
False,8337060,Jestetten,55 - 60 Jahre,368,192,176
False,8337060,Jestetten,60 - 65 Jahre,261,126,135
False,8337060,Jestetten,65 - 75 Jahre,427,183,244
False,8337060,Jestetten,75 und mehr Jahre,357,102,255
False,8337060,Jestetten,Insgesamt,4943,2371,2572
False,8337062,Klettgau,unter 3 Jahre,268,130,138
False,8337062,Klettgau,3 -  6 Jahre,291,153,138
False,8337062,Klettgau,6 - 10 Jahre,366,201,165
False,8337062,Klettgau,10 - 15 Jahre,491,235,256
False,8337062,Klettgau,15 - 18 Jahre,252,127,125
False,8337062,Klettgau,18 - 20 Jahre,148,75,73
False,8337062,Klettgau,20 - 25 Jahre,410,213,197
False,8337062,Klettgau,25 - 30 Jahre,668,340,328
False,8337062,Klettgau,30 - 35 Jahre,665,347,318
False,8337062,Klettgau,35 - 40 Jahre,574,304,270
False,8337062,Klettgau,40 - 45 Jahre,514,276,238
False,8337062,Klettgau,45 - 50 Jahre,407,227,180
False,8337062,Klettgau,50 - 55 Jahre,367,174,193
False,8337062,Klettgau,55 - 60 Jahre,474,243,231
False,8337062,Klettgau,60 - 65 Jahre,341,172,169
False,8337062,Klettgau,65 - 75 Jahre,639,268,371
False,8337062,Klettgau,75 und mehr Jahre,403,129,274
False,8337062,Klettgau,Insgesamt,7278,3614,3664
False,8337065,Lauchringen,unter 3 Jahre,258,125,133
False,8337065,Lauchringen,3 -  6 Jahre,252,123,129
False,8337065,Lauchringen,6 - 10 Jahre,334,166,168
False,8337065,Lauchringen,10 - 15 Jahre,439,223,216
False,8337065,Lauchringen,15 - 18 Jahre,258,138,120
False,8337065,Lauchringen,18 - 20 Jahre,175,91,84
False,8337065,Lauchringen,20 - 25 Jahre,459,233,226
False,8337065,Lauchringen,25 - 30 Jahre,590,285,305
False,8337065,Lauchringen,30 - 35 Jahre,590,307,283
False,8337065,Lauchringen,35 - 40 Jahre,549,286,263
False,8337065,Lauchringen,40 - 45 Jahre,526,244,282
False,8337065,Lauchringen,45 - 50 Jahre,446,235,211
False,8337065,Lauchringen,50 - 55 Jahre,439,226,213
False,8337065,Lauchringen,55 - 60 Jahre,480,251,229
False,8337065,Lauchringen,60 - 65 Jahre,345,182,163
False,8337065,Lauchringen,65 - 75 Jahre,573,247,326
False,8337065,Lauchringen,75 und mehr Jahre,332,99,233
False,8337065,Lauchringen,Insgesamt,7045,3461,3584
False,8337066,"Laufenburg (Baden), Stadt",unter 3 Jahre,288,144,144
False,8337066,"Laufenburg (Baden), Stadt",3 -  6 Jahre,342,174,168
False,8337066,"Laufenburg (Baden), Stadt",6 - 10 Jahre,462,234,228
False,8337066,"Laufenburg (Baden), Stadt",10 - 15 Jahre,536,274,262
False,8337066,"Laufenburg (Baden), Stadt",15 - 18 Jahre,301,151,150
False,8337066,"Laufenburg (Baden), Stadt",18 - 20 Jahre,170,86,84
False,8337066,"Laufenburg (Baden), Stadt",20 - 25 Jahre,487,253,234
False,8337066,"Laufenburg (Baden), Stadt",25 - 30 Jahre,643,315,328
False,8337066,"Laufenburg (Baden), Stadt",30 - 35 Jahre,734,356,378
False,8337066,"Laufenburg (Baden), Stadt",35 - 40 Jahre,695,354,341
False,8337066,"Laufenburg (Baden), Stadt",40 - 45 Jahre,569,292,277
False,8337066,"Laufenburg (Baden), Stadt",45 - 50 Jahre,503,252,251
False,8337066,"Laufenburg (Baden), Stadt",50 - 55 Jahre,466,242,224
False,8337066,"Laufenburg (Baden), Stadt",55 - 60 Jahre,518,268,250
False,8337066,"Laufenburg (Baden), Stadt",60 - 65 Jahre,441,226,215
False,8337066,"Laufenburg (Baden), Stadt",65 - 75 Jahre,706,298,408
False,8337066,"Laufenburg (Baden), Stadt",75 und mehr Jahre,464,140,324
False,8337066,"Laufenburg (Baden), Stadt",Insgesamt,8325,4059,4266
False,8337070,Lottstetten,unter 3 Jahre,101,47,54
False,8337070,Lottstetten,3 -  6 Jahre,96,59,37
False,8337070,Lottstetten,6 - 10 Jahre,92,46,46
False,8337070,Lottstetten,10 - 15 Jahre,141,72,69
False,8337070,Lottstetten,15 - 18 Jahre,71,37,34
False,8337070,Lottstetten,18 - 20 Jahre,45,23,22
False,8337070,Lottstetten,20 - 25 Jahre,116,58,58
False,8337070,Lottstetten,25 - 30 Jahre,197,101,96
False,8337070,Lottstetten,30 - 35 Jahre,242,122,120
False,8337070,Lottstetten,35 - 40 Jahre,190,101,89
False,8337070,Lottstetten,40 - 45 Jahre,143,76,67
False,8337070,Lottstetten,45 - 50 Jahre,128,60,68
False,8337070,Lottstetten,50 - 55 Jahre,143,70,73
False,8337070,Lottstetten,55 - 60 Jahre,156,81,75
False,8337070,Lottstetten,60 - 65 Jahre,108,50,58
False,8337070,Lottstetten,65 - 75 Jahre,151,70,81
False,8337070,Lottstetten,75 und mehr Jahre,110,23,87
False,8337070,Lottstetten,Insgesamt,2230,1096,1134
False,8337076,Murg,unter 3 Jahre,247,127,120
False,8337076,Murg,3 -  6 Jahre,285,141,144
False,8337076,Murg,6 - 10 Jahre,369,184,185
False,8337076,Murg,10 - 15 Jahre,419,214,205
False,8337076,Murg,15 - 18 Jahre,250,131,119
False,8337076,Murg,18 - 20 Jahre,140,73,67
False,8337076,Murg,20 - 25 Jahre,428,207,221
False,8337076,Murg,25 - 30 Jahre,558,283,275
False,8337076,Murg,30 - 35 Jahre,606,292,314
False,8337076,Murg,35 - 40 Jahre,509,265,244
False,8337076,Murg,40 - 45 Jahre,510,264,246
False,8337076,Murg,45 - 50 Jahre,390,202,188
False,8337076,Murg,50 - 55 Jahre,348,179,169
False,8337076,Murg,55 - 60 Jahre,444,225,219
False,8337076,Murg,60 - 65 Jahre,366,180,186
False,8337076,Murg,65 - 75 Jahre,551,236,315
False,8337076,Murg,75 und mehr Jahre,383,116,267
False,8337076,Murg,Insgesamt,6803,3319,3484
False,8337090,Rickenbach,unter 3 Jahre,138,70,68
False,8337090,Rickenbach,3 -  6 Jahre,158,75,83
False,8337090,Rickenbach,6 - 10 Jahre,220,130,90
False,8337090,Rickenbach,10 - 15 Jahre,283,161,122
False,8337090,Rickenbach,15 - 18 Jahre,155,80,75
False,8337090,Rickenbach,18 - 20 Jahre,105,56,49
False,8337090,Rickenbach,20 - 25 Jahre,245,118,127
False,8337090,Rickenbach,25 - 30 Jahre,292,156,136
False,8337090,Rickenbach,30 - 35 Jahre,344,156,188
False,8337090,Rickenbach,35 - 40 Jahre,325,168,157
False,8337090,Rickenbach,40 - 45 Jahre,242,135,107
False,8337090,Rickenbach,45 - 50 Jahre,214,113,101
False,8337090,Rickenbach,50 - 55 Jahre,196,94,102
False,8337090,Rickenbach,55 - 60 Jahre,280,142,138
False,8337090,Rickenbach,60 - 65 Jahre,218,110,108
False,8337090,Rickenbach,65 - 75 Jahre,307,130,177
False,8337090,Rickenbach,75 und mehr Jahre,203,72,131
False,8337090,Rickenbach,Insgesamt,3925,1966,1959
False,8337096,"Bad Säckingen, Stadt",unter 3 Jahre,489,277,212
False,8337096,"Bad Säckingen, Stadt",3 -  6 Jahre,512,258,254
False,8337096,"Bad Säckingen, Stadt",6 - 10 Jahre,683,335,348
False,8337096,"Bad Säckingen, Stadt",10 - 15 Jahre,837,437,400
False,8337096,"Bad Säckingen, Stadt",15 - 18 Jahre,426,212,214
False,8337096,"Bad Säckingen, Stadt",18 - 20 Jahre,292,144,148
False,8337096,"Bad Säckingen, Stadt",20 - 25 Jahre,918,417,501
False,8337096,"Bad Säckingen, Stadt",25 - 30 Jahre,1264,646,618
False,8337096,"Bad Säckingen, Stadt",30 - 35 Jahre,1221,626,595
False,8337096,"Bad Säckingen, Stadt",35 - 40 Jahre,1105,529,576
False,8337096,"Bad Säckingen, Stadt",40 - 45 Jahre,1040,509,531
False,8337096,"Bad Säckingen, Stadt",45 - 50 Jahre,983,485,498
False,8337096,"Bad Säckingen, Stadt",50 - 55 Jahre,977,509,468
False,8337096,"Bad Säckingen, Stadt",55 - 60 Jahre,1162,545,617
False,8337096,"Bad Säckingen, Stadt",60 - 65 Jahre,933,437,496
False,8337096,"Bad Säckingen, Stadt",65 - 75 Jahre,1615,612,1003
False,8337096,"Bad Säckingen, Stadt",75 und mehr Jahre,1294,372,922
False,8337096,"Bad Säckingen, Stadt",Insgesamt,15751,7350,8401
False,8337097,"St. Blasien, Stadt",unter 3 Jahre,95,45,50
False,8337097,"St. Blasien, Stadt",3 -  6 Jahre,111,58,53
False,8337097,"St. Blasien, Stadt",6 - 10 Jahre,176,84,92
False,8337097,"St. Blasien, Stadt",10 - 15 Jahre,285,156,129
False,8337097,"St. Blasien, Stadt",15 - 18 Jahre,290,158,132
False,8337097,"St. Blasien, Stadt",18 - 20 Jahre,156,81,75
False,8337097,"St. Blasien, Stadt",20 - 25 Jahre,347,204,143
False,8337097,"St. Blasien, Stadt",25 - 30 Jahre,402,274,128
False,8337097,"St. Blasien, Stadt",30 - 35 Jahre,268,118,150
False,8337097,"St. Blasien, Stadt",35 - 40 Jahre,308,158,150
False,8337097,"St. Blasien, Stadt",40 - 45 Jahre,275,130,145
False,8337097,"St. Blasien, Stadt",45 - 50 Jahre,275,145,130
False,8337097,"St. Blasien, Stadt",50 - 55 Jahre,213,102,111
False,8337097,"St. Blasien, Stadt",55 - 60 Jahre,308,146,162
False,8337097,"St. Blasien, Stadt",60 - 65 Jahre,209,106,103
False,8337097,"St. Blasien, Stadt",65 - 75 Jahre,375,169,206
False,8337097,"St. Blasien, Stadt",75 und mehr Jahre,313,92,221
False,8337097,"St. Blasien, Stadt",Insgesamt,4406,2226,2180
False,8337106,"Stühlingen, Stadt",unter 3 Jahre,196,98,98
False,8337106,"Stühlingen, Stadt",3 -  6 Jahre,213,105,108
False,8337106,"Stühlingen, Stadt",6 - 10 Jahre,316,166,150
False,8337106,"Stühlingen, Stadt",10 - 15 Jahre,340,179,161
False,8337106,"Stühlingen, Stadt",15 - 18 Jahre,186,103,83
False,8337106,"Stühlingen, Stadt",18 - 20 Jahre,132,67,65
False,8337106,"Stühlingen, Stadt",20 - 25 Jahre,310,166,144
False,8337106,"Stühlingen, Stadt",25 - 30 Jahre,410,208,202
False,8337106,"Stühlingen, Stadt",30 - 35 Jahre,502,248,254
False,8337106,"Stühlingen, Stadt",35 - 40 Jahre,451,238,213
False,8337106,"Stühlingen, Stadt",40 - 45 Jahre,356,201,155
False,8337106,"Stühlingen, Stadt",45 - 50 Jahre,317,169,148
False,8337106,"Stühlingen, Stadt",50 - 55 Jahre,238,129,109
False,8337106,"Stühlingen, Stadt",55 - 60 Jahre,343,178,165
False,8337106,"Stühlingen, Stadt",60 - 65 Jahre,245,129,116
False,8337106,"Stühlingen, Stadt",65 - 75 Jahre,501,213,288
False,8337106,"Stühlingen, Stadt",75 und mehr Jahre,306,98,208
False,8337106,"Stühlingen, Stadt",Insgesamt,5362,2695,2667
False,8337108,Todtmoos,unter 3 Jahre,56,31,25
False,8337108,Todtmoos,3 -  6 Jahre,76,36,40
False,8337108,Todtmoos,6 - 10 Jahre,129,64,65
False,8337108,Todtmoos,10 - 15 Jahre,122,57,65
False,8337108,Todtmoos,15 - 18 Jahre,81,34,47
False,8337108,Todtmoos,18 - 20 Jahre,41,25,16
False,8337108,Todtmoos,20 - 25 Jahre,121,64,57
False,8337108,Todtmoos,25 - 30 Jahre,147,62,85
False,8337108,Todtmoos,30 - 35 Jahre,234,114,120
False,8337108,Todtmoos,35 - 40 Jahre,178,93,85
False,8337108,Todtmoos,40 - 45 Jahre,168,72,96
False,8337108,Todtmoos,45 - 50 Jahre,148,71,77
False,8337108,Todtmoos,50 - 55 Jahre,119,60,59
False,8337108,Todtmoos,55 - 60 Jahre,139,61,78
False,8337108,Todtmoos,60 - 65 Jahre,123,56,67
False,8337108,Todtmoos,65 - 75 Jahre,219,87,132
False,8337108,Todtmoos,75 und mehr Jahre,127,43,84
False,8337108,Todtmoos,Insgesamt,2228,1030,1198
False,8337116,"Wehr, Stadt",unter 3 Jahre,491,250,241
False,8337116,"Wehr, Stadt",3 -  6 Jahre,504,247,257
False,8337116,"Wehr, Stadt",6 - 10 Jahre,723,349,374
False,8337116,"Wehr, Stadt",10 - 15 Jahre,724,351,373
False,8337116,"Wehr, Stadt",15 - 18 Jahre,433,220,213
False,8337116,"Wehr, Stadt",18 - 20 Jahre,244,116,128
False,8337116,"Wehr, Stadt",20 - 25 Jahre,768,369,399
False,8337116,"Wehr, Stadt",25 - 30 Jahre,1043,526,517
False,8337116,"Wehr, Stadt",30 - 35 Jahre,1215,619,596
False,8337116,"Wehr, Stadt",35 - 40 Jahre,1046,529,517
False,8337116,"Wehr, Stadt",40 - 45 Jahre,922,461,461
False,8337116,"Wehr, Stadt",45 - 50 Jahre,761,386,375
False,8337116,"Wehr, Stadt",50 - 55 Jahre,796,388,408
False,8337116,"Wehr, Stadt",55 - 60 Jahre,984,497,487
False,8337116,"Wehr, Stadt",60 - 65 Jahre,727,369,358
False,8337116,"Wehr, Stadt",65 - 75 Jahre,1144,484,660
False,8337116,"Wehr, Stadt",75 und mehr Jahre,791,238,553
False,8337116,"Wehr, Stadt",Insgesamt,13316,6399,6917
False,8337118,Weilheim,unter 3 Jahre,147,74,73
False,8337118,Weilheim,3 -  6 Jahre,139,67,72
False,8337118,Weilheim,6 - 10 Jahre,175,93,82
False,8337118,Weilheim,10 - 15 Jahre,211,105,106
False,8337118,Weilheim,15 - 18 Jahre,94,36,58
False,8337118,Weilheim,18 - 20 Jahre,45,27,18
False,8337118,Weilheim,20 - 25 Jahre,143,69,74
False,8337118,Weilheim,25 - 30 Jahre,251,120,131
False,8337118,Weilheim,30 - 35 Jahre,343,166,177
False,8337118,Weilheim,35 - 40 Jahre,275,156,119
False,8337118,Weilheim,40 - 45 Jahre,190,104,86
False,8337118,Weilheim,45 - 50 Jahre,152,84,68
False,8337118,Weilheim,50 - 55 Jahre,134,75,59
False,8337118,Weilheim,55 - 60 Jahre,186,85,101
False,8337118,Weilheim,60 - 65 Jahre,143,73,70
False,8337118,Weilheim,65 - 75 Jahre,206,98,108
False,8337118,Weilheim,75 und mehr Jahre,125,39,86
False,8337118,Weilheim,Insgesamt,2959,1471,1488
False,8337123,Wutöschingen,unter 3 Jahre,241,127,114
False,8337123,Wutöschingen,3 -  6 Jahre,262,132,130
False,8337123,Wutöschingen,6 - 10 Jahre,317,159,158
False,8337123,Wutöschingen,10 - 15 Jahre,399,202,197
False,8337123,Wutöschingen,15 - 18 Jahre,249,118,131
False,8337123,Wutöschingen,18 - 20 Jahre,159,82,77
False,8337123,Wutöschingen,20 - 25 Jahre,411,221,190
False,8337123,Wutöschingen,25 - 30 Jahre,610,323,287
False,8337123,Wutöschingen,30 - 35 Jahre,603,330,273
False,8337123,Wutöschingen,35 - 40 Jahre,485,237,248
False,8337123,Wutöschingen,40 - 45 Jahre,437,222,215
False,8337123,Wutöschingen,45 - 50 Jahre,397,207,190
False,8337123,Wutöschingen,50 - 55 Jahre,347,187,160
False,8337123,Wutöschingen,55 - 60 Jahre,447,245,202
False,8337123,Wutöschingen,60 - 65 Jahre,311,159,152
False,8337123,Wutöschingen,65 - 75 Jahre,448,193,255
False,8337123,Wutöschingen,75 und mehr Jahre,301,99,202
False,8337123,Wutöschingen,Insgesamt,6424,3243,3181
False,8337124,Eggingen,unter 3 Jahre,71,37,34
False,8337124,Eggingen,3 -  6 Jahre,79,37,42
False,8337124,Eggingen,6 - 10 Jahre,95,58,37
False,8337124,Eggingen,10 - 15 Jahre,101,41,60
False,8337124,Eggingen,15 - 18 Jahre,61,33,28
False,8337124,Eggingen,18 - 20 Jahre,45,19,26
False,8337124,Eggingen,20 - 25 Jahre,81,39,42
False,8337124,Eggingen,25 - 30 Jahre,168,84,84
False,8337124,Eggingen,30 - 35 Jahre,139,78,61
False,8337124,Eggingen,35 - 40 Jahre,135,71,64
False,8337124,Eggingen,40 - 45 Jahre,106,59,47
False,8337124,Eggingen,45 - 50 Jahre,101,47,54
False,8337124,Eggingen,50 - 55 Jahre,79,44,35
False,8337124,Eggingen,55 - 60 Jahre,90,49,41
False,8337124,Eggingen,60 - 65 Jahre,71,34,37
False,8337124,Eggingen,65 - 75 Jahre,117,54,63
False,8337124,Eggingen,75 und mehr Jahre,91,29,62
False,8337124,Eggingen,Insgesamt,1630,813,817
False,8337125,Küssaberg,unter 3 Jahre,183,89,94
False,8337125,Küssaberg,3 -  6 Jahre,188,86,102
False,8337125,Küssaberg,6 - 10 Jahre,270,160,110
False,8337125,Küssaberg,10 - 15 Jahre,301,157,144
False,8337125,Küssaberg,15 - 18 Jahre,164,91,73
False,8337125,Küssaberg,18 - 20 Jahre,95,50,45
False,8337125,Küssaberg,20 - 25 Jahre,305,143,162
False,8337125,Küssaberg,25 - 30 Jahre,490,227,263
False,8337125,Küssaberg,30 - 35 Jahre,539,297,242
False,8337125,Küssaberg,35 - 40 Jahre,461,250,211
False,8337125,Küssaberg,40 - 45 Jahre,352,173,179
False,8337125,Küssaberg,45 - 50 Jahre,327,149,178
False,8337125,Küssaberg,50 - 55 Jahre,301,156,145
False,8337125,Küssaberg,55 - 60 Jahre,353,192,161
False,8337125,Küssaberg,60 - 65 Jahre,257,121,136
False,8337125,Küssaberg,65 - 75 Jahre,455,200,255
False,8337125,Küssaberg,75 und mehr Jahre,265,94,171
False,8337125,Küssaberg,Insgesamt,5306,2635,2671
False,8337126,"Waldshut-Tiengen, Stadt",unter 3 Jahre,712,378,334
False,8337126,"Waldshut-Tiengen, Stadt",3 -  6 Jahre,727,376,351
False,8337126,"Waldshut-Tiengen, Stadt",6 - 10 Jahre,1011,524,487
False,8337126,"Waldshut-Tiengen, Stadt",10 - 15 Jahre,1256,652,604
False,8337126,"Waldshut-Tiengen, Stadt",15 - 18 Jahre,714,368,346
False,8337126,"Waldshut-Tiengen, Stadt",18 - 20 Jahre,446,235,211
False,8337126,"Waldshut-Tiengen, Stadt",20 - 25 Jahre,1311,664,647
False,8337126,"Waldshut-Tiengen, Stadt",25 - 30 Jahre,1689,852,837
False,8337126,"Waldshut-Tiengen, Stadt",30 - 35 Jahre,1811,946,865
False,8337126,"Waldshut-Tiengen, Stadt",35 - 40 Jahre,1614,844,770
False,8337126,"Waldshut-Tiengen, Stadt",40 - 45 Jahre,1588,773,815
False,8337126,"Waldshut-Tiengen, Stadt",45 - 50 Jahre,1387,728,659
False,8337126,"Waldshut-Tiengen, Stadt",50 - 55 Jahre,1228,628,600
False,8337126,"Waldshut-Tiengen, Stadt",55 - 60 Jahre,1477,731,746
False,8337126,"Waldshut-Tiengen, Stadt",60 - 65 Jahre,1187,562,625
False,8337126,"Waldshut-Tiengen, Stadt",65 - 75 Jahre,2200,880,1320
False,8337126,"Waldshut-Tiengen, Stadt",75 und mehr Jahre,1782,524,1258
False,8337126,"Waldshut-Tiengen, Stadt",Insgesamt,22140,10665,11475
False,8337127,Wutach,unter 3 Jahre,44,25,19
False,8337127,Wutach,3 -  6 Jahre,47,20,27
False,8337127,Wutach,6 - 10 Jahre,66,32,34
False,8337127,Wutach,10 - 15 Jahre,74,40,34
False,8337127,Wutach,15 - 18 Jahre,50,27,23
False,8337127,Wutach,18 - 20 Jahre,24,12,12
False,8337127,Wutach,20 - 25 Jahre,78,37,41
False,8337127,Wutach,25 - 30 Jahre,88,55,33
False,8337127,Wutach,30 - 35 Jahre,99,58,41
False,8337127,Wutach,35 - 40 Jahre,84,48,36
False,8337127,Wutach,40 - 45 Jahre,70,40,30
False,8337127,Wutach,45 - 50 Jahre,61,32,29
False,8337127,Wutach,50 - 55 Jahre,45,20,25
False,8337127,Wutach,55 - 60 Jahre,93,48,45
False,8337127,Wutach,60 - 65 Jahre,76,42,34
False,8337127,Wutach,65 - 75 Jahre,108,50,58
False,8337127,Wutach,75 und mehr Jahre,72,20,52
False,8337127,Wutach,Insgesamt,1179,606,573
False,8337128,Ühlingen-Birkendorf,unter 3 Jahre,182,97,85
False,8337128,Ühlingen-Birkendorf,3 -  6 Jahre,237,138,99
False,8337128,Ühlingen-Birkendorf,6 - 10 Jahre,296,146,150
False,8337128,Ühlingen-Birkendorf,10 - 15 Jahre,335,174,161
False,8337128,Ühlingen-Birkendorf,15 - 18 Jahre,169,90,79
False,8337128,Ühlingen-Birkendorf,18 - 20 Jahre,108,63,45
False,8337128,Ühlingen-Birkendorf,20 - 25 Jahre,286,151,135
False,8337128,Ühlingen-Birkendorf,25 - 30 Jahre,388,181,207
False,8337128,Ühlingen-Birkendorf,30 - 35 Jahre,427,221,206
False,8337128,Ühlingen-Birkendorf,35 - 40 Jahre,377,207,170
False,8337128,Ühlingen-Birkendorf,40 - 45 Jahre,300,155,145
False,8337128,Ühlingen-Birkendorf,45 - 50 Jahre,271,149,122
False,8337128,Ühlingen-Birkendorf,50 - 55 Jahre,235,129,106
False,8337128,Ühlingen-Birkendorf,55 - 60 Jahre,316,148,168
False,8337128,Ühlingen-Birkendorf,60 - 65 Jahre,242,128,114
False,8337128,Ühlingen-Birkendorf,65 - 75 Jahre,443,172,271
False,8337128,Ühlingen-Birkendorf,75 und mehr Jahre,348,127,221
False,8337128,Ühlingen-Birkendorf,Insgesamt,4960,2476,2484
False,84,Regierungsbezirk Tübingen,unter 3 Jahre,61047,31321,29726
False,84,Regierungsbezirk Tübingen,3 -  6 Jahre,65901,33764,32137
False,84,Regierungsbezirk Tübingen,6 - 10 Jahre,86423,44450,41973
False,84,Regierungsbezirk Tübingen,10 - 15 Jahre,99933,51404,48529
False,84,Regierungsbezirk Tübingen,15 - 18 Jahre,57619,29658,27961
False,84,Regierungsbezirk Tübingen,18 - 20 Jahre,38048,19627,18421
False,84,Regierungsbezirk Tübingen,20 - 25 Jahre,110027,55960,54067
False,84,Regierungsbezirk Tübingen,25 - 30 Jahre,149347,77558,71789
False,84,Regierungsbezirk Tübingen,30 - 35 Jahre,157629,82087,75542
False,84,Regierungsbezirk Tübingen,35 - 40 Jahre,137965,71171,66794
False,84,Regierungsbezirk Tübingen,40 - 45 Jahre,116912,59341,57571
False,84,Regierungsbezirk Tübingen,45 - 50 Jahre,102480,52760,49720
False,84,Regierungsbezirk Tübingen,50 - 55 Jahre,96092,48851,47241
False,84,Regierungsbezirk Tübingen,55 - 60 Jahre,115945,58236,57709
False,84,Regierungsbezirk Tübingen,60 - 65 Jahre,84811,41760,43051
False,84,Regierungsbezirk Tübingen,65 - 75 Jahre,141086,58691,82395
False,84,Regierungsbezirk Tübingen,75 und mehr Jahre,104319,31415,72904
False,84,Regierungsbezirk Tübingen,Insgesamt,1725584,848054,877530
False,8415,Landkreis Reutlingen,unter 3 Jahre,9353,4798,4555
False,8415,Landkreis Reutlingen,3 -  6 Jahre,10034,5093,4941
False,8415,Landkreis Reutlingen,6 - 10 Jahre,12862,6556,6306
False,8415,Landkreis Reutlingen,10 - 15 Jahre,14904,7701,7203
False,8415,Landkreis Reutlingen,15 - 18 Jahre,8474,4324,4150
False,8415,Landkreis Reutlingen,18 - 20 Jahre,5788,2983,2805
False,8415,Landkreis Reutlingen,20 - 25 Jahre,16983,8619,8364
False,8415,Landkreis Reutlingen,25 - 30 Jahre,23414,12038,11376
False,8415,Landkreis Reutlingen,30 - 35 Jahre,24742,12767,11975
False,8415,Landkreis Reutlingen,35 - 40 Jahre,21857,11341,10516
False,8415,Landkreis Reutlingen,40 - 45 Jahre,18344,9265,9079
False,8415,Landkreis Reutlingen,45 - 50 Jahre,16043,8142,7901
False,8415,Landkreis Reutlingen,50 - 55 Jahre,15636,7842,7794
False,8415,Landkreis Reutlingen,55 - 60 Jahre,19231,9558,9673
False,8415,Landkreis Reutlingen,60 - 65 Jahre,14514,7119,7395
False,8415,Landkreis Reutlingen,65 - 75 Jahre,22804,9474,13330
False,8415,Landkreis Reutlingen,75 und mehr Jahre,17074,4987,12087
False,8415,Landkreis Reutlingen,Insgesamt,272057,132607,139450
False,8415014,Dettingen an der Erms,unter 3 Jahre,310,157,153
False,8415014,Dettingen an der Erms,3 -  6 Jahre,321,158,163
False,8415014,Dettingen an der Erms,6 - 10 Jahre,427,222,205
False,8415014,Dettingen an der Erms,10 - 15 Jahre,505,276,229
False,8415014,Dettingen an der Erms,15 - 18 Jahre,295,162,133
False,8415014,Dettingen an der Erms,18 - 20 Jahre,191,91,100
False,8415014,Dettingen an der Erms,20 - 25 Jahre,562,277,285
False,8415014,Dettingen an der Erms,25 - 30 Jahre,822,416,406
False,8415014,Dettingen an der Erms,30 - 35 Jahre,825,428,397
False,8415014,Dettingen an der Erms,35 - 40 Jahre,731,384,347
False,8415014,Dettingen an der Erms,40 - 45 Jahre,560,302,258
False,8415014,Dettingen an der Erms,45 - 50 Jahre,518,267,251
False,8415014,Dettingen an der Erms,50 - 55 Jahre,552,285,267
False,8415014,Dettingen an der Erms,55 - 60 Jahre,635,315,320
False,8415014,Dettingen an der Erms,60 - 65 Jahre,511,242,269
False,8415014,Dettingen an der Erms,65 - 75 Jahre,737,307,430
False,8415014,Dettingen an der Erms,75 und mehr Jahre,578,146,432
False,8415014,Dettingen an der Erms,Insgesamt,9080,4435,4645
False,8415019,Eningen unter Achalm,unter 3 Jahre,319,147,172
False,8415019,Eningen unter Achalm,3 -  6 Jahre,290,153,137
False,8415019,Eningen unter Achalm,6 - 10 Jahre,441,207,234
False,8415019,Eningen unter Achalm,10 - 15 Jahre,536,279,257
False,8415019,Eningen unter Achalm,15 - 18 Jahre,279,134,145
False,8415019,Eningen unter Achalm,18 - 20 Jahre,201,113,88
False,8415019,Eningen unter Achalm,20 - 25 Jahre,587,314,273
False,8415019,Eningen unter Achalm,25 - 30 Jahre,886,440,446
False,8415019,Eningen unter Achalm,30 - 35 Jahre,882,459,423
False,8415019,Eningen unter Achalm,35 - 40 Jahre,772,414,358
False,8415019,Eningen unter Achalm,40 - 45 Jahre,687,346,341
False,8415019,Eningen unter Achalm,45 - 50 Jahre,680,338,342
False,8415019,Eningen unter Achalm,50 - 55 Jahre,617,328,289
False,8415019,Eningen unter Achalm,55 - 60 Jahre,772,381,391
False,8415019,Eningen unter Achalm,60 - 65 Jahre,527,260,267
False,8415019,Eningen unter Achalm,65 - 75 Jahre,888,390,498
False,8415019,Eningen unter Achalm,75 und mehr Jahre,668,189,479
False,8415019,Eningen unter Achalm,Insgesamt,10032,4892,5140
False,8415027,Gomadingen,unter 3 Jahre,76,39,37
False,8415027,Gomadingen,3 -  6 Jahre,86,42,44
False,8415027,Gomadingen,6 - 10 Jahre,91,45,46
False,8415027,Gomadingen,10 - 15 Jahre,93,50,43
False,8415027,Gomadingen,15 - 18 Jahre,60,38,22
False,8415027,Gomadingen,18 - 20 Jahre,52,27,25
False,8415027,Gomadingen,20 - 25 Jahre,136,62,74
False,8415027,Gomadingen,25 - 30 Jahre,197,106,91
False,8415027,Gomadingen,30 - 35 Jahre,189,96,93
False,8415027,Gomadingen,35 - 40 Jahre,184,108,76
False,8415027,Gomadingen,40 - 45 Jahre,141,79,62
False,8415027,Gomadingen,45 - 50 Jahre,112,65,47
False,8415027,Gomadingen,50 - 55 Jahre,114,66,48
False,8415027,Gomadingen,55 - 60 Jahre,148,74,74
False,8415027,Gomadingen,60 - 65 Jahre,109,56,53
False,8415027,Gomadingen,65 - 75 Jahre,213,99,114
False,8415027,Gomadingen,75 und mehr Jahre,126,44,82
False,8415027,Gomadingen,Insgesamt,2127,1096,1031
False,8415028,Grabenstetten,unter 3 Jahre,41,20,21
False,8415028,Grabenstetten,3 -  6 Jahre,59,35,24
False,8415028,Grabenstetten,6 - 10 Jahre,93,50,43
False,8415028,Grabenstetten,10 - 15 Jahre,98,60,38
False,8415028,Grabenstetten,15 - 18 Jahre,45,26,19
False,8415028,Grabenstetten,18 - 20 Jahre,31,22,9
False,8415028,Grabenstetten,20 - 25 Jahre,89,50,39
False,8415028,Grabenstetten,25 - 30 Jahre,99,53,46
False,8415028,Grabenstetten,30 - 35 Jahre,112,53,59
False,8415028,Grabenstetten,35 - 40 Jahre,130,61,69
False,8415028,Grabenstetten,40 - 45 Jahre,131,67,64
False,8415028,Grabenstetten,45 - 50 Jahre,96,62,34
False,8415028,Grabenstetten,50 - 55 Jahre,53,26,27
False,8415028,Grabenstetten,55 - 60 Jahre,96,43,53
False,8415028,Grabenstetten,60 - 65 Jahre,74,42,32
False,8415028,Grabenstetten,65 - 75 Jahre,136,62,74
False,8415028,Grabenstetten,75 und mehr Jahre,75,26,49
False,8415028,Grabenstetten,Insgesamt,1458,758,700
False,8415029,Grafenberg,unter 3 Jahre,85,44,41
False,8415029,Grafenberg,3 -  6 Jahre,91,40,51
False,8415029,Grafenberg,6 - 10 Jahre,143,86,57
False,8415029,Grafenberg,10 - 15 Jahre,142,79,63
False,8415029,Grafenberg,15 - 18 Jahre,75,40,35
False,8415029,Grafenberg,18 - 20 Jahre,53,26,27
False,8415029,Grafenberg,20 - 25 Jahre,140,73,67
False,8415029,Grafenberg,25 - 30 Jahre,245,130,115
False,8415029,Grafenberg,30 - 35 Jahre,215,110,105
False,8415029,Grafenberg,35 - 40 Jahre,214,103,111
False,8415029,Grafenberg,40 - 45 Jahre,185,98,87
False,8415029,Grafenberg,45 - 50 Jahre,163,83,80
False,8415029,Grafenberg,50 - 55 Jahre,139,76,63
False,8415029,Grafenberg,55 - 60 Jahre,185,92,93
False,8415029,Grafenberg,60 - 65 Jahre,126,69,57
False,8415029,Grafenberg,65 - 75 Jahre,158,78,80
False,8415029,Grafenberg,75 und mehr Jahre,120,39,81
False,8415029,Grafenberg,Insgesamt,2479,1266,1213
False,8415034,"Hayingen, Stadt",unter 3 Jahre,76,44,32
False,8415034,"Hayingen, Stadt",3 -  6 Jahre,92,46,46
False,8415034,"Hayingen, Stadt",6 - 10 Jahre,117,67,50
False,8415034,"Hayingen, Stadt",10 - 15 Jahre,148,59,89
False,8415034,"Hayingen, Stadt",15 - 18 Jahre,84,48,36
False,8415034,"Hayingen, Stadt",18 - 20 Jahre,42,22,20
False,8415034,"Hayingen, Stadt",20 - 25 Jahre,166,91,75
False,8415034,"Hayingen, Stadt",25 - 30 Jahre,170,96,74
False,8415034,"Hayingen, Stadt",30 - 35 Jahre,199,101,98
False,8415034,"Hayingen, Stadt",35 - 40 Jahre,154,90,64
False,8415034,"Hayingen, Stadt",40 - 45 Jahre,121,60,61
False,8415034,"Hayingen, Stadt",45 - 50 Jahre,130,69,61
False,8415034,"Hayingen, Stadt",50 - 55 Jahre,111,62,49
False,8415034,"Hayingen, Stadt",55 - 60 Jahre,151,81,70
False,8415034,"Hayingen, Stadt",60 - 65 Jahre,113,58,55
False,8415034,"Hayingen, Stadt",65 - 75 Jahre,168,68,100
False,8415034,"Hayingen, Stadt",75 und mehr Jahre,122,44,78
False,8415034,"Hayingen, Stadt",Insgesamt,2164,1106,1058
False,8415039,Hülben,unter 3 Jahre,119,64,55
False,8415039,Hülben,3 -  6 Jahre,127,57,70
False,8415039,Hülben,6 - 10 Jahre,139,66,73
False,8415039,Hülben,10 - 15 Jahre,143,72,71
False,8415039,Hülben,15 - 18 Jahre,90,55,35
False,8415039,Hülben,18 - 20 Jahre,47,17,30
False,8415039,Hülben,20 - 25 Jahre,176,85,91
False,8415039,Hülben,25 - 30 Jahre,254,127,127
False,8415039,Hülben,30 - 35 Jahre,272,150,122
False,8415039,Hülben,35 - 40 Jahre,228,114,114
False,8415039,Hülben,40 - 45 Jahre,171,93,78
False,8415039,Hülben,45 - 50 Jahre,162,81,81
False,8415039,Hülben,50 - 55 Jahre,151,80,71
False,8415039,Hülben,55 - 60 Jahre,190,85,105
False,8415039,Hülben,60 - 65 Jahre,176,81,95
False,8415039,Hülben,65 - 75 Jahre,290,126,164
False,8415039,Hülben,75 und mehr Jahre,158,45,113
False,8415039,Hülben,Insgesamt,2893,1398,1495
False,8415048,Mehrstetten,unter 3 Jahre,50,30,20
False,8415048,Mehrstetten,3 -  6 Jahre,63,33,30
False,8415048,Mehrstetten,6 - 10 Jahre,89,45,44
False,8415048,Mehrstetten,10 - 15 Jahre,115,66,49
False,8415048,Mehrstetten,15 - 18 Jahre,51,24,27
False,8415048,Mehrstetten,18 - 20 Jahre,34,19,15
False,8415048,Mehrstetten,20 - 25 Jahre,82,42,40
False,8415048,Mehrstetten,25 - 30 Jahre,109,59,50
False,8415048,Mehrstetten,30 - 35 Jahre,137,81,56
False,8415048,Mehrstetten,35 - 40 Jahre,110,56,54
False,8415048,Mehrstetten,40 - 45 Jahre,114,53,61
False,8415048,Mehrstetten,45 - 50 Jahre,77,47,30
False,8415048,Mehrstetten,50 - 55 Jahre,58,27,31
False,8415048,Mehrstetten,55 - 60 Jahre,68,34,34
False,8415048,Mehrstetten,60 - 65 Jahre,59,30,29
False,8415048,Mehrstetten,65 - 75 Jahre,109,44,65
False,8415048,Mehrstetten,75 und mehr Jahre,67,23,44
False,8415048,Mehrstetten,Insgesamt,1392,713,679
False,8415050,"Metzingen, Stadt",unter 3 Jahre,715,348,367
False,8415050,"Metzingen, Stadt",3 -  6 Jahre,741,371,370
False,8415050,"Metzingen, Stadt",6 - 10 Jahre,997,492,505
False,8415050,"Metzingen, Stadt",10 - 15 Jahre,1111,577,534
False,8415050,"Metzingen, Stadt",15 - 18 Jahre,652,339,313
False,8415050,"Metzingen, Stadt",18 - 20 Jahre,467,243,224
False,8415050,"Metzingen, Stadt",20 - 25 Jahre,1381,695,686
False,8415050,"Metzingen, Stadt",25 - 30 Jahre,1787,941,846
False,8415050,"Metzingen, Stadt",30 - 35 Jahre,1804,968,836
False,8415050,"Metzingen, Stadt",35 - 40 Jahre,1630,803,827
False,8415050,"Metzingen, Stadt",40 - 45 Jahre,1394,679,715
False,8415050,"Metzingen, Stadt",45 - 50 Jahre,1252,608,644
False,8415050,"Metzingen, Stadt",50 - 55 Jahre,1271,642,629
False,8415050,"Metzingen, Stadt",55 - 60 Jahre,1668,812,856
False,8415050,"Metzingen, Stadt",60 - 65 Jahre,1271,667,604
False,8415050,"Metzingen, Stadt",65 - 75 Jahre,1817,761,1056
False,8415050,"Metzingen, Stadt",75 und mehr Jahre,1489,431,1058
False,8415050,"Metzingen, Stadt",Insgesamt,21447,10377,11070
False,8415053,"Münsingen, Stadt",unter 3 Jahre,467,232,235
False,8415053,"Münsingen, Stadt",3 -  6 Jahre,542,274,268
False,8415053,"Münsingen, Stadt",6 - 10 Jahre,752,372,380
False,8415053,"Münsingen, Stadt",10 - 15 Jahre,919,473,446
False,8415053,"Münsingen, Stadt",15 - 18 Jahre,495,264,231
False,8415053,"Münsingen, Stadt",18 - 20 Jahre,295,150,145
False,8415053,"Münsingen, Stadt",20 - 25 Jahre,785,411,374
False,8415053,"Münsingen, Stadt",25 - 30 Jahre,1127,619,508
False,8415053,"Münsingen, Stadt",30 - 35 Jahre,1205,635,570
False,8415053,"Münsingen, Stadt",35 - 40 Jahre,1073,556,517
False,8415053,"Münsingen, Stadt",40 - 45 Jahre,895,459,436
False,8415053,"Münsingen, Stadt",45 - 50 Jahre,751,385,366
False,8415053,"Münsingen, Stadt",50 - 55 Jahre,667,322,345
False,8415053,"Münsingen, Stadt",55 - 60 Jahre,967,494,473
False,8415053,"Münsingen, Stadt",60 - 65 Jahre,719,317,402
False,8415053,"Münsingen, Stadt",65 - 75 Jahre,1132,466,666
False,8415053,"Münsingen, Stadt",75 und mehr Jahre,890,264,626
False,8415053,"Münsingen, Stadt",Insgesamt,13681,6693,6988
False,8415058,Pfronstetten,unter 3 Jahre,70,42,28
False,8415058,Pfronstetten,3 -  6 Jahre,81,44,37
False,8415058,Pfronstetten,6 - 10 Jahre,109,63,46
False,8415058,Pfronstetten,10 - 15 Jahre,108,59,49
False,8415058,Pfronstetten,15 - 18 Jahre,70,34,36
False,8415058,Pfronstetten,18 - 20 Jahre,41,22,19
False,8415058,Pfronstetten,20 - 25 Jahre,107,56,51
False,8415058,Pfronstetten,25 - 30 Jahre,135,58,77
False,8415058,Pfronstetten,30 - 35 Jahre,145,81,64
False,8415058,Pfronstetten,35 - 40 Jahre,118,70,48
False,8415058,Pfronstetten,40 - 45 Jahre,108,61,47
False,8415058,Pfronstetten,45 - 50 Jahre,64,40,24
False,8415058,Pfronstetten,50 - 55 Jahre,57,27,30
False,8415058,Pfronstetten,55 - 60 Jahre,92,43,49
False,8415058,Pfronstetten,60 - 65 Jahre,59,37,22
False,8415058,Pfronstetten,65 - 75 Jahre,148,53,95
False,8415058,Pfronstetten,75 und mehr Jahre,90,31,59
False,8415058,Pfronstetten,Insgesamt,1602,821,781
False,8415059,"Pfullingen, Stadt",unter 3 Jahre,600,299,301
False,8415059,"Pfullingen, Stadt",3 -  6 Jahre,604,298,306
False,8415059,"Pfullingen, Stadt",6 - 10 Jahre,738,363,375
False,8415059,"Pfullingen, Stadt",10 - 15 Jahre,880,480,400
False,8415059,"Pfullingen, Stadt",15 - 18 Jahre,512,262,250
False,8415059,"Pfullingen, Stadt",18 - 20 Jahre,354,174,180
False,8415059,"Pfullingen, Stadt",20 - 25 Jahre,1033,526,507
False,8415059,"Pfullingen, Stadt",25 - 30 Jahre,1528,762,766
False,8415059,"Pfullingen, Stadt",30 - 35 Jahre,1619,851,768
False,8415059,"Pfullingen, Stadt",35 - 40 Jahre,1427,721,706
False,8415059,"Pfullingen, Stadt",40 - 45 Jahre,1123,546,577
False,8415059,"Pfullingen, Stadt",45 - 50 Jahre,1045,519,526
False,8415059,"Pfullingen, Stadt",50 - 55 Jahre,1085,525,560
False,8415059,"Pfullingen, Stadt",55 - 60 Jahre,1285,638,647
False,8415059,"Pfullingen, Stadt",60 - 65 Jahre,960,465,495
False,8415059,"Pfullingen, Stadt",65 - 75 Jahre,1508,616,892
False,8415059,"Pfullingen, Stadt",75 und mehr Jahre,1178,327,851
False,8415059,"Pfullingen, Stadt",Insgesamt,17479,8372,9107
False,8415060,Pliezhausen,unter 3 Jahre,320,156,164
False,8415060,Pliezhausen,3 -  6 Jahre,386,186,200
False,8415060,Pliezhausen,6 - 10 Jahre,466,250,216
False,8415060,Pliezhausen,10 - 15 Jahre,550,307,243
False,8415060,Pliezhausen,15 - 18 Jahre,300,152,148
False,8415060,Pliezhausen,18 - 20 Jahre,166,91,75
False,8415060,Pliezhausen,20 - 25 Jahre,484,232,252
False,8415060,Pliezhausen,25 - 30 Jahre,719,357,362
False,8415060,Pliezhausen,30 - 35 Jahre,871,432,439
False,8415060,Pliezhausen,35 - 40 Jahre,731,372,359
False,8415060,Pliezhausen,40 - 45 Jahre,622,325,297
False,8415060,Pliezhausen,45 - 50 Jahre,567,300,267
False,8415060,Pliezhausen,50 - 55 Jahre,517,271,246
False,8415060,Pliezhausen,55 - 60 Jahre,595,306,289
False,8415060,Pliezhausen,60 - 65 Jahre,378,190,188
False,8415060,Pliezhausen,65 - 75 Jahre,570,239,331
False,8415060,Pliezhausen,75 und mehr Jahre,365,110,255
False,8415060,Pliezhausen,Insgesamt,8607,4276,4331
False,8415061,"Reutlingen, Stadt",unter 3 Jahre,3408,1780,1628
False,8415061,"Reutlingen, Stadt",3 -  6 Jahre,3686,1895,1791
False,8415061,"Reutlingen, Stadt",6 - 10 Jahre,4648,2420,2228
False,8415061,"Reutlingen, Stadt",10 - 15 Jahre,5566,2836,2730
False,8415061,"Reutlingen, Stadt",15 - 18 Jahre,3236,1631,1605
False,8415061,"Reutlingen, Stadt",18 - 20 Jahre,2288,1140,1148
False,8415061,"Reutlingen, Stadt",20 - 25 Jahre,7040,3545,3495
False,8415061,"Reutlingen, Stadt",25 - 30 Jahre,9479,4890,4589
False,8415061,"Reutlingen, Stadt",30 - 35 Jahre,9897,5041,4856
False,8415061,"Reutlingen, Stadt",35 - 40 Jahre,8658,4465,4193
False,8415061,"Reutlingen, Stadt",40 - 45 Jahre,7330,3672,3658
False,8415061,"Reutlingen, Stadt",45 - 50 Jahre,6372,3144,3228
False,8415061,"Reutlingen, Stadt",50 - 55 Jahre,6591,3268,3323
False,8415061,"Reutlingen, Stadt",55 - 60 Jahre,7776,3870,3906
False,8415061,"Reutlingen, Stadt",60 - 65 Jahre,5746,2768,2978
False,8415061,"Reutlingen, Stadt",65 - 75 Jahre,9419,3876,5543
False,8415061,"Reutlingen, Stadt",75 und mehr Jahre,7425,2145,5280
False,8415061,"Reutlingen, Stadt",Insgesamt,108565,52386,56179
False,8415062,Riederich,unter 3 Jahre,134,74,60
False,8415062,Riederich,3 -  6 Jahre,135,69,66
False,8415062,Riederich,6 - 10 Jahre,223,108,115
False,8415062,Riederich,10 - 15 Jahre,224,127,97
False,8415062,Riederich,15 - 18 Jahre,127,70,57
False,8415062,Riederich,18 - 20 Jahre,102,50,52
False,8415062,Riederich,20 - 25 Jahre,258,148,110
False,8415062,Riederich,25 - 30 Jahre,379,199,180
False,8415062,Riederich,30 - 35 Jahre,400,210,190
False,8415062,Riederich,35 - 40 Jahre,353,174,179
False,8415062,Riederich,40 - 45 Jahre,312,146,166
False,8415062,Riederich,45 - 50 Jahre,310,169,141
False,8415062,Riederich,50 - 55 Jahre,308,149,159
False,8415062,Riederich,55 - 60 Jahre,331,168,163
False,8415062,Riederich,60 - 65 Jahre,257,134,123
False,8415062,Riederich,65 - 75 Jahre,273,121,152
False,8415062,Riederich,75 und mehr Jahre,168,52,116
False,8415062,Riederich,Insgesamt,4294,2168,2126
False,8415073,"Trochtelfingen, Stadt",unter 3 Jahre,284,147,137
False,8415073,"Trochtelfingen, Stadt",3 -  6 Jahre,292,143,149
False,8415073,"Trochtelfingen, Stadt",6 - 10 Jahre,346,174,172
False,8415073,"Trochtelfingen, Stadt",10 - 15 Jahre,368,173,195
False,8415073,"Trochtelfingen, Stadt",15 - 18 Jahre,234,121,113
False,8415073,"Trochtelfingen, Stadt",18 - 20 Jahre,158,89,69
False,8415073,"Trochtelfingen, Stadt",20 - 25 Jahre,418,226,192
False,8415073,"Trochtelfingen, Stadt",25 - 30 Jahre,537,286,251
False,8415073,"Trochtelfingen, Stadt",30 - 35 Jahre,577,311,266
False,8415073,"Trochtelfingen, Stadt",35 - 40 Jahre,510,280,230
False,8415073,"Trochtelfingen, Stadt",40 - 45 Jahre,436,213,223
False,8415073,"Trochtelfingen, Stadt",45 - 50 Jahre,374,186,188
False,8415073,"Trochtelfingen, Stadt",50 - 55 Jahre,332,172,160
False,8415073,"Trochtelfingen, Stadt",55 - 60 Jahre,380,198,182
False,8415073,"Trochtelfingen, Stadt",60 - 65 Jahre,320,154,166
False,8415073,"Trochtelfingen, Stadt",65 - 75 Jahre,507,205,302
False,8415073,"Trochtelfingen, Stadt",75 und mehr Jahre,302,95,207
False,8415073,"Trochtelfingen, Stadt",Insgesamt,6375,3173,3202
False,8415078,"Bad Urach, Stadt",unter 3 Jahre,447,231,216
False,8415078,"Bad Urach, Stadt",3 -  6 Jahre,490,242,248
False,8415078,"Bad Urach, Stadt",6 - 10 Jahre,602,306,296
False,8415078,"Bad Urach, Stadt",10 - 15 Jahre,644,315,329
False,8415078,"Bad Urach, Stadt",15 - 18 Jahre,395,200,195
False,8415078,"Bad Urach, Stadt",18 - 20 Jahre,251,136,115
False,8415078,"Bad Urach, Stadt",20 - 25 Jahre,800,391,409
False,8415078,"Bad Urach, Stadt",25 - 30 Jahre,1021,525,496
False,8415078,"Bad Urach, Stadt",30 - 35 Jahre,1084,538,546
False,8415078,"Bad Urach, Stadt",35 - 40 Jahre,921,495,426
False,8415078,"Bad Urach, Stadt",40 - 45 Jahre,807,398,409
False,8415078,"Bad Urach, Stadt",45 - 50 Jahre,748,399,349
False,8415078,"Bad Urach, Stadt",50 - 55 Jahre,699,356,343
False,8415078,"Bad Urach, Stadt",55 - 60 Jahre,866,417,449
False,8415078,"Bad Urach, Stadt",60 - 65 Jahre,742,367,375
False,8415078,"Bad Urach, Stadt",65 - 75 Jahre,1127,450,677
False,8415078,"Bad Urach, Stadt",75 und mehr Jahre,867,259,608
False,8415078,"Bad Urach, Stadt",Insgesamt,12511,6025,6486
False,8415080,Wannweil,unter 3 Jahre,209,118,91
False,8415080,Wannweil,3 -  6 Jahre,197,91,106
False,8415080,Wannweil,6 - 10 Jahre,219,108,111
False,8415080,Wannweil,10 - 15 Jahre,253,139,114
False,8415080,Wannweil,15 - 18 Jahre,134,63,71
False,8415080,Wannweil,18 - 20 Jahre,113,61,52
False,8415080,Wannweil,20 - 25 Jahre,272,147,125
False,8415080,Wannweil,25 - 30 Jahre,449,220,229
False,8415080,Wannweil,30 - 35 Jahre,513,252,261
False,8415080,Wannweil,35 - 40 Jahre,471,258,213
False,8415080,Wannweil,40 - 45 Jahre,370,195,175
False,8415080,Wannweil,45 - 50 Jahre,289,151,138
False,8415080,Wannweil,50 - 55 Jahre,274,142,132
False,8415080,Wannweil,55 - 60 Jahre,346,171,175
False,8415080,Wannweil,60 - 65 Jahre,247,123,124
False,8415080,Wannweil,65 - 75 Jahre,459,196,263
False,8415080,Wannweil,75 und mehr Jahre,307,97,210
False,8415080,Wannweil,Insgesamt,5122,2532,2590
False,8415085,Zwiefalten,unter 3 Jahre,76,37,39
False,8415085,Zwiefalten,3 -  6 Jahre,101,51,50
False,8415085,Zwiefalten,6 - 10 Jahre,103,53,50
False,8415085,Zwiefalten,10 - 15 Jahre,127,78,49
False,8415085,Zwiefalten,15 - 18 Jahre,77,32,45
False,8415085,Zwiefalten,18 - 20 Jahre,58,32,26
False,8415085,Zwiefalten,20 - 25 Jahre,143,75,68
False,8415085,Zwiefalten,25 - 30 Jahre,168,85,83
False,8415085,Zwiefalten,30 - 35 Jahre,214,120,94
False,8415085,Zwiefalten,35 - 40 Jahre,150,75,75
False,8415085,Zwiefalten,40 - 45 Jahre,149,80,69
False,8415085,Zwiefalten,45 - 50 Jahre,112,68,44
False,8415085,Zwiefalten,50 - 55 Jahre,101,49,52
False,8415085,Zwiefalten,55 - 60 Jahre,162,79,83
False,8415085,Zwiefalten,60 - 65 Jahre,155,73,82
False,8415085,Zwiefalten,65 - 75 Jahre,220,82,138
False,8415085,Zwiefalten,75 und mehr Jahre,157,57,100
False,8415085,Zwiefalten,Insgesamt,2273,1126,1147
False,8415086,Gutsbezirk Münsingen,unter 3 Jahre,5,3,2
False,8415086,Gutsbezirk Münsingen,3 -  6 Jahre,5,2,3
False,8415086,Gutsbezirk Münsingen,6 - 10 Jahre,13,5,8
False,8415086,Gutsbezirk Münsingen,10 - 15 Jahre,10,4,6
False,8415086,Gutsbezirk Münsingen,15 - 18 Jahre,5,2,3
False,8415086,Gutsbezirk Münsingen,18 - 20 Jahre,6,1,5
False,8415086,Gutsbezirk Münsingen,20 - 25 Jahre,23,10,13
False,8415086,Gutsbezirk Münsingen,25 - 30 Jahre,41,20,21
False,8415086,Gutsbezirk Münsingen,30 - 35 Jahre,39,28,11
False,8415086,Gutsbezirk Münsingen,35 - 40 Jahre,24,15,9
False,8415086,Gutsbezirk Münsingen,40 - 45 Jahre,3,1,2
False,8415086,Gutsbezirk Münsingen,45 - 50 Jahre,13,7,6
False,8415086,Gutsbezirk Münsingen,50 - 55 Jahre,9,4,5
False,8415086,Gutsbezirk Münsingen,55 - 60 Jahre,12,7,5
False,8415086,Gutsbezirk Münsingen,60 - 65 Jahre,9,6,3
False,8415086,Gutsbezirk Münsingen,65 - 75 Jahre,11,5,6
False,8415086,Gutsbezirk Münsingen,75 und mehr Jahre,12,3,9
False,8415086,Gutsbezirk Münsingen,Insgesamt,240,123,117
False,8415087,Walddorfhäslach,unter 3 Jahre,205,101,104
False,8415087,Walddorfhäslach,3 -  6 Jahre,219,113,106
False,8415087,Walddorfhäslach,6 - 10 Jahre,259,125,134
False,8415087,Walddorfhäslach,10 - 15 Jahre,306,158,148
False,8415087,Walddorfhäslach,15 - 18 Jahre,151,73,78
False,8415087,Walddorfhäslach,18 - 20 Jahre,102,63,39
False,8415087,Walddorfhäslach,20 - 25 Jahre,274,129,145
False,8415087,Walddorfhäslach,25 - 30 Jahre,383,182,201
False,8415087,Walddorfhäslach,30 - 35 Jahre,465,256,209
False,8415087,Walddorfhäslach,35 - 40 Jahre,431,223,208
False,8415087,Walddorfhäslach,40 - 45 Jahre,370,187,183
False,8415087,Walddorfhäslach,45 - 50 Jahre,287,150,137
False,8415087,Walddorfhäslach,50 - 55 Jahre,241,125,116
False,8415087,Walddorfhäslach,55 - 60 Jahre,248,134,114
False,8415087,Walddorfhäslach,60 - 65 Jahre,192,106,86
False,8415087,Walddorfhäslach,65 - 75 Jahre,234,97,137
False,8415087,Walddorfhäslach,75 und mehr Jahre,154,42,112
False,8415087,Walddorfhäslach,Insgesamt,4521,2264,2257
False,8415088,Römerstein,unter 3 Jahre,148,63,85
False,8415088,Römerstein,3 -  6 Jahre,152,73,79
False,8415088,Römerstein,6 - 10 Jahre,197,90,107
False,8415088,Römerstein,10 - 15 Jahre,223,103,120
False,8415088,Römerstein,15 - 18 Jahre,129,62,67
False,8415088,Römerstein,18 - 20 Jahre,80,45,35
False,8415088,Römerstein,20 - 25 Jahre,246,138,108
False,8415088,Römerstein,25 - 30 Jahre,331,176,155
False,8415088,Römerstein,30 - 35 Jahre,309,151,158
False,8415088,Römerstein,35 - 40 Jahre,289,160,129
False,8415088,Römerstein,40 - 45 Jahre,235,124,111
False,8415088,Römerstein,45 - 50 Jahre,234,124,110
False,8415088,Römerstein,50 - 55 Jahre,172,86,86
False,8415088,Römerstein,55 - 60 Jahre,271,124,147
False,8415088,Römerstein,60 - 65 Jahre,193,95,98
False,8415088,Römerstein,65 - 75 Jahre,342,151,191
False,8415088,Römerstein,75 und mehr Jahre,208,48,160
False,8415088,Römerstein,Insgesamt,3759,1813,1946
False,8415089,Engstingen,unter 3 Jahre,210,107,103
False,8415089,Engstingen,3 -  6 Jahre,226,118,108
False,8415089,Engstingen,6 - 10 Jahre,301,146,155
False,8415089,Engstingen,10 - 15 Jahre,298,150,148
False,8415089,Engstingen,15 - 18 Jahre,139,73,66
False,8415089,Engstingen,18 - 20 Jahre,105,50,55
False,8415089,Engstingen,20 - 25 Jahre,261,128,133
False,8415089,Engstingen,25 - 30 Jahre,433,243,190
False,8415089,Engstingen,30 - 35 Jahre,468,238,230
False,8415089,Engstingen,35 - 40 Jahre,431,220,211
False,8415089,Engstingen,40 - 45 Jahre,341,171,170
False,8415089,Engstingen,45 - 50 Jahre,273,142,131
False,8415089,Engstingen,50 - 55 Jahre,243,128,115
False,8415089,Engstingen,55 - 60 Jahre,303,144,159
False,8415089,Engstingen,60 - 65 Jahre,252,130,122
False,8415089,Engstingen,65 - 75 Jahre,357,144,213
False,8415089,Engstingen,75 und mehr Jahre,230,63,167
False,8415089,Engstingen,Insgesamt,4871,2395,2476
False,8415090,Hohenstein,unter 3 Jahre,183,95,88
False,8415090,Hohenstein,3 -  6 Jahre,162,88,74
False,8415090,Hohenstein,6 - 10 Jahre,176,88,88
False,8415090,Hohenstein,10 - 15 Jahre,217,102,115
False,8415090,Hohenstein,15 - 18 Jahre,122,59,63
False,8415090,Hohenstein,18 - 20 Jahre,98,52,46
False,8415090,Hohenstein,20 - 25 Jahre,257,139,118
False,8415090,Hohenstein,25 - 30 Jahre,285,146,139
False,8415090,Hohenstein,30 - 35 Jahre,327,182,145
False,8415090,Hohenstein,35 - 40 Jahre,280,137,143
False,8415090,Hohenstein,40 - 45 Jahre,222,107,115
False,8415090,Hohenstein,45 - 50 Jahre,190,109,81
False,8415090,Hohenstein,50 - 55 Jahre,145,66,79
False,8415090,Hohenstein,55 - 60 Jahre,213,106,107
False,8415090,Hohenstein,60 - 65 Jahre,184,99,85
False,8415090,Hohenstein,65 - 75 Jahre,308,128,180
False,8415090,Hohenstein,75 und mehr Jahre,136,47,89
False,8415090,Hohenstein,Insgesamt,3505,1750,1755
False,8415091,Sonnenbühl,unter 3 Jahre,264,135,129
False,8415091,Sonnenbühl,3 -  6 Jahre,269,148,121
False,8415091,Sonnenbühl,6 - 10 Jahre,374,187,187
False,8415091,Sonnenbühl,10 - 15 Jahre,378,203,175
False,8415091,Sonnenbühl,15 - 18 Jahre,226,113,113
False,8415091,Sonnenbühl,18 - 20 Jahre,141,85,56
False,8415091,Sonnenbühl,20 - 25 Jahre,441,217,224
False,8415091,Sonnenbühl,25 - 30 Jahre,627,314,313
False,8415091,Sonnenbühl,30 - 35 Jahre,634,328,306
False,8415091,Sonnenbühl,35 - 40 Jahre,552,283,269
False,8415091,Sonnenbühl,40 - 45 Jahre,449,253,196
False,8415091,Sonnenbühl,45 - 50 Jahre,427,219,208
False,8415091,Sonnenbühl,50 - 55 Jahre,323,164,159
False,8415091,Sonnenbühl,55 - 60 Jahre,481,251,230
False,8415091,Sonnenbühl,60 - 65 Jahre,387,174,213
False,8415091,Sonnenbühl,65 - 75 Jahre,473,214,259
False,8415091,Sonnenbühl,75 und mehr Jahre,325,88,237
False,8415091,Sonnenbühl,Insgesamt,6771,3376,3395
False,8415092,Lichtenstein,unter 3 Jahre,344,183,161
False,8415092,Lichtenstein,3 -  6 Jahre,400,200,200
False,8415092,Lichtenstein,6 - 10 Jahre,529,272,257
False,8415092,Lichtenstein,10 - 15 Jahre,622,312,310
False,8415092,Lichtenstein,15 - 18 Jahre,332,170,162
False,8415092,Lichtenstein,18 - 20 Jahre,213,108,105
False,8415092,Lichtenstein,20 - 25 Jahre,556,283,273
False,8415092,Lichtenstein,25 - 30 Jahre,803,393,410
False,8415092,Lichtenstein,30 - 35 Jahre,865,416,449
False,8415092,Lichtenstein,35 - 40 Jahre,856,475,381
False,8415092,Lichtenstein,40 - 45 Jahre,712,352,360
False,8415092,Lichtenstein,45 - 50 Jahre,513,272,241
False,8415092,Lichtenstein,50 - 55 Jahre,529,256,273
False,8415092,Lichtenstein,55 - 60 Jahre,651,323,328
False,8415092,Lichtenstein,60 - 65 Jahre,472,240,232
False,8415092,Lichtenstein,65 - 75 Jahre,746,307,439
False,8415092,Lichtenstein,75 und mehr Jahre,571,169,402
False,8415092,Lichtenstein,Insgesamt,9714,4731,4983
False,8415093,St. Johann,unter 3 Jahre,188,102,86
False,8415093,St. Johann,3 -  6 Jahre,217,123,94
False,8415093,St. Johann,6 - 10 Jahre,270,146,124
False,8415093,St. Johann,10 - 15 Jahre,320,164,156
False,8415093,St. Johann,15 - 18 Jahre,159,77,82
False,8415093,St. Johann,18 - 20 Jahre,99,54,45
False,8415093,St. Johann,20 - 25 Jahre,266,129,137
False,8415093,St. Johann,25 - 30 Jahre,400,195,205
False,8415093,St. Johann,30 - 35 Jahre,475,251,224
False,8415093,St. Johann,35 - 40 Jahre,429,229,200
False,8415093,St. Johann,40 - 45 Jahre,356,198,158
False,8415093,St. Johann,45 - 50 Jahre,284,138,146
False,8415093,St. Johann,50 - 55 Jahre,277,140,137
False,8415093,St. Johann,55 - 60 Jahre,339,168,171
False,8415093,St. Johann,60 - 65 Jahre,276,136,140
False,8415093,St. Johann,65 - 75 Jahre,454,189,265
False,8415093,St. Johann,75 und mehr Jahre,286,103,183
False,8415093,St. Johann,Insgesamt,5095,2542,2553
False,8416,Landkreis Tübingen,unter 3 Jahre,7222,3718,3504
False,8416,Landkreis Tübingen,3 -  6 Jahre,7553,3863,3690
False,8416,Landkreis Tübingen,6 - 10 Jahre,9975,5154,4821
False,8416,Landkreis Tübingen,10 - 15 Jahre,11459,5921,5538
False,8416,Landkreis Tübingen,15 - 18 Jahre,6325,3172,3153
False,8416,Landkreis Tübingen,18 - 20 Jahre,4108,2031,2077
False,8416,Landkreis Tübingen,20 - 25 Jahre,13579,6469,7110
False,8416,Landkreis Tübingen,25 - 30 Jahre,20888,10579,10309
False,8416,Landkreis Tübingen,30 - 35 Jahre,22804,11887,10917
False,8416,Landkreis Tübingen,35 - 40 Jahre,19283,10222,9061
False,8416,Landkreis Tübingen,40 - 45 Jahre,14660,7537,7123
False,8416,Landkreis Tübingen,45 - 50 Jahre,11559,6078,5481
False,8416,Landkreis Tübingen,50 - 55 Jahre,10170,5244,4926
False,8416,Landkreis Tübingen,55 - 60 Jahre,11925,5954,5971
False,8416,Landkreis Tübingen,60 - 65 Jahre,8598,4223,4375
False,8416,Landkreis Tübingen,65 - 75 Jahre,13828,5711,8117
False,8416,Landkreis Tübingen,75 und mehr Jahre,10032,2845,7187
False,8416,Landkreis Tübingen,Insgesamt,203968,100608,103360
False,8416006,Bodelshausen,unter 3 Jahre,189,107,82
False,8416006,Bodelshausen,3 -  6 Jahre,216,115,101
False,8416006,Bodelshausen,6 - 10 Jahre,305,179,126
False,8416006,Bodelshausen,10 - 15 Jahre,360,198,162
False,8416006,Bodelshausen,15 - 18 Jahre,230,115,115
False,8416006,Bodelshausen,18 - 20 Jahre,145,76,69
False,8416006,Bodelshausen,20 - 25 Jahre,390,189,201
False,8416006,Bodelshausen,25 - 30 Jahre,461,237,224
False,8416006,Bodelshausen,30 - 35 Jahre,479,254,225
False,8416006,Bodelshausen,35 - 40 Jahre,447,233,214
False,8416006,Bodelshausen,40 - 45 Jahre,414,194,220
False,8416006,Bodelshausen,45 - 50 Jahre,344,174,170
False,8416006,Bodelshausen,50 - 55 Jahre,327,168,159
False,8416006,Bodelshausen,55 - 60 Jahre,380,187,193
False,8416006,Bodelshausen,60 - 65 Jahre,283,154,129
False,8416006,Bodelshausen,65 - 75 Jahre,388,159,229
False,8416006,Bodelshausen,75 und mehr Jahre,255,86,169
False,8416006,Bodelshausen,Insgesamt,5613,2825,2788
False,8416009,Dettenhausen,unter 3 Jahre,181,95,86
False,8416009,Dettenhausen,3 -  6 Jahre,199,109,90
False,8416009,Dettenhausen,6 - 10 Jahre,263,145,118
False,8416009,Dettenhausen,10 - 15 Jahre,331,194,137
False,8416009,Dettenhausen,15 - 18 Jahre,187,78,109
False,8416009,Dettenhausen,18 - 20 Jahre,127,64,63
False,8416009,Dettenhausen,20 - 25 Jahre,283,149,134
False,8416009,Dettenhausen,25 - 30 Jahre,396,210,186
False,8416009,Dettenhausen,30 - 35 Jahre,436,229,207
False,8416009,Dettenhausen,35 - 40 Jahre,464,237,227
False,8416009,Dettenhausen,40 - 45 Jahre,362,190,172
False,8416009,Dettenhausen,45 - 50 Jahre,344,162,182
False,8416009,Dettenhausen,50 - 55 Jahre,379,200,179
False,8416009,Dettenhausen,55 - 60 Jahre,365,180,185
False,8416009,Dettenhausen,60 - 65 Jahre,226,121,105
False,8416009,Dettenhausen,65 - 75 Jahre,372,162,210
False,8416009,Dettenhausen,75 und mehr Jahre,194,54,140
False,8416009,Dettenhausen,Insgesamt,5109,2579,2530
False,8416011,Dußlingen,unter 3 Jahre,180,90,90
False,8416011,Dußlingen,3 -  6 Jahre,183,102,81
False,8416011,Dußlingen,6 - 10 Jahre,196,109,87
False,8416011,Dußlingen,10 - 15 Jahre,273,135,138
False,8416011,Dußlingen,15 - 18 Jahre,117,66,51
False,8416011,Dußlingen,18 - 20 Jahre,78,36,42
False,8416011,Dußlingen,20 - 25 Jahre,256,145,111
False,8416011,Dußlingen,25 - 30 Jahre,368,193,175
False,8416011,Dußlingen,30 - 35 Jahre,462,219,243
False,8416011,Dußlingen,35 - 40 Jahre,392,220,172
False,8416011,Dußlingen,40 - 45 Jahre,295,141,154
False,8416011,Dußlingen,45 - 50 Jahre,256,132,124
False,8416011,Dußlingen,50 - 55 Jahre,209,105,104
False,8416011,Dußlingen,55 - 60 Jahre,315,154,161
False,8416011,Dußlingen,60 - 65 Jahre,282,141,141
False,8416011,Dußlingen,65 - 75 Jahre,405,166,239
False,8416011,Dußlingen,75 und mehr Jahre,269,72,197
False,8416011,Dußlingen,Insgesamt,4536,2226,2310
False,8416015,Gomaringen,unter 3 Jahre,324,175,149
False,8416015,Gomaringen,3 -  6 Jahre,290,153,137
False,8416015,Gomaringen,6 - 10 Jahre,431,215,216
False,8416015,Gomaringen,10 - 15 Jahre,456,238,218
False,8416015,Gomaringen,15 - 18 Jahre,234,123,111
False,8416015,Gomaringen,18 - 20 Jahre,146,66,80
False,8416015,Gomaringen,20 - 25 Jahre,449,225,224
False,8416015,Gomaringen,25 - 30 Jahre,726,361,365
False,8416015,Gomaringen,30 - 35 Jahre,728,371,357
False,8416015,Gomaringen,35 - 40 Jahre,687,351,336
False,8416015,Gomaringen,40 - 45 Jahre,516,258,258
False,8416015,Gomaringen,45 - 50 Jahre,420,221,199
False,8416015,Gomaringen,50 - 55 Jahre,400,206,194
False,8416015,Gomaringen,55 - 60 Jahre,502,253,249
False,8416015,Gomaringen,60 - 65 Jahre,375,183,192
False,8416015,Gomaringen,65 - 75 Jahre,555,240,315
False,8416015,Gomaringen,75 und mehr Jahre,344,86,258
False,8416015,Gomaringen,Insgesamt,7583,3725,3858
False,8416018,Hirrlingen,unter 3 Jahre,121,61,60
False,8416018,Hirrlingen,3 -  6 Jahre,151,68,83
False,8416018,Hirrlingen,6 - 10 Jahre,172,86,86
False,8416018,Hirrlingen,10 - 15 Jahre,172,83,89
False,8416018,Hirrlingen,15 - 18 Jahre,94,50,44
False,8416018,Hirrlingen,18 - 20 Jahre,57,31,26
False,8416018,Hirrlingen,20 - 25 Jahre,170,88,82
False,8416018,Hirrlingen,25 - 30 Jahre,227,121,106
False,8416018,Hirrlingen,30 - 35 Jahre,269,150,119
False,8416018,Hirrlingen,35 - 40 Jahre,220,124,96
False,8416018,Hirrlingen,40 - 45 Jahre,202,101,101
False,8416018,Hirrlingen,45 - 50 Jahre,136,72,64
False,8416018,Hirrlingen,50 - 55 Jahre,91,52,39
False,8416018,Hirrlingen,55 - 60 Jahre,177,91,86
False,8416018,Hirrlingen,60 - 65 Jahre,113,61,52
False,8416018,Hirrlingen,65 - 75 Jahre,177,68,109
False,8416018,Hirrlingen,75 und mehr Jahre,90,32,58
False,8416018,Hirrlingen,Insgesamt,2639,1339,1300
False,8416022,Kirchentellinsfurt,unter 3 Jahre,171,93,78
False,8416022,Kirchentellinsfurt,3 -  6 Jahre,208,112,96
False,8416022,Kirchentellinsfurt,6 - 10 Jahre,240,133,107
False,8416022,Kirchentellinsfurt,10 - 15 Jahre,339,182,157
False,8416022,Kirchentellinsfurt,15 - 18 Jahre,144,73,71
False,8416022,Kirchentellinsfurt,18 - 20 Jahre,101,55,46
False,8416022,Kirchentellinsfurt,20 - 25 Jahre,275,134,141
False,8416022,Kirchentellinsfurt,25 - 30 Jahre,486,255,231
False,8416022,Kirchentellinsfurt,30 - 35 Jahre,538,272,266
False,8416022,Kirchentellinsfurt,35 - 40 Jahre,462,233,229
False,8416022,Kirchentellinsfurt,40 - 45 Jahre,427,220,207
False,8416022,Kirchentellinsfurt,45 - 50 Jahre,342,174,168
False,8416022,Kirchentellinsfurt,50 - 55 Jahre,335,180,155
False,8416022,Kirchentellinsfurt,55 - 60 Jahre,314,158,156
False,8416022,Kirchentellinsfurt,60 - 65 Jahre,260,125,135
False,8416022,Kirchentellinsfurt,65 - 75 Jahre,376,160,216
False,8416022,Kirchentellinsfurt,75 und mehr Jahre,236,66,170
False,8416022,Kirchentellinsfurt,Insgesamt,5254,2625,2629
False,8416023,Kusterdingen,unter 3 Jahre,344,187,157
False,8416023,Kusterdingen,3 -  6 Jahre,320,153,167
False,8416023,Kusterdingen,6 - 10 Jahre,417,211,206
False,8416023,Kusterdingen,10 - 15 Jahre,422,214,208
False,8416023,Kusterdingen,15 - 18 Jahre,218,109,109
False,8416023,Kusterdingen,18 - 20 Jahre,163,74,89
False,8416023,Kusterdingen,20 - 25 Jahre,468,244,224
False,8416023,Kusterdingen,25 - 30 Jahre,739,379,360
False,8416023,Kusterdingen,30 - 35 Jahre,818,393,425
False,8416023,Kusterdingen,35 - 40 Jahre,681,359,322
False,8416023,Kusterdingen,40 - 45 Jahre,598,328,270
False,8416023,Kusterdingen,45 - 50 Jahre,448,232,216
False,8416023,Kusterdingen,50 - 55 Jahre,386,186,200
False,8416023,Kusterdingen,55 - 60 Jahre,578,292,286
False,8416023,Kusterdingen,60 - 65 Jahre,356,181,175
False,8416023,Kusterdingen,65 - 75 Jahre,527,220,307
False,8416023,Kusterdingen,75 und mehr Jahre,324,86,238
False,8416023,Kusterdingen,Insgesamt,7807,3848,3959
False,8416025,"Mössingen, Stadt",unter 3 Jahre,660,336,324
False,8416025,"Mössingen, Stadt",3 -  6 Jahre,758,394,364
False,8416025,"Mössingen, Stadt",6 - 10 Jahre,1058,532,526
False,8416025,"Mössingen, Stadt",10 - 15 Jahre,1301,666,635
False,8416025,"Mössingen, Stadt",15 - 18 Jahre,769,376,393
False,8416025,"Mössingen, Stadt",18 - 20 Jahre,459,235,224
False,8416025,"Mössingen, Stadt",20 - 25 Jahre,1178,568,610
False,8416025,"Mössingen, Stadt",25 - 30 Jahre,1448,723,725
False,8416025,"Mössingen, Stadt",30 - 35 Jahre,1560,805,755
False,8416025,"Mössingen, Stadt",35 - 40 Jahre,1556,788,768
False,8416025,"Mössingen, Stadt",40 - 45 Jahre,1336,634,702
False,8416025,"Mössingen, Stadt",45 - 50 Jahre,1105,572,533
False,8416025,"Mössingen, Stadt",50 - 55 Jahre,975,525,450
False,8416025,"Mössingen, Stadt",55 - 60 Jahre,1194,593,601
False,8416025,"Mössingen, Stadt",60 - 65 Jahre,925,471,454
False,8416025,"Mössingen, Stadt",65 - 75 Jahre,1379,587,792
False,8416025,"Mössingen, Stadt",75 und mehr Jahre,959,292,667
False,8416025,"Mössingen, Stadt",Insgesamt,18620,9097,9523
False,8416026,Nehren,unter 3 Jahre,121,65,56
False,8416026,Nehren,3 -  6 Jahre,143,78,65
False,8416026,Nehren,6 - 10 Jahre,189,96,93
False,8416026,Nehren,10 - 15 Jahre,214,124,90
False,8416026,Nehren,15 - 18 Jahre,128,65,63
False,8416026,Nehren,18 - 20 Jahre,92,45,47
False,8416026,Nehren,20 - 25 Jahre,195,88,107
False,8416026,Nehren,25 - 30 Jahre,303,149,154
False,8416026,Nehren,30 - 35 Jahre,332,173,159
False,8416026,Nehren,35 - 40 Jahre,307,143,164
False,8416026,Nehren,40 - 45 Jahre,282,137,145
False,8416026,Nehren,45 - 50 Jahre,228,126,102
False,8416026,Nehren,50 - 55 Jahre,185,99,86
False,8416026,Nehren,55 - 60 Jahre,211,98,113
False,8416026,Nehren,60 - 65 Jahre,171,80,91
False,8416026,Nehren,65 - 75 Jahre,278,117,161
False,8416026,Nehren,75 und mehr Jahre,225,67,158
False,8416026,Nehren,Insgesamt,3604,1750,1854
False,8416031,Ofterdingen,unter 3 Jahre,127,72,55
False,8416031,Ofterdingen,3 -  6 Jahre,153,74,79
False,8416031,Ofterdingen,6 - 10 Jahre,209,96,113
False,8416031,Ofterdingen,10 - 15 Jahre,262,135,127
False,8416031,Ofterdingen,15 - 18 Jahre,161,80,81
False,8416031,Ofterdingen,18 - 20 Jahre,102,51,51
False,8416031,Ofterdingen,20 - 25 Jahre,238,107,131
False,8416031,Ofterdingen,25 - 30 Jahre,327,166,161
False,8416031,Ofterdingen,30 - 35 Jahre,405,217,188
False,8416031,Ofterdingen,35 - 40 Jahre,336,174,162
False,8416031,Ofterdingen,40 - 45 Jahre,323,164,159
False,8416031,Ofterdingen,45 - 50 Jahre,267,145,122
False,8416031,Ofterdingen,50 - 55 Jahre,203,111,92
False,8416031,Ofterdingen,55 - 60 Jahre,251,124,127
False,8416031,Ofterdingen,60 - 65 Jahre,206,105,101
False,8416031,Ofterdingen,65 - 75 Jahre,314,127,187
False,8416031,Ofterdingen,75 und mehr Jahre,158,46,112
False,8416031,Ofterdingen,Insgesamt,4042,1994,2048
False,8416036,"Rottenburg am Neckar, Stadt",unter 3 Jahre,1563,813,750
False,8416036,"Rottenburg am Neckar, Stadt",3 -  6 Jahre,1728,895,833
False,8416036,"Rottenburg am Neckar, Stadt",6 - 10 Jahre,2224,1139,1085
False,8416036,"Rottenburg am Neckar, Stadt",10 - 15 Jahre,2524,1339,1185
False,8416036,"Rottenburg am Neckar, Stadt",15 - 18 Jahre,1368,690,678
False,8416036,"Rottenburg am Neckar, Stadt",18 - 20 Jahre,841,437,404
False,8416036,"Rottenburg am Neckar, Stadt",20 - 25 Jahre,2401,1184,1217
False,8416036,"Rottenburg am Neckar, Stadt",25 - 30 Jahre,3348,1706,1642
False,8416036,"Rottenburg am Neckar, Stadt",30 - 35 Jahre,4039,2205,1834
False,8416036,"Rottenburg am Neckar, Stadt",35 - 40 Jahre,3649,1954,1695
False,8416036,"Rottenburg am Neckar, Stadt",40 - 45 Jahre,2800,1461,1339
False,8416036,"Rottenburg am Neckar, Stadt",45 - 50 Jahre,2249,1190,1059
False,8416036,"Rottenburg am Neckar, Stadt",50 - 55 Jahre,2073,1094,979
False,8416036,"Rottenburg am Neckar, Stadt",55 - 60 Jahre,2518,1319,1199
False,8416036,"Rottenburg am Neckar, Stadt",60 - 65 Jahre,1732,868,864
False,8416036,"Rottenburg am Neckar, Stadt",65 - 75 Jahre,2760,1150,1610
False,8416036,"Rottenburg am Neckar, Stadt",75 und mehr Jahre,1872,545,1327
False,8416036,"Rottenburg am Neckar, Stadt",Insgesamt,39689,19989,19700
False,8416041,"Tübingen, Universitätsstadt",unter 3 Jahre,2469,1226,1243
False,8416041,"Tübingen, Universitätsstadt",3 -  6 Jahre,2427,1235,1192
False,8416041,"Tübingen, Universitätsstadt",6 - 10 Jahre,3186,1649,1537
False,8416041,"Tübingen, Universitätsstadt",10 - 15 Jahre,3666,1820,1846
False,8416041,"Tübingen, Universitätsstadt",15 - 18 Jahre,2053,1035,1018
False,8416041,"Tübingen, Universitätsstadt",18 - 20 Jahre,1409,656,753
False,8416041,"Tübingen, Universitätsstadt",20 - 25 Jahre,6278,2831,3447
False,8416041,"Tübingen, Universitätsstadt",25 - 30 Jahre,10467,5282,5185
False,8416041,"Tübingen, Universitätsstadt",30 - 35 Jahre,10947,5712,5235
False,8416041,"Tübingen, Universitätsstadt",35 - 40 Jahre,8431,4520,3911
False,8416041,"Tübingen, Universitätsstadt",40 - 45 Jahre,5815,3052,2763
False,8416041,"Tübingen, Universitätsstadt",45 - 50 Jahre,4420,2330,2090
False,8416041,"Tübingen, Universitätsstadt",50 - 55 Jahre,3801,1889,1912
False,8416041,"Tübingen, Universitätsstadt",55 - 60 Jahre,4032,1950,2082
False,8416041,"Tübingen, Universitätsstadt",60 - 65 Jahre,2859,1330,1529
False,8416041,"Tübingen, Universitätsstadt",65 - 75 Jahre,5073,2027,3046
False,8416041,"Tübingen, Universitätsstadt",75 und mehr Jahre,4436,1231,3205
False,8416041,"Tübingen, Universitätsstadt",Insgesamt,81769,39775,41994
False,8416048,Ammerbuch,unter 3 Jahre,466,255,211
False,8416048,Ammerbuch,3 -  6 Jahre,463,224,239
False,8416048,Ammerbuch,6 - 10 Jahre,629,328,301
False,8416048,Ammerbuch,10 - 15 Jahre,682,364,318
False,8416048,Ammerbuch,15 - 18 Jahre,378,196,182
False,8416048,Ammerbuch,18 - 20 Jahre,225,111,114
False,8416048,Ammerbuch,20 - 25 Jahre,621,300,321
False,8416048,Ammerbuch,25 - 30 Jahre,1002,501,501
False,8416048,Ammerbuch,30 - 35 Jahre,1094,556,538
False,8416048,Ammerbuch,35 - 40 Jahre,1004,537,467
False,8416048,Ammerbuch,40 - 45 Jahre,776,372,404
False,8416048,Ammerbuch,45 - 50 Jahre,661,357,304
False,8416048,Ammerbuch,50 - 55 Jahre,544,292,252
False,8416048,Ammerbuch,55 - 60 Jahre,690,353,337
False,8416048,Ammerbuch,60 - 65 Jahre,475,229,246
False,8416048,Ammerbuch,65 - 75 Jahre,685,303,382
False,8416048,Ammerbuch,75 und mehr Jahre,402,97,305
False,8416048,Ammerbuch,Insgesamt,10797,5375,5422
False,8416049,Neustetten,unter 3 Jahre,145,62,83
False,8416049,Neustetten,3 -  6 Jahre,139,70,69
False,8416049,Neustetten,6 - 10 Jahre,205,110,95
False,8416049,Neustetten,10 - 15 Jahre,220,122,98
False,8416049,Neustetten,15 - 18 Jahre,126,57,69
False,8416049,Neustetten,18 - 20 Jahre,84,50,34
False,8416049,Neustetten,20 - 25 Jahre,182,96,86
False,8416049,Neustetten,25 - 30 Jahre,276,141,135
False,8416049,Neustetten,30 - 35 Jahre,308,148,160
False,8416049,Neustetten,35 - 40 Jahre,302,158,144
False,8416049,Neustetten,40 - 45 Jahre,262,154,108
False,8416049,Neustetten,45 - 50 Jahre,178,95,83
False,8416049,Neustetten,50 - 55 Jahre,124,65,59
False,8416049,Neustetten,55 - 60 Jahre,149,79,70
False,8416049,Neustetten,60 - 65 Jahre,118,62,56
False,8416049,Neustetten,65 - 75 Jahre,194,81,113
False,8416049,Neustetten,75 und mehr Jahre,113,29,84
False,8416049,Neustetten,Insgesamt,3125,1579,1546
False,8416050,Starzach,unter 3 Jahre,161,81,80
False,8416050,Starzach,3 -  6 Jahre,175,81,94
False,8416050,Starzach,6 - 10 Jahre,251,126,125
False,8416050,Starzach,10 - 15 Jahre,237,107,130
False,8416050,Starzach,15 - 18 Jahre,118,59,59
False,8416050,Starzach,18 - 20 Jahre,79,44,35
False,8416050,Starzach,20 - 25 Jahre,195,121,74
False,8416050,Starzach,25 - 30 Jahre,314,155,159
False,8416050,Starzach,30 - 35 Jahre,389,183,206
False,8416050,Starzach,35 - 40 Jahre,345,191,154
False,8416050,Starzach,40 - 45 Jahre,252,131,121
False,8416050,Starzach,45 - 50 Jahre,161,96,65
False,8416050,Starzach,50 - 55 Jahre,138,72,66
False,8416050,Starzach,55 - 60 Jahre,249,123,126
False,8416050,Starzach,60 - 65 Jahre,217,112,105
False,8416050,Starzach,65 - 75 Jahre,345,144,201
False,8416050,Starzach,75 und mehr Jahre,155,56,99
False,8416050,Starzach,Insgesamt,3781,1882,1899
False,8417,Landkreis Zollernalbkreis,unter 3 Jahre,6776,3444,3332
False,8417,Landkreis Zollernalbkreis,3 -  6 Jahre,7309,3761,3548
False,8417,Landkreis Zollernalbkreis,6 - 10 Jahre,9583,5007,4576
False,8417,Landkreis Zollernalbkreis,10 - 15 Jahre,10879,5582,5297
False,8417,Landkreis Zollernalbkreis,15 - 18 Jahre,6252,3281,2971
False,8417,Landkreis Zollernalbkreis,18 - 20 Jahre,4092,2121,1971
False,8417,Landkreis Zollernalbkreis,20 - 25 Jahre,11846,6183,5663
False,8417,Landkreis Zollernalbkreis,25 - 30 Jahre,15386,8023,7363
False,8417,Landkreis Zollernalbkreis,30 - 35 Jahre,16688,8702,7986
False,8417,Landkreis Zollernalbkreis,35 - 40 Jahre,15072,7797,7275
False,8417,Landkreis Zollernalbkreis,40 - 45 Jahre,12980,6575,6405
False,8417,Landkreis Zollernalbkreis,45 - 50 Jahre,11416,5827,5589
False,8417,Landkreis Zollernalbkreis,50 - 55 Jahre,10531,5273,5258
False,8417,Landkreis Zollernalbkreis,55 - 60 Jahre,13944,6920,7024
False,8417,Landkreis Zollernalbkreis,60 - 65 Jahre,10860,5299,5561
False,8417,Landkreis Zollernalbkreis,65 - 75 Jahre,17206,7122,10084
False,8417,Landkreis Zollernalbkreis,75 und mehr Jahre,12042,3447,8595
False,8417,Landkreis Zollernalbkreis,Insgesamt,192862,94364,98498
False,8417002,"Balingen, Stadt",unter 3 Jahre,1035,547,488
False,8417002,"Balingen, Stadt",3 -  6 Jahre,1131,591,540
False,8417002,"Balingen, Stadt",6 - 10 Jahre,1581,849,732
False,8417002,"Balingen, Stadt",10 - 15 Jahre,1833,924,909
False,8417002,"Balingen, Stadt",15 - 18 Jahre,1118,582,536
False,8417002,"Balingen, Stadt",18 - 20 Jahre,740,402,338
False,8417002,"Balingen, Stadt",20 - 25 Jahre,2011,1082,929
False,8417002,"Balingen, Stadt",25 - 30 Jahre,2593,1319,1274
False,8417002,"Balingen, Stadt",30 - 35 Jahre,2839,1492,1347
False,8417002,"Balingen, Stadt",35 - 40 Jahre,2597,1285,1312
False,8417002,"Balingen, Stadt",40 - 45 Jahre,2301,1159,1142
False,8417002,"Balingen, Stadt",45 - 50 Jahre,2043,1009,1034
False,8417002,"Balingen, Stadt",50 - 55 Jahre,2024,995,1029
False,8417002,"Balingen, Stadt",55 - 60 Jahre,2483,1212,1271
False,8417002,"Balingen, Stadt",60 - 65 Jahre,1862,917,945
False,8417002,"Balingen, Stadt",65 - 75 Jahre,3084,1280,1804
False,8417002,"Balingen, Stadt",75 und mehr Jahre,2349,701,1648
False,8417002,"Balingen, Stadt",Insgesamt,33624,16346,17278
False,8417008,Bisingen,unter 3 Jahre,315,167,148
False,8417008,Bisingen,3 -  6 Jahre,366,207,159
False,8417008,Bisingen,6 - 10 Jahre,459,236,223
False,8417008,Bisingen,10 - 15 Jahre,503,283,220
False,8417008,Bisingen,15 - 18 Jahre,302,156,146
False,8417008,Bisingen,18 - 20 Jahre,193,99,94
False,8417008,Bisingen,20 - 25 Jahre,560,290,270
False,8417008,Bisingen,25 - 30 Jahre,730,370,360
False,8417008,Bisingen,30 - 35 Jahre,797,412,385
False,8417008,Bisingen,35 - 40 Jahre,745,375,370
False,8417008,Bisingen,40 - 45 Jahre,668,351,317
False,8417008,Bisingen,45 - 50 Jahre,560,285,275
False,8417008,Bisingen,50 - 55 Jahre,459,228,231
False,8417008,Bisingen,55 - 60 Jahre,638,335,303
False,8417008,Bisingen,60 - 65 Jahre,476,228,248
False,8417008,Bisingen,65 - 75 Jahre,796,324,472
False,8417008,Bisingen,75 und mehr Jahre,413,134,279
False,8417008,Bisingen,Insgesamt,8980,4480,4500
False,8417010,Bitz,unter 3 Jahre,136,70,66
False,8417010,Bitz,3 -  6 Jahre,139,68,71
False,8417010,Bitz,6 - 10 Jahre,160,65,95
False,8417010,Bitz,10 - 15 Jahre,233,125,108
False,8417010,Bitz,15 - 18 Jahre,102,58,44
False,8417010,Bitz,18 - 20 Jahre,69,34,35
False,8417010,Bitz,20 - 25 Jahre,231,127,104
False,8417010,Bitz,25 - 30 Jahre,273,144,129
False,8417010,Bitz,30 - 35 Jahre,319,157,162
False,8417010,Bitz,35 - 40 Jahre,314,171,143
False,8417010,Bitz,40 - 45 Jahre,244,125,119
False,8417010,Bitz,45 - 50 Jahre,242,126,116
False,8417010,Bitz,50 - 55 Jahre,236,110,126
False,8417010,Bitz,55 - 60 Jahre,279,128,151
False,8417010,Bitz,60 - 65 Jahre,241,118,123
False,8417010,Bitz,65 - 75 Jahre,407,188,219
False,8417010,Bitz,75 und mehr Jahre,202,56,146
False,8417010,Bitz,Insgesamt,3827,1870,1957
False,8417013,"Burladingen, Stadt",unter 3 Jahre,480,242,238
False,8417013,"Burladingen, Stadt",3 -  6 Jahre,535,283,252
False,8417013,"Burladingen, Stadt",6 - 10 Jahre,673,335,338
False,8417013,"Burladingen, Stadt",10 - 15 Jahre,722,367,355
False,8417013,"Burladingen, Stadt",15 - 18 Jahre,440,249,191
False,8417013,"Burladingen, Stadt",18 - 20 Jahre,310,148,162
False,8417013,"Burladingen, Stadt",20 - 25 Jahre,828,424,404
False,8417013,"Burladingen, Stadt",25 - 30 Jahre,1127,611,516
False,8417013,"Burladingen, Stadt",30 - 35 Jahre,1147,584,563
False,8417013,"Burladingen, Stadt",35 - 40 Jahre,1042,552,490
False,8417013,"Burladingen, Stadt",40 - 45 Jahre,906,432,474
False,8417013,"Burladingen, Stadt",45 - 50 Jahre,768,430,338
False,8417013,"Burladingen, Stadt",50 - 55 Jahre,615,310,305
False,8417013,"Burladingen, Stadt",55 - 60 Jahre,934,462,472
False,8417013,"Burladingen, Stadt",60 - 65 Jahre,725,352,373
False,8417013,"Burladingen, Stadt",65 - 75 Jahre,1176,468,708
False,8417013,"Burladingen, Stadt",75 und mehr Jahre,684,187,497
False,8417013,"Burladingen, Stadt",Insgesamt,13112,6436,6676
False,8417014,Dautmergen,unter 3 Jahre,18,8,10
False,8417014,Dautmergen,3 -  6 Jahre,18,9,9
False,8417014,Dautmergen,6 - 10 Jahre,18,9,9
False,8417014,Dautmergen,10 - 15 Jahre,28,18,10
False,8417014,Dautmergen,15 - 18 Jahre,20,11,9
False,8417014,Dautmergen,18 - 20 Jahre,9,1,8
False,8417014,Dautmergen,20 - 25 Jahre,27,14,13
False,8417014,Dautmergen,25 - 30 Jahre,32,19,13
False,8417014,Dautmergen,30 - 35 Jahre,27,16,11
False,8417014,Dautmergen,35 - 40 Jahre,37,13,24
False,8417014,Dautmergen,40 - 45 Jahre,35,16,19
False,8417014,Dautmergen,45 - 50 Jahre,23,15,8
False,8417014,Dautmergen,50 - 55 Jahre,22,12,10
False,8417014,Dautmergen,55 - 60 Jahre,24,11,13
False,8417014,Dautmergen,60 - 65 Jahre,20,10,10
False,8417014,Dautmergen,65 - 75 Jahre,32,13,19
False,8417014,Dautmergen,75 und mehr Jahre,17,7,10
False,8417014,Dautmergen,Insgesamt,407,202,205
False,8417015,Dormettingen,unter 3 Jahre,54,29,25
False,8417015,Dormettingen,3 -  6 Jahre,50,25,25
False,8417015,Dormettingen,6 - 10 Jahre,69,38,31
False,8417015,Dormettingen,10 - 15 Jahre,78,39,39
False,8417015,Dormettingen,15 - 18 Jahre,36,16,20
False,8417015,Dormettingen,18 - 20 Jahre,16,9,7
False,8417015,Dormettingen,20 - 25 Jahre,46,30,16
False,8417015,Dormettingen,25 - 30 Jahre,78,36,42
False,8417015,Dormettingen,30 - 35 Jahre,108,59,49
False,8417015,Dormettingen,35 - 40 Jahre,97,45,52
False,8417015,Dormettingen,40 - 45 Jahre,68,39,29
False,8417015,Dormettingen,45 - 50 Jahre,43,26,17
False,8417015,Dormettingen,50 - 55 Jahre,39,23,16
False,8417015,Dormettingen,55 - 60 Jahre,64,31,33
False,8417015,Dormettingen,60 - 65 Jahre,37,22,15
False,8417015,Dormettingen,65 - 75 Jahre,84,38,46
False,8417015,Dormettingen,75 und mehr Jahre,53,18,35
False,8417015,Dormettingen,Insgesamt,1020,523,497
False,8417016,Dotternhausen,unter 3 Jahre,72,41,31
False,8417016,Dotternhausen,3 -  6 Jahre,72,38,34
False,8417016,Dotternhausen,6 - 10 Jahre,109,49,60
False,8417016,Dotternhausen,10 - 15 Jahre,129,68,61
False,8417016,Dotternhausen,15 - 18 Jahre,78,34,44
False,8417016,Dotternhausen,18 - 20 Jahre,35,18,17
False,8417016,Dotternhausen,20 - 25 Jahre,109,53,56
False,8417016,Dotternhausen,25 - 30 Jahre,104,58,46
False,8417016,Dotternhausen,30 - 35 Jahre,158,84,74
False,8417016,Dotternhausen,35 - 40 Jahre,173,79,94
False,8417016,Dotternhausen,40 - 45 Jahre,165,85,80
False,8417016,Dotternhausen,45 - 50 Jahre,90,49,41
False,8417016,Dotternhausen,50 - 55 Jahre,71,36,35
False,8417016,Dotternhausen,55 - 60 Jahre,103,49,54
False,8417016,Dotternhausen,60 - 65 Jahre,89,44,45
False,8417016,Dotternhausen,65 - 75 Jahre,123,50,73
False,8417016,Dotternhausen,75 und mehr Jahre,55,14,41
False,8417016,Dotternhausen,Insgesamt,1735,849,886
False,8417022,"Geislingen, Stadt",unter 3 Jahre,233,112,121
False,8417022,"Geislingen, Stadt",3 -  6 Jahre,249,123,126
False,8417022,"Geislingen, Stadt",6 - 10 Jahre,314,169,145
False,8417022,"Geislingen, Stadt",10 - 15 Jahre,353,183,170
False,8417022,"Geislingen, Stadt",15 - 18 Jahre,203,117,86
False,8417022,"Geislingen, Stadt",18 - 20 Jahre,108,61,47
False,8417022,"Geislingen, Stadt",20 - 25 Jahre,361,176,185
False,8417022,"Geislingen, Stadt",25 - 30 Jahre,511,275,236
False,8417022,"Geislingen, Stadt",30 - 35 Jahre,552,287,265
False,8417022,"Geislingen, Stadt",35 - 40 Jahre,470,261,209
False,8417022,"Geislingen, Stadt",40 - 45 Jahre,357,180,177
False,8417022,"Geislingen, Stadt",45 - 50 Jahre,356,181,175
False,8417022,"Geislingen, Stadt",50 - 55 Jahre,273,142,131
False,8417022,"Geislingen, Stadt",55 - 60 Jahre,455,229,226
False,8417022,"Geislingen, Stadt",60 - 65 Jahre,338,164,174
False,8417022,"Geislingen, Stadt",65 - 75 Jahre,454,211,243
False,8417022,"Geislingen, Stadt",75 und mehr Jahre,335,89,246
False,8417022,"Geislingen, Stadt",Insgesamt,5922,2960,2962
False,8417023,Grosselfingen,unter 3 Jahre,76,42,34
False,8417023,Grosselfingen,3 -  6 Jahre,102,50,52
False,8417023,Grosselfingen,6 - 10 Jahre,81,51,30
False,8417023,Grosselfingen,10 - 15 Jahre,102,57,45
False,8417023,Grosselfingen,15 - 18 Jahre,61,25,36
False,8417023,Grosselfingen,18 - 20 Jahre,38,16,22
False,8417023,Grosselfingen,20 - 25 Jahre,134,72,62
False,8417023,Grosselfingen,25 - 30 Jahre,157,77,80
False,8417023,Grosselfingen,30 - 35 Jahre,191,90,101
False,8417023,Grosselfingen,35 - 40 Jahre,157,90,67
False,8417023,Grosselfingen,40 - 45 Jahre,137,70,67
False,8417023,Grosselfingen,45 - 50 Jahre,108,64,44
False,8417023,Grosselfingen,50 - 55 Jahre,91,50,41
False,8417023,Grosselfingen,55 - 60 Jahre,118,54,64
False,8417023,Grosselfingen,60 - 65 Jahre,103,54,49
False,8417023,Grosselfingen,65 - 75 Jahre,164,66,98
False,8417023,Grosselfingen,75 und mehr Jahre,99,26,73
False,8417023,Grosselfingen,Insgesamt,1919,954,965
False,8417025,"Haigerloch, Stadt",unter 3 Jahre,427,204,223
False,8417025,"Haigerloch, Stadt",3 -  6 Jahre,476,233,243
False,8417025,"Haigerloch, Stadt",6 - 10 Jahre,579,310,269
False,8417025,"Haigerloch, Stadt",10 - 15 Jahre,598,300,298
False,8417025,"Haigerloch, Stadt",15 - 18 Jahre,364,210,154
False,8417025,"Haigerloch, Stadt",18 - 20 Jahre,227,113,114
False,8417025,"Haigerloch, Stadt",20 - 25 Jahre,681,351,330
False,8417025,"Haigerloch, Stadt",25 - 30 Jahre,956,504,452
False,8417025,"Haigerloch, Stadt",30 - 35 Jahre,1026,547,479
False,8417025,"Haigerloch, Stadt",35 - 40 Jahre,897,473,424
False,8417025,"Haigerloch, Stadt",40 - 45 Jahre,676,350,326
False,8417025,"Haigerloch, Stadt",45 - 50 Jahre,668,339,329
False,8417025,"Haigerloch, Stadt",50 - 55 Jahre,517,277,240
False,8417025,"Haigerloch, Stadt",55 - 60 Jahre,766,357,409
False,8417025,"Haigerloch, Stadt",60 - 65 Jahre,580,297,283
False,8417025,"Haigerloch, Stadt",65 - 75 Jahre,868,370,498
False,8417025,"Haigerloch, Stadt",75 und mehr Jahre,577,158,419
False,8417025,"Haigerloch, Stadt",Insgesamt,10883,5393,5490
False,8417029,Hausen am Tann,unter 3 Jahre,16,8,8
False,8417029,Hausen am Tann,3 -  6 Jahre,23,10,13
False,8417029,Hausen am Tann,6 - 10 Jahre,28,15,13
False,8417029,Hausen am Tann,10 - 15 Jahre,41,21,20
False,8417029,Hausen am Tann,15 - 18 Jahre,26,9,17
False,8417029,Hausen am Tann,18 - 20 Jahre,15,6,9
False,8417029,Hausen am Tann,20 - 25 Jahre,27,19,8
False,8417029,Hausen am Tann,25 - 30 Jahre,30,19,11
False,8417029,Hausen am Tann,30 - 35 Jahre,52,24,28
False,8417029,Hausen am Tann,35 - 40 Jahre,44,25,19
False,8417029,Hausen am Tann,40 - 45 Jahre,37,16,21
False,8417029,Hausen am Tann,45 - 50 Jahre,27,15,12
False,8417029,Hausen am Tann,50 - 55 Jahre,17,13,4
False,8417029,Hausen am Tann,55 - 60 Jahre,28,15,13
False,8417029,Hausen am Tann,60 - 65 Jahre,26,13,13
False,8417029,Hausen am Tann,65 - 75 Jahre,50,18,32
False,8417029,Hausen am Tann,75 und mehr Jahre,25,10,15
False,8417029,Hausen am Tann,Insgesamt,512,256,256
False,8417031,"Hechingen, Stadt",unter 3 Jahre,682,332,350
False,8417031,"Hechingen, Stadt",3 -  6 Jahre,734,381,353
False,8417031,"Hechingen, Stadt",6 - 10 Jahre,953,492,461
False,8417031,"Hechingen, Stadt",10 - 15 Jahre,1139,594,545
False,8417031,"Hechingen, Stadt",15 - 18 Jahre,615,316,299
False,8417031,"Hechingen, Stadt",18 - 20 Jahre,390,203,187
False,8417031,"Hechingen, Stadt",20 - 25 Jahre,1146,604,542
False,8417031,"Hechingen, Stadt",25 - 30 Jahre,1410,675,735
False,8417031,"Hechingen, Stadt",30 - 35 Jahre,1544,791,753
False,8417031,"Hechingen, Stadt",35 - 40 Jahre,1495,792,703
False,8417031,"Hechingen, Stadt",40 - 45 Jahre,1348,693,655
False,8417031,"Hechingen, Stadt",45 - 50 Jahre,1069,538,531
False,8417031,"Hechingen, Stadt",50 - 55 Jahre,1085,533,552
False,8417031,"Hechingen, Stadt",55 - 60 Jahre,1259,642,617
False,8417031,"Hechingen, Stadt",60 - 65 Jahre,1061,487,574
False,8417031,"Hechingen, Stadt",65 - 75 Jahre,1678,692,986
False,8417031,"Hechingen, Stadt",75 und mehr Jahre,1272,327,945
False,8417031,"Hechingen, Stadt",Insgesamt,18880,9092,9788
False,8417036,Jungingen,unter 3 Jahre,47,23,24
False,8417036,Jungingen,3 -  6 Jahre,49,28,21
False,8417036,Jungingen,6 - 10 Jahre,75,34,41
False,8417036,Jungingen,10 - 15 Jahre,63,34,29
False,8417036,Jungingen,15 - 18 Jahre,54,35,19
False,8417036,Jungingen,18 - 20 Jahre,23,9,14
False,8417036,Jungingen,20 - 25 Jahre,73,38,35
False,8417036,Jungingen,25 - 30 Jahre,101,47,54
False,8417036,Jungingen,30 - 35 Jahre,114,62,52
False,8417036,Jungingen,35 - 40 Jahre,129,61,68
False,8417036,Jungingen,40 - 45 Jahre,104,55,49
False,8417036,Jungingen,45 - 50 Jahre,96,41,55
False,8417036,Jungingen,50 - 55 Jahre,101,57,44
False,8417036,Jungingen,55 - 60 Jahre,107,51,56
False,8417036,Jungingen,60 - 65 Jahre,94,46,48
False,8417036,Jungingen,65 - 75 Jahre,160,72,88
False,8417036,Jungingen,75 und mehr Jahre,92,30,62
False,8417036,Jungingen,Insgesamt,1482,723,759
False,8417044,"Meßstetten, Stadt",unter 3 Jahre,434,224,210
False,8417044,"Meßstetten, Stadt",3 -  6 Jahre,465,237,228
False,8417044,"Meßstetten, Stadt",6 - 10 Jahre,612,317,295
False,8417044,"Meßstetten, Stadt",10 - 15 Jahre,690,348,342
False,8417044,"Meßstetten, Stadt",15 - 18 Jahre,365,187,178
False,8417044,"Meßstetten, Stadt",18 - 20 Jahre,222,131,91
False,8417044,"Meßstetten, Stadt",20 - 25 Jahre,620,320,300
False,8417044,"Meßstetten, Stadt",25 - 30 Jahre,929,501,428
False,8417044,"Meßstetten, Stadt",30 - 35 Jahre,1110,611,499
False,8417044,"Meßstetten, Stadt",35 - 40 Jahre,943,487,456
False,8417044,"Meßstetten, Stadt",40 - 45 Jahre,738,382,356
False,8417044,"Meßstetten, Stadt",45 - 50 Jahre,627,318,309
False,8417044,"Meßstetten, Stadt",50 - 55 Jahre,577,305,272
False,8417044,"Meßstetten, Stadt",55 - 60 Jahre,707,340,367
False,8417044,"Meßstetten, Stadt",60 - 65 Jahre,544,276,268
False,8417044,"Meßstetten, Stadt",65 - 75 Jahre,744,307,437
False,8417044,"Meßstetten, Stadt",75 und mehr Jahre,493,139,354
False,8417044,"Meßstetten, Stadt",Insgesamt,10820,5430,5390
False,8417045,Nusplingen,unter 3 Jahre,71,37,34
False,8417045,Nusplingen,3 -  6 Jahre,85,47,38
False,8417045,Nusplingen,6 - 10 Jahre,114,53,61
False,8417045,Nusplingen,10 - 15 Jahre,111,54,57
False,8417045,Nusplingen,15 - 18 Jahre,78,39,39
False,8417045,Nusplingen,18 - 20 Jahre,47,16,31
False,8417045,Nusplingen,20 - 25 Jahre,132,73,59
False,8417045,Nusplingen,25 - 30 Jahre,137,73,64
False,8417045,Nusplingen,30 - 35 Jahre,181,96,85
False,8417045,Nusplingen,35 - 40 Jahre,163,87,76
False,8417045,Nusplingen,40 - 45 Jahre,114,67,47
False,8417045,Nusplingen,45 - 50 Jahre,104,49,55
False,8417045,Nusplingen,50 - 55 Jahre,93,51,42
False,8417045,Nusplingen,55 - 60 Jahre,151,73,78
False,8417045,Nusplingen,60 - 65 Jahre,119,57,62
False,8417045,Nusplingen,65 - 75 Jahre,187,77,110
False,8417045,Nusplingen,75 und mehr Jahre,83,21,62
False,8417045,Nusplingen,Insgesamt,1970,970,1000
False,8417047,Obernheim,unter 3 Jahre,66,32,34
False,8417047,Obernheim,3 -  6 Jahre,61,30,31
False,8417047,Obernheim,6 - 10 Jahre,87,48,39
False,8417047,Obernheim,10 - 15 Jahre,62,31,31
False,8417047,Obernheim,15 - 18 Jahre,50,18,32
False,8417047,Obernheim,18 - 20 Jahre,41,32,9
False,8417047,Obernheim,20 - 25 Jahre,105,53,52
False,8417047,Obernheim,25 - 30 Jahre,122,74,48
False,8417047,Obernheim,30 - 35 Jahre,128,62,66
False,8417047,Obernheim,35 - 40 Jahre,117,54,63
False,8417047,Obernheim,40 - 45 Jahre,106,60,46
False,8417047,Obernheim,45 - 50 Jahre,99,51,48
False,8417047,Obernheim,50 - 55 Jahre,68,32,36
False,8417047,Obernheim,55 - 60 Jahre,106,56,50
False,8417047,Obernheim,60 - 65 Jahre,96,47,49
False,8417047,Obernheim,65 - 75 Jahre,131,56,75
False,8417047,Obernheim,75 und mehr Jahre,73,19,54
False,8417047,Obernheim,Insgesamt,1518,755,763
False,8417051,Rangendingen,unter 3 Jahre,165,74,91
False,8417051,Rangendingen,3 -  6 Jahre,181,86,95
False,8417051,Rangendingen,6 - 10 Jahre,270,132,138
False,8417051,Rangendingen,10 - 15 Jahre,371,192,179
False,8417051,Rangendingen,15 - 18 Jahre,214,110,104
False,8417051,Rangendingen,18 - 20 Jahre,140,68,72
False,8417051,Rangendingen,20 - 25 Jahre,344,178,166
False,8417051,Rangendingen,25 - 30 Jahre,339,177,162
False,8417051,Rangendingen,30 - 35 Jahre,399,212,187
False,8417051,Rangendingen,35 - 40 Jahre,404,194,210
False,8417051,Rangendingen,40 - 45 Jahre,368,176,192
False,8417051,Rangendingen,45 - 50 Jahre,350,180,170
False,8417051,Rangendingen,50 - 55 Jahre,285,153,132
False,8417051,Rangendingen,55 - 60 Jahre,350,189,161
False,8417051,Rangendingen,60 - 65 Jahre,227,121,106
False,8417051,Rangendingen,65 - 75 Jahre,373,152,221
False,8417051,Rangendingen,75 und mehr Jahre,197,50,147
False,8417051,Rangendingen,Insgesamt,4977,2444,2533
False,8417052,Ratshausen,unter 3 Jahre,45,17,28
False,8417052,Ratshausen,3 -  6 Jahre,47,25,22
False,8417052,Ratshausen,6 - 10 Jahre,38,22,16
False,8417052,Ratshausen,10 - 15 Jahre,47,20,27
False,8417052,Ratshausen,15 - 18 Jahre,26,13,13
False,8417052,Ratshausen,18 - 20 Jahre,15,8,7
False,8417052,Ratshausen,20 - 25 Jahre,60,33,27
False,8417052,Ratshausen,25 - 30 Jahre,63,36,27
False,8417052,Ratshausen,30 - 35 Jahre,69,32,37
False,8417052,Ratshausen,35 - 40 Jahre,61,34,27
False,8417052,Ratshausen,40 - 45 Jahre,44,24,20
False,8417052,Ratshausen,45 - 50 Jahre,59,28,31
False,8417052,Ratshausen,50 - 55 Jahre,38,24,14
False,8417052,Ratshausen,55 - 60 Jahre,45,19,26
False,8417052,Ratshausen,60 - 65 Jahre,34,13,21
False,8417052,Ratshausen,65 - 75 Jahre,46,19,27
False,8417052,Ratshausen,75 und mehr Jahre,47,12,35
False,8417052,Ratshausen,Insgesamt,784,379,405
False,8417054,"Rosenfeld, Stadt",unter 3 Jahre,275,134,141
False,8417054,"Rosenfeld, Stadt",3 -  6 Jahre,260,129,131
False,8417054,"Rosenfeld, Stadt",6 - 10 Jahre,352,179,173
False,8417054,"Rosenfeld, Stadt",10 - 15 Jahre,348,186,162
False,8417054,"Rosenfeld, Stadt",15 - 18 Jahre,215,114,101
False,8417054,"Rosenfeld, Stadt",18 - 20 Jahre,123,76,47
False,8417054,"Rosenfeld, Stadt",20 - 25 Jahre,391,196,195
False,8417054,"Rosenfeld, Stadt",25 - 30 Jahre,475,263,212
False,8417054,"Rosenfeld, Stadt",30 - 35 Jahre,505,282,223
False,8417054,"Rosenfeld, Stadt",35 - 40 Jahre,445,225,220
False,8417054,"Rosenfeld, Stadt",40 - 45 Jahre,391,202,189
False,8417054,"Rosenfeld, Stadt",45 - 50 Jahre,344,173,171
False,8417054,"Rosenfeld, Stadt",50 - 55 Jahre,316,160,156
False,8417054,"Rosenfeld, Stadt",55 - 60 Jahre,435,228,207
False,8417054,"Rosenfeld, Stadt",60 - 65 Jahre,279,145,134
False,8417054,"Rosenfeld, Stadt",65 - 75 Jahre,561,232,329
False,8417054,"Rosenfeld, Stadt",75 und mehr Jahre,322,111,211
False,8417054,"Rosenfeld, Stadt",Insgesamt,6037,3035,3002
False,8417057,"Schömberg, Stadt",unter 3 Jahre,191,88,103
False,8417057,"Schömberg, Stadt",3 -  6 Jahre,188,106,82
False,8417057,"Schömberg, Stadt",6 - 10 Jahre,233,129,104
False,8417057,"Schömberg, Stadt",10 - 15 Jahre,278,138,140
False,8417057,"Schömberg, Stadt",15 - 18 Jahre,163,87,76
False,8417057,"Schömberg, Stadt",18 - 20 Jahre,93,46,47
False,8417057,"Schömberg, Stadt",20 - 25 Jahre,316,155,161
False,8417057,"Schömberg, Stadt",25 - 30 Jahre,350,179,171
False,8417057,"Schömberg, Stadt",30 - 35 Jahre,396,194,202
False,8417057,"Schömberg, Stadt",35 - 40 Jahre,335,170,165
False,8417057,"Schömberg, Stadt",40 - 45 Jahre,273,145,128
False,8417057,"Schömberg, Stadt",45 - 50 Jahre,273,147,126
False,8417057,"Schömberg, Stadt",50 - 55 Jahre,202,115,87
False,8417057,"Schömberg, Stadt",55 - 60 Jahre,279,135,144
False,8417057,"Schömberg, Stadt",60 - 65 Jahre,174,93,81
False,8417057,"Schömberg, Stadt",65 - 75 Jahre,354,132,222
False,8417057,"Schömberg, Stadt",75 und mehr Jahre,269,89,180
False,8417057,"Schömberg, Stadt",Insgesamt,4367,2148,2219
False,8417063,Straßberg,unter 3 Jahre,93,55,38
False,8417063,Straßberg,3 -  6 Jahre,124,71,53
False,8417063,Straßberg,6 - 10 Jahre,142,76,66
False,8417063,Straßberg,10 - 15 Jahre,160,84,76
False,8417063,Straßberg,15 - 18 Jahre,86,50,36
False,8417063,Straßberg,18 - 20 Jahre,50,19,31
False,8417063,Straßberg,20 - 25 Jahre,164,84,80
False,8417063,Straßberg,25 - 30 Jahre,209,105,104
False,8417063,Straßberg,30 - 35 Jahre,250,117,133
False,8417063,Straßberg,35 - 40 Jahre,216,120,96
False,8417063,Straßberg,40 - 45 Jahre,190,87,103
False,8417063,Straßberg,45 - 50 Jahre,187,95,92
False,8417063,Straßberg,50 - 55 Jahre,145,67,78
False,8417063,Straßberg,55 - 60 Jahre,189,108,81
False,8417063,Straßberg,60 - 65 Jahre,151,78,73
False,8417063,Straßberg,65 - 75 Jahre,237,87,150
False,8417063,Straßberg,75 und mehr Jahre,171,49,122
False,8417063,Straßberg,Insgesamt,2764,1352,1412
False,8417071,Weilen unter den Rinnen,unter 3 Jahre,30,14,16
False,8417071,Weilen unter den Rinnen,3 -  6 Jahre,37,16,21
False,8417071,Weilen unter den Rinnen,6 - 10 Jahre,31,15,16
False,8417071,Weilen unter den Rinnen,10 - 15 Jahre,25,10,15
False,8417071,Weilen unter den Rinnen,15 - 18 Jahre,18,6,12
False,8417071,Weilen unter den Rinnen,18 - 20 Jahre,16,7,9
False,8417071,Weilen unter den Rinnen,20 - 25 Jahre,37,21,16
False,8417071,Weilen unter den Rinnen,25 - 30 Jahre,66,32,34
False,8417071,Weilen unter den Rinnen,30 - 35 Jahre,73,39,34
False,8417071,Weilen unter den Rinnen,35 - 40 Jahre,55,32,23
False,8417071,Weilen unter den Rinnen,40 - 45 Jahre,34,15,19
False,8417071,Weilen unter den Rinnen,45 - 50 Jahre,31,17,14
False,8417071,Weilen unter den Rinnen,50 - 55 Jahre,21,11,10
False,8417071,Weilen unter den Rinnen,55 - 60 Jahre,30,12,18
False,8417071,Weilen unter den Rinnen,60 - 65 Jahre,26,12,14
False,8417071,Weilen unter den Rinnen,65 - 75 Jahre,36,16,20
False,8417071,Weilen unter den Rinnen,75 und mehr Jahre,20,4,16
False,8417071,Weilen unter den Rinnen,Insgesamt,586,279,307
False,8417075,Winterlingen,unter 3 Jahre,246,138,108
False,8417075,Winterlingen,3 -  6 Jahre,300,157,143
False,8417075,Winterlingen,6 - 10 Jahre,378,203,175
False,8417075,Winterlingen,10 - 15 Jahre,418,205,213
False,8417075,Winterlingen,15 - 18 Jahre,190,101,89
False,8417075,Winterlingen,18 - 20 Jahre,133,68,65
False,8417075,Winterlingen,20 - 25 Jahre,388,214,174
False,8417075,Winterlingen,25 - 30 Jahre,560,290,270
False,8417075,Winterlingen,30 - 35 Jahre,580,296,284
False,8417075,Winterlingen,35 - 40 Jahre,559,299,260
False,8417075,Winterlingen,40 - 45 Jahre,451,233,218
False,8417075,Winterlingen,45 - 50 Jahre,382,189,193
False,8417075,Winterlingen,50 - 55 Jahre,335,173,162
False,8417075,Winterlingen,55 - 60 Jahre,473,229,244
False,8417075,Winterlingen,60 - 65 Jahre,377,190,187
False,8417075,Winterlingen,65 - 75 Jahre,603,251,352
False,8417075,Winterlingen,75 und mehr Jahre,428,122,306
False,8417075,Winterlingen,Insgesamt,6801,3358,3443
False,8417078,Zimmern unter der Burg,unter 3 Jahre,20,13,7
False,8417078,Zimmern unter der Burg,3 -  6 Jahre,34,20,14
False,8417078,Zimmern unter der Burg,6 - 10 Jahre,27,13,14
False,8417078,Zimmern unter der Burg,10 - 15 Jahre,19,10,9
False,8417078,Zimmern unter der Burg,15 - 18 Jahre,17,9,8
False,8417078,Zimmern unter der Burg,18 - 20 Jahre,13,8,5
False,8417078,Zimmern unter der Burg,20 - 25 Jahre,30,19,11
False,8417078,Zimmern unter der Burg,25 - 30 Jahre,43,23,20
False,8417078,Zimmern unter der Burg,30 - 35 Jahre,33,14,19
False,8417078,Zimmern unter der Burg,35 - 40 Jahre,44,24,20
False,8417078,Zimmern unter der Burg,40 - 45 Jahre,24,12,12
False,8417078,Zimmern unter der Burg,45 - 50 Jahre,30,17,13
False,8417078,Zimmern unter der Burg,50 - 55 Jahre,24,14,10
False,8417078,Zimmern unter der Burg,55 - 60 Jahre,26,13,13
False,8417078,Zimmern unter der Burg,60 - 65 Jahre,24,11,13
False,8417078,Zimmern unter der Burg,65 - 75 Jahre,41,19,22
False,8417078,Zimmern unter der Burg,75 und mehr Jahre,23,3,20
False,8417078,Zimmern unter der Burg,Insgesamt,472,242,230
False,8417079,"Albstadt, Stadt",unter 3 Jahre,1549,793,756
False,8417079,"Albstadt, Stadt",3 -  6 Jahre,1583,791,792
False,8417079,"Albstadt, Stadt",6 - 10 Jahre,2200,1168,1032
False,8417079,"Albstadt, Stadt",10 - 15 Jahre,2528,1291,1237
False,8417079,"Albstadt, Stadt",15 - 18 Jahre,1411,729,682
False,8417079,"Albstadt, Stadt",18 - 20 Jahre,1026,523,503
False,8417079,"Albstadt, Stadt",20 - 25 Jahre,3025,1557,1468
False,8417079,"Albstadt, Stadt",25 - 30 Jahre,3991,2116,1875
False,8417079,"Albstadt, Stadt",30 - 35 Jahre,4090,2142,1948
False,8417079,"Albstadt, Stadt",35 - 40 Jahre,3533,1849,1684
False,8417079,"Albstadt, Stadt",40 - 45 Jahre,3201,1601,1600
False,8417079,"Albstadt, Stadt",45 - 50 Jahre,2837,1445,1392
False,8417079,"Albstadt, Stadt",50 - 55 Jahre,2877,1382,1495
False,8417079,"Albstadt, Stadt",55 - 60 Jahre,3895,1942,1953
False,8417079,"Albstadt, Stadt",60 - 65 Jahre,3157,1504,1653
False,8417079,"Albstadt, Stadt",65 - 75 Jahre,4817,1984,2833
False,8417079,"Albstadt, Stadt",75 und mehr Jahre,3743,1071,2672
False,8417079,"Albstadt, Stadt",Insgesamt,49463,23888,25575
False,8421,Stadtkreis Ulm,unter 3 Jahre,3524,1822,1702
False,8421,Stadtkreis Ulm,3 -  6 Jahre,3600,1823,1777
False,8421,Stadtkreis Ulm,6 - 10 Jahre,4627,2405,2222
False,8421,Stadtkreis Ulm,10 - 15 Jahre,5937,3025,2912
False,8421,Stadtkreis Ulm,15 - 18 Jahre,3602,1856,1746
False,8421,Stadtkreis Ulm,18 - 20 Jahre,2500,1233,1267
False,8421,Stadtkreis Ulm,20 - 25 Jahre,8154,4053,4101
False,8421,Stadtkreis Ulm,25 - 30 Jahre,10821,5768,5053
False,8421,Stadtkreis Ulm,30 - 35 Jahre,10486,5563,4923
False,8421,Stadtkreis Ulm,35 - 40 Jahre,8631,4416,4215
False,8421,Stadtkreis Ulm,40 - 45 Jahre,7631,3740,3891
False,8421,Stadtkreis Ulm,45 - 50 Jahre,7276,3703,3573
False,8421,Stadtkreis Ulm,50 - 55 Jahre,7175,3649,3526
False,8421,Stadtkreis Ulm,55 - 60 Jahre,7757,3911,3846
False,8421,Stadtkreis Ulm,60 - 65 Jahre,5412,2609,2803
False,8421,Stadtkreis Ulm,65 - 75 Jahre,9987,4036,5951
False,8421,Stadtkreis Ulm,75 und mehr Jahre,8601,2641,5960
False,8421,Stadtkreis Ulm,Insgesamt,115721,56253,59468
False,8421000,"Ulm, Universitätsstadt",unter 3 Jahre,3524,1822,1702
False,8421000,"Ulm, Universitätsstadt",3 -  6 Jahre,3600,1823,1777
False,8421000,"Ulm, Universitätsstadt",6 - 10 Jahre,4627,2405,2222
False,8421000,"Ulm, Universitätsstadt",10 - 15 Jahre,5937,3025,2912
False,8421000,"Ulm, Universitätsstadt",15 - 18 Jahre,3602,1856,1746
False,8421000,"Ulm, Universitätsstadt",18 - 20 Jahre,2500,1233,1267
False,8421000,"Ulm, Universitätsstadt",20 - 25 Jahre,8154,4053,4101
False,8421000,"Ulm, Universitätsstadt",25 - 30 Jahre,10821,5768,5053
False,8421000,"Ulm, Universitätsstadt",30 - 35 Jahre,10486,5563,4923
False,8421000,"Ulm, Universitätsstadt",35 - 40 Jahre,8631,4416,4215
False,8421000,"Ulm, Universitätsstadt",40 - 45 Jahre,7631,3740,3891
False,8421000,"Ulm, Universitätsstadt",45 - 50 Jahre,7276,3703,3573
False,8421000,"Ulm, Universitätsstadt",50 - 55 Jahre,7175,3649,3526
False,8421000,"Ulm, Universitätsstadt",55 - 60 Jahre,7757,3911,3846
False,8421000,"Ulm, Universitätsstadt",60 - 65 Jahre,5412,2609,2803
False,8421000,"Ulm, Universitätsstadt",65 - 75 Jahre,9987,4036,5951
False,8421000,"Ulm, Universitätsstadt",75 und mehr Jahre,8601,2641,5960
False,8421000,"Ulm, Universitätsstadt",Insgesamt,115721,56253,59468
False,8425,Landkreis Alb-Donau-Kreis,unter 3 Jahre,6627,3397,3230
False,8425,Landkreis Alb-Donau-Kreis,3 -  6 Jahre,7351,3725,3626
False,8425,Landkreis Alb-Donau-Kreis,6 - 10 Jahre,9688,4918,4770
False,8425,Landkreis Alb-Donau-Kreis,10 - 15 Jahre,11070,5703,5367
False,8425,Landkreis Alb-Donau-Kreis,15 - 18 Jahre,6419,3390,3029
False,8425,Landkreis Alb-Donau-Kreis,18 - 20 Jahre,4176,2239,1937
False,8425,Landkreis Alb-Donau-Kreis,20 - 25 Jahre,11340,5886,5454
False,8425,Landkreis Alb-Donau-Kreis,25 - 30 Jahre,14657,7739,6918
False,8425,Landkreis Alb-Donau-Kreis,30 - 35 Jahre,15852,8347,7505
False,8425,Landkreis Alb-Donau-Kreis,35 - 40 Jahre,14250,7333,6917
False,8425,Landkreis Alb-Donau-Kreis,40 - 45 Jahre,12555,6554,6001
False,8425,Landkreis Alb-Donau-Kreis,45 - 50 Jahre,10766,5663,5103
False,8425,Landkreis Alb-Donau-Kreis,50 - 55 Jahre,9811,5024,4787
False,8425,Landkreis Alb-Donau-Kreis,55 - 60 Jahre,12034,6168,5866
False,8425,Landkreis Alb-Donau-Kreis,60 - 65 Jahre,8863,4336,4527
False,8425,Landkreis Alb-Donau-Kreis,65 - 75 Jahre,15013,6423,8590
False,8425,Landkreis Alb-Donau-Kreis,75 und mehr Jahre,9837,2968,6869
False,8425,Landkreis Alb-Donau-Kreis,Insgesamt,180309,89813,90496
False,8425002,Allmendingen,unter 3 Jahre,162,87,75
False,8425002,Allmendingen,3 -  6 Jahre,187,100,87
False,8425002,Allmendingen,6 - 10 Jahre,280,146,134
False,8425002,Allmendingen,10 - 15 Jahre,284,134,150
False,8425002,Allmendingen,15 - 18 Jahre,161,78,83
False,8425002,Allmendingen,18 - 20 Jahre,104,56,48
False,8425002,Allmendingen,20 - 25 Jahre,298,151,147
False,8425002,Allmendingen,25 - 30 Jahre,354,178,176
False,8425002,Allmendingen,30 - 35 Jahre,382,224,158
False,8425002,Allmendingen,35 - 40 Jahre,376,187,189
False,8425002,Allmendingen,40 - 45 Jahre,319,176,143
False,8425002,Allmendingen,45 - 50 Jahre,266,131,135
False,8425002,Allmendingen,50 - 55 Jahre,227,123,104
False,8425002,Allmendingen,55 - 60 Jahre,308,163,145
False,8425002,Allmendingen,60 - 65 Jahre,237,113,124
False,8425002,Allmendingen,65 - 75 Jahre,369,150,219
False,8425002,Allmendingen,75 und mehr Jahre,212,72,140
False,8425002,Allmendingen,Insgesamt,4526,2269,2257
False,8425004,Altheim,unter 3 Jahre,26,16,10
False,8425004,Altheim,3 -  6 Jahre,39,19,20
False,8425004,Altheim,6 - 10 Jahre,29,13,16
False,8425004,Altheim,10 - 15 Jahre,28,11,17
False,8425004,Altheim,15 - 18 Jahre,23,14,9
False,8425004,Altheim,18 - 20 Jahre,11,6,5
False,8425004,Altheim,20 - 25 Jahre,51,24,27
False,8425004,Altheim,25 - 30 Jahre,40,21,19
False,8425004,Altheim,30 - 35 Jahre,50,27,23
False,8425004,Altheim,35 - 40 Jahre,29,15,14
False,8425004,Altheim,40 - 45 Jahre,39,20,19
False,8425004,Altheim,45 - 50 Jahre,35,16,19
False,8425004,Altheim,50 - 55 Jahre,33,16,17
False,8425004,Altheim,55 - 60 Jahre,42,24,18
False,8425004,Altheim,60 - 65 Jahre,14,7,7
False,8425004,Altheim,65 - 75 Jahre,35,20,15
False,8425004,Altheim,75 und mehr Jahre,9,1,8
False,8425004,Altheim,Insgesamt,533,270,263
False,8425005,Altheim (Alb),unter 3 Jahre,72,35,37
False,8425005,Altheim (Alb),3 -  6 Jahre,66,37,29
False,8425005,Altheim (Alb),6 - 10 Jahre,100,50,50
False,8425005,Altheim (Alb),10 - 15 Jahre,114,62,52
False,8425005,Altheim (Alb),15 - 18 Jahre,55,27,28
False,8425005,Altheim (Alb),18 - 20 Jahre,37,22,15
False,8425005,Altheim (Alb),20 - 25 Jahre,101,60,41
False,8425005,Altheim (Alb),25 - 30 Jahre,109,58,51
False,8425005,Altheim (Alb),30 - 35 Jahre,134,72,62
False,8425005,Altheim (Alb),35 - 40 Jahre,132,66,66
False,8425005,Altheim (Alb),40 - 45 Jahre,110,56,54
False,8425005,Altheim (Alb),45 - 50 Jahre,106,55,51
False,8425005,Altheim (Alb),50 - 55 Jahre,82,44,38
False,8425005,Altheim (Alb),55 - 60 Jahre,96,45,51
False,8425005,Altheim (Alb),60 - 65 Jahre,98,51,47
False,8425005,Altheim (Alb),65 - 75 Jahre,144,61,83
False,8425005,Altheim (Alb),75 und mehr Jahre,86,36,50
False,8425005,Altheim (Alb),Insgesamt,1642,837,805
False,8425008,Amstetten,unter 3 Jahre,154,82,72
False,8425008,Amstetten,3 -  6 Jahre,176,91,85
False,8425008,Amstetten,6 - 10 Jahre,210,112,98
False,8425008,Amstetten,10 - 15 Jahre,269,153,116
False,8425008,Amstetten,15 - 18 Jahre,153,80,73
False,8425008,Amstetten,18 - 20 Jahre,80,41,39
False,8425008,Amstetten,20 - 25 Jahre,255,130,125
False,8425008,Amstetten,25 - 30 Jahre,358,195,163
False,8425008,Amstetten,30 - 35 Jahre,328,175,153
False,8425008,Amstetten,35 - 40 Jahre,291,151,140
False,8425008,Amstetten,40 - 45 Jahre,266,136,130
False,8425008,Amstetten,45 - 50 Jahre,204,109,95
False,8425008,Amstetten,50 - 55 Jahre,243,127,116
False,8425008,Amstetten,55 - 60 Jahre,248,133,115
False,8425008,Amstetten,60 - 65 Jahre,199,102,97
False,8425008,Amstetten,65 - 75 Jahre,336,145,191
False,8425008,Amstetten,75 und mehr Jahre,182,54,128
False,8425008,Amstetten,Insgesamt,3952,2016,1936
False,8425011,Asselfingen,unter 3 Jahre,38,20,18
False,8425011,Asselfingen,3 -  6 Jahre,48,27,21
False,8425011,Asselfingen,6 - 10 Jahre,54,25,29
False,8425011,Asselfingen,10 - 15 Jahre,69,42,27
False,8425011,Asselfingen,15 - 18 Jahre,33,19,14
False,8425011,Asselfingen,18 - 20 Jahre,18,12,6
False,8425011,Asselfingen,20 - 25 Jahre,45,20,25
False,8425011,Asselfingen,25 - 30 Jahre,64,34,30
False,8425011,Asselfingen,30 - 35 Jahre,97,56,41
False,8425011,Asselfingen,35 - 40 Jahre,73,35,38
False,8425011,Asselfingen,40 - 45 Jahre,80,45,35
False,8425011,Asselfingen,45 - 50 Jahre,48,23,25
False,8425011,Asselfingen,50 - 55 Jahre,40,22,18
False,8425011,Asselfingen,55 - 60 Jahre,57,37,20
False,8425011,Asselfingen,60 - 65 Jahre,33,20,13
False,8425011,Asselfingen,65 - 75 Jahre,80,36,44
False,8425011,Asselfingen,75 und mehr Jahre,44,15,29
False,8425011,Asselfingen,Insgesamt,921,488,433
False,8425013,Ballendorf,unter 3 Jahre,28,12,16
False,8425013,Ballendorf,3 -  6 Jahre,29,15,14
False,8425013,Ballendorf,6 - 10 Jahre,41,16,25
False,8425013,Ballendorf,10 - 15 Jahre,28,16,12
False,8425013,Ballendorf,15 - 18 Jahre,24,9,15
False,8425013,Ballendorf,18 - 20 Jahre,16,7,9
False,8425013,Ballendorf,20 - 25 Jahre,35,16,19
False,8425013,Ballendorf,25 - 30 Jahre,53,28,25
False,8425013,Ballendorf,30 - 35 Jahre,57,29,28
False,8425013,Ballendorf,35 - 40 Jahre,52,32,20
False,8425013,Ballendorf,40 - 45 Jahre,47,21,26
False,8425013,Ballendorf,45 - 50 Jahre,18,10,8
False,8425013,Ballendorf,50 - 55 Jahre,41,20,21
False,8425013,Ballendorf,55 - 60 Jahre,41,21,20
False,8425013,Ballendorf,60 - 65 Jahre,40,18,22
False,8425013,Ballendorf,65 - 75 Jahre,53,29,24
False,8425013,Ballendorf,75 und mehr Jahre,32,5,27
False,8425013,Ballendorf,Insgesamt,635,304,331
False,8425014,Beimerstetten,unter 3 Jahre,98,46,52
False,8425014,Beimerstetten,3 -  6 Jahre,101,48,53
False,8425014,Beimerstetten,6 - 10 Jahre,130,68,62
False,8425014,Beimerstetten,10 - 15 Jahre,128,52,76
False,8425014,Beimerstetten,15 - 18 Jahre,62,33,29
False,8425014,Beimerstetten,18 - 20 Jahre,33,14,19
False,8425014,Beimerstetten,20 - 25 Jahre,106,57,49
False,8425014,Beimerstetten,25 - 30 Jahre,192,98,94
False,8425014,Beimerstetten,30 - 35 Jahre,227,117,110
False,8425014,Beimerstetten,35 - 40 Jahre,208,105,103
False,8425014,Beimerstetten,40 - 45 Jahre,164,85,79
False,8425014,Beimerstetten,45 - 50 Jahre,131,70,61
False,8425014,Beimerstetten,50 - 55 Jahre,133,68,65
False,8425014,Beimerstetten,55 - 60 Jahre,195,99,96
False,8425014,Beimerstetten,60 - 65 Jahre,96,48,48
False,8425014,Beimerstetten,65 - 75 Jahre,168,68,100
False,8425014,Beimerstetten,75 und mehr Jahre,135,41,94
False,8425014,Beimerstetten,Insgesamt,2307,1117,1190
False,8425017,Berghülen,unter 3 Jahre,88,52,36
False,8425017,Berghülen,3 -  6 Jahre,98,53,45
False,8425017,Berghülen,6 - 10 Jahre,116,62,54
False,8425017,Berghülen,10 - 15 Jahre,123,69,54
False,8425017,Berghülen,15 - 18 Jahre,75,48,27
False,8425017,Berghülen,18 - 20 Jahre,43,24,19
False,8425017,Berghülen,20 - 25 Jahre,113,65,48
False,8425017,Berghülen,25 - 30 Jahre,128,71,57
False,8425017,Berghülen,30 - 35 Jahre,169,85,84
False,8425017,Berghülen,35 - 40 Jahre,173,90,83
False,8425017,Berghülen,40 - 45 Jahre,147,79,68
False,8425017,Berghülen,45 - 50 Jahre,107,59,48
False,8425017,Berghülen,50 - 55 Jahre,94,48,46
False,8425017,Berghülen,55 - 60 Jahre,103,51,52
False,8425017,Berghülen,60 - 65 Jahre,78,37,41
False,8425017,Berghülen,65 - 75 Jahre,152,67,85
False,8425017,Berghülen,75 und mehr Jahre,95,29,66
False,8425017,Berghülen,Insgesamt,1902,989,913
False,8425019,Bernstadt,unter 3 Jahre,80,28,52
False,8425019,Bernstadt,3 -  6 Jahre,79,43,36
False,8425019,Bernstadt,6 - 10 Jahre,95,50,45
False,8425019,Bernstadt,10 - 15 Jahre,94,51,43
False,8425019,Bernstadt,15 - 18 Jahre,57,26,31
False,8425019,Bernstadt,18 - 20 Jahre,45,27,18
False,8425019,Bernstadt,20 - 25 Jahre,101,48,53
False,8425019,Bernstadt,25 - 30 Jahre,149,81,68
False,8425019,Bernstadt,30 - 35 Jahre,156,76,80
False,8425019,Bernstadt,35 - 40 Jahre,162,85,77
False,8425019,Bernstadt,40 - 45 Jahre,115,54,61
False,8425019,Bernstadt,45 - 50 Jahre,121,62,59
False,8425019,Bernstadt,50 - 55 Jahre,110,60,50
False,8425019,Bernstadt,55 - 60 Jahre,105,56,49
False,8425019,Bernstadt,60 - 65 Jahre,89,41,48
False,8425019,Bernstadt,65 - 75 Jahre,152,63,89
False,8425019,Bernstadt,75 und mehr Jahre,97,40,57
False,8425019,Bernstadt,Insgesamt,1807,891,916
False,8425020,"Blaubeuren, Stadt",unter 3 Jahre,431,220,211
False,8425020,"Blaubeuren, Stadt",3 -  6 Jahre,475,251,224
False,8425020,"Blaubeuren, Stadt",6 - 10 Jahre,601,294,307
False,8425020,"Blaubeuren, Stadt",10 - 15 Jahre,659,319,340
False,8425020,"Blaubeuren, Stadt",15 - 18 Jahre,410,202,208
False,8425020,"Blaubeuren, Stadt",18 - 20 Jahre,257,128,129
False,8425020,"Blaubeuren, Stadt",20 - 25 Jahre,738,401,337
False,8425020,"Blaubeuren, Stadt",25 - 30 Jahre,900,486,414
False,8425020,"Blaubeuren, Stadt",30 - 35 Jahre,984,546,438
False,8425020,"Blaubeuren, Stadt",35 - 40 Jahre,861,455,406
False,8425020,"Blaubeuren, Stadt",40 - 45 Jahre,781,431,350
False,8425020,"Blaubeuren, Stadt",45 - 50 Jahre,676,352,324
False,8425020,"Blaubeuren, Stadt",50 - 55 Jahre,662,331,331
False,8425020,"Blaubeuren, Stadt",55 - 60 Jahre,788,370,418
False,8425020,"Blaubeuren, Stadt",60 - 65 Jahre,663,334,329
False,8425020,"Blaubeuren, Stadt",65 - 75 Jahre,1097,455,642
False,8425020,"Blaubeuren, Stadt",75 und mehr Jahre,915,265,650
False,8425020,"Blaubeuren, Stadt",Insgesamt,11898,5840,6058
False,8425022,Börslingen,unter 3 Jahre,7,4,3
False,8425022,Börslingen,3 -  6 Jahre,9,4,5
False,8425022,Börslingen,6 - 10 Jahre,6,3,3
False,8425022,Börslingen,10 - 15 Jahre,16,7,9
False,8425022,Börslingen,15 - 18 Jahre,10,2,8
False,8425022,Börslingen,18 - 20 Jahre,4,3,1
False,8425022,Börslingen,20 - 25 Jahre,6,5,1
False,8425022,Börslingen,25 - 30 Jahre,11,6,5
False,8425022,Börslingen,30 - 35 Jahre,11,6,5
False,8425022,Börslingen,35 - 40 Jahre,11,6,5
False,8425022,Börslingen,40 - 45 Jahre,13,8,5
False,8425022,Börslingen,45 - 50 Jahre,13,7,6
False,8425022,Börslingen,50 - 55 Jahre,8,5,3
False,8425022,Börslingen,55 - 60 Jahre,8,4,4
False,8425022,Börslingen,60 - 65 Jahre,10,5,5
False,8425022,Börslingen,65 - 75 Jahre,11,5,6
False,8425022,Börslingen,75 und mehr Jahre,18,9,9
False,8425022,Börslingen,Insgesamt,172,89,83
False,8425024,Breitingen,unter 3 Jahre,4,2,2
False,8425024,Breitingen,3 -  6 Jahre,11,3,8
False,8425024,Breitingen,6 - 10 Jahre,15,5,10
False,8425024,Breitingen,10 - 15 Jahre,13,9,4
False,8425024,Breitingen,15 - 18 Jahre,7,2,5
False,8425024,Breitingen,18 - 20 Jahre,8,5,3
False,8425024,Breitingen,20 - 25 Jahre,8,5,3
False,8425024,Breitingen,25 - 30 Jahre,17,8,9
False,8425024,Breitingen,30 - 35 Jahre,22,8,14
False,8425024,Breitingen,35 - 40 Jahre,25,15,10
False,8425024,Breitingen,40 - 45 Jahre,29,14,15
False,8425024,Breitingen,45 - 50 Jahre,12,10,2
False,8425024,Breitingen,50 - 55 Jahre,11,6,5
False,8425024,Breitingen,55 - 60 Jahre,9,4,5
False,8425024,Breitingen,60 - 65 Jahre,10,4,6
False,8425024,Breitingen,65 - 75 Jahre,28,13,15
False,8425024,Breitingen,75 und mehr Jahre,13,5,8
False,8425024,Breitingen,Insgesamt,242,118,124
False,8425028,"Dietenheim, Stadt",unter 3 Jahre,238,136,102
False,8425028,"Dietenheim, Stadt",3 -  6 Jahre,267,145,122
False,8425028,"Dietenheim, Stadt",6 - 10 Jahre,383,196,187
False,8425028,"Dietenheim, Stadt",10 - 15 Jahre,439,239,200
False,8425028,"Dietenheim, Stadt",15 - 18 Jahre,227,132,95
False,8425028,"Dietenheim, Stadt",18 - 20 Jahre,160,87,73
False,8425028,"Dietenheim, Stadt",20 - 25 Jahre,415,230,185
False,8425028,"Dietenheim, Stadt",25 - 30 Jahre,485,267,218
False,8425028,"Dietenheim, Stadt",30 - 35 Jahre,540,286,254
False,8425028,"Dietenheim, Stadt",35 - 40 Jahre,560,288,272
False,8425028,"Dietenheim, Stadt",40 - 45 Jahre,438,235,203
False,8425028,"Dietenheim, Stadt",45 - 50 Jahre,357,191,166
False,8425028,"Dietenheim, Stadt",50 - 55 Jahre,333,165,168
False,8425028,"Dietenheim, Stadt",55 - 60 Jahre,402,193,209
False,8425028,"Dietenheim, Stadt",60 - 65 Jahre,316,151,165
False,8425028,"Dietenheim, Stadt",65 - 75 Jahre,555,227,328
False,8425028,"Dietenheim, Stadt",75 und mehr Jahre,409,113,296
False,8425028,"Dietenheim, Stadt",Insgesamt,6524,3281,3243
False,8425031,Dornstadt,unter 3 Jahre,296,147,149
False,8425031,Dornstadt,3 -  6 Jahre,318,163,155
False,8425031,Dornstadt,6 - 10 Jahre,426,227,199
False,8425031,Dornstadt,10 - 15 Jahre,494,246,248
False,8425031,Dornstadt,15 - 18 Jahre,324,153,171
False,8425031,Dornstadt,18 - 20 Jahre,198,105,93
False,8425031,Dornstadt,20 - 25 Jahre,471,230,241
False,8425031,Dornstadt,25 - 30 Jahre,671,368,303
False,8425031,Dornstadt,30 - 35 Jahre,740,365,375
False,8425031,Dornstadt,35 - 40 Jahre,668,319,349
False,8425031,Dornstadt,40 - 45 Jahre,622,319,303
False,8425031,Dornstadt,45 - 50 Jahre,545,289,256
False,8425031,Dornstadt,50 - 55 Jahre,543,254,289
False,8425031,Dornstadt,55 - 60 Jahre,615,325,290
False,8425031,Dornstadt,60 - 65 Jahre,434,230,204
False,8425031,Dornstadt,65 - 75 Jahre,636,285,351
False,8425031,Dornstadt,75 und mehr Jahre,509,145,364
False,8425031,Dornstadt,Insgesamt,8510,4170,4340
False,8425033,"Ehingen (Donau), Stadt",unter 3 Jahre,880,441,439
False,8425033,"Ehingen (Donau), Stadt",3 -  6 Jahre,948,453,495
False,8425033,"Ehingen (Donau), Stadt",6 - 10 Jahre,1292,630,662
False,8425033,"Ehingen (Donau), Stadt",10 - 15 Jahre,1520,782,738
False,8425033,"Ehingen (Donau), Stadt",15 - 18 Jahre,935,510,425
False,8425033,"Ehingen (Donau), Stadt",18 - 20 Jahre,613,323,290
False,8425033,"Ehingen (Donau), Stadt",20 - 25 Jahre,1755,888,867
False,8425033,"Ehingen (Donau), Stadt",25 - 30 Jahre,2076,1079,997
False,8425033,"Ehingen (Donau), Stadt",30 - 35 Jahre,2137,1182,955
False,8425033,"Ehingen (Donau), Stadt",35 - 40 Jahre,1844,926,918
False,8425033,"Ehingen (Donau), Stadt",40 - 45 Jahre,1702,857,845
False,8425033,"Ehingen (Donau), Stadt",45 - 50 Jahre,1576,815,761
False,8425033,"Ehingen (Donau), Stadt",50 - 55 Jahre,1355,726,629
False,8425033,"Ehingen (Donau), Stadt",55 - 60 Jahre,1613,847,766
False,8425033,"Ehingen (Donau), Stadt",60 - 65 Jahre,1119,538,581
False,8425033,"Ehingen (Donau), Stadt",65 - 75 Jahre,1988,826,1162
False,8425033,"Ehingen (Donau), Stadt",75 und mehr Jahre,1313,423,890
False,8425033,"Ehingen (Donau), Stadt",Insgesamt,24666,12246,12420
False,8425035,Emeringen,unter 3 Jahre,7,3,4
False,8425035,Emeringen,3 -  6 Jahre,11,5,6
False,8425035,Emeringen,6 - 10 Jahre,15,6,9
False,8425035,Emeringen,10 - 15 Jahre,9,6,3
False,8425035,Emeringen,15 - 18 Jahre,1,0,1
False,8425035,Emeringen,18 - 20 Jahre,5,5,0
False,8425035,Emeringen,20 - 25 Jahre,9,5,4
False,8425035,Emeringen,25 - 30 Jahre,15,6,9
False,8425035,Emeringen,30 - 35 Jahre,15,8,7
False,8425035,Emeringen,35 - 40 Jahre,7,3,4
False,8425035,Emeringen,40 - 45 Jahre,7,3,4
False,8425035,Emeringen,45 - 50 Jahre,10,6,4
False,8425035,Emeringen,50 - 55 Jahre,5,3,2
False,8425035,Emeringen,55 - 60 Jahre,11,5,6
False,8425035,Emeringen,60 - 65 Jahre,6,4,2
False,8425035,Emeringen,65 - 75 Jahre,15,8,7
False,8425035,Emeringen,75 und mehr Jahre,5,1,4
False,8425035,Emeringen,Insgesamt,153,77,76
False,8425036,Emerkingen,unter 3 Jahre,35,17,18
False,8425036,Emerkingen,3 -  6 Jahre,22,13,9
False,8425036,Emerkingen,6 - 10 Jahre,38,13,25
False,8425036,Emerkingen,10 - 15 Jahre,32,13,19
False,8425036,Emerkingen,15 - 18 Jahre,35,24,11
False,8425036,Emerkingen,18 - 20 Jahre,24,21,3
False,8425036,Emerkingen,20 - 25 Jahre,69,33,36
False,8425036,Emerkingen,25 - 30 Jahre,62,28,34
False,8425036,Emerkingen,30 - 35 Jahre,71,42,29
False,8425036,Emerkingen,35 - 40 Jahre,44,26,18
False,8425036,Emerkingen,40 - 45 Jahre,46,27,19
False,8425036,Emerkingen,45 - 50 Jahre,42,16,26
False,8425036,Emerkingen,50 - 55 Jahre,45,26,19
False,8425036,Emerkingen,55 - 60 Jahre,42,24,18
False,8425036,Emerkingen,60 - 65 Jahre,23,11,12
False,8425036,Emerkingen,65 - 75 Jahre,57,21,36
False,8425036,Emerkingen,75 und mehr Jahre,41,11,30
False,8425036,Emerkingen,Insgesamt,728,366,362
False,8425039,"Erbach, Stadt",unter 3 Jahre,403,210,193
False,8425039,"Erbach, Stadt",3 -  6 Jahre,482,227,255
False,8425039,"Erbach, Stadt",6 - 10 Jahre,660,335,325
False,8425039,"Erbach, Stadt",10 - 15 Jahre,800,415,385
False,8425039,"Erbach, Stadt",15 - 18 Jahre,421,227,194
False,8425039,"Erbach, Stadt",18 - 20 Jahre,298,160,138
False,8425039,"Erbach, Stadt",20 - 25 Jahre,678,346,332
False,8425039,"Erbach, Stadt",25 - 30 Jahre,982,510,472
False,8425039,"Erbach, Stadt",30 - 35 Jahre,1064,583,481
False,8425039,"Erbach, Stadt",35 - 40 Jahre,907,453,454
False,8425039,"Erbach, Stadt",40 - 45 Jahre,942,482,460
False,8425039,"Erbach, Stadt",45 - 50 Jahre,752,397,355
False,8425039,"Erbach, Stadt",50 - 55 Jahre,628,314,314
False,8425039,"Erbach, Stadt",55 - 60 Jahre,788,410,378
False,8425039,"Erbach, Stadt",60 - 65 Jahre,572,274,298
False,8425039,"Erbach, Stadt",65 - 75 Jahre,983,427,556
False,8425039,"Erbach, Stadt",75 und mehr Jahre,558,204,354
False,8425039,"Erbach, Stadt",Insgesamt,11918,5974,5944
False,8425050,Griesingen,unter 3 Jahre,37,17,20
False,8425050,Griesingen,3 -  6 Jahre,47,24,23
False,8425050,Griesingen,6 - 10 Jahre,49,24,25
False,8425050,Griesingen,10 - 15 Jahre,72,28,44
False,8425050,Griesingen,15 - 18 Jahre,32,17,15
False,8425050,Griesingen,18 - 20 Jahre,22,11,11
False,8425050,Griesingen,20 - 25 Jahre,56,33,23
False,8425050,Griesingen,25 - 30 Jahre,74,37,37
False,8425050,Griesingen,30 - 35 Jahre,88,44,44
False,8425050,Griesingen,35 - 40 Jahre,84,40,44
False,8425050,Griesingen,40 - 45 Jahre,68,45,23
False,8425050,Griesingen,45 - 50 Jahre,41,19,22
False,8425050,Griesingen,50 - 55 Jahre,30,13,17
False,8425050,Griesingen,55 - 60 Jahre,45,23,22
False,8425050,Griesingen,60 - 65 Jahre,42,22,20
False,8425050,Griesingen,65 - 75 Jahre,70,28,42
False,8425050,Griesingen,75 und mehr Jahre,33,8,25
False,8425050,Griesingen,Insgesamt,890,433,457
False,8425052,Grundsheim,unter 3 Jahre,4,1,3
False,8425052,Grundsheim,3 -  6 Jahre,3,0,3
False,8425052,Grundsheim,6 - 10 Jahre,9,4,5
False,8425052,Grundsheim,10 - 15 Jahre,12,5,7
False,8425052,Grundsheim,15 - 18 Jahre,6,3,3
False,8425052,Grundsheim,18 - 20 Jahre,6,4,2
False,8425052,Grundsheim,20 - 25 Jahre,16,8,8
False,8425052,Grundsheim,25 - 30 Jahre,17,7,10
False,8425052,Grundsheim,30 - 35 Jahre,15,10,5
False,8425052,Grundsheim,35 - 40 Jahre,16,8,8
False,8425052,Grundsheim,40 - 45 Jahre,9,7,2
False,8425052,Grundsheim,45 - 50 Jahre,12,8,4
False,8425052,Grundsheim,50 - 55 Jahre,4,1,3
False,8425052,Grundsheim,55 - 60 Jahre,16,8,8
False,8425052,Grundsheim,60 - 65 Jahre,18,6,12
False,8425052,Grundsheim,65 - 75 Jahre,16,8,8
False,8425052,Grundsheim,75 und mehr Jahre,15,3,12
False,8425052,Grundsheim,Insgesamt,194,91,103
False,8425055,Hausen am Bussen,unter 3 Jahre,10,7,3
False,8425055,Hausen am Bussen,3 -  6 Jahre,14,5,9
False,8425055,Hausen am Bussen,6 - 10 Jahre,18,6,12
False,8425055,Hausen am Bussen,10 - 15 Jahre,21,7,14
False,8425055,Hausen am Bussen,15 - 18 Jahre,4,4,0
False,8425055,Hausen am Bussen,18 - 20 Jahre,12,5,7
False,8425055,Hausen am Bussen,20 - 25 Jahre,20,12,8
False,8425055,Hausen am Bussen,25 - 30 Jahre,25,10,15
False,8425055,Hausen am Bussen,30 - 35 Jahre,25,12,13
False,8425055,Hausen am Bussen,35 - 40 Jahre,21,17,4
False,8425055,Hausen am Bussen,40 - 45 Jahre,17,8,9
False,8425055,Hausen am Bussen,45 - 50 Jahre,15,8,7
False,8425055,Hausen am Bussen,50 - 55 Jahre,8,3,5
False,8425055,Hausen am Bussen,55 - 60 Jahre,15,8,7
False,8425055,Hausen am Bussen,60 - 65 Jahre,9,5,4
False,8425055,Hausen am Bussen,65 - 75 Jahre,18,8,10
False,8425055,Hausen am Bussen,75 und mehr Jahre,11,6,5
False,8425055,Hausen am Bussen,Insgesamt,263,131,132
False,8425062,Holzkirch,unter 3 Jahre,12,5,7
False,8425062,Holzkirch,3 -  6 Jahre,10,7,3
False,8425062,Holzkirch,6 - 10 Jahre,12,4,8
False,8425062,Holzkirch,10 - 15 Jahre,10,3,7
False,8425062,Holzkirch,15 - 18 Jahre,5,2,3
False,8425062,Holzkirch,18 - 20 Jahre,2,1,1
False,8425062,Holzkirch,20 - 25 Jahre,12,7,5
False,8425062,Holzkirch,25 - 30 Jahre,21,10,11
False,8425062,Holzkirch,30 - 35 Jahre,24,14,10
False,8425062,Holzkirch,35 - 40 Jahre,12,6,6
False,8425062,Holzkirch,40 - 45 Jahre,13,9,4
False,8425062,Holzkirch,45 - 50 Jahre,8,7,1
False,8425062,Holzkirch,50 - 55 Jahre,7,3,4
False,8425062,Holzkirch,55 - 60 Jahre,20,8,12
False,8425062,Holzkirch,60 - 65 Jahre,20,12,8
False,8425062,Holzkirch,65 - 75 Jahre,32,9,23
False,8425062,Holzkirch,75 und mehr Jahre,10,1,9
False,8425062,Holzkirch,Insgesamt,230,108,122
False,8425064,Hüttisheim,unter 3 Jahre,47,25,22
False,8425064,Hüttisheim,3 -  6 Jahre,54,27,27
False,8425064,Hüttisheim,6 - 10 Jahre,85,49,36
False,8425064,Hüttisheim,10 - 15 Jahre,98,50,48
False,8425064,Hüttisheim,15 - 18 Jahre,46,21,25
False,8425064,Hüttisheim,18 - 20 Jahre,24,9,15
False,8425064,Hüttisheim,20 - 25 Jahre,85,45,40
False,8425064,Hüttisheim,25 - 30 Jahre,106,52,54
False,8425064,Hüttisheim,30 - 35 Jahre,102,47,55
False,8425064,Hüttisheim,35 - 40 Jahre,132,67,65
False,8425064,Hüttisheim,40 - 45 Jahre,96,52,44
False,8425064,Hüttisheim,45 - 50 Jahre,68,36,32
False,8425064,Hüttisheim,50 - 55 Jahre,68,33,35
False,8425064,Hüttisheim,55 - 60 Jahre,106,52,54
False,8425064,Hüttisheim,60 - 65 Jahre,75,37,38
False,8425064,Hüttisheim,65 - 75 Jahre,95,39,56
False,8425064,Hüttisheim,75 und mehr Jahre,58,19,39
False,8425064,Hüttisheim,Insgesamt,1345,660,685
False,8425066,Illerrieden,unter 3 Jahre,119,48,71
False,8425066,Illerrieden,3 -  6 Jahre,133,66,67
False,8425066,Illerrieden,6 - 10 Jahre,162,83,79
False,8425066,Illerrieden,10 - 15 Jahre,209,111,98
False,8425066,Illerrieden,15 - 18 Jahre,136,66,70
False,8425066,Illerrieden,18 - 20 Jahre,90,40,50
False,8425066,Illerrieden,20 - 25 Jahre,217,111,106
False,8425066,Illerrieden,25 - 30 Jahre,240,130,110
False,8425066,Illerrieden,30 - 35 Jahre,298,154,144
False,8425066,Illerrieden,35 - 40 Jahre,266,137,129
False,8425066,Illerrieden,40 - 45 Jahre,246,116,130
False,8425066,Illerrieden,45 - 50 Jahre,253,132,121
False,8425066,Illerrieden,50 - 55 Jahre,193,108,85
False,8425066,Illerrieden,55 - 60 Jahre,224,120,104
False,8425066,Illerrieden,60 - 65 Jahre,120,62,58
False,8425066,Illerrieden,65 - 75 Jahre,228,86,142
False,8425066,Illerrieden,75 und mehr Jahre,143,55,88
False,8425066,Illerrieden,Insgesamt,3277,1625,1652
False,8425071,"Laichingen, Stadt",unter 3 Jahre,368,196,172
False,8425071,"Laichingen, Stadt",3 -  6 Jahre,444,219,225
False,8425071,"Laichingen, Stadt",6 - 10 Jahre,554,286,268
False,8425071,"Laichingen, Stadt",10 - 15 Jahre,616,332,284
False,8425071,"Laichingen, Stadt",15 - 18 Jahre,350,186,164
False,8425071,"Laichingen, Stadt",18 - 20 Jahre,240,119,121
False,8425071,"Laichingen, Stadt",20 - 25 Jahre,638,335,303
False,8425071,"Laichingen, Stadt",25 - 30 Jahre,827,433,394
False,8425071,"Laichingen, Stadt",30 - 35 Jahre,885,465,420
False,8425071,"Laichingen, Stadt",35 - 40 Jahre,734,406,328
False,8425071,"Laichingen, Stadt",40 - 45 Jahre,654,321,333
False,8425071,"Laichingen, Stadt",45 - 50 Jahre,624,325,299
False,8425071,"Laichingen, Stadt",50 - 55 Jahre,519,279,240
False,8425071,"Laichingen, Stadt",55 - 60 Jahre,693,340,353
False,8425071,"Laichingen, Stadt",60 - 65 Jahre,482,238,244
False,8425071,"Laichingen, Stadt",65 - 75 Jahre,937,395,542
False,8425071,"Laichingen, Stadt",75 und mehr Jahre,518,144,374
False,8425071,"Laichingen, Stadt",Insgesamt,10083,5019,5064
False,8425072,"Langenau, Stadt",unter 3 Jahre,464,238,226
False,8425072,"Langenau, Stadt",3 -  6 Jahre,482,253,229
False,8425072,"Langenau, Stadt",6 - 10 Jahre,679,335,344
False,8425072,"Langenau, Stadt",10 - 15 Jahre,797,411,386
False,8425072,"Langenau, Stadt",15 - 18 Jahre,440,254,186
False,8425072,"Langenau, Stadt",18 - 20 Jahre,275,141,134
False,8425072,"Langenau, Stadt",20 - 25 Jahre,754,377,377
False,8425072,"Langenau, Stadt",25 - 30 Jahre,1128,594,534
False,8425072,"Langenau, Stadt",30 - 35 Jahre,1167,603,564
False,8425072,"Langenau, Stadt",35 - 40 Jahre,1098,579,519
False,8425072,"Langenau, Stadt",40 - 45 Jahre,890,467,423
False,8425072,"Langenau, Stadt",45 - 50 Jahre,787,419,368
False,8425072,"Langenau, Stadt",50 - 55 Jahre,709,371,338
False,8425072,"Langenau, Stadt",55 - 60 Jahre,855,438,417
False,8425072,"Langenau, Stadt",60 - 65 Jahre,670,321,349
False,8425072,"Langenau, Stadt",65 - 75 Jahre,1138,486,652
False,8425072,"Langenau, Stadt",75 und mehr Jahre,725,222,503
False,8425072,"Langenau, Stadt",Insgesamt,13058,6509,6549
False,8425073,Lauterach,unter 3 Jahre,28,10,18
False,8425073,Lauterach,3 -  6 Jahre,27,10,17
False,8425073,Lauterach,6 - 10 Jahre,38,19,19
False,8425073,Lauterach,10 - 15 Jahre,47,22,25
False,8425073,Lauterach,15 - 18 Jahre,25,13,12
False,8425073,Lauterach,18 - 20 Jahre,11,3,8
False,8425073,Lauterach,20 - 25 Jahre,45,20,25
False,8425073,Lauterach,25 - 30 Jahre,55,39,16
False,8425073,Lauterach,30 - 35 Jahre,66,40,26
False,8425073,Lauterach,35 - 40 Jahre,52,32,20
False,8425073,Lauterach,40 - 45 Jahre,52,32,20
False,8425073,Lauterach,45 - 50 Jahre,36,21,15
False,8425073,Lauterach,50 - 55 Jahre,25,10,15
False,8425073,Lauterach,55 - 60 Jahre,22,9,13
False,8425073,Lauterach,60 - 65 Jahre,22,9,13
False,8425073,Lauterach,65 - 75 Jahre,56,25,31
False,8425073,Lauterach,75 und mehr Jahre,22,9,13
False,8425073,Lauterach,Insgesamt,629,323,306
False,8425075,Lonsee,unter 3 Jahre,167,86,81
False,8425075,Lonsee,3 -  6 Jahre,216,103,113
False,8425075,Lonsee,6 - 10 Jahre,271,158,113
False,8425075,Lonsee,10 - 15 Jahre,302,158,144
False,8425075,Lonsee,15 - 18 Jahre,144,72,72
False,8425075,Lonsee,18 - 20 Jahre,96,55,41
False,8425075,Lonsee,20 - 25 Jahre,267,137,130
False,8425075,Lonsee,25 - 30 Jahre,308,155,153
False,8425075,Lonsee,30 - 35 Jahre,428,237,191
False,8425075,Lonsee,35 - 40 Jahre,377,202,175
False,8425075,Lonsee,40 - 45 Jahre,307,155,152
False,8425075,Lonsee,45 - 50 Jahre,280,152,128
False,8425075,Lonsee,50 - 55 Jahre,218,115,103
False,8425075,Lonsee,55 - 60 Jahre,262,137,125
False,8425075,Lonsee,60 - 65 Jahre,215,105,110
False,8425075,Lonsee,65 - 75 Jahre,342,146,196
False,8425075,Lonsee,75 und mehr Jahre,192,65,127
False,8425075,Lonsee,Insgesamt,4392,2238,2154
False,8425079,Merklingen,unter 3 Jahre,73,34,39
False,8425079,Merklingen,3 -  6 Jahre,76,38,38
False,8425079,Merklingen,6 - 10 Jahre,91,47,44
False,8425079,Merklingen,10 - 15 Jahre,64,32,32
False,8425079,Merklingen,15 - 18 Jahre,52,25,27
False,8425079,Merklingen,18 - 20 Jahre,29,17,12
False,8425079,Merklingen,20 - 25 Jahre,105,57,48
False,8425079,Merklingen,25 - 30 Jahre,156,75,81
False,8425079,Merklingen,30 - 35 Jahre,172,100,72
False,8425079,Merklingen,35 - 40 Jahre,119,64,55
False,8425079,Merklingen,40 - 45 Jahre,109,54,55
False,8425079,Merklingen,45 - 50 Jahre,99,51,48
False,8425079,Merklingen,50 - 55 Jahre,91,47,44
False,8425079,Merklingen,55 - 60 Jahre,131,73,58
False,8425079,Merklingen,60 - 65 Jahre,107,51,56
False,8425079,Merklingen,65 - 75 Jahre,151,69,82
False,8425079,Merklingen,75 und mehr Jahre,77,19,58
False,8425079,Merklingen,Insgesamt,1702,853,849
False,8425081,"Munderkingen, Stadt",unter 3 Jahre,184,96,88
False,8425081,"Munderkingen, Stadt",3 -  6 Jahre,222,119,103
False,8425081,"Munderkingen, Stadt",6 - 10 Jahre,312,149,163
False,8425081,"Munderkingen, Stadt",10 - 15 Jahre,311,162,149
False,8425081,"Munderkingen, Stadt",15 - 18 Jahre,175,97,78
False,8425081,"Munderkingen, Stadt",18 - 20 Jahre,127,58,69
False,8425081,"Munderkingen, Stadt",20 - 25 Jahre,351,194,157
False,8425081,"Munderkingen, Stadt",25 - 30 Jahre,363,193,170
False,8425081,"Munderkingen, Stadt",30 - 35 Jahre,410,192,218
False,8425081,"Munderkingen, Stadt",35 - 40 Jahre,415,218,197
False,8425081,"Munderkingen, Stadt",40 - 45 Jahre,351,180,171
False,8425081,"Munderkingen, Stadt",45 - 50 Jahre,297,155,142
False,8425081,"Munderkingen, Stadt",50 - 55 Jahre,270,134,136
False,8425081,"Munderkingen, Stadt",55 - 60 Jahre,352,172,180
False,8425081,"Munderkingen, Stadt",60 - 65 Jahre,285,137,148
False,8425081,"Munderkingen, Stadt",65 - 75 Jahre,409,176,233
False,8425081,"Munderkingen, Stadt",75 und mehr Jahre,372,97,275
False,8425081,"Munderkingen, Stadt",Insgesamt,5206,2529,2677
False,8425083,Neenstetten,unter 3 Jahre,24,6,18
False,8425083,Neenstetten,3 -  6 Jahre,35,19,16
False,8425083,Neenstetten,6 - 10 Jahre,39,18,21
False,8425083,Neenstetten,10 - 15 Jahre,49,25,24
False,8425083,Neenstetten,15 - 18 Jahre,28,12,16
False,8425083,Neenstetten,18 - 20 Jahre,19,9,10
False,8425083,Neenstetten,20 - 25 Jahre,44,19,25
False,8425083,Neenstetten,25 - 30 Jahre,51,22,29
False,8425083,Neenstetten,30 - 35 Jahre,70,36,34
False,8425083,Neenstetten,35 - 40 Jahre,72,38,34
False,8425083,Neenstetten,40 - 45 Jahre,51,30,21
False,8425083,Neenstetten,45 - 50 Jahre,41,20,21
False,8425083,Neenstetten,50 - 55 Jahre,51,31,20
False,8425083,Neenstetten,55 - 60 Jahre,42,21,21
False,8425083,Neenstetten,60 - 65 Jahre,39,20,19
False,8425083,Neenstetten,65 - 75 Jahre,58,26,32
False,8425083,Neenstetten,75 und mehr Jahre,30,11,19
False,8425083,Neenstetten,Insgesamt,743,363,380
False,8425084,Nellingen,unter 3 Jahre,66,37,29
False,8425084,Nellingen,3 -  6 Jahre,57,34,23
False,8425084,Nellingen,6 - 10 Jahre,79,42,37
False,8425084,Nellingen,10 - 15 Jahre,109,55,54
False,8425084,Nellingen,15 - 18 Jahre,37,17,20
False,8425084,Nellingen,18 - 20 Jahre,32,14,18
False,8425084,Nellingen,20 - 25 Jahre,109,56,53
False,8425084,Nellingen,25 - 30 Jahre,138,63,75
False,8425084,Nellingen,30 - 35 Jahre,163,87,76
False,8425084,Nellingen,35 - 40 Jahre,143,81,62
False,8425084,Nellingen,40 - 45 Jahre,123,63,60
False,8425084,Nellingen,45 - 50 Jahre,110,63,47
False,8425084,Nellingen,50 - 55 Jahre,93,48,45
False,8425084,Nellingen,55 - 60 Jahre,102,55,47
False,8425084,Nellingen,60 - 65 Jahre,82,38,44
False,8425084,Nellingen,65 - 75 Jahre,151,70,81
False,8425084,Nellingen,75 und mehr Jahre,98,28,70
False,8425084,Nellingen,Insgesamt,1692,851,841
False,8425085,Nerenstetten,unter 3 Jahre,15,6,9
False,8425085,Nerenstetten,3 -  6 Jahre,16,7,9
False,8425085,Nerenstetten,6 - 10 Jahre,22,8,14
False,8425085,Nerenstetten,10 - 15 Jahre,27,13,14
False,8425085,Nerenstetten,15 - 18 Jahre,14,6,8
False,8425085,Nerenstetten,18 - 20 Jahre,8,6,2
False,8425085,Nerenstetten,20 - 25 Jahre,20,11,9
False,8425085,Nerenstetten,25 - 30 Jahre,27,12,15
False,8425085,Nerenstetten,30 - 35 Jahre,26,14,12
False,8425085,Nerenstetten,35 - 40 Jahre,19,7,12
False,8425085,Nerenstetten,40 - 45 Jahre,30,20,10
False,8425085,Nerenstetten,45 - 50 Jahre,15,8,7
False,8425085,Nerenstetten,50 - 55 Jahre,14,9,5
False,8425085,Nerenstetten,55 - 60 Jahre,18,11,7
False,8425085,Nerenstetten,60 - 65 Jahre,11,7,4
False,8425085,Nerenstetten,65 - 75 Jahre,26,12,14
False,8425085,Nerenstetten,75 und mehr Jahre,12,5,7
False,8425085,Nerenstetten,Insgesamt,320,162,158
False,8425088,Oberdischingen,unter 3 Jahre,77,45,32
False,8425088,Oberdischingen,3 -  6 Jahre,88,48,40
False,8425088,Oberdischingen,6 - 10 Jahre,112,67,45
False,8425088,Oberdischingen,10 - 15 Jahre,122,64,58
False,8425088,Oberdischingen,15 - 18 Jahre,63,30,33
False,8425088,Oberdischingen,18 - 20 Jahre,30,22,8
False,8425088,Oberdischingen,20 - 25 Jahre,73,41,32
False,8425088,Oberdischingen,25 - 30 Jahre,123,64,59
False,8425088,Oberdischingen,30 - 35 Jahre,131,55,76
False,8425088,Oberdischingen,35 - 40 Jahre,165,86,79
False,8425088,Oberdischingen,40 - 45 Jahre,135,73,62
False,8425088,Oberdischingen,45 - 50 Jahre,87,47,40
False,8425088,Oberdischingen,50 - 55 Jahre,70,39,31
False,8425088,Oberdischingen,55 - 60 Jahre,107,48,59
False,8425088,Oberdischingen,60 - 65 Jahre,83,38,45
False,8425088,Oberdischingen,65 - 75 Jahre,149,59,90
False,8425088,Oberdischingen,75 und mehr Jahre,148,36,112
False,8425088,Oberdischingen,Insgesamt,1763,862,901
False,8425090,Obermarchtal,unter 3 Jahre,50,26,24
False,8425090,Obermarchtal,3 -  6 Jahre,40,19,21
False,8425090,Obermarchtal,6 - 10 Jahre,83,45,38
False,8425090,Obermarchtal,10 - 15 Jahre,74,36,38
False,8425090,Obermarchtal,15 - 18 Jahre,50,26,24
False,8425090,Obermarchtal,18 - 20 Jahre,31,15,16
False,8425090,Obermarchtal,20 - 25 Jahre,101,50,51
False,8425090,Obermarchtal,25 - 30 Jahre,98,48,50
False,8425090,Obermarchtal,30 - 35 Jahre,97,46,51
False,8425090,Obermarchtal,35 - 40 Jahre,77,42,35
False,8425090,Obermarchtal,40 - 45 Jahre,79,42,37
False,8425090,Obermarchtal,45 - 50 Jahre,76,37,39
False,8425090,Obermarchtal,50 - 55 Jahre,54,26,28
False,8425090,Obermarchtal,55 - 60 Jahre,75,41,34
False,8425090,Obermarchtal,60 - 65 Jahre,46,21,25
False,8425090,Obermarchtal,65 - 75 Jahre,120,51,69
False,8425090,Obermarchtal,75 und mehr Jahre,83,19,64
False,8425090,Obermarchtal,Insgesamt,1234,590,644
False,8425091,Oberstadion,unter 3 Jahre,74,41,33
False,8425091,Oberstadion,3 -  6 Jahre,72,40,32
False,8425091,Oberstadion,6 - 10 Jahre,103,55,48
False,8425091,Oberstadion,10 - 15 Jahre,126,71,55
False,8425091,Oberstadion,15 - 18 Jahre,61,35,26
False,8425091,Oberstadion,18 - 20 Jahre,31,16,15
False,8425091,Oberstadion,20 - 25 Jahre,103,44,59
False,8425091,Oberstadion,25 - 30 Jahre,113,52,61
False,8425091,Oberstadion,30 - 35 Jahre,149,83,66
False,8425091,Oberstadion,35 - 40 Jahre,145,72,73
False,8425091,Oberstadion,40 - 45 Jahre,108,56,52
False,8425091,Oberstadion,45 - 50 Jahre,58,40,18
False,8425091,Oberstadion,50 - 55 Jahre,50,18,32
False,8425091,Oberstadion,55 - 60 Jahre,69,36,33
False,8425091,Oberstadion,60 - 65 Jahre,56,29,27
False,8425091,Oberstadion,65 - 75 Jahre,119,56,63
False,8425091,Oberstadion,75 und mehr Jahre,64,19,45
False,8425091,Oberstadion,Insgesamt,1501,763,738
False,8425092,Öllingen,unter 3 Jahre,28,15,13
False,8425092,Öllingen,3 -  6 Jahre,31,14,17
False,8425092,Öllingen,6 - 10 Jahre,27,11,16
False,8425092,Öllingen,10 - 15 Jahre,33,14,19
False,8425092,Öllingen,15 - 18 Jahre,8,7,1
False,8425092,Öllingen,18 - 20 Jahre,9,6,3
False,8425092,Öllingen,20 - 25 Jahre,23,12,11
False,8425092,Öllingen,25 - 30 Jahre,33,17,16
False,8425092,Öllingen,30 - 35 Jahre,55,28,27
False,8425092,Öllingen,35 - 40 Jahre,43,27,16
False,8425092,Öllingen,40 - 45 Jahre,24,8,16
False,8425092,Öllingen,45 - 50 Jahre,16,8,8
False,8425092,Öllingen,50 - 55 Jahre,16,8,8
False,8425092,Öllingen,55 - 60 Jahre,43,22,21
False,8425092,Öllingen,60 - 65 Jahre,19,11,8
False,8425092,Öllingen,65 - 75 Jahre,34,17,17
False,8425092,Öllingen,75 und mehr Jahre,20,6,14
False,8425092,Öllingen,Insgesamt,462,231,231
False,8425093,Öpfingen,unter 3 Jahre,84,44,40
False,8425093,Öpfingen,3 -  6 Jahre,78,45,33
False,8425093,Öpfingen,6 - 10 Jahre,118,55,63
False,8425093,Öpfingen,10 - 15 Jahre,123,58,65
False,8425093,Öpfingen,15 - 18 Jahre,70,30,40
False,8425093,Öpfingen,18 - 20 Jahre,63,32,31
False,8425093,Öpfingen,20 - 25 Jahre,132,71,61
False,8425093,Öpfingen,25 - 30 Jahre,162,88,74
False,8425093,Öpfingen,30 - 35 Jahre,176,80,96
False,8425093,Öpfingen,35 - 40 Jahre,165,86,79
False,8425093,Öpfingen,40 - 45 Jahre,143,69,74
False,8425093,Öpfingen,45 - 50 Jahre,125,66,59
False,8425093,Öpfingen,50 - 55 Jahre,124,61,63
False,8425093,Öpfingen,55 - 60 Jahre,146,81,65
False,8425093,Öpfingen,60 - 65 Jahre,103,51,52
False,8425093,Öpfingen,65 - 75 Jahre,154,66,88
False,8425093,Öpfingen,75 und mehr Jahre,92,38,54
False,8425093,Öpfingen,Insgesamt,2058,1021,1037
False,8425097,Rammingen,unter 3 Jahre,44,30,14
False,8425097,Rammingen,3 -  6 Jahre,54,29,25
False,8425097,Rammingen,6 - 10 Jahre,73,35,38
False,8425097,Rammingen,10 - 15 Jahre,76,46,30
False,8425097,Rammingen,15 - 18 Jahre,28,9,19
False,8425097,Rammingen,18 - 20 Jahre,23,14,9
False,8425097,Rammingen,20 - 25 Jahre,82,47,35
False,8425097,Rammingen,25 - 30 Jahre,105,58,47
False,8425097,Rammingen,30 - 35 Jahre,111,61,50
False,8425097,Rammingen,35 - 40 Jahre,100,55,45
False,8425097,Rammingen,40 - 45 Jahre,98,54,44
False,8425097,Rammingen,45 - 50 Jahre,76,38,38
False,8425097,Rammingen,50 - 55 Jahre,77,48,29
False,8425097,Rammingen,55 - 60 Jahre,78,42,36
False,8425097,Rammingen,60 - 65 Jahre,54,29,25
False,8425097,Rammingen,65 - 75 Jahre,86,35,51
False,8425097,Rammingen,75 und mehr Jahre,69,22,47
False,8425097,Rammingen,Insgesamt,1234,652,582
False,8425098,Rechtenstein,unter 3 Jahre,7,5,2
False,8425098,Rechtenstein,3 -  6 Jahre,9,6,3
False,8425098,Rechtenstein,6 - 10 Jahre,12,6,6
False,8425098,Rechtenstein,10 - 15 Jahre,34,16,18
False,8425098,Rechtenstein,15 - 18 Jahre,13,3,10
False,8425098,Rechtenstein,18 - 20 Jahre,7,5,2
False,8425098,Rechtenstein,20 - 25 Jahre,15,6,9
False,8425098,Rechtenstein,25 - 30 Jahre,23,18,5
False,8425098,Rechtenstein,30 - 35 Jahre,28,12,16
False,8425098,Rechtenstein,35 - 40 Jahre,31,17,14
False,8425098,Rechtenstein,40 - 45 Jahre,22,12,10
False,8425098,Rechtenstein,45 - 50 Jahre,15,10,5
False,8425098,Rechtenstein,50 - 55 Jahre,10,5,5
False,8425098,Rechtenstein,55 - 60 Jahre,25,12,13
False,8425098,Rechtenstein,60 - 65 Jahre,10,5,5
False,8425098,Rechtenstein,65 - 75 Jahre,21,7,14
False,8425098,Rechtenstein,75 und mehr Jahre,14,5,9
False,8425098,Rechtenstein,Insgesamt,296,150,146
False,8425104,Rottenacker,unter 3 Jahre,84,53,31
False,8425104,Rottenacker,3 -  6 Jahre,97,60,37
False,8425104,Rottenacker,6 - 10 Jahre,111,64,47
False,8425104,Rottenacker,10 - 15 Jahre,128,72,56
False,8425104,Rottenacker,15 - 18 Jahre,73,47,26
False,8425104,Rottenacker,18 - 20 Jahre,47,24,23
False,8425104,Rottenacker,20 - 25 Jahre,108,53,55
False,8425104,Rottenacker,25 - 30 Jahre,153,79,74
False,8425104,Rottenacker,30 - 35 Jahre,188,98,90
False,8425104,Rottenacker,35 - 40 Jahre,154,74,80
False,8425104,Rottenacker,40 - 45 Jahre,150,73,77
False,8425104,Rottenacker,45 - 50 Jahre,105,61,44
False,8425104,Rottenacker,50 - 55 Jahre,95,48,47
False,8425104,Rottenacker,55 - 60 Jahre,153,73,80
False,8425104,Rottenacker,60 - 65 Jahre,117,59,58
False,8425104,Rottenacker,65 - 75 Jahre,193,82,111
False,8425104,Rottenacker,75 und mehr Jahre,104,29,75
False,8425104,Rottenacker,Insgesamt,2060,1049,1011
False,8425108,"Schelklingen, Stadt",unter 3 Jahre,218,108,110
False,8425108,"Schelklingen, Stadt",3 -  6 Jahre,275,135,140
False,8425108,"Schelklingen, Stadt",6 - 10 Jahre,358,195,163
False,8425108,"Schelklingen, Stadt",10 - 15 Jahre,440,227,213
False,8425108,"Schelklingen, Stadt",15 - 18 Jahre,367,225,142
False,8425108,"Schelklingen, Stadt",18 - 20 Jahre,248,177,71
False,8425108,"Schelklingen, Stadt",20 - 25 Jahre,539,302,237
False,8425108,"Schelklingen, Stadt",25 - 30 Jahre,608,349,259
False,8425108,"Schelklingen, Stadt",30 - 35 Jahre,543,269,274
False,8425108,"Schelklingen, Stadt",35 - 40 Jahre,509,270,239
False,8425108,"Schelklingen, Stadt",40 - 45 Jahre,419,214,205
False,8425108,"Schelklingen, Stadt",45 - 50 Jahre,371,189,182
False,8425108,"Schelklingen, Stadt",50 - 55 Jahre,354,178,176
False,8425108,"Schelklingen, Stadt",55 - 60 Jahre,444,225,219
False,8425108,"Schelklingen, Stadt",60 - 65 Jahre,395,191,204
False,8425108,"Schelklingen, Stadt",65 - 75 Jahre,624,278,346
False,8425108,"Schelklingen, Stadt",75 und mehr Jahre,380,104,276
False,8425108,"Schelklingen, Stadt",Insgesamt,7092,3636,3456
False,8425110,Schnürpflingen,unter 3 Jahre,51,22,29
False,8425110,Schnürpflingen,3 -  6 Jahre,77,27,50
False,8425110,Schnürpflingen,6 - 10 Jahre,91,48,43
False,8425110,Schnürpflingen,10 - 15 Jahre,104,49,55
False,8425110,Schnürpflingen,15 - 18 Jahre,56,33,23
False,8425110,Schnürpflingen,18 - 20 Jahre,24,14,10
False,8425110,Schnürpflingen,20 - 25 Jahre,89,45,44
False,8425110,Schnürpflingen,25 - 30 Jahre,106,53,53
False,8425110,Schnürpflingen,30 - 35 Jahre,116,53,63
False,8425110,Schnürpflingen,35 - 40 Jahre,127,65,62
False,8425110,Schnürpflingen,40 - 45 Jahre,100,49,51
False,8425110,Schnürpflingen,45 - 50 Jahre,104,65,39
False,8425110,Schnürpflingen,50 - 55 Jahre,71,37,34
False,8425110,Schnürpflingen,55 - 60 Jahre,53,28,25
False,8425110,Schnürpflingen,60 - 65 Jahre,44,21,23
False,8425110,Schnürpflingen,65 - 75 Jahre,91,41,50
False,8425110,Schnürpflingen,75 und mehr Jahre,65,24,41
False,8425110,Schnürpflingen,Insgesamt,1369,674,695
False,8425112,Setzingen,unter 3 Jahre,20,14,6
False,8425112,Setzingen,3 -  6 Jahre,19,6,13
False,8425112,Setzingen,6 - 10 Jahre,37,19,18
False,8425112,Setzingen,10 - 15 Jahre,53,29,24
False,8425112,Setzingen,15 - 18 Jahre,28,18,10
False,8425112,Setzingen,18 - 20 Jahre,15,6,9
False,8425112,Setzingen,20 - 25 Jahre,40,21,19
False,8425112,Setzingen,25 - 30 Jahre,44,27,17
False,8425112,Setzingen,30 - 35 Jahre,63,36,27
False,8425112,Setzingen,35 - 40 Jahre,47,22,25
False,8425112,Setzingen,40 - 45 Jahre,40,20,20
False,8425112,Setzingen,45 - 50 Jahre,45,24,21
False,8425112,Setzingen,50 - 55 Jahre,44,24,20
False,8425112,Setzingen,55 - 60 Jahre,33,22,11
False,8425112,Setzingen,60 - 65 Jahre,24,11,13
False,8425112,Setzingen,65 - 75 Jahre,45,18,27
False,8425112,Setzingen,75 und mehr Jahre,29,7,22
False,8425112,Setzingen,Insgesamt,626,324,302
False,8425123,Untermarchtal,unter 3 Jahre,18,12,6
False,8425123,Untermarchtal,3 -  6 Jahre,32,12,20
False,8425123,Untermarchtal,6 - 10 Jahre,34,16,18
False,8425123,Untermarchtal,10 - 15 Jahre,32,13,19
False,8425123,Untermarchtal,15 - 18 Jahre,32,15,17
False,8425123,Untermarchtal,18 - 20 Jahre,18,10,8
False,8425123,Untermarchtal,20 - 25 Jahre,35,16,19
False,8425123,Untermarchtal,25 - 30 Jahre,46,23,23
False,8425123,Untermarchtal,30 - 35 Jahre,50,27,23
False,8425123,Untermarchtal,35 - 40 Jahre,54,24,30
False,8425123,Untermarchtal,40 - 45 Jahre,50,23,27
False,8425123,Untermarchtal,45 - 50 Jahre,35,20,15
False,8425123,Untermarchtal,50 - 55 Jahre,47,20,27
False,8425123,Untermarchtal,55 - 60 Jahre,66,19,47
False,8425123,Untermarchtal,60 - 65 Jahre,50,11,39
False,8425123,Untermarchtal,65 - 75 Jahre,129,26,103
False,8425123,Untermarchtal,75 und mehr Jahre,155,13,142
False,8425123,Untermarchtal,Insgesamt,883,300,583
False,8425124,Unterstadion,unter 3 Jahre,26,15,11
False,8425124,Unterstadion,3 -  6 Jahre,37,19,18
False,8425124,Unterstadion,6 - 10 Jahre,39,13,26
False,8425124,Unterstadion,10 - 15 Jahre,40,19,21
False,8425124,Unterstadion,15 - 18 Jahre,22,11,11
False,8425124,Unterstadion,18 - 20 Jahre,17,7,10
False,8425124,Unterstadion,20 - 25 Jahre,43,18,25
False,8425124,Unterstadion,25 - 30 Jahre,52,26,26
False,8425124,Unterstadion,30 - 35 Jahre,61,32,29
False,8425124,Unterstadion,35 - 40 Jahre,60,29,31
False,8425124,Unterstadion,40 - 45 Jahre,45,25,20
False,8425124,Unterstadion,45 - 50 Jahre,44,27,17
False,8425124,Unterstadion,50 - 55 Jahre,25,11,14
False,8425124,Unterstadion,55 - 60 Jahre,36,17,19
False,8425124,Unterstadion,60 - 65 Jahre,25,12,13
False,8425124,Unterstadion,65 - 75 Jahre,40,17,23
False,8425124,Unterstadion,75 und mehr Jahre,31,8,23
False,8425124,Unterstadion,Insgesamt,643,306,337
False,8425125,Unterwachingen,unter 3 Jahre,1,0,1
False,8425125,Unterwachingen,3 -  6 Jahre,4,3,1
False,8425125,Unterwachingen,6 - 10 Jahre,6,5,1
False,8425125,Unterwachingen,10 - 15 Jahre,9,4,5
False,8425125,Unterwachingen,15 - 18 Jahre,2,2,0
False,8425125,Unterwachingen,18 - 20 Jahre,5,2,3
False,8425125,Unterwachingen,20 - 25 Jahre,15,8,7
False,8425125,Unterwachingen,25 - 30 Jahre,14,9,5
False,8425125,Unterwachingen,30 - 35 Jahre,8,6,2
False,8425125,Unterwachingen,35 - 40 Jahre,7,2,5
False,8425125,Unterwachingen,40 - 45 Jahre,11,7,4
False,8425125,Unterwachingen,45 - 50 Jahre,9,5,4
False,8425125,Unterwachingen,50 - 55 Jahre,10,5,5
False,8425125,Unterwachingen,55 - 60 Jahre,10,6,4
False,8425125,Unterwachingen,60 - 65 Jahre,10,4,6
False,8425125,Unterwachingen,65 - 75 Jahre,7,3,4
False,8425125,Unterwachingen,75 und mehr Jahre,15,5,10
False,8425125,Unterwachingen,Insgesamt,143,76,67
False,8425130,Weidenstetten,unter 3 Jahre,63,33,30
False,8425130,Weidenstetten,3 -  6 Jahre,43,27,16
False,8425130,Weidenstetten,6 - 10 Jahre,50,26,24
False,8425130,Weidenstetten,10 - 15 Jahre,60,28,32
False,8425130,Weidenstetten,15 - 18 Jahre,40,16,24
False,8425130,Weidenstetten,18 - 20 Jahre,23,12,11
False,8425130,Weidenstetten,20 - 25 Jahre,75,38,37
False,8425130,Weidenstetten,25 - 30 Jahre,106,55,51
False,8425130,Weidenstetten,30 - 35 Jahre,103,65,38
False,8425130,Weidenstetten,35 - 40 Jahre,100,48,52
False,8425130,Weidenstetten,40 - 45 Jahre,82,46,36
False,8425130,Weidenstetten,45 - 50 Jahre,63,35,28
False,8425130,Weidenstetten,50 - 55 Jahre,61,32,29
False,8425130,Weidenstetten,55 - 60 Jahre,99,42,57
False,8425130,Weidenstetten,60 - 65 Jahre,75,43,32
False,8425130,Weidenstetten,65 - 75 Jahre,95,49,46
False,8425130,Weidenstetten,75 und mehr Jahre,53,11,42
False,8425130,Weidenstetten,Insgesamt,1191,606,585
False,8425134,Westerheim,unter 3 Jahre,96,52,44
False,8425134,Westerheim,3 -  6 Jahre,104,57,47
False,8425134,Westerheim,6 - 10 Jahre,154,83,71
False,8425134,Westerheim,10 - 15 Jahre,190,88,102
False,8425134,Westerheim,15 - 18 Jahre,88,44,44
False,8425134,Westerheim,18 - 20 Jahre,54,25,29
False,8425134,Westerheim,20 - 25 Jahre,190,104,86
False,8425134,Westerheim,25 - 30 Jahre,204,115,89
False,8425134,Westerheim,30 - 35 Jahre,228,113,115
False,8425134,Westerheim,35 - 40 Jahre,198,96,102
False,8425134,Westerheim,40 - 45 Jahre,196,102,94
False,8425134,Westerheim,45 - 50 Jahre,153,79,74
False,8425134,Westerheim,50 - 55 Jahre,157,73,84
False,8425134,Westerheim,55 - 60 Jahre,212,114,98
False,8425134,Westerheim,60 - 65 Jahre,131,62,69
False,8425134,Westerheim,65 - 75 Jahre,180,81,99
False,8425134,Westerheim,75 und mehr Jahre,109,22,87
False,8425134,Westerheim,Insgesamt,2644,1310,1334
False,8425135,Westerstetten,unter 3 Jahre,84,34,50
False,8425135,Westerstetten,3 -  6 Jahre,102,55,47
False,8425135,Westerstetten,6 - 10 Jahre,126,61,65
False,8425135,Westerstetten,10 - 15 Jahre,136,80,56
False,8425135,Westerstetten,15 - 18 Jahre,73,37,36
False,8425135,Westerstetten,18 - 20 Jahre,47,29,18
False,8425135,Westerstetten,20 - 25 Jahre,133,61,72
False,8425135,Westerstetten,25 - 30 Jahre,148,74,74
False,8425135,Westerstetten,30 - 35 Jahre,186,94,92
False,8425135,Westerstetten,35 - 40 Jahre,192,90,102
False,8425135,Westerstetten,40 - 45 Jahre,153,94,59
False,8425135,Westerstetten,45 - 50 Jahre,115,54,61
False,8425135,Westerstetten,50 - 55 Jahre,111,60,51
False,8425135,Westerstetten,55 - 60 Jahre,98,51,47
False,8425135,Westerstetten,60 - 65 Jahre,84,39,45
False,8425135,Westerstetten,65 - 75 Jahre,133,58,75
False,8425135,Westerstetten,75 und mehr Jahre,101,29,72
False,8425135,Westerstetten,Insgesamt,2022,1000,1022
False,8425137,Illerkirchberg,unter 3 Jahre,154,74,80
False,8425137,Illerkirchberg,3 -  6 Jahre,159,83,76
False,8425137,Illerkirchberg,6 - 10 Jahre,210,94,116
False,8425137,Illerkirchberg,10 - 15 Jahre,248,132,116
False,8425137,Illerkirchberg,15 - 18 Jahre,150,83,67
False,8425137,Illerkirchberg,18 - 20 Jahre,80,41,39
False,8425137,Illerkirchberg,20 - 25 Jahre,268,121,147
False,8425137,Illerkirchberg,25 - 30 Jahre,330,172,158
False,8425137,Illerkirchberg,30 - 35 Jahre,381,193,188
False,8425137,Illerkirchberg,35 - 40 Jahre,358,183,175
False,8425137,Illerkirchberg,40 - 45 Jahre,360,199,161
False,8425137,Illerkirchberg,45 - 50 Jahre,284,148,136
False,8425137,Illerkirchberg,50 - 55 Jahre,262,135,127
False,8425137,Illerkirchberg,55 - 60 Jahre,300,153,147
False,8425137,Illerkirchberg,60 - 65 Jahre,213,109,104
False,8425137,Illerkirchberg,65 - 75 Jahre,389,172,217
False,8425137,Illerkirchberg,75 und mehr Jahre,212,61,151
False,8425137,Illerkirchberg,Insgesamt,4358,2153,2205
False,8425138,Staig,unter 3 Jahre,100,55,45
False,8425138,Staig,3 -  6 Jahre,107,52,55
False,8425138,Staig,6 - 10 Jahre,142,69,73
False,8425138,Staig,10 - 15 Jahre,185,104,81
False,8425138,Staig,15 - 18 Jahre,103,46,57
False,8425138,Staig,18 - 20 Jahre,67,34,33
False,8425138,Staig,20 - 25 Jahre,161,83,78
False,8425138,Staig,25 - 30 Jahre,252,142,110
False,8425138,Staig,30 - 35 Jahre,280,124,156
False,8425138,Staig,35 - 40 Jahre,245,124,121
False,8425138,Staig,40 - 45 Jahre,211,114,97
False,8425138,Staig,45 - 50 Jahre,192,105,87
False,8425138,Staig,50 - 55 Jahre,179,95,84
False,8425138,Staig,55 - 60 Jahre,229,127,102
False,8425138,Staig,60 - 65 Jahre,147,74,73
False,8425138,Staig,65 - 75 Jahre,233,105,128
False,8425138,Staig,75 und mehr Jahre,115,33,82
False,8425138,Staig,Insgesamt,2948,1486,1462
False,8425139,Heroldstatt,unter 3 Jahre,101,52,49
False,8425139,Heroldstatt,3 -  6 Jahre,113,61,52
False,8425139,Heroldstatt,6 - 10 Jahre,121,68,53
False,8425139,Heroldstatt,10 - 15 Jahre,114,63,51
False,8425139,Heroldstatt,15 - 18 Jahre,71,32,39
False,8425139,Heroldstatt,18 - 20 Jahre,59,31,28
False,8425139,Heroldstatt,20 - 25 Jahre,129,66,63
False,8425139,Heroldstatt,25 - 30 Jahre,187,89,98
False,8425139,Heroldstatt,30 - 35 Jahre,243,131,112
False,8425139,Heroldstatt,35 - 40 Jahre,182,100,82
False,8425139,Heroldstatt,40 - 45 Jahre,145,74,71
False,8425139,Heroldstatt,45 - 50 Jahre,137,74,63
False,8425139,Heroldstatt,50 - 55 Jahre,114,60,54
False,8425139,Heroldstatt,55 - 60 Jahre,156,72,84
False,8425139,Heroldstatt,60 - 65 Jahre,118,62,56
False,8425139,Heroldstatt,65 - 75 Jahre,194,80,114
False,8425139,Heroldstatt,75 und mehr Jahre,102,30,72
False,8425139,Heroldstatt,Insgesamt,2286,1145,1141
False,8425140,Balzheim,unter 3 Jahre,80,38,42
False,8425140,Balzheim,3 -  6 Jahre,83,44,39
False,8425140,Balzheim,6 - 10 Jahre,120,74,46
False,8425140,Balzheim,10 - 15 Jahre,123,61,62
False,8425140,Balzheim,15 - 18 Jahre,62,32,30
False,8425140,Balzheim,18 - 20 Jahre,38,21,17
False,8425140,Balzheim,20 - 25 Jahre,84,47,37
False,8425140,Balzheim,25 - 30 Jahre,157,81,76
False,8425140,Balzheim,30 - 35 Jahre,159,85,74
False,8425140,Balzheim,35 - 40 Jahre,184,87,97
False,8425140,Balzheim,40 - 45 Jahre,134,82,52
False,8425140,Balzheim,45 - 50 Jahre,101,56,45
False,8425140,Balzheim,50 - 55 Jahre,84,38,46
False,8425140,Balzheim,55 - 60 Jahre,106,61,45
False,8425140,Balzheim,60 - 65 Jahre,90,42,48
False,8425140,Balzheim,65 - 75 Jahre,115,56,59
False,8425140,Balzheim,75 und mehr Jahre,105,30,75
False,8425140,Balzheim,Insgesamt,1825,935,890
False,8425141,Blaustein,unter 3 Jahre,502,259,243
False,8425141,Blaustein,3 -  6 Jahre,525,255,270
False,8425141,Blaustein,6 - 10 Jahre,650,326,324
False,8425141,Blaustein,10 - 15 Jahre,757,389,368
False,8425141,Blaustein,15 - 18 Jahre,452,228,224
False,8425141,Blaustein,18 - 20 Jahre,293,158,135
False,8425141,Blaustein,20 - 25 Jahre,909,496,413
False,8425141,Blaustein,25 - 30 Jahre,1391,746,645
False,8425141,Blaustein,30 - 35 Jahre,1373,714,659
False,8425141,Blaustein,35 - 40 Jahre,1124,575,549
False,8425141,Blaustein,40 - 45 Jahre,967,511,456
False,8425141,Blaustein,45 - 50 Jahre,850,433,417
False,8425141,Blaustein,50 - 55 Jahre,903,440,463
False,8425141,Blaustein,55 - 60 Jahre,1122,590,532
False,8425141,Blaustein,60 - 65 Jahre,735,354,381
False,8425141,Blaustein,65 - 75 Jahre,1276,577,699
False,8425141,Blaustein,75 und mehr Jahre,782,256,526
False,8425141,Blaustein,Insgesamt,14611,7307,7304
False,8426,Landkreis Biberach,unter 3 Jahre,6691,3425,3266
False,8426,Landkreis Biberach,3 -  6 Jahre,7396,3783,3613
False,8426,Landkreis Biberach,6 - 10 Jahre,9956,5152,4804
False,8426,Landkreis Biberach,10 - 15 Jahre,11171,5759,5412
False,8426,Landkreis Biberach,15 - 18 Jahre,6276,3222,3054
False,8426,Landkreis Biberach,18 - 20 Jahre,3984,2073,1911
False,8426,Landkreis Biberach,20 - 25 Jahre,10993,5700,5293
False,8426,Landkreis Biberach,25 - 30 Jahre,14532,7553,6979
False,8426,Landkreis Biberach,30 - 35 Jahre,15221,7970,7251
False,8426,Landkreis Biberach,35 - 40 Jahre,14017,7131,6886
False,8426,Landkreis Biberach,40 - 45 Jahre,11917,6153,5764
False,8426,Landkreis Biberach,45 - 50 Jahre,10181,5338,4843
False,8426,Landkreis Biberach,50 - 55 Jahre,8876,4569,4307
False,8426,Landkreis Biberach,55 - 60 Jahre,11450,5741,5709
False,8426,Landkreis Biberach,60 - 65 Jahre,8545,4260,4285
False,8426,Landkreis Biberach,65 - 75 Jahre,14372,5968,8404
False,8426,Landkreis Biberach,75 und mehr Jahre,10044,3105,6939
False,8426,Landkreis Biberach,Insgesamt,175622,86902,88720
False,8426001,Achstetten,unter 3 Jahre,148,70,78
False,8426001,Achstetten,3 -  6 Jahre,150,68,82
False,8426001,Achstetten,6 - 10 Jahre,227,113,114
False,8426001,Achstetten,10 - 15 Jahre,254,134,120
False,8426001,Achstetten,15 - 18 Jahre,136,77,59
False,8426001,Achstetten,18 - 20 Jahre,88,57,31
False,8426001,Achstetten,20 - 25 Jahre,226,121,105
False,8426001,Achstetten,25 - 30 Jahre,298,159,139
False,8426001,Achstetten,30 - 35 Jahre,333,158,175
False,8426001,Achstetten,35 - 40 Jahre,287,149,138
False,8426001,Achstetten,40 - 45 Jahre,260,121,139
False,8426001,Achstetten,45 - 50 Jahre,224,118,106
False,8426001,Achstetten,50 - 55 Jahre,167,94,73
False,8426001,Achstetten,55 - 60 Jahre,192,93,99
False,8426001,Achstetten,60 - 65 Jahre,147,81,66
False,8426001,Achstetten,65 - 75 Jahre,249,101,148
False,8426001,Achstetten,75 und mehr Jahre,133,40,93
False,8426001,Achstetten,Insgesamt,3519,1754,1765
False,8426005,Alleshausen,unter 3 Jahre,24,13,11
False,8426005,Alleshausen,3 -  6 Jahre,17,7,10
False,8426005,Alleshausen,6 - 10 Jahre,41,26,15
False,8426005,Alleshausen,10 - 15 Jahre,38,21,17
False,8426005,Alleshausen,15 - 18 Jahre,16,7,9
False,8426005,Alleshausen,18 - 20 Jahre,12,4,8
False,8426005,Alleshausen,20 - 25 Jahre,17,13,4
False,8426005,Alleshausen,25 - 30 Jahre,36,15,21
False,8426005,Alleshausen,30 - 35 Jahre,43,27,16
False,8426005,Alleshausen,35 - 40 Jahre,40,18,22
False,8426005,Alleshausen,40 - 45 Jahre,25,15,10
False,8426005,Alleshausen,45 - 50 Jahre,26,16,10
False,8426005,Alleshausen,50 - 55 Jahre,8,3,5
False,8426005,Alleshausen,55 - 60 Jahre,26,14,12
False,8426005,Alleshausen,60 - 65 Jahre,22,7,15
False,8426005,Alleshausen,65 - 75 Jahre,52,26,26
False,8426005,Alleshausen,75 und mehr Jahre,25,8,17
False,8426005,Alleshausen,Insgesamt,468,240,228
False,8426006,Allmannsweiler,unter 3 Jahre,17,7,10
False,8426006,Allmannsweiler,3 -  6 Jahre,18,8,10
False,8426006,Allmannsweiler,6 - 10 Jahre,23,13,10
False,8426006,Allmannsweiler,10 - 15 Jahre,20,12,8
False,8426006,Allmannsweiler,15 - 18 Jahre,13,5,8
False,8426006,Allmannsweiler,18 - 20 Jahre,7,7,0
False,8426006,Allmannsweiler,20 - 25 Jahre,13,5,8
False,8426006,Allmannsweiler,25 - 30 Jahre,24,10,14
False,8426006,Allmannsweiler,30 - 35 Jahre,37,15,22
False,8426006,Allmannsweiler,35 - 40 Jahre,26,13,13
False,8426006,Allmannsweiler,40 - 45 Jahre,18,12,6
False,8426006,Allmannsweiler,45 - 50 Jahre,13,6,7
False,8426006,Allmannsweiler,50 - 55 Jahre,13,7,6
False,8426006,Allmannsweiler,55 - 60 Jahre,21,13,8
False,8426006,Allmannsweiler,60 - 65 Jahre,12,3,9
False,8426006,Allmannsweiler,65 - 75 Jahre,16,11,5
False,8426006,Allmannsweiler,75 und mehr Jahre,11,6,5
False,8426006,Allmannsweiler,Insgesamt,302,153,149
False,8426008,Altheim,unter 3 Jahre,67,30,37
False,8426008,Altheim,3 -  6 Jahre,96,51,45
False,8426008,Altheim,6 - 10 Jahre,124,67,57
False,8426008,Altheim,10 - 15 Jahre,148,80,68
False,8426008,Altheim,15 - 18 Jahre,89,47,42
False,8426008,Altheim,18 - 20 Jahre,52,29,23
False,8426008,Altheim,20 - 25 Jahre,140,72,68
False,8426008,Altheim,25 - 30 Jahre,168,84,84
False,8426008,Altheim,30 - 35 Jahre,168,91,77
False,8426008,Altheim,35 - 40 Jahre,196,88,108
False,8426008,Altheim,40 - 45 Jahre,144,78,66
False,8426008,Altheim,45 - 50 Jahre,137,72,65
False,8426008,Altheim,50 - 55 Jahre,94,50,44
False,8426008,Altheim,55 - 60 Jahre,110,54,56
False,8426008,Altheim,60 - 65 Jahre,107,53,54
False,8426008,Altheim,65 - 75 Jahre,143,68,75
False,8426008,Altheim,75 und mehr Jahre,128,50,78
False,8426008,Altheim,Insgesamt,2111,1064,1047
False,8426011,Attenweiler,unter 3 Jahre,52,31,21
False,8426011,Attenweiler,3 -  6 Jahre,79,44,35
False,8426011,Attenweiler,6 - 10 Jahre,87,50,37
False,8426011,Attenweiler,10 - 15 Jahre,90,49,41
False,8426011,Attenweiler,15 - 18 Jahre,61,28,33
False,8426011,Attenweiler,18 - 20 Jahre,41,18,23
False,8426011,Attenweiler,20 - 25 Jahre,109,75,34
False,8426011,Attenweiler,25 - 30 Jahre,128,57,71
False,8426011,Attenweiler,30 - 35 Jahre,126,80,46
False,8426011,Attenweiler,35 - 40 Jahre,121,65,56
False,8426011,Attenweiler,40 - 45 Jahre,105,51,54
False,8426011,Attenweiler,45 - 50 Jahre,70,41,29
False,8426011,Attenweiler,50 - 55 Jahre,78,37,41
False,8426011,Attenweiler,55 - 60 Jahre,102,53,49
False,8426011,Attenweiler,60 - 65 Jahre,82,48,34
False,8426011,Attenweiler,65 - 75 Jahre,114,50,64
False,8426011,Attenweiler,75 und mehr Jahre,77,16,61
False,8426011,Attenweiler,Insgesamt,1522,793,729
False,8426013,"Bad Buchau, Stadt",unter 3 Jahre,146,69,77
False,8426013,"Bad Buchau, Stadt",3 -  6 Jahre,137,68,69
False,8426013,"Bad Buchau, Stadt",6 - 10 Jahre,212,124,88
False,8426013,"Bad Buchau, Stadt",10 - 15 Jahre,257,127,130
False,8426013,"Bad Buchau, Stadt",15 - 18 Jahre,119,63,56
False,8426013,"Bad Buchau, Stadt",18 - 20 Jahre,83,43,40
False,8426013,"Bad Buchau, Stadt",20 - 25 Jahre,232,121,111
False,8426013,"Bad Buchau, Stadt",25 - 30 Jahre,313,166,147
False,8426013,"Bad Buchau, Stadt",30 - 35 Jahre,332,185,147
False,8426013,"Bad Buchau, Stadt",35 - 40 Jahre,296,141,155
False,8426013,"Bad Buchau, Stadt",40 - 45 Jahre,239,113,126
False,8426013,"Bad Buchau, Stadt",45 - 50 Jahre,243,120,123
False,8426013,"Bad Buchau, Stadt",50 - 55 Jahre,226,122,104
False,8426013,"Bad Buchau, Stadt",55 - 60 Jahre,291,148,143
False,8426013,"Bad Buchau, Stadt",60 - 65 Jahre,233,109,124
False,8426013,"Bad Buchau, Stadt",65 - 75 Jahre,400,163,237
False,8426013,"Bad Buchau, Stadt",75 und mehr Jahre,386,111,275
False,8426013,"Bad Buchau, Stadt",Insgesamt,4145,1993,2152
False,8426014,"Bad Schussenried, Stadt",unter 3 Jahre,290,156,134
False,8426014,"Bad Schussenried, Stadt",3 -  6 Jahre,305,165,140
False,8426014,"Bad Schussenried, Stadt",6 - 10 Jahre,437,210,227
False,8426014,"Bad Schussenried, Stadt",10 - 15 Jahre,491,225,266
False,8426014,"Bad Schussenried, Stadt",15 - 18 Jahre,251,102,149
False,8426014,"Bad Schussenried, Stadt",18 - 20 Jahre,158,82,76
False,8426014,"Bad Schussenried, Stadt",20 - 25 Jahre,463,225,238
False,8426014,"Bad Schussenried, Stadt",25 - 30 Jahre,646,341,305
False,8426014,"Bad Schussenried, Stadt",30 - 35 Jahre,717,361,356
False,8426014,"Bad Schussenried, Stadt",35 - 40 Jahre,653,333,320
False,8426014,"Bad Schussenried, Stadt",40 - 45 Jahre,541,280,261
False,8426014,"Bad Schussenried, Stadt",45 - 50 Jahre,410,211,199
False,8426014,"Bad Schussenried, Stadt",50 - 55 Jahre,423,216,207
False,8426014,"Bad Schussenried, Stadt",55 - 60 Jahre,545,274,271
False,8426014,"Bad Schussenried, Stadt",60 - 65 Jahre,419,216,203
False,8426014,"Bad Schussenried, Stadt",65 - 75 Jahre,726,315,411
False,8426014,"Bad Schussenried, Stadt",75 und mehr Jahre,617,164,453
False,8426014,"Bad Schussenried, Stadt",Insgesamt,8092,3876,4216
False,8426019,Berkheim,unter 3 Jahre,104,61,43
False,8426019,Berkheim,3 -  6 Jahre,97,48,49
False,8426019,Berkheim,6 - 10 Jahre,157,79,78
False,8426019,Berkheim,10 - 15 Jahre,194,99,95
False,8426019,Berkheim,15 - 18 Jahre,117,53,64
False,8426019,Berkheim,18 - 20 Jahre,71,39,32
False,8426019,Berkheim,20 - 25 Jahre,199,81,118
False,8426019,Berkheim,25 - 30 Jahre,189,92,97
False,8426019,Berkheim,30 - 35 Jahre,191,97,94
False,8426019,Berkheim,35 - 40 Jahre,163,86,77
False,8426019,Berkheim,40 - 45 Jahre,195,99,96
False,8426019,Berkheim,45 - 50 Jahre,159,89,70
False,8426019,Berkheim,50 - 55 Jahre,112,56,56
False,8426019,Berkheim,55 - 60 Jahre,136,76,60
False,8426019,Berkheim,60 - 65 Jahre,97,44,53
False,8426019,Berkheim,65 - 75 Jahre,172,71,101
False,8426019,Berkheim,75 und mehr Jahre,139,39,100
False,8426019,Berkheim,Insgesamt,2492,1209,1283
False,8426020,Betzenweiler,unter 3 Jahre,24,12,12
False,8426020,Betzenweiler,3 -  6 Jahre,33,20,13
False,8426020,Betzenweiler,6 - 10 Jahre,45,20,25
False,8426020,Betzenweiler,10 - 15 Jahre,53,28,25
False,8426020,Betzenweiler,15 - 18 Jahre,26,13,13
False,8426020,Betzenweiler,18 - 20 Jahre,16,9,7
False,8426020,Betzenweiler,20 - 25 Jahre,35,23,12
False,8426020,Betzenweiler,25 - 30 Jahre,64,34,30
False,8426020,Betzenweiler,30 - 35 Jahre,59,36,23
False,8426020,Betzenweiler,35 - 40 Jahre,47,18,29
False,8426020,Betzenweiler,40 - 45 Jahre,48,30,18
False,8426020,Betzenweiler,45 - 50 Jahre,37,21,16
False,8426020,Betzenweiler,50 - 55 Jahre,26,11,15
False,8426020,Betzenweiler,55 - 60 Jahre,38,18,20
False,8426020,Betzenweiler,60 - 65 Jahre,32,18,14
False,8426020,Betzenweiler,65 - 75 Jahre,49,18,31
False,8426020,Betzenweiler,75 und mehr Jahre,23,10,13
False,8426020,Betzenweiler,Insgesamt,655,339,316
False,8426021,"Biberach an der Riß, Stadt",unter 3 Jahre,952,483,469
False,8426021,"Biberach an der Riß, Stadt",3 -  6 Jahre,1073,559,514
False,8426021,"Biberach an der Riß, Stadt",6 - 10 Jahre,1446,754,692
False,8426021,"Biberach an der Riß, Stadt",10 - 15 Jahre,1609,823,786
False,8426021,"Biberach an der Riß, Stadt",15 - 18 Jahre,1014,524,490
False,8426021,"Biberach an der Riß, Stadt",18 - 20 Jahre,704,380,324
False,8426021,"Biberach an der Riß, Stadt",20 - 25 Jahre,1824,912,912
False,8426021,"Biberach an der Riß, Stadt",25 - 30 Jahre,2511,1281,1230
False,8426021,"Biberach an der Riß, Stadt",30 - 35 Jahre,2540,1326,1214
False,8426021,"Biberach an der Riß, Stadt",35 - 40 Jahre,2305,1133,1172
False,8426021,"Biberach an der Riß, Stadt",40 - 45 Jahre,2036,999,1037
False,8426021,"Biberach an der Riß, Stadt",45 - 50 Jahre,1880,939,941
False,8426021,"Biberach an der Riß, Stadt",50 - 55 Jahre,1719,866,853
False,8426021,"Biberach an der Riß, Stadt",55 - 60 Jahre,2303,1090,1213
False,8426021,"Biberach an der Riß, Stadt",60 - 65 Jahre,1759,836,923
False,8426021,"Biberach an der Riß, Stadt",65 - 75 Jahre,3071,1237,1834
False,8426021,"Biberach an der Riß, Stadt",75 und mehr Jahre,2116,667,1449
False,8426021,"Biberach an der Riß, Stadt",Insgesamt,30862,14809,16053
False,8426028,Burgrieden,unter 3 Jahre,147,77,70
False,8426028,Burgrieden,3 -  6 Jahre,160,83,77
False,8426028,Burgrieden,6 - 10 Jahre,176,105,71
False,8426028,Burgrieden,10 - 15 Jahre,211,106,105
False,8426028,Burgrieden,15 - 18 Jahre,110,65,45
False,8426028,Burgrieden,18 - 20 Jahre,81,42,39
False,8426028,Burgrieden,20 - 25 Jahre,182,89,93
False,8426028,Burgrieden,25 - 30 Jahre,313,159,154
False,8426028,Burgrieden,30 - 35 Jahre,342,195,147
False,8426028,Burgrieden,35 - 40 Jahre,299,159,140
False,8426028,Burgrieden,40 - 45 Jahre,228,115,113
False,8426028,Burgrieden,45 - 50 Jahre,172,92,80
False,8426028,Burgrieden,50 - 55 Jahre,163,97,66
False,8426028,Burgrieden,55 - 60 Jahre,175,79,96
False,8426028,Burgrieden,60 - 65 Jahre,145,64,81
False,8426028,Burgrieden,65 - 75 Jahre,252,114,138
False,8426028,Burgrieden,75 und mehr Jahre,124,36,88
False,8426028,Burgrieden,Insgesamt,3280,1677,1603
False,8426031,Dettingen an der Iller,unter 3 Jahre,81,40,41
False,8426031,Dettingen an der Iller,3 -  6 Jahre,118,64,54
False,8426031,Dettingen an der Iller,6 - 10 Jahre,155,71,84
False,8426031,Dettingen an der Iller,10 - 15 Jahre,147,62,85
False,8426031,Dettingen an der Iller,15 - 18 Jahre,61,37,24
False,8426031,Dettingen an der Iller,18 - 20 Jahre,36,13,23
False,8426031,Dettingen an der Iller,20 - 25 Jahre,89,49,40
False,8426031,Dettingen an der Iller,25 - 30 Jahre,143,79,64
False,8426031,Dettingen an der Iller,30 - 35 Jahre,193,89,104
False,8426031,Dettingen an der Iller,35 - 40 Jahre,176,94,82
False,8426031,Dettingen an der Iller,40 - 45 Jahre,132,71,61
False,8426031,Dettingen an der Iller,45 - 50 Jahre,83,49,34
False,8426031,Dettingen an der Iller,50 - 55 Jahre,95,49,46
False,8426031,Dettingen an der Iller,55 - 60 Jahre,113,55,58
False,8426031,Dettingen an der Iller,60 - 65 Jahre,107,55,52
False,8426031,Dettingen an der Iller,65 - 75 Jahre,125,61,64
False,8426031,Dettingen an der Iller,75 und mehr Jahre,75,30,45
False,8426031,Dettingen an der Iller,Insgesamt,1929,968,961
False,8426035,Dürmentingen,unter 3 Jahre,84,47,37
False,8426035,Dürmentingen,3 -  6 Jahre,108,53,55
False,8426035,Dürmentingen,6 - 10 Jahre,147,77,70
False,8426035,Dürmentingen,10 - 15 Jahre,193,109,84
False,8426035,Dürmentingen,15 - 18 Jahre,116,54,62
False,8426035,Dürmentingen,18 - 20 Jahre,69,30,39
False,8426035,Dürmentingen,20 - 25 Jahre,140,84,56
False,8426035,Dürmentingen,25 - 30 Jahre,176,104,72
False,8426035,Dürmentingen,30 - 35 Jahre,190,91,99
False,8426035,Dürmentingen,35 - 40 Jahre,194,104,90
False,8426035,Dürmentingen,40 - 45 Jahre,158,86,72
False,8426035,Dürmentingen,45 - 50 Jahre,138,68,70
False,8426035,Dürmentingen,50 - 55 Jahre,91,46,45
False,8426035,Dürmentingen,55 - 60 Jahre,154,77,77
False,8426035,Dürmentingen,60 - 65 Jahre,135,62,73
False,8426035,Dürmentingen,65 - 75 Jahre,209,88,121
False,8426035,Dürmentingen,75 und mehr Jahre,144,41,103
False,8426035,Dürmentingen,Insgesamt,2446,1221,1225
False,8426036,Dürnau,unter 3 Jahre,13,8,5
False,8426036,Dürnau,3 -  6 Jahre,23,13,10
False,8426036,Dürnau,6 - 10 Jahre,21,11,10
False,8426036,Dürnau,10 - 15 Jahre,34,20,14
False,8426036,Dürnau,15 - 18 Jahre,20,10,10
False,8426036,Dürnau,18 - 20 Jahre,8,5,3
False,8426036,Dürnau,20 - 25 Jahre,35,15,20
False,8426036,Dürnau,25 - 30 Jahre,39,16,23
False,8426036,Dürnau,30 - 35 Jahre,43,22,21
False,8426036,Dürnau,35 - 40 Jahre,24,14,10
False,8426036,Dürnau,40 - 45 Jahre,32,13,19
False,8426036,Dürnau,45 - 50 Jahre,29,16,13
False,8426036,Dürnau,50 - 55 Jahre,13,4,9
False,8426036,Dürnau,55 - 60 Jahre,24,14,10
False,8426036,Dürnau,60 - 65 Jahre,23,12,11
False,8426036,Dürnau,65 - 75 Jahre,36,16,20
False,8426036,Dürnau,75 und mehr Jahre,24,10,14
False,8426036,Dürnau,Insgesamt,441,219,222
False,8426038,Eberhardzell,unter 3 Jahre,162,87,75
False,8426038,Eberhardzell,3 -  6 Jahre,179,99,80
False,8426038,Eberhardzell,6 - 10 Jahre,235,137,98
False,8426038,Eberhardzell,10 - 15 Jahre,237,129,108
False,8426038,Eberhardzell,15 - 18 Jahre,124,63,61
False,8426038,Eberhardzell,18 - 20 Jahre,91,44,47
False,8426038,Eberhardzell,20 - 25 Jahre,204,96,108
False,8426038,Eberhardzell,25 - 30 Jahre,333,176,157
False,8426038,Eberhardzell,30 - 35 Jahre,332,169,163
False,8426038,Eberhardzell,35 - 40 Jahre,322,152,170
False,8426038,Eberhardzell,40 - 45 Jahre,271,154,117
False,8426038,Eberhardzell,45 - 50 Jahre,184,114,70
False,8426038,Eberhardzell,50 - 55 Jahre,159,79,80
False,8426038,Eberhardzell,55 - 60 Jahre,215,116,99
False,8426038,Eberhardzell,60 - 65 Jahre,143,67,76
False,8426038,Eberhardzell,65 - 75 Jahre,253,108,145
False,8426038,Eberhardzell,75 und mehr Jahre,213,64,149
False,8426038,Eberhardzell,Insgesamt,3657,1854,1803
False,8426043,Erlenmoos,unter 3 Jahre,57,33,24
False,8426043,Erlenmoos,3 -  6 Jahre,62,36,26
False,8426043,Erlenmoos,6 - 10 Jahre,82,40,42
False,8426043,Erlenmoos,10 - 15 Jahre,98,42,56
False,8426043,Erlenmoos,15 - 18 Jahre,57,31,26
False,8426043,Erlenmoos,18 - 20 Jahre,31,16,15
False,8426043,Erlenmoos,20 - 25 Jahre,113,62,51
False,8426043,Erlenmoos,25 - 30 Jahre,134,72,62
False,8426043,Erlenmoos,30 - 35 Jahre,107,64,43
False,8426043,Erlenmoos,35 - 40 Jahre,115,57,58
False,8426043,Erlenmoos,40 - 45 Jahre,99,49,50
False,8426043,Erlenmoos,45 - 50 Jahre,91,56,35
False,8426043,Erlenmoos,50 - 55 Jahre,59,29,30
False,8426043,Erlenmoos,55 - 60 Jahre,110,56,54
False,8426043,Erlenmoos,60 - 65 Jahre,77,48,29
False,8426043,Erlenmoos,65 - 75 Jahre,106,43,63
False,8426043,Erlenmoos,75 und mehr Jahre,49,16,33
False,8426043,Erlenmoos,Insgesamt,1447,750,697
False,8426044,Erolzheim,unter 3 Jahre,123,66,57
False,8426044,Erolzheim,3 -  6 Jahre,133,66,67
False,8426044,Erolzheim,6 - 10 Jahre,180,85,95
False,8426044,Erolzheim,10 - 15 Jahre,234,117,117
False,8426044,Erolzheim,15 - 18 Jahre,95,49,46
False,8426044,Erolzheim,18 - 20 Jahre,71,36,35
False,8426044,Erolzheim,20 - 25 Jahre,163,84,79
False,8426044,Erolzheim,25 - 30 Jahre,234,101,133
False,8426044,Erolzheim,30 - 35 Jahre,259,131,128
False,8426044,Erolzheim,35 - 40 Jahre,244,123,121
False,8426044,Erolzheim,40 - 45 Jahre,202,103,99
False,8426044,Erolzheim,45 - 50 Jahre,157,86,71
False,8426044,Erolzheim,50 - 55 Jahre,123,67,56
False,8426044,Erolzheim,55 - 60 Jahre,164,80,84
False,8426044,Erolzheim,60 - 65 Jahre,113,57,56
False,8426044,Erolzheim,65 - 75 Jahre,211,86,125
False,8426044,Erolzheim,75 und mehr Jahre,150,59,91
False,8426044,Erolzheim,Insgesamt,2856,1396,1460
False,8426045,Ertingen,unter 3 Jahre,210,111,99
False,8426045,Ertingen,3 -  6 Jahre,246,129,117
False,8426045,Ertingen,6 - 10 Jahre,360,201,159
False,8426045,Ertingen,10 - 15 Jahre,355,183,172
False,8426045,Ertingen,15 - 18 Jahre,175,95,80
False,8426045,Ertingen,18 - 20 Jahre,122,62,60
False,8426045,Ertingen,20 - 25 Jahre,375,187,188
False,8426045,Ertingen,25 - 30 Jahre,434,212,222
False,8426045,Ertingen,30 - 35 Jahre,450,219,231
False,8426045,Ertingen,35 - 40 Jahre,413,204,209
False,8426045,Ertingen,40 - 45 Jahre,353,188,165
False,8426045,Ertingen,45 - 50 Jahre,276,145,131
False,8426045,Ertingen,50 - 55 Jahre,220,117,103
False,8426045,Ertingen,55 - 60 Jahre,326,176,150
False,8426045,Ertingen,60 - 65 Jahre,248,110,138
False,8426045,Ertingen,65 - 75 Jahre,434,186,248
False,8426045,Ertingen,75 und mehr Jahre,314,88,226
False,8426045,Ertingen,Insgesamt,5311,2613,2698
False,8426058,Hochdorf,unter 3 Jahre,90,42,48
False,8426058,Hochdorf,3 -  6 Jahre,93,48,45
False,8426058,Hochdorf,6 - 10 Jahre,105,54,51
False,8426058,Hochdorf,10 - 15 Jahre,133,70,63
False,8426058,Hochdorf,15 - 18 Jahre,85,39,46
False,8426058,Hochdorf,18 - 20 Jahre,42,20,22
False,8426058,Hochdorf,20 - 25 Jahre,124,58,66
False,8426058,Hochdorf,25 - 30 Jahre,158,89,69
False,8426058,Hochdorf,30 - 35 Jahre,188,101,87
False,8426058,Hochdorf,35 - 40 Jahre,145,69,76
False,8426058,Hochdorf,40 - 45 Jahre,133,74,59
False,8426058,Hochdorf,45 - 50 Jahre,149,73,76
False,8426058,Hochdorf,50 - 55 Jahre,104,56,48
False,8426058,Hochdorf,55 - 60 Jahre,125,68,57
False,8426058,Hochdorf,60 - 65 Jahre,81,42,39
False,8426058,Hochdorf,65 - 75 Jahre,147,70,77
False,8426058,Hochdorf,75 und mehr Jahre,95,29,66
False,8426058,Hochdorf,Insgesamt,1997,1002,995
False,8426062,Ingoldingen,unter 3 Jahre,112,51,61
False,8426062,Ingoldingen,3 -  6 Jahre,124,70,54
False,8426062,Ingoldingen,6 - 10 Jahre,168,80,88
False,8426062,Ingoldingen,10 - 15 Jahre,181,83,98
False,8426062,Ingoldingen,15 - 18 Jahre,109,57,52
False,8426062,Ingoldingen,18 - 20 Jahre,77,42,35
False,8426062,Ingoldingen,20 - 25 Jahre,157,79,78
False,8426062,Ingoldingen,25 - 30 Jahre,206,116,90
False,8426062,Ingoldingen,30 - 35 Jahre,183,101,82
False,8426062,Ingoldingen,35 - 40 Jahre,210,107,103
False,8426062,Ingoldingen,40 - 45 Jahre,203,104,99
False,8426062,Ingoldingen,45 - 50 Jahre,168,87,81
False,8426062,Ingoldingen,50 - 55 Jahre,150,86,64
False,8426062,Ingoldingen,55 - 60 Jahre,137,75,62
False,8426062,Ingoldingen,60 - 65 Jahre,108,57,51
False,8426062,Ingoldingen,65 - 75 Jahre,198,91,107
False,8426062,Ingoldingen,75 und mehr Jahre,145,50,95
False,8426062,Ingoldingen,Insgesamt,2636,1336,1300
False,8426064,Kanzach,unter 3 Jahre,19,10,9
False,8426064,Kanzach,3 -  6 Jahre,31,17,14
False,8426064,Kanzach,6 - 10 Jahre,34,17,17
False,8426064,Kanzach,10 - 15 Jahre,44,21,23
False,8426064,Kanzach,15 - 18 Jahre,21,11,10
False,8426064,Kanzach,18 - 20 Jahre,5,3,2
False,8426064,Kanzach,20 - 25 Jahre,22,10,12
False,8426064,Kanzach,25 - 30 Jahre,22,17,5
False,8426064,Kanzach,30 - 35 Jahre,49,23,26
False,8426064,Kanzach,35 - 40 Jahre,46,23,23
False,8426064,Kanzach,40 - 45 Jahre,44,27,17
False,8426064,Kanzach,45 - 50 Jahre,19,10,9
False,8426064,Kanzach,50 - 55 Jahre,15,7,8
False,8426064,Kanzach,55 - 60 Jahre,32,19,13
False,8426064,Kanzach,60 - 65 Jahre,18,7,11
False,8426064,Kanzach,65 - 75 Jahre,50,21,29
False,8426064,Kanzach,75 und mehr Jahre,30,12,18
False,8426064,Kanzach,Insgesamt,501,255,246
False,8426065,Kirchberg an der Iller,unter 3 Jahre,54,27,27
False,8426065,Kirchberg an der Iller,3 -  6 Jahre,80,47,33
False,8426065,Kirchberg an der Iller,6 - 10 Jahre,108,52,56
False,8426065,Kirchberg an der Iller,10 - 15 Jahre,134,78,56
False,8426065,Kirchberg an der Iller,15 - 18 Jahre,84,26,58
False,8426065,Kirchberg an der Iller,18 - 20 Jahre,41,21,20
False,8426065,Kirchberg an der Iller,20 - 25 Jahre,94,57,37
False,8426065,Kirchberg an der Iller,25 - 30 Jahre,134,68,66
False,8426065,Kirchberg an der Iller,30 - 35 Jahre,127,66,61
False,8426065,Kirchberg an der Iller,35 - 40 Jahre,121,59,62
False,8426065,Kirchberg an der Iller,40 - 45 Jahre,129,66,63
False,8426065,Kirchberg an der Iller,45 - 50 Jahre,110,54,56
False,8426065,Kirchberg an der Iller,50 - 55 Jahre,100,60,40
False,8426065,Kirchberg an der Iller,55 - 60 Jahre,110,53,57
False,8426065,Kirchberg an der Iller,60 - 65 Jahre,78,39,39
False,8426065,Kirchberg an der Iller,65 - 75 Jahre,157,76,81
False,8426065,Kirchberg an der Iller,75 und mehr Jahre,85,18,67
False,8426065,Kirchberg an der Iller,Insgesamt,1746,867,879
False,8426066,Kirchdorf an der Iller,unter 3 Jahre,119,60,59
False,8426066,Kirchdorf an der Iller,3 -  6 Jahre,165,76,89
False,8426066,Kirchdorf an der Iller,6 - 10 Jahre,226,110,116
False,8426066,Kirchdorf an der Iller,10 - 15 Jahre,246,137,109
False,8426066,Kirchdorf an der Iller,15 - 18 Jahre,123,67,56
False,8426066,Kirchdorf an der Iller,18 - 20 Jahre,75,32,43
False,8426066,Kirchdorf an der Iller,20 - 25 Jahre,187,99,88
False,8426066,Kirchdorf an der Iller,25 - 30 Jahre,247,128,119
False,8426066,Kirchdorf an der Iller,30 - 35 Jahre,314,161,153
False,8426066,Kirchdorf an der Iller,35 - 40 Jahre,260,133,127
False,8426066,Kirchdorf an der Iller,40 - 45 Jahre,221,104,117
False,8426066,Kirchdorf an der Iller,45 - 50 Jahre,191,108,83
False,8426066,Kirchdorf an der Iller,50 - 55 Jahre,160,74,86
False,8426066,Kirchdorf an der Iller,55 - 60 Jahre,171,95,76
False,8426066,Kirchdorf an der Iller,60 - 65 Jahre,124,62,62
False,8426066,Kirchdorf an der Iller,65 - 75 Jahre,244,114,130
False,8426066,Kirchdorf an der Iller,75 und mehr Jahre,142,44,98
False,8426066,Kirchdorf an der Iller,Insgesamt,3215,1604,1611
False,8426067,Langenenslingen,unter 3 Jahre,163,87,76
False,8426067,Langenenslingen,3 -  6 Jahre,185,88,97
False,8426067,Langenenslingen,6 - 10 Jahre,229,114,115
False,8426067,Langenenslingen,10 - 15 Jahre,235,103,132
False,8426067,Langenenslingen,15 - 18 Jahre,128,67,61
False,8426067,Langenenslingen,18 - 20 Jahre,69,36,33
False,8426067,Langenenslingen,20 - 25 Jahre,220,103,117
False,8426067,Langenenslingen,25 - 30 Jahre,310,170,140
False,8426067,Langenenslingen,30 - 35 Jahre,292,147,145
False,8426067,Langenenslingen,35 - 40 Jahre,312,165,147
False,8426067,Langenenslingen,40 - 45 Jahre,194,110,84
False,8426067,Langenenslingen,45 - 50 Jahre,159,85,74
False,8426067,Langenenslingen,50 - 55 Jahre,130,66,64
False,8426067,Langenenslingen,55 - 60 Jahre,238,115,123
False,8426067,Langenenslingen,60 - 65 Jahre,182,92,90
False,8426067,Langenenslingen,65 - 75 Jahre,323,138,185
False,8426067,Langenenslingen,75 und mehr Jahre,187,55,132
False,8426067,Langenenslingen,Insgesamt,3556,1741,1815
False,8426070,"Laupheim, Stadt",unter 3 Jahre,618,337,281
False,8426070,"Laupheim, Stadt",3 -  6 Jahre,658,321,337
False,8426070,"Laupheim, Stadt",6 - 10 Jahre,948,509,439
False,8426070,"Laupheim, Stadt",10 - 15 Jahre,1126,570,556
False,8426070,"Laupheim, Stadt",15 - 18 Jahre,622,330,292
False,8426070,"Laupheim, Stadt",18 - 20 Jahre,401,204,197
False,8426070,"Laupheim, Stadt",20 - 25 Jahre,1165,616,549
False,8426070,"Laupheim, Stadt",25 - 30 Jahre,1503,793,710
False,8426070,"Laupheim, Stadt",30 - 35 Jahre,1546,827,719
False,8426070,"Laupheim, Stadt",35 - 40 Jahre,1412,713,699
False,8426070,"Laupheim, Stadt",40 - 45 Jahre,1212,645,567
False,8426070,"Laupheim, Stadt",45 - 50 Jahre,1127,585,542
False,8426070,"Laupheim, Stadt",50 - 55 Jahre,1017,516,501
False,8426070,"Laupheim, Stadt",55 - 60 Jahre,1191,600,591
False,8426070,"Laupheim, Stadt",60 - 65 Jahre,800,394,406
False,8426070,"Laupheim, Stadt",65 - 75 Jahre,1383,538,845
False,8426070,"Laupheim, Stadt",75 und mehr Jahre,1021,272,749
False,8426070,"Laupheim, Stadt",Insgesamt,17750,8770,8980
False,8426071,Maselheim,unter 3 Jahre,195,101,94
False,8426071,Maselheim,3 -  6 Jahre,197,111,86
False,8426071,Maselheim,6 - 10 Jahre,305,143,162
False,8426071,Maselheim,10 - 15 Jahre,272,135,137
False,8426071,Maselheim,15 - 18 Jahre,136,70,66
False,8426071,Maselheim,18 - 20 Jahre,96,41,55
False,8426071,Maselheim,20 - 25 Jahre,249,151,98
False,8426071,Maselheim,25 - 30 Jahre,401,201,200
False,8426071,Maselheim,30 - 35 Jahre,447,220,227
False,8426071,Maselheim,35 - 40 Jahre,379,200,179
False,8426071,Maselheim,40 - 45 Jahre,334,167,167
False,8426071,Maselheim,45 - 50 Jahre,266,147,119
False,8426071,Maselheim,50 - 55 Jahre,210,106,104
False,8426071,Maselheim,55 - 60 Jahre,293,144,149
False,8426071,Maselheim,60 - 65 Jahre,185,88,97
False,8426071,Maselheim,65 - 75 Jahre,335,140,195
False,8426071,Maselheim,75 und mehr Jahre,218,79,139
False,8426071,Maselheim,Insgesamt,4518,2244,2274
False,8426073,Mietingen,unter 3 Jahre,176,97,79
False,8426073,Mietingen,3 -  6 Jahre,179,93,86
False,8426073,Mietingen,6 - 10 Jahre,227,115,112
False,8426073,Mietingen,10 - 15 Jahre,276,145,131
False,8426073,Mietingen,15 - 18 Jahre,150,80,70
False,8426073,Mietingen,18 - 20 Jahre,87,50,37
False,8426073,Mietingen,20 - 25 Jahre,250,139,111
False,8426073,Mietingen,25 - 30 Jahre,315,166,149
False,8426073,Mietingen,30 - 35 Jahre,378,201,177
False,8426073,Mietingen,35 - 40 Jahre,318,160,158
False,8426073,Mietingen,40 - 45 Jahre,251,133,118
False,8426073,Mietingen,45 - 50 Jahre,221,116,105
False,8426073,Mietingen,50 - 55 Jahre,156,80,76
False,8426073,Mietingen,55 - 60 Jahre,179,94,85
False,8426073,Mietingen,60 - 65 Jahre,132,68,64
False,8426073,Mietingen,65 - 75 Jahre,182,78,104
False,8426073,Mietingen,75 und mehr Jahre,122,48,74
False,8426073,Mietingen,Insgesamt,3599,1863,1736
False,8426074,Mittelbiberach,unter 3 Jahre,165,78,87
False,8426074,Mittelbiberach,3 -  6 Jahre,164,81,83
False,8426074,Mittelbiberach,6 - 10 Jahre,207,111,96
False,8426074,Mittelbiberach,10 - 15 Jahre,229,123,106
False,8426074,Mittelbiberach,15 - 18 Jahre,131,58,73
False,8426074,Mittelbiberach,18 - 20 Jahre,82,43,39
False,8426074,Mittelbiberach,20 - 25 Jahre,187,102,85
False,8426074,Mittelbiberach,25 - 30 Jahre,253,124,129
False,8426074,Mittelbiberach,30 - 35 Jahre,310,163,147
False,8426074,Mittelbiberach,35 - 40 Jahre,320,151,169
False,8426074,Mittelbiberach,40 - 45 Jahre,261,135,126
False,8426074,Mittelbiberach,45 - 50 Jahre,234,119,115
False,8426074,Mittelbiberach,50 - 55 Jahre,179,96,83
False,8426074,Mittelbiberach,55 - 60 Jahre,215,103,112
False,8426074,Mittelbiberach,60 - 65 Jahre,135,69,66
False,8426074,Mittelbiberach,65 - 75 Jahre,211,89,122
False,8426074,Mittelbiberach,75 und mehr Jahre,113,36,77
False,8426074,Mittelbiberach,Insgesamt,3396,1681,1715
False,8426078,Moosburg,unter 3 Jahre,9,4,5
False,8426078,Moosburg,3 -  6 Jahre,10,4,6
False,8426078,Moosburg,6 - 10 Jahre,14,8,6
False,8426078,Moosburg,10 - 15 Jahre,10,5,5
False,8426078,Moosburg,15 - 18 Jahre,6,4,2
False,8426078,Moosburg,18 - 20 Jahre,5,1,4
False,8426078,Moosburg,20 - 25 Jahre,11,7,4
False,8426078,Moosburg,25 - 30 Jahre,12,1,11
False,8426078,Moosburg,30 - 35 Jahre,7,6,1
False,8426078,Moosburg,35 - 40 Jahre,9,3,6
False,8426078,Moosburg,40 - 45 Jahre,19,12,7
False,8426078,Moosburg,45 - 50 Jahre,4,1,3
False,8426078,Moosburg,50 - 55 Jahre,10,4,6
False,8426078,Moosburg,55 - 60 Jahre,23,13,10
False,8426078,Moosburg,60 - 65 Jahre,11,3,8
False,8426078,Moosburg,65 - 75 Jahre,16,10,6
False,8426078,Moosburg,75 und mehr Jahre,14,5,9
False,8426078,Moosburg,Insgesamt,190,91,99
False,8426087,"Ochsenhausen, Stadt",unter 3 Jahre,367,173,194
False,8426087,"Ochsenhausen, Stadt",3 -  6 Jahre,330,165,165
False,8426087,"Ochsenhausen, Stadt",6 - 10 Jahre,468,234,234
False,8426087,"Ochsenhausen, Stadt",10 - 15 Jahre,512,278,234
False,8426087,"Ochsenhausen, Stadt",15 - 18 Jahre,295,162,133
False,8426087,"Ochsenhausen, Stadt",18 - 20 Jahre,168,79,89
False,8426087,"Ochsenhausen, Stadt",20 - 25 Jahre,522,252,270
False,8426087,"Ochsenhausen, Stadt",25 - 30 Jahre,746,380,366
False,8426087,"Ochsenhausen, Stadt",30 - 35 Jahre,662,355,307
False,8426087,"Ochsenhausen, Stadt",35 - 40 Jahre,698,370,328
False,8426087,"Ochsenhausen, Stadt",40 - 45 Jahre,548,285,263
False,8426087,"Ochsenhausen, Stadt",45 - 50 Jahre,430,233,197
False,8426087,"Ochsenhausen, Stadt",50 - 55 Jahre,350,176,174
False,8426087,"Ochsenhausen, Stadt",55 - 60 Jahre,492,245,247
False,8426087,"Ochsenhausen, Stadt",60 - 65 Jahre,397,200,197
False,8426087,"Ochsenhausen, Stadt",65 - 75 Jahre,605,244,361
False,8426087,"Ochsenhausen, Stadt",75 und mehr Jahre,413,131,282
False,8426087,"Ochsenhausen, Stadt",Insgesamt,8003,3962,4041
False,8426090,Oggelshausen,unter 3 Jahre,30,7,23
False,8426090,Oggelshausen,3 -  6 Jahre,48,29,19
False,8426090,Oggelshausen,6 - 10 Jahre,53,34,19
False,8426090,Oggelshausen,10 - 15 Jahre,38,22,16
False,8426090,Oggelshausen,15 - 18 Jahre,25,16,9
False,8426090,Oggelshausen,18 - 20 Jahre,21,13,8
False,8426090,Oggelshausen,20 - 25 Jahre,58,33,25
False,8426090,Oggelshausen,25 - 30 Jahre,64,33,31
False,8426090,Oggelshausen,30 - 35 Jahre,107,57,50
False,8426090,Oggelshausen,35 - 40 Jahre,81,50,31
False,8426090,Oggelshausen,40 - 45 Jahre,58,30,28
False,8426090,Oggelshausen,45 - 50 Jahre,27,12,15
False,8426090,Oggelshausen,50 - 55 Jahre,51,20,31
False,8426090,Oggelshausen,55 - 60 Jahre,62,30,32
False,8426090,Oggelshausen,60 - 65 Jahre,41,23,18
False,8426090,Oggelshausen,65 - 75 Jahre,84,34,50
False,8426090,Oggelshausen,75 und mehr Jahre,38,10,28
False,8426090,Oggelshausen,Insgesamt,886,453,433
False,8426097,"Riedlingen, Stadt",unter 3 Jahre,333,165,168
False,8426097,"Riedlingen, Stadt",3 -  6 Jahre,345,162,183
False,8426097,"Riedlingen, Stadt",6 - 10 Jahre,466,241,225
False,8426097,"Riedlingen, Stadt",10 - 15 Jahre,572,307,265
False,8426097,"Riedlingen, Stadt",15 - 18 Jahre,337,177,160
False,8426097,"Riedlingen, Stadt",18 - 20 Jahre,215,113,102
False,8426097,"Riedlingen, Stadt",20 - 25 Jahre,618,326,292
False,8426097,"Riedlingen, Stadt",25 - 30 Jahre,749,385,364
False,8426097,"Riedlingen, Stadt",30 - 35 Jahre,761,411,350
False,8426097,"Riedlingen, Stadt",35 - 40 Jahre,678,336,342
False,8426097,"Riedlingen, Stadt",40 - 45 Jahre,616,322,294
False,8426097,"Riedlingen, Stadt",45 - 50 Jahre,511,259,252
False,8426097,"Riedlingen, Stadt",50 - 55 Jahre,476,242,234
False,8426097,"Riedlingen, Stadt",55 - 60 Jahre,662,318,344
False,8426097,"Riedlingen, Stadt",60 - 65 Jahre,529,279,250
False,8426097,"Riedlingen, Stadt",65 - 75 Jahre,875,337,538
False,8426097,"Riedlingen, Stadt",75 und mehr Jahre,756,229,527
False,8426097,"Riedlingen, Stadt",Insgesamt,9499,4609,4890
False,8426100,Rot an der Rot,unter 3 Jahre,163,92,71
False,8426100,Rot an der Rot,3 -  6 Jahre,203,95,108
False,8426100,Rot an der Rot,6 - 10 Jahre,232,136,96
False,8426100,Rot an der Rot,10 - 15 Jahre,284,150,134
False,8426100,Rot an der Rot,15 - 18 Jahre,161,88,73
False,8426100,Rot an der Rot,18 - 20 Jahre,94,54,40
False,8426100,Rot an der Rot,20 - 25 Jahre,300,172,128
False,8426100,Rot an der Rot,25 - 30 Jahre,344,171,173
False,8426100,Rot an der Rot,30 - 35 Jahre,366,209,157
False,8426100,Rot an der Rot,35 - 40 Jahre,348,194,154
False,8426100,Rot an der Rot,40 - 45 Jahre,277,148,129
False,8426100,Rot an der Rot,45 - 50 Jahre,241,132,109
False,8426100,Rot an der Rot,50 - 55 Jahre,212,103,109
False,8426100,Rot an der Rot,55 - 60 Jahre,280,152,128
False,8426100,Rot an der Rot,60 - 65 Jahre,200,111,89
False,8426100,Rot an der Rot,65 - 75 Jahre,307,121,186
False,8426100,Rot an der Rot,75 und mehr Jahre,242,87,155
False,8426100,Rot an der Rot,Insgesamt,4254,2215,2039
False,8426108,Schwendi,unter 3 Jahre,257,134,123
False,8426108,Schwendi,3 -  6 Jahre,279,148,131
False,8426108,Schwendi,6 - 10 Jahre,335,160,175
False,8426108,Schwendi,10 - 15 Jahre,377,208,169
False,8426108,Schwendi,15 - 18 Jahre,198,108,90
False,8426108,Schwendi,18 - 20 Jahre,130,57,73
False,8426108,Schwendi,20 - 25 Jahre,398,211,187
False,8426108,Schwendi,25 - 30 Jahre,497,270,227
False,8426108,Schwendi,30 - 35 Jahre,539,280,259
False,8426108,Schwendi,35 - 40 Jahre,454,237,217
False,8426108,Schwendi,40 - 45 Jahre,380,191,189
False,8426108,Schwendi,45 - 50 Jahre,337,189,148
False,8426108,Schwendi,50 - 55 Jahre,294,158,136
False,8426108,Schwendi,55 - 60 Jahre,360,192,168
False,8426108,Schwendi,60 - 65 Jahre,274,145,129
False,8426108,Schwendi,65 - 75 Jahre,457,187,270
False,8426108,Schwendi,75 und mehr Jahre,294,89,205
False,8426108,Schwendi,Insgesamt,5860,2964,2896
False,8426109,Seekirch,unter 3 Jahre,13,6,7
False,8426109,Seekirch,3 -  6 Jahre,14,7,7
False,8426109,Seekirch,6 - 10 Jahre,5,1,4
False,8426109,Seekirch,10 - 15 Jahre,13,7,6
False,8426109,Seekirch,15 - 18 Jahre,6,1,5
False,8426109,Seekirch,18 - 20 Jahre,3,1,2
False,8426109,Seekirch,20 - 25 Jahre,16,4,12
False,8426109,Seekirch,25 - 30 Jahre,26,12,14
False,8426109,Seekirch,30 - 35 Jahre,25,13,12
False,8426109,Seekirch,35 - 40 Jahre,14,8,6
False,8426109,Seekirch,40 - 45 Jahre,13,5,8
False,8426109,Seekirch,45 - 50 Jahre,5,4,1
False,8426109,Seekirch,50 - 55 Jahre,11,3,8
False,8426109,Seekirch,55 - 60 Jahre,26,14,12
False,8426109,Seekirch,60 - 65 Jahre,15,7,8
False,8426109,Seekirch,65 - 75 Jahre,10,5,5
False,8426109,Seekirch,75 und mehr Jahre,8,3,5
False,8426109,Seekirch,Insgesamt,223,101,122
False,8426113,Steinhausen an der Rottum,unter 3 Jahre,77,41,36
False,8426113,Steinhausen an der Rottum,3 -  6 Jahre,83,35,48
False,8426113,Steinhausen an der Rottum,6 - 10 Jahre,115,53,62
False,8426113,Steinhausen an der Rottum,10 - 15 Jahre,99,58,41
False,8426113,Steinhausen an der Rottum,15 - 18 Jahre,61,29,32
False,8426113,Steinhausen an der Rottum,18 - 20 Jahre,44,21,23
False,8426113,Steinhausen an der Rottum,20 - 25 Jahre,110,68,42
False,8426113,Steinhausen an der Rottum,25 - 30 Jahre,171,86,85
False,8426113,Steinhausen an der Rottum,30 - 35 Jahre,169,94,75
False,8426113,Steinhausen an der Rottum,35 - 40 Jahre,139,78,61
False,8426113,Steinhausen an der Rottum,40 - 45 Jahre,111,61,50
False,8426113,Steinhausen an der Rottum,45 - 50 Jahre,86,45,41
False,8426113,Steinhausen an der Rottum,50 - 55 Jahre,60,32,28
False,8426113,Steinhausen an der Rottum,55 - 60 Jahre,106,52,54
False,8426113,Steinhausen an der Rottum,60 - 65 Jahre,86,49,37
False,8426113,Steinhausen an der Rottum,65 - 75 Jahre,147,62,85
False,8426113,Steinhausen an der Rottum,75 und mehr Jahre,91,29,62
False,8426113,Steinhausen an der Rottum,Insgesamt,1755,893,862
False,8426117,Tannheim,unter 3 Jahre,75,37,38
False,8426117,Tannheim,3 -  6 Jahre,87,46,41
False,8426117,Tannheim,6 - 10 Jahre,110,58,52
False,8426117,Tannheim,10 - 15 Jahre,153,85,68
False,8426117,Tannheim,15 - 18 Jahre,80,34,46
False,8426117,Tannheim,18 - 20 Jahre,44,22,22
False,8426117,Tannheim,20 - 25 Jahre,117,58,59
False,8426117,Tannheim,25 - 30 Jahre,182,107,75
False,8426117,Tannheim,30 - 35 Jahre,179,101,78
False,8426117,Tannheim,35 - 40 Jahre,176,96,80
False,8426117,Tannheim,40 - 45 Jahre,166,86,80
False,8426117,Tannheim,45 - 50 Jahre,104,58,46
False,8426117,Tannheim,50 - 55 Jahre,118,56,62
False,8426117,Tannheim,55 - 60 Jahre,143,69,74
False,8426117,Tannheim,60 - 65 Jahre,117,54,63
False,8426117,Tannheim,65 - 75 Jahre,188,81,107
False,8426117,Tannheim,75 und mehr Jahre,96,31,65
False,8426117,Tannheim,Insgesamt,2135,1079,1056
False,8426118,Tiefenbach,unter 3 Jahre,23,8,15
False,8426118,Tiefenbach,3 -  6 Jahre,13,6,7
False,8426118,Tiefenbach,6 - 10 Jahre,19,6,13
False,8426118,Tiefenbach,10 - 15 Jahre,32,11,21
False,8426118,Tiefenbach,15 - 18 Jahre,14,7,7
False,8426118,Tiefenbach,18 - 20 Jahre,7,4,3
False,8426118,Tiefenbach,20 - 25 Jahre,46,22,24
False,8426118,Tiefenbach,25 - 30 Jahre,52,30,22
False,8426118,Tiefenbach,30 - 35 Jahre,32,19,13
False,8426118,Tiefenbach,35 - 40 Jahre,29,13,16
False,8426118,Tiefenbach,40 - 45 Jahre,19,10,9
False,8426118,Tiefenbach,45 - 50 Jahre,17,9,8
False,8426118,Tiefenbach,50 - 55 Jahre,31,13,18
False,8426118,Tiefenbach,55 - 60 Jahre,33,19,14
False,8426118,Tiefenbach,60 - 65 Jahre,22,10,12
False,8426118,Tiefenbach,65 - 75 Jahre,32,17,15
False,8426118,Tiefenbach,75 und mehr Jahre,26,8,18
False,8426118,Tiefenbach,Insgesamt,447,212,235
False,8426120,Ummendorf,unter 3 Jahre,147,77,70
False,8426120,Ummendorf,3 -  6 Jahre,153,76,77
False,8426120,Ummendorf,6 - 10 Jahre,227,103,124
False,8426120,Ummendorf,10 - 15 Jahre,213,101,112
False,8426120,Ummendorf,15 - 18 Jahre,134,68,66
False,8426120,Ummendorf,18 - 20 Jahre,96,53,43
False,8426120,Ummendorf,20 - 25 Jahre,278,155,123
False,8426120,Ummendorf,25 - 30 Jahre,339,186,153
False,8426120,Ummendorf,30 - 35 Jahre,342,168,174
False,8426120,Ummendorf,35 - 40 Jahre,291,161,130
False,8426120,Ummendorf,40 - 45 Jahre,259,129,130
False,8426120,Ummendorf,45 - 50 Jahre,269,126,143
False,8426120,Ummendorf,50 - 55 Jahre,214,122,92
False,8426120,Ummendorf,55 - 60 Jahre,295,140,155
False,8426120,Ummendorf,60 - 65 Jahre,180,95,85
False,8426120,Ummendorf,65 - 75 Jahre,288,115,173
False,8426120,Ummendorf,75 und mehr Jahre,172,50,122
False,8426120,Ummendorf,Insgesamt,3897,1925,1972
False,8426121,Unlingen,unter 3 Jahre,93,46,47
False,8426121,Unlingen,3 -  6 Jahre,112,57,55
False,8426121,Unlingen,6 - 10 Jahre,132,75,57
False,8426121,Unlingen,10 - 15 Jahre,136,79,57
False,8426121,Unlingen,15 - 18 Jahre,92,52,40
False,8426121,Unlingen,18 - 20 Jahre,58,34,24
False,8426121,Unlingen,20 - 25 Jahre,184,100,84
False,8426121,Unlingen,25 - 30 Jahre,215,110,105
False,8426121,Unlingen,30 - 35 Jahre,206,110,96
False,8426121,Unlingen,35 - 40 Jahre,182,102,80
False,8426121,Unlingen,40 - 45 Jahre,137,76,61
False,8426121,Unlingen,45 - 50 Jahre,128,68,60
False,8426121,Unlingen,50 - 55 Jahre,120,58,62
False,8426121,Unlingen,55 - 60 Jahre,151,91,60
False,8426121,Unlingen,60 - 65 Jahre,91,42,49
False,8426121,Unlingen,65 - 75 Jahre,170,77,93
False,8426121,Unlingen,75 und mehr Jahre,120,36,84
False,8426121,Unlingen,Insgesamt,2327,1213,1114
False,8426124,Uttenweiler,unter 3 Jahre,112,57,55
False,8426124,Uttenweiler,3 -  6 Jahre,145,79,66
False,8426124,Uttenweiler,6 - 10 Jahre,239,128,111
False,8426124,Uttenweiler,10 - 15 Jahre,264,132,132
False,8426124,Uttenweiler,15 - 18 Jahre,132,69,63
False,8426124,Uttenweiler,18 - 20 Jahre,75,38,37
False,8426124,Uttenweiler,20 - 25 Jahre,200,100,100
False,8426124,Uttenweiler,25 - 30 Jahre,220,131,89
False,8426124,Uttenweiler,30 - 35 Jahre,278,148,130
False,8426124,Uttenweiler,35 - 40 Jahre,307,155,152
False,8426124,Uttenweiler,40 - 45 Jahre,248,141,107
False,8426124,Uttenweiler,45 - 50 Jahre,170,87,83
False,8426124,Uttenweiler,50 - 55 Jahre,129,70,59
False,8426124,Uttenweiler,55 - 60 Jahre,170,90,80
False,8426124,Uttenweiler,60 - 65 Jahre,151,74,77
False,8426124,Uttenweiler,65 - 75 Jahre,298,129,169
False,8426124,Uttenweiler,75 und mehr Jahre,177,60,117
False,8426124,Uttenweiler,Insgesamt,3315,1688,1627
False,8426125,Wain,unter 3 Jahre,65,35,30
False,8426125,Wain,3 -  6 Jahre,73,41,32
False,8426125,Wain,6 - 10 Jahre,90,49,41
False,8426125,Wain,10 - 15 Jahre,122,71,51
False,8426125,Wain,15 - 18 Jahre,71,36,35
False,8426125,Wain,18 - 20 Jahre,41,21,20
False,8426125,Wain,20 - 25 Jahre,86,51,35
False,8426125,Wain,25 - 30 Jahre,109,61,48
False,8426125,Wain,30 - 35 Jahre,122,69,53
False,8426125,Wain,35 - 40 Jahre,107,52,55
False,8426125,Wain,40 - 45 Jahre,110,54,56
False,8426125,Wain,45 - 50 Jahre,102,55,47
False,8426125,Wain,50 - 55 Jahre,73,49,24
False,8426125,Wain,55 - 60 Jahre,89,43,46
False,8426125,Wain,60 - 65 Jahre,62,35,27
False,8426125,Wain,65 - 75 Jahre,116,41,75
False,8426125,Wain,75 und mehr Jahre,94,30,64
False,8426125,Wain,Insgesamt,1532,793,739
False,8426128,Warthausen,unter 3 Jahre,152,82,70
False,8426128,Warthausen,3 -  6 Jahre,179,90,89
False,8426128,Warthausen,6 - 10 Jahre,236,120,116
False,8426128,Warthausen,10 - 15 Jahre,241,120,121
False,8426128,Warthausen,15 - 18 Jahre,148,72,76
False,8426128,Warthausen,18 - 20 Jahre,72,46,26
False,8426128,Warthausen,20 - 25 Jahre,286,143,143
False,8426128,Warthausen,25 - 30 Jahre,351,199,152
False,8426128,Warthausen,30 - 35 Jahre,362,177,185
False,8426128,Warthausen,35 - 40 Jahre,353,176,177
False,8426128,Warthausen,40 - 45 Jahre,298,149,149
False,8426128,Warthausen,45 - 50 Jahre,277,146,131
False,8426128,Warthausen,50 - 55 Jahre,308,146,162
False,8426128,Warthausen,55 - 60 Jahre,317,165,152
False,8426128,Warthausen,60 - 65 Jahre,232,121,111
False,8426128,Warthausen,65 - 75 Jahre,355,153,202
False,8426128,Warthausen,75 und mehr Jahre,188,65,123
False,8426128,Warthausen,Insgesamt,4355,2170,2185
False,8426134,Schemmerhofen,unter 3 Jahre,298,142,156
False,8426134,Schemmerhofen,3 -  6 Jahre,325,161,164
False,8426134,Schemmerhofen,6 - 10 Jahre,400,210,190
False,8426134,Schemmerhofen,10 - 15 Jahre,436,223,213
False,8426134,Schemmerhofen,15 - 18 Jahre,274,140,134
False,8426134,Schemmerhofen,18 - 20 Jahre,151,81,70
False,8426134,Schemmerhofen,20 - 25 Jahre,458,219,239
False,8426134,Schemmerhofen,25 - 30 Jahre,610,303,307
False,8426134,Schemmerhofen,30 - 35 Jahre,616,310,306
False,8426134,Schemmerhofen,35 - 40 Jahre,567,302,265
False,8426134,Schemmerhofen,40 - 45 Jahre,451,235,216
False,8426134,Schemmerhofen,45 - 50 Jahre,401,215,186
False,8426134,Schemmerhofen,50 - 55 Jahre,340,178,162
False,8426134,Schemmerhofen,55 - 60 Jahre,413,209,204
False,8426134,Schemmerhofen,60 - 65 Jahre,332,170,162
False,8426134,Schemmerhofen,65 - 75 Jahre,452,189,263
False,8426134,Schemmerhofen,75 und mehr Jahre,324,118,206
False,8426134,Schemmerhofen,Insgesamt,6848,3405,3443
False,8426135,Gutenzell-Hürbel,unter 3 Jahre,65,28,37
False,8426135,Gutenzell-Hürbel,3 -  6 Jahre,87,49,38
False,8426135,Gutenzell-Hürbel,6 - 10 Jahre,103,48,55
False,8426135,Gutenzell-Hürbel,10 - 15 Jahre,130,71,59
False,8426135,Gutenzell-Hürbel,15 - 18 Jahre,53,31,22
False,8426135,Gutenzell-Hürbel,18 - 20 Jahre,44,27,17
False,8426135,Gutenzell-Hürbel,20 - 25 Jahre,91,51,40
False,8426135,Gutenzell-Hürbel,25 - 30 Jahre,113,58,55
False,8426135,Gutenzell-Hürbel,30 - 35 Jahre,152,77,75
False,8426135,Gutenzell-Hürbel,35 - 40 Jahre,140,67,73
False,8426135,Gutenzell-Hürbel,40 - 45 Jahre,139,77,62
False,8426135,Gutenzell-Hürbel,45 - 50 Jahre,99,56,43
False,8426135,Gutenzell-Hürbel,50 - 55 Jahre,69,42,27
False,8426135,Gutenzell-Hürbel,55 - 60 Jahre,92,47,45
False,8426135,Gutenzell-Hürbel,60 - 65 Jahre,61,34,27
False,8426135,Gutenzell-Hürbel,65 - 75 Jahre,124,49,75
False,8426135,Gutenzell-Hürbel,75 und mehr Jahre,85,26,59
False,8426135,Gutenzell-Hürbel,Insgesamt,1647,838,809
False,8435,Landkreis Bodenseekreis,unter 3 Jahre,6720,3448,3272
False,8435,Landkreis Bodenseekreis,3 -  6 Jahre,6994,3617,3377
False,8435,Landkreis Bodenseekreis,6 - 10 Jahre,9151,4644,4507
False,8435,Landkreis Bodenseekreis,10 - 15 Jahre,10699,5449,5250
False,8435,Landkreis Bodenseekreis,15 - 18 Jahre,6416,3285,3131
False,8435,Landkreis Bodenseekreis,18 - 20 Jahre,4287,2216,2071
False,8435,Landkreis Bodenseekreis,20 - 25 Jahre,11335,5776,5559
False,8435,Landkreis Bodenseekreis,25 - 30 Jahre,15505,7963,7542
False,8435,Landkreis Bodenseekreis,30 - 35 Jahre,16517,8452,8065
False,8435,Landkreis Bodenseekreis,35 - 40 Jahre,14823,7640,7183
False,8435,Landkreis Bodenseekreis,40 - 45 Jahre,12982,6435,6547
False,8435,Landkreis Bodenseekreis,45 - 50 Jahre,12472,6201,6271
False,8435,Landkreis Bodenseekreis,50 - 55 Jahre,12641,6402,6239
False,8435,Landkreis Bodenseekreis,55 - 60 Jahre,14110,7126,6984
False,8435,Landkreis Bodenseekreis,60 - 65 Jahre,9249,4648,4601
False,8435,Landkreis Bodenseekreis,65 - 75 Jahre,15895,6646,9249
False,8435,Landkreis Bodenseekreis,75 und mehr Jahre,13151,4223,8928
False,8435,Landkreis Bodenseekreis,Insgesamt,192947,94171,98776
False,8435005,Bermatingen,unter 3 Jahre,137,68,69
False,8435005,Bermatingen,3 -  6 Jahre,143,64,79
False,8435005,Bermatingen,6 - 10 Jahre,185,101,84
False,8435005,Bermatingen,10 - 15 Jahre,184,82,102
False,8435005,Bermatingen,15 - 18 Jahre,116,60,56
False,8435005,Bermatingen,18 - 20 Jahre,83,39,44
False,8435005,Bermatingen,20 - 25 Jahre,220,110,110
False,8435005,Bermatingen,25 - 30 Jahre,303,150,153
False,8435005,Bermatingen,30 - 35 Jahre,316,149,167
False,8435005,Bermatingen,35 - 40 Jahre,286,145,141
False,8435005,Bermatingen,40 - 45 Jahre,255,131,124
False,8435005,Bermatingen,45 - 50 Jahre,250,139,111
False,8435005,Bermatingen,50 - 55 Jahre,229,112,117
False,8435005,Bermatingen,55 - 60 Jahre,267,148,119
False,8435005,Bermatingen,60 - 65 Jahre,146,68,78
False,8435005,Bermatingen,65 - 75 Jahre,275,131,144
False,8435005,Bermatingen,75 und mehr Jahre,115,39,76
False,8435005,Bermatingen,Insgesamt,3510,1736,1774
False,8435010,Daisendorf,unter 3 Jahre,41,20,21
False,8435010,Daisendorf,3 -  6 Jahre,39,19,20
False,8435010,Daisendorf,6 - 10 Jahre,49,23,26
False,8435010,Daisendorf,10 - 15 Jahre,75,40,35
False,8435010,Daisendorf,15 - 18 Jahre,41,14,27
False,8435010,Daisendorf,18 - 20 Jahre,28,13,15
False,8435010,Daisendorf,20 - 25 Jahre,51,31,20
False,8435010,Daisendorf,25 - 30 Jahre,115,51,64
False,8435010,Daisendorf,30 - 35 Jahre,116,58,58
False,8435010,Daisendorf,35 - 40 Jahre,87,43,44
False,8435010,Daisendorf,40 - 45 Jahre,89,49,40
False,8435010,Daisendorf,45 - 50 Jahre,98,49,49
False,8435010,Daisendorf,50 - 55 Jahre,102,46,56
False,8435010,Daisendorf,55 - 60 Jahre,107,58,49
False,8435010,Daisendorf,60 - 65 Jahre,53,25,28
False,8435010,Daisendorf,65 - 75 Jahre,108,52,56
False,8435010,Daisendorf,75 und mehr Jahre,108,43,65
False,8435010,Daisendorf,Insgesamt,1307,634,673
False,8435013,Eriskirch,unter 3 Jahre,142,79,63
False,8435013,Eriskirch,3 -  6 Jahre,181,97,84
False,8435013,Eriskirch,6 - 10 Jahre,232,127,105
False,8435013,Eriskirch,10 - 15 Jahre,214,113,101
False,8435013,Eriskirch,15 - 18 Jahre,120,54,66
False,8435013,Eriskirch,18 - 20 Jahre,69,42,27
False,8435013,Eriskirch,20 - 25 Jahre,287,138,149
False,8435013,Eriskirch,25 - 30 Jahre,408,214,194
False,8435013,Eriskirch,30 - 35 Jahre,431,222,209
False,8435013,Eriskirch,35 - 40 Jahre,351,190,161
False,8435013,Eriskirch,40 - 45 Jahre,291,144,147
False,8435013,Eriskirch,45 - 50 Jahre,292,143,149
False,8435013,Eriskirch,50 - 55 Jahre,269,134,135
False,8435013,Eriskirch,55 - 60 Jahre,286,152,134
False,8435013,Eriskirch,60 - 65 Jahre,174,90,84
False,8435013,Eriskirch,65 - 75 Jahre,334,146,188
False,8435013,Eriskirch,75 und mehr Jahre,224,85,139
False,8435013,Eriskirch,Insgesamt,4305,2170,2135
False,8435015,Frickingen,unter 3 Jahre,115,61,54
False,8435015,Frickingen,3 -  6 Jahre,119,58,61
False,8435015,Frickingen,6 - 10 Jahre,126,56,70
False,8435015,Frickingen,10 - 15 Jahre,152,67,85
False,8435015,Frickingen,15 - 18 Jahre,104,56,48
False,8435015,Frickingen,18 - 20 Jahre,46,28,18
False,8435015,Frickingen,20 - 25 Jahre,115,63,52
False,8435015,Frickingen,25 - 30 Jahre,167,88,79
False,8435015,Frickingen,30 - 35 Jahre,195,110,85
False,8435015,Frickingen,35 - 40 Jahre,184,102,82
False,8435015,Frickingen,40 - 45 Jahre,182,105,77
False,8435015,Frickingen,45 - 50 Jahre,159,80,79
False,8435015,Frickingen,50 - 55 Jahre,164,91,73
False,8435015,Frickingen,55 - 60 Jahre,148,73,75
False,8435015,Frickingen,60 - 65 Jahre,128,69,59
False,8435015,Frickingen,65 - 75 Jahre,232,100,132
False,8435015,Frickingen,75 und mehr Jahre,131,50,81
False,8435015,Frickingen,Insgesamt,2467,1257,1210
False,8435016,"Friedrichshafen, Stadt",unter 3 Jahre,1784,875,909
False,8435016,"Friedrichshafen, Stadt",3 -  6 Jahre,1852,946,906
False,8435016,"Friedrichshafen, Stadt",6 - 10 Jahre,2563,1317,1246
False,8435016,"Friedrichshafen, Stadt",10 - 15 Jahre,3013,1499,1514
False,8435016,"Friedrichshafen, Stadt",15 - 18 Jahre,1848,948,900
False,8435016,"Friedrichshafen, Stadt",18 - 20 Jahre,1235,636,599
False,8435016,"Friedrichshafen, Stadt",20 - 25 Jahre,3377,1708,1669
False,8435016,"Friedrichshafen, Stadt",25 - 30 Jahre,4501,2354,2147
False,8435016,"Friedrichshafen, Stadt",30 - 35 Jahre,4631,2462,2169
False,8435016,"Friedrichshafen, Stadt",35 - 40 Jahre,4043,2081,1962
False,8435016,"Friedrichshafen, Stadt",40 - 45 Jahre,3680,1786,1894
False,8435016,"Friedrichshafen, Stadt",45 - 50 Jahre,3685,1875,1810
False,8435016,"Friedrichshafen, Stadt",50 - 55 Jahre,3901,1936,1965
False,8435016,"Friedrichshafen, Stadt",55 - 60 Jahre,4380,2240,2140
False,8435016,"Friedrichshafen, Stadt",60 - 65 Jahre,2921,1454,1467
False,8435016,"Friedrichshafen, Stadt",65 - 75 Jahre,4797,1999,2798
False,8435016,"Friedrichshafen, Stadt",75 und mehr Jahre,4104,1334,2770
False,8435016,"Friedrichshafen, Stadt",Insgesamt,56315,27450,28865
False,8435018,Hagnau am Bodensee,unter 3 Jahre,44,21,23
False,8435018,Hagnau am Bodensee,3 -  6 Jahre,44,22,22
False,8435018,Hagnau am Bodensee,6 - 10 Jahre,45,18,27
False,8435018,Hagnau am Bodensee,10 - 15 Jahre,75,33,42
False,8435018,Hagnau am Bodensee,15 - 18 Jahre,42,18,24
False,8435018,Hagnau am Bodensee,18 - 20 Jahre,25,12,13
False,8435018,Hagnau am Bodensee,20 - 25 Jahre,60,30,30
False,8435018,Hagnau am Bodensee,25 - 30 Jahre,95,43,52
False,8435018,Hagnau am Bodensee,30 - 35 Jahre,93,43,50
False,8435018,Hagnau am Bodensee,35 - 40 Jahre,111,58,53
False,8435018,Hagnau am Bodensee,40 - 45 Jahre,93,47,46
False,8435018,Hagnau am Bodensee,45 - 50 Jahre,107,52,55
False,8435018,Hagnau am Bodensee,50 - 55 Jahre,85,45,40
False,8435018,Hagnau am Bodensee,55 - 60 Jahre,123,57,66
False,8435018,Hagnau am Bodensee,60 - 65 Jahre,72,38,34
False,8435018,Hagnau am Bodensee,65 - 75 Jahre,146,61,85
False,8435018,Hagnau am Bodensee,75 und mehr Jahre,133,55,78
False,8435018,Hagnau am Bodensee,Insgesamt,1393,653,740
False,8435020,Heiligenberg,unter 3 Jahre,126,70,56
False,8435020,Heiligenberg,3 -  6 Jahre,132,79,53
False,8435020,Heiligenberg,6 - 10 Jahre,166,77,89
False,8435020,Heiligenberg,10 - 15 Jahre,219,112,107
False,8435020,Heiligenberg,15 - 18 Jahre,116,63,53
False,8435020,Heiligenberg,18 - 20 Jahre,68,37,31
False,8435020,Heiligenberg,20 - 25 Jahre,167,88,79
False,8435020,Heiligenberg,25 - 30 Jahre,211,116,95
False,8435020,Heiligenberg,30 - 35 Jahre,257,122,135
False,8435020,Heiligenberg,35 - 40 Jahre,235,123,112
False,8435020,Heiligenberg,40 - 45 Jahre,215,121,94
False,8435020,Heiligenberg,45 - 50 Jahre,137,61,76
False,8435020,Heiligenberg,50 - 55 Jahre,110,56,54
False,8435020,Heiligenberg,55 - 60 Jahre,150,63,87
False,8435020,Heiligenberg,60 - 65 Jahre,157,87,70
False,8435020,Heiligenberg,65 - 75 Jahre,254,95,159
False,8435020,Heiligenberg,75 und mehr Jahre,193,60,133
False,8435020,Heiligenberg,Insgesamt,2913,1430,1483
False,8435024,Immenstaad am Bodensee,unter 3 Jahre,186,93,93
False,8435024,Immenstaad am Bodensee,3 -  6 Jahre,211,103,108
False,8435024,Immenstaad am Bodensee,6 - 10 Jahre,241,116,125
False,8435024,Immenstaad am Bodensee,10 - 15 Jahre,317,159,158
False,8435024,Immenstaad am Bodensee,15 - 18 Jahre,181,86,95
False,8435024,Immenstaad am Bodensee,18 - 20 Jahre,125,60,65
False,8435024,Immenstaad am Bodensee,20 - 25 Jahre,241,109,132
False,8435024,Immenstaad am Bodensee,25 - 30 Jahre,349,160,189
False,8435024,Immenstaad am Bodensee,30 - 35 Jahre,488,257,231
False,8435024,Immenstaad am Bodensee,35 - 40 Jahre,500,264,236
False,8435024,Immenstaad am Bodensee,40 - 45 Jahre,451,214,237
False,8435024,Immenstaad am Bodensee,45 - 50 Jahre,432,212,220
False,8435024,Immenstaad am Bodensee,50 - 55 Jahre,469,245,224
False,8435024,Immenstaad am Bodensee,55 - 60 Jahre,466,242,224
False,8435024,Immenstaad am Bodensee,60 - 65 Jahre,242,132,110
False,8435024,Immenstaad am Bodensee,65 - 75 Jahre,392,157,235
False,8435024,Immenstaad am Bodensee,75 und mehr Jahre,334,120,214
False,8435024,Immenstaad am Bodensee,Insgesamt,5625,2729,2896
False,8435029,Kressbronn am Bodensee,unter 3 Jahre,256,132,124
False,8435029,Kressbronn am Bodensee,3 -  6 Jahre,268,134,134
False,8435029,Kressbronn am Bodensee,6 - 10 Jahre,337,172,165
False,8435029,Kressbronn am Bodensee,10 - 15 Jahre,398,210,188
False,8435029,Kressbronn am Bodensee,15 - 18 Jahre,234,132,102
False,8435029,Kressbronn am Bodensee,18 - 20 Jahre,148,81,67
False,8435029,Kressbronn am Bodensee,20 - 25 Jahre,392,192,200
False,8435029,Kressbronn am Bodensee,25 - 30 Jahre,504,271,233
False,8435029,Kressbronn am Bodensee,30 - 35 Jahre,569,296,273
False,8435029,Kressbronn am Bodensee,35 - 40 Jahre,495,260,235
False,8435029,Kressbronn am Bodensee,40 - 45 Jahre,446,224,222
False,8435029,Kressbronn am Bodensee,45 - 50 Jahre,466,223,243
False,8435029,Kressbronn am Bodensee,50 - 55 Jahre,494,239,255
False,8435029,Kressbronn am Bodensee,55 - 60 Jahre,550,273,277
False,8435029,Kressbronn am Bodensee,60 - 65 Jahre,362,169,193
False,8435029,Kressbronn am Bodensee,65 - 75 Jahre,607,250,357
False,8435029,Kressbronn am Bodensee,75 und mehr Jahre,579,184,395
False,8435029,Kressbronn am Bodensee,Insgesamt,7105,3442,3663
False,8435030,Langenargen,unter 3 Jahre,267,147,120
False,8435030,Langenargen,3 -  6 Jahre,220,114,106
False,8435030,Langenargen,6 - 10 Jahre,295,162,133
False,8435030,Langenargen,10 - 15 Jahre,343,185,158
False,8435030,Langenargen,15 - 18 Jahre,198,96,102
False,8435030,Langenargen,18 - 20 Jahre,133,72,61
False,8435030,Langenargen,20 - 25 Jahre,379,194,185
False,8435030,Langenargen,25 - 30 Jahre,608,304,304
False,8435030,Langenargen,30 - 35 Jahre,613,302,311
False,8435030,Langenargen,35 - 40 Jahre,528,264,264
False,8435030,Langenargen,40 - 45 Jahre,468,239,229
False,8435030,Langenargen,45 - 50 Jahre,487,251,236
False,8435030,Langenargen,50 - 55 Jahre,477,242,235
False,8435030,Langenargen,55 - 60 Jahre,558,269,289
False,8435030,Langenargen,60 - 65 Jahre,346,178,168
False,8435030,Langenargen,65 - 75 Jahre,679,291,388
False,8435030,Langenargen,75 und mehr Jahre,518,160,358
False,8435030,Langenargen,Insgesamt,7117,3470,3647
False,8435034,"Markdorf, Stadt",unter 3 Jahre,408,206,202
False,8435034,"Markdorf, Stadt",3 -  6 Jahre,382,183,199
False,8435034,"Markdorf, Stadt",6 - 10 Jahre,519,255,264
False,8435034,"Markdorf, Stadt",10 - 15 Jahre,633,323,310
False,8435034,"Markdorf, Stadt",15 - 18 Jahre,384,196,188
False,8435034,"Markdorf, Stadt",18 - 20 Jahre,265,144,121
False,8435034,"Markdorf, Stadt",20 - 25 Jahre,709,387,322
False,8435034,"Markdorf, Stadt",25 - 30 Jahre,949,501,448
False,8435034,"Markdorf, Stadt",30 - 35 Jahre,880,431,449
False,8435034,"Markdorf, Stadt",35 - 40 Jahre,900,470,430
False,8435034,"Markdorf, Stadt",40 - 45 Jahre,728,328,400
False,8435034,"Markdorf, Stadt",45 - 50 Jahre,781,385,396
False,8435034,"Markdorf, Stadt",50 - 55 Jahre,869,436,433
False,8435034,"Markdorf, Stadt",55 - 60 Jahre,996,514,482
False,8435034,"Markdorf, Stadt",60 - 65 Jahre,516,267,249
False,8435034,"Markdorf, Stadt",65 - 75 Jahre,834,365,469
False,8435034,"Markdorf, Stadt",75 und mehr Jahre,636,190,446
False,8435034,"Markdorf, Stadt",Insgesamt,11389,5581,5808
False,8435035,Meckenbeuren,unter 3 Jahre,465,258,207
False,8435035,Meckenbeuren,3 -  6 Jahre,466,242,224
False,8435035,Meckenbeuren,6 - 10 Jahre,594,301,293
False,8435035,Meckenbeuren,10 - 15 Jahre,700,353,347
False,8435035,Meckenbeuren,15 - 18 Jahre,444,232,212
False,8435035,Meckenbeuren,18 - 20 Jahre,263,138,125
False,8435035,Meckenbeuren,20 - 25 Jahre,830,422,408
False,8435035,Meckenbeuren,25 - 30 Jahre,1180,628,552
False,8435035,Meckenbeuren,30 - 35 Jahre,1246,636,610
False,8435035,Meckenbeuren,35 - 40 Jahre,1030,527,503
False,8435035,Meckenbeuren,40 - 45 Jahre,939,479,460
False,8435035,Meckenbeuren,45 - 50 Jahre,802,408,394
False,8435035,Meckenbeuren,50 - 55 Jahre,721,352,369
False,8435035,Meckenbeuren,55 - 60 Jahre,821,409,412
False,8435035,Meckenbeuren,60 - 65 Jahre,564,286,278
False,8435035,Meckenbeuren,65 - 75 Jahre,776,344,432
False,8435035,Meckenbeuren,75 und mehr Jahre,633,197,436
False,8435035,Meckenbeuren,Insgesamt,12474,6212,6262
False,8435036,"Meersburg, Stadt",unter 3 Jahre,174,85,89
False,8435036,"Meersburg, Stadt",3 -  6 Jahre,172,93,79
False,8435036,"Meersburg, Stadt",6 - 10 Jahre,198,104,94
False,8435036,"Meersburg, Stadt",10 - 15 Jahre,221,105,116
False,8435036,"Meersburg, Stadt",15 - 18 Jahre,147,74,73
False,8435036,"Meersburg, Stadt",18 - 20 Jahre,107,54,53
False,8435036,"Meersburg, Stadt",20 - 25 Jahre,343,175,168
False,8435036,"Meersburg, Stadt",25 - 30 Jahre,530,266,264
False,8435036,"Meersburg, Stadt",30 - 35 Jahre,480,242,238
False,8435036,"Meersburg, Stadt",35 - 40 Jahre,402,215,187
False,8435036,"Meersburg, Stadt",40 - 45 Jahre,295,142,153
False,8435036,"Meersburg, Stadt",45 - 50 Jahre,345,155,190
False,8435036,"Meersburg, Stadt",50 - 55 Jahre,363,182,181
False,8435036,"Meersburg, Stadt",55 - 60 Jahre,407,192,215
False,8435036,"Meersburg, Stadt",60 - 65 Jahre,254,127,127
False,8435036,"Meersburg, Stadt",65 - 75 Jahre,477,184,293
False,8435036,"Meersburg, Stadt",75 und mehr Jahre,460,128,332
False,8435036,"Meersburg, Stadt",Insgesamt,5375,2523,2852
False,8435042,Neukirch,unter 3 Jahre,91,50,41
False,8435042,Neukirch,3 -  6 Jahre,99,54,45
False,8435042,Neukirch,6 - 10 Jahre,146,79,67
False,8435042,Neukirch,10 - 15 Jahre,165,74,91
False,8435042,Neukirch,15 - 18 Jahre,72,36,36
False,8435042,Neukirch,18 - 20 Jahre,57,35,22
False,8435042,Neukirch,20 - 25 Jahre,133,67,66
False,8435042,Neukirch,25 - 30 Jahre,192,96,96
False,8435042,Neukirch,30 - 35 Jahre,213,100,113
False,8435042,Neukirch,35 - 40 Jahre,192,103,89
False,8435042,Neukirch,40 - 45 Jahre,161,90,71
False,8435042,Neukirch,45 - 50 Jahre,141,71,70
False,8435042,Neukirch,50 - 55 Jahre,117,76,41
False,8435042,Neukirch,55 - 60 Jahre,140,73,67
False,8435042,Neukirch,60 - 65 Jahre,82,40,42
False,8435042,Neukirch,65 - 75 Jahre,171,72,99
False,8435042,Neukirch,75 und mehr Jahre,116,41,75
False,8435042,Neukirch,Insgesamt,2288,1157,1131
False,8435045,Oberteuringen,unter 3 Jahre,165,90,75
False,8435045,Oberteuringen,3 -  6 Jahre,172,88,84
False,8435045,Oberteuringen,6 - 10 Jahre,210,102,108
False,8435045,Oberteuringen,10 - 15 Jahre,235,121,114
False,8435045,Oberteuringen,15 - 18 Jahre,107,53,54
False,8435045,Oberteuringen,18 - 20 Jahre,70,32,38
False,8435045,Oberteuringen,20 - 25 Jahre,227,122,105
False,8435045,Oberteuringen,25 - 30 Jahre,356,193,163
False,8435045,Oberteuringen,30 - 35 Jahre,379,205,174
False,8435045,Oberteuringen,35 - 40 Jahre,341,169,172
False,8435045,Oberteuringen,40 - 45 Jahre,269,145,124
False,8435045,Oberteuringen,45 - 50 Jahre,238,124,114
False,8435045,Oberteuringen,50 - 55 Jahre,243,129,114
False,8435045,Oberteuringen,55 - 60 Jahre,236,121,115
False,8435045,Oberteuringen,60 - 65 Jahre,157,92,65
False,8435045,Oberteuringen,65 - 75 Jahre,243,101,142
False,8435045,Oberteuringen,75 und mehr Jahre,179,65,114
False,8435045,Oberteuringen,Insgesamt,3827,1952,1875
False,8435047,Owingen,unter 3 Jahre,145,89,56
False,8435047,Owingen,3 -  6 Jahre,185,100,85
False,8435047,Owingen,6 - 10 Jahre,244,118,126
False,8435047,Owingen,10 - 15 Jahre,253,128,125
False,8435047,Owingen,15 - 18 Jahre,126,71,55
False,8435047,Owingen,18 - 20 Jahre,87,39,48
False,8435047,Owingen,20 - 25 Jahre,228,104,124
False,8435047,Owingen,25 - 30 Jahre,294,157,137
False,8435047,Owingen,30 - 35 Jahre,342,182,160
False,8435047,Owingen,35 - 40 Jahre,356,191,165
False,8435047,Owingen,40 - 45 Jahre,296,140,156
False,8435047,Owingen,45 - 50 Jahre,238,126,112
False,8435047,Owingen,50 - 55 Jahre,194,104,90
False,8435047,Owingen,55 - 60 Jahre,252,124,128
False,8435047,Owingen,60 - 65 Jahre,183,106,77
False,8435047,Owingen,65 - 75 Jahre,245,115,130
False,8435047,Owingen,75 und mehr Jahre,161,52,109
False,8435047,Owingen,Insgesamt,3829,1946,1883
False,8435052,Salem,unter 3 Jahre,435,204,231
False,8435052,Salem,3 -  6 Jahre,478,254,224
False,8435052,Salem,6 - 10 Jahre,609,307,302
False,8435052,Salem,10 - 15 Jahre,719,379,340
False,8435052,Salem,15 - 18 Jahre,538,279,259
False,8435052,Salem,18 - 20 Jahre,280,140,140
False,8435052,Salem,20 - 25 Jahre,642,360,282
False,8435052,Salem,25 - 30 Jahre,747,389,358
False,8435052,Salem,30 - 35 Jahre,916,446,470
False,8435052,Salem,35 - 40 Jahre,871,438,433
False,8435052,Salem,40 - 45 Jahre,752,369,383
False,8435052,Salem,45 - 50 Jahre,641,329,312
False,8435052,Salem,50 - 55 Jahre,582,318,264
False,8435052,Salem,55 - 60 Jahre,612,310,302
False,8435052,Salem,60 - 65 Jahre,389,192,197
False,8435052,Salem,65 - 75 Jahre,665,289,376
False,8435052,Salem,75 und mehr Jahre,563,165,398
False,8435052,Salem,Insgesamt,10439,5168,5271
False,8435053,Sipplingen,unter 3 Jahre,61,25,36
False,8435053,Sipplingen,3 -  6 Jahre,70,36,34
False,8435053,Sipplingen,6 - 10 Jahre,90,41,49
False,8435053,Sipplingen,10 - 15 Jahre,98,48,50
False,8435053,Sipplingen,15 - 18 Jahre,56,25,31
False,8435053,Sipplingen,18 - 20 Jahre,41,26,15
False,8435053,Sipplingen,20 - 25 Jahre,112,59,53
False,8435053,Sipplingen,25 - 30 Jahre,159,89,70
False,8435053,Sipplingen,30 - 35 Jahre,184,92,92
False,8435053,Sipplingen,35 - 40 Jahre,160,87,73
False,8435053,Sipplingen,40 - 45 Jahre,136,61,75
False,8435053,Sipplingen,45 - 50 Jahre,131,69,62
False,8435053,Sipplingen,50 - 55 Jahre,128,68,60
False,8435053,Sipplingen,55 - 60 Jahre,161,80,81
False,8435053,Sipplingen,60 - 65 Jahre,112,53,59
False,8435053,Sipplingen,65 - 75 Jahre,259,120,139
False,8435053,Sipplingen,75 und mehr Jahre,190,63,127
False,8435053,Sipplingen,Insgesamt,2148,1042,1106
False,8435054,Stetten,unter 3 Jahre,29,15,14
False,8435054,Stetten,3 -  6 Jahre,37,13,24
False,8435054,Stetten,6 - 10 Jahre,56,35,21
False,8435054,Stetten,10 - 15 Jahre,52,30,22
False,8435054,Stetten,15 - 18 Jahre,32,15,17
False,8435054,Stetten,18 - 20 Jahre,13,4,9
False,8435054,Stetten,20 - 25 Jahre,45,24,21
False,8435054,Stetten,25 - 30 Jahre,55,22,33
False,8435054,Stetten,30 - 35 Jahre,105,47,58
False,8435054,Stetten,35 - 40 Jahre,86,42,44
False,8435054,Stetten,40 - 45 Jahre,77,35,42
False,8435054,Stetten,45 - 50 Jahre,50,27,23
False,8435054,Stetten,50 - 55 Jahre,73,35,38
False,8435054,Stetten,55 - 60 Jahre,85,42,43
False,8435054,Stetten,60 - 65 Jahre,41,20,21
False,8435054,Stetten,65 - 75 Jahre,72,34,38
False,8435054,Stetten,75 und mehr Jahre,89,21,68
False,8435054,Stetten,Insgesamt,997,461,536
False,8435057,"Tettnang, Stadt",unter 3 Jahre,628,315,313
False,8435057,"Tettnang, Stadt",3 -  6 Jahre,672,356,316
False,8435057,"Tettnang, Stadt",6 - 10 Jahre,837,412,425
False,8435057,"Tettnang, Stadt",10 - 15 Jahre,929,476,453
False,8435057,"Tettnang, Stadt",15 - 18 Jahre,550,299,251
False,8435057,"Tettnang, Stadt",18 - 20 Jahre,359,179,180
False,8435057,"Tettnang, Stadt",20 - 25 Jahre,972,499,473
False,8435057,"Tettnang, Stadt",25 - 30 Jahre,1355,718,637
False,8435057,"Tettnang, Stadt",30 - 35 Jahre,1537,783,754
False,8435057,"Tettnang, Stadt",35 - 40 Jahre,1336,711,625
False,8435057,"Tettnang, Stadt",40 - 45 Jahre,1170,589,581
False,8435057,"Tettnang, Stadt",45 - 50 Jahre,1070,544,526
False,8435057,"Tettnang, Stadt",50 - 55 Jahre,1079,586,493
False,8435057,"Tettnang, Stadt",55 - 60 Jahre,1134,586,548
False,8435057,"Tettnang, Stadt",60 - 65 Jahre,775,400,375
False,8435057,"Tettnang, Stadt",65 - 75 Jahre,1285,539,746
False,8435057,"Tettnang, Stadt",75 und mehr Jahre,926,315,611
False,8435057,"Tettnang, Stadt",Insgesamt,16614,8307,8307
False,8435059,"Überlingen, Stadt",unter 3 Jahre,583,292,291
False,8435059,"Überlingen, Stadt",3 -  6 Jahre,595,325,270
False,8435059,"Überlingen, Stadt",6 - 10 Jahre,837,432,405
False,8435059,"Überlingen, Stadt",10 - 15 Jahre,1083,574,509
False,8435059,"Überlingen, Stadt",15 - 18 Jahre,652,336,316
False,8435059,"Überlingen, Stadt",18 - 20 Jahre,551,288,263
False,8435059,"Überlingen, Stadt",20 - 25 Jahre,1168,572,596
False,8435059,"Überlingen, Stadt",25 - 30 Jahre,1429,667,762
False,8435059,"Überlingen, Stadt",30 - 35 Jahre,1413,686,727
False,8435059,"Überlingen, Stadt",35 - 40 Jahre,1344,649,695
False,8435059,"Überlingen, Stadt",40 - 45 Jahre,1253,605,648
False,8435059,"Überlingen, Stadt",45 - 50 Jahre,1246,556,690
False,8435059,"Überlingen, Stadt",50 - 55 Jahre,1326,649,677
False,8435059,"Überlingen, Stadt",55 - 60 Jahre,1553,753,800
False,8435059,"Überlingen, Stadt",60 - 65 Jahre,1087,505,582
False,8435059,"Überlingen, Stadt",65 - 75 Jahre,2196,826,1370
False,8435059,"Überlingen, Stadt",75 und mehr Jahre,2178,670,1508
False,8435059,"Überlingen, Stadt",Insgesamt,20494,9385,11109
False,8435066,Uhldingen-Mühlhofen,unter 3 Jahre,286,165,121
False,8435066,Uhldingen-Mühlhofen,3 -  6 Jahre,295,147,148
False,8435066,Uhldingen-Mühlhofen,6 - 10 Jahre,343,177,166
False,8435066,Uhldingen-Mühlhofen,10 - 15 Jahre,410,236,174
False,8435066,Uhldingen-Mühlhofen,15 - 18 Jahre,197,98,99
False,8435066,Uhldingen-Mühlhofen,18 - 20 Jahre,136,75,61
False,8435066,Uhldingen-Mühlhofen,20 - 25 Jahre,411,204,207
False,8435066,Uhldingen-Mühlhofen,25 - 30 Jahre,643,309,334
False,8435066,Uhldingen-Mühlhofen,30 - 35 Jahre,729,373,356
False,8435066,Uhldingen-Mühlhofen,35 - 40 Jahre,649,327,322
False,8435066,Uhldingen-Mühlhofen,40 - 45 Jahre,488,258,230
False,8435066,Uhldingen-Mühlhofen,45 - 50 Jahre,478,230,248
False,8435066,Uhldingen-Mühlhofen,50 - 55 Jahre,459,231,228
False,8435066,Uhldingen-Mühlhofen,55 - 60 Jahre,444,227,217
False,8435066,Uhldingen-Mühlhofen,60 - 65 Jahre,304,142,162
False,8435066,Uhldingen-Mühlhofen,65 - 75 Jahre,569,258,311
False,8435066,Uhldingen-Mühlhofen,75 und mehr Jahre,402,128,274
False,8435066,Uhldingen-Mühlhofen,Insgesamt,7243,3585,3658
False,8435067,Deggenhausertal,unter 3 Jahre,152,88,64
False,8435067,Deggenhausertal,3 -  6 Jahre,162,90,72
False,8435067,Deggenhausertal,6 - 10 Jahre,229,112,117
False,8435067,Deggenhausertal,10 - 15 Jahre,211,102,109
False,8435067,Deggenhausertal,15 - 18 Jahre,111,44,67
False,8435067,Deggenhausertal,18 - 20 Jahre,98,42,56
False,8435067,Deggenhausertal,20 - 25 Jahre,226,118,108
False,8435067,Deggenhausertal,25 - 30 Jahre,355,177,178
False,8435067,Deggenhausertal,30 - 35 Jahre,384,208,176
False,8435067,Deggenhausertal,35 - 40 Jahre,336,181,155
False,8435067,Deggenhausertal,40 - 45 Jahre,248,134,114
False,8435067,Deggenhausertal,45 - 50 Jahre,198,92,106
False,8435067,Deggenhausertal,50 - 55 Jahre,187,90,97
False,8435067,Deggenhausertal,55 - 60 Jahre,234,120,114
False,8435067,Deggenhausertal,60 - 65 Jahre,184,108,76
False,8435067,Deggenhausertal,65 - 75 Jahre,279,117,162
False,8435067,Deggenhausertal,75 und mehr Jahre,179,58,121
False,8435067,Deggenhausertal,Insgesamt,3773,1881,1892
False,8436,Landkreis Ravensburg,unter 3 Jahre,9318,4815,4503
False,8436,Landkreis Ravensburg,3 -  6 Jahre,10448,5405,5043
False,8436,Landkreis Ravensburg,6 - 10 Jahre,13596,7043,6553
False,8436,Landkreis Ravensburg,10 - 15 Jahre,15572,8060,7512
False,8436,Landkreis Ravensburg,15 - 18 Jahre,9039,4686,4353
False,8436,Landkreis Ravensburg,18 - 20 Jahre,6046,3153,2893
False,8436,Landkreis Ravensburg,20 - 25 Jahre,17103,8754,8349
False,8436,Landkreis Ravensburg,25 - 30 Jahre,22570,11631,10939
False,8436,Landkreis Ravensburg,30 - 35 Jahre,23140,11935,11205
False,8436,Landkreis Ravensburg,35 - 40 Jahre,20056,10116,9940
False,8436,Landkreis Ravensburg,40 - 45 Jahre,17292,8747,8545
False,8436,Landkreis Ravensburg,45 - 50 Jahre,15564,8039,7525
False,8436,Landkreis Ravensburg,50 - 55 Jahre,14724,7525,7199
False,8436,Landkreis Ravensburg,55 - 60 Jahre,16999,8638,8361
False,8436,Landkreis Ravensburg,60 - 65 Jahre,12382,6144,6238
False,8436,Landkreis Ravensburg,65 - 75 Jahre,21184,8803,12381
False,8436,Landkreis Ravensburg,75 und mehr Jahre,16413,5048,11365
False,8436,Landkreis Ravensburg,Insgesamt,261446,128542,132904
False,8436001,Achberg,unter 3 Jahre,65,36,29
False,8436001,Achberg,3 -  6 Jahre,60,27,33
False,8436001,Achberg,6 - 10 Jahre,90,48,42
False,8436001,Achberg,10 - 15 Jahre,94,54,40
False,8436001,Achberg,15 - 18 Jahre,42,18,24
False,8436001,Achberg,18 - 20 Jahre,26,13,13
False,8436001,Achberg,20 - 25 Jahre,67,35,32
False,8436001,Achberg,25 - 30 Jahre,108,55,53
False,8436001,Achberg,30 - 35 Jahre,104,50,54
False,8436001,Achberg,35 - 40 Jahre,109,55,54
False,8436001,Achberg,40 - 45 Jahre,85,39,46
False,8436001,Achberg,45 - 50 Jahre,72,42,30
False,8436001,Achberg,50 - 55 Jahre,66,37,29
False,8436001,Achberg,55 - 60 Jahre,67,30,37
False,8436001,Achberg,60 - 65 Jahre,62,32,30
False,8436001,Achberg,65 - 75 Jahre,104,44,60
False,8436001,Achberg,75 und mehr Jahre,90,30,60
False,8436001,Achberg,Insgesamt,1311,645,666
False,8436003,Aichstetten,unter 3 Jahre,77,38,39
False,8436003,Aichstetten,3 -  6 Jahre,113,52,61
False,8436003,Aichstetten,6 - 10 Jahre,156,82,74
False,8436003,Aichstetten,10 - 15 Jahre,156,73,83
False,8436003,Aichstetten,15 - 18 Jahre,78,43,35
False,8436003,Aichstetten,18 - 20 Jahre,60,31,29
False,8436003,Aichstetten,20 - 25 Jahre,175,87,88
False,8436003,Aichstetten,25 - 30 Jahre,209,124,85
False,8436003,Aichstetten,30 - 35 Jahre,202,103,99
False,8436003,Aichstetten,35 - 40 Jahre,206,111,95
False,8436003,Aichstetten,40 - 45 Jahre,147,81,66
False,8436003,Aichstetten,45 - 50 Jahre,152,74,78
False,8436003,Aichstetten,50 - 55 Jahre,134,78,56
False,8436003,Aichstetten,55 - 60 Jahre,161,86,75
False,8436003,Aichstetten,60 - 65 Jahre,119,57,62
False,8436003,Aichstetten,65 - 75 Jahre,165,73,92
False,8436003,Aichstetten,75 und mehr Jahre,104,31,73
False,8436003,Aichstetten,Insgesamt,2414,1224,1190
False,8436004,Aitrach,unter 3 Jahre,105,56,49
False,8436004,Aitrach,3 -  6 Jahre,84,48,36
False,8436004,Aitrach,6 - 10 Jahre,121,59,62
False,8436004,Aitrach,10 - 15 Jahre,169,90,79
False,8436004,Aitrach,15 - 18 Jahre,112,51,61
False,8436004,Aitrach,18 - 20 Jahre,73,38,35
False,8436004,Aitrach,20 - 25 Jahre,172,90,82
False,8436004,Aitrach,25 - 30 Jahre,193,110,83
False,8436004,Aitrach,30 - 35 Jahre,203,106,97
False,8436004,Aitrach,35 - 40 Jahre,189,100,89
False,8436004,Aitrach,40 - 45 Jahre,156,73,83
False,8436004,Aitrach,45 - 50 Jahre,195,96,99
False,8436004,Aitrach,50 - 55 Jahre,180,94,86
False,8436004,Aitrach,55 - 60 Jahre,189,104,85
False,8436004,Aitrach,60 - 65 Jahre,132,66,66
False,8436004,Aitrach,65 - 75 Jahre,212,95,117
False,8436004,Aitrach,75 und mehr Jahre,140,38,102
False,8436004,Aitrach,Insgesamt,2625,1314,1311
False,8436005,Altshausen,unter 3 Jahre,153,81,72
False,8436005,Altshausen,3 -  6 Jahre,164,89,75
False,8436005,Altshausen,6 - 10 Jahre,205,109,96
False,8436005,Altshausen,10 - 15 Jahre,314,163,151
False,8436005,Altshausen,15 - 18 Jahre,158,99,59
False,8436005,Altshausen,18 - 20 Jahre,105,45,60
False,8436005,Altshausen,20 - 25 Jahre,321,175,146
False,8436005,Altshausen,25 - 30 Jahre,294,143,151
False,8436005,Altshausen,30 - 35 Jahre,290,166,124
False,8436005,Altshausen,35 - 40 Jahre,344,191,153
False,8436005,Altshausen,40 - 45 Jahre,319,190,129
False,8436005,Altshausen,45 - 50 Jahre,275,178,97
False,8436005,Altshausen,50 - 55 Jahre,238,136,102
False,8436005,Altshausen,55 - 60 Jahre,360,235,125
False,8436005,Altshausen,60 - 65 Jahre,277,174,103
False,8436005,Altshausen,65 - 75 Jahre,372,155,217
False,8436005,Altshausen,75 und mehr Jahre,337,98,239
False,8436005,Altshausen,Insgesamt,4526,2427,2099
False,8436006,Amtzell,unter 3 Jahre,138,66,72
False,8436006,Amtzell,3 -  6 Jahre,156,77,79
False,8436006,Amtzell,6 - 10 Jahre,182,96,86
False,8436006,Amtzell,10 - 15 Jahre,205,105,100
False,8436006,Amtzell,15 - 18 Jahre,121,63,58
False,8436006,Amtzell,18 - 20 Jahre,82,41,41
False,8436006,Amtzell,20 - 25 Jahre,187,90,97
False,8436006,Amtzell,25 - 30 Jahre,250,129,121
False,8436006,Amtzell,30 - 35 Jahre,296,136,160
False,8436006,Amtzell,35 - 40 Jahre,264,129,135
False,8436006,Amtzell,40 - 45 Jahre,259,130,129
False,8436006,Amtzell,45 - 50 Jahre,205,115,90
False,8436006,Amtzell,50 - 55 Jahre,161,80,81
False,8436006,Amtzell,55 - 60 Jahre,137,82,55
False,8436006,Amtzell,60 - 65 Jahre,129,64,65
False,8436006,Amtzell,65 - 75 Jahre,224,86,138
False,8436006,Amtzell,75 und mehr Jahre,207,68,139
False,8436006,Amtzell,Insgesamt,3203,1557,1646
False,8436008,"Aulendorf, Stadt",unter 3 Jahre,302,167,135
False,8436008,"Aulendorf, Stadt",3 -  6 Jahre,361,177,184
False,8436008,"Aulendorf, Stadt",6 - 10 Jahre,522,281,241
False,8436008,"Aulendorf, Stadt",10 - 15 Jahre,568,313,255
False,8436008,"Aulendorf, Stadt",15 - 18 Jahre,291,141,150
False,8436008,"Aulendorf, Stadt",18 - 20 Jahre,215,120,95
False,8436008,"Aulendorf, Stadt",20 - 25 Jahre,557,306,251
False,8436008,"Aulendorf, Stadt",25 - 30 Jahre,631,325,306
False,8436008,"Aulendorf, Stadt",30 - 35 Jahre,764,364,400
False,8436008,"Aulendorf, Stadt",35 - 40 Jahre,701,348,353
False,8436008,"Aulendorf, Stadt",40 - 45 Jahre,589,291,298
False,8436008,"Aulendorf, Stadt",45 - 50 Jahre,559,290,269
False,8436008,"Aulendorf, Stadt",50 - 55 Jahre,437,231,206
False,8436008,"Aulendorf, Stadt",55 - 60 Jahre,500,246,254
False,8436008,"Aulendorf, Stadt",60 - 65 Jahre,424,205,219
False,8436008,"Aulendorf, Stadt",65 - 75 Jahre,762,299,463
False,8436008,"Aulendorf, Stadt",75 und mehr Jahre,594,173,421
False,8436008,"Aulendorf, Stadt",Insgesamt,8777,4277,4500
False,8436009,"Bad Waldsee, Stadt",unter 3 Jahre,645,318,327
False,8436009,"Bad Waldsee, Stadt",3 -  6 Jahre,764,400,364
False,8436009,"Bad Waldsee, Stadt",6 - 10 Jahre,987,515,472
False,8436009,"Bad Waldsee, Stadt",10 - 15 Jahre,1071,537,534
False,8436009,"Bad Waldsee, Stadt",15 - 18 Jahre,610,332,278
False,8436009,"Bad Waldsee, Stadt",18 - 20 Jahre,414,199,215
False,8436009,"Bad Waldsee, Stadt",20 - 25 Jahre,1267,614,653
False,8436009,"Bad Waldsee, Stadt",25 - 30 Jahre,1603,805,798
False,8436009,"Bad Waldsee, Stadt",30 - 35 Jahre,1538,768,770
False,8436009,"Bad Waldsee, Stadt",35 - 40 Jahre,1396,699,697
False,8436009,"Bad Waldsee, Stadt",40 - 45 Jahre,1252,628,624
False,8436009,"Bad Waldsee, Stadt",45 - 50 Jahre,1117,529,588
False,8436009,"Bad Waldsee, Stadt",50 - 55 Jahre,1043,503,540
False,8436009,"Bad Waldsee, Stadt",55 - 60 Jahre,1133,576,557
False,8436009,"Bad Waldsee, Stadt",60 - 65 Jahre,798,387,411
False,8436009,"Bad Waldsee, Stadt",65 - 75 Jahre,1485,567,918
False,8436009,"Bad Waldsee, Stadt",75 und mehr Jahre,1244,345,899
False,8436009,"Bad Waldsee, Stadt",Insgesamt,18367,8722,9645
False,8436010,"Bad Wurzach, Stadt",unter 3 Jahre,600,294,306
False,8436010,"Bad Wurzach, Stadt",3 -  6 Jahre,667,350,317
False,8436010,"Bad Wurzach, Stadt",6 - 10 Jahre,823,412,411
False,8436010,"Bad Wurzach, Stadt",10 - 15 Jahre,923,485,438
False,8436010,"Bad Wurzach, Stadt",15 - 18 Jahre,535,275,260
False,8436010,"Bad Wurzach, Stadt",18 - 20 Jahre,327,176,151
False,8436010,"Bad Wurzach, Stadt",20 - 25 Jahre,1053,572,481
False,8436010,"Bad Wurzach, Stadt",25 - 30 Jahre,1276,673,603
False,8436010,"Bad Wurzach, Stadt",30 - 35 Jahre,1241,645,596
False,8436010,"Bad Wurzach, Stadt",35 - 40 Jahre,1021,555,466
False,8436010,"Bad Wurzach, Stadt",40 - 45 Jahre,876,465,411
False,8436010,"Bad Wurzach, Stadt",45 - 50 Jahre,762,400,362
False,8436010,"Bad Wurzach, Stadt",50 - 55 Jahre,671,358,313
False,8436010,"Bad Wurzach, Stadt",55 - 60 Jahre,856,451,405
False,8436010,"Bad Wurzach, Stadt",60 - 65 Jahre,624,322,302
False,8436010,"Bad Wurzach, Stadt",65 - 75 Jahre,970,399,571
False,8436010,"Bad Wurzach, Stadt",75 und mehr Jahre,727,239,488
False,8436010,"Bad Wurzach, Stadt",Insgesamt,13952,7071,6881
False,8436011,Baienfurt,unter 3 Jahre,240,122,118
False,8436011,Baienfurt,3 -  6 Jahre,270,128,142
False,8436011,Baienfurt,6 - 10 Jahre,341,168,173
False,8436011,Baienfurt,10 - 15 Jahre,377,196,181
False,8436011,Baienfurt,15 - 18 Jahre,192,86,106
False,8436011,Baienfurt,18 - 20 Jahre,125,61,64
False,8436011,Baienfurt,20 - 25 Jahre,438,222,216
False,8436011,Baienfurt,25 - 30 Jahre,628,325,303
False,8436011,Baienfurt,30 - 35 Jahre,584,315,269
False,8436011,Baienfurt,35 - 40 Jahre,526,264,262
False,8436011,Baienfurt,40 - 45 Jahre,475,236,239
False,8436011,Baienfurt,45 - 50 Jahre,401,203,198
False,8436011,Baienfurt,50 - 55 Jahre,438,219,219
False,8436011,Baienfurt,55 - 60 Jahre,529,254,275
False,8436011,Baienfurt,60 - 65 Jahre,389,190,199
False,8436011,Baienfurt,65 - 75 Jahre,561,249,312
False,8436011,Baienfurt,75 und mehr Jahre,369,114,255
False,8436011,Baienfurt,Insgesamt,6883,3352,3531
False,8436012,Baindt,unter 3 Jahre,135,70,65
False,8436012,Baindt,3 -  6 Jahre,172,81,91
False,8436012,Baindt,6 - 10 Jahre,258,136,122
False,8436012,Baindt,10 - 15 Jahre,281,146,135
False,8436012,Baindt,15 - 18 Jahre,174,84,90
False,8436012,Baindt,18 - 20 Jahre,116,54,62
False,8436012,Baindt,20 - 25 Jahre,268,138,130
False,8436012,Baindt,25 - 30 Jahre,392,193,199
False,8436012,Baindt,30 - 35 Jahre,410,211,199
False,8436012,Baindt,35 - 40 Jahre,361,171,190
False,8436012,Baindt,40 - 45 Jahre,340,164,176
False,8436012,Baindt,45 - 50 Jahre,299,151,148
False,8436012,Baindt,50 - 55 Jahre,323,160,163
False,8436012,Baindt,55 - 60 Jahre,320,170,150
False,8436012,Baindt,60 - 65 Jahre,237,114,123
False,8436012,Baindt,65 - 75 Jahre,319,141,178
False,8436012,Baindt,75 und mehr Jahre,146,53,93
False,8436012,Baindt,Insgesamt,4551,2237,2314
False,8436013,Berg,unter 3 Jahre,114,67,47
False,8436013,Berg,3 -  6 Jahre,142,77,65
False,8436013,Berg,6 - 10 Jahre,174,102,72
False,8436013,Berg,10 - 15 Jahre,207,119,88
False,8436013,Berg,15 - 18 Jahre,133,79,54
False,8436013,Berg,18 - 20 Jahre,83,43,40
False,8436013,Berg,20 - 25 Jahre,262,151,111
False,8436013,Berg,25 - 30 Jahre,316,188,128
False,8436013,Berg,30 - 35 Jahre,288,142,146
False,8436013,Berg,35 - 40 Jahre,274,132,142
False,8436013,Berg,40 - 45 Jahre,250,114,136
False,8436013,Berg,45 - 50 Jahre,251,134,117
False,8436013,Berg,50 - 55 Jahre,257,111,146
False,8436013,Berg,55 - 60 Jahre,272,158,114
False,8436013,Berg,60 - 65 Jahre,174,83,91
False,8436013,Berg,65 - 75 Jahre,266,118,148
False,8436013,Berg,75 und mehr Jahre,186,47,139
False,8436013,Berg,Insgesamt,3649,1865,1784
False,8436014,Bergatreute,unter 3 Jahre,140,80,60
False,8436014,Bergatreute,3 -  6 Jahre,149,86,63
False,8436014,Bergatreute,6 - 10 Jahre,213,102,111
False,8436014,Bergatreute,10 - 15 Jahre,210,98,112
False,8436014,Bergatreute,15 - 18 Jahre,88,42,46
False,8436014,Bergatreute,18 - 20 Jahre,66,30,36
False,8436014,Bergatreute,20 - 25 Jahre,167,85,82
False,8436014,Bergatreute,25 - 30 Jahre,227,123,104
False,8436014,Bergatreute,30 - 35 Jahre,287,134,153
False,8436014,Bergatreute,35 - 40 Jahre,253,143,110
False,8436014,Bergatreute,40 - 45 Jahre,208,103,105
False,8436014,Bergatreute,45 - 50 Jahre,148,85,63
False,8436014,Bergatreute,50 - 55 Jahre,125,61,64
False,8436014,Bergatreute,55 - 60 Jahre,180,92,88
False,8436014,Bergatreute,60 - 65 Jahre,127,63,64
False,8436014,Bergatreute,65 - 75 Jahre,192,90,102
False,8436014,Bergatreute,75 und mehr Jahre,96,25,71
False,8436014,Bergatreute,Insgesamt,2876,1442,1434
False,8436018,Bodnegg,unter 3 Jahre,83,38,45
False,8436018,Bodnegg,3 -  6 Jahre,112,58,54
False,8436018,Bodnegg,6 - 10 Jahre,149,76,73
False,8436018,Bodnegg,10 - 15 Jahre,155,73,82
False,8436018,Bodnegg,15 - 18 Jahre,82,37,45
False,8436018,Bodnegg,18 - 20 Jahre,55,31,24
False,8436018,Bodnegg,20 - 25 Jahre,161,91,70
False,8436018,Bodnegg,25 - 30 Jahre,240,136,104
False,8436018,Bodnegg,30 - 35 Jahre,238,144,94
False,8436018,Bodnegg,35 - 40 Jahre,217,105,112
False,8436018,Bodnegg,40 - 45 Jahre,204,101,103
False,8436018,Bodnegg,45 - 50 Jahre,200,109,91
False,8436018,Bodnegg,50 - 55 Jahre,182,96,86
False,8436018,Bodnegg,55 - 60 Jahre,232,108,124
False,8436018,Bodnegg,60 - 65 Jahre,161,88,73
False,8436018,Bodnegg,65 - 75 Jahre,230,107,123
False,8436018,Bodnegg,75 und mehr Jahre,160,51,109
False,8436018,Bodnegg,Insgesamt,2861,1449,1412
False,8436019,Boms,unter 3 Jahre,14,9,5
False,8436019,Boms,3 -  6 Jahre,27,18,9
False,8436019,Boms,6 - 10 Jahre,35,23,12
False,8436019,Boms,10 - 15 Jahre,36,18,18
False,8436019,Boms,15 - 18 Jahre,27,15,12
False,8436019,Boms,18 - 20 Jahre,10,8,2
False,8436019,Boms,20 - 25 Jahre,18,12,6
False,8436019,Boms,25 - 30 Jahre,38,14,24
False,8436019,Boms,30 - 35 Jahre,43,21,22
False,8436019,Boms,35 - 40 Jahre,52,29,23
False,8436019,Boms,40 - 45 Jahre,48,24,24
False,8436019,Boms,45 - 50 Jahre,18,13,5
False,8436019,Boms,50 - 55 Jahre,14,8,6
False,8436019,Boms,55 - 60 Jahre,20,12,8
False,8436019,Boms,60 - 65 Jahre,27,13,14
False,8436019,Boms,65 - 75 Jahre,46,21,25
False,8436019,Boms,75 und mehr Jahre,25,5,20
False,8436019,Boms,Insgesamt,498,263,235
False,8436024,Ebenweiler,unter 3 Jahre,35,21,14
False,8436024,Ebenweiler,3 -  6 Jahre,73,44,29
False,8436024,Ebenweiler,6 - 10 Jahre,65,29,36
False,8436024,Ebenweiler,10 - 15 Jahre,66,41,25
False,8436024,Ebenweiler,15 - 18 Jahre,28,16,12
False,8436024,Ebenweiler,18 - 20 Jahre,22,12,10
False,8436024,Ebenweiler,20 - 25 Jahre,62,27,35
False,8436024,Ebenweiler,25 - 30 Jahre,73,32,41
False,8436024,Ebenweiler,30 - 35 Jahre,90,43,47
False,8436024,Ebenweiler,35 - 40 Jahre,80,42,38
False,8436024,Ebenweiler,40 - 45 Jahre,65,35,30
False,8436024,Ebenweiler,45 - 50 Jahre,50,31,19
False,8436024,Ebenweiler,50 - 55 Jahre,48,19,29
False,8436024,Ebenweiler,55 - 60 Jahre,51,26,25
False,8436024,Ebenweiler,60 - 65 Jahre,34,20,14
False,8436024,Ebenweiler,65 - 75 Jahre,71,33,38
False,8436024,Ebenweiler,75 und mehr Jahre,36,12,24
False,8436024,Ebenweiler,Insgesamt,949,483,466
False,8436027,Eichstegen,unter 3 Jahre,17,11,6
False,8436027,Eichstegen,3 -  6 Jahre,22,9,13
False,8436027,Eichstegen,6 - 10 Jahre,32,18,14
False,8436027,Eichstegen,10 - 15 Jahre,28,15,13
False,8436027,Eichstegen,15 - 18 Jahre,21,14,7
False,8436027,Eichstegen,18 - 20 Jahre,9,4,5
False,8436027,Eichstegen,20 - 25 Jahre,26,9,17
False,8436027,Eichstegen,25 - 30 Jahre,29,15,14
False,8436027,Eichstegen,30 - 35 Jahre,51,27,24
False,8436027,Eichstegen,35 - 40 Jahre,39,18,21
False,8436027,Eichstegen,40 - 45 Jahre,30,17,13
False,8436027,Eichstegen,45 - 50 Jahre,18,9,9
False,8436027,Eichstegen,50 - 55 Jahre,11,5,6
False,8436027,Eichstegen,55 - 60 Jahre,27,16,11
False,8436027,Eichstegen,60 - 65 Jahre,24,14,10
False,8436027,Eichstegen,65 - 75 Jahre,45,18,27
False,8436027,Eichstegen,75 und mehr Jahre,28,8,20
False,8436027,Eichstegen,Insgesamt,457,227,230
False,8436032,Fleischwangen,unter 3 Jahre,28,16,12
False,8436032,Fleischwangen,3 -  6 Jahre,36,26,10
False,8436032,Fleischwangen,6 - 10 Jahre,41,17,24
False,8436032,Fleischwangen,10 - 15 Jahre,29,21,8
False,8436032,Fleischwangen,15 - 18 Jahre,21,5,16
False,8436032,Fleischwangen,18 - 20 Jahre,14,4,10
False,8436032,Fleischwangen,20 - 25 Jahre,29,17,12
False,8436032,Fleischwangen,25 - 30 Jahre,61,37,24
False,8436032,Fleischwangen,30 - 35 Jahre,56,28,28
False,8436032,Fleischwangen,35 - 40 Jahre,41,21,20
False,8436032,Fleischwangen,40 - 45 Jahre,21,8,13
False,8436032,Fleischwangen,45 - 50 Jahre,31,17,14
False,8436032,Fleischwangen,50 - 55 Jahre,32,18,14
False,8436032,Fleischwangen,55 - 60 Jahre,26,17,9
False,8436032,Fleischwangen,60 - 65 Jahre,21,9,12
False,8436032,Fleischwangen,65 - 75 Jahre,22,9,13
False,8436032,Fleischwangen,75 und mehr Jahre,12,4,8
False,8436032,Fleischwangen,Insgesamt,521,274,247
False,8436039,Grünkraut,unter 3 Jahre,106,45,61
False,8436039,Grünkraut,3 -  6 Jahre,101,50,51
False,8436039,Grünkraut,6 - 10 Jahre,179,107,72
False,8436039,Grünkraut,10 - 15 Jahre,193,86,107
False,8436039,Grünkraut,15 - 18 Jahre,104,40,64
False,8436039,Grünkraut,18 - 20 Jahre,65,30,35
False,8436039,Grünkraut,20 - 25 Jahre,163,85,78
False,8436039,Grünkraut,25 - 30 Jahre,253,131,122
False,8436039,Grünkraut,30 - 35 Jahre,253,127,126
False,8436039,Grünkraut,35 - 40 Jahre,242,123,119
False,8436039,Grünkraut,40 - 45 Jahre,227,112,115
False,8436039,Grünkraut,45 - 50 Jahre,183,86,97
False,8436039,Grünkraut,50 - 55 Jahre,171,96,75
False,8436039,Grünkraut,55 - 60 Jahre,178,87,91
False,8436039,Grünkraut,60 - 65 Jahre,132,70,62
False,8436039,Grünkraut,65 - 75 Jahre,183,78,105
False,8436039,Grünkraut,75 und mehr Jahre,109,39,70
False,8436039,Grünkraut,Insgesamt,2842,1392,1450
False,8436040,Guggenhausen,unter 3 Jahre,10,6,4
False,8436040,Guggenhausen,3 -  6 Jahre,6,4,2
False,8436040,Guggenhausen,6 - 10 Jahre,14,5,9
False,8436040,Guggenhausen,10 - 15 Jahre,13,8,5
False,8436040,Guggenhausen,15 - 18 Jahre,11,8,3
False,8436040,Guggenhausen,18 - 20 Jahre,5,4,1
False,8436040,Guggenhausen,20 - 25 Jahre,19,12,7
False,8436040,Guggenhausen,25 - 30 Jahre,9,5,4
False,8436040,Guggenhausen,30 - 35 Jahre,21,11,10
False,8436040,Guggenhausen,35 - 40 Jahre,23,15,8
False,8436040,Guggenhausen,40 - 45 Jahre,13,7,6
False,8436040,Guggenhausen,45 - 50 Jahre,10,4,6
False,8436040,Guggenhausen,50 - 55 Jahre,8,5,3
False,8436040,Guggenhausen,55 - 60 Jahre,17,11,6
False,8436040,Guggenhausen,60 - 65 Jahre,9,3,6
False,8436040,Guggenhausen,65 - 75 Jahre,12,7,5
False,8436040,Guggenhausen,75 und mehr Jahre,16,3,13
False,8436040,Guggenhausen,Insgesamt,216,118,98
False,8436047,Hoßkirch,unter 3 Jahre,34,18,16
False,8436047,Hoßkirch,3 -  6 Jahre,36,22,14
False,8436047,Hoßkirch,6 - 10 Jahre,38,18,20
False,8436047,Hoßkirch,10 - 15 Jahre,52,30,22
False,8436047,Hoßkirch,15 - 18 Jahre,22,11,11
False,8436047,Hoßkirch,18 - 20 Jahre,11,9,2
False,8436047,Hoßkirch,20 - 25 Jahre,33,17,16
False,8436047,Hoßkirch,25 - 30 Jahre,47,22,25
False,8436047,Hoßkirch,30 - 35 Jahre,57,35,22
False,8436047,Hoßkirch,35 - 40 Jahre,63,26,37
False,8436047,Hoßkirch,40 - 45 Jahre,57,30,27
False,8436047,Hoßkirch,45 - 50 Jahre,67,41,26
False,8436047,Hoßkirch,50 - 55 Jahre,30,17,13
False,8436047,Hoßkirch,55 - 60 Jahre,45,24,21
False,8436047,Hoßkirch,60 - 65 Jahre,26,13,13
False,8436047,Hoßkirch,65 - 75 Jahre,37,15,22
False,8436047,Hoßkirch,75 und mehr Jahre,36,12,24
False,8436047,Hoßkirch,Insgesamt,691,360,331
False,8436049,"Isny im Allgäu, Stadt",unter 3 Jahre,451,236,215
False,8436049,"Isny im Allgäu, Stadt",3 -  6 Jahre,510,267,243
False,8436049,"Isny im Allgäu, Stadt",6 - 10 Jahre,618,334,284
False,8436049,"Isny im Allgäu, Stadt",10 - 15 Jahre,796,411,385
False,8436049,"Isny im Allgäu, Stadt",15 - 18 Jahre,544,275,269
False,8436049,"Isny im Allgäu, Stadt",18 - 20 Jahre,401,209,192
False,8436049,"Isny im Allgäu, Stadt",20 - 25 Jahre,1182,558,624
False,8436049,"Isny im Allgäu, Stadt",25 - 30 Jahre,1564,703,861
False,8436049,"Isny im Allgäu, Stadt",30 - 35 Jahre,1408,696,712
False,8436049,"Isny im Allgäu, Stadt",35 - 40 Jahre,1031,500,531
False,8436049,"Isny im Allgäu, Stadt",40 - 45 Jahre,863,455,408
False,8436049,"Isny im Allgäu, Stadt",45 - 50 Jahre,788,393,395
False,8436049,"Isny im Allgäu, Stadt",50 - 55 Jahre,756,399,357
False,8436049,"Isny im Allgäu, Stadt",55 - 60 Jahre,817,406,411
False,8436049,"Isny im Allgäu, Stadt",60 - 65 Jahre,613,295,318
False,8436049,"Isny im Allgäu, Stadt",65 - 75 Jahre,1127,440,687
False,8436049,"Isny im Allgäu, Stadt",75 und mehr Jahre,1006,313,693
False,8436049,"Isny im Allgäu, Stadt",Insgesamt,14475,6890,7585
False,8436052,Kißlegg,unter 3 Jahre,393,206,187
False,8436052,Kißlegg,3 -  6 Jahre,362,198,164
False,8436052,Kißlegg,6 - 10 Jahre,501,271,230
False,8436052,Kißlegg,10 - 15 Jahre,625,307,318
False,8436052,Kißlegg,15 - 18 Jahre,354,184,170
False,8436052,Kißlegg,18 - 20 Jahre,216,119,97
False,8436052,Kißlegg,20 - 25 Jahre,499,252,247
False,8436052,Kißlegg,25 - 30 Jahre,656,326,330
False,8436052,Kißlegg,30 - 35 Jahre,727,379,348
False,8436052,Kißlegg,35 - 40 Jahre,655,336,319
False,8436052,Kißlegg,40 - 45 Jahre,573,321,252
False,8436052,Kißlegg,45 - 50 Jahre,511,257,254
False,8436052,Kißlegg,50 - 55 Jahre,404,210,194
False,8436052,Kißlegg,55 - 60 Jahre,478,244,234
False,8436052,Kißlegg,60 - 65 Jahre,379,183,196
False,8436052,Kißlegg,65 - 75 Jahre,610,276,334
False,8436052,Kißlegg,75 und mehr Jahre,604,184,420
False,8436052,Kißlegg,Insgesamt,8547,4253,4294
False,8436053,Königseggwald,unter 3 Jahre,28,13,15
False,8436053,Königseggwald,3 -  6 Jahre,32,19,13
False,8436053,Königseggwald,6 - 10 Jahre,34,19,15
False,8436053,Königseggwald,10 - 15 Jahre,44,23,21
False,8436053,Königseggwald,15 - 18 Jahre,24,13,11
False,8436053,Königseggwald,18 - 20 Jahre,18,10,8
False,8436053,Königseggwald,20 - 25 Jahre,31,16,15
False,8436053,Königseggwald,25 - 30 Jahre,57,30,27
False,8436053,Königseggwald,30 - 35 Jahre,54,33,21
False,8436053,Königseggwald,35 - 40 Jahre,42,15,27
False,8436053,Königseggwald,40 - 45 Jahre,47,27,20
False,8436053,Königseggwald,45 - 50 Jahre,25,16,9
False,8436053,Königseggwald,50 - 55 Jahre,36,15,21
False,8436053,Königseggwald,55 - 60 Jahre,45,27,18
False,8436053,Königseggwald,60 - 65 Jahre,46,24,22
False,8436053,Königseggwald,65 - 75 Jahre,40,19,21
False,8436053,Königseggwald,75 und mehr Jahre,22,4,18
False,8436053,Königseggwald,Insgesamt,625,323,302
False,8436055,"Leutkirch im Allgäu, Stadt",unter 3 Jahre,838,441,397
False,8436055,"Leutkirch im Allgäu, Stadt",3 -  6 Jahre,918,457,461
False,8436055,"Leutkirch im Allgäu, Stadt",6 - 10 Jahre,1165,591,574
False,8436055,"Leutkirch im Allgäu, Stadt",10 - 15 Jahre,1419,750,669
False,8436055,"Leutkirch im Allgäu, Stadt",15 - 18 Jahre,756,412,344
False,8436055,"Leutkirch im Allgäu, Stadt",18 - 20 Jahre,504,258,246
False,8436055,"Leutkirch im Allgäu, Stadt",20 - 25 Jahre,1374,725,649
False,8436055,"Leutkirch im Allgäu, Stadt",25 - 30 Jahre,1693,902,791
False,8436055,"Leutkirch im Allgäu, Stadt",30 - 35 Jahre,1799,969,830
False,8436055,"Leutkirch im Allgäu, Stadt",35 - 40 Jahre,1636,834,802
False,8436055,"Leutkirch im Allgäu, Stadt",40 - 45 Jahre,1405,706,699
False,8436055,"Leutkirch im Allgäu, Stadt",45 - 50 Jahre,1264,663,601
False,8436055,"Leutkirch im Allgäu, Stadt",50 - 55 Jahre,1165,617,548
False,8436055,"Leutkirch im Allgäu, Stadt",55 - 60 Jahre,1379,692,687
False,8436055,"Leutkirch im Allgäu, Stadt",60 - 65 Jahre,1023,518,505
False,8436055,"Leutkirch im Allgäu, Stadt",65 - 75 Jahre,1796,734,1062
False,8436055,"Leutkirch im Allgäu, Stadt",75 und mehr Jahre,1451,486,965
False,8436055,"Leutkirch im Allgäu, Stadt",Insgesamt,21585,10755,10830
False,8436064,"Ravensburg, Stadt",unter 3 Jahre,1399,742,657
False,8436064,"Ravensburg, Stadt",3 -  6 Jahre,1621,844,777
False,8436064,"Ravensburg, Stadt",6 - 10 Jahre,1996,1036,960
False,8436064,"Ravensburg, Stadt",10 - 15 Jahre,2333,1219,1114
False,8436064,"Ravensburg, Stadt",15 - 18 Jahre,1353,716,637
False,8436064,"Ravensburg, Stadt",18 - 20 Jahre,1103,590,513
False,8436064,"Ravensburg, Stadt",20 - 25 Jahre,2890,1379,1511
False,8436064,"Ravensburg, Stadt",25 - 30 Jahre,4091,2020,2071
False,8436064,"Ravensburg, Stadt",30 - 35 Jahre,4214,2197,2017
False,8436064,"Ravensburg, Stadt",35 - 40 Jahre,3556,1821,1735
False,8436064,"Ravensburg, Stadt",40 - 45 Jahre,2955,1423,1532
False,8436064,"Ravensburg, Stadt",45 - 50 Jahre,2818,1420,1398
False,8436064,"Ravensburg, Stadt",50 - 55 Jahre,2951,1471,1480
False,8436064,"Ravensburg, Stadt",55 - 60 Jahre,3324,1633,1691
False,8436064,"Ravensburg, Stadt",60 - 65 Jahre,2299,1110,1189
False,8436064,"Ravensburg, Stadt",65 - 75 Jahre,4300,1763,2537
False,8436064,"Ravensburg, Stadt",75 und mehr Jahre,3417,1007,2410
False,8436064,"Ravensburg, Stadt",Insgesamt,46620,22391,24229
False,8436067,Riedhausen,unter 3 Jahre,45,22,23
False,8436067,Riedhausen,3 -  6 Jahre,32,18,14
False,8436067,Riedhausen,6 - 10 Jahre,42,25,17
False,8436067,Riedhausen,10 - 15 Jahre,37,18,19
False,8436067,Riedhausen,15 - 18 Jahre,15,7,8
False,8436067,Riedhausen,18 - 20 Jahre,7,4,3
False,8436067,Riedhausen,20 - 25 Jahre,22,10,12
False,8436067,Riedhausen,25 - 30 Jahre,50,25,25
False,8436067,Riedhausen,30 - 35 Jahre,44,22,22
False,8436067,Riedhausen,35 - 40 Jahre,52,29,23
False,8436067,Riedhausen,40 - 45 Jahre,29,20,9
False,8436067,Riedhausen,45 - 50 Jahre,20,11,9
False,8436067,Riedhausen,50 - 55 Jahre,14,8,6
False,8436067,Riedhausen,55 - 60 Jahre,28,13,15
False,8436067,Riedhausen,60 - 65 Jahre,23,8,15
False,8436067,Riedhausen,65 - 75 Jahre,39,23,16
False,8436067,Riedhausen,75 und mehr Jahre,15,2,13
False,8436067,Riedhausen,Insgesamt,514,265,249
False,8436069,Schlier,unter 3 Jahre,144,70,74
False,8436069,Schlier,3 -  6 Jahre,158,78,80
False,8436069,Schlier,6 - 10 Jahre,206,105,101
False,8436069,Schlier,10 - 15 Jahre,228,129,99
False,8436069,Schlier,15 - 18 Jahre,145,77,68
False,8436069,Schlier,18 - 20 Jahre,75,43,32
False,8436069,Schlier,20 - 25 Jahre,227,119,108
False,8436069,Schlier,25 - 30 Jahre,253,122,131
False,8436069,Schlier,30 - 35 Jahre,324,161,163
False,8436069,Schlier,35 - 40 Jahre,336,163,173
False,8436069,Schlier,40 - 45 Jahre,274,144,130
False,8436069,Schlier,45 - 50 Jahre,201,102,99
False,8436069,Schlier,50 - 55 Jahre,221,123,98
False,8436069,Schlier,55 - 60 Jahre,247,132,115
False,8436069,Schlier,60 - 65 Jahre,151,75,76
False,8436069,Schlier,65 - 75 Jahre,244,117,127
False,8436069,Schlier,75 und mehr Jahre,156,65,91
False,8436069,Schlier,Insgesamt,3590,1825,1765
False,8436077,Unterwaldhausen,unter 3 Jahre,14,5,9
False,8436077,Unterwaldhausen,3 -  6 Jahre,11,6,5
False,8436077,Unterwaldhausen,6 - 10 Jahre,26,12,14
False,8436077,Unterwaldhausen,10 - 15 Jahre,16,9,7
False,8436077,Unterwaldhausen,15 - 18 Jahre,7,3,4
False,8436077,Unterwaldhausen,18 - 20 Jahre,4,4,0
False,8436077,Unterwaldhausen,20 - 25 Jahre,17,9,8
False,8436077,Unterwaldhausen,25 - 30 Jahre,34,20,14
False,8436077,Unterwaldhausen,30 - 35 Jahre,22,10,12
False,8436077,Unterwaldhausen,35 - 40 Jahre,16,7,9
False,8436077,Unterwaldhausen,40 - 45 Jahre,19,11,8
False,8436077,Unterwaldhausen,45 - 50 Jahre,13,9,4
False,8436077,Unterwaldhausen,50 - 55 Jahre,7,4,3
False,8436077,Unterwaldhausen,55 - 60 Jahre,7,5,2
False,8436077,Unterwaldhausen,60 - 65 Jahre,6,4,2
False,8436077,Unterwaldhausen,65 - 75 Jahre,18,7,11
False,8436077,Unterwaldhausen,75 und mehr Jahre,16,6,10
False,8436077,Unterwaldhausen,Insgesamt,253,131,122
False,8436078,Vogt,unter 3 Jahre,177,91,86
False,8436078,Vogt,3 -  6 Jahre,217,107,110
False,8436078,Vogt,6 - 10 Jahre,267,123,144
False,8436078,Vogt,10 - 15 Jahre,283,150,133
False,8436078,Vogt,15 - 18 Jahre,171,93,78
False,8436078,Vogt,18 - 20 Jahre,75,41,34
False,8436078,Vogt,20 - 25 Jahre,249,133,116
False,8436078,Vogt,25 - 30 Jahre,351,177,174
False,8436078,Vogt,30 - 35 Jahre,396,203,193
False,8436078,Vogt,35 - 40 Jahre,395,183,212
False,8436078,Vogt,40 - 45 Jahre,324,171,153
False,8436078,Vogt,45 - 50 Jahre,260,149,111
False,8436078,Vogt,50 - 55 Jahre,261,135,126
False,8436078,Vogt,55 - 60 Jahre,263,133,130
False,8436078,Vogt,60 - 65 Jahre,173,89,84
False,8436078,Vogt,65 - 75 Jahre,276,115,161
False,8436078,Vogt,75 und mehr Jahre,226,76,150
False,8436078,Vogt,Insgesamt,4364,2169,2195
False,8436079,Waldburg,unter 3 Jahre,82,43,39
False,8436079,Waldburg,3 -  6 Jahre,97,43,54
False,8436079,Waldburg,6 - 10 Jahre,129,75,54
False,8436079,Waldburg,10 - 15 Jahre,133,69,64
False,8436079,Waldburg,15 - 18 Jahre,74,33,41
False,8436079,Waldburg,18 - 20 Jahre,60,33,27
False,8436079,Waldburg,20 - 25 Jahre,123,63,60
False,8436079,Waldburg,25 - 30 Jahre,173,97,76
False,8436079,Waldburg,30 - 35 Jahre,198,94,104
False,8436079,Waldburg,35 - 40 Jahre,180,102,78
False,8436079,Waldburg,40 - 45 Jahre,161,84,77
False,8436079,Waldburg,45 - 50 Jahre,147,81,66
False,8436079,Waldburg,50 - 55 Jahre,142,67,75
False,8436079,Waldburg,55 - 60 Jahre,168,92,76
False,8436079,Waldburg,60 - 65 Jahre,113,63,50
False,8436079,Waldburg,65 - 75 Jahre,173,72,101
False,8436079,Waldburg,75 und mehr Jahre,123,44,79
False,8436079,Waldburg,Insgesamt,2276,1155,1121
False,8436081,"Wangen im Allgäu, Stadt",unter 3 Jahre,878,426,452
False,8436081,"Wangen im Allgäu, Stadt",3 -  6 Jahre,960,498,462
False,8436081,"Wangen im Allgäu, Stadt",6 - 10 Jahre,1320,639,681
False,8436081,"Wangen im Allgäu, Stadt",10 - 15 Jahre,1406,715,691
False,8436081,"Wangen im Allgäu, Stadt",15 - 18 Jahre,903,463,440
False,8436081,"Wangen im Allgäu, Stadt",18 - 20 Jahre,567,287,280
False,8436081,"Wangen im Allgäu, Stadt",20 - 25 Jahre,1612,841,771
False,8436081,"Wangen im Allgäu, Stadt",25 - 30 Jahre,2138,1147,991
False,8436081,"Wangen im Allgäu, Stadt",30 - 35 Jahre,2232,1142,1090
False,8436081,"Wangen im Allgäu, Stadt",35 - 40 Jahre,1840,922,918
False,8436081,"Wangen im Allgäu, Stadt",40 - 45 Jahre,1610,781,829
False,8436081,"Wangen im Allgäu, Stadt",45 - 50 Jahre,1603,833,770
False,8436081,"Wangen im Allgäu, Stadt",50 - 55 Jahre,1510,778,732
False,8436081,"Wangen im Allgäu, Stadt",55 - 60 Jahre,1682,808,874
False,8436081,"Wangen im Allgäu, Stadt",60 - 65 Jahre,1309,650,659
False,8436081,"Wangen im Allgäu, Stadt",65 - 75 Jahre,2301,950,1351
False,8436081,"Wangen im Allgäu, Stadt",75 und mehr Jahre,1850,587,1263
False,8436081,"Wangen im Allgäu, Stadt",Insgesamt,25721,12467,13254
False,8436082,"Weingarten, Stadt",unter 3 Jahre,687,367,320
False,8436082,"Weingarten, Stadt",3 -  6 Jahre,755,407,348
False,8436082,"Weingarten, Stadt",6 - 10 Jahre,992,533,459
False,8436082,"Weingarten, Stadt",10 - 15 Jahre,1138,579,559
False,8436082,"Weingarten, Stadt",15 - 18 Jahre,690,335,355
False,8436082,"Weingarten, Stadt",18 - 20 Jahre,478,254,224
False,8436082,"Weingarten, Stadt",20 - 25 Jahre,1647,891,756
False,8436082,"Weingarten, Stadt",25 - 30 Jahre,2248,1262,986
False,8436082,"Weingarten, Stadt",30 - 35 Jahre,2203,1170,1033
False,8436082,"Weingarten, Stadt",35 - 40 Jahre,1748,850,898
False,8436082,"Weingarten, Stadt",40 - 45 Jahre,1536,758,778
False,8436082,"Weingarten, Stadt",45 - 50 Jahre,1347,680,667
False,8436082,"Weingarten, Stadt",50 - 55 Jahre,1397,683,714
False,8436082,"Weingarten, Stadt",55 - 60 Jahre,1681,850,831
False,8436082,"Weingarten, Stadt",60 - 65 Jahre,1170,573,597
False,8436082,"Weingarten, Stadt",65 - 75 Jahre,2140,869,1271
False,8436082,"Weingarten, Stadt",75 und mehr Jahre,1509,453,1056
False,8436082,"Weingarten, Stadt",Insgesamt,23366,11514,11852
False,8436083,Wilhelmsdorf,unter 3 Jahre,199,90,109
False,8436083,Wilhelmsdorf,3 -  6 Jahre,209,107,102
False,8436083,Wilhelmsdorf,6 - 10 Jahre,308,163,145
False,8436083,Wilhelmsdorf,10 - 15 Jahre,372,212,160
False,8436083,Wilhelmsdorf,15 - 18 Jahre,249,142,107
False,8436083,Wilhelmsdorf,18 - 20 Jahre,114,67,47
False,8436083,Wilhelmsdorf,20 - 25 Jahre,304,160,144
False,8436083,Wilhelmsdorf,25 - 30 Jahre,417,222,195
False,8436083,Wilhelmsdorf,30 - 35 Jahre,440,220,220
False,8436083,Wilhelmsdorf,35 - 40 Jahre,390,190,200
False,8436083,Wilhelmsdorf,40 - 45 Jahre,310,173,137
False,8436083,Wilhelmsdorf,45 - 50 Jahre,249,113,136
False,8436083,Wilhelmsdorf,50 - 55 Jahre,234,110,124
False,8436083,Wilhelmsdorf,55 - 60 Jahre,259,128,131
False,8436083,Wilhelmsdorf,60 - 65 Jahre,193,88,105
False,8436083,Wilhelmsdorf,65 - 75 Jahre,296,135,161
False,8436083,Wilhelmsdorf,75 und mehr Jahre,209,76,133
False,8436083,Wilhelmsdorf,Insgesamt,4752,2396,2356
False,8436085,Wolfegg,unter 3 Jahre,124,72,52
False,8436085,Wolfegg,3 -  6 Jahre,126,71,55
False,8436085,Wolfegg,6 - 10 Jahre,159,71,88
False,8436085,Wolfegg,10 - 15 Jahre,195,101,94
False,8436085,Wolfegg,15 - 18 Jahre,117,70,47
False,8436085,Wolfegg,18 - 20 Jahre,84,43,41
False,8436085,Wolfegg,20 - 25 Jahre,211,108,103
False,8436085,Wolfegg,25 - 30 Jahre,264,146,118
False,8436085,Wolfegg,30 - 35 Jahre,231,115,116
False,8436085,Wolfegg,35 - 40 Jahre,229,111,118
False,8436085,Wolfegg,40 - 45 Jahre,221,118,103
False,8436085,Wolfegg,45 - 50 Jahre,181,89,92
False,8436085,Wolfegg,50 - 55 Jahre,168,81,87
False,8436085,Wolfegg,55 - 60 Jahre,217,111,106
False,8436085,Wolfegg,60 - 65 Jahre,152,75,77
False,8436085,Wolfegg,65 - 75 Jahre,274,118,156
False,8436085,Wolfegg,75 und mehr Jahre,241,66,175
False,8436085,Wolfegg,Insgesamt,3194,1566,1628
False,8436087,Wolpertswende,unter 3 Jahre,161,77,84
False,8436087,Wolpertswende,3 -  6 Jahre,196,93,103
False,8436087,Wolpertswende,6 - 10 Jahre,224,124,100
False,8436087,Wolpertswende,10 - 15 Jahre,269,134,135
False,8436087,Wolpertswende,15 - 18 Jahre,155,72,83
False,8436087,Wolpertswende,18 - 20 Jahre,91,49,42
False,8436087,Wolpertswende,20 - 25 Jahre,263,141,122
False,8436087,Wolpertswende,25 - 30 Jahre,331,159,172
False,8436087,Wolpertswende,30 - 35 Jahre,365,183,182
False,8436087,Wolpertswende,35 - 40 Jahre,326,155,171
False,8436087,Wolpertswende,40 - 45 Jahre,296,153,143
False,8436087,Wolpertswende,45 - 50 Jahre,239,138,101
False,8436087,Wolpertswende,50 - 55 Jahre,194,107,87
False,8436087,Wolpertswende,55 - 60 Jahre,261,131,130
False,8436087,Wolpertswende,60 - 65 Jahre,189,96,93
False,8436087,Wolpertswende,65 - 75 Jahre,250,112,138
False,8436087,Wolpertswende,75 und mehr Jahre,187,60,127
False,8436087,Wolpertswende,Insgesamt,3997,1984,2013
False,8436093,Ebersbach-Musbach,unter 3 Jahre,77,45,32
False,8436093,Ebersbach-Musbach,3 -  6 Jahre,90,42,48
False,8436093,Ebersbach-Musbach,6 - 10 Jahre,117,60,57
False,8436093,Ebersbach-Musbach,10 - 15 Jahre,112,52,60
False,8436093,Ebersbach-Musbach,15 - 18 Jahre,58,34,24
False,8436093,Ebersbach-Musbach,18 - 20 Jahre,45,26,19
False,8436093,Ebersbach-Musbach,20 - 25 Jahre,94,47,47
False,8436093,Ebersbach-Musbach,25 - 30 Jahre,130,66,64
False,8436093,Ebersbach-Musbach,30 - 35 Jahre,178,91,87
False,8436093,Ebersbach-Musbach,35 - 40 Jahre,162,92,70
False,8436093,Ebersbach-Musbach,40 - 45 Jahre,119,71,48
False,8436093,Ebersbach-Musbach,45 - 50 Jahre,72,34,38
False,8436093,Ebersbach-Musbach,50 - 55 Jahre,79,50,29
False,8436093,Ebersbach-Musbach,55 - 60 Jahre,90,56,34
False,8436093,Ebersbach-Musbach,60 - 65 Jahre,64,33,31
False,8436093,Ebersbach-Musbach,65 - 75 Jahre,117,48,69
False,8436093,Ebersbach-Musbach,75 und mehr Jahre,70,18,52
False,8436093,Ebersbach-Musbach,Insgesamt,1674,865,809
False,8436094,Argenbühl,unter 3 Jahre,232,114,118
False,8436094,Argenbühl,3 -  6 Jahre,271,130,141
False,8436094,Argenbühl,6 - 10 Jahre,349,178,171
False,8436094,Argenbühl,10 - 15 Jahre,431,223,208
False,8436094,Argenbühl,15 - 18 Jahre,243,122,121
False,8436094,Argenbühl,18 - 20 Jahre,132,72,60
False,8436094,Argenbühl,20 - 25 Jahre,373,198,175
False,8436094,Argenbühl,25 - 30 Jahre,469,246,223
False,8436094,Argenbühl,30 - 35 Jahre,481,246,235
False,8436094,Argenbühl,35 - 40 Jahre,416,210,206
False,8436094,Argenbühl,40 - 45 Jahre,379,200,179
False,8436094,Argenbühl,45 - 50 Jahre,342,192,150
False,8436094,Argenbühl,50 - 55 Jahre,265,135,130
False,8436094,Argenbühl,55 - 60 Jahre,293,152,141
False,8436094,Argenbühl,60 - 65 Jahre,242,118,124
False,8436094,Argenbühl,65 - 75 Jahre,391,165,226
False,8436094,Argenbühl,75 und mehr Jahre,309,106,203
False,8436094,Argenbühl,Insgesamt,5618,2807,2811
False,8436095,Horgenzell,unter 3 Jahre,171,102,69
False,8436095,Horgenzell,3 -  6 Jahre,195,110,85
False,8436095,Horgenzell,6 - 10 Jahre,270,144,126
False,8436095,Horgenzell,10 - 15 Jahre,319,156,163
False,8436095,Horgenzell,15 - 18 Jahre,178,94,84
False,8436095,Horgenzell,18 - 20 Jahre,112,52,60
False,8436095,Horgenzell,20 - 25 Jahre,329,163,166
False,8436095,Horgenzell,25 - 30 Jahre,409,200,209
False,8436095,Horgenzell,30 - 35 Jahre,406,214,192
False,8436095,Horgenzell,35 - 40 Jahre,320,159,161
False,8436095,Horgenzell,40 - 45 Jahre,260,140,120
False,8436095,Horgenzell,45 - 50 Jahre,227,124,103
False,8436095,Horgenzell,50 - 55 Jahre,168,91,77
False,8436095,Horgenzell,55 - 60 Jahre,236,121,115
False,8436095,Horgenzell,60 - 65 Jahre,142,70,72
False,8436095,Horgenzell,65 - 75 Jahre,270,129,141
False,8436095,Horgenzell,75 und mehr Jahre,195,58,137
False,8436095,Horgenzell,Insgesamt,4207,2127,2080
False,8436096,Fronreute,unter 3 Jahre,177,94,83
False,8436096,Fronreute,3 -  6 Jahre,173,87,86
False,8436096,Fronreute,6 - 10 Jahre,248,137,111
False,8436096,Fronreute,10 - 15 Jahre,269,132,137
False,8436096,Fronreute,15 - 18 Jahre,153,82,71
False,8436096,Fronreute,18 - 20 Jahre,77,39,38
False,8436096,Fronreute,20 - 25 Jahre,211,106,105
False,8436096,Fronreute,25 - 30 Jahre,365,176,189
False,8436096,Fronreute,30 - 35 Jahre,402,214,188
False,8436096,Fronreute,35 - 40 Jahre,325,160,165
False,8436096,Fronreute,40 - 45 Jahre,290,143,147
False,8436096,Fronreute,45 - 50 Jahre,244,128,116
False,8436096,Fronreute,50 - 55 Jahre,183,109,74
False,8436096,Fronreute,55 - 60 Jahre,224,119,105
False,8436096,Fronreute,60 - 65 Jahre,169,85,84
False,8436096,Fronreute,65 - 75 Jahre,244,107,137
False,8436096,Fronreute,75 und mehr Jahre,145,42,103
False,8436096,Fronreute,Insgesamt,3899,1960,1939
False,8437,Landkreis Sigmaringen,unter 3 Jahre,4816,2454,2362
False,8437,Landkreis Sigmaringen,3 -  6 Jahre,5216,2694,2522
False,8437,Landkreis Sigmaringen,6 - 10 Jahre,6985,3571,3414
False,8437,Landkreis Sigmaringen,10 - 15 Jahre,8242,4204,4038
False,8437,Landkreis Sigmaringen,15 - 18 Jahre,4816,2442,2374
False,8437,Landkreis Sigmaringen,18 - 20 Jahre,3067,1578,1489
False,8437,Landkreis Sigmaringen,20 - 25 Jahre,8694,4520,4174
False,8437,Landkreis Sigmaringen,25 - 30 Jahre,11574,6264,5310
False,8437,Landkreis Sigmaringen,30 - 35 Jahre,12179,6464,5715
False,8437,Landkreis Sigmaringen,35 - 40 Jahre,9976,5175,4801
False,8437,Landkreis Sigmaringen,40 - 45 Jahre,8551,4335,4216
False,8437,Landkreis Sigmaringen,45 - 50 Jahre,7203,3769,3434
False,8437,Landkreis Sigmaringen,50 - 55 Jahre,6528,3323,3205
False,8437,Landkreis Sigmaringen,55 - 60 Jahre,8495,4220,4275
False,8437,Landkreis Sigmaringen,60 - 65 Jahre,6388,3122,3266
False,8437,Landkreis Sigmaringen,65 - 75 Jahre,10797,4508,6289
False,8437,Landkreis Sigmaringen,75 und mehr Jahre,7125,2151,4974
False,8437,Landkreis Sigmaringen,Insgesamt,130652,64794,65858
False,8437005,Beuron,unter 3 Jahre,17,9,8
False,8437005,Beuron,3 -  6 Jahre,27,14,13
False,8437005,Beuron,6 - 10 Jahre,33,15,18
False,8437005,Beuron,10 - 15 Jahre,38,13,25
False,8437005,Beuron,15 - 18 Jahre,22,9,13
False,8437005,Beuron,18 - 20 Jahre,20,10,10
False,8437005,Beuron,20 - 25 Jahre,29,21,8
False,8437005,Beuron,25 - 30 Jahre,32,18,14
False,8437005,Beuron,30 - 35 Jahre,52,31,21
False,8437005,Beuron,35 - 40 Jahre,56,27,29
False,8437005,Beuron,40 - 45 Jahre,53,30,23
False,8437005,Beuron,45 - 50 Jahre,56,26,30
False,8437005,Beuron,50 - 55 Jahre,48,33,15
False,8437005,Beuron,55 - 60 Jahre,75,41,34
False,8437005,Beuron,60 - 65 Jahre,44,26,18
False,8437005,Beuron,65 - 75 Jahre,109,52,57
False,8437005,Beuron,75 und mehr Jahre,108,36,72
False,8437005,Beuron,Insgesamt,819,411,408
False,8437008,Bingen,unter 3 Jahre,109,48,61
False,8437008,Bingen,3 -  6 Jahre,123,59,64
False,8437008,Bingen,6 - 10 Jahre,157,84,73
False,8437008,Bingen,10 - 15 Jahre,151,79,72
False,8437008,Bingen,15 - 18 Jahre,88,45,43
False,8437008,Bingen,18 - 20 Jahre,55,30,25
False,8437008,Bingen,20 - 25 Jahre,208,110,98
False,8437008,Bingen,25 - 30 Jahre,249,109,140
False,8437008,Bingen,30 - 35 Jahre,285,161,124
False,8437008,Bingen,35 - 40 Jahre,200,95,105
False,8437008,Bingen,40 - 45 Jahre,188,100,88
False,8437008,Bingen,45 - 50 Jahre,194,99,95
False,8437008,Bingen,50 - 55 Jahre,154,78,76
False,8437008,Bingen,55 - 60 Jahre,171,92,79
False,8437008,Bingen,60 - 65 Jahre,134,70,64
False,8437008,Bingen,65 - 75 Jahre,217,87,130
False,8437008,Bingen,75 und mehr Jahre,137,37,100
False,8437008,Bingen,Insgesamt,2820,1383,1437
False,8437031,"Gammertingen, Stadt",unter 3 Jahre,218,105,113
False,8437031,"Gammertingen, Stadt",3 -  6 Jahre,255,124,131
False,8437031,"Gammertingen, Stadt",6 - 10 Jahre,329,176,153
False,8437031,"Gammertingen, Stadt",10 - 15 Jahre,431,226,205
False,8437031,"Gammertingen, Stadt",15 - 18 Jahre,281,144,137
False,8437031,"Gammertingen, Stadt",18 - 20 Jahre,187,97,90
False,8437031,"Gammertingen, Stadt",20 - 25 Jahre,491,256,235
False,8437031,"Gammertingen, Stadt",25 - 30 Jahre,591,318,273
False,8437031,"Gammertingen, Stadt",30 - 35 Jahre,584,295,289
False,8437031,"Gammertingen, Stadt",35 - 40 Jahre,533,277,256
False,8437031,"Gammertingen, Stadt",40 - 45 Jahre,473,232,241
False,8437031,"Gammertingen, Stadt",45 - 50 Jahre,396,206,190
False,8437031,"Gammertingen, Stadt",50 - 55 Jahre,398,195,203
False,8437031,"Gammertingen, Stadt",55 - 60 Jahre,493,243,250
False,8437031,"Gammertingen, Stadt",60 - 65 Jahre,301,141,160
False,8437031,"Gammertingen, Stadt",65 - 75 Jahre,478,194,284
False,8437031,"Gammertingen, Stadt",75 und mehr Jahre,319,104,215
False,8437031,"Gammertingen, Stadt",Insgesamt,6758,3333,3425
False,8437044,Herbertingen,unter 3 Jahre,196,93,103
False,8437044,Herbertingen,3 -  6 Jahre,207,102,105
False,8437044,Herbertingen,6 - 10 Jahre,261,136,125
False,8437044,Herbertingen,10 - 15 Jahre,289,148,141
False,8437044,Herbertingen,15 - 18 Jahre,166,96,70
False,8437044,Herbertingen,18 - 20 Jahre,111,53,58
False,8437044,Herbertingen,20 - 25 Jahre,321,163,158
False,8437044,Herbertingen,25 - 30 Jahre,394,193,201
False,8437044,Herbertingen,30 - 35 Jahre,374,195,179
False,8437044,Herbertingen,35 - 40 Jahre,330,179,151
False,8437044,Herbertingen,40 - 45 Jahre,346,182,164
False,8437044,Herbertingen,45 - 50 Jahre,247,128,119
False,8437044,Herbertingen,50 - 55 Jahre,240,124,116
False,8437044,Herbertingen,55 - 60 Jahre,264,136,128
False,8437044,Herbertingen,60 - 65 Jahre,223,102,121
False,8437044,Herbertingen,65 - 75 Jahre,348,149,199
False,8437044,Herbertingen,75 und mehr Jahre,237,79,158
False,8437044,Herbertingen,Insgesamt,4554,2258,2296
False,8437047,"Hettingen, Stadt",unter 3 Jahre,79,29,50
False,8437047,"Hettingen, Stadt",3 -  6 Jahre,105,61,44
False,8437047,"Hettingen, Stadt",6 - 10 Jahre,115,59,56
False,8437047,"Hettingen, Stadt",10 - 15 Jahre,137,63,74
False,8437047,"Hettingen, Stadt",15 - 18 Jahre,84,40,44
False,8437047,"Hettingen, Stadt",18 - 20 Jahre,43,33,10
False,8437047,"Hettingen, Stadt",20 - 25 Jahre,134,65,69
False,8437047,"Hettingen, Stadt",25 - 30 Jahre,196,113,83
False,8437047,"Hettingen, Stadt",30 - 35 Jahre,212,119,93
False,8437047,"Hettingen, Stadt",35 - 40 Jahre,152,79,73
False,8437047,"Hettingen, Stadt",40 - 45 Jahre,138,68,70
False,8437047,"Hettingen, Stadt",45 - 50 Jahre,114,66,48
False,8437047,"Hettingen, Stadt",50 - 55 Jahre,106,54,52
False,8437047,"Hettingen, Stadt",55 - 60 Jahre,145,72,73
False,8437047,"Hettingen, Stadt",60 - 65 Jahre,120,56,64
False,8437047,"Hettingen, Stadt",65 - 75 Jahre,135,60,75
False,8437047,"Hettingen, Stadt",75 und mehr Jahre,88,34,54
False,8437047,"Hettingen, Stadt",Insgesamt,2103,1071,1032
False,8437053,Hohentengen,unter 3 Jahre,163,86,77
False,8437053,Hohentengen,3 -  6 Jahre,177,95,82
False,8437053,Hohentengen,6 - 10 Jahre,252,141,111
False,8437053,Hohentengen,10 - 15 Jahre,265,127,138
False,8437053,Hohentengen,15 - 18 Jahre,149,78,71
False,8437053,Hohentengen,18 - 20 Jahre,92,46,46
False,8437053,Hohentengen,20 - 25 Jahre,312,160,152
False,8437053,Hohentengen,25 - 30 Jahre,481,329,152
False,8437053,Hohentengen,30 - 35 Jahre,455,277,178
False,8437053,Hohentengen,35 - 40 Jahre,321,166,155
False,8437053,Hohentengen,40 - 45 Jahre,280,157,123
False,8437053,Hohentengen,45 - 50 Jahre,227,125,102
False,8437053,Hohentengen,50 - 55 Jahre,195,99,96
False,8437053,Hohentengen,55 - 60 Jahre,282,147,135
False,8437053,Hohentengen,60 - 65 Jahre,202,102,100
False,8437053,Hohentengen,65 - 75 Jahre,318,141,177
False,8437053,Hohentengen,75 und mehr Jahre,174,51,123
False,8437053,Hohentengen,Insgesamt,4345,2327,2018
False,8437056,Illmensee,unter 3 Jahre,87,47,40
False,8437056,Illmensee,3 -  6 Jahre,91,40,51
False,8437056,Illmensee,6 - 10 Jahre,117,64,53
False,8437056,Illmensee,10 - 15 Jahre,121,62,59
False,8437056,Illmensee,15 - 18 Jahre,65,32,33
False,8437056,Illmensee,18 - 20 Jahre,48,23,25
False,8437056,Illmensee,20 - 25 Jahre,116,57,59
False,8437056,Illmensee,25 - 30 Jahre,134,74,60
False,8437056,Illmensee,30 - 35 Jahre,166,83,83
False,8437056,Illmensee,35 - 40 Jahre,178,93,85
False,8437056,Illmensee,40 - 45 Jahre,152,75,77
False,8437056,Illmensee,45 - 50 Jahre,122,74,48
False,8437056,Illmensee,50 - 55 Jahre,64,33,31
False,8437056,Illmensee,55 - 60 Jahre,80,37,43
False,8437056,Illmensee,60 - 65 Jahre,85,37,48
False,8437056,Illmensee,65 - 75 Jahre,129,61,68
False,8437056,Illmensee,75 und mehr Jahre,70,26,44
False,8437056,Illmensee,Insgesamt,1825,918,907
False,8437059,Inzigkofen,unter 3 Jahre,85,43,42
False,8437059,Inzigkofen,3 -  6 Jahre,99,54,45
False,8437059,Inzigkofen,6 - 10 Jahre,164,79,85
False,8437059,Inzigkofen,10 - 15 Jahre,156,78,78
False,8437059,Inzigkofen,15 - 18 Jahre,96,48,48
False,8437059,Inzigkofen,18 - 20 Jahre,76,41,35
False,8437059,Inzigkofen,20 - 25 Jahre,161,78,83
False,8437059,Inzigkofen,25 - 30 Jahre,232,136,96
False,8437059,Inzigkofen,30 - 35 Jahre,245,122,123
False,8437059,Inzigkofen,35 - 40 Jahre,236,125,111
False,8437059,Inzigkofen,40 - 45 Jahre,193,96,97
False,8437059,Inzigkofen,45 - 50 Jahre,154,81,73
False,8437059,Inzigkofen,50 - 55 Jahre,123,62,61
False,8437059,Inzigkofen,55 - 60 Jahre,165,95,70
False,8437059,Inzigkofen,60 - 65 Jahre,148,79,69
False,8437059,Inzigkofen,65 - 75 Jahre,232,94,138
False,8437059,Inzigkofen,75 und mehr Jahre,100,29,71
False,8437059,Inzigkofen,Insgesamt,2665,1340,1325
False,8437065,Krauchenwies,unter 3 Jahre,196,105,91
False,8437065,Krauchenwies,3 -  6 Jahre,200,109,91
False,8437065,Krauchenwies,6 - 10 Jahre,296,130,166
False,8437065,Krauchenwies,10 - 15 Jahre,371,184,187
False,8437065,Krauchenwies,15 - 18 Jahre,212,107,105
False,8437065,Krauchenwies,18 - 20 Jahre,117,66,51
False,8437065,Krauchenwies,20 - 25 Jahre,297,159,138
False,8437065,Krauchenwies,25 - 30 Jahre,421,209,212
False,8437065,Krauchenwies,30 - 35 Jahre,406,201,205
False,8437065,Krauchenwies,35 - 40 Jahre,432,222,210
False,8437065,Krauchenwies,40 - 45 Jahre,370,198,172
False,8437065,Krauchenwies,45 - 50 Jahre,255,132,123
False,8437065,Krauchenwies,50 - 55 Jahre,227,123,104
False,8437065,Krauchenwies,55 - 60 Jahre,301,146,155
False,8437065,Krauchenwies,60 - 65 Jahre,210,105,105
False,8437065,Krauchenwies,65 - 75 Jahre,394,159,235
False,8437065,Krauchenwies,75 und mehr Jahre,225,71,154
False,8437065,Krauchenwies,Insgesamt,4930,2426,2504
False,8437072,Leibertingen,unter 3 Jahre,78,40,38
False,8437072,Leibertingen,3 -  6 Jahre,101,58,43
False,8437072,Leibertingen,6 - 10 Jahre,129,60,69
False,8437072,Leibertingen,10 - 15 Jahre,145,79,66
False,8437072,Leibertingen,15 - 18 Jahre,70,34,36
False,8437072,Leibertingen,18 - 20 Jahre,49,30,19
False,8437072,Leibertingen,20 - 25 Jahre,146,75,71
False,8437072,Leibertingen,25 - 30 Jahre,202,109,93
False,8437072,Leibertingen,30 - 35 Jahre,212,115,97
False,8437072,Leibertingen,35 - 40 Jahre,204,116,88
False,8437072,Leibertingen,40 - 45 Jahre,127,62,65
False,8437072,Leibertingen,45 - 50 Jahre,108,52,56
False,8437072,Leibertingen,50 - 55 Jahre,96,55,41
False,8437072,Leibertingen,55 - 60 Jahre,140,78,62
False,8437072,Leibertingen,60 - 65 Jahre,114,53,61
False,8437072,Leibertingen,65 - 75 Jahre,175,81,94
False,8437072,Leibertingen,75 und mehr Jahre,95,25,70
False,8437072,Leibertingen,Insgesamt,2191,1122,1069
False,8437076,"Mengen, Stadt",unter 3 Jahre,368,185,183
False,8437076,"Mengen, Stadt",3 -  6 Jahre,387,197,190
False,8437076,"Mengen, Stadt",6 - 10 Jahre,523,284,239
False,8437076,"Mengen, Stadt",10 - 15 Jahre,558,312,246
False,8437076,"Mengen, Stadt",15 - 18 Jahre,334,175,159
False,8437076,"Mengen, Stadt",18 - 20 Jahre,205,97,108
False,8437076,"Mengen, Stadt",20 - 25 Jahre,632,328,304
False,8437076,"Mengen, Stadt",25 - 30 Jahre,835,419,416
False,8437076,"Mengen, Stadt",30 - 35 Jahre,906,457,449
False,8437076,"Mengen, Stadt",35 - 40 Jahre,716,367,349
False,8437076,"Mengen, Stadt",40 - 45 Jahre,664,336,328
False,8437076,"Mengen, Stadt",45 - 50 Jahre,592,317,275
False,8437076,"Mengen, Stadt",50 - 55 Jahre,522,254,268
False,8437076,"Mengen, Stadt",55 - 60 Jahre,736,381,355
False,8437076,"Mengen, Stadt",60 - 65 Jahre,503,241,262
False,8437076,"Mengen, Stadt",65 - 75 Jahre,841,332,509
False,8437076,"Mengen, Stadt",75 und mehr Jahre,579,168,411
False,8437076,"Mengen, Stadt",Insgesamt,9901,4850,5051
False,8437078,"Meßkirch, Stadt",unter 3 Jahre,349,177,172
False,8437078,"Meßkirch, Stadt",3 -  6 Jahre,368,187,181
False,8437078,"Meßkirch, Stadt",6 - 10 Jahre,541,300,241
False,8437078,"Meßkirch, Stadt",10 - 15 Jahre,588,294,294
False,8437078,"Meßkirch, Stadt",15 - 18 Jahre,347,169,178
False,8437078,"Meßkirch, Stadt",18 - 20 Jahre,210,104,106
False,8437078,"Meßkirch, Stadt",20 - 25 Jahre,531,270,261
False,8437078,"Meßkirch, Stadt",25 - 30 Jahre,662,325,337
False,8437078,"Meßkirch, Stadt",30 - 35 Jahre,841,423,418
False,8437078,"Meßkirch, Stadt",35 - 40 Jahre,667,364,303
False,8437078,"Meßkirch, Stadt",40 - 45 Jahre,548,290,258
False,8437078,"Meßkirch, Stadt",45 - 50 Jahre,448,229,219
False,8437078,"Meßkirch, Stadt",50 - 55 Jahre,363,187,176
False,8437078,"Meßkirch, Stadt",55 - 60 Jahre,552,254,298
False,8437078,"Meßkirch, Stadt",60 - 65 Jahre,438,217,221
False,8437078,"Meßkirch, Stadt",65 - 75 Jahre,791,322,469
False,8437078,"Meßkirch, Stadt",75 und mehr Jahre,467,123,344
False,8437078,"Meßkirch, Stadt",Insgesamt,8711,4235,4476
False,8437082,Neufra,unter 3 Jahre,70,35,35
False,8437082,Neufra,3 -  6 Jahre,69,38,31
False,8437082,Neufra,6 - 10 Jahre,96,38,58
False,8437082,Neufra,10 - 15 Jahre,136,51,85
False,8437082,Neufra,15 - 18 Jahre,71,39,32
False,8437082,Neufra,18 - 20 Jahre,35,14,21
False,8437082,Neufra,20 - 25 Jahre,121,61,60
False,8437082,Neufra,25 - 30 Jahre,150,80,70
False,8437082,Neufra,30 - 35 Jahre,163,78,85
False,8437082,Neufra,35 - 40 Jahre,182,86,96
False,8437082,Neufra,40 - 45 Jahre,140,74,66
False,8437082,Neufra,45 - 50 Jahre,103,43,60
False,8437082,Neufra,50 - 55 Jahre,118,63,55
False,8437082,Neufra,55 - 60 Jahre,141,78,63
False,8437082,Neufra,60 - 65 Jahre,86,40,46
False,8437082,Neufra,65 - 75 Jahre,165,73,92
False,8437082,Neufra,75 und mehr Jahre,121,30,91
False,8437082,Neufra,Insgesamt,1967,921,1046
False,8437086,Ostrach,unter 3 Jahre,272,130,142
False,8437086,Ostrach,3 -  6 Jahre,317,149,168
False,8437086,Ostrach,6 - 10 Jahre,425,209,216
False,8437086,Ostrach,10 - 15 Jahre,492,246,246
False,8437086,Ostrach,15 - 18 Jahre,233,120,113
False,8437086,Ostrach,18 - 20 Jahre,135,72,63
False,8437086,Ostrach,20 - 25 Jahre,385,185,200
False,8437086,Ostrach,25 - 30 Jahre,523,265,258
False,8437086,Ostrach,30 - 35 Jahre,608,299,309
False,8437086,Ostrach,35 - 40 Jahre,544,278,266
False,8437086,Ostrach,40 - 45 Jahre,432,236,196
False,8437086,Ostrach,45 - 50 Jahre,327,178,149
False,8437086,Ostrach,50 - 55 Jahre,279,134,145
False,8437086,Ostrach,55 - 60 Jahre,391,205,186
False,8437086,Ostrach,60 - 65 Jahre,301,145,156
False,8437086,Ostrach,65 - 75 Jahre,513,201,312
False,8437086,Ostrach,75 und mehr Jahre,309,97,212
False,8437086,Ostrach,Insgesamt,6486,3149,3337
False,8437088,"Pfullendorf, Stadt",unter 3 Jahre,494,256,238
False,8437088,"Pfullendorf, Stadt",3 -  6 Jahre,561,305,256
False,8437088,"Pfullendorf, Stadt",6 - 10 Jahre,693,359,334
False,8437088,"Pfullendorf, Stadt",10 - 15 Jahre,843,433,410
False,8437088,"Pfullendorf, Stadt",15 - 18 Jahre,505,252,253
False,8437088,"Pfullendorf, Stadt",18 - 20 Jahre,313,166,147
False,8437088,"Pfullendorf, Stadt",20 - 25 Jahre,995,549,446
False,8437088,"Pfullendorf, Stadt",25 - 30 Jahre,1118,629,489
False,8437088,"Pfullendorf, Stadt",30 - 35 Jahre,1241,684,557
False,8437088,"Pfullendorf, Stadt",35 - 40 Jahre,1039,562,477
False,8437088,"Pfullendorf, Stadt",40 - 45 Jahre,788,395,393
False,8437088,"Pfullendorf, Stadt",45 - 50 Jahre,733,374,359
False,8437088,"Pfullendorf, Stadt",50 - 55 Jahre,634,329,305
False,8437088,"Pfullendorf, Stadt",55 - 60 Jahre,767,390,377
False,8437088,"Pfullendorf, Stadt",60 - 65 Jahre,577,282,295
False,8437088,"Pfullendorf, Stadt",65 - 75 Jahre,894,379,515
False,8437088,"Pfullendorf, Stadt",75 und mehr Jahre,524,184,340
False,8437088,"Pfullendorf, Stadt",Insgesamt,12719,6528,6191
False,8437100,"Bad Saulgau, Stadt",unter 3 Jahre,572,316,256
False,8437100,"Bad Saulgau, Stadt",3 -  6 Jahre,594,312,282
False,8437100,"Bad Saulgau, Stadt",6 - 10 Jahre,848,421,427
False,8437100,"Bad Saulgau, Stadt",10 - 15 Jahre,1045,575,470
False,8437100,"Bad Saulgau, Stadt",15 - 18 Jahre,675,378,297
False,8437100,"Bad Saulgau, Stadt",18 - 20 Jahre,387,209,178
False,8437100,"Bad Saulgau, Stadt",20 - 25 Jahre,1133,556,577
False,8437100,"Bad Saulgau, Stadt",25 - 30 Jahre,1425,719,706
False,8437100,"Bad Saulgau, Stadt",30 - 35 Jahre,1390,704,686
False,8437100,"Bad Saulgau, Stadt",35 - 40 Jahre,1180,579,601
False,8437100,"Bad Saulgau, Stadt",40 - 45 Jahre,1061,491,570
False,8437100,"Bad Saulgau, Stadt",45 - 50 Jahre,965,507,458
False,8437100,"Bad Saulgau, Stadt",50 - 55 Jahre,905,459,446
False,8437100,"Bad Saulgau, Stadt",55 - 60 Jahre,1158,562,596
False,8437100,"Bad Saulgau, Stadt",60 - 65 Jahre,894,430,464
False,8437100,"Bad Saulgau, Stadt",65 - 75 Jahre,1658,685,973
False,8437100,"Bad Saulgau, Stadt",75 und mehr Jahre,1182,356,826
False,8437100,"Bad Saulgau, Stadt",Insgesamt,17072,8259,8813
False,8437101,"Scheer, Stadt",unter 3 Jahre,93,44,49
False,8437101,"Scheer, Stadt",3 -  6 Jahre,109,56,53
False,8437101,"Scheer, Stadt",6 - 10 Jahre,142,84,58
False,8437101,"Scheer, Stadt",10 - 15 Jahre,169,89,80
False,8437101,"Scheer, Stadt",15 - 18 Jahre,102,40,62
False,8437101,"Scheer, Stadt",18 - 20 Jahre,56,29,27
False,8437101,"Scheer, Stadt",20 - 25 Jahre,152,77,75
False,8437101,"Scheer, Stadt",25 - 30 Jahre,241,113,128
False,8437101,"Scheer, Stadt",30 - 35 Jahre,245,129,116
False,8437101,"Scheer, Stadt",35 - 40 Jahre,214,104,110
False,8437101,"Scheer, Stadt",40 - 45 Jahre,189,98,91
False,8437101,"Scheer, Stadt",45 - 50 Jahre,179,94,85
False,8437101,"Scheer, Stadt",50 - 55 Jahre,120,59,61
False,8437101,"Scheer, Stadt",55 - 60 Jahre,177,89,88
False,8437101,"Scheer, Stadt",60 - 65 Jahre,135,72,63
False,8437101,"Scheer, Stadt",65 - 75 Jahre,211,99,112
False,8437101,"Scheer, Stadt",75 und mehr Jahre,163,51,112
False,8437101,"Scheer, Stadt",Insgesamt,2697,1327,1370
False,8437102,Schwenningen,unter 3 Jahre,79,45,34
False,8437102,Schwenningen,3 -  6 Jahre,78,35,43
False,8437102,Schwenningen,6 - 10 Jahre,106,44,62
False,8437102,Schwenningen,10 - 15 Jahre,126,61,65
False,8437102,Schwenningen,15 - 18 Jahre,45,24,21
False,8437102,Schwenningen,18 - 20 Jahre,35,19,16
False,8437102,Schwenningen,20 - 25 Jahre,88,43,45
False,8437102,Schwenningen,25 - 30 Jahre,130,59,71
False,8437102,Schwenningen,30 - 35 Jahre,176,102,74
False,8437102,Schwenningen,35 - 40 Jahre,123,59,64
False,8437102,Schwenningen,40 - 45 Jahre,117,64,53
False,8437102,Schwenningen,45 - 50 Jahre,72,33,39
False,8437102,Schwenningen,50 - 55 Jahre,83,47,36
False,8437102,Schwenningen,55 - 60 Jahre,115,46,69
False,8437102,Schwenningen,60 - 65 Jahre,84,49,35
False,8437102,Schwenningen,65 - 75 Jahre,138,57,81
False,8437102,Schwenningen,75 und mehr Jahre,73,23,50
False,8437102,Schwenningen,Insgesamt,1668,810,858
False,8437104,"Sigmaringen, Stadt",unter 3 Jahre,569,303,266
False,8437104,"Sigmaringen, Stadt",3 -  6 Jahre,552,291,261
False,8437104,"Sigmaringen, Stadt",6 - 10 Jahre,740,383,357
False,8437104,"Sigmaringen, Stadt",10 - 15 Jahre,983,496,487
False,8437104,"Sigmaringen, Stadt",15 - 18 Jahre,548,288,260
False,8437104,"Sigmaringen, Stadt",18 - 20 Jahre,385,206,179
False,8437104,"Sigmaringen, Stadt",20 - 25 Jahre,1108,554,554
False,8437104,"Sigmaringen, Stadt",25 - 30 Jahre,1752,1061,691
False,8437104,"Sigmaringen, Stadt",30 - 35 Jahre,1927,1152,775
False,8437104,"Sigmaringen, Stadt",35 - 40 Jahre,1148,591,557
False,8437104,"Sigmaringen, Stadt",40 - 45 Jahre,1008,503,505
False,8437104,"Sigmaringen, Stadt",45 - 50 Jahre,843,446,397
False,8437104,"Sigmaringen, Stadt",50 - 55 Jahre,862,414,448
False,8437104,"Sigmaringen, Stadt",55 - 60 Jahre,1099,517,582
False,8437104,"Sigmaringen, Stadt",60 - 65 Jahre,767,360,407
False,8437104,"Sigmaringen, Stadt",65 - 75 Jahre,1471,602,869
False,8437104,"Sigmaringen, Stadt",75 und mehr Jahre,1114,326,788
False,8437104,"Sigmaringen, Stadt",Insgesamt,16876,8493,8383
False,8437105,Sigmaringendorf,unter 3 Jahre,131,65,66
False,8437105,Sigmaringendorf,3 -  6 Jahre,125,61,64
False,8437105,Sigmaringendorf,6 - 10 Jahre,166,79,87
False,8437105,Sigmaringendorf,10 - 15 Jahre,224,110,114
False,8437105,Sigmaringendorf,15 - 18 Jahre,133,69,64
False,8437105,Sigmaringendorf,18 - 20 Jahre,87,38,49
False,8437105,Sigmaringendorf,20 - 25 Jahre,220,99,121
False,8437105,Sigmaringendorf,25 - 30 Jahre,281,154,127
False,8437105,Sigmaringendorf,30 - 35 Jahre,292,149,143
False,8437105,Sigmaringendorf,35 - 40 Jahre,261,130,131
False,8437105,Sigmaringendorf,40 - 45 Jahre,234,113,121
False,8437105,Sigmaringendorf,45 - 50 Jahre,247,119,128
False,8437105,Sigmaringendorf,50 - 55 Jahre,256,135,121
False,8437105,Sigmaringendorf,55 - 60 Jahre,293,144,149
False,8437105,Sigmaringendorf,60 - 65 Jahre,230,125,105
False,8437105,Sigmaringendorf,65 - 75 Jahre,319,124,195
False,8437105,Sigmaringendorf,75 und mehr Jahre,211,60,151
False,8437105,Sigmaringendorf,Insgesamt,3710,1774,1936
False,8437107,Stetten am kalten Markt,unter 3 Jahre,194,87,107
False,8437107,Stetten am kalten Markt,3 -  6 Jahre,202,109,93
False,8437107,Stetten am kalten Markt,6 - 10 Jahre,298,148,150
False,8437107,Stetten am kalten Markt,10 - 15 Jahre,335,162,173
False,8437107,Stetten am kalten Markt,15 - 18 Jahre,160,77,83
False,8437107,Stetten am kalten Markt,18 - 20 Jahre,126,76,50
False,8437107,Stetten am kalten Markt,20 - 25 Jahre,511,353,158
False,8437107,Stetten am kalten Markt,25 - 30 Jahre,596,392,204
False,8437107,Stetten am kalten Markt,30 - 35 Jahre,458,225,233
False,8437107,Stetten am kalten Markt,35 - 40 Jahre,369,199,170
False,8437107,Stetten am kalten Markt,40 - 45 Jahre,370,197,173
False,8437107,Stetten am kalten Markt,45 - 50 Jahre,283,143,140
False,8437107,Stetten am kalten Markt,50 - 55 Jahre,296,156,140
False,8437107,Stetten am kalten Markt,55 - 60 Jahre,317,161,156
False,8437107,Stetten am kalten Markt,60 - 65 Jahre,270,133,137
False,8437107,Stetten am kalten Markt,65 - 75 Jahre,431,182,249
False,8437107,Stetten am kalten Markt,75 und mehr Jahre,333,88,245
False,8437107,Stetten am kalten Markt,Insgesamt,5549,2888,2661
False,8437114,"Veringenstadt, Stadt",unter 3 Jahre,98,47,51
False,8437114,"Veringenstadt, Stadt",3 -  6 Jahre,112,61,51
False,8437114,"Veringenstadt, Stadt",6 - 10 Jahre,110,56,54
False,8437114,"Veringenstadt, Stadt",10 - 15 Jahre,143,78,65
False,8437114,"Veringenstadt, Stadt",15 - 18 Jahre,85,40,45
False,8437114,"Veringenstadt, Stadt",18 - 20 Jahre,52,23,29
False,8437114,"Veringenstadt, Stadt",20 - 25 Jahre,155,74,81
False,8437114,"Veringenstadt, Stadt",25 - 30 Jahre,177,96,81
False,8437114,"Veringenstadt, Stadt",30 - 35 Jahre,196,105,91
False,8437114,"Veringenstadt, Stadt",35 - 40 Jahre,185,94,91
False,8437114,"Veringenstadt, Stadt",40 - 45 Jahre,168,77,91
False,8437114,"Veringenstadt, Stadt",45 - 50 Jahre,164,90,74
False,8437114,"Veringenstadt, Stadt",50 - 55 Jahre,118,61,57
False,8437114,"Veringenstadt, Stadt",55 - 60 Jahre,159,84,75
False,8437114,"Veringenstadt, Stadt",60 - 65 Jahre,113,51,62
False,8437114,"Veringenstadt, Stadt",65 - 75 Jahre,192,89,103
False,8437114,"Veringenstadt, Stadt",75 und mehr Jahre,118,38,80
False,8437114,"Veringenstadt, Stadt",Insgesamt,2345,1164,1181
False,8437118,Wald,unter 3 Jahre,94,51,43
False,8437118,Wald,3 -  6 Jahre,124,60,64
False,8437118,Wald,6 - 10 Jahre,147,80,67
False,8437118,Wald,10 - 15 Jahre,181,66,115
False,8437118,Wald,15 - 18 Jahre,181,54,127
False,8437118,Wald,18 - 20 Jahre,137,39,98
False,8437118,Wald,20 - 25 Jahre,178,72,106
False,8437118,Wald,25 - 30 Jahre,293,116,177
False,8437118,Wald,30 - 35 Jahre,209,107,102
False,8437118,Wald,35 - 40 Jahre,220,120,100
False,8437118,Wald,40 - 45 Jahre,164,82,82
False,8437118,Wald,45 - 50 Jahre,113,60,53
False,8437118,Wald,50 - 55 Jahre,89,50,39
False,8437118,Wald,55 - 60 Jahre,170,74,96
False,8437118,Wald,60 - 65 Jahre,141,66,75
False,8437118,Wald,65 - 75 Jahre,186,77,109
False,8437118,Wald,75 und mehr Jahre,144,38,106
False,8437118,Wald,Insgesamt,2771,1212,1559
False,8437123,Sauldorf,unter 3 Jahre,89,51,38
False,8437123,Sauldorf,3 -  6 Jahre,100,49,51
False,8437123,Sauldorf,6 - 10 Jahre,131,67,64
False,8437123,Sauldorf,10 - 15 Jahre,123,61,62
False,8437123,Sauldorf,15 - 18 Jahre,69,34,35
False,8437123,Sauldorf,18 - 20 Jahre,41,21,20
False,8437123,Sauldorf,20 - 25 Jahre,109,63,46
False,8437123,Sauldorf,25 - 30 Jahre,215,112,103
False,8437123,Sauldorf,30 - 35 Jahre,216,105,111
False,8437123,Sauldorf,35 - 40 Jahre,209,116,93
False,8437123,Sauldorf,40 - 45 Jahre,125,70,55
False,8437123,Sauldorf,45 - 50 Jahre,106,59,47
False,8437123,Sauldorf,50 - 55 Jahre,95,40,55
False,8437123,Sauldorf,55 - 60 Jahre,157,83,74
False,8437123,Sauldorf,60 - 65 Jahre,153,76,77
False,8437123,Sauldorf,65 - 75 Jahre,231,105,126
False,8437123,Sauldorf,75 und mehr Jahre,113,37,76
False,8437123,Sauldorf,Insgesamt,2282,1149,1133
False,8437124,Herdwangen-Schönach,unter 3 Jahre,116,57,59
False,8437124,Herdwangen-Schönach,3 -  6 Jahre,133,68,65
False,8437124,Herdwangen-Schönach,6 - 10 Jahre,166,75,91
False,8437124,Herdwangen-Schönach,10 - 15 Jahre,192,111,81
False,8437124,Herdwangen-Schönach,15 - 18 Jahre,95,50,45
False,8437124,Herdwangen-Schönach,18 - 20 Jahre,65,36,29
False,8437124,Herdwangen-Schönach,20 - 25 Jahre,161,92,69
False,8437124,Herdwangen-Schönach,25 - 30 Jahre,244,116,128
False,8437124,Herdwangen-Schönach,30 - 35 Jahre,320,146,174
False,8437124,Herdwangen-Schönach,35 - 40 Jahre,277,147,130
False,8437124,Herdwangen-Schönach,40 - 45 Jahre,223,109,114
False,8437124,Herdwangen-Schönach,45 - 50 Jahre,155,88,67
False,8437124,Herdwangen-Schönach,50 - 55 Jahre,137,79,58
False,8437124,Herdwangen-Schönach,55 - 60 Jahre,147,65,82
False,8437124,Herdwangen-Schönach,60 - 65 Jahre,115,64,51
False,8437124,Herdwangen-Schönach,65 - 75 Jahre,221,103,118
False,8437124,Herdwangen-Schönach,75 und mehr Jahre,121,40,81
False,8437124,Herdwangen-Schönach,Insgesamt,2888,1446,1442
