Anlagen,AGS,Ort,Alter von bis unter,Bevölkerung insgesamt,Bevölkerung männlich,Bevölkerung weiblich
False,8,Land Baden-Württemberg,unter 3 Jahre,274527,140596,133931
False,8,Land Baden-Württemberg,3 -  6 Jahre,282759,144522,138237
False,8,Land Baden-Württemberg,6 - 10 Jahre,400183,205988,194195
False,8,Land Baden-Württemberg,10 - 15 Jahre,567924,291291,276633
False,8,Land Baden-Württemberg,15 - 18 Jahre,352126,180996,171130
False,8,Land Baden-Württemberg,18 - 20 Jahre,250774,128655,122119
False,8,Land Baden-Württemberg,20 - 25 Jahre,662196,337534,324662
False,8,Land Baden-Württemberg,25 - 30 Jahre,653610,329104,324506
False,8,Land Baden-Württemberg,30 - 35 Jahre,642527,321647,320880
False,8,Land Baden-Württemberg,35 - 40 Jahre,675399,338976,336423
False,8,Land Baden-Württemberg,40 - 45 Jahre,887840,451884,435956
False,8,Land Baden-Württemberg,45 - 50 Jahre,934960,479220,455740
False,8,Land Baden-Württemberg,50 - 55 Jahre,809210,410580,398630
False,8,Land Baden-Württemberg,55 - 60 Jahre,681662,337283,344379
False,8,Land Baden-Württemberg,60 - 65 Jahre,586835,289774,297061
False,8,Land Baden-Württemberg,65 - 75 Jahre,1140008,542451,597557
False,8,Land Baden-Württemberg,75 und mehr Jahre,951340,365748,585592
False,8,Land Baden-Württemberg,Insgesamt,10753880,5296249,5457631
False,81,Regierungsbezirk Stuttgart,unter 3 Jahre,104083,53167,50916
False,81,Regierungsbezirk Stuttgart,3 -  6 Jahre,107122,54776,52346
False,81,Regierungsbezirk Stuttgart,6 - 10 Jahre,151064,77642,73422
False,81,Regierungsbezirk Stuttgart,10 - 15 Jahre,211118,108336,102782
False,81,Regierungsbezirk Stuttgart,15 - 18 Jahre,130651,67010,63641
False,81,Regierungsbezirk Stuttgart,18 - 20 Jahre,91277,47032,44245
False,81,Regierungsbezirk Stuttgart,20 - 25 Jahre,235302,120705,114597
False,81,Regierungsbezirk Stuttgart,25 - 30 Jahre,241323,121395,119928
False,81,Regierungsbezirk Stuttgart,30 - 35 Jahre,249545,125123,124422
False,81,Regierungsbezirk Stuttgart,35 - 40 Jahre,261765,132666,129099
False,81,Regierungsbezirk Stuttgart,40 - 45 Jahre,333415,171108,162307
False,81,Regierungsbezirk Stuttgart,45 - 50 Jahre,342809,177548,165261
False,81,Regierungsbezirk Stuttgart,50 - 55 Jahre,295441,150492,144949
False,81,Regierungsbezirk Stuttgart,55 - 60 Jahre,248555,122441,126114
False,81,Regierungsbezirk Stuttgart,60 - 65 Jahre,218301,107454,110847
False,81,Regierungsbezirk Stuttgart,65 - 75 Jahre,430213,204935,225278
False,81,Regierungsbezirk Stuttgart,75 und mehr Jahre,350587,136079,214508
False,81,Regierungsbezirk Stuttgart,Insgesamt,4002571,1977909,2024662
False,8111,Stadtkreis Stuttgart,unter 3 Jahre,16416,8417,7999
False,8111,Stadtkreis Stuttgart,3 -  6 Jahre,15127,7689,7438
False,8111,Stadtkreis Stuttgart,6 - 10 Jahre,18958,9765,9193
False,8111,Stadtkreis Stuttgart,10 - 15 Jahre,24366,12559,11807
False,8111,Stadtkreis Stuttgart,15 - 18 Jahre,14515,7527,6988
False,8111,Stadtkreis Stuttgart,18 - 20 Jahre,10959,5531,5428
False,8111,Stadtkreis Stuttgart,20 - 25 Jahre,40431,19892,20539
False,8111,Stadtkreis Stuttgart,25 - 30 Jahre,49043,24055,24988
False,8111,Stadtkreis Stuttgart,30 - 35 Jahre,49596,25165,24431
False,8111,Stadtkreis Stuttgart,35 - 40 Jahre,45826,24146,21680
False,8111,Stadtkreis Stuttgart,40 - 45 Jahre,51078,27070,24008
False,8111,Stadtkreis Stuttgart,45 - 50 Jahre,49758,26975,22783
False,8111,Stadtkreis Stuttgart,50 - 55 Jahre,40823,21323,19500
False,8111,Stadtkreis Stuttgart,55 - 60 Jahre,34062,16804,17258
False,8111,Stadtkreis Stuttgart,60 - 65 Jahre,31651,15625,16026
False,8111,Stadtkreis Stuttgart,65 - 75 Jahre,62280,29445,32835
False,8111,Stadtkreis Stuttgart,75 und mehr Jahre,51699,19140,32559
False,8111,Stadtkreis Stuttgart,Insgesamt,606588,301128,305460
False,8111000,"Stuttgart, Landeshauptstadt",unter 3 Jahre,16416,8417,7999
False,8111000,"Stuttgart, Landeshauptstadt",3 -  6 Jahre,15127,7689,7438
False,8111000,"Stuttgart, Landeshauptstadt",6 - 10 Jahre,18958,9765,9193
False,8111000,"Stuttgart, Landeshauptstadt",10 - 15 Jahre,24366,12559,11807
False,8111000,"Stuttgart, Landeshauptstadt",15 - 18 Jahre,14515,7527,6988
False,8111000,"Stuttgart, Landeshauptstadt",18 - 20 Jahre,10959,5531,5428
False,8111000,"Stuttgart, Landeshauptstadt",20 - 25 Jahre,40431,19892,20539
False,8111000,"Stuttgart, Landeshauptstadt",25 - 30 Jahre,49043,24055,24988
False,8111000,"Stuttgart, Landeshauptstadt",30 - 35 Jahre,49596,25165,24431
False,8111000,"Stuttgart, Landeshauptstadt",35 - 40 Jahre,45826,24146,21680
False,8111000,"Stuttgart, Landeshauptstadt",40 - 45 Jahre,51078,27070,24008
False,8111000,"Stuttgart, Landeshauptstadt",45 - 50 Jahre,49758,26975,22783
False,8111000,"Stuttgart, Landeshauptstadt",50 - 55 Jahre,40823,21323,19500
False,8111000,"Stuttgart, Landeshauptstadt",55 - 60 Jahre,34062,16804,17258
False,8111000,"Stuttgart, Landeshauptstadt",60 - 65 Jahre,31651,15625,16026
False,8111000,"Stuttgart, Landeshauptstadt",65 - 75 Jahre,62280,29445,32835
False,8111000,"Stuttgart, Landeshauptstadt",75 und mehr Jahre,51699,19140,32559
False,8111000,"Stuttgart, Landeshauptstadt",Insgesamt,606588,301128,305460
False,8115,Landkreis Böblingen,unter 3 Jahre,10161,5158,5003
False,8115,Landkreis Böblingen,3 -  6 Jahre,10389,5379,5010
False,8115,Landkreis Böblingen,6 - 10 Jahre,14538,7543,6995
False,8115,Landkreis Böblingen,10 - 15 Jahre,20460,10481,9979
False,8115,Landkreis Böblingen,15 - 18 Jahre,12336,6342,5994
False,8115,Landkreis Böblingen,18 - 20 Jahre,8523,4352,4171
False,8115,Landkreis Böblingen,20 - 25 Jahre,20424,10485,9939
False,8115,Landkreis Böblingen,25 - 30 Jahre,21312,10669,10643
False,8115,Landkreis Böblingen,30 - 35 Jahre,22807,11422,11385
False,8115,Landkreis Böblingen,35 - 40 Jahre,24262,12095,12167
False,8115,Landkreis Böblingen,40 - 45 Jahre,31683,16191,15492
False,8115,Landkreis Böblingen,45 - 50 Jahre,31989,16327,15662
False,8115,Landkreis Böblingen,50 - 55 Jahre,27806,13998,13808
False,8115,Landkreis Böblingen,55 - 60 Jahre,22813,11161,11652
False,8115,Landkreis Böblingen,60 - 65 Jahre,19917,9647,10270
False,8115,Landkreis Böblingen,65 - 75 Jahre,41511,19999,21512
False,8115,Landkreis Böblingen,75 und mehr Jahre,30465,12238,18227
False,8115,Landkreis Böblingen,Insgesamt,371396,183487,187909
False,8115001,Aidlingen,unter 3 Jahre,231,111,120
False,8115001,Aidlingen,3 -  6 Jahre,222,119,103
False,8115001,Aidlingen,6 - 10 Jahre,356,201,155
False,8115001,Aidlingen,10 - 15 Jahre,510,269,241
False,8115001,Aidlingen,15 - 18 Jahre,301,149,152
False,8115001,Aidlingen,18 - 20 Jahre,241,125,116
False,8115001,Aidlingen,20 - 25 Jahre,487,248,239
False,8115001,Aidlingen,25 - 30 Jahre,479,243,236
False,8115001,Aidlingen,30 - 35 Jahre,478,243,235
False,8115001,Aidlingen,35 - 40 Jahre,638,297,341
False,8115001,Aidlingen,40 - 45 Jahre,866,394,472
False,8115001,Aidlingen,45 - 50 Jahre,889,462,427
False,8115001,Aidlingen,50 - 55 Jahre,650,325,325
False,8115001,Aidlingen,55 - 60 Jahre,544,273,271
False,8115001,Aidlingen,60 - 65 Jahre,514,237,277
False,8115001,Aidlingen,65 - 75 Jahre,983,506,477
False,8115001,Aidlingen,75 und mehr Jahre,644,273,371
False,8115001,Aidlingen,Insgesamt,9033,4475,4558
False,8115002,Altdorf,unter 3 Jahre,141,57,84
False,8115002,Altdorf,3 -  6 Jahre,169,83,86
False,8115002,Altdorf,6 - 10 Jahre,232,139,93
False,8115002,Altdorf,10 - 15 Jahre,342,174,168
False,8115002,Altdorf,15 - 18 Jahre,193,104,89
False,8115002,Altdorf,18 - 20 Jahre,118,64,54
False,8115002,Altdorf,20 - 25 Jahre,234,110,124
False,8115002,Altdorf,25 - 30 Jahre,259,120,139
False,8115002,Altdorf,30 - 35 Jahre,220,122,98
False,8115002,Altdorf,35 - 40 Jahre,290,125,165
False,8115002,Altdorf,40 - 45 Jahre,489,232,257
False,8115002,Altdorf,45 - 50 Jahre,439,229,210
False,8115002,Altdorf,50 - 55 Jahre,335,159,176
False,8115002,Altdorf,55 - 60 Jahre,236,119,117
False,8115002,Altdorf,60 - 65 Jahre,181,81,100
False,8115002,Altdorf,65 - 75 Jahre,425,203,222
False,8115002,Altdorf,75 und mehr Jahre,241,106,135
False,8115002,Altdorf,Insgesamt,4544,2227,2317
False,8115003,"Böblingen, Stadt",unter 3 Jahre,1276,651,625
False,8115003,"Böblingen, Stadt",3 -  6 Jahre,1285,673,612
False,8115003,"Böblingen, Stadt",6 - 10 Jahre,1648,804,844
False,8115003,"Böblingen, Stadt",10 - 15 Jahre,2212,1110,1102
False,8115003,"Böblingen, Stadt",15 - 18 Jahre,1366,730,636
False,8115003,"Böblingen, Stadt",18 - 20 Jahre,931,470,461
False,8115003,"Böblingen, Stadt",20 - 25 Jahre,2570,1248,1322
False,8115003,"Böblingen, Stadt",25 - 30 Jahre,2924,1471,1453
False,8115003,"Böblingen, Stadt",30 - 35 Jahre,3231,1647,1584
False,8115003,"Böblingen, Stadt",35 - 40 Jahre,3122,1600,1522
False,8115003,"Böblingen, Stadt",40 - 45 Jahre,3668,1952,1716
False,8115003,"Böblingen, Stadt",45 - 50 Jahre,3601,1835,1766
False,8115003,"Böblingen, Stadt",50 - 55 Jahre,3279,1644,1635
False,8115003,"Böblingen, Stadt",55 - 60 Jahre,2806,1327,1479
False,8115003,"Böblingen, Stadt",60 - 65 Jahre,2622,1247,1375
False,8115003,"Böblingen, Stadt",65 - 75 Jahre,5634,2646,2988
False,8115003,"Böblingen, Stadt",75 und mehr Jahre,4313,1753,2560
False,8115003,"Böblingen, Stadt",Insgesamt,46488,22808,23680
False,8115004,Bondorf,unter 3 Jahre,143,76,67
False,8115004,Bondorf,3 -  6 Jahre,169,93,76
False,8115004,Bondorf,6 - 10 Jahre,306,158,148
False,8115004,Bondorf,10 - 15 Jahre,418,212,206
False,8115004,Bondorf,15 - 18 Jahre,243,125,118
False,8115004,Bondorf,18 - 20 Jahre,190,81,109
False,8115004,Bondorf,20 - 25 Jahre,345,192,153
False,8115004,Bondorf,25 - 30 Jahre,294,158,136
False,8115004,Bondorf,30 - 35 Jahre,335,156,179
False,8115004,Bondorf,35 - 40 Jahre,400,204,196
False,8115004,Bondorf,40 - 45 Jahre,567,277,290
False,8115004,Bondorf,45 - 50 Jahre,564,271,293
False,8115004,Bondorf,50 - 55 Jahre,448,236,212
False,8115004,Bondorf,55 - 60 Jahre,357,187,170
False,8115004,Bondorf,60 - 65 Jahre,246,119,127
False,8115004,Bondorf,65 - 75 Jahre,456,224,232
False,8115004,Bondorf,75 und mehr Jahre,380,129,251
False,8115004,Bondorf,Insgesamt,5861,2898,2963
False,8115010,Deckenpfronn,unter 3 Jahre,100,47,53
False,8115010,Deckenpfronn,3 -  6 Jahre,87,39,48
False,8115010,Deckenpfronn,6 - 10 Jahre,131,64,67
False,8115010,Deckenpfronn,10 - 15 Jahre,194,87,107
False,8115010,Deckenpfronn,15 - 18 Jahre,114,56,58
False,8115010,Deckenpfronn,18 - 20 Jahre,82,39,43
False,8115010,Deckenpfronn,20 - 25 Jahre,198,98,100
False,8115010,Deckenpfronn,25 - 30 Jahre,171,81,90
False,8115010,Deckenpfronn,30 - 35 Jahre,205,100,105
False,8115010,Deckenpfronn,35 - 40 Jahre,227,115,112
False,8115010,Deckenpfronn,40 - 45 Jahre,299,163,136
False,8115010,Deckenpfronn,45 - 50 Jahre,330,173,157
False,8115010,Deckenpfronn,50 - 55 Jahre,224,110,114
False,8115010,Deckenpfronn,55 - 60 Jahre,168,88,80
False,8115010,Deckenpfronn,60 - 65 Jahre,150,78,72
False,8115010,Deckenpfronn,65 - 75 Jahre,261,124,137
False,8115010,Deckenpfronn,75 und mehr Jahre,227,85,142
False,8115010,Deckenpfronn,Insgesamt,3168,1547,1621
False,8115013,Ehningen,unter 3 Jahre,202,115,87
False,8115013,Ehningen,3 -  6 Jahre,243,120,123
False,8115013,Ehningen,6 - 10 Jahre,315,160,155
False,8115013,Ehningen,10 - 15 Jahre,452,234,218
False,8115013,Ehningen,15 - 18 Jahre,257,127,130
False,8115013,Ehningen,18 - 20 Jahre,178,96,82
False,8115013,Ehningen,20 - 25 Jahre,424,238,186
False,8115013,Ehningen,25 - 30 Jahre,468,240,228
False,8115013,Ehningen,30 - 35 Jahre,494,260,234
False,8115013,Ehningen,35 - 40 Jahre,535,262,273
False,8115013,Ehningen,40 - 45 Jahre,723,364,359
False,8115013,Ehningen,45 - 50 Jahre,730,367,363
False,8115013,Ehningen,50 - 55 Jahre,580,304,276
False,8115013,Ehningen,55 - 60 Jahre,464,228,236
False,8115013,Ehningen,60 - 65 Jahre,417,209,208
False,8115013,Ehningen,65 - 75 Jahre,840,381,459
False,8115013,Ehningen,75 und mehr Jahre,581,244,337
False,8115013,Ehningen,Insgesamt,7903,3949,3954
False,8115015,Gärtringen,unter 3 Jahre,385,191,194
False,8115015,Gärtringen,3 -  6 Jahre,414,225,189
False,8115015,Gärtringen,6 - 10 Jahre,531,268,263
False,8115015,Gärtringen,10 - 15 Jahre,627,306,321
False,8115015,Gärtringen,15 - 18 Jahre,345,172,173
False,8115015,Gärtringen,18 - 20 Jahre,272,129,143
False,8115015,Gärtringen,20 - 25 Jahre,658,328,330
False,8115015,Gärtringen,25 - 30 Jahre,689,354,335
False,8115015,Gärtringen,30 - 35 Jahre,756,340,416
False,8115015,Gärtringen,35 - 40 Jahre,853,417,436
False,8115015,Gärtringen,40 - 45 Jahre,1115,557,558
False,8115015,Gärtringen,45 - 50 Jahre,1065,536,529
False,8115015,Gärtringen,50 - 55 Jahre,874,435,439
False,8115015,Gärtringen,55 - 60 Jahre,744,380,364
False,8115015,Gärtringen,60 - 65 Jahre,620,295,325
False,8115015,Gärtringen,65 - 75 Jahre,1304,632,672
False,8115015,Gärtringen,75 und mehr Jahre,864,362,502
False,8115015,Gärtringen,Insgesamt,12116,5927,6189
False,8115016,Gäufelden,unter 3 Jahre,241,119,122
False,8115016,Gäufelden,3 -  6 Jahre,285,155,130
False,8115016,Gäufelden,6 - 10 Jahre,390,203,187
False,8115016,Gäufelden,10 - 15 Jahre,615,299,316
False,8115016,Gäufelden,15 - 18 Jahre,378,201,177
False,8115016,Gäufelden,18 - 20 Jahre,264,121,143
False,8115016,Gäufelden,20 - 25 Jahre,592,299,293
False,8115016,Gäufelden,25 - 30 Jahre,504,254,250
False,8115016,Gäufelden,30 - 35 Jahre,573,289,284
False,8115016,Gäufelden,35 - 40 Jahre,620,300,320
False,8115016,Gäufelden,40 - 45 Jahre,841,457,384
False,8115016,Gäufelden,45 - 50 Jahre,858,435,423
False,8115016,Gäufelden,50 - 55 Jahre,776,402,374
False,8115016,Gäufelden,55 - 60 Jahre,563,279,284
False,8115016,Gäufelden,60 - 65 Jahre,474,229,245
False,8115016,Gäufelden,65 - 75 Jahre,801,403,398
False,8115016,Gäufelden,75 und mehr Jahre,537,222,315
False,8115016,Gäufelden,Insgesamt,9312,4667,4645
False,8115021,"Herrenberg, Stadt",unter 3 Jahre,828,434,394
False,8115021,"Herrenberg, Stadt",3 -  6 Jahre,871,448,423
False,8115021,"Herrenberg, Stadt",6 - 10 Jahre,1247,680,567
False,8115021,"Herrenberg, Stadt",10 - 15 Jahre,1777,933,844
False,8115021,"Herrenberg, Stadt",15 - 18 Jahre,1079,543,536
False,8115021,"Herrenberg, Stadt",18 - 20 Jahre,776,407,369
False,8115021,"Herrenberg, Stadt",20 - 25 Jahre,1725,884,841
False,8115021,"Herrenberg, Stadt",25 - 30 Jahre,1914,975,939
False,8115021,"Herrenberg, Stadt",30 - 35 Jahre,1817,859,958
False,8115021,"Herrenberg, Stadt",35 - 40 Jahre,2017,1000,1017
False,8115021,"Herrenberg, Stadt",40 - 45 Jahre,2647,1348,1299
False,8115021,"Herrenberg, Stadt",45 - 50 Jahre,2660,1362,1298
False,8115021,"Herrenberg, Stadt",50 - 55 Jahre,2345,1151,1194
False,8115021,"Herrenberg, Stadt",55 - 60 Jahre,1897,954,943
False,8115021,"Herrenberg, Stadt",60 - 65 Jahre,1564,765,799
False,8115021,"Herrenberg, Stadt",65 - 75 Jahre,3541,1687,1854
False,8115021,"Herrenberg, Stadt",75 und mehr Jahre,2587,998,1589
False,8115021,"Herrenberg, Stadt",Insgesamt,31292,15428,15864
False,8115022,Hildrizhausen,unter 3 Jahre,104,49,55
False,8115022,Hildrizhausen,3 -  6 Jahre,106,58,48
False,8115022,Hildrizhausen,6 - 10 Jahre,155,80,75
False,8115022,Hildrizhausen,10 - 15 Jahre,222,120,102
False,8115022,Hildrizhausen,15 - 18 Jahre,149,79,70
False,8115022,Hildrizhausen,18 - 20 Jahre,88,53,35
False,8115022,Hildrizhausen,20 - 25 Jahre,182,92,90
False,8115022,Hildrizhausen,25 - 30 Jahre,193,108,85
False,8115022,Hildrizhausen,30 - 35 Jahre,191,85,106
False,8115022,Hildrizhausen,35 - 40 Jahre,245,127,118
False,8115022,Hildrizhausen,40 - 45 Jahre,346,169,177
False,8115022,Hildrizhausen,45 - 50 Jahre,350,173,177
False,8115022,Hildrizhausen,50 - 55 Jahre,275,147,128
False,8115022,Hildrizhausen,55 - 60 Jahre,218,103,115
False,8115022,Hildrizhausen,60 - 65 Jahre,185,94,91
False,8115022,Hildrizhausen,65 - 75 Jahre,375,189,186
False,8115022,Hildrizhausen,75 und mehr Jahre,209,95,114
False,8115022,Hildrizhausen,Insgesamt,3593,1821,1772
False,8115024,"Holzgerlingen, Stadt",unter 3 Jahre,430,217,213
False,8115024,"Holzgerlingen, Stadt",3 -  6 Jahre,432,218,214
False,8115024,"Holzgerlingen, Stadt",6 - 10 Jahre,569,308,261
False,8115024,"Holzgerlingen, Stadt",10 - 15 Jahre,719,355,364
False,8115024,"Holzgerlingen, Stadt",15 - 18 Jahre,401,233,168
False,8115024,"Holzgerlingen, Stadt",18 - 20 Jahre,290,162,128
False,8115024,"Holzgerlingen, Stadt",20 - 25 Jahre,663,357,306
False,8115024,"Holzgerlingen, Stadt",25 - 30 Jahre,624,279,345
False,8115024,"Holzgerlingen, Stadt",30 - 35 Jahre,815,374,441
False,8115024,"Holzgerlingen, Stadt",35 - 40 Jahre,965,452,513
False,8115024,"Holzgerlingen, Stadt",40 - 45 Jahre,1220,632,588
False,8115024,"Holzgerlingen, Stadt",45 - 50 Jahre,1124,563,561
False,8115024,"Holzgerlingen, Stadt",50 - 55 Jahre,935,490,445
False,8115024,"Holzgerlingen, Stadt",55 - 60 Jahre,653,316,337
False,8115024,"Holzgerlingen, Stadt",60 - 65 Jahre,623,286,337
False,8115024,"Holzgerlingen, Stadt",65 - 75 Jahre,1343,666,677
False,8115024,"Holzgerlingen, Stadt",75 und mehr Jahre,916,373,543
False,8115024,"Holzgerlingen, Stadt",Insgesamt,12722,6281,6441
False,8115028,"Leonberg, Stadt",unter 3 Jahre,1150,593,557
False,8115028,"Leonberg, Stadt",3 -  6 Jahre,1164,603,561
False,8115028,"Leonberg, Stadt",6 - 10 Jahre,1592,807,785
False,8115028,"Leonberg, Stadt",10 - 15 Jahre,2194,1111,1083
False,8115028,"Leonberg, Stadt",15 - 18 Jahre,1359,694,665
False,8115028,"Leonberg, Stadt",18 - 20 Jahre,892,456,436
False,8115028,"Leonberg, Stadt",20 - 25 Jahre,2264,1193,1071
False,8115028,"Leonberg, Stadt",25 - 30 Jahre,2713,1326,1387
False,8115028,"Leonberg, Stadt",30 - 35 Jahre,2937,1529,1408
False,8115028,"Leonberg, Stadt",35 - 40 Jahre,2838,1441,1397
False,8115028,"Leonberg, Stadt",40 - 45 Jahre,3810,1978,1832
False,8115028,"Leonberg, Stadt",45 - 50 Jahre,3693,1904,1789
False,8115028,"Leonberg, Stadt",50 - 55 Jahre,3314,1657,1657
False,8115028,"Leonberg, Stadt",55 - 60 Jahre,2805,1370,1435
False,8115028,"Leonberg, Stadt",60 - 65 Jahre,2637,1260,1377
False,8115028,"Leonberg, Stadt",65 - 75 Jahre,5495,2584,2911
False,8115028,"Leonberg, Stadt",75 und mehr Jahre,4241,1622,2619
False,8115028,"Leonberg, Stadt",Insgesamt,45098,22128,22970
False,8115029,Magstadt,unter 3 Jahre,265,133,132
False,8115029,Magstadt,3 -  6 Jahre,283,140,143
False,8115029,Magstadt,6 - 10 Jahre,366,195,171
False,8115029,Magstadt,10 - 15 Jahre,431,216,215
False,8115029,Magstadt,15 - 18 Jahre,283,143,140
False,8115029,Magstadt,18 - 20 Jahre,197,105,92
False,8115029,Magstadt,20 - 25 Jahre,492,254,238
False,8115029,Magstadt,25 - 30 Jahre,541,272,269
False,8115029,Magstadt,30 - 35 Jahre,583,301,282
False,8115029,Magstadt,35 - 40 Jahre,622,326,296
False,8115029,Magstadt,40 - 45 Jahre,746,406,340
False,8115029,Magstadt,45 - 50 Jahre,767,392,375
False,8115029,Magstadt,50 - 55 Jahre,612,310,302
False,8115029,Magstadt,55 - 60 Jahre,548,251,297
False,8115029,Magstadt,60 - 65 Jahre,472,247,225
False,8115029,Magstadt,65 - 75 Jahre,927,446,481
False,8115029,Magstadt,75 und mehr Jahre,658,257,401
False,8115029,Magstadt,Insgesamt,8793,4394,4399
False,8115034,Mötzingen,unter 3 Jahre,97,49,48
False,8115034,Mötzingen,3 -  6 Jahre,108,41,67
False,8115034,Mötzingen,6 - 10 Jahre,158,76,82
False,8115034,Mötzingen,10 - 15 Jahre,264,135,129
False,8115034,Mötzingen,15 - 18 Jahre,174,84,90
False,8115034,Mötzingen,18 - 20 Jahre,108,61,47
False,8115034,Mötzingen,20 - 25 Jahre,235,115,120
False,8115034,Mötzingen,25 - 30 Jahre,200,98,102
False,8115034,Mötzingen,30 - 35 Jahre,158,94,64
False,8115034,Mötzingen,35 - 40 Jahre,219,99,120
False,8115034,Mötzingen,40 - 45 Jahre,353,171,182
False,8115034,Mötzingen,45 - 50 Jahre,348,172,176
False,8115034,Mötzingen,50 - 55 Jahre,318,161,157
False,8115034,Mötzingen,55 - 60 Jahre,228,121,107
False,8115034,Mötzingen,60 - 65 Jahre,187,92,95
False,8115034,Mötzingen,65 - 75 Jahre,318,163,155
False,8115034,Mötzingen,75 und mehr Jahre,205,76,129
False,8115034,Mötzingen,Insgesamt,3678,1808,1870
False,8115037,Nufringen,unter 3 Jahre,159,70,89
False,8115037,Nufringen,3 -  6 Jahre,164,87,77
False,8115037,Nufringen,6 - 10 Jahre,226,126,100
False,8115037,Nufringen,10 - 15 Jahre,334,174,160
False,8115037,Nufringen,15 - 18 Jahre,177,86,91
False,8115037,Nufringen,18 - 20 Jahre,129,61,68
False,8115037,Nufringen,20 - 25 Jahre,322,176,146
False,8115037,Nufringen,25 - 30 Jahre,349,176,173
False,8115037,Nufringen,30 - 35 Jahre,321,160,161
False,8115037,Nufringen,35 - 40 Jahre,382,189,193
False,8115037,Nufringen,40 - 45 Jahre,465,223,242
False,8115037,Nufringen,45 - 50 Jahre,482,246,236
False,8115037,Nufringen,50 - 55 Jahre,402,197,205
False,8115037,Nufringen,55 - 60 Jahre,321,151,170
False,8115037,Nufringen,60 - 65 Jahre,259,131,128
False,8115037,Nufringen,65 - 75 Jahre,519,271,248
False,8115037,Nufringen,75 und mehr Jahre,378,154,224
False,8115037,Nufringen,Insgesamt,5389,2678,2711
False,8115041,"Renningen, Stadt",unter 3 Jahre,480,246,234
False,8115041,"Renningen, Stadt",3 -  6 Jahre,479,232,247
False,8115041,"Renningen, Stadt",6 - 10 Jahre,660,340,320
False,8115041,"Renningen, Stadt",10 - 15 Jahre,1043,554,489
False,8115041,"Renningen, Stadt",15 - 18 Jahre,605,316,289
False,8115041,"Renningen, Stadt",18 - 20 Jahre,405,212,193
False,8115041,"Renningen, Stadt",20 - 25 Jahre,957,498,459
False,8115041,"Renningen, Stadt",25 - 30 Jahre,953,469,484
False,8115041,"Renningen, Stadt",30 - 35 Jahre,1034,501,533
False,8115041,"Renningen, Stadt",35 - 40 Jahre,1169,589,580
False,8115041,"Renningen, Stadt",40 - 45 Jahre,1536,777,759
False,8115041,"Renningen, Stadt",45 - 50 Jahre,1542,758,784
False,8115041,"Renningen, Stadt",50 - 55 Jahre,1388,649,739
False,8115041,"Renningen, Stadt",55 - 60 Jahre,1071,514,557
False,8115041,"Renningen, Stadt",60 - 65 Jahre,881,437,444
False,8115041,"Renningen, Stadt",65 - 75 Jahre,1787,865,922
False,8115041,"Renningen, Stadt",75 und mehr Jahre,1301,532,769
False,8115041,"Renningen, Stadt",Insgesamt,17291,8489,8802
False,8115042,"Rutesheim, Stadt",unter 3 Jahre,272,127,145
False,8115042,"Rutesheim, Stadt",3 -  6 Jahre,253,124,129
False,8115042,"Rutesheim, Stadt",6 - 10 Jahre,412,223,189
False,8115042,"Rutesheim, Stadt",10 - 15 Jahre,623,331,292
False,8115042,"Rutesheim, Stadt",15 - 18 Jahre,371,187,184
False,8115042,"Rutesheim, Stadt",18 - 20 Jahre,230,120,110
False,8115042,"Rutesheim, Stadt",20 - 25 Jahre,532,267,265
False,8115042,"Rutesheim, Stadt",25 - 30 Jahre,510,269,241
False,8115042,"Rutesheim, Stadt",30 - 35 Jahre,565,272,293
False,8115042,"Rutesheim, Stadt",35 - 40 Jahre,670,349,321
False,8115042,"Rutesheim, Stadt",40 - 45 Jahre,916,440,476
False,8115042,"Rutesheim, Stadt",45 - 50 Jahre,957,480,477
False,8115042,"Rutesheim, Stadt",50 - 55 Jahre,797,404,393
False,8115042,"Rutesheim, Stadt",55 - 60 Jahre,615,301,314
False,8115042,"Rutesheim, Stadt",60 - 65 Jahre,597,309,288
False,8115042,"Rutesheim, Stadt",65 - 75 Jahre,1104,531,573
False,8115042,"Rutesheim, Stadt",75 und mehr Jahre,825,337,488
False,8115042,"Rutesheim, Stadt",Insgesamt,10249,5071,5178
False,8115044,Schönaich,unter 3 Jahre,235,119,116
False,8115044,Schönaich,3 -  6 Jahre,232,122,110
False,8115044,Schönaich,6 - 10 Jahre,337,177,160
False,8115044,Schönaich,10 - 15 Jahre,564,302,262
False,8115044,Schönaich,15 - 18 Jahre,288,147,141
False,8115044,Schönaich,18 - 20 Jahre,212,108,104
False,8115044,Schönaich,20 - 25 Jahre,536,286,250
False,8115044,Schönaich,25 - 30 Jahre,502,240,262
False,8115044,Schönaich,30 - 35 Jahre,535,273,262
False,8115044,Schönaich,35 - 40 Jahre,572,297,275
False,8115044,Schönaich,40 - 45 Jahre,826,379,447
False,8115044,Schönaich,45 - 50 Jahre,868,459,409
False,8115044,Schönaich,50 - 55 Jahre,707,384,323
False,8115044,Schönaich,55 - 60 Jahre,638,312,326
False,8115044,Schönaich,60 - 65 Jahre,527,252,275
False,8115044,Schönaich,65 - 75 Jahre,1242,589,653
False,8115044,Schönaich,75 und mehr Jahre,858,369,489
False,8115044,Schönaich,Insgesamt,9679,4815,4864
False,8115045,"Sindelfingen, Stadt",unter 3 Jahre,1748,913,835
False,8115045,"Sindelfingen, Stadt",3 -  6 Jahre,1684,883,801
False,8115045,"Sindelfingen, Stadt",6 - 10 Jahre,2309,1199,1110
False,8115045,"Sindelfingen, Stadt",10 - 15 Jahre,3056,1575,1481
False,8115045,"Sindelfingen, Stadt",15 - 18 Jahre,1918,968,950
False,8115045,"Sindelfingen, Stadt",18 - 20 Jahre,1301,643,658
False,8115045,"Sindelfingen, Stadt",20 - 25 Jahre,3404,1687,1717
False,8115045,"Sindelfingen, Stadt",25 - 30 Jahre,3751,1911,1840
False,8115045,"Sindelfingen, Stadt",30 - 35 Jahre,3951,2056,1895
False,8115045,"Sindelfingen, Stadt",35 - 40 Jahre,3967,2015,1952
False,8115045,"Sindelfingen, Stadt",40 - 45 Jahre,4640,2403,2237
False,8115045,"Sindelfingen, Stadt",45 - 50 Jahre,4798,2518,2280
False,8115045,"Sindelfingen, Stadt",50 - 55 Jahre,4363,2139,2224
False,8115045,"Sindelfingen, Stadt",55 - 60 Jahre,3613,1785,1828
False,8115045,"Sindelfingen, Stadt",60 - 65 Jahre,3326,1567,1759
False,8115045,"Sindelfingen, Stadt",65 - 75 Jahre,7173,3460,3713
False,8115045,"Sindelfingen, Stadt",75 und mehr Jahre,5443,2242,3201
False,8115045,"Sindelfingen, Stadt",Insgesamt,60445,29964,30481
False,8115046,Steinenbronn,unter 3 Jahre,191,88,103
False,8115046,Steinenbronn,3 -  6 Jahre,186,102,84
False,8115046,Steinenbronn,6 - 10 Jahre,228,125,103
False,8115046,Steinenbronn,10 - 15 Jahre,331,183,148
False,8115046,Steinenbronn,15 - 18 Jahre,220,120,100
False,8115046,Steinenbronn,18 - 20 Jahre,157,84,73
False,8115046,Steinenbronn,20 - 25 Jahre,372,210,162
False,8115046,Steinenbronn,25 - 30 Jahre,349,167,182
False,8115046,Steinenbronn,30 - 35 Jahre,409,200,209
False,8115046,Steinenbronn,35 - 40 Jahre,359,178,181
False,8115046,Steinenbronn,40 - 45 Jahre,484,250,234
False,8115046,Steinenbronn,45 - 50 Jahre,560,294,266
False,8115046,Steinenbronn,50 - 55 Jahre,508,263,245
False,8115046,Steinenbronn,55 - 60 Jahre,394,219,175
False,8115046,Steinenbronn,60 - 65 Jahre,306,148,158
False,8115046,Steinenbronn,65 - 75 Jahre,592,275,317
False,8115046,Steinenbronn,75 und mehr Jahre,443,180,263
False,8115046,Steinenbronn,Insgesamt,6089,3086,3003
False,8115048,"Waldenbuch, Stadt",unter 3 Jahre,220,106,114
False,8115048,"Waldenbuch, Stadt",3 -  6 Jahre,228,127,101
False,8115048,"Waldenbuch, Stadt",6 - 10 Jahre,336,176,160
False,8115048,"Waldenbuch, Stadt",10 - 15 Jahre,471,245,226
False,8115048,"Waldenbuch, Stadt",15 - 18 Jahre,279,145,134
False,8115048,"Waldenbuch, Stadt",18 - 20 Jahre,209,104,105
False,8115048,"Waldenbuch, Stadt",20 - 25 Jahre,416,224,192
False,8115048,"Waldenbuch, Stadt",25 - 30 Jahre,435,191,244
False,8115048,"Waldenbuch, Stadt",30 - 35 Jahre,495,246,249
False,8115048,"Waldenbuch, Stadt",35 - 40 Jahre,513,248,265
False,8115048,"Waldenbuch, Stadt",40 - 45 Jahre,712,370,342
False,8115048,"Waldenbuch, Stadt",45 - 50 Jahre,749,362,387
False,8115048,"Waldenbuch, Stadt",50 - 55 Jahre,709,365,344
False,8115048,"Waldenbuch, Stadt",55 - 60 Jahre,618,277,341
False,8115048,"Waldenbuch, Stadt",60 - 65 Jahre,510,266,244
False,8115048,"Waldenbuch, Stadt",65 - 75 Jahre,929,451,478
False,8115048,"Waldenbuch, Stadt",75 und mehr Jahre,698,267,431
False,8115048,"Waldenbuch, Stadt",Insgesamt,8527,4170,4357
False,8115050,"Weil der Stadt, Stadt",unter 3 Jahre,491,245,246
False,8115050,"Weil der Stadt, Stadt",3 -  6 Jahre,485,262,223
False,8115050,"Weil der Stadt, Stadt",6 - 10 Jahre,715,363,352
False,8115050,"Weil der Stadt, Stadt",10 - 15 Jahre,1027,528,499
False,8115050,"Weil der Stadt, Stadt",15 - 18 Jahre,692,362,330
False,8115050,"Weil der Stadt, Stadt",18 - 20 Jahre,463,228,235
False,8115050,"Weil der Stadt, Stadt",20 - 25 Jahre,1101,577,524
False,8115050,"Weil der Stadt, Stadt",25 - 30 Jahre,947,470,477
False,8115050,"Weil der Stadt, Stadt",30 - 35 Jahre,1090,532,558
False,8115050,"Weil der Stadt, Stadt",35 - 40 Jahre,1115,562,553
False,8115050,"Weil der Stadt, Stadt",40 - 45 Jahre,1610,846,764
False,8115050,"Weil der Stadt, Stadt",45 - 50 Jahre,1668,874,794
False,8115050,"Weil der Stadt, Stadt",50 - 55 Jahre,1484,760,724
False,8115050,"Weil der Stadt, Stadt",55 - 60 Jahre,1290,616,674
False,8115050,"Weil der Stadt, Stadt",60 - 65 Jahre,1001,500,501
False,8115050,"Weil der Stadt, Stadt",65 - 75 Jahre,2104,1017,1087
False,8115050,"Weil der Stadt, Stadt",75 und mehr Jahre,1581,623,958
False,8115050,"Weil der Stadt, Stadt",Insgesamt,18864,9365,9499
False,8115051,Weil im Schönbuch,unter 3 Jahre,218,115,103
False,8115051,Weil im Schönbuch,3 -  6 Jahre,283,135,148
False,8115051,Weil im Schönbuch,6 - 10 Jahre,449,232,217
False,8115051,Weil im Schönbuch,10 - 15 Jahre,676,332,344
False,8115051,Weil im Schönbuch,15 - 18 Jahre,358,169,189
False,8115051,Weil im Schönbuch,18 - 20 Jahre,215,115,100
False,8115051,Weil im Schönbuch,20 - 25 Jahre,489,270,219
False,8115051,Weil im Schönbuch,25 - 30 Jahre,457,222,235
False,8115051,Weil im Schönbuch,30 - 35 Jahre,473,224,249
False,8115051,Weil im Schönbuch,35 - 40 Jahre,596,254,342
False,8115051,Weil im Schönbuch,40 - 45 Jahre,950,513,437
False,8115051,Weil im Schönbuch,45 - 50 Jahre,933,463,470
False,8115051,Weil im Schönbuch,50 - 55 Jahre,773,425,348
False,8115051,Weil im Schönbuch,55 - 60 Jahre,582,269,313
False,8115051,Weil im Schönbuch,60 - 65 Jahre,503,250,253
False,8115051,Weil im Schönbuch,65 - 75 Jahre,1075,529,546
False,8115051,Weil im Schönbuch,75 und mehr Jahre,747,291,456
False,8115051,Weil im Schönbuch,Insgesamt,9777,4808,4969
False,8115052,Weissach,unter 3 Jahre,183,98,85
False,8115052,Weissach,3 -  6 Jahre,191,99,92
False,8115052,Weissach,6 - 10 Jahre,289,140,149
False,8115052,Weissach,10 - 15 Jahre,440,230,210
False,8115052,Weissach,15 - 18 Jahre,285,151,134
False,8115052,Weissach,18 - 20 Jahre,225,120,105
False,8115052,Weissach,20 - 25 Jahre,396,212,184
False,8115052,Weissach,25 - 30 Jahre,384,209,175
False,8115052,Weissach,30 - 35 Jahre,326,172,154
False,8115052,Weissach,35 - 40 Jahre,414,194,220
False,8115052,Weissach,40 - 45 Jahre,648,322,326
False,8115052,Weissach,45 - 50 Jahre,693,337,356
False,8115052,Weissach,50 - 55 Jahre,606,307,299
False,8115052,Weissach,55 - 60 Jahre,533,265,268
False,8115052,Weissach,60 - 65 Jahre,376,174,202
False,8115052,Weissach,65 - 75 Jahre,822,415,407
False,8115052,Weissach,75 und mehr Jahre,587,239,348
False,8115052,Weissach,Insgesamt,7398,3684,3714
False,8115053,Jettingen,unter 3 Jahre,204,106,98
False,8115053,Jettingen,3 -  6 Jahre,209,108,101
False,8115053,Jettingen,6 - 10 Jahre,328,175,153
False,8115053,Jettingen,10 - 15 Jahre,514,253,261
False,8115053,Jettingen,15 - 18 Jahre,308,149,159
False,8115053,Jettingen,18 - 20 Jahre,212,107,105
False,8115053,Jettingen,20 - 25 Jahre,510,264,246
False,8115053,Jettingen,25 - 30 Jahre,401,212,189
False,8115053,Jettingen,30 - 35 Jahre,425,211,214
False,8115053,Jettingen,35 - 40 Jahre,468,219,249
False,8115053,Jettingen,40 - 45 Jahre,618,276,342
False,8115053,Jettingen,45 - 50 Jahre,714,347,367
False,8115053,Jettingen,50 - 55 Jahre,629,320,309
False,8115053,Jettingen,55 - 60 Jahre,481,243,238
False,8115053,Jettingen,60 - 65 Jahre,371,195,176
False,8115053,Jettingen,65 - 75 Jahre,716,357,359
False,8115053,Jettingen,75 und mehr Jahre,463,175,288
False,8115053,Jettingen,Insgesamt,7571,3717,3854
False,8115054,Grafenau,unter 3 Jahre,167,83,84
False,8115054,Grafenau,3 -  6 Jahre,157,83,74
False,8115054,Grafenau,6 - 10 Jahre,253,124,129
False,8115054,Grafenau,10 - 15 Jahre,404,213,191
False,8115054,Grafenau,15 - 18 Jahre,193,102,91
False,8115054,Grafenau,18 - 20 Jahre,138,81,57
False,8115054,Grafenau,20 - 25 Jahre,320,158,162
False,8115054,Grafenau,25 - 30 Jahre,301,154,147
False,8115054,Grafenau,30 - 35 Jahre,390,176,214
False,8115054,Grafenau,35 - 40 Jahre,446,236,210
False,8115054,Grafenau,40 - 45 Jahre,588,292,296
False,8115054,Grafenau,45 - 50 Jahre,607,315,292
False,8115054,Grafenau,50 - 55 Jahre,475,254,221
False,8115054,Grafenau,55 - 60 Jahre,426,213,213
False,8115054,Grafenau,60 - 65 Jahre,368,179,189
False,8115054,Grafenau,65 - 75 Jahre,745,385,360
False,8115054,Grafenau,75 und mehr Jahre,538,234,304
False,8115054,Grafenau,Insgesamt,6516,3282,3234
False,8116,Landkreis Esslingen,unter 3 Jahre,13734,7025,6709
False,8116,Landkreis Esslingen,3 -  6 Jahre,14106,7285,6821
False,8116,Landkreis Esslingen,6 - 10 Jahre,19695,10126,9569
False,8116,Landkreis Esslingen,10 - 15 Jahre,27091,13818,13273
False,8116,Landkreis Esslingen,15 - 18 Jahre,16627,8466,8161
False,8116,Landkreis Esslingen,18 - 20 Jahre,11226,5820,5406
False,8116,Landkreis Esslingen,20 - 25 Jahre,28873,14864,14009
False,8116,Landkreis Esslingen,25 - 30 Jahre,29533,14677,14856
False,8116,Landkreis Esslingen,30 - 35 Jahre,31310,15397,15913
False,8116,Landkreis Esslingen,35 - 40 Jahre,33308,16767,16541
False,8116,Landkreis Esslingen,40 - 45 Jahre,42930,21616,21314
False,8116,Landkreis Esslingen,45 - 50 Jahre,44760,23017,21743
False,8116,Landkreis Esslingen,50 - 55 Jahre,37928,19150,18778
False,8116,Landkreis Esslingen,55 - 60 Jahre,31453,15305,16148
False,8116,Landkreis Esslingen,60 - 65 Jahre,28804,13957,14847
False,8116,Landkreis Esslingen,65 - 75 Jahre,58111,27768,30343
False,8116,Landkreis Esslingen,75 und mehr Jahre,45341,18175,27166
False,8116,Landkreis Esslingen,Insgesamt,514830,253233,261597
False,8116004,Altbach,unter 3 Jahre,161,79,82
False,8116004,Altbach,3 -  6 Jahre,146,86,60
False,8116004,Altbach,6 - 10 Jahre,251,120,131
False,8116004,Altbach,10 - 15 Jahre,268,143,125
False,8116004,Altbach,15 - 18 Jahre,154,81,73
False,8116004,Altbach,18 - 20 Jahre,108,57,51
False,8116004,Altbach,20 - 25 Jahre,300,154,146
False,8116004,Altbach,25 - 30 Jahre,389,192,197
False,8116004,Altbach,30 - 35 Jahre,394,201,193
False,8116004,Altbach,35 - 40 Jahre,354,180,174
False,8116004,Altbach,40 - 45 Jahre,527,267,260
False,8116004,Altbach,45 - 50 Jahre,481,262,219
False,8116004,Altbach,50 - 55 Jahre,390,211,179
False,8116004,Altbach,55 - 60 Jahre,291,130,161
False,8116004,Altbach,60 - 65 Jahre,336,152,184
False,8116004,Altbach,65 - 75 Jahre,749,364,385
False,8116004,Altbach,75 und mehr Jahre,541,220,321
False,8116004,Altbach,Insgesamt,5840,2899,2941
False,8116005,Altdorf,unter 3 Jahre,51,28,23
False,8116005,Altdorf,3 -  6 Jahre,55,30,25
False,8116005,Altdorf,6 - 10 Jahre,91,55,36
False,8116005,Altdorf,10 - 15 Jahre,100,52,48
False,8116005,Altdorf,15 - 18 Jahre,52,32,20
False,8116005,Altdorf,18 - 20 Jahre,44,23,21
False,8116005,Altdorf,20 - 25 Jahre,84,42,42
False,8116005,Altdorf,25 - 30 Jahre,81,33,48
False,8116005,Altdorf,30 - 35 Jahre,76,32,44
False,8116005,Altdorf,35 - 40 Jahre,103,45,58
False,8116005,Altdorf,40 - 45 Jahre,146,77,69
False,8116005,Altdorf,45 - 50 Jahre,143,81,62
False,8116005,Altdorf,50 - 55 Jahre,112,54,58
False,8116005,Altdorf,55 - 60 Jahre,81,45,36
False,8116005,Altdorf,60 - 65 Jahre,79,43,36
False,8116005,Altdorf,65 - 75 Jahre,120,63,57
False,8116005,Altdorf,75 und mehr Jahre,66,23,43
False,8116005,Altdorf,Insgesamt,1484,758,726
False,8116006,Altenriet,unter 3 Jahre,48,26,22
False,8116006,Altenriet,3 -  6 Jahre,58,33,25
False,8116006,Altenriet,6 - 10 Jahre,104,57,47
False,8116006,Altenriet,10 - 15 Jahre,132,67,65
False,8116006,Altenriet,15 - 18 Jahre,75,46,29
False,8116006,Altenriet,18 - 20 Jahre,44,24,20
False,8116006,Altenriet,20 - 25 Jahre,102,50,52
False,8116006,Altenriet,25 - 30 Jahre,88,44,44
False,8116006,Altenriet,30 - 35 Jahre,102,46,56
False,8116006,Altenriet,35 - 40 Jahre,128,58,70
False,8116006,Altenriet,40 - 45 Jahre,182,79,103
False,8116006,Altenriet,45 - 50 Jahre,195,107,88
False,8116006,Altenriet,50 - 55 Jahre,159,73,86
False,8116006,Altenriet,55 - 60 Jahre,116,56,60
False,8116006,Altenriet,60 - 65 Jahre,110,57,53
False,8116006,Altenriet,65 - 75 Jahre,184,95,89
False,8116006,Altenriet,75 und mehr Jahre,106,45,61
False,8116006,Altenriet,Insgesamt,1933,963,970
False,8116007,Baltmannsweiler,unter 3 Jahre,156,79,77
False,8116007,Baltmannsweiler,3 -  6 Jahre,148,81,67
False,8116007,Baltmannsweiler,6 - 10 Jahre,237,118,119
False,8116007,Baltmannsweiler,10 - 15 Jahre,362,188,174
False,8116007,Baltmannsweiler,15 - 18 Jahre,204,101,103
False,8116007,Baltmannsweiler,18 - 20 Jahre,137,80,57
False,8116007,Baltmannsweiler,20 - 25 Jahre,277,153,124
False,8116007,Baltmannsweiler,25 - 30 Jahre,234,113,121
False,8116007,Baltmannsweiler,30 - 35 Jahre,275,136,139
False,8116007,Baltmannsweiler,35 - 40 Jahre,312,143,169
False,8116007,Baltmannsweiler,40 - 45 Jahre,458,226,232
False,8116007,Baltmannsweiler,45 - 50 Jahre,514,266,248
False,8116007,Baltmannsweiler,50 - 55 Jahre,375,204,171
False,8116007,Baltmannsweiler,55 - 60 Jahre,338,158,180
False,8116007,Baltmannsweiler,60 - 65 Jahre,317,156,161
False,8116007,Baltmannsweiler,65 - 75 Jahre,710,328,382
False,8116007,Baltmannsweiler,75 und mehr Jahre,500,204,296
False,8116007,Baltmannsweiler,Insgesamt,5554,2734,2820
False,8116008,Bempflingen,unter 3 Jahre,90,50,40
False,8116008,Bempflingen,3 -  6 Jahre,93,53,40
False,8116008,Bempflingen,6 - 10 Jahre,130,74,56
False,8116008,Bempflingen,10 - 15 Jahre,200,98,102
False,8116008,Bempflingen,15 - 18 Jahre,117,58,59
False,8116008,Bempflingen,18 - 20 Jahre,66,35,31
False,8116008,Bempflingen,20 - 25 Jahre,197,94,103
False,8116008,Bempflingen,25 - 30 Jahre,164,72,92
False,8116008,Bempflingen,30 - 35 Jahre,166,68,98
False,8116008,Bempflingen,35 - 40 Jahre,239,140,99
False,8116008,Bempflingen,40 - 45 Jahre,275,125,150
False,8116008,Bempflingen,45 - 50 Jahre,303,159,144
False,8116008,Bempflingen,50 - 55 Jahre,242,116,126
False,8116008,Bempflingen,55 - 60 Jahre,197,101,96
False,8116008,Bempflingen,60 - 65 Jahre,168,79,89
False,8116008,Bempflingen,65 - 75 Jahre,416,204,212
False,8116008,Bempflingen,75 und mehr Jahre,285,115,170
False,8116008,Bempflingen,Insgesamt,3348,1641,1707
False,8116011,Beuren,unter 3 Jahre,86,48,38
False,8116011,Beuren,3 -  6 Jahre,77,35,42
False,8116011,Beuren,6 - 10 Jahre,114,53,61
False,8116011,Beuren,10 - 15 Jahre,158,77,81
False,8116011,Beuren,15 - 18 Jahre,106,47,59
False,8116011,Beuren,18 - 20 Jahre,83,45,38
False,8116011,Beuren,20 - 25 Jahre,217,127,90
False,8116011,Beuren,25 - 30 Jahre,162,85,77
False,8116011,Beuren,30 - 35 Jahre,179,88,91
False,8116011,Beuren,35 - 40 Jahre,164,94,70
False,8116011,Beuren,40 - 45 Jahre,258,133,125
False,8116011,Beuren,45 - 50 Jahre,267,135,132
False,8116011,Beuren,50 - 55 Jahre,285,142,143
False,8116011,Beuren,55 - 60 Jahre,219,112,107
False,8116011,Beuren,60 - 65 Jahre,160,87,73
False,8116011,Beuren,65 - 75 Jahre,407,179,228
False,8116011,Beuren,75 und mehr Jahre,417,163,254
False,8116011,Beuren,Insgesamt,3359,1650,1709
False,8116012,Bissingen an der Teck,unter 3 Jahre,77,44,33
False,8116012,Bissingen an der Teck,3 -  6 Jahre,84,55,29
False,8116012,Bissingen an der Teck,6 - 10 Jahre,142,65,77
False,8116012,Bissingen an der Teck,10 - 15 Jahre,211,118,93
False,8116012,Bissingen an der Teck,15 - 18 Jahre,140,75,65
False,8116012,Bissingen an der Teck,18 - 20 Jahre,94,50,44
False,8116012,Bissingen an der Teck,20 - 25 Jahre,186,89,97
False,8116012,Bissingen an der Teck,25 - 30 Jahre,188,104,84
False,8116012,Bissingen an der Teck,30 - 35 Jahre,178,97,81
False,8116012,Bissingen an der Teck,35 - 40 Jahre,245,110,135
False,8116012,Bissingen an der Teck,40 - 45 Jahre,290,141,149
False,8116012,Bissingen an der Teck,45 - 50 Jahre,332,167,165
False,8116012,Bissingen an der Teck,50 - 55 Jahre,276,142,134
False,8116012,Bissingen an der Teck,55 - 60 Jahre,234,119,115
False,8116012,Bissingen an der Teck,60 - 65 Jahre,190,86,104
False,8116012,Bissingen an der Teck,65 - 75 Jahre,361,180,181
False,8116012,Bissingen an der Teck,75 und mehr Jahre,295,126,169
False,8116012,Bissingen an der Teck,Insgesamt,3523,1768,1755
False,8116014,Deizisau,unter 3 Jahre,138,67,71
False,8116014,Deizisau,3 -  6 Jahre,160,87,73
False,8116014,Deizisau,6 - 10 Jahre,290,158,132
False,8116014,Deizisau,10 - 15 Jahre,375,218,157
False,8116014,Deizisau,15 - 18 Jahre,223,123,100
False,8116014,Deizisau,18 - 20 Jahre,136,71,65
False,8116014,Deizisau,20 - 25 Jahre,330,172,158
False,8116014,Deizisau,25 - 30 Jahre,378,190,188
False,8116014,Deizisau,30 - 35 Jahre,335,179,156
False,8116014,Deizisau,35 - 40 Jahre,387,179,208
False,8116014,Deizisau,40 - 45 Jahre,599,295,304
False,8116014,Deizisau,45 - 50 Jahre,607,306,301
False,8116014,Deizisau,50 - 55 Jahre,420,216,204
False,8116014,Deizisau,55 - 60 Jahre,377,185,192
False,8116014,Deizisau,60 - 65 Jahre,345,155,190
False,8116014,Deizisau,65 - 75 Jahre,789,370,419
False,8116014,Deizisau,75 und mehr Jahre,531,225,306
False,8116014,Deizisau,Insgesamt,6420,3196,3224
False,8116015,Denkendorf,unter 3 Jahre,282,147,135
False,8116015,Denkendorf,3 -  6 Jahre,283,140,143
False,8116015,Denkendorf,6 - 10 Jahre,416,213,203
False,8116015,Denkendorf,10 - 15 Jahre,605,296,309
False,8116015,Denkendorf,15 - 18 Jahre,355,201,154
False,8116015,Denkendorf,18 - 20 Jahre,230,108,122
False,8116015,Denkendorf,20 - 25 Jahre,621,315,306
False,8116015,Denkendorf,25 - 30 Jahre,610,312,298
False,8116015,Denkendorf,30 - 35 Jahre,681,338,343
False,8116015,Denkendorf,35 - 40 Jahre,680,332,348
False,8116015,Denkendorf,40 - 45 Jahre,873,448,425
False,8116015,Denkendorf,45 - 50 Jahre,860,448,412
False,8116015,Denkendorf,50 - 55 Jahre,730,356,374
False,8116015,Denkendorf,55 - 60 Jahre,619,298,321
False,8116015,Denkendorf,60 - 65 Jahre,575,297,278
False,8116015,Denkendorf,65 - 75 Jahre,1186,554,632
False,8116015,Denkendorf,75 und mehr Jahre,861,371,490
False,8116015,Denkendorf,Insgesamt,10467,5174,5293
False,8116016,Dettingen unter Teck,unter 3 Jahre,173,89,84
False,8116016,Dettingen unter Teck,3 -  6 Jahre,154,86,68
False,8116016,Dettingen unter Teck,6 - 10 Jahre,244,130,114
False,8116016,Dettingen unter Teck,10 - 15 Jahre,306,156,150
False,8116016,Dettingen unter Teck,15 - 18 Jahre,180,104,76
False,8116016,Dettingen unter Teck,18 - 20 Jahre,115,51,64
False,8116016,Dettingen unter Teck,20 - 25 Jahre,277,144,133
False,8116016,Dettingen unter Teck,25 - 30 Jahre,300,149,151
False,8116016,Dettingen unter Teck,30 - 35 Jahre,314,170,144
False,8116016,Dettingen unter Teck,35 - 40 Jahre,378,189,189
False,8116016,Dettingen unter Teck,40 - 45 Jahre,454,244,210
False,8116016,Dettingen unter Teck,45 - 50 Jahre,419,222,197
False,8116016,Dettingen unter Teck,50 - 55 Jahre,392,192,200
False,8116016,Dettingen unter Teck,55 - 60 Jahre,377,173,204
False,8116016,Dettingen unter Teck,60 - 65 Jahre,341,174,167
False,8116016,Dettingen unter Teck,65 - 75 Jahre,694,347,347
False,8116016,Dettingen unter Teck,75 und mehr Jahre,580,221,359
False,8116016,Dettingen unter Teck,Insgesamt,5698,2841,2857
False,8116018,Erkenbrechtsweiler,unter 3 Jahre,57,33,24
False,8116018,Erkenbrechtsweiler,3 -  6 Jahre,50,23,27
False,8116018,Erkenbrechtsweiler,6 - 10 Jahre,86,38,48
False,8116018,Erkenbrechtsweiler,10 - 15 Jahre,128,65,63
False,8116018,Erkenbrechtsweiler,15 - 18 Jahre,83,44,39
False,8116018,Erkenbrechtsweiler,18 - 20 Jahre,76,43,33
False,8116018,Erkenbrechtsweiler,20 - 25 Jahre,116,60,56
False,8116018,Erkenbrechtsweiler,25 - 30 Jahre,96,42,54
False,8116018,Erkenbrechtsweiler,30 - 35 Jahre,102,51,51
False,8116018,Erkenbrechtsweiler,35 - 40 Jahre,131,68,63
False,8116018,Erkenbrechtsweiler,40 - 45 Jahre,165,77,88
False,8116018,Erkenbrechtsweiler,45 - 50 Jahre,194,95,99
False,8116018,Erkenbrechtsweiler,50 - 55 Jahre,179,100,79
False,8116018,Erkenbrechtsweiler,55 - 60 Jahre,148,74,74
False,8116018,Erkenbrechtsweiler,60 - 65 Jahre,125,66,59
False,8116018,Erkenbrechtsweiler,65 - 75 Jahre,221,102,119
False,8116018,Erkenbrechtsweiler,75 und mehr Jahre,145,51,94
False,8116018,Erkenbrechtsweiler,Insgesamt,2102,1032,1070
False,8116019,"Esslingen am Neckar, Stadt",unter 3 Jahre,2535,1294,1241
False,8116019,"Esslingen am Neckar, Stadt",3 -  6 Jahre,2494,1258,1236
False,8116019,"Esslingen am Neckar, Stadt",6 - 10 Jahre,3231,1651,1580
False,8116019,"Esslingen am Neckar, Stadt",10 - 15 Jahre,4332,2188,2144
False,8116019,"Esslingen am Neckar, Stadt",15 - 18 Jahre,2529,1286,1243
False,8116019,"Esslingen am Neckar, Stadt",18 - 20 Jahre,1778,912,866
False,8116019,"Esslingen am Neckar, Stadt",20 - 25 Jahre,4969,2575,2394
False,8116019,"Esslingen am Neckar, Stadt",25 - 30 Jahre,5941,2891,3050
False,8116019,"Esslingen am Neckar, Stadt",30 - 35 Jahre,6288,3125,3163
False,8116019,"Esslingen am Neckar, Stadt",35 - 40 Jahre,6154,3194,2960
False,8116019,"Esslingen am Neckar, Stadt",40 - 45 Jahre,7222,3777,3445
False,8116019,"Esslingen am Neckar, Stadt",45 - 50 Jahre,7671,4034,3637
False,8116019,"Esslingen am Neckar, Stadt",50 - 55 Jahre,6463,3285,3178
False,8116019,"Esslingen am Neckar, Stadt",55 - 60 Jahre,5254,2567,2687
False,8116019,"Esslingen am Neckar, Stadt",60 - 65 Jahre,5033,2393,2640
False,8116019,"Esslingen am Neckar, Stadt",65 - 75 Jahre,10853,5174,5679
False,8116019,"Esslingen am Neckar, Stadt",75 und mehr Jahre,9122,3598,5524
False,8116019,"Esslingen am Neckar, Stadt",Insgesamt,91869,45202,46667
False,8116020,Frickenhausen,unter 3 Jahre,208,115,93
False,8116020,Frickenhausen,3 -  6 Jahre,221,106,115
False,8116020,Frickenhausen,6 - 10 Jahre,317,172,145
False,8116020,Frickenhausen,10 - 15 Jahre,490,252,238
False,8116020,Frickenhausen,15 - 18 Jahre,324,163,161
False,8116020,Frickenhausen,18 - 20 Jahre,232,119,113
False,8116020,Frickenhausen,20 - 25 Jahre,492,245,247
False,8116020,Frickenhausen,25 - 30 Jahre,415,219,196
False,8116020,Frickenhausen,30 - 35 Jahre,456,213,243
False,8116020,Frickenhausen,35 - 40 Jahre,486,238,248
False,8116020,Frickenhausen,40 - 45 Jahre,700,348,352
False,8116020,Frickenhausen,45 - 50 Jahre,795,412,383
False,8116020,Frickenhausen,50 - 55 Jahre,653,345,308
False,8116020,Frickenhausen,55 - 60 Jahre,554,264,290
False,8116020,Frickenhausen,60 - 65 Jahre,533,264,269
False,8116020,Frickenhausen,65 - 75 Jahre,1083,527,556
False,8116020,Frickenhausen,75 und mehr Jahre,801,364,437
False,8116020,Frickenhausen,Insgesamt,8760,4366,4394
False,8116022,Großbettlingen,unter 3 Jahre,120,64,56
False,8116022,Großbettlingen,3 -  6 Jahre,138,72,66
False,8116022,Großbettlingen,6 - 10 Jahre,181,98,83
False,8116022,Großbettlingen,10 - 15 Jahre,232,115,117
False,8116022,Großbettlingen,15 - 18 Jahre,176,79,97
False,8116022,Großbettlingen,18 - 20 Jahre,95,44,51
False,8116022,Großbettlingen,20 - 25 Jahre,210,92,118
False,8116022,Großbettlingen,25 - 30 Jahre,213,103,110
False,8116022,Großbettlingen,30 - 35 Jahre,245,122,123
False,8116022,Großbettlingen,35 - 40 Jahre,265,130,135
False,8116022,Großbettlingen,40 - 45 Jahre,342,167,175
False,8116022,Großbettlingen,45 - 50 Jahre,393,203,190
False,8116022,Großbettlingen,50 - 55 Jahre,273,137,136
False,8116022,Großbettlingen,55 - 60 Jahre,269,123,146
False,8116022,Großbettlingen,60 - 65 Jahre,234,121,113
False,8116022,Großbettlingen,65 - 75 Jahre,474,229,245
False,8116022,Großbettlingen,75 und mehr Jahre,321,113,208
False,8116022,Großbettlingen,Insgesamt,4181,2012,2169
False,8116027,Hochdorf,unter 3 Jahre,127,67,60
False,8116027,Hochdorf,3 -  6 Jahre,122,65,57
False,8116027,Hochdorf,6 - 10 Jahre,152,77,75
False,8116027,Hochdorf,10 - 15 Jahre,243,121,122
False,8116027,Hochdorf,15 - 18 Jahre,166,77,89
False,8116027,Hochdorf,18 - 20 Jahre,101,59,42
False,8116027,Hochdorf,20 - 25 Jahre,207,106,101
False,8116027,Hochdorf,25 - 30 Jahre,224,109,115
False,8116027,Hochdorf,30 - 35 Jahre,292,137,155
False,8116027,Hochdorf,35 - 40 Jahre,285,161,124
False,8116027,Hochdorf,40 - 45 Jahre,440,224,216
False,8116027,Hochdorf,45 - 50 Jahre,364,167,197
False,8116027,Hochdorf,50 - 55 Jahre,354,185,169
False,8116027,Hochdorf,55 - 60 Jahre,301,145,156
False,8116027,Hochdorf,60 - 65 Jahre,278,143,135
False,8116027,Hochdorf,65 - 75 Jahre,577,271,306
False,8116027,Hochdorf,75 und mehr Jahre,460,182,278
False,8116027,Hochdorf,Insgesamt,4693,2296,2397
False,8116029,Holzmaden,unter 3 Jahre,46,31,15
False,8116029,Holzmaden,3 -  6 Jahre,59,27,32
False,8116029,Holzmaden,6 - 10 Jahre,90,43,47
False,8116029,Holzmaden,10 - 15 Jahre,148,66,82
False,8116029,Holzmaden,15 - 18 Jahre,84,40,44
False,8116029,Holzmaden,18 - 20 Jahre,65,37,28
False,8116029,Holzmaden,20 - 25 Jahre,115,65,50
False,8116029,Holzmaden,25 - 30 Jahre,95,45,50
False,8116029,Holzmaden,30 - 35 Jahre,129,74,55
False,8116029,Holzmaden,35 - 40 Jahre,126,60,66
False,8116029,Holzmaden,40 - 45 Jahre,194,91,103
False,8116029,Holzmaden,45 - 50 Jahre,230,119,111
False,8116029,Holzmaden,50 - 55 Jahre,180,84,96
False,8116029,Holzmaden,55 - 60 Jahre,127,69,58
False,8116029,Holzmaden,60 - 65 Jahre,106,53,53
False,8116029,Holzmaden,65 - 75 Jahre,181,90,91
False,8116029,Holzmaden,75 und mehr Jahre,156,68,88
False,8116029,Holzmaden,Insgesamt,2131,1062,1069
False,8116033,"Kirchheim unter Teck, Stadt",unter 3 Jahre,1012,506,506
False,8116033,"Kirchheim unter Teck, Stadt",3 -  6 Jahre,1091,563,528
False,8116033,"Kirchheim unter Teck, Stadt",6 - 10 Jahre,1398,727,671
False,8116033,"Kirchheim unter Teck, Stadt",10 - 15 Jahre,2148,1082,1066
False,8116033,"Kirchheim unter Teck, Stadt",15 - 18 Jahre,1361,688,673
False,8116033,"Kirchheim unter Teck, Stadt",18 - 20 Jahre,894,477,417
False,8116033,"Kirchheim unter Teck, Stadt",20 - 25 Jahre,2261,1156,1105
False,8116033,"Kirchheim unter Teck, Stadt",25 - 30 Jahre,2233,1092,1141
False,8116033,"Kirchheim unter Teck, Stadt",30 - 35 Jahre,2336,1160,1176
False,8116033,"Kirchheim unter Teck, Stadt",35 - 40 Jahre,2534,1309,1225
False,8116033,"Kirchheim unter Teck, Stadt",40 - 45 Jahre,3213,1558,1655
False,8116033,"Kirchheim unter Teck, Stadt",45 - 50 Jahre,3365,1687,1678
False,8116033,"Kirchheim unter Teck, Stadt",50 - 55 Jahre,3138,1546,1592
False,8116033,"Kirchheim unter Teck, Stadt",55 - 60 Jahre,2690,1301,1389
False,8116033,"Kirchheim unter Teck, Stadt",60 - 65 Jahre,2181,1086,1095
False,8116033,"Kirchheim unter Teck, Stadt",65 - 75 Jahre,4224,2001,2223
False,8116033,"Kirchheim unter Teck, Stadt",75 und mehr Jahre,3780,1433,2347
False,8116033,"Kirchheim unter Teck, Stadt",Insgesamt,39859,19372,20487
False,8116035,Köngen,unter 3 Jahre,216,124,92
False,8116035,Köngen,3 -  6 Jahre,255,126,129
False,8116035,Köngen,6 - 10 Jahre,375,207,168
False,8116035,Köngen,10 - 15 Jahre,557,293,264
False,8116035,Köngen,15 - 18 Jahre,355,184,171
False,8116035,Köngen,18 - 20 Jahre,250,136,114
False,8116035,Köngen,20 - 25 Jahre,547,304,243
False,8116035,Köngen,25 - 30 Jahre,498,248,250
False,8116035,Köngen,30 - 35 Jahre,519,245,274
False,8116035,Köngen,35 - 40 Jahre,605,283,322
False,8116035,Köngen,40 - 45 Jahre,910,447,463
False,8116035,Köngen,45 - 50 Jahre,966,483,483
False,8116035,Köngen,50 - 55 Jahre,676,343,333
False,8116035,Köngen,55 - 60 Jahre,546,271,275
False,8116035,Köngen,60 - 65 Jahre,527,257,270
False,8116035,Köngen,65 - 75 Jahre,990,475,515
False,8116035,Köngen,75 und mehr Jahre,821,306,515
False,8116035,Köngen,Insgesamt,9613,4732,4881
False,8116036,Kohlberg,unter 3 Jahre,75,40,35
False,8116036,Kohlberg,3 -  6 Jahre,78,50,28
False,8116036,Kohlberg,6 - 10 Jahre,89,39,50
False,8116036,Kohlberg,10 - 15 Jahre,133,61,72
False,8116036,Kohlberg,15 - 18 Jahre,73,35,38
False,8116036,Kohlberg,18 - 20 Jahre,55,33,22
False,8116036,Kohlberg,20 - 25 Jahre,129,75,54
False,8116036,Kohlberg,25 - 30 Jahre,122,71,51
False,8116036,Kohlberg,30 - 35 Jahre,133,68,65
False,8116036,Kohlberg,35 - 40 Jahre,153,82,71
False,8116036,Kohlberg,40 - 45 Jahre,181,87,94
False,8116036,Kohlberg,45 - 50 Jahre,194,103,91
False,8116036,Kohlberg,50 - 55 Jahre,166,80,86
False,8116036,Kohlberg,55 - 60 Jahre,131,63,68
False,8116036,Kohlberg,60 - 65 Jahre,140,66,74
False,8116036,Kohlberg,65 - 75 Jahre,264,132,132
False,8116036,Kohlberg,75 und mehr Jahre,161,56,105
False,8116036,Kohlberg,Insgesamt,2277,1141,1136
False,8116037,Lichtenwald,unter 3 Jahre,49,27,22
False,8116037,Lichtenwald,3 -  6 Jahre,48,23,25
False,8116037,Lichtenwald,6 - 10 Jahre,67,34,33
False,8116037,Lichtenwald,10 - 15 Jahre,138,64,74
False,8116037,Lichtenwald,15 - 18 Jahre,83,35,48
False,8116037,Lichtenwald,18 - 20 Jahre,61,26,35
False,8116037,Lichtenwald,20 - 25 Jahre,126,70,56
False,8116037,Lichtenwald,25 - 30 Jahre,124,61,63
False,8116037,Lichtenwald,30 - 35 Jahre,117,60,57
False,8116037,Lichtenwald,35 - 40 Jahre,129,69,60
False,8116037,Lichtenwald,40 - 45 Jahre,180,89,91
False,8116037,Lichtenwald,45 - 50 Jahre,233,110,123
False,8116037,Lichtenwald,50 - 55 Jahre,189,99,90
False,8116037,Lichtenwald,55 - 60 Jahre,173,87,86
False,8116037,Lichtenwald,60 - 65 Jahre,183,85,98
False,8116037,Lichtenwald,65 - 75 Jahre,317,158,159
False,8116037,Lichtenwald,75 und mehr Jahre,224,102,122
False,8116037,Lichtenwald,Insgesamt,2441,1199,1242
False,8116041,Neckartailfingen,unter 3 Jahre,100,57,43
False,8116041,Neckartailfingen,3 -  6 Jahre,106,52,54
False,8116041,Neckartailfingen,6 - 10 Jahre,167,94,73
False,8116041,Neckartailfingen,10 - 15 Jahre,205,107,98
False,8116041,Neckartailfingen,15 - 18 Jahre,144,71,73
False,8116041,Neckartailfingen,18 - 20 Jahre,92,53,39
False,8116041,Neckartailfingen,20 - 25 Jahre,204,110,94
False,8116041,Neckartailfingen,25 - 30 Jahre,200,101,99
False,8116041,Neckartailfingen,30 - 35 Jahre,232,102,130
False,8116041,Neckartailfingen,35 - 40 Jahre,255,125,130
False,8116041,Neckartailfingen,40 - 45 Jahre,334,163,171
False,8116041,Neckartailfingen,45 - 50 Jahre,337,181,156
False,8116041,Neckartailfingen,50 - 55 Jahre,309,157,152
False,8116041,Neckartailfingen,55 - 60 Jahre,215,102,113
False,8116041,Neckartailfingen,60 - 65 Jahre,196,100,96
False,8116041,Neckartailfingen,65 - 75 Jahre,386,184,202
False,8116041,Neckartailfingen,75 und mehr Jahre,289,129,160
False,8116041,Neckartailfingen,Insgesamt,3771,1888,1883
False,8116042,Neckartenzlingen,unter 3 Jahre,144,76,68
False,8116042,Neckartenzlingen,3 -  6 Jahre,184,93,91
False,8116042,Neckartenzlingen,6 - 10 Jahre,227,133,94
False,8116042,Neckartenzlingen,10 - 15 Jahre,332,171,161
False,8116042,Neckartenzlingen,15 - 18 Jahre,206,102,104
False,8116042,Neckartenzlingen,18 - 20 Jahre,129,57,72
False,8116042,Neckartenzlingen,20 - 25 Jahre,364,196,168
False,8116042,Neckartenzlingen,25 - 30 Jahre,369,198,171
False,8116042,Neckartenzlingen,30 - 35 Jahre,373,176,197
False,8116042,Neckartenzlingen,35 - 40 Jahre,415,210,205
False,8116042,Neckartenzlingen,40 - 45 Jahre,531,288,243
False,8116042,Neckartenzlingen,45 - 50 Jahre,480,230,250
False,8116042,Neckartenzlingen,50 - 55 Jahre,484,248,236
False,8116042,Neckartenzlingen,55 - 60 Jahre,416,201,215
False,8116042,Neckartenzlingen,60 - 65 Jahre,388,193,195
False,8116042,Neckartenzlingen,65 - 75 Jahre,689,340,349
False,8116042,Neckartenzlingen,75 und mehr Jahre,419,162,257
False,8116042,Neckartenzlingen,Insgesamt,6150,3074,3076
False,8116043,Neidlingen,unter 3 Jahre,57,27,30
False,8116043,Neidlingen,3 -  6 Jahre,41,28,13
False,8116043,Neidlingen,6 - 10 Jahre,69,31,38
False,8116043,Neidlingen,10 - 15 Jahre,112,62,50
False,8116043,Neidlingen,15 - 18 Jahre,76,36,40
False,8116043,Neidlingen,18 - 20 Jahre,38,20,18
False,8116043,Neidlingen,20 - 25 Jahre,90,47,43
False,8116043,Neidlingen,25 - 30 Jahre,85,37,48
False,8116043,Neidlingen,30 - 35 Jahre,112,41,71
False,8116043,Neidlingen,35 - 40 Jahre,113,66,47
False,8116043,Neidlingen,40 - 45 Jahre,152,77,75
False,8116043,Neidlingen,45 - 50 Jahre,177,98,79
False,8116043,Neidlingen,50 - 55 Jahre,137,67,70
False,8116043,Neidlingen,55 - 60 Jahre,107,57,50
False,8116043,Neidlingen,60 - 65 Jahre,107,50,57
False,8116043,Neidlingen,65 - 75 Jahre,188,93,95
False,8116043,Neidlingen,75 und mehr Jahre,157,63,94
False,8116043,Neidlingen,Insgesamt,1818,900,918
False,8116046,"Neuffen, Stadt",unter 3 Jahre,155,83,72
False,8116046,"Neuffen, Stadt",3 -  6 Jahre,170,99,71
False,8116046,"Neuffen, Stadt",6 - 10 Jahre,233,110,123
False,8116046,"Neuffen, Stadt",10 - 15 Jahre,361,180,181
False,8116046,"Neuffen, Stadt",15 - 18 Jahre,234,128,106
False,8116046,"Neuffen, Stadt",18 - 20 Jahre,148,76,72
False,8116046,"Neuffen, Stadt",20 - 25 Jahre,356,167,189
False,8116046,"Neuffen, Stadt",25 - 30 Jahre,275,153,122
False,8116046,"Neuffen, Stadt",30 - 35 Jahre,322,135,187
False,8116046,"Neuffen, Stadt",35 - 40 Jahre,388,195,193
False,8116046,"Neuffen, Stadt",40 - 45 Jahre,564,288,276
False,8116046,"Neuffen, Stadt",45 - 50 Jahre,513,265,248
False,8116046,"Neuffen, Stadt",50 - 55 Jahre,486,253,233
False,8116046,"Neuffen, Stadt",55 - 60 Jahre,407,203,204
False,8116046,"Neuffen, Stadt",60 - 65 Jahre,341,156,185
False,8116046,"Neuffen, Stadt",65 - 75 Jahre,672,328,344
False,8116046,"Neuffen, Stadt",75 und mehr Jahre,539,223,316
False,8116046,"Neuffen, Stadt",Insgesamt,6164,3042,3122
False,8116047,Neuhausen auf den Fildern,unter 3 Jahre,304,146,158
False,8116047,Neuhausen auf den Fildern,3 -  6 Jahre,335,170,165
False,8116047,Neuhausen auf den Fildern,6 - 10 Jahre,489,241,248
False,8116047,Neuhausen auf den Fildern,10 - 15 Jahre,596,291,305
False,8116047,Neuhausen auf den Fildern,15 - 18 Jahre,370,191,179
False,8116047,Neuhausen auf den Fildern,18 - 20 Jahre,266,134,132
False,8116047,Neuhausen auf den Fildern,20 - 25 Jahre,619,305,314
False,8116047,Neuhausen auf den Fildern,25 - 30 Jahre,715,342,373
False,8116047,Neuhausen auf den Fildern,30 - 35 Jahre,705,348,357
False,8116047,Neuhausen auf den Fildern,35 - 40 Jahre,769,381,388
False,8116047,Neuhausen auf den Fildern,40 - 45 Jahre,910,444,466
False,8116047,Neuhausen auf den Fildern,45 - 50 Jahre,1022,545,477
False,8116047,Neuhausen auf den Fildern,50 - 55 Jahre,820,433,387
False,8116047,Neuhausen auf den Fildern,55 - 60 Jahre,596,268,328
False,8116047,Neuhausen auf den Fildern,60 - 65 Jahre,667,324,343
False,8116047,Neuhausen auf den Fildern,65 - 75 Jahre,1216,573,643
False,8116047,Neuhausen auf den Fildern,75 und mehr Jahre,950,390,560
False,8116047,Neuhausen auf den Fildern,Insgesamt,11349,5526,5823
False,8116048,Notzingen,unter 3 Jahre,89,57,32
False,8116048,Notzingen,3 -  6 Jahre,102,59,43
False,8116048,Notzingen,6 - 10 Jahre,146,72,74
False,8116048,Notzingen,10 - 15 Jahre,185,94,91
False,8116048,Notzingen,15 - 18 Jahre,121,64,57
False,8116048,Notzingen,18 - 20 Jahre,84,56,28
False,8116048,Notzingen,20 - 25 Jahre,201,113,88
False,8116048,Notzingen,25 - 30 Jahre,162,74,88
False,8116048,Notzingen,30 - 35 Jahre,182,90,92
False,8116048,Notzingen,35 - 40 Jahre,203,96,107
False,8116048,Notzingen,40 - 45 Jahre,274,150,124
False,8116048,Notzingen,45 - 50 Jahre,326,187,139
False,8116048,Notzingen,50 - 55 Jahre,310,145,165
False,8116048,Notzingen,55 - 60 Jahre,274,144,130
False,8116048,Notzingen,60 - 65 Jahre,209,99,110
False,8116048,Notzingen,65 - 75 Jahre,395,183,212
False,8116048,Notzingen,75 und mehr Jahre,289,117,172
False,8116048,Notzingen,Insgesamt,3552,1800,1752
False,8116049,"Nürtingen, Stadt",unter 3 Jahre,1039,522,517
False,8116049,"Nürtingen, Stadt",3 -  6 Jahre,1128,586,542
False,8116049,"Nürtingen, Stadt",6 - 10 Jahre,1574,796,778
False,8116049,"Nürtingen, Stadt",10 - 15 Jahre,2053,1043,1010
False,8116049,"Nürtingen, Stadt",15 - 18 Jahre,1289,655,634
False,8116049,"Nürtingen, Stadt",18 - 20 Jahre,892,468,424
False,8116049,"Nürtingen, Stadt",20 - 25 Jahre,2669,1353,1316
False,8116049,"Nürtingen, Stadt",25 - 30 Jahre,2388,1245,1143
False,8116049,"Nürtingen, Stadt",30 - 35 Jahre,2151,1041,1110
False,8116049,"Nürtingen, Stadt",35 - 40 Jahre,2493,1220,1273
False,8116049,"Nürtingen, Stadt",40 - 45 Jahre,3295,1679,1616
False,8116049,"Nürtingen, Stadt",45 - 50 Jahre,3399,1720,1679
False,8116049,"Nürtingen, Stadt",50 - 55 Jahre,2891,1418,1473
False,8116049,"Nürtingen, Stadt",55 - 60 Jahre,2523,1243,1280
False,8116049,"Nürtingen, Stadt",60 - 65 Jahre,2285,1131,1154
False,8116049,"Nürtingen, Stadt",65 - 75 Jahre,4544,2171,2373
False,8116049,"Nürtingen, Stadt",75 und mehr Jahre,3751,1496,2255
False,8116049,"Nürtingen, Stadt",Insgesamt,40364,19787,20577
False,8116050,Oberboihingen,unter 3 Jahre,135,67,68
False,8116050,Oberboihingen,3 -  6 Jahre,145,78,67
False,8116050,Oberboihingen,6 - 10 Jahre,221,112,109
False,8116050,Oberboihingen,10 - 15 Jahre,279,130,149
False,8116050,Oberboihingen,15 - 18 Jahre,163,81,82
False,8116050,Oberboihingen,18 - 20 Jahre,117,56,61
False,8116050,Oberboihingen,20 - 25 Jahre,298,142,156
False,8116050,Oberboihingen,25 - 30 Jahre,316,152,164
False,8116050,Oberboihingen,30 - 35 Jahre,330,171,159
False,8116050,Oberboihingen,35 - 40 Jahre,325,172,153
False,8116050,Oberboihingen,40 - 45 Jahre,461,237,224
False,8116050,Oberboihingen,45 - 50 Jahre,441,219,222
False,8116050,Oberboihingen,50 - 55 Jahre,459,249,210
False,8116050,Oberboihingen,55 - 60 Jahre,350,174,176
False,8116050,Oberboihingen,60 - 65 Jahre,317,143,174
False,8116050,Oberboihingen,65 - 75 Jahre,619,325,294
False,8116050,Oberboihingen,75 und mehr Jahre,411,174,237
False,8116050,Oberboihingen,Insgesamt,5387,2682,2705
False,8116053,Ohmden,unter 3 Jahre,41,22,19
False,8116053,Ohmden,3 -  6 Jahre,56,29,27
False,8116053,Ohmden,6 - 10 Jahre,60,35,25
False,8116053,Ohmden,10 - 15 Jahre,110,68,42
False,8116053,Ohmden,15 - 18 Jahre,47,19,28
False,8116053,Ohmden,18 - 20 Jahre,38,19,19
False,8116053,Ohmden,20 - 25 Jahre,84,43,41
False,8116053,Ohmden,25 - 30 Jahre,95,40,55
False,8116053,Ohmden,30 - 35 Jahre,71,34,37
False,8116053,Ohmden,35 - 40 Jahre,115,52,63
False,8116053,Ohmden,40 - 45 Jahre,179,95,84
False,8116053,Ohmden,45 - 50 Jahre,172,101,71
False,8116053,Ohmden,50 - 55 Jahre,110,58,52
False,8116053,Ohmden,55 - 60 Jahre,120,63,57
False,8116053,Ohmden,60 - 65 Jahre,87,48,39
False,8116053,Ohmden,65 - 75 Jahre,202,96,106
False,8116053,Ohmden,75 und mehr Jahre,135,63,72
False,8116053,Ohmden,Insgesamt,1722,885,837
False,8116054,"Owen, Stadt",unter 3 Jahre,92,50,42
False,8116054,"Owen, Stadt",3 -  6 Jahre,77,41,36
False,8116054,"Owen, Stadt",6 - 10 Jahre,137,68,69
False,8116054,"Owen, Stadt",10 - 15 Jahre,209,103,106
False,8116054,"Owen, Stadt",15 - 18 Jahre,147,84,63
False,8116054,"Owen, Stadt",18 - 20 Jahre,101,57,44
False,8116054,"Owen, Stadt",20 - 25 Jahre,204,121,83
False,8116054,"Owen, Stadt",25 - 30 Jahre,174,90,84
False,8116054,"Owen, Stadt",30 - 35 Jahre,183,82,101
False,8116054,"Owen, Stadt",35 - 40 Jahre,210,103,107
False,8116054,"Owen, Stadt",40 - 45 Jahre,285,141,144
False,8116054,"Owen, Stadt",45 - 50 Jahre,331,171,160
False,8116054,"Owen, Stadt",50 - 55 Jahre,261,127,134
False,8116054,"Owen, Stadt",55 - 60 Jahre,216,104,112
False,8116054,"Owen, Stadt",60 - 65 Jahre,198,108,90
False,8116054,"Owen, Stadt",65 - 75 Jahre,333,173,160
False,8116054,"Owen, Stadt",75 und mehr Jahre,291,119,172
False,8116054,"Owen, Stadt",Insgesamt,3449,1742,1707
False,8116056,"Plochingen, Stadt",unter 3 Jahre,377,191,186
False,8116056,"Plochingen, Stadt",3 -  6 Jahre,367,194,173
False,8116056,"Plochingen, Stadt",6 - 10 Jahre,504,260,244
False,8116056,"Plochingen, Stadt",10 - 15 Jahre,760,392,368
False,8116056,"Plochingen, Stadt",15 - 18 Jahre,446,226,220
False,8116056,"Plochingen, Stadt",18 - 20 Jahre,337,165,172
False,8116056,"Plochingen, Stadt",20 - 25 Jahre,798,417,381
False,8116056,"Plochingen, Stadt",25 - 30 Jahre,814,399,415
False,8116056,"Plochingen, Stadt",30 - 35 Jahre,889,450,439
False,8116056,"Plochingen, Stadt",35 - 40 Jahre,882,459,423
False,8116056,"Plochingen, Stadt",40 - 45 Jahre,1191,591,600
False,8116056,"Plochingen, Stadt",45 - 50 Jahre,1221,632,589
False,8116056,"Plochingen, Stadt",50 - 55 Jahre,1007,514,493
False,8116056,"Plochingen, Stadt",55 - 60 Jahre,870,451,419
False,8116056,"Plochingen, Stadt",60 - 65 Jahre,773,385,388
False,8116056,"Plochingen, Stadt",65 - 75 Jahre,1619,765,854
False,8116056,"Plochingen, Stadt",75 und mehr Jahre,1190,465,725
False,8116056,"Plochingen, Stadt",Insgesamt,14045,6956,7089
False,8116058,Reichenbach an der Fils,unter 3 Jahre,201,108,93
False,8116058,Reichenbach an der Fils,3 -  6 Jahre,219,111,108
False,8116058,Reichenbach an der Fils,6 - 10 Jahre,304,161,143
False,8116058,Reichenbach an der Fils,10 - 15 Jahre,459,243,216
False,8116058,Reichenbach an der Fils,15 - 18 Jahre,284,150,134
False,8116058,Reichenbach an der Fils,18 - 20 Jahre,184,76,108
False,8116058,Reichenbach an der Fils,20 - 25 Jahre,421,226,195
False,8116058,Reichenbach an der Fils,25 - 30 Jahre,416,206,210
False,8116058,Reichenbach an der Fils,30 - 35 Jahre,455,216,239
False,8116058,Reichenbach an der Fils,35 - 40 Jahre,509,246,263
False,8116058,Reichenbach an der Fils,40 - 45 Jahre,596,293,303
False,8116058,Reichenbach an der Fils,45 - 50 Jahre,728,387,341
False,8116058,Reichenbach an der Fils,50 - 55 Jahre,598,315,283
False,8116058,Reichenbach an der Fils,55 - 60 Jahre,482,242,240
False,8116058,Reichenbach an der Fils,60 - 65 Jahre,409,199,210
False,8116058,Reichenbach an der Fils,65 - 75 Jahre,919,404,515
False,8116058,Reichenbach an der Fils,75 und mehr Jahre,752,313,439
False,8116058,Reichenbach an der Fils,Insgesamt,7936,3896,4040
False,8116063,Schlaitdorf,unter 3 Jahre,71,33,38
False,8116063,Schlaitdorf,3 -  6 Jahre,74,32,42
False,8116063,Schlaitdorf,6 - 10 Jahre,79,32,47
False,8116063,Schlaitdorf,10 - 15 Jahre,105,57,48
False,8116063,Schlaitdorf,15 - 18 Jahre,66,30,36
False,8116063,Schlaitdorf,18 - 20 Jahre,47,24,23
False,8116063,Schlaitdorf,20 - 25 Jahre,93,43,50
False,8116063,Schlaitdorf,25 - 30 Jahre,88,46,42
False,8116063,Schlaitdorf,30 - 35 Jahre,90,46,44
False,8116063,Schlaitdorf,35 - 40 Jahre,122,58,64
False,8116063,Schlaitdorf,40 - 45 Jahre,162,85,77
False,8116063,Schlaitdorf,45 - 50 Jahre,162,84,78
False,8116063,Schlaitdorf,50 - 55 Jahre,160,69,91
False,8116063,Schlaitdorf,55 - 60 Jahre,112,57,55
False,8116063,Schlaitdorf,60 - 65 Jahre,93,48,45
False,8116063,Schlaitdorf,65 - 75 Jahre,148,75,73
False,8116063,Schlaitdorf,75 und mehr Jahre,111,47,64
False,8116063,Schlaitdorf,Insgesamt,1783,866,917
False,8116068,Unterensingen,unter 3 Jahre,115,62,53
False,8116068,Unterensingen,3 -  6 Jahre,127,66,61
False,8116068,Unterensingen,6 - 10 Jahre,181,108,73
False,8116068,Unterensingen,10 - 15 Jahre,288,161,127
False,8116068,Unterensingen,15 - 18 Jahre,181,94,87
False,8116068,Unterensingen,18 - 20 Jahre,102,51,51
False,8116068,Unterensingen,20 - 25 Jahre,239,130,109
False,8116068,Unterensingen,25 - 30 Jahre,220,103,117
False,8116068,Unterensingen,30 - 35 Jahre,261,127,134
False,8116068,Unterensingen,35 - 40 Jahre,308,149,159
False,8116068,Unterensingen,40 - 45 Jahre,417,186,231
False,8116068,Unterensingen,45 - 50 Jahre,454,249,205
False,8116068,Unterensingen,50 - 55 Jahre,310,178,132
False,8116068,Unterensingen,55 - 60 Jahre,250,107,143
False,8116068,Unterensingen,60 - 65 Jahre,233,102,131
False,8116068,Unterensingen,65 - 75 Jahre,508,238,270
False,8116068,Unterensingen,75 und mehr Jahre,383,159,224
False,8116068,Unterensingen,Insgesamt,4577,2270,2307
False,8116070,"Weilheim an der Teck, Stadt",unter 3 Jahre,208,105,103
False,8116070,"Weilheim an der Teck, Stadt",3 -  6 Jahre,249,121,128
False,8116070,"Weilheim an der Teck, Stadt",6 - 10 Jahre,395,209,186
False,8116070,"Weilheim an der Teck, Stadt",10 - 15 Jahre,588,309,279
False,8116070,"Weilheim an der Teck, Stadt",15 - 18 Jahre,377,198,179
False,8116070,"Weilheim an der Teck, Stadt",18 - 20 Jahre,236,123,113
False,8116070,"Weilheim an der Teck, Stadt",20 - 25 Jahre,564,302,262
False,8116070,"Weilheim an der Teck, Stadt",25 - 30 Jahre,475,255,220
False,8116070,"Weilheim an der Teck, Stadt",30 - 35 Jahre,458,225,233
False,8116070,"Weilheim an der Teck, Stadt",35 - 40 Jahre,521,238,283
False,8116070,"Weilheim an der Teck, Stadt",40 - 45 Jahre,826,411,415
False,8116070,"Weilheim an der Teck, Stadt",45 - 50 Jahre,852,429,423
False,8116070,"Weilheim an der Teck, Stadt",50 - 55 Jahre,782,409,373
False,8116070,"Weilheim an der Teck, Stadt",55 - 60 Jahre,602,304,298
False,8116070,"Weilheim an der Teck, Stadt",60 - 65 Jahre,497,260,237
False,8116070,"Weilheim an der Teck, Stadt",65 - 75 Jahre,947,447,500
False,8116070,"Weilheim an der Teck, Stadt",75 und mehr Jahre,854,337,517
False,8116070,"Weilheim an der Teck, Stadt",Insgesamt,9431,4682,4749
False,8116071,"Wendlingen am Neckar, Stadt",unter 3 Jahre,450,228,222
False,8116071,"Wendlingen am Neckar, Stadt",3 -  6 Jahre,423,210,213
False,8116071,"Wendlingen am Neckar, Stadt",6 - 10 Jahre,560,266,294
False,8116071,"Wendlingen am Neckar, Stadt",10 - 15 Jahre,824,403,421
False,8116071,"Wendlingen am Neckar, Stadt",15 - 18 Jahre,537,264,273
False,8116071,"Wendlingen am Neckar, Stadt",18 - 20 Jahre,389,210,179
False,8116071,"Wendlingen am Neckar, Stadt",20 - 25 Jahre,922,460,462
False,8116071,"Wendlingen am Neckar, Stadt",25 - 30 Jahre,876,426,450
False,8116071,"Wendlingen am Neckar, Stadt",30 - 35 Jahre,1014,490,524
False,8116071,"Wendlingen am Neckar, Stadt",35 - 40 Jahre,998,507,491
False,8116071,"Wendlingen am Neckar, Stadt",40 - 45 Jahre,1296,636,660
False,8116071,"Wendlingen am Neckar, Stadt",45 - 50 Jahre,1419,763,656
False,8116071,"Wendlingen am Neckar, Stadt",50 - 55 Jahre,1245,608,637
False,8116071,"Wendlingen am Neckar, Stadt",55 - 60 Jahre,934,453,481
False,8116071,"Wendlingen am Neckar, Stadt",60 - 65 Jahre,897,407,490
False,8116071,"Wendlingen am Neckar, Stadt",65 - 75 Jahre,1840,884,956
False,8116071,"Wendlingen am Neckar, Stadt",75 und mehr Jahre,1354,541,813
False,8116071,"Wendlingen am Neckar, Stadt",Insgesamt,15978,7756,8222
False,8116072,"Wernau (Neckar), Stadt",unter 3 Jahre,295,151,144
False,8116072,"Wernau (Neckar), Stadt",3 -  6 Jahre,313,154,159
False,8116072,"Wernau (Neckar), Stadt",6 - 10 Jahre,442,232,210
False,8116072,"Wernau (Neckar), Stadt",10 - 15 Jahre,651,329,322
False,8116072,"Wernau (Neckar), Stadt",15 - 18 Jahre,363,199,164
False,8116072,"Wernau (Neckar), Stadt",18 - 20 Jahre,231,113,118
False,8116072,"Wernau (Neckar), Stadt",20 - 25 Jahre,662,351,311
False,8116072,"Wernau (Neckar), Stadt",25 - 30 Jahre,733,370,363
False,8116072,"Wernau (Neckar), Stadt",30 - 35 Jahre,747,371,376
False,8116072,"Wernau (Neckar), Stadt",35 - 40 Jahre,858,434,424
False,8116072,"Wernau (Neckar), Stadt",40 - 45 Jahre,1037,520,517
False,8116072,"Wernau (Neckar), Stadt",45 - 50 Jahre,1066,541,525
False,8116072,"Wernau (Neckar), Stadt",50 - 55 Jahre,838,470,368
False,8116072,"Wernau (Neckar), Stadt",55 - 60 Jahre,767,370,397
False,8116072,"Wernau (Neckar), Stadt",60 - 65 Jahre,676,350,326
False,8116072,"Wernau (Neckar), Stadt",65 - 75 Jahre,1417,652,765
False,8116072,"Wernau (Neckar), Stadt",75 und mehr Jahre,1287,522,765
False,8116072,"Wernau (Neckar), Stadt",Insgesamt,12383,6129,6254
False,8116073,Wolfschlugen,unter 3 Jahre,180,94,86
False,8116073,Wolfschlugen,3 -  6 Jahre,171,80,91
False,8116073,Wolfschlugen,6 - 10 Jahre,273,133,140
False,8116073,Wolfschlugen,10 - 15 Jahre,325,160,165
False,8116073,Wolfschlugen,15 - 18 Jahre,216,113,103
False,8116073,Wolfschlugen,18 - 20 Jahre,121,65,56
False,8116073,Wolfschlugen,20 - 25 Jahre,320,160,160
False,8116073,Wolfschlugen,25 - 30 Jahre,288,151,137
False,8116073,Wolfschlugen,30 - 35 Jahre,421,195,226
False,8116073,Wolfschlugen,35 - 40 Jahre,434,209,225
False,8116073,Wolfschlugen,40 - 45 Jahre,577,303,274
False,8116073,Wolfschlugen,45 - 50 Jahre,536,269,267
False,8116073,Wolfschlugen,50 - 55 Jahre,506,257,249
False,8116073,Wolfschlugen,55 - 60 Jahre,419,196,223
False,8116073,Wolfschlugen,60 - 65 Jahre,359,170,189
False,8116073,Wolfschlugen,65 - 75 Jahre,729,362,367
False,8116073,Wolfschlugen,75 und mehr Jahre,434,187,247
False,8116073,Wolfschlugen,Insgesamt,6309,3104,3205
False,8116076,Aichwald,unter 3 Jahre,145,64,81
False,8116076,Aichwald,3 -  6 Jahre,179,88,91
False,8116076,Aichwald,6 - 10 Jahre,296,151,145
False,8116076,Aichwald,10 - 15 Jahre,424,219,205
False,8116076,Aichwald,15 - 18 Jahre,244,121,123
False,8116076,Aichwald,18 - 20 Jahre,163,84,79
False,8116076,Aichwald,20 - 25 Jahre,344,194,150
False,8116076,Aichwald,25 - 30 Jahre,308,161,147
False,8116076,Aichwald,30 - 35 Jahre,345,148,197
False,8116076,Aichwald,35 - 40 Jahre,412,194,218
False,8116076,Aichwald,40 - 45 Jahre,620,305,315
False,8116076,Aichwald,45 - 50 Jahre,620,317,303
False,8116076,Aichwald,50 - 55 Jahre,566,266,300
False,8116076,Aichwald,55 - 60 Jahre,487,226,261
False,8116076,Aichwald,60 - 65 Jahre,512,235,277
False,8116076,Aichwald,65 - 75 Jahre,1170,582,588
False,8116076,Aichwald,75 und mehr Jahre,723,303,420
False,8116076,Aichwald,Insgesamt,7558,3658,3900
False,8116077,"Filderstadt, Stadt",unter 3 Jahre,1239,609,630
False,8116077,"Filderstadt, Stadt",3 -  6 Jahre,1236,649,587
False,8116077,"Filderstadt, Stadt",6 - 10 Jahre,1733,890,843
False,8116077,"Filderstadt, Stadt",10 - 15 Jahre,2357,1196,1161
False,8116077,"Filderstadt, Stadt",15 - 18 Jahre,1498,737,761
False,8116077,"Filderstadt, Stadt",18 - 20 Jahre,953,500,453
False,8116077,"Filderstadt, Stadt",20 - 25 Jahre,2620,1353,1267
False,8116077,"Filderstadt, Stadt",25 - 30 Jahre,2713,1305,1408
False,8116077,"Filderstadt, Stadt",30 - 35 Jahre,2958,1484,1474
False,8116077,"Filderstadt, Stadt",35 - 40 Jahre,2942,1461,1481
False,8116077,"Filderstadt, Stadt",40 - 45 Jahre,3928,1980,1948
False,8116077,"Filderstadt, Stadt",45 - 50 Jahre,3933,1989,1944
False,8116077,"Filderstadt, Stadt",50 - 55 Jahre,3369,1696,1673
False,8116077,"Filderstadt, Stadt",55 - 60 Jahre,2687,1303,1384
False,8116077,"Filderstadt, Stadt",60 - 65 Jahre,2512,1206,1306
False,8116077,"Filderstadt, Stadt",65 - 75 Jahre,4533,2173,2360
False,8116077,"Filderstadt, Stadt",75 und mehr Jahre,3137,1267,1870
False,8116077,"Filderstadt, Stadt",Insgesamt,44348,21798,22550
False,8116078,"Leinfelden-Echterdingen, Stadt",unter 3 Jahre,1044,533,511
False,8116078,"Leinfelden-Echterdingen, Stadt",3 -  6 Jahre,1038,534,504
False,8116078,"Leinfelden-Echterdingen, Stadt",6 - 10 Jahre,1419,723,696
False,8116078,"Leinfelden-Echterdingen, Stadt",10 - 15 Jahre,1702,867,835
False,8116078,"Leinfelden-Echterdingen, Stadt",15 - 18 Jahre,1001,519,482
False,8116078,"Leinfelden-Echterdingen, Stadt",18 - 20 Jahre,724,373,351
False,8116078,"Leinfelden-Echterdingen, Stadt",20 - 25 Jahre,1983,994,989
False,8116078,"Leinfelden-Echterdingen, Stadt",25 - 30 Jahre,2265,1125,1140
False,8116078,"Leinfelden-Echterdingen, Stadt",30 - 35 Jahre,2460,1223,1237
False,8116078,"Leinfelden-Echterdingen, Stadt",35 - 40 Jahre,2530,1281,1249
False,8116078,"Leinfelden-Echterdingen, Stadt",40 - 45 Jahre,3097,1538,1559
False,8116078,"Leinfelden-Echterdingen, Stadt",45 - 50 Jahre,3295,1707,1588
False,8116078,"Leinfelden-Echterdingen, Stadt",50 - 55 Jahre,2587,1283,1304
False,8116078,"Leinfelden-Echterdingen, Stadt",55 - 60 Jahre,2201,1069,1132
False,8116078,"Leinfelden-Echterdingen, Stadt",60 - 65 Jahre,2038,945,1093
False,8116078,"Leinfelden-Echterdingen, Stadt",65 - 75 Jahre,4433,2051,2382
False,8116078,"Leinfelden-Echterdingen, Stadt",75 und mehr Jahre,3405,1359,2046
False,8116078,"Leinfelden-Echterdingen, Stadt",Insgesamt,37222,18124,19098
False,8116079,Lenningen,unter 3 Jahre,183,85,98
False,8116079,Lenningen,3 -  6 Jahre,202,104,98
False,8116079,Lenningen,6 - 10 Jahre,306,165,141
False,8116079,Lenningen,10 - 15 Jahre,462,247,215
False,8116079,Lenningen,15 - 18 Jahre,276,136,140
False,8116079,Lenningen,18 - 20 Jahre,225,135,90
False,8116079,Lenningen,20 - 25 Jahre,510,282,228
False,8116079,Lenningen,25 - 30 Jahre,389,199,190
False,8116079,Lenningen,30 - 35 Jahre,386,208,178
False,8116079,Lenningen,35 - 40 Jahre,410,207,203
False,8116079,Lenningen,40 - 45 Jahre,657,337,320
False,8116079,Lenningen,45 - 50 Jahre,790,405,385
False,8116079,Lenningen,50 - 55 Jahre,662,346,316
False,8116079,Lenningen,55 - 60 Jahre,516,254,262
False,8116079,Lenningen,60 - 65 Jahre,482,241,241
False,8116079,Lenningen,65 - 75 Jahre,959,491,468
False,8116079,Lenningen,75 und mehr Jahre,762,296,466
False,8116079,Lenningen,Insgesamt,8177,4138,4039
False,8116080,"Ostfildern, Stadt",unter 3 Jahre,1102,556,546
False,8116080,"Ostfildern, Stadt",3 -  6 Jahre,1079,573,506
False,8116080,"Ostfildern, Stadt",6 - 10 Jahre,1484,780,704
False,8116080,"Ostfildern, Stadt",10 - 15 Jahre,1945,1013,932
False,8116080,"Ostfildern, Stadt",15 - 18 Jahre,1143,561,582
False,8116080,"Ostfildern, Stadt",18 - 20 Jahre,714,360,354
False,8116080,"Ostfildern, Stadt",20 - 25 Jahre,2020,994,1026
False,8116080,"Ostfildern, Stadt",25 - 30 Jahre,2148,1086,1062
False,8116080,"Ostfildern, Stadt",30 - 35 Jahre,2331,1107,1224
False,8116080,"Ostfildern, Stadt",35 - 40 Jahre,2644,1350,1294
False,8116080,"Ostfildern, Stadt",40 - 45 Jahre,3070,1543,1527
False,8116080,"Ostfildern, Stadt",45 - 50 Jahre,3082,1534,1548
False,8116080,"Ostfildern, Stadt",50 - 55 Jahre,2539,1245,1294
False,8116080,"Ostfildern, Stadt",55 - 60 Jahre,2155,1024,1131
False,8116080,"Ostfildern, Stadt",60 - 65 Jahre,1959,924,1035
False,8116080,"Ostfildern, Stadt",65 - 75 Jahre,3879,1855,2024
False,8116080,"Ostfildern, Stadt",75 und mehr Jahre,2869,1177,1692
False,8116080,"Ostfildern, Stadt",Insgesamt,36163,17682,18481
False,8116081,"Aichtal, Stadt",unter 3 Jahre,261,141,120
False,8116081,"Aichtal, Stadt",3 -  6 Jahre,271,135,136
False,8116081,"Aichtal, Stadt",6 - 10 Jahre,391,195,196
False,8116081,"Aichtal, Stadt",10 - 15 Jahre,493,253,240
False,8116081,"Aichtal, Stadt",15 - 18 Jahre,358,188,170
False,8116081,"Aichtal, Stadt",18 - 20 Jahre,231,115,116
False,8116081,"Aichtal, Stadt",20 - 25 Jahre,525,273,252
False,8116081,"Aichtal, Stadt",25 - 30 Jahre,466,238,228
False,8116081,"Aichtal, Stadt",30 - 35 Jahre,517,277,240
False,8116081,"Aichtal, Stadt",35 - 40 Jahre,594,290,304
False,8116081,"Aichtal, Stadt",40 - 45 Jahre,862,426,436
False,8116081,"Aichtal, Stadt",45 - 50 Jahre,878,428,450
False,8116081,"Aichtal, Stadt",50 - 55 Jahre,840,429,411
False,8116081,"Aichtal, Stadt",55 - 60 Jahre,705,349,356
False,8116081,"Aichtal, Stadt",60 - 65 Jahre,608,313,295
False,8116081,"Aichtal, Stadt",65 - 75 Jahre,966,480,486
False,8116081,"Aichtal, Stadt",75 und mehr Jahre,676,280,396
False,8116081,"Aichtal, Stadt",Insgesamt,9642,4810,4832
False,8117,Landkreis Göppingen,unter 3 Jahre,6094,3083,3011
False,8117,Landkreis Göppingen,3 -  6 Jahre,6441,3284,3157
False,8117,Landkreis Göppingen,6 - 10 Jahre,9475,4866,4609
False,8117,Landkreis Göppingen,10 - 15 Jahre,13812,7161,6651
False,8117,Landkreis Göppingen,15 - 18 Jahre,8742,4484,4258
False,8117,Landkreis Göppingen,18 - 20 Jahre,6164,3253,2911
False,8117,Landkreis Göppingen,20 - 25 Jahre,14600,7584,7016
False,8117,Landkreis Göppingen,25 - 30 Jahre,13845,7121,6724
False,8117,Landkreis Göppingen,30 - 35 Jahre,13789,6882,6907
False,8117,Landkreis Göppingen,35 - 40 Jahre,15511,7730,7781
False,8117,Landkreis Göppingen,40 - 45 Jahre,20681,10528,10153
False,8117,Landkreis Göppingen,45 - 50 Jahre,21406,11094,10312
False,8117,Landkreis Göppingen,50 - 55 Jahre,18856,9528,9328
False,8117,Landkreis Göppingen,55 - 60 Jahre,16257,8009,8248
False,8117,Landkreis Göppingen,60 - 65 Jahre,14382,7075,7307
False,8117,Landkreis Göppingen,65 - 75 Jahre,28623,13555,15068
False,8117,Landkreis Göppingen,75 und mehr Jahre,23870,9335,14535
False,8117,Landkreis Göppingen,Insgesamt,252548,124572,127976
False,8117001,Adelberg,unter 3 Jahre,50,24,26
False,8117001,Adelberg,3 -  6 Jahre,58,28,30
False,8117001,Adelberg,6 - 10 Jahre,82,36,46
False,8117001,Adelberg,10 - 15 Jahre,107,56,51
False,8117001,Adelberg,15 - 18 Jahre,66,32,34
False,8117001,Adelberg,18 - 20 Jahre,46,24,22
False,8117001,Adelberg,20 - 25 Jahre,93,53,40
False,8117001,Adelberg,25 - 30 Jahre,95,55,40
False,8117001,Adelberg,30 - 35 Jahre,99,45,54
False,8117001,Adelberg,35 - 40 Jahre,121,56,65
False,8117001,Adelberg,40 - 45 Jahre,192,103,89
False,8117001,Adelberg,45 - 50 Jahre,192,102,90
False,8117001,Adelberg,50 - 55 Jahre,138,70,68
False,8117001,Adelberg,55 - 60 Jahre,150,69,81
False,8117001,Adelberg,60 - 65 Jahre,126,68,58
False,8117001,Adelberg,65 - 75 Jahre,220,111,109
False,8117001,Adelberg,75 und mehr Jahre,171,73,98
False,8117001,Adelberg,Insgesamt,2006,1005,1001
False,8117002,Aichelberg,unter 3 Jahre,30,14,16
False,8117002,Aichelberg,3 -  6 Jahre,45,19,26
False,8117002,Aichelberg,6 - 10 Jahre,54,26,28
False,8117002,Aichelberg,10 - 15 Jahre,80,44,36
False,8117002,Aichelberg,15 - 18 Jahre,39,22,17
False,8117002,Aichelberg,18 - 20 Jahre,28,15,13
False,8117002,Aichelberg,20 - 25 Jahre,55,34,21
False,8117002,Aichelberg,25 - 30 Jahre,56,30,26
False,8117002,Aichelberg,30 - 35 Jahre,80,36,44
False,8117002,Aichelberg,35 - 40 Jahre,81,33,48
False,8117002,Aichelberg,40 - 45 Jahre,130,72,58
False,8117002,Aichelberg,45 - 50 Jahre,132,70,62
False,8117002,Aichelberg,50 - 55 Jahre,101,49,52
False,8117002,Aichelberg,55 - 60 Jahre,84,42,42
False,8117002,Aichelberg,60 - 65 Jahre,85,50,35
False,8117002,Aichelberg,65 - 75 Jahre,124,60,64
False,8117002,Aichelberg,75 und mehr Jahre,90,40,50
False,8117002,Aichelberg,Insgesamt,1294,656,638
False,8117003,Albershausen,unter 3 Jahre,118,55,63
False,8117003,Albershausen,3 -  6 Jahre,127,67,60
False,8117003,Albershausen,6 - 10 Jahre,177,96,81
False,8117003,Albershausen,10 - 15 Jahre,252,138,114
False,8117003,Albershausen,15 - 18 Jahre,173,90,83
False,8117003,Albershausen,18 - 20 Jahre,105,64,41
False,8117003,Albershausen,20 - 25 Jahre,194,102,92
False,8117003,Albershausen,25 - 30 Jahre,193,96,97
False,8117003,Albershausen,30 - 35 Jahre,226,105,121
False,8117003,Albershausen,35 - 40 Jahre,293,145,148
False,8117003,Albershausen,40 - 45 Jahre,420,206,214
False,8117003,Albershausen,45 - 50 Jahre,408,214,194
False,8117003,Albershausen,50 - 55 Jahre,288,135,153
False,8117003,Albershausen,55 - 60 Jahre,267,130,137
False,8117003,Albershausen,60 - 65 Jahre,235,125,110
False,8117003,Albershausen,65 - 75 Jahre,460,219,241
False,8117003,Albershausen,75 und mehr Jahre,373,166,207
False,8117003,Albershausen,Insgesamt,4309,2153,2156
False,8117006,Bad Ditzenbach,unter 3 Jahre,89,41,48
False,8117006,Bad Ditzenbach,3 -  6 Jahre,88,42,46
False,8117006,Bad Ditzenbach,6 - 10 Jahre,114,66,48
False,8117006,Bad Ditzenbach,10 - 15 Jahre,194,93,101
False,8117006,Bad Ditzenbach,15 - 18 Jahre,135,67,68
False,8117006,Bad Ditzenbach,18 - 20 Jahre,114,60,54
False,8117006,Bad Ditzenbach,20 - 25 Jahre,206,107,99
False,8117006,Bad Ditzenbach,25 - 30 Jahre,206,103,103
False,8117006,Bad Ditzenbach,30 - 35 Jahre,184,86,98
False,8117006,Bad Ditzenbach,35 - 40 Jahre,207,99,108
False,8117006,Bad Ditzenbach,40 - 45 Jahre,316,158,158
False,8117006,Bad Ditzenbach,45 - 50 Jahre,345,174,171
False,8117006,Bad Ditzenbach,50 - 55 Jahre,294,155,139
False,8117006,Bad Ditzenbach,55 - 60 Jahre,232,122,110
False,8117006,Bad Ditzenbach,60 - 65 Jahre,198,95,103
False,8117006,Bad Ditzenbach,65 - 75 Jahre,407,201,206
False,8117006,Bad Ditzenbach,75 und mehr Jahre,345,138,207
False,8117006,Bad Ditzenbach,Insgesamt,3674,1807,1867
False,8117007,Bad Überkingen,unter 3 Jahre,77,43,34
False,8117007,Bad Überkingen,3 -  6 Jahre,87,47,40
False,8117007,Bad Überkingen,6 - 10 Jahre,122,68,54
False,8117007,Bad Überkingen,10 - 15 Jahre,220,112,108
False,8117007,Bad Überkingen,15 - 18 Jahre,133,67,66
False,8117007,Bad Überkingen,18 - 20 Jahre,83,48,35
False,8117007,Bad Überkingen,20 - 25 Jahre,210,104,106
False,8117007,Bad Überkingen,25 - 30 Jahre,186,88,98
False,8117007,Bad Überkingen,30 - 35 Jahre,183,91,92
False,8117007,Bad Überkingen,35 - 40 Jahre,217,104,113
False,8117007,Bad Überkingen,40 - 45 Jahre,303,131,172
False,8117007,Bad Überkingen,45 - 50 Jahre,309,160,149
False,8117007,Bad Überkingen,50 - 55 Jahre,256,128,128
False,8117007,Bad Überkingen,55 - 60 Jahre,233,98,135
False,8117007,Bad Überkingen,60 - 65 Jahre,212,115,97
False,8117007,Bad Überkingen,65 - 75 Jahre,527,232,295
False,8117007,Bad Überkingen,75 und mehr Jahre,466,186,280
False,8117007,Bad Überkingen,Insgesamt,3824,1822,2002
False,8117009,Birenbach,unter 3 Jahre,34,15,19
False,8117009,Birenbach,3 -  6 Jahre,36,18,18
False,8117009,Birenbach,6 - 10 Jahre,80,39,41
False,8117009,Birenbach,10 - 15 Jahre,102,48,54
False,8117009,Birenbach,15 - 18 Jahre,63,30,33
False,8117009,Birenbach,18 - 20 Jahre,56,22,34
False,8117009,Birenbach,20 - 25 Jahre,109,50,59
False,8117009,Birenbach,25 - 30 Jahre,99,64,35
False,8117009,Birenbach,30 - 35 Jahre,95,44,51
False,8117009,Birenbach,35 - 40 Jahre,84,43,41
False,8117009,Birenbach,40 - 45 Jahre,159,71,88
False,8117009,Birenbach,45 - 50 Jahre,156,92,64
False,8117009,Birenbach,50 - 55 Jahre,165,90,75
False,8117009,Birenbach,55 - 60 Jahre,136,65,71
False,8117009,Birenbach,60 - 65 Jahre,111,49,62
False,8117009,Birenbach,65 - 75 Jahre,221,109,112
False,8117009,Birenbach,75 und mehr Jahre,158,70,88
False,8117009,Birenbach,Insgesamt,1864,919,945
False,8117010,Böhmenkirch,unter 3 Jahre,129,63,66
False,8117010,Böhmenkirch,3 -  6 Jahre,152,87,65
False,8117010,Böhmenkirch,6 - 10 Jahre,215,114,101
False,8117010,Böhmenkirch,10 - 15 Jahre,344,169,175
False,8117010,Böhmenkirch,15 - 18 Jahre,214,110,104
False,8117010,Böhmenkirch,18 - 20 Jahre,140,83,57
False,8117010,Böhmenkirch,20 - 25 Jahre,338,187,151
False,8117010,Böhmenkirch,25 - 30 Jahre,289,165,124
False,8117010,Böhmenkirch,30 - 35 Jahre,303,151,152
False,8117010,Böhmenkirch,35 - 40 Jahre,343,193,150
False,8117010,Böhmenkirch,40 - 45 Jahre,519,256,263
False,8117010,Böhmenkirch,45 - 50 Jahre,557,297,260
False,8117010,Böhmenkirch,50 - 55 Jahre,395,210,185
False,8117010,Böhmenkirch,55 - 60 Jahre,336,184,152
False,8117010,Böhmenkirch,60 - 65 Jahre,287,134,153
False,8117010,Böhmenkirch,65 - 75 Jahre,548,267,281
False,8117010,Böhmenkirch,75 und mehr Jahre,406,169,237
False,8117010,Böhmenkirch,Insgesamt,5515,2839,2676
False,8117011,Börtlingen,unter 3 Jahre,45,22,23
False,8117011,Börtlingen,3 -  6 Jahre,34,17,17
False,8117011,Börtlingen,6 - 10 Jahre,66,30,36
False,8117011,Börtlingen,10 - 15 Jahre,113,63,50
False,8117011,Börtlingen,15 - 18 Jahre,54,24,30
False,8117011,Börtlingen,18 - 20 Jahre,45,24,21
False,8117011,Börtlingen,20 - 25 Jahre,75,46,29
False,8117011,Börtlingen,25 - 30 Jahre,80,40,40
False,8117011,Börtlingen,30 - 35 Jahre,87,40,47
False,8117011,Börtlingen,35 - 40 Jahre,93,43,50
False,8117011,Börtlingen,40 - 45 Jahre,156,72,84
False,8117011,Börtlingen,45 - 50 Jahre,138,82,56
False,8117011,Börtlingen,50 - 55 Jahre,140,68,72
False,8117011,Börtlingen,55 - 60 Jahre,129,71,58
False,8117011,Börtlingen,60 - 65 Jahre,110,53,57
False,8117011,Börtlingen,65 - 75 Jahre,226,112,114
False,8117011,Börtlingen,75 und mehr Jahre,163,66,97
False,8117011,Börtlingen,Insgesamt,1754,873,881
False,8117012,Bad Boll,unter 3 Jahre,125,67,58
False,8117012,Bad Boll,3 -  6 Jahre,135,80,55
False,8117012,Bad Boll,6 - 10 Jahre,219,107,112
False,8117012,Bad Boll,10 - 15 Jahre,266,138,128
False,8117012,Bad Boll,15 - 18 Jahre,183,101,82
False,8117012,Bad Boll,18 - 20 Jahre,125,67,58
False,8117012,Bad Boll,20 - 25 Jahre,293,157,136
False,8117012,Bad Boll,25 - 30 Jahre,230,108,122
False,8117012,Bad Boll,30 - 35 Jahre,251,131,120
False,8117012,Bad Boll,35 - 40 Jahre,355,174,181
False,8117012,Bad Boll,40 - 45 Jahre,453,210,243
False,8117012,Bad Boll,45 - 50 Jahre,431,192,239
False,8117012,Bad Boll,50 - 55 Jahre,389,189,200
False,8117012,Bad Boll,55 - 60 Jahre,319,153,166
False,8117012,Bad Boll,60 - 65 Jahre,306,142,164
False,8117012,Bad Boll,65 - 75 Jahre,531,224,307
False,8117012,Bad Boll,75 und mehr Jahre,594,222,372
False,8117012,Bad Boll,Insgesamt,5205,2462,2743
False,8117014,Deggingen,unter 3 Jahre,116,58,58
False,8117014,Deggingen,3 -  6 Jahre,124,62,62
False,8117014,Deggingen,6 - 10 Jahre,223,119,104
False,8117014,Deggingen,10 - 15 Jahre,291,142,149
False,8117014,Deggingen,15 - 18 Jahre,164,89,75
False,8117014,Deggingen,18 - 20 Jahre,115,66,49
False,8117014,Deggingen,20 - 25 Jahre,312,150,162
False,8117014,Deggingen,25 - 30 Jahre,268,147,121
False,8117014,Deggingen,30 - 35 Jahre,240,118,122
False,8117014,Deggingen,35 - 40 Jahre,345,174,171
False,8117014,Deggingen,40 - 45 Jahre,453,226,227
False,8117014,Deggingen,45 - 50 Jahre,499,266,233
False,8117014,Deggingen,50 - 55 Jahre,383,200,183
False,8117014,Deggingen,55 - 60 Jahre,370,172,198
False,8117014,Deggingen,60 - 65 Jahre,317,160,157
False,8117014,Deggingen,65 - 75 Jahre,668,317,351
False,8117014,Deggingen,75 und mehr Jahre,568,230,338
False,8117014,Deggingen,Insgesamt,5456,2696,2760
False,8117015,"Donzdorf, Stadt",unter 3 Jahre,250,113,137
False,8117015,"Donzdorf, Stadt",3 -  6 Jahre,268,147,121
False,8117015,"Donzdorf, Stadt",6 - 10 Jahre,406,217,189
False,8117015,"Donzdorf, Stadt",10 - 15 Jahre,618,334,284
False,8117015,"Donzdorf, Stadt",15 - 18 Jahre,402,192,210
False,8117015,"Donzdorf, Stadt",18 - 20 Jahre,240,131,109
False,8117015,"Donzdorf, Stadt",20 - 25 Jahre,587,317,270
False,8117015,"Donzdorf, Stadt",25 - 30 Jahre,534,282,252
False,8117015,"Donzdorf, Stadt",30 - 35 Jahre,579,286,293
False,8117015,"Donzdorf, Stadt",35 - 40 Jahre,620,304,316
False,8117015,"Donzdorf, Stadt",40 - 45 Jahre,895,447,448
False,8117015,"Donzdorf, Stadt",45 - 50 Jahre,895,468,427
False,8117015,"Donzdorf, Stadt",50 - 55 Jahre,792,399,393
False,8117015,"Donzdorf, Stadt",55 - 60 Jahre,696,327,369
False,8117015,"Donzdorf, Stadt",60 - 65 Jahre,694,343,351
False,8117015,"Donzdorf, Stadt",65 - 75 Jahre,1319,649,670
False,8117015,"Donzdorf, Stadt",75 und mehr Jahre,1021,422,599
False,8117015,"Donzdorf, Stadt",Insgesamt,10816,5378,5438
False,8117016,Drackenstein,unter 3 Jahre,11,5,6
False,8117016,Drackenstein,3 -  6 Jahre,13,2,11
False,8117016,Drackenstein,6 - 10 Jahre,13,6,7
False,8117016,Drackenstein,10 - 15 Jahre,28,11,17
False,8117016,Drackenstein,15 - 18 Jahre,12,6,6
False,8117016,Drackenstein,18 - 20 Jahre,14,6,8
False,8117016,Drackenstein,20 - 25 Jahre,27,18,9
False,8117016,Drackenstein,25 - 30 Jahre,31,19,12
False,8117016,Drackenstein,30 - 35 Jahre,33,15,18
False,8117016,Drackenstein,35 - 40 Jahre,31,18,13
False,8117016,Drackenstein,40 - 45 Jahre,27,11,16
False,8117016,Drackenstein,45 - 50 Jahre,44,24,20
False,8117016,Drackenstein,50 - 55 Jahre,36,20,16
False,8117016,Drackenstein,55 - 60 Jahre,31,18,13
False,8117016,Drackenstein,60 - 65 Jahre,28,17,11
False,8117016,Drackenstein,65 - 75 Jahre,31,18,13
False,8117016,Drackenstein,75 und mehr Jahre,27,8,19
False,8117016,Drackenstein,Insgesamt,437,222,215
False,8117017,Dürnau,unter 3 Jahre,60,29,31
False,8117017,Dürnau,3 -  6 Jahre,59,30,29
False,8117017,Dürnau,6 - 10 Jahre,96,48,48
False,8117017,Dürnau,10 - 15 Jahre,127,53,74
False,8117017,Dürnau,15 - 18 Jahre,100,54,46
False,8117017,Dürnau,18 - 20 Jahre,56,30,26
False,8117017,Dürnau,20 - 25 Jahre,96,53,43
False,8117017,Dürnau,25 - 30 Jahre,107,53,54
False,8117017,Dürnau,30 - 35 Jahre,108,59,49
False,8117017,Dürnau,35 - 40 Jahre,115,51,64
False,8117017,Dürnau,40 - 45 Jahre,202,106,96
False,8117017,Dürnau,45 - 50 Jahre,200,106,94
False,8117017,Dürnau,50 - 55 Jahre,164,85,79
False,8117017,Dürnau,55 - 60 Jahre,130,66,64
False,8117017,Dürnau,60 - 65 Jahre,128,66,62
False,8117017,Dürnau,65 - 75 Jahre,196,89,107
False,8117017,Dürnau,75 und mehr Jahre,139,57,82
False,8117017,Dürnau,Insgesamt,2083,1035,1048
False,8117018,"Ebersbach an der Fils, Stadt",unter 3 Jahre,351,180,171
False,8117018,"Ebersbach an der Fils, Stadt",3 -  6 Jahre,356,171,185
False,8117018,"Ebersbach an der Fils, Stadt",6 - 10 Jahre,526,265,261
False,8117018,"Ebersbach an der Fils, Stadt",10 - 15 Jahre,810,431,379
False,8117018,"Ebersbach an der Fils, Stadt",15 - 18 Jahre,564,298,266
False,8117018,"Ebersbach an der Fils, Stadt",18 - 20 Jahre,378,205,173
False,8117018,"Ebersbach an der Fils, Stadt",20 - 25 Jahre,862,426,436
False,8117018,"Ebersbach an der Fils, Stadt",25 - 30 Jahre,872,446,426
False,8117018,"Ebersbach an der Fils, Stadt",30 - 35 Jahre,789,368,421
False,8117018,"Ebersbach an der Fils, Stadt",35 - 40 Jahre,928,443,485
False,8117018,"Ebersbach an der Fils, Stadt",40 - 45 Jahre,1227,622,605
False,8117018,"Ebersbach an der Fils, Stadt",45 - 50 Jahre,1382,730,652
False,8117018,"Ebersbach an der Fils, Stadt",50 - 55 Jahre,1201,622,579
False,8117018,"Ebersbach an der Fils, Stadt",55 - 60 Jahre,938,461,477
False,8117018,"Ebersbach an der Fils, Stadt",60 - 65 Jahre,846,446,400
False,8117018,"Ebersbach an der Fils, Stadt",65 - 75 Jahre,1832,849,983
False,8117018,"Ebersbach an der Fils, Stadt",75 und mehr Jahre,1429,605,824
False,8117018,"Ebersbach an der Fils, Stadt",Insgesamt,15291,7568,7723
False,8117019,"Eislingen/Fils, Stadt",unter 3 Jahre,505,259,246
False,8117019,"Eislingen/Fils, Stadt",3 -  6 Jahre,509,255,254
False,8117019,"Eislingen/Fils, Stadt",6 - 10 Jahre,912,463,449
False,8117019,"Eislingen/Fils, Stadt",10 - 15 Jahre,1079,528,551
False,8117019,"Eislingen/Fils, Stadt",15 - 18 Jahre,643,320,323
False,8117019,"Eislingen/Fils, Stadt",18 - 20 Jahre,477,256,221
False,8117019,"Eislingen/Fils, Stadt",20 - 25 Jahre,1222,636,586
False,8117019,"Eislingen/Fils, Stadt",25 - 30 Jahre,1238,630,608
False,8117019,"Eislingen/Fils, Stadt",30 - 35 Jahre,1334,687,647
False,8117019,"Eislingen/Fils, Stadt",35 - 40 Jahre,1331,666,665
False,8117019,"Eislingen/Fils, Stadt",40 - 45 Jahre,1602,821,781
False,8117019,"Eislingen/Fils, Stadt",45 - 50 Jahre,1586,828,758
False,8117019,"Eislingen/Fils, Stadt",50 - 55 Jahre,1472,733,739
False,8117019,"Eislingen/Fils, Stadt",55 - 60 Jahre,1333,635,698
False,8117019,"Eislingen/Fils, Stadt",60 - 65 Jahre,1157,570,587
False,8117019,"Eislingen/Fils, Stadt",65 - 75 Jahre,2147,1044,1103
False,8117019,"Eislingen/Fils, Stadt",75 und mehr Jahre,1817,669,1148
False,8117019,"Eislingen/Fils, Stadt",Insgesamt,20364,10000,10364
False,8117020,Eschenbach,unter 3 Jahre,47,19,28
False,8117020,Eschenbach,3 -  6 Jahre,53,26,27
False,8117020,Eschenbach,6 - 10 Jahre,80,38,42
False,8117020,Eschenbach,10 - 15 Jahre,109,66,43
False,8117020,Eschenbach,15 - 18 Jahre,72,46,26
False,8117020,Eschenbach,18 - 20 Jahre,46,27,19
False,8117020,Eschenbach,20 - 25 Jahre,106,52,54
False,8117020,Eschenbach,25 - 30 Jahre,135,64,71
False,8117020,Eschenbach,30 - 35 Jahre,116,62,54
False,8117020,Eschenbach,35 - 40 Jahre,144,72,72
False,8117020,Eschenbach,40 - 45 Jahre,177,89,88
False,8117020,Eschenbach,45 - 50 Jahre,196,105,91
False,8117020,Eschenbach,50 - 55 Jahre,175,87,88
False,8117020,Eschenbach,55 - 60 Jahre,178,81,97
False,8117020,Eschenbach,60 - 65 Jahre,143,70,73
False,8117020,Eschenbach,65 - 75 Jahre,237,118,119
False,8117020,Eschenbach,75 und mehr Jahre,167,69,98
False,8117020,Eschenbach,Insgesamt,2181,1091,1090
False,8117023,Gammelshausen,unter 3 Jahre,43,21,22
False,8117023,Gammelshausen,3 -  6 Jahre,37,23,14
False,8117023,Gammelshausen,6 - 10 Jahre,45,26,19
False,8117023,Gammelshausen,10 - 15 Jahre,74,47,27
False,8117023,Gammelshausen,15 - 18 Jahre,51,30,21
False,8117023,Gammelshausen,18 - 20 Jahre,39,22,17
False,8117023,Gammelshausen,20 - 25 Jahre,87,55,32
False,8117023,Gammelshausen,25 - 30 Jahre,68,34,34
False,8117023,Gammelshausen,30 - 35 Jahre,76,35,41
False,8117023,Gammelshausen,35 - 40 Jahre,95,44,51
False,8117023,Gammelshausen,40 - 45 Jahre,127,70,57
False,8117023,Gammelshausen,45 - 50 Jahre,123,61,62
False,8117023,Gammelshausen,50 - 55 Jahre,108,63,45
False,8117023,Gammelshausen,55 - 60 Jahre,94,43,51
False,8117023,Gammelshausen,60 - 65 Jahre,97,54,43
False,8117023,Gammelshausen,65 - 75 Jahre,170,73,97
False,8117023,Gammelshausen,75 und mehr Jahre,130,64,66
False,8117023,Gammelshausen,Insgesamt,1464,765,699
False,8117024,"Geislingen an der Steige, Stadt",unter 3 Jahre,687,352,335
False,8117024,"Geislingen an der Steige, Stadt",3 -  6 Jahre,672,350,322
False,8117024,"Geislingen an der Steige, Stadt",6 - 10 Jahre,1015,504,511
False,8117024,"Geislingen an der Steige, Stadt",10 - 15 Jahre,1502,800,702
False,8117024,"Geislingen an der Steige, Stadt",15 - 18 Jahre,948,480,468
False,8117024,"Geislingen an der Steige, Stadt",18 - 20 Jahre,723,369,354
False,8117024,"Geislingen an der Steige, Stadt",20 - 25 Jahre,1779,882,897
False,8117024,"Geislingen an der Steige, Stadt",25 - 30 Jahre,1597,829,768
False,8117024,"Geislingen an der Steige, Stadt",30 - 35 Jahre,1505,765,740
False,8117024,"Geislingen an der Steige, Stadt",35 - 40 Jahre,1548,746,802
False,8117024,"Geislingen an der Steige, Stadt",40 - 45 Jahre,2016,1037,979
False,8117024,"Geislingen an der Steige, Stadt",45 - 50 Jahre,2204,1131,1073
False,8117024,"Geislingen an der Steige, Stadt",50 - 55 Jahre,1942,993,949
False,8117024,"Geislingen an der Steige, Stadt",55 - 60 Jahre,1638,816,822
False,8117024,"Geislingen an der Steige, Stadt",60 - 65 Jahre,1477,728,749
False,8117024,"Geislingen an der Steige, Stadt",65 - 75 Jahre,2853,1320,1533
False,8117024,"Geislingen an der Steige, Stadt",75 und mehr Jahre,2735,1033,1702
False,8117024,"Geislingen an der Steige, Stadt",Insgesamt,26841,13135,13706
False,8117025,Gingen an der Fils,unter 3 Jahre,106,53,53
False,8117025,Gingen an der Fils,3 -  6 Jahre,121,52,69
False,8117025,Gingen an der Fils,6 - 10 Jahre,192,85,107
False,8117025,Gingen an der Fils,10 - 15 Jahre,228,109,119
False,8117025,Gingen an der Fils,15 - 18 Jahre,133,65,68
False,8117025,Gingen an der Fils,18 - 20 Jahre,94,42,52
False,8117025,Gingen an der Fils,20 - 25 Jahre,250,138,112
False,8117025,Gingen an der Fils,25 - 30 Jahre,183,96,87
False,8117025,Gingen an der Fils,30 - 35 Jahre,225,114,111
False,8117025,Gingen an der Fils,35 - 40 Jahre,293,151,142
False,8117025,Gingen an der Fils,40 - 45 Jahre,356,186,170
False,8117025,Gingen an der Fils,45 - 50 Jahre,375,204,171
False,8117025,Gingen an der Fils,50 - 55 Jahre,298,161,137
False,8117025,Gingen an der Fils,55 - 60 Jahre,242,117,125
False,8117025,Gingen an der Fils,60 - 65 Jahre,238,105,133
False,8117025,Gingen an der Fils,65 - 75 Jahre,539,261,278
False,8117025,Gingen an der Fils,75 und mehr Jahre,416,166,250
False,8117025,Gingen an der Fils,Insgesamt,4289,2105,2184
False,8117026,"Göppingen, Stadt",unter 3 Jahre,1384,707,677
False,8117026,"Göppingen, Stadt",3 -  6 Jahre,1463,741,722
False,8117026,"Göppingen, Stadt",6 - 10 Jahre,1947,1046,901
False,8117026,"Göppingen, Stadt",10 - 15 Jahre,2862,1482,1380
False,8117026,"Göppingen, Stadt",15 - 18 Jahre,1820,912,908
False,8117026,"Göppingen, Stadt",18 - 20 Jahre,1362,717,645
False,8117026,"Göppingen, Stadt",20 - 25 Jahre,3433,1722,1711
False,8117026,"Göppingen, Stadt",25 - 30 Jahre,3450,1746,1704
False,8117026,"Göppingen, Stadt",30 - 35 Jahre,3284,1689,1595
False,8117026,"Göppingen, Stadt",35 - 40 Jahre,3579,1854,1725
False,8117026,"Göppingen, Stadt",40 - 45 Jahre,4592,2369,2223
False,8117026,"Göppingen, Stadt",45 - 50 Jahre,4583,2368,2215
False,8117026,"Göppingen, Stadt",50 - 55 Jahre,4140,2031,2109
False,8117026,"Göppingen, Stadt",55 - 60 Jahre,3687,1841,1846
False,8117026,"Göppingen, Stadt",60 - 65 Jahre,3192,1517,1675
False,8117026,"Göppingen, Stadt",65 - 75 Jahre,6449,3008,3441
False,8117026,"Göppingen, Stadt",75 und mehr Jahre,5592,2093,3499
False,8117026,"Göppingen, Stadt",Insgesamt,56819,27843,28976
False,8117028,Gruibingen,unter 3 Jahre,41,23,18
False,8117028,Gruibingen,3 -  6 Jahre,57,26,31
False,8117028,Gruibingen,6 - 10 Jahre,69,30,39
False,8117028,Gruibingen,10 - 15 Jahre,131,66,65
False,8117028,Gruibingen,15 - 18 Jahre,64,42,22
False,8117028,Gruibingen,18 - 20 Jahre,45,25,20
False,8117028,Gruibingen,20 - 25 Jahre,145,92,53
False,8117028,Gruibingen,25 - 30 Jahre,109,67,42
False,8117028,Gruibingen,30 - 35 Jahre,104,60,44
False,8117028,Gruibingen,35 - 40 Jahre,108,52,56
False,8117028,Gruibingen,40 - 45 Jahre,181,91,90
False,8117028,Gruibingen,45 - 50 Jahre,174,95,79
False,8117028,Gruibingen,50 - 55 Jahre,185,92,93
False,8117028,Gruibingen,55 - 60 Jahre,172,81,91
False,8117028,Gruibingen,60 - 65 Jahre,134,69,65
False,8117028,Gruibingen,65 - 75 Jahre,181,101,80
False,8117028,Gruibingen,75 und mehr Jahre,167,69,98
False,8117028,Gruibingen,Insgesamt,2067,1081,986
False,8117029,Hattenhofen,unter 3 Jahre,79,46,33
False,8117029,Hattenhofen,3 -  6 Jahre,66,33,33
False,8117029,Hattenhofen,6 - 10 Jahre,114,56,58
False,8117029,Hattenhofen,10 - 15 Jahre,147,61,86
False,8117029,Hattenhofen,15 - 18 Jahre,104,48,56
False,8117029,Hattenhofen,18 - 20 Jahre,69,33,36
False,8117029,Hattenhofen,20 - 25 Jahre,143,78,65
False,8117029,Hattenhofen,25 - 30 Jahre,139,69,70
False,8117029,Hattenhofen,30 - 35 Jahre,148,75,73
False,8117029,Hattenhofen,35 - 40 Jahre,194,98,96
False,8117029,Hattenhofen,40 - 45 Jahre,236,120,116
False,8117029,Hattenhofen,45 - 50 Jahre,240,122,118
False,8117029,Hattenhofen,50 - 55 Jahre,230,108,122
False,8117029,Hattenhofen,55 - 60 Jahre,211,104,107
False,8117029,Hattenhofen,60 - 65 Jahre,196,93,103
False,8117029,Hattenhofen,65 - 75 Jahre,359,187,172
False,8117029,Hattenhofen,75 und mehr Jahre,258,99,159
False,8117029,Hattenhofen,Insgesamt,2933,1430,1503
False,8117030,Heiningen,unter 3 Jahre,98,50,48
False,8117030,Heiningen,3 -  6 Jahre,118,58,60
False,8117030,Heiningen,6 - 10 Jahre,185,91,94
False,8117030,Heiningen,10 - 15 Jahre,285,142,143
False,8117030,Heiningen,15 - 18 Jahre,173,92,81
False,8117030,Heiningen,18 - 20 Jahre,117,56,61
False,8117030,Heiningen,20 - 25 Jahre,297,160,137
False,8117030,Heiningen,25 - 30 Jahre,259,143,116
False,8117030,Heiningen,30 - 35 Jahre,290,129,161
False,8117030,Heiningen,35 - 40 Jahre,314,164,150
False,8117030,Heiningen,40 - 45 Jahre,423,224,199
False,8117030,Heiningen,45 - 50 Jahre,440,234,206
False,8117030,Heiningen,50 - 55 Jahre,437,211,226
False,8117030,Heiningen,55 - 60 Jahre,369,188,181
False,8117030,Heiningen,60 - 65 Jahre,332,171,161
False,8117030,Heiningen,65 - 75 Jahre,656,313,343
False,8117030,Heiningen,75 und mehr Jahre,492,208,284
False,8117030,Heiningen,Insgesamt,5285,2634,2651
False,8117031,Hohenstadt,unter 3 Jahre,22,14,8
False,8117031,Hohenstadt,3 -  6 Jahre,23,10,13
False,8117031,Hohenstadt,6 - 10 Jahre,41,22,19
False,8117031,Hohenstadt,10 - 15 Jahre,45,25,20
False,8117031,Hohenstadt,15 - 18 Jahre,37,17,20
False,8117031,Hohenstadt,18 - 20 Jahre,15,7,8
False,8117031,Hohenstadt,20 - 25 Jahre,37,16,21
False,8117031,Hohenstadt,25 - 30 Jahre,26,10,16
False,8117031,Hohenstadt,30 - 35 Jahre,41,18,23
False,8117031,Hohenstadt,35 - 40 Jahre,47,27,20
False,8117031,Hohenstadt,40 - 45 Jahre,59,34,25
False,8117031,Hohenstadt,45 - 50 Jahre,54,32,22
False,8117031,Hohenstadt,50 - 55 Jahre,62,26,36
False,8117031,Hohenstadt,55 - 60 Jahre,56,25,31
False,8117031,Hohenstadt,60 - 65 Jahre,50,30,20
False,8117031,Hohenstadt,65 - 75 Jahre,57,22,35
False,8117031,Hohenstadt,75 und mehr Jahre,50,21,29
False,8117031,Hohenstadt,Insgesamt,722,356,366
False,8117033,Kuchen,unter 3 Jahre,114,60,54
False,8117033,Kuchen,3 -  6 Jahre,144,70,74
False,8117033,Kuchen,6 - 10 Jahre,196,96,100
False,8117033,Kuchen,10 - 15 Jahre,319,167,152
False,8117033,Kuchen,15 - 18 Jahre,190,104,86
False,8117033,Kuchen,18 - 20 Jahre,117,66,51
False,8117033,Kuchen,20 - 25 Jahre,302,170,132
False,8117033,Kuchen,25 - 30 Jahre,293,150,143
False,8117033,Kuchen,30 - 35 Jahre,274,139,135
False,8117033,Kuchen,35 - 40 Jahre,300,163,137
False,8117033,Kuchen,40 - 45 Jahre,458,248,210
False,8117033,Kuchen,45 - 50 Jahre,457,217,240
False,8117033,Kuchen,50 - 55 Jahre,375,192,183
False,8117033,Kuchen,55 - 60 Jahre,366,175,191
False,8117033,Kuchen,60 - 65 Jahre,367,185,182
False,8117033,Kuchen,65 - 75 Jahre,750,345,405
False,8117033,Kuchen,75 und mehr Jahre,490,212,278
False,8117033,Kuchen,Insgesamt,5512,2759,2753
False,8117035,Mühlhausen im Täle,unter 3 Jahre,22,13,9
False,8117035,Mühlhausen im Täle,3 -  6 Jahre,23,13,10
False,8117035,Mühlhausen im Täle,6 - 10 Jahre,39,19,20
False,8117035,Mühlhausen im Täle,10 - 15 Jahre,45,20,25
False,8117035,Mühlhausen im Täle,15 - 18 Jahre,44,24,20
False,8117035,Mühlhausen im Täle,18 - 20 Jahre,29,14,15
False,8117035,Mühlhausen im Täle,20 - 25 Jahre,67,34,33
False,8117035,Mühlhausen im Täle,25 - 30 Jahre,60,32,28
False,8117035,Mühlhausen im Täle,30 - 35 Jahre,47,25,22
False,8117035,Mühlhausen im Täle,35 - 40 Jahre,48,23,25
False,8117035,Mühlhausen im Täle,40 - 45 Jahre,70,36,34
False,8117035,Mühlhausen im Täle,45 - 50 Jahre,99,52,47
False,8117035,Mühlhausen im Täle,50 - 55 Jahre,92,54,38
False,8117035,Mühlhausen im Täle,55 - 60 Jahre,81,34,47
False,8117035,Mühlhausen im Täle,60 - 65 Jahre,56,40,16
False,8117035,Mühlhausen im Täle,65 - 75 Jahre,74,34,40
False,8117035,Mühlhausen im Täle,75 und mehr Jahre,82,29,53
False,8117035,Mühlhausen im Täle,Insgesamt,978,496,482
False,8117037,Ottenbach,unter 3 Jahre,42,17,25
False,8117037,Ottenbach,3 -  6 Jahre,83,52,31
False,8117037,Ottenbach,6 - 10 Jahre,101,49,52
False,8117037,Ottenbach,10 - 15 Jahre,147,81,66
False,8117037,Ottenbach,15 - 18 Jahre,92,41,51
False,8117037,Ottenbach,18 - 20 Jahre,63,31,32
False,8117037,Ottenbach,20 - 25 Jahre,116,55,61
False,8117037,Ottenbach,25 - 30 Jahre,112,56,56
False,8117037,Ottenbach,30 - 35 Jahre,129,54,75
False,8117037,Ottenbach,35 - 40 Jahre,148,75,73
False,8117037,Ottenbach,40 - 45 Jahre,229,108,121
False,8117037,Ottenbach,45 - 50 Jahre,231,115,116
False,8117037,Ottenbach,50 - 55 Jahre,181,97,84
False,8117037,Ottenbach,55 - 60 Jahre,177,89,88
False,8117037,Ottenbach,60 - 65 Jahre,131,65,66
False,8117037,Ottenbach,65 - 75 Jahre,268,133,135
False,8117037,Ottenbach,75 und mehr Jahre,193,73,120
False,8117037,Ottenbach,Insgesamt,2443,1191,1252
False,8117038,Rechberghausen,unter 3 Jahre,129,53,76
False,8117038,Rechberghausen,3 -  6 Jahre,115,63,52
False,8117038,Rechberghausen,6 - 10 Jahre,183,88,95
False,8117038,Rechberghausen,10 - 15 Jahre,284,140,144
False,8117038,Rechberghausen,15 - 18 Jahre,182,99,83
False,8117038,Rechberghausen,18 - 20 Jahre,125,71,54
False,8117038,Rechberghausen,20 - 25 Jahre,269,143,126
False,8117038,Rechberghausen,25 - 30 Jahre,233,119,114
False,8117038,Rechberghausen,30 - 35 Jahre,279,125,154
False,8117038,Rechberghausen,35 - 40 Jahre,374,172,202
False,8117038,Rechberghausen,40 - 45 Jahre,455,241,214
False,8117038,Rechberghausen,45 - 50 Jahre,431,211,220
False,8117038,Rechberghausen,50 - 55 Jahre,408,195,213
False,8117038,Rechberghausen,55 - 60 Jahre,331,147,184
False,8117038,Rechberghausen,60 - 65 Jahre,321,159,162
False,8117038,Rechberghausen,65 - 75 Jahre,682,321,361
False,8117038,Rechberghausen,75 und mehr Jahre,565,234,331
False,8117038,Rechberghausen,Insgesamt,5366,2581,2785
False,8117042,Salach,unter 3 Jahre,192,100,92
False,8117042,Salach,3 -  6 Jahre,186,94,92
False,8117042,Salach,6 - 10 Jahre,283,148,135
False,8117042,Salach,10 - 15 Jahre,424,216,208
False,8117042,Salach,15 - 18 Jahre,257,131,126
False,8117042,Salach,18 - 20 Jahre,192,105,87
False,8117042,Salach,20 - 25 Jahre,458,251,207
False,8117042,Salach,25 - 30 Jahre,453,230,223
False,8117042,Salach,30 - 35 Jahre,453,220,233
False,8117042,Salach,35 - 40 Jahre,498,252,246
False,8117042,Salach,40 - 45 Jahre,637,318,319
False,8117042,Salach,45 - 50 Jahre,651,339,312
False,8117042,Salach,50 - 55 Jahre,549,272,277
False,8117042,Salach,55 - 60 Jahre,532,273,259
False,8117042,Salach,60 - 65 Jahre,425,206,219
False,8117042,Salach,65 - 75 Jahre,863,408,455
False,8117042,Salach,75 und mehr Jahre,695,242,453
False,8117042,Salach,Insgesamt,7748,3805,3943
False,8117043,Schlat,unter 3 Jahre,36,19,17
False,8117043,Schlat,3 -  6 Jahre,51,21,30
False,8117043,Schlat,6 - 10 Jahre,75,31,44
False,8117043,Schlat,10 - 15 Jahre,99,57,42
False,8117043,Schlat,15 - 18 Jahre,63,32,31
False,8117043,Schlat,18 - 20 Jahre,40,26,14
False,8117043,Schlat,20 - 25 Jahre,79,38,41
False,8117043,Schlat,25 - 30 Jahre,85,43,42
False,8117043,Schlat,30 - 35 Jahre,83,36,47
False,8117043,Schlat,35 - 40 Jahre,101,50,51
False,8117043,Schlat,40 - 45 Jahre,143,75,68
False,8117043,Schlat,45 - 50 Jahre,139,76,63
False,8117043,Schlat,50 - 55 Jahre,151,75,76
False,8117043,Schlat,55 - 60 Jahre,125,71,54
False,8117043,Schlat,60 - 65 Jahre,89,36,53
False,8117043,Schlat,65 - 75 Jahre,211,116,95
False,8117043,Schlat,75 und mehr Jahre,157,58,99
False,8117043,Schlat,Insgesamt,1727,860,867
False,8117044,Schlierbach,unter 3 Jahre,98,56,42
False,8117044,Schlierbach,3 -  6 Jahre,92,49,43
False,8117044,Schlierbach,6 - 10 Jahre,172,102,70
False,8117044,Schlierbach,10 - 15 Jahre,234,124,110
False,8117044,Schlierbach,15 - 18 Jahre,165,87,78
False,8117044,Schlierbach,18 - 20 Jahre,90,44,46
False,8117044,Schlierbach,20 - 25 Jahre,176,77,99
False,8117044,Schlierbach,25 - 30 Jahre,150,82,68
False,8117044,Schlierbach,30 - 35 Jahre,187,80,107
False,8117044,Schlierbach,35 - 40 Jahre,241,121,120
False,8117044,Schlierbach,40 - 45 Jahre,318,156,162
False,8117044,Schlierbach,45 - 50 Jahre,373,186,187
False,8117044,Schlierbach,50 - 55 Jahre,257,137,120
False,8117044,Schlierbach,55 - 60 Jahre,224,118,106
False,8117044,Schlierbach,60 - 65 Jahre,221,102,119
False,8117044,Schlierbach,65 - 75 Jahre,441,218,223
False,8117044,Schlierbach,75 und mehr Jahre,365,148,217
False,8117044,Schlierbach,Insgesamt,3804,1887,1917
False,8117049,"Süßen, Stadt",unter 3 Jahre,240,125,115
False,8117049,"Süßen, Stadt",3 -  6 Jahre,232,121,111
False,8117049,"Süßen, Stadt",6 - 10 Jahre,338,175,163
False,8117049,"Süßen, Stadt",10 - 15 Jahre,531,281,250
False,8117049,"Süßen, Stadt",15 - 18 Jahre,340,175,165
False,8117049,"Süßen, Stadt",18 - 20 Jahre,248,126,122
False,8117049,"Süßen, Stadt",20 - 25 Jahre,593,312,281
False,8117049,"Süßen, Stadt",25 - 30 Jahre,563,288,275
False,8117049,"Süßen, Stadt",30 - 35 Jahre,553,306,247
False,8117049,"Süßen, Stadt",35 - 40 Jahre,602,289,313
False,8117049,"Süßen, Stadt",40 - 45 Jahre,791,423,368
False,8117049,"Süßen, Stadt",45 - 50 Jahre,872,450,422
False,8117049,"Süßen, Stadt",50 - 55 Jahre,784,419,365
False,8117049,"Süßen, Stadt",55 - 60 Jahre,653,327,326
False,8117049,"Süßen, Stadt",60 - 65 Jahre,560,272,288
False,8117049,"Süßen, Stadt",65 - 75 Jahre,1077,511,566
False,8117049,"Süßen, Stadt",75 und mehr Jahre,957,372,585
False,8117049,"Süßen, Stadt",Insgesamt,9934,4972,4962
False,8117051,"Uhingen, Stadt",unter 3 Jahre,362,188,174
False,8117051,"Uhingen, Stadt",3 -  6 Jahre,385,191,194
False,8117051,"Uhingen, Stadt",6 - 10 Jahre,553,286,267
False,8117051,"Uhingen, Stadt",10 - 15 Jahre,863,479,384
False,8117051,"Uhingen, Stadt",15 - 18 Jahre,520,264,256
False,8117051,"Uhingen, Stadt",18 - 20 Jahre,351,195,156
False,8117051,"Uhingen, Stadt",20 - 25 Jahre,759,406,353
False,8117051,"Uhingen, Stadt",25 - 30 Jahre,700,365,335
False,8117051,"Uhingen, Stadt",30 - 35 Jahre,693,335,358
False,8117051,"Uhingen, Stadt",35 - 40 Jahre,794,406,388
False,8117051,"Uhingen, Stadt",40 - 45 Jahre,1076,537,539
False,8117051,"Uhingen, Stadt",45 - 50 Jahre,1104,568,536
False,8117051,"Uhingen, Stadt",50 - 55 Jahre,1044,539,505
False,8117051,"Uhingen, Stadt",55 - 60 Jahre,791,381,410
False,8117051,"Uhingen, Stadt",60 - 65 Jahre,706,333,373
False,8117051,"Uhingen, Stadt",65 - 75 Jahre,1543,725,818
False,8117051,"Uhingen, Stadt",75 und mehr Jahre,1311,512,799
False,8117051,"Uhingen, Stadt",Insgesamt,13555,6710,6845
False,8117053,Wäschenbeuren,unter 3 Jahre,107,53,54
False,8117053,Wäschenbeuren,3 -  6 Jahre,126,65,61
False,8117053,Wäschenbeuren,6 - 10 Jahre,168,90,78
False,8117053,Wäschenbeuren,10 - 15 Jahre,268,142,126
False,8117053,Wäschenbeuren,15 - 18 Jahre,149,71,78
False,8117053,Wäschenbeuren,18 - 20 Jahre,90,41,49
False,8117053,Wäschenbeuren,20 - 25 Jahre,232,129,103
False,8117053,Wäschenbeuren,25 - 30 Jahre,183,90,93
False,8117053,Wäschenbeuren,30 - 35 Jahre,200,97,103
False,8117053,Wäschenbeuren,35 - 40 Jahre,253,114,139
False,8117053,Wäschenbeuren,40 - 45 Jahre,370,182,188
False,8117053,Wäschenbeuren,45 - 50 Jahre,398,205,193
False,8117053,Wäschenbeuren,50 - 55 Jahre,333,173,160
False,8117053,Wäschenbeuren,55 - 60 Jahre,208,106,102
False,8117053,Wäschenbeuren,60 - 65 Jahre,176,87,89
False,8117053,Wäschenbeuren,65 - 75 Jahre,434,205,229
False,8117053,Wäschenbeuren,75 und mehr Jahre,281,121,160
False,8117053,Wäschenbeuren,Insgesamt,3976,1971,2005
False,8117055,Wangen,unter 3 Jahre,70,32,38
False,8117055,Wangen,3 -  6 Jahre,82,42,40
False,8117055,Wangen,6 - 10 Jahre,108,55,53
False,8117055,Wangen,10 - 15 Jahre,158,72,86
False,8117055,Wangen,15 - 18 Jahre,107,48,59
False,8117055,Wangen,18 - 20 Jahre,71,31,40
False,8117055,Wangen,20 - 25 Jahre,166,88,78
False,8117055,Wangen,25 - 30 Jahre,148,68,80
False,8117055,Wangen,30 - 35 Jahre,138,77,61
False,8117055,Wangen,35 - 40 Jahre,200,92,108
False,8117055,Wangen,40 - 45 Jahre,255,136,119
False,8117055,Wangen,45 - 50 Jahre,297,153,144
False,8117055,Wangen,50 - 55 Jahre,253,118,135
False,8117055,Wangen,55 - 60 Jahre,220,109,111
False,8117055,Wangen,60 - 65 Jahre,172,90,82
False,8117055,Wangen,65 - 75 Jahre,427,203,224
False,8117055,Wangen,75 und mehr Jahre,293,125,168
False,8117055,Wangen,Insgesamt,3165,1539,1626
False,8117058,"Wiesensteig, Stadt",unter 3 Jahre,37,19,18
False,8117058,"Wiesensteig, Stadt",3 -  6 Jahre,55,21,34
False,8117058,"Wiesensteig, Stadt",6 - 10 Jahre,62,33,29
False,8117058,"Wiesensteig, Stadt",10 - 15 Jahre,101,54,47
False,8117058,"Wiesensteig, Stadt",15 - 18 Jahre,88,55,33
False,8117058,"Wiesensteig, Stadt",18 - 20 Jahre,68,38,30
False,8117058,"Wiesensteig, Stadt",20 - 25 Jahre,152,86,66
False,8117058,"Wiesensteig, Stadt",25 - 30 Jahre,110,61,49
False,8117058,"Wiesensteig, Stadt",30 - 35 Jahre,93,43,50
False,8117058,"Wiesensteig, Stadt",35 - 40 Jahre,117,46,71
False,8117058,"Wiesensteig, Stadt",40 - 45 Jahre,169,96,73
False,8117058,"Wiesensteig, Stadt",45 - 50 Jahre,178,96,82
False,8117058,"Wiesensteig, Stadt",50 - 55 Jahre,169,93,76
False,8117058,"Wiesensteig, Stadt",55 - 60 Jahre,133,72,61
False,8117058,"Wiesensteig, Stadt",60 - 65 Jahre,109,53,56
False,8117058,"Wiesensteig, Stadt",65 - 75 Jahre,248,110,138
False,8117058,"Wiesensteig, Stadt",75 und mehr Jahre,249,95,154
False,8117058,"Wiesensteig, Stadt",Insgesamt,2138,1071,1067
False,8117060,Zell unter Aichelberg,unter 3 Jahre,84,45,39
False,8117060,Zell unter Aichelberg,3 -  6 Jahre,105,56,49
False,8117060,Zell unter Aichelberg,6 - 10 Jahre,108,55,53
False,8117060,Zell unter Aichelberg,10 - 15 Jahre,171,95,76
False,8117060,Zell unter Aichelberg,15 - 18 Jahre,103,66,37
False,8117060,Zell unter Aichelberg,18 - 20 Jahre,67,29,38
False,8117060,Zell unter Aichelberg,20 - 25 Jahre,137,77,60
False,8117060,Zell unter Aichelberg,25 - 30 Jahre,154,84,70
False,8117060,Zell unter Aichelberg,30 - 35 Jahre,167,80,87
False,8117060,Zell unter Aichelberg,35 - 40 Jahre,192,95,97
False,8117060,Zell unter Aichelberg,40 - 45 Jahre,286,141,145
False,8117060,Zell unter Aichelberg,45 - 50 Jahre,253,135,118
False,8117060,Zell unter Aichelberg,50 - 55 Jahre,254,127,127
False,8117060,Zell unter Aichelberg,55 - 60 Jahre,199,101,98
False,8117060,Zell unter Aichelberg,60 - 65 Jahre,194,99,95
False,8117060,Zell unter Aichelberg,65 - 75 Jahre,329,162,167
False,8117060,Zell unter Aichelberg,75 und mehr Jahre,225,81,144
False,8117060,Zell unter Aichelberg,Insgesamt,3028,1528,1500
False,8117061,"Lauterstein, Stadt",unter 3 Jahre,64,30,34
False,8117061,"Lauterstein, Stadt",3 -  6 Jahre,61,35,26
False,8117061,"Lauterstein, Stadt",6 - 10 Jahre,96,41,55
False,8117061,"Lauterstein, Stadt",10 - 15 Jahre,154,75,79
False,8117061,"Lauterstein, Stadt",15 - 18 Jahre,95,53,42
False,8117061,"Lauterstein, Stadt",18 - 20 Jahre,81,37,44
False,8117061,"Lauterstein, Stadt",20 - 25 Jahre,138,83,55
False,8117061,"Lauterstein, Stadt",25 - 30 Jahre,151,69,82
False,8117061,"Lauterstein, Stadt",30 - 35 Jahre,113,56,57
False,8117061,"Lauterstein, Stadt",35 - 40 Jahre,157,78,79
False,8117061,"Lauterstein, Stadt",40 - 45 Jahre,203,99,104
False,8117061,"Lauterstein, Stadt",45 - 50 Jahre,260,134,126
False,8117061,"Lauterstein, Stadt",50 - 55 Jahre,215,112,103
False,8117061,"Lauterstein, Stadt",55 - 60 Jahre,186,97,89
False,8117061,"Lauterstein, Stadt",60 - 65 Jahre,156,78,78
False,8117061,"Lauterstein, Stadt",65 - 75 Jahre,318,160,158
False,8117061,"Lauterstein, Stadt",75 und mehr Jahre,233,90,143
False,8117061,"Lauterstein, Stadt",Insgesamt,2681,1327,1354
False,8118,Landkreis Ludwigsburg,unter 3 Jahre,14178,7274,6904
False,8118,Landkreis Ludwigsburg,3 -  6 Jahre,14418,7351,7067
False,8118,Landkreis Ludwigsburg,6 - 10 Jahre,20333,10483,9850
False,8118,Landkreis Ludwigsburg,10 - 15 Jahre,27745,14326,13419
False,8118,Landkreis Ludwigsburg,15 - 18 Jahre,16815,8653,8162
False,8118,Landkreis Ludwigsburg,18 - 20 Jahre,11856,6089,5767
False,8118,Landkreis Ludwigsburg,20 - 25 Jahre,28856,14546,14310
False,8118,Landkreis Ludwigsburg,25 - 30 Jahre,29503,14435,15068
False,8118,Landkreis Ludwigsburg,30 - 35 Jahre,32558,16355,16203
False,8118,Landkreis Ludwigsburg,35 - 40 Jahre,34237,17191,17046
False,8118,Landkreis Ludwigsburg,40 - 45 Jahre,44496,22816,21680
False,8118,Landkreis Ludwigsburg,45 - 50 Jahre,44461,22833,21628
False,8118,Landkreis Ludwigsburg,50 - 55 Jahre,38120,19260,18860
False,8118,Landkreis Ludwigsburg,55 - 60 Jahre,31808,15493,16315
False,8118,Landkreis Ludwigsburg,60 - 65 Jahre,28192,13838,14354
False,8118,Landkreis Ludwigsburg,65 - 75 Jahre,56906,27113,29793
False,8118,Landkreis Ludwigsburg,75 und mehr Jahre,43503,17215,26288
False,8118,Landkreis Ludwigsburg,Insgesamt,517985,255271,262714
False,8118001,Affalterbach,unter 3 Jahre,111,50,61
False,8118001,Affalterbach,3 -  6 Jahre,125,67,58
False,8118001,Affalterbach,6 - 10 Jahre,160,83,77
False,8118001,Affalterbach,10 - 15 Jahre,256,126,130
False,8118001,Affalterbach,15 - 18 Jahre,168,106,62
False,8118001,Affalterbach,18 - 20 Jahre,108,52,56
False,8118001,Affalterbach,20 - 25 Jahre,251,151,100
False,8118001,Affalterbach,25 - 30 Jahre,179,88,91
False,8118001,Affalterbach,30 - 35 Jahre,256,135,121
False,8118001,Affalterbach,35 - 40 Jahre,269,141,128
False,8118001,Affalterbach,40 - 45 Jahre,402,193,209
False,8118001,Affalterbach,45 - 50 Jahre,388,192,196
False,8118001,Affalterbach,50 - 55 Jahre,326,149,177
False,8118001,Affalterbach,55 - 60 Jahre,307,141,166
False,8118001,Affalterbach,60 - 65 Jahre,311,162,149
False,8118001,Affalterbach,65 - 75 Jahre,540,268,272
False,8118001,Affalterbach,75 und mehr Jahre,401,167,234
False,8118001,Affalterbach,Insgesamt,4558,2271,2287
False,8118003,"Asperg, Stadt",unter 3 Jahre,357,178,179
False,8118003,"Asperg, Stadt",3 -  6 Jahre,388,207,181
False,8118003,"Asperg, Stadt",6 - 10 Jahre,549,300,249
False,8118003,"Asperg, Stadt",10 - 15 Jahre,686,340,346
False,8118003,"Asperg, Stadt",15 - 18 Jahre,372,209,163
False,8118003,"Asperg, Stadt",18 - 20 Jahre,272,134,138
False,8118003,"Asperg, Stadt",20 - 25 Jahre,716,361,355
False,8118003,"Asperg, Stadt",25 - 30 Jahre,764,369,395
False,8118003,"Asperg, Stadt",30 - 35 Jahre,814,400,414
False,8118003,"Asperg, Stadt",35 - 40 Jahre,850,448,402
False,8118003,"Asperg, Stadt",40 - 45 Jahre,1088,548,540
False,8118003,"Asperg, Stadt",45 - 50 Jahre,1101,569,532
False,8118003,"Asperg, Stadt",50 - 55 Jahre,1000,494,506
False,8118003,"Asperg, Stadt",55 - 60 Jahre,813,427,386
False,8118003,"Asperg, Stadt",60 - 65 Jahre,697,357,340
False,8118003,"Asperg, Stadt",65 - 75 Jahre,1478,685,793
False,8118003,"Asperg, Stadt",75 und mehr Jahre,1181,470,711
False,8118003,"Asperg, Stadt",Insgesamt,13126,6496,6630
False,8118006,Benningen am Neckar,unter 3 Jahre,175,99,76
False,8118006,Benningen am Neckar,3 -  6 Jahre,156,81,75
False,8118006,Benningen am Neckar,6 - 10 Jahre,237,116,121
False,8118006,Benningen am Neckar,10 - 15 Jahre,311,161,150
False,8118006,Benningen am Neckar,15 - 18 Jahre,183,98,85
False,8118006,Benningen am Neckar,18 - 20 Jahre,143,69,74
False,8118006,Benningen am Neckar,20 - 25 Jahre,363,181,182
False,8118006,Benningen am Neckar,25 - 30 Jahre,291,150,141
False,8118006,Benningen am Neckar,30 - 35 Jahre,349,168,181
False,8118006,Benningen am Neckar,35 - 40 Jahre,364,198,166
False,8118006,Benningen am Neckar,40 - 45 Jahre,484,246,238
False,8118006,Benningen am Neckar,45 - 50 Jahre,491,246,245
False,8118006,Benningen am Neckar,50 - 55 Jahre,473,228,245
False,8118006,Benningen am Neckar,55 - 60 Jahre,430,208,222
False,8118006,Benningen am Neckar,60 - 65 Jahre,349,176,173
False,8118006,Benningen am Neckar,65 - 75 Jahre,586,285,301
False,8118006,Benningen am Neckar,75 und mehr Jahre,408,163,245
False,8118006,Benningen am Neckar,Insgesamt,5793,2873,2920
False,8118007,"Besigheim, Stadt",unter 3 Jahre,326,163,163
False,8118007,"Besigheim, Stadt",3 -  6 Jahre,337,189,148
False,8118007,"Besigheim, Stadt",6 - 10 Jahre,507,254,253
False,8118007,"Besigheim, Stadt",10 - 15 Jahre,631,326,305
False,8118007,"Besigheim, Stadt",15 - 18 Jahre,412,198,214
False,8118007,"Besigheim, Stadt",18 - 20 Jahre,262,144,118
False,8118007,"Besigheim, Stadt",20 - 25 Jahre,629,324,305
False,8118007,"Besigheim, Stadt",25 - 30 Jahre,698,309,389
False,8118007,"Besigheim, Stadt",30 - 35 Jahre,710,359,351
False,8118007,"Besigheim, Stadt",35 - 40 Jahre,778,368,410
False,8118007,"Besigheim, Stadt",40 - 45 Jahre,1066,545,521
False,8118007,"Besigheim, Stadt",45 - 50 Jahre,1054,533,521
False,8118007,"Besigheim, Stadt",50 - 55 Jahre,955,491,464
False,8118007,"Besigheim, Stadt",55 - 60 Jahre,727,361,366
False,8118007,"Besigheim, Stadt",60 - 65 Jahre,618,326,292
False,8118007,"Besigheim, Stadt",65 - 75 Jahre,1182,553,629
False,8118007,"Besigheim, Stadt",75 und mehr Jahre,978,387,591
False,8118007,"Besigheim, Stadt",Insgesamt,11870,5830,6040
False,8118010,"Bönnigheim, Stadt",unter 3 Jahre,171,84,87
False,8118010,"Bönnigheim, Stadt",3 -  6 Jahre,184,93,91
False,8118010,"Bönnigheim, Stadt",6 - 10 Jahre,318,161,157
False,8118010,"Bönnigheim, Stadt",10 - 15 Jahre,476,251,225
False,8118010,"Bönnigheim, Stadt",15 - 18 Jahre,296,139,157
False,8118010,"Bönnigheim, Stadt",18 - 20 Jahre,210,108,102
False,8118010,"Bönnigheim, Stadt",20 - 25 Jahre,450,238,212
False,8118010,"Bönnigheim, Stadt",25 - 30 Jahre,360,178,182
False,8118010,"Bönnigheim, Stadt",30 - 35 Jahre,389,192,197
False,8118010,"Bönnigheim, Stadt",35 - 40 Jahre,560,280,280
False,8118010,"Bönnigheim, Stadt",40 - 45 Jahre,726,385,341
False,8118010,"Bönnigheim, Stadt",45 - 50 Jahre,727,362,365
False,8118010,"Bönnigheim, Stadt",50 - 55 Jahre,550,269,281
False,8118010,"Bönnigheim, Stadt",55 - 60 Jahre,409,205,204
False,8118010,"Bönnigheim, Stadt",60 - 65 Jahre,399,193,206
False,8118010,"Bönnigheim, Stadt",65 - 75 Jahre,708,335,373
False,8118010,"Bönnigheim, Stadt",75 und mehr Jahre,587,225,362
False,8118010,"Bönnigheim, Stadt",Insgesamt,7520,3698,3822
False,8118011,"Ditzingen, Stadt",unter 3 Jahre,696,349,347
False,8118011,"Ditzingen, Stadt",3 -  6 Jahre,706,342,364
False,8118011,"Ditzingen, Stadt",6 - 10 Jahre,990,506,484
False,8118011,"Ditzingen, Stadt",10 - 15 Jahre,1278,666,612
False,8118011,"Ditzingen, Stadt",15 - 18 Jahre,769,414,355
False,8118011,"Ditzingen, Stadt",18 - 20 Jahre,510,258,252
False,8118011,"Ditzingen, Stadt",20 - 25 Jahre,1262,603,659
False,8118011,"Ditzingen, Stadt",25 - 30 Jahre,1406,695,711
False,8118011,"Ditzingen, Stadt",30 - 35 Jahre,1542,817,725
False,8118011,"Ditzingen, Stadt",35 - 40 Jahre,1613,827,786
False,8118011,"Ditzingen, Stadt",40 - 45 Jahre,2022,1020,1002
False,8118011,"Ditzingen, Stadt",45 - 50 Jahre,2069,1049,1020
False,8118011,"Ditzingen, Stadt",50 - 55 Jahre,1820,926,894
False,8118011,"Ditzingen, Stadt",55 - 60 Jahre,1563,784,779
False,8118011,"Ditzingen, Stadt",60 - 65 Jahre,1396,680,716
False,8118011,"Ditzingen, Stadt",65 - 75 Jahre,2812,1367,1445
False,8118011,"Ditzingen, Stadt",75 und mehr Jahre,2039,823,1216
False,8118011,"Ditzingen, Stadt",Insgesamt,24493,12126,12367
False,8118012,Eberdingen,unter 3 Jahre,189,96,93
False,8118012,Eberdingen,3 -  6 Jahre,186,85,101
False,8118012,Eberdingen,6 - 10 Jahre,240,120,120
False,8118012,Eberdingen,10 - 15 Jahre,341,190,151
False,8118012,Eberdingen,15 - 18 Jahre,251,127,124
False,8118012,Eberdingen,18 - 20 Jahre,178,104,74
False,8118012,Eberdingen,20 - 25 Jahre,322,144,178
False,8118012,Eberdingen,25 - 30 Jahre,320,161,159
False,8118012,Eberdingen,30 - 35 Jahre,349,160,189
False,8118012,Eberdingen,35 - 40 Jahre,396,197,199
False,8118012,Eberdingen,40 - 45 Jahre,559,281,278
False,8118012,Eberdingen,45 - 50 Jahre,573,300,273
False,8118012,Eberdingen,50 - 55 Jahre,455,240,215
False,8118012,Eberdingen,55 - 60 Jahre,449,237,212
False,8118012,Eberdingen,60 - 65 Jahre,386,190,196
False,8118012,Eberdingen,65 - 75 Jahre,751,357,394
False,8118012,Eberdingen,75 und mehr Jahre,462,198,264
False,8118012,Eberdingen,Insgesamt,6407,3187,3220
False,8118014,Erdmannhausen,unter 3 Jahre,132,68,64
False,8118014,Erdmannhausen,3 -  6 Jahre,119,58,61
False,8118014,Erdmannhausen,6 - 10 Jahre,179,102,77
False,8118014,Erdmannhausen,10 - 15 Jahre,260,143,117
False,8118014,Erdmannhausen,15 - 18 Jahre,169,94,75
False,8118014,Erdmannhausen,18 - 20 Jahre,128,62,66
False,8118014,Erdmannhausen,20 - 25 Jahre,256,132,124
False,8118014,Erdmannhausen,25 - 30 Jahre,206,101,105
False,8118014,Erdmannhausen,30 - 35 Jahre,263,124,139
False,8118014,Erdmannhausen,35 - 40 Jahre,237,120,117
False,8118014,Erdmannhausen,40 - 45 Jahre,402,201,201
False,8118014,Erdmannhausen,45 - 50 Jahre,403,211,192
False,8118014,Erdmannhausen,50 - 55 Jahre,409,204,205
False,8118014,Erdmannhausen,55 - 60 Jahre,373,172,201
False,8118014,Erdmannhausen,60 - 65 Jahre,287,158,129
False,8118014,Erdmannhausen,65 - 75 Jahre,495,249,246
False,8118014,Erdmannhausen,75 und mehr Jahre,398,149,249
False,8118014,Erdmannhausen,Insgesamt,4716,2348,2368
False,8118015,Erligheim,unter 3 Jahre,67,34,33
False,8118015,Erligheim,3 -  6 Jahre,69,37,32
False,8118015,Erligheim,6 - 10 Jahre,115,56,59
False,8118015,Erligheim,10 - 15 Jahre,147,76,71
False,8118015,Erligheim,15 - 18 Jahre,109,61,48
False,8118015,Erligheim,18 - 20 Jahre,76,42,34
False,8118015,Erligheim,20 - 25 Jahre,189,104,85
False,8118015,Erligheim,25 - 30 Jahre,146,79,67
False,8118015,Erligheim,30 - 35 Jahre,160,81,79
False,8118015,Erligheim,35 - 40 Jahre,171,85,86
False,8118015,Erligheim,40 - 45 Jahre,236,131,105
False,8118015,Erligheim,45 - 50 Jahre,250,114,136
False,8118015,Erligheim,50 - 55 Jahre,223,126,97
False,8118015,Erligheim,55 - 60 Jahre,186,89,97
False,8118015,Erligheim,60 - 65 Jahre,119,60,59
False,8118015,Erligheim,65 - 75 Jahre,246,114,132
False,8118015,Erligheim,75 und mehr Jahre,177,84,93
False,8118015,Erligheim,Insgesamt,2686,1373,1313
False,8118016,Freudental,unter 3 Jahre,69,35,34
False,8118016,Freudental,3 -  6 Jahre,75,35,40
False,8118016,Freudental,6 - 10 Jahre,109,56,53
False,8118016,Freudental,10 - 15 Jahre,117,65,52
False,8118016,Freudental,15 - 18 Jahre,93,46,47
False,8118016,Freudental,18 - 20 Jahre,59,31,28
False,8118016,Freudental,20 - 25 Jahre,128,70,58
False,8118016,Freudental,25 - 30 Jahre,86,43,43
False,8118016,Freudental,30 - 35 Jahre,135,71,64
False,8118016,Freudental,35 - 40 Jahre,162,80,82
False,8118016,Freudental,40 - 45 Jahre,220,110,110
False,8118016,Freudental,45 - 50 Jahre,238,130,108
False,8118016,Freudental,50 - 55 Jahre,186,95,91
False,8118016,Freudental,55 - 60 Jahre,139,71,68
False,8118016,Freudental,60 - 65 Jahre,120,53,67
False,8118016,Freudental,65 - 75 Jahre,289,139,150
False,8118016,Freudental,75 und mehr Jahre,205,99,106
False,8118016,Freudental,Insgesamt,2430,1229,1201
False,8118018,Gemmrigheim,unter 3 Jahre,94,58,36
False,8118018,Gemmrigheim,3 -  6 Jahre,111,58,53
False,8118018,Gemmrigheim,6 - 10 Jahre,173,85,88
False,8118018,Gemmrigheim,10 - 15 Jahre,246,125,121
False,8118018,Gemmrigheim,15 - 18 Jahre,149,79,70
False,8118018,Gemmrigheim,18 - 20 Jahre,89,46,43
False,8118018,Gemmrigheim,20 - 25 Jahre,249,121,128
False,8118018,Gemmrigheim,25 - 30 Jahre,222,105,117
False,8118018,Gemmrigheim,30 - 35 Jahre,242,122,120
False,8118018,Gemmrigheim,35 - 40 Jahre,266,127,139
False,8118018,Gemmrigheim,40 - 45 Jahre,360,186,174
False,8118018,Gemmrigheim,45 - 50 Jahre,336,197,139
False,8118018,Gemmrigheim,50 - 55 Jahre,266,137,129
False,8118018,Gemmrigheim,55 - 60 Jahre,233,106,127
False,8118018,Gemmrigheim,60 - 65 Jahre,195,102,93
False,8118018,Gemmrigheim,65 - 75 Jahre,393,190,203
False,8118018,Gemmrigheim,75 und mehr Jahre,304,112,192
False,8118018,Gemmrigheim,Insgesamt,3928,1956,1972
False,8118019,"Gerlingen, Stadt",unter 3 Jahre,510,256,254
False,8118019,"Gerlingen, Stadt",3 -  6 Jahre,508,259,249
False,8118019,"Gerlingen, Stadt",6 - 10 Jahre,722,378,344
False,8118019,"Gerlingen, Stadt",10 - 15 Jahre,938,485,453
False,8118019,"Gerlingen, Stadt",15 - 18 Jahre,516,276,240
False,8118019,"Gerlingen, Stadt",18 - 20 Jahre,334,171,163
False,8118019,"Gerlingen, Stadt",20 - 25 Jahre,819,414,405
False,8118019,"Gerlingen, Stadt",25 - 30 Jahre,1029,480,549
False,8118019,"Gerlingen, Stadt",30 - 35 Jahre,1184,625,559
False,8118019,"Gerlingen, Stadt",35 - 40 Jahre,1253,633,620
False,8118019,"Gerlingen, Stadt",40 - 45 Jahre,1740,907,833
False,8118019,"Gerlingen, Stadt",45 - 50 Jahre,1658,872,786
False,8118019,"Gerlingen, Stadt",50 - 55 Jahre,1299,659,640
False,8118019,"Gerlingen, Stadt",55 - 60 Jahre,1038,498,540
False,8118019,"Gerlingen, Stadt",60 - 65 Jahre,1009,499,510
False,8118019,"Gerlingen, Stadt",65 - 75 Jahre,2450,1103,1347
False,8118019,"Gerlingen, Stadt",75 und mehr Jahre,2018,830,1188
False,8118019,"Gerlingen, Stadt",Insgesamt,19025,9345,9680
False,8118021,"Großbottwar, Stadt",unter 3 Jahre,219,107,112
False,8118021,"Großbottwar, Stadt",3 -  6 Jahre,203,106,97
False,8118021,"Großbottwar, Stadt",6 - 10 Jahre,370,210,160
False,8118021,"Großbottwar, Stadt",10 - 15 Jahre,486,277,209
False,8118021,"Großbottwar, Stadt",15 - 18 Jahre,333,162,171
False,8118021,"Großbottwar, Stadt",18 - 20 Jahre,219,107,112
False,8118021,"Großbottwar, Stadt",20 - 25 Jahre,450,228,222
False,8118021,"Großbottwar, Stadt",25 - 30 Jahre,389,199,190
False,8118021,"Großbottwar, Stadt",30 - 35 Jahre,457,236,221
False,8118021,"Großbottwar, Stadt",35 - 40 Jahre,477,233,244
False,8118021,"Großbottwar, Stadt",40 - 45 Jahre,748,379,369
False,8118021,"Großbottwar, Stadt",45 - 50 Jahre,778,397,381
False,8118021,"Großbottwar, Stadt",50 - 55 Jahre,587,303,284
False,8118021,"Großbottwar, Stadt",55 - 60 Jahre,519,251,268
False,8118021,"Großbottwar, Stadt",60 - 65 Jahre,443,229,214
False,8118021,"Großbottwar, Stadt",65 - 75 Jahre,858,424,434
False,8118021,"Großbottwar, Stadt",75 und mehr Jahre,635,260,375
False,8118021,"Großbottwar, Stadt",Insgesamt,8171,4108,4063
False,8118027,Hemmingen,unter 3 Jahre,201,103,98
False,8118027,Hemmingen,3 -  6 Jahre,191,94,97
False,8118027,Hemmingen,6 - 10 Jahre,245,139,106
False,8118027,Hemmingen,10 - 15 Jahre,416,210,206
False,8118027,Hemmingen,15 - 18 Jahre,254,122,132
False,8118027,Hemmingen,18 - 20 Jahre,191,104,87
False,8118027,Hemmingen,20 - 25 Jahre,372,198,174
False,8118027,Hemmingen,25 - 30 Jahre,347,183,164
False,8118027,Hemmingen,30 - 35 Jahre,416,206,210
False,8118027,Hemmingen,35 - 40 Jahre,404,178,226
False,8118027,Hemmingen,40 - 45 Jahre,606,313,293
False,8118027,Hemmingen,45 - 50 Jahre,645,326,319
False,8118027,Hemmingen,50 - 55 Jahre,537,287,250
False,8118027,Hemmingen,55 - 60 Jahre,529,245,284
False,8118027,Hemmingen,60 - 65 Jahre,454,209,245
False,8118027,Hemmingen,65 - 75 Jahre,971,476,495
False,8118027,Hemmingen,75 und mehr Jahre,575,244,331
False,8118027,Hemmingen,Insgesamt,7354,3637,3717
False,8118028,Hessigheim,unter 3 Jahre,72,34,38
False,8118028,Hessigheim,3 -  6 Jahre,69,36,33
False,8118028,Hessigheim,6 - 10 Jahre,103,49,54
False,8118028,Hessigheim,10 - 15 Jahre,142,75,67
False,8118028,Hessigheim,15 - 18 Jahre,67,34,33
False,8118028,Hessigheim,18 - 20 Jahre,54,21,33
False,8118028,Hessigheim,20 - 25 Jahre,138,75,63
False,8118028,Hessigheim,25 - 30 Jahre,158,83,75
False,8118028,Hessigheim,30 - 35 Jahre,139,85,54
False,8118028,Hessigheim,35 - 40 Jahre,130,63,67
False,8118028,Hessigheim,40 - 45 Jahre,179,89,90
False,8118028,Hessigheim,45 - 50 Jahre,202,96,106
False,8118028,Hessigheim,50 - 55 Jahre,157,74,83
False,8118028,Hessigheim,55 - 60 Jahre,142,72,70
False,8118028,Hessigheim,60 - 65 Jahre,101,54,47
False,8118028,Hessigheim,65 - 75 Jahre,203,94,109
False,8118028,Hessigheim,75 und mehr Jahre,161,66,95
False,8118028,Hessigheim,Insgesamt,2217,1100,1117
False,8118040,Kirchheim am Neckar,unter 3 Jahre,146,78,68
False,8118040,Kirchheim am Neckar,3 -  6 Jahre,157,78,79
False,8118040,Kirchheim am Neckar,6 - 10 Jahre,207,103,104
False,8118040,Kirchheim am Neckar,10 - 15 Jahre,307,150,157
False,8118040,Kirchheim am Neckar,15 - 18 Jahre,213,118,95
False,8118040,Kirchheim am Neckar,18 - 20 Jahre,145,77,68
False,8118040,Kirchheim am Neckar,20 - 25 Jahre,343,188,155
False,8118040,Kirchheim am Neckar,25 - 30 Jahre,305,149,156
False,8118040,Kirchheim am Neckar,30 - 35 Jahre,297,155,142
False,8118040,Kirchheim am Neckar,35 - 40 Jahre,348,168,180
False,8118040,Kirchheim am Neckar,40 - 45 Jahre,424,206,218
False,8118040,Kirchheim am Neckar,45 - 50 Jahre,455,251,204
False,8118040,Kirchheim am Neckar,50 - 55 Jahre,381,186,195
False,8118040,Kirchheim am Neckar,55 - 60 Jahre,322,178,144
False,8118040,Kirchheim am Neckar,60 - 65 Jahre,265,128,137
False,8118040,Kirchheim am Neckar,65 - 75 Jahre,441,193,248
False,8118040,Kirchheim am Neckar,75 und mehr Jahre,403,161,242
False,8118040,Kirchheim am Neckar,Insgesamt,5159,2567,2592
False,8118046,"Kornwestheim, Stadt",unter 3 Jahre,889,476,413
False,8118046,"Kornwestheim, Stadt",3 -  6 Jahre,883,458,425
False,8118046,"Kornwestheim, Stadt",6 - 10 Jahre,1147,608,539
False,8118046,"Kornwestheim, Stadt",10 - 15 Jahre,1531,772,759
False,8118046,"Kornwestheim, Stadt",15 - 18 Jahre,946,476,470
False,8118046,"Kornwestheim, Stadt",18 - 20 Jahre,698,384,314
False,8118046,"Kornwestheim, Stadt",20 - 25 Jahre,1853,925,928
False,8118046,"Kornwestheim, Stadt",25 - 30 Jahre,2089,1021,1068
False,8118046,"Kornwestheim, Stadt",30 - 35 Jahre,2112,1079,1033
False,8118046,"Kornwestheim, Stadt",35 - 40 Jahre,2084,1030,1054
False,8118046,"Kornwestheim, Stadt",40 - 45 Jahre,2484,1315,1169
False,8118046,"Kornwestheim, Stadt",45 - 50 Jahre,2489,1280,1209
False,8118046,"Kornwestheim, Stadt",50 - 55 Jahre,2274,1138,1136
False,8118046,"Kornwestheim, Stadt",55 - 60 Jahre,1775,879,896
False,8118046,"Kornwestheim, Stadt",60 - 65 Jahre,1679,780,899
False,8118046,"Kornwestheim, Stadt",65 - 75 Jahre,3455,1636,1819
False,8118046,"Kornwestheim, Stadt",75 und mehr Jahre,2904,1129,1775
False,8118046,"Kornwestheim, Stadt",Insgesamt,31292,15386,15906
False,8118047,Löchgau,unter 3 Jahre,114,58,56
False,8118047,Löchgau,3 -  6 Jahre,134,61,73
False,8118047,Löchgau,6 - 10 Jahre,236,118,118
False,8118047,Löchgau,10 - 15 Jahre,302,148,154
False,8118047,Löchgau,15 - 18 Jahre,194,109,85
False,8118047,Löchgau,18 - 20 Jahre,142,76,66
False,8118047,Löchgau,20 - 25 Jahre,309,166,143
False,8118047,Löchgau,25 - 30 Jahre,249,124,125
False,8118047,Löchgau,30 - 35 Jahre,235,121,114
False,8118047,Löchgau,35 - 40 Jahre,297,135,162
False,8118047,Löchgau,40 - 45 Jahre,455,232,223
False,8118047,Löchgau,45 - 50 Jahre,486,264,222
False,8118047,Löchgau,50 - 55 Jahre,472,228,244
False,8118047,Löchgau,55 - 60 Jahre,363,187,176
False,8118047,Löchgau,60 - 65 Jahre,280,127,153
False,8118047,Löchgau,65 - 75 Jahre,621,311,310
False,8118047,Löchgau,75 und mehr Jahre,482,188,294
False,8118047,Löchgau,Insgesamt,5371,2653,2718
False,8118048,"Ludwigsburg, Stadt",unter 3 Jahre,2516,1267,1249
False,8118048,"Ludwigsburg, Stadt",3 -  6 Jahre,2385,1192,1193
False,8118048,"Ludwigsburg, Stadt",6 - 10 Jahre,3187,1603,1584
False,8118048,"Ludwigsburg, Stadt",10 - 15 Jahre,4201,2182,2019
False,8118048,"Ludwigsburg, Stadt",15 - 18 Jahre,2376,1201,1175
False,8118048,"Ludwigsburg, Stadt",18 - 20 Jahre,1838,921,917
False,8118048,"Ludwigsburg, Stadt",20 - 25 Jahre,5248,2518,2730
False,8118048,"Ludwigsburg, Stadt",25 - 30 Jahre,5902,2799,3103
False,8118048,"Ludwigsburg, Stadt",30 - 35 Jahre,6255,3212,3043
False,8118048,"Ludwigsburg, Stadt",35 - 40 Jahre,6277,3244,3033
False,8118048,"Ludwigsburg, Stadt",40 - 45 Jahre,7420,3853,3567
False,8118048,"Ludwigsburg, Stadt",45 - 50 Jahre,7046,3622,3424
False,8118048,"Ludwigsburg, Stadt",50 - 55 Jahre,6015,3034,2981
False,8118048,"Ludwigsburg, Stadt",55 - 60 Jahre,4985,2322,2663
False,8118048,"Ludwigsburg, Stadt",60 - 65 Jahre,4743,2267,2476
False,8118048,"Ludwigsburg, Stadt",65 - 75 Jahre,9553,4494,5059
False,8118048,"Ludwigsburg, Stadt",75 und mehr Jahre,7788,2880,4908
False,8118048,"Ludwigsburg, Stadt",Insgesamt,87735,42611,45124
False,8118049,"Marbach am Neckar, Stadt",unter 3 Jahre,435,232,203
False,8118049,"Marbach am Neckar, Stadt",3 -  6 Jahre,450,243,207
False,8118049,"Marbach am Neckar, Stadt",6 - 10 Jahre,646,322,324
False,8118049,"Marbach am Neckar, Stadt",10 - 15 Jahre,857,445,412
False,8118049,"Marbach am Neckar, Stadt",15 - 18 Jahre,559,294,265
False,8118049,"Marbach am Neckar, Stadt",18 - 20 Jahre,345,181,164
False,8118049,"Marbach am Neckar, Stadt",20 - 25 Jahre,796,420,376
False,8118049,"Marbach am Neckar, Stadt",25 - 30 Jahre,803,384,419
False,8118049,"Marbach am Neckar, Stadt",30 - 35 Jahre,1021,513,508
False,8118049,"Marbach am Neckar, Stadt",35 - 40 Jahre,1026,511,515
False,8118049,"Marbach am Neckar, Stadt",40 - 45 Jahre,1370,707,663
False,8118049,"Marbach am Neckar, Stadt",45 - 50 Jahre,1446,747,699
False,8118049,"Marbach am Neckar, Stadt",50 - 55 Jahre,1125,587,538
False,8118049,"Marbach am Neckar, Stadt",55 - 60 Jahre,925,424,501
False,8118049,"Marbach am Neckar, Stadt",60 - 65 Jahre,738,367,371
False,8118049,"Marbach am Neckar, Stadt",65 - 75 Jahre,1648,768,880
False,8118049,"Marbach am Neckar, Stadt",75 und mehr Jahre,1320,533,787
False,8118049,"Marbach am Neckar, Stadt",Insgesamt,15510,7678,7832
False,8118050,"Markgröningen, Stadt",unter 3 Jahre,379,197,182
False,8118050,"Markgröningen, Stadt",3 -  6 Jahre,402,211,191
False,8118050,"Markgröningen, Stadt",6 - 10 Jahre,544,291,253
False,8118050,"Markgröningen, Stadt",10 - 15 Jahre,754,402,352
False,8118050,"Markgröningen, Stadt",15 - 18 Jahre,474,250,224
False,8118050,"Markgröningen, Stadt",18 - 20 Jahre,364,182,182
False,8118050,"Markgröningen, Stadt",20 - 25 Jahre,889,454,435
False,8118050,"Markgröningen, Stadt",25 - 30 Jahre,844,438,406
False,8118050,"Markgröningen, Stadt",30 - 35 Jahre,896,438,458
False,8118050,"Markgröningen, Stadt",35 - 40 Jahre,994,488,506
False,8118050,"Markgröningen, Stadt",40 - 45 Jahre,1266,646,620
False,8118050,"Markgröningen, Stadt",45 - 50 Jahre,1259,656,603
False,8118050,"Markgröningen, Stadt",50 - 55 Jahre,1142,567,575
False,8118050,"Markgröningen, Stadt",55 - 60 Jahre,947,478,469
False,8118050,"Markgröningen, Stadt",60 - 65 Jahre,780,420,360
False,8118050,"Markgröningen, Stadt",65 - 75 Jahre,1438,701,737
False,8118050,"Markgröningen, Stadt",75 und mehr Jahre,1018,404,614
False,8118050,"Markgröningen, Stadt",Insgesamt,14390,7223,7167
False,8118051,Möglingen,unter 3 Jahre,298,160,138
False,8118051,Möglingen,3 -  6 Jahre,302,164,138
False,8118051,Möglingen,6 - 10 Jahre,387,185,202
False,8118051,Möglingen,10 - 15 Jahre,543,290,253
False,8118051,Möglingen,15 - 18 Jahre,336,175,161
False,8118051,Möglingen,18 - 20 Jahre,224,122,102
False,8118051,Möglingen,20 - 25 Jahre,569,277,292
False,8118051,Möglingen,25 - 30 Jahre,631,303,328
False,8118051,Möglingen,30 - 35 Jahre,714,367,347
False,8118051,Möglingen,35 - 40 Jahre,722,361,361
False,8118051,Möglingen,40 - 45 Jahre,888,479,409
False,8118051,Möglingen,45 - 50 Jahre,866,446,420
False,8118051,Möglingen,50 - 55 Jahre,755,365,390
False,8118051,Möglingen,55 - 60 Jahre,600,307,293
False,8118051,Möglingen,60 - 65 Jahre,586,279,307
False,8118051,Möglingen,65 - 75 Jahre,1300,615,685
False,8118051,Möglingen,75 und mehr Jahre,896,388,508
False,8118051,Möglingen,Insgesamt,10617,5283,5334
False,8118053,Mundelsheim,unter 3 Jahre,73,32,41
False,8118053,Mundelsheim,3 -  6 Jahre,85,48,37
False,8118053,Mundelsheim,6 - 10 Jahre,134,79,55
False,8118053,Mundelsheim,10 - 15 Jahre,181,96,85
False,8118053,Mundelsheim,15 - 18 Jahre,109,58,51
False,8118053,Mundelsheim,18 - 20 Jahre,87,47,40
False,8118053,Mundelsheim,20 - 25 Jahre,171,86,85
False,8118053,Mundelsheim,25 - 30 Jahre,151,81,70
False,8118053,Mundelsheim,30 - 35 Jahre,168,82,86
False,8118053,Mundelsheim,35 - 40 Jahre,186,104,82
False,8118053,Mundelsheim,40 - 45 Jahre,261,126,135
False,8118053,Mundelsheim,45 - 50 Jahre,294,143,151
False,8118053,Mundelsheim,50 - 55 Jahre,272,140,132
False,8118053,Mundelsheim,55 - 60 Jahre,191,94,97
False,8118053,Mundelsheim,60 - 65 Jahre,163,76,87
False,8118053,Mundelsheim,65 - 75 Jahre,350,173,177
False,8118053,Mundelsheim,75 und mehr Jahre,278,108,170
False,8118053,Mundelsheim,Insgesamt,3154,1573,1581
False,8118054,Murr,unter 3 Jahre,181,100,81
False,8118054,Murr,3 -  6 Jahre,175,93,82
False,8118054,Murr,6 - 10 Jahre,226,105,121
False,8118054,Murr,10 - 15 Jahre,370,190,180
False,8118054,Murr,15 - 18 Jahre,225,108,117
False,8118054,Murr,18 - 20 Jahre,138,65,73
False,8118054,Murr,20 - 25 Jahre,332,187,145
False,8118054,Murr,25 - 30 Jahre,324,151,173
False,8118054,Murr,30 - 35 Jahre,385,192,193
False,8118054,Murr,35 - 40 Jahre,412,207,205
False,8118054,Murr,40 - 45 Jahre,577,299,278
False,8118054,Murr,45 - 50 Jahre,581,274,307
False,8118054,Murr,50 - 55 Jahre,441,228,213
False,8118054,Murr,55 - 60 Jahre,384,189,195
False,8118054,Murr,60 - 65 Jahre,338,156,182
False,8118054,Murr,65 - 75 Jahre,658,318,340
False,8118054,Murr,75 und mehr Jahre,454,178,276
False,8118054,Murr,Insgesamt,6201,3040,3161
False,8118059,"Oberriexingen, Stadt",unter 3 Jahre,92,45,47
False,8118059,"Oberriexingen, Stadt",3 -  6 Jahre,93,47,46
False,8118059,"Oberriexingen, Stadt",6 - 10 Jahre,135,69,66
False,8118059,"Oberriexingen, Stadt",10 - 15 Jahre,184,100,84
False,8118059,"Oberriexingen, Stadt",15 - 18 Jahre,125,59,66
False,8118059,"Oberriexingen, Stadt",18 - 20 Jahre,92,62,30
False,8118059,"Oberriexingen, Stadt",20 - 25 Jahre,153,77,76
False,8118059,"Oberriexingen, Stadt",25 - 30 Jahre,162,79,83
False,8118059,"Oberriexingen, Stadt",30 - 35 Jahre,196,94,102
False,8118059,"Oberriexingen, Stadt",35 - 40 Jahre,220,113,107
False,8118059,"Oberriexingen, Stadt",40 - 45 Jahre,304,150,154
False,8118059,"Oberriexingen, Stadt",45 - 50 Jahre,288,158,130
False,8118059,"Oberriexingen, Stadt",50 - 55 Jahre,253,132,121
False,8118059,"Oberriexingen, Stadt",55 - 60 Jahre,190,93,97
False,8118059,"Oberriexingen, Stadt",60 - 65 Jahre,175,87,88
False,8118059,"Oberriexingen, Stadt",65 - 75 Jahre,323,158,165
False,8118059,"Oberriexingen, Stadt",75 und mehr Jahre,182,76,106
False,8118059,"Oberriexingen, Stadt",Insgesamt,3167,1599,1568
False,8118060,Oberstenfeld,unter 3 Jahre,179,81,98
False,8118060,Oberstenfeld,3 -  6 Jahre,208,108,100
False,8118060,Oberstenfeld,6 - 10 Jahre,323,173,150
False,8118060,Oberstenfeld,10 - 15 Jahre,440,222,218
False,8118060,Oberstenfeld,15 - 18 Jahre,298,159,139
False,8118060,Oberstenfeld,18 - 20 Jahre,204,106,98
False,8118060,Oberstenfeld,20 - 25 Jahre,471,260,211
False,8118060,Oberstenfeld,25 - 30 Jahre,411,225,186
False,8118060,Oberstenfeld,30 - 35 Jahre,418,197,221
False,8118060,Oberstenfeld,35 - 40 Jahre,450,225,225
False,8118060,Oberstenfeld,40 - 45 Jahre,631,295,336
False,8118060,Oberstenfeld,45 - 50 Jahre,695,341,354
False,8118060,Oberstenfeld,50 - 55 Jahre,604,304,300
False,8118060,Oberstenfeld,55 - 60 Jahre,462,234,228
False,8118060,Oberstenfeld,60 - 65 Jahre,507,243,264
False,8118060,Oberstenfeld,65 - 75 Jahre,992,490,502
False,8118060,Oberstenfeld,75 und mehr Jahre,604,241,363
False,8118060,Oberstenfeld,Insgesamt,7897,3904,3993
False,8118063,Pleidelsheim,unter 3 Jahre,155,72,83
False,8118063,Pleidelsheim,3 -  6 Jahre,163,90,73
False,8118063,Pleidelsheim,6 - 10 Jahre,259,143,116
False,8118063,Pleidelsheim,10 - 15 Jahre,388,202,186
False,8118063,Pleidelsheim,15 - 18 Jahre,243,135,108
False,8118063,Pleidelsheim,18 - 20 Jahre,154,85,69
False,8118063,Pleidelsheim,20 - 25 Jahre,348,170,178
False,8118063,Pleidelsheim,25 - 30 Jahre,322,151,171
False,8118063,Pleidelsheim,30 - 35 Jahre,380,183,197
False,8118063,Pleidelsheim,35 - 40 Jahre,395,183,212
False,8118063,Pleidelsheim,40 - 45 Jahre,561,279,282
False,8118063,Pleidelsheim,45 - 50 Jahre,607,316,291
False,8118063,Pleidelsheim,50 - 55 Jahre,441,214,227
False,8118063,Pleidelsheim,55 - 60 Jahre,406,190,216
False,8118063,Pleidelsheim,60 - 65 Jahre,292,155,137
False,8118063,Pleidelsheim,65 - 75 Jahre,650,303,347
False,8118063,Pleidelsheim,75 und mehr Jahre,508,189,319
False,8118063,Pleidelsheim,Insgesamt,6272,3060,3212
False,8118067,Schwieberdingen,unter 3 Jahre,347,193,154
False,8118067,Schwieberdingen,3 -  6 Jahre,368,193,175
False,8118067,Schwieberdingen,6 - 10 Jahre,491,254,237
False,8118067,Schwieberdingen,10 - 15 Jahre,532,284,248
False,8118067,Schwieberdingen,15 - 18 Jahre,312,162,150
False,8118067,Schwieberdingen,18 - 20 Jahre,247,122,125
False,8118067,Schwieberdingen,20 - 25 Jahre,554,267,287
False,8118067,Schwieberdingen,25 - 30 Jahre,670,320,350
False,8118067,Schwieberdingen,30 - 35 Jahre,849,422,427
False,8118067,Schwieberdingen,35 - 40 Jahre,894,493,401
False,8118067,Schwieberdingen,40 - 45 Jahre,994,508,486
False,8118067,Schwieberdingen,45 - 50 Jahre,880,479,401
False,8118067,Schwieberdingen,50 - 55 Jahre,783,405,378
False,8118067,Schwieberdingen,55 - 60 Jahre,671,319,352
False,8118067,Schwieberdingen,60 - 65 Jahre,624,313,311
False,8118067,Schwieberdingen,65 - 75 Jahre,1277,633,644
False,8118067,Schwieberdingen,75 und mehr Jahre,869,395,474
False,8118067,Schwieberdingen,Insgesamt,11362,5762,5600
False,8118068,Sersheim,unter 3 Jahre,156,77,79
False,8118068,Sersheim,3 -  6 Jahre,156,75,81
False,8118068,Sersheim,6 - 10 Jahre,226,128,98
False,8118068,Sersheim,10 - 15 Jahre,350,167,183
False,8118068,Sersheim,15 - 18 Jahre,200,93,107
False,8118068,Sersheim,18 - 20 Jahre,132,65,67
False,8118068,Sersheim,20 - 25 Jahre,292,165,127
False,8118068,Sersheim,25 - 30 Jahre,271,131,140
False,8118068,Sersheim,30 - 35 Jahre,278,126,152
False,8118068,Sersheim,35 - 40 Jahre,344,181,163
False,8118068,Sersheim,40 - 45 Jahre,486,229,257
False,8118068,Sersheim,45 - 50 Jahre,475,240,235
False,8118068,Sersheim,50 - 55 Jahre,355,191,164
False,8118068,Sersheim,55 - 60 Jahre,319,169,150
False,8118068,Sersheim,60 - 65 Jahre,281,136,145
False,8118068,Sersheim,65 - 75 Jahre,532,251,281
False,8118068,Sersheim,75 und mehr Jahre,409,155,254
False,8118068,Sersheim,Insgesamt,5262,2579,2683
False,8118070,"Steinheim an der Murr, Stadt",unter 3 Jahre,322,160,162
False,8118070,"Steinheim an der Murr, Stadt",3 -  6 Jahre,385,202,183
False,8118070,"Steinheim an der Murr, Stadt",6 - 10 Jahre,520,266,254
False,8118070,"Steinheim an der Murr, Stadt",10 - 15 Jahre,718,375,343
False,8118070,"Steinheim an der Murr, Stadt",15 - 18 Jahre,451,245,206
False,8118070,"Steinheim an der Murr, Stadt",18 - 20 Jahre,332,160,172
False,8118070,"Steinheim an der Murr, Stadt",20 - 25 Jahre,724,364,360
False,8118070,"Steinheim an der Murr, Stadt",25 - 30 Jahre,585,293,292
False,8118070,"Steinheim an der Murr, Stadt",30 - 35 Jahre,593,273,320
False,8118070,"Steinheim an der Murr, Stadt",35 - 40 Jahre,712,355,357
False,8118070,"Steinheim an der Murr, Stadt",40 - 45 Jahre,1115,572,543
False,8118070,"Steinheim an der Murr, Stadt",45 - 50 Jahre,1120,569,551
False,8118070,"Steinheim an der Murr, Stadt",50 - 55 Jahre,982,468,514
False,8118070,"Steinheim an der Murr, Stadt",55 - 60 Jahre,805,422,383
False,8118070,"Steinheim an der Murr, Stadt",60 - 65 Jahre,617,324,293
False,8118070,"Steinheim an der Murr, Stadt",65 - 75 Jahre,1162,558,604
False,8118070,"Steinheim an der Murr, Stadt",75 und mehr Jahre,896,346,550
False,8118070,"Steinheim an der Murr, Stadt",Insgesamt,12039,5952,6087
False,8118071,Tamm,unter 3 Jahre,324,162,162
False,8118071,Tamm,3 -  6 Jahre,306,170,136
False,8118071,Tamm,6 - 10 Jahre,386,198,188
False,8118071,Tamm,10 - 15 Jahre,591,311,280
False,8118071,Tamm,15 - 18 Jahre,402,209,193
False,8118071,Tamm,18 - 20 Jahre,266,147,119
False,8118071,Tamm,20 - 25 Jahre,646,309,337
False,8118071,Tamm,25 - 30 Jahre,725,367,358
False,8118071,Tamm,30 - 35 Jahre,759,362,397
False,8118071,Tamm,35 - 40 Jahre,844,440,404
False,8118071,Tamm,40 - 45 Jahre,970,504,466
False,8118071,Tamm,45 - 50 Jahre,1000,483,517
False,8118071,Tamm,50 - 55 Jahre,1007,476,531
False,8118071,Tamm,55 - 60 Jahre,954,434,520
False,8118071,Tamm,60 - 65 Jahre,849,428,421
False,8118071,Tamm,65 - 75 Jahre,1409,693,716
False,8118071,Tamm,75 und mehr Jahre,848,365,483
False,8118071,Tamm,Insgesamt,12286,6058,6228
False,8118073,"Vaihingen an der Enz, Stadt",unter 3 Jahre,777,391,386
False,8118073,"Vaihingen an der Enz, Stadt",3 -  6 Jahre,787,372,415
False,8118073,"Vaihingen an der Enz, Stadt",6 - 10 Jahre,1231,621,610
False,8118073,"Vaihingen an der Enz, Stadt",10 - 15 Jahre,1854,956,898
False,8118073,"Vaihingen an der Enz, Stadt",15 - 18 Jahre,1094,528,566
False,8118073,"Vaihingen an der Enz, Stadt",18 - 20 Jahre,733,363,370
False,8118073,"Vaihingen an der Enz, Stadt",20 - 25 Jahre,1601,866,735
False,8118073,"Vaihingen an der Enz, Stadt",25 - 30 Jahre,1394,702,692
False,8118073,"Vaihingen an der Enz, Stadt",30 - 35 Jahre,1687,829,858
False,8118073,"Vaihingen an der Enz, Stadt",35 - 40 Jahre,1783,902,881
False,8118073,"Vaihingen an der Enz, Stadt",40 - 45 Jahre,2523,1276,1247
False,8118073,"Vaihingen an der Enz, Stadt",45 - 50 Jahre,2599,1360,1239
False,8118073,"Vaihingen an der Enz, Stadt",50 - 55 Jahre,2195,1117,1078
False,8118073,"Vaihingen an der Enz, Stadt",55 - 60 Jahre,1722,893,829
False,8118073,"Vaihingen an der Enz, Stadt",60 - 65 Jahre,1539,754,785
False,8118073,"Vaihingen an der Enz, Stadt",65 - 75 Jahre,3018,1466,1552
False,8118073,"Vaihingen an der Enz, Stadt",75 und mehr Jahre,2296,894,1402
False,8118073,"Vaihingen an der Enz, Stadt",Insgesamt,28833,14290,14543
False,8118074,Walheim,unter 3 Jahre,62,38,24
False,8118074,Walheim,3 -  6 Jahre,63,29,34
False,8118074,Walheim,6 - 10 Jahre,103,54,49
False,8118074,Walheim,10 - 15 Jahre,166,84,82
False,8118074,Walheim,15 - 18 Jahre,120,67,53
False,8118074,Walheim,18 - 20 Jahre,73,45,28
False,8118074,Walheim,20 - 25 Jahre,194,99,95
False,8118074,Walheim,25 - 30 Jahre,163,93,70
False,8118074,Walheim,30 - 35 Jahre,136,76,60
False,8118074,Walheim,35 - 40 Jahre,152,82,70
False,8118074,Walheim,40 - 45 Jahre,249,118,131
False,8118074,Walheim,45 - 50 Jahre,270,143,127
False,8118074,Walheim,50 - 55 Jahre,215,111,104
False,8118074,Walheim,55 - 60 Jahre,195,98,97
False,8118074,Walheim,60 - 65 Jahre,145,75,70
False,8118074,Walheim,65 - 75 Jahre,348,156,192
False,8118074,Walheim,75 und mehr Jahre,317,125,192
False,8118074,Walheim,Insgesamt,2971,1493,1478
False,8118076,"Sachsenheim, Stadt",unter 3 Jahre,455,224,231
False,8118076,"Sachsenheim, Stadt",3 -  6 Jahre,454,246,208
False,8118076,"Sachsenheim, Stadt",6 - 10 Jahre,683,399,284
False,8118076,"Sachsenheim, Stadt",10 - 15 Jahre,951,456,495
False,8118076,"Sachsenheim, Stadt",15 - 18 Jahre,605,306,299
False,8118076,"Sachsenheim, Stadt",18 - 20 Jahre,429,223,206
False,8118076,"Sachsenheim, Stadt",20 - 25 Jahre,1085,568,517
False,8118076,"Sachsenheim, Stadt",25 - 30 Jahre,983,517,466
False,8118076,"Sachsenheim, Stadt",30 - 35 Jahre,1025,516,509
False,8118076,"Sachsenheim, Stadt",35 - 40 Jahre,1105,532,573
False,8118076,"Sachsenheim, Stadt",40 - 45 Jahre,1423,732,691
False,8118076,"Sachsenheim, Stadt",45 - 50 Jahre,1543,805,738
False,8118076,"Sachsenheim, Stadt",50 - 55 Jahre,1421,731,690
False,8118076,"Sachsenheim, Stadt",55 - 60 Jahre,1167,580,587
False,8118076,"Sachsenheim, Stadt",60 - 65 Jahre,926,484,442
False,8118076,"Sachsenheim, Stadt",65 - 75 Jahre,1934,925,1009
False,8118076,"Sachsenheim, Stadt",75 und mehr Jahre,1485,583,902
False,8118076,"Sachsenheim, Stadt",Insgesamt,17674,8827,8847
False,8118077,Ingersheim,unter 3 Jahre,188,102,86
False,8118077,Ingersheim,3 -  6 Jahre,187,87,100
False,8118077,Ingersheim,6 - 10 Jahre,244,132,112
False,8118077,Ingersheim,10 - 15 Jahre,345,169,176
False,8118077,Ingersheim,15 - 18 Jahre,190,90,100
False,8118077,Ingersheim,18 - 20 Jahre,126,60,66
False,8118077,Ingersheim,20 - 25 Jahre,318,146,172
False,8118077,Ingersheim,25 - 30 Jahre,333,157,176
False,8118077,Ingersheim,30 - 35 Jahre,406,190,216
False,8118077,Ingersheim,35 - 40 Jahre,390,202,188
False,8118077,Ingersheim,40 - 45 Jahre,594,302,292
False,8118077,Ingersheim,45 - 50 Jahre,498,262,236
False,8118077,Ingersheim,50 - 55 Jahre,390,192,198
False,8118077,Ingersheim,55 - 60 Jahre,364,180,184
False,8118077,Ingersheim,60 - 65 Jahre,321,152,169
False,8118077,Ingersheim,65 - 75 Jahre,595,289,306
False,8118077,Ingersheim,75 und mehr Jahre,534,212,322
False,8118077,Ingersheim,Insgesamt,6023,2924,3099
False,8118078,"Freiberg am Neckar, Stadt",unter 3 Jahre,408,211,197
False,8118078,"Freiberg am Neckar, Stadt",3 -  6 Jahre,410,206,204
False,8118078,"Freiberg am Neckar, Stadt",6 - 10 Jahre,584,292,292
False,8118078,"Freiberg am Neckar, Stadt",10 - 15 Jahre,819,414,405
False,8118078,"Freiberg am Neckar, Stadt",15 - 18 Jahre,493,239,254
False,8118078,"Freiberg am Neckar, Stadt",18 - 20 Jahre,366,172,194
False,8118078,"Freiberg am Neckar, Stadt",20 - 25 Jahre,807,427,380
False,8118078,"Freiberg am Neckar, Stadt",25 - 30 Jahre,896,428,468
False,8118078,"Freiberg am Neckar, Stadt",30 - 35 Jahre,945,460,485
False,8118078,"Freiberg am Neckar, Stadt",35 - 40 Jahre,1038,511,527
False,8118078,"Freiberg am Neckar, Stadt",40 - 45 Jahre,1420,698,722
False,8118078,"Freiberg am Neckar, Stadt",45 - 50 Jahre,1425,694,731
False,8118078,"Freiberg am Neckar, Stadt",50 - 55 Jahre,1132,583,549
False,8118078,"Freiberg am Neckar, Stadt",55 - 60 Jahre,1003,491,512
False,8118078,"Freiberg am Neckar, Stadt",60 - 65 Jahre,890,419,471
False,8118078,"Freiberg am Neckar, Stadt",65 - 75 Jahre,1773,850,923
False,8118078,"Freiberg am Neckar, Stadt",75 und mehr Jahre,1293,525,768
False,8118078,"Freiberg am Neckar, Stadt",Insgesamt,15702,7620,8082
False,8118079,"Bietigheim-Bissingen, Stadt",unter 3 Jahre,1118,572,546
False,8118079,"Bietigheim-Bissingen, Stadt",3 -  6 Jahre,1205,622,583
False,8118079,"Bietigheim-Bissingen, Stadt",6 - 10 Jahre,1678,853,825
False,8118079,"Bietigheim-Bissingen, Stadt",10 - 15 Jahre,2289,1170,1119
False,8118079,"Bietigheim-Bissingen, Stadt",15 - 18 Jahre,1313,679,634
False,8118079,"Bietigheim-Bissingen, Stadt",18 - 20 Jahre,925,485,440
False,8118079,"Bietigheim-Bissingen, Stadt",20 - 25 Jahre,2319,1152,1167
False,8118079,"Bietigheim-Bissingen, Stadt",25 - 30 Jahre,2460,1225,1235
False,8118079,"Bietigheim-Bissingen, Stadt",30 - 35 Jahre,2724,1360,1364
False,8118079,"Bietigheim-Bissingen, Stadt",35 - 40 Jahre,2775,1362,1413
False,8118079,"Bietigheim-Bissingen, Stadt",40 - 45 Jahre,3487,1777,1710
False,8118079,"Bietigheim-Bissingen, Stadt",45 - 50 Jahre,3472,1784,1688
False,8118079,"Bietigheim-Bissingen, Stadt",50 - 55 Jahre,3249,1618,1631
False,8118079,"Bietigheim-Bissingen, Stadt",55 - 60 Jahre,2682,1276,1406
False,8118079,"Bietigheim-Bissingen, Stadt",60 - 65 Jahre,2278,1092,1186
False,8118079,"Bietigheim-Bissingen, Stadt",65 - 75 Jahre,4934,2330,2604
False,8118079,"Bietigheim-Bissingen, Stadt",75 und mehr Jahre,3902,1518,2384
False,8118079,"Bietigheim-Bissingen, Stadt",Insgesamt,42810,20875,21935
False,8118080,"Korntal-Münchingen, Stadt",unter 3 Jahre,534,267,267
False,8118080,"Korntal-Münchingen, Stadt",3 -  6 Jahre,541,262,279
False,8118080,"Korntal-Münchingen, Stadt",6 - 10 Jahre,728,368,360
False,8118080,"Korntal-Münchingen, Stadt",10 - 15 Jahre,953,507,446
False,8118080,"Korntal-Münchingen, Stadt",15 - 18 Jahre,562,296,266
False,8118080,"Korntal-Münchingen, Stadt",18 - 20 Jahre,400,221,179
False,8118080,"Korntal-Münchingen, Stadt",20 - 25 Jahre,995,476,519
False,8118080,"Korntal-Münchingen, Stadt",25 - 30 Jahre,1011,483,528
False,8118080,"Korntal-Münchingen, Stadt",30 - 35 Jahre,1151,566,585
False,8118080,"Korntal-Münchingen, Stadt",35 - 40 Jahre,1277,622,655
False,8118080,"Korntal-Münchingen, Stadt",40 - 45 Jahre,1621,864,757
False,8118080,"Korntal-Münchingen, Stadt",45 - 50 Jahre,1616,856,760
False,8118080,"Korntal-Münchingen, Stadt",50 - 55 Jahre,1248,667,581
False,8118080,"Korntal-Münchingen, Stadt",55 - 60 Jahre,1100,519,581
False,8118080,"Korntal-Münchingen, Stadt",60 - 65 Jahre,986,457,529
False,8118080,"Korntal-Münchingen, Stadt",65 - 75 Jahre,2178,1058,1120
False,8118080,"Korntal-Münchingen, Stadt",75 und mehr Jahre,1708,654,1054
False,8118080,"Korntal-Münchingen, Stadt",Insgesamt,18609,9143,9466
False,8118081,"Remseck am Neckar, Stadt",unter 3 Jahre,641,365,276
False,8118081,"Remseck am Neckar, Stadt",3 -  6 Jahre,692,347,345
False,8118081,"Remseck am Neckar, Stadt",6 - 10 Jahre,1011,504,507
False,8118081,"Remseck am Neckar, Stadt",10 - 15 Jahre,1388,718,670
False,8118081,"Remseck am Neckar, Stadt",15 - 18 Jahre,834,432,402
False,8118081,"Remseck am Neckar, Stadt",18 - 20 Jahre,563,265,298
False,8118081,"Remseck am Neckar, Stadt",20 - 25 Jahre,1245,635,610
False,8118081,"Remseck am Neckar, Stadt",25 - 30 Jahre,1218,591,627
False,8118081,"Remseck am Neckar, Stadt",30 - 35 Jahre,1523,761,762
False,8118081,"Remseck am Neckar, Stadt",35 - 40 Jahre,1582,762,820
False,8118081,"Remseck am Neckar, Stadt",40 - 45 Jahre,2135,1115,1020
False,8118081,"Remseck am Neckar, Stadt",45 - 50 Jahre,2138,1066,1072
False,8118081,"Remseck am Neckar, Stadt",50 - 55 Jahre,1725,896,829
False,8118081,"Remseck am Neckar, Stadt",55 - 60 Jahre,1419,670,749
False,8118081,"Remseck am Neckar, Stadt",60 - 65 Jahre,1306,671,635
False,8118081,"Remseck am Neckar, Stadt",65 - 75 Jahre,2355,1105,1250
False,8118081,"Remseck am Neckar, Stadt",75 und mehr Jahre,1580,691,889
False,8118081,"Remseck am Neckar, Stadt",Insgesamt,23355,11594,11761
False,8119,Landkreis Rems-Murr-Kreis,unter 3 Jahre,10200,5222,4978
False,8119,Landkreis Rems-Murr-Kreis,3 -  6 Jahre,11149,5718,5431
False,8119,Landkreis Rems-Murr-Kreis,6 - 10 Jahre,15945,8128,7817
False,8119,Landkreis Rems-Murr-Kreis,10 - 15 Jahre,22809,11556,11253
False,8119,Landkreis Rems-Murr-Kreis,15 - 18 Jahre,14236,7235,7001
False,8119,Landkreis Rems-Murr-Kreis,18 - 20 Jahre,9801,5068,4733
False,8119,Landkreis Rems-Murr-Kreis,20 - 25 Jahre,22916,11915,11001
False,8119,Landkreis Rems-Murr-Kreis,25 - 30 Jahre,22392,11260,11132
False,8119,Landkreis Rems-Murr-Kreis,30 - 35 Jahre,23351,11467,11884
False,8119,Landkreis Rems-Murr-Kreis,35 - 40 Jahre,26011,12975,13036
False,8119,Landkreis Rems-Murr-Kreis,40 - 45 Jahre,35274,17867,17407
False,8119,Landkreis Rems-Murr-Kreis,45 - 50 Jahre,36858,18936,17922
False,8119,Landkreis Rems-Murr-Kreis,50 - 55 Jahre,31300,15959,15341
False,8119,Landkreis Rems-Murr-Kreis,55 - 60 Jahre,26240,12803,13437
False,8119,Landkreis Rems-Murr-Kreis,60 - 65 Jahre,23112,11307,11805
False,8119,Landkreis Rems-Murr-Kreis,65 - 75 Jahre,46995,22351,24644
False,8119,Landkreis Rems-Murr-Kreis,75 und mehr Jahre,36859,14495,22364
False,8119,Landkreis Rems-Murr-Kreis,Insgesamt,415448,204262,211186
False,8119001,Alfdorf,unter 3 Jahre,174,85,89
False,8119001,Alfdorf,3 -  6 Jahre,213,115,98
False,8119001,Alfdorf,6 - 10 Jahre,303,167,136
False,8119001,Alfdorf,10 - 15 Jahre,477,247,230
False,8119001,Alfdorf,15 - 18 Jahre,289,137,152
False,8119001,Alfdorf,18 - 20 Jahre,196,107,89
False,8119001,Alfdorf,20 - 25 Jahre,469,262,207
False,8119001,Alfdorf,25 - 30 Jahre,348,179,169
False,8119001,Alfdorf,30 - 35 Jahre,337,171,166
False,8119001,Alfdorf,35 - 40 Jahre,395,197,198
False,8119001,Alfdorf,40 - 45 Jahre,603,300,303
False,8119001,Alfdorf,45 - 50 Jahre,626,325,301
False,8119001,Alfdorf,50 - 55 Jahre,559,282,277
False,8119001,Alfdorf,55 - 60 Jahre,447,228,219
False,8119001,Alfdorf,60 - 65 Jahre,340,192,148
False,8119001,Alfdorf,65 - 75 Jahre,702,328,374
False,8119001,Alfdorf,75 und mehr Jahre,656,259,397
False,8119001,Alfdorf,Insgesamt,7134,3581,3553
False,8119003,Allmersbach im Tal,unter 3 Jahre,108,61,47
False,8119003,Allmersbach im Tal,3 -  6 Jahre,122,56,66
False,8119003,Allmersbach im Tal,6 - 10 Jahre,197,110,87
False,8119003,Allmersbach im Tal,10 - 15 Jahre,278,139,139
False,8119003,Allmersbach im Tal,15 - 18 Jahre,175,93,82
False,8119003,Allmersbach im Tal,18 - 20 Jahre,107,59,48
False,8119003,Allmersbach im Tal,20 - 25 Jahre,212,103,109
False,8119003,Allmersbach im Tal,25 - 30 Jahre,208,109,99
False,8119003,Allmersbach im Tal,30 - 35 Jahre,223,110,113
False,8119003,Allmersbach im Tal,35 - 40 Jahre,279,128,151
False,8119003,Allmersbach im Tal,40 - 45 Jahre,468,231,237
False,8119003,Allmersbach im Tal,45 - 50 Jahre,441,226,215
False,8119003,Allmersbach im Tal,50 - 55 Jahre,347,179,168
False,8119003,Allmersbach im Tal,55 - 60 Jahre,271,126,145
False,8119003,Allmersbach im Tal,60 - 65 Jahre,254,125,129
False,8119003,Allmersbach im Tal,65 - 75 Jahre,595,296,299
False,8119003,Allmersbach im Tal,75 und mehr Jahre,420,174,246
False,8119003,Allmersbach im Tal,Insgesamt,4705,2325,2380
False,8119004,Althütte,unter 3 Jahre,107,66,41
False,8119004,Althütte,3 -  6 Jahre,127,65,62
False,8119004,Althütte,6 - 10 Jahre,180,84,96
False,8119004,Althütte,10 - 15 Jahre,278,133,145
False,8119004,Althütte,15 - 18 Jahre,164,85,79
False,8119004,Althütte,18 - 20 Jahre,86,42,44
False,8119004,Althütte,20 - 25 Jahre,224,130,94
False,8119004,Althütte,25 - 30 Jahre,182,94,88
False,8119004,Althütte,30 - 35 Jahre,173,73,100
False,8119004,Althütte,35 - 40 Jahre,249,123,126
False,8119004,Althütte,40 - 45 Jahre,384,179,205
False,8119004,Althütte,45 - 50 Jahre,394,210,184
False,8119004,Althütte,50 - 55 Jahre,325,178,147
False,8119004,Althütte,55 - 60 Jahre,265,125,140
False,8119004,Althütte,60 - 65 Jahre,265,126,139
False,8119004,Althütte,65 - 75 Jahre,468,234,234
False,8119004,Althütte,75 und mehr Jahre,318,138,180
False,8119004,Althütte,Insgesamt,4189,2085,2104
False,8119006,Auenwald,unter 3 Jahre,157,93,64
False,8119006,Auenwald,3 -  6 Jahre,203,109,94
False,8119006,Auenwald,6 - 10 Jahre,272,142,130
False,8119006,Auenwald,10 - 15 Jahre,405,208,197
False,8119006,Auenwald,15 - 18 Jahre,255,126,129
False,8119006,Auenwald,18 - 20 Jahre,199,104,95
False,8119006,Auenwald,20 - 25 Jahre,388,185,203
False,8119006,Auenwald,25 - 30 Jahre,328,163,165
False,8119006,Auenwald,30 - 35 Jahre,337,188,149
False,8119006,Auenwald,35 - 40 Jahre,448,211,237
False,8119006,Auenwald,40 - 45 Jahre,611,306,305
False,8119006,Auenwald,45 - 50 Jahre,670,340,330
False,8119006,Auenwald,50 - 55 Jahre,537,254,283
False,8119006,Auenwald,55 - 60 Jahre,455,228,227
False,8119006,Auenwald,60 - 65 Jahre,418,215,203
False,8119006,Auenwald,65 - 75 Jahre,793,391,402
False,8119006,Auenwald,75 und mehr Jahre,443,177,266
False,8119006,Auenwald,Insgesamt,6919,3440,3479
False,8119008,"Backnang, Stadt",unter 3 Jahre,846,444,402
False,8119008,"Backnang, Stadt",3 -  6 Jahre,912,460,452
False,8119008,"Backnang, Stadt",6 - 10 Jahre,1384,717,667
False,8119008,"Backnang, Stadt",10 - 15 Jahre,1955,970,985
False,8119008,"Backnang, Stadt",15 - 18 Jahre,1265,658,607
False,8119008,"Backnang, Stadt",18 - 20 Jahre,874,433,441
False,8119008,"Backnang, Stadt",20 - 25 Jahre,2068,1029,1039
False,8119008,"Backnang, Stadt",25 - 30 Jahre,2062,1104,958
False,8119008,"Backnang, Stadt",30 - 35 Jahre,1915,964,951
False,8119008,"Backnang, Stadt",35 - 40 Jahre,2146,1114,1032
False,8119008,"Backnang, Stadt",40 - 45 Jahre,2778,1468,1310
False,8119008,"Backnang, Stadt",45 - 50 Jahre,3101,1630,1471
False,8119008,"Backnang, Stadt",50 - 55 Jahre,2755,1447,1308
False,8119008,"Backnang, Stadt",55 - 60 Jahre,2259,1087,1172
False,8119008,"Backnang, Stadt",60 - 65 Jahre,1926,938,988
False,8119008,"Backnang, Stadt",65 - 75 Jahre,3809,1838,1971
False,8119008,"Backnang, Stadt",75 und mehr Jahre,3340,1304,2036
False,8119008,"Backnang, Stadt",Insgesamt,35395,17605,17790
False,8119018,Burgstetten,unter 3 Jahre,99,43,56
False,8119018,Burgstetten,3 -  6 Jahre,87,50,37
False,8119018,Burgstetten,6 - 10 Jahre,147,70,77
False,8119018,Burgstetten,10 - 15 Jahre,219,113,106
False,8119018,Burgstetten,15 - 18 Jahre,139,71,68
False,8119018,Burgstetten,18 - 20 Jahre,91,40,51
False,8119018,Burgstetten,20 - 25 Jahre,190,104,86
False,8119018,Burgstetten,25 - 30 Jahre,164,88,76
False,8119018,Burgstetten,30 - 35 Jahre,188,90,98
False,8119018,Burgstetten,35 - 40 Jahre,210,102,108
False,8119018,Burgstetten,40 - 45 Jahre,315,161,154
False,8119018,Burgstetten,45 - 50 Jahre,313,149,164
False,8119018,Burgstetten,50 - 55 Jahre,258,131,127
False,8119018,Burgstetten,55 - 60 Jahre,203,99,104
False,8119018,Burgstetten,60 - 65 Jahre,193,100,93
False,8119018,Burgstetten,65 - 75 Jahre,313,159,154
False,8119018,Burgstetten,75 und mehr Jahre,261,110,151
False,8119018,Burgstetten,Insgesamt,3390,1680,1710
False,8119020,"Fellbach, Stadt",unter 3 Jahre,1186,606,580
False,8119020,"Fellbach, Stadt",3 -  6 Jahre,1151,577,574
False,8119020,"Fellbach, Stadt",6 - 10 Jahre,1616,815,801
False,8119020,"Fellbach, Stadt",10 - 15 Jahre,2197,1128,1069
False,8119020,"Fellbach, Stadt",15 - 18 Jahre,1352,671,681
False,8119020,"Fellbach, Stadt",18 - 20 Jahre,874,472,402
False,8119020,"Fellbach, Stadt",20 - 25 Jahre,2466,1279,1187
False,8119020,"Fellbach, Stadt",25 - 30 Jahre,2731,1354,1377
False,8119020,"Fellbach, Stadt",30 - 35 Jahre,3019,1432,1587
False,8119020,"Fellbach, Stadt",35 - 40 Jahre,3164,1602,1562
False,8119020,"Fellbach, Stadt",40 - 45 Jahre,3866,2072,1794
False,8119020,"Fellbach, Stadt",45 - 50 Jahre,3817,1970,1847
False,8119020,"Fellbach, Stadt",50 - 55 Jahre,3167,1586,1581
False,8119020,"Fellbach, Stadt",55 - 60 Jahre,2647,1251,1396
False,8119020,"Fellbach, Stadt",60 - 65 Jahre,2388,1166,1222
False,8119020,"Fellbach, Stadt",65 - 75 Jahre,5027,2320,2707
False,8119020,"Fellbach, Stadt",75 und mehr Jahre,3997,1533,2464
False,8119020,"Fellbach, Stadt",Insgesamt,44665,21834,22831
False,8119024,Großerlach,unter 3 Jahre,38,16,22
False,8119024,Großerlach,3 -  6 Jahre,53,24,29
False,8119024,Großerlach,6 - 10 Jahre,74,39,35
False,8119024,Großerlach,10 - 15 Jahre,113,58,55
False,8119024,Großerlach,15 - 18 Jahre,79,41,38
False,8119024,Großerlach,18 - 20 Jahre,71,41,30
False,8119024,Großerlach,20 - 25 Jahre,126,60,66
False,8119024,Großerlach,25 - 30 Jahre,104,52,52
False,8119024,Großerlach,30 - 35 Jahre,88,49,39
False,8119024,Großerlach,35 - 40 Jahre,103,53,50
False,8119024,Großerlach,40 - 45 Jahre,194,103,91
False,8119024,Großerlach,45 - 50 Jahre,243,131,112
False,8119024,Großerlach,50 - 55 Jahre,247,155,92
False,8119024,Großerlach,55 - 60 Jahre,197,129,68
False,8119024,Großerlach,60 - 65 Jahre,172,101,71
False,8119024,Großerlach,65 - 75 Jahre,282,179,103
False,8119024,Großerlach,75 und mehr Jahre,304,104,200
False,8119024,Großerlach,Insgesamt,2488,1335,1153
False,8119037,Kaisersbach,unter 3 Jahre,58,31,27
False,8119037,Kaisersbach,3 -  6 Jahre,84,42,42
False,8119037,Kaisersbach,6 - 10 Jahre,89,58,31
False,8119037,Kaisersbach,10 - 15 Jahre,150,78,72
False,8119037,Kaisersbach,15 - 18 Jahre,119,50,69
False,8119037,Kaisersbach,18 - 20 Jahre,67,38,29
False,8119037,Kaisersbach,20 - 25 Jahre,163,92,71
False,8119037,Kaisersbach,25 - 30 Jahre,147,78,69
False,8119037,Kaisersbach,30 - 35 Jahre,135,66,69
False,8119037,Kaisersbach,35 - 40 Jahre,130,69,61
False,8119037,Kaisersbach,40 - 45 Jahre,238,110,128
False,8119037,Kaisersbach,45 - 50 Jahre,251,136,115
False,8119037,Kaisersbach,50 - 55 Jahre,208,108,100
False,8119037,Kaisersbach,55 - 60 Jahre,195,98,97
False,8119037,Kaisersbach,60 - 65 Jahre,135,69,66
False,8119037,Kaisersbach,65 - 75 Jahre,240,123,117
False,8119037,Kaisersbach,75 und mehr Jahre,242,96,146
False,8119037,Kaisersbach,Insgesamt,2651,1342,1309
False,8119038,Kirchberg an der Murr,unter 3 Jahre,101,52,49
False,8119038,Kirchberg an der Murr,3 -  6 Jahre,108,49,59
False,8119038,Kirchberg an der Murr,6 - 10 Jahre,173,79,94
False,8119038,Kirchberg an der Murr,10 - 15 Jahre,200,100,100
False,8119038,Kirchberg an der Murr,15 - 18 Jahre,129,64,65
False,8119038,Kirchberg an der Murr,18 - 20 Jahre,80,41,39
False,8119038,Kirchberg an der Murr,20 - 25 Jahre,193,106,87
False,8119038,Kirchberg an der Murr,25 - 30 Jahre,178,107,71
False,8119038,Kirchberg an der Murr,30 - 35 Jahre,199,93,106
False,8119038,Kirchberg an der Murr,35 - 40 Jahre,257,134,123
False,8119038,Kirchberg an der Murr,40 - 45 Jahre,305,151,154
False,8119038,Kirchberg an der Murr,45 - 50 Jahre,318,158,160
False,8119038,Kirchberg an der Murr,50 - 55 Jahre,265,142,123
False,8119038,Kirchberg an der Murr,55 - 60 Jahre,239,121,118
False,8119038,Kirchberg an der Murr,60 - 65 Jahre,179,89,90
False,8119038,Kirchberg an der Murr,65 - 75 Jahre,397,208,189
False,8119038,Kirchberg an der Murr,75 und mehr Jahre,335,152,183
False,8119038,Kirchberg an der Murr,Insgesamt,3656,1846,1810
False,8119041,Korb,unter 3 Jahre,251,137,114
False,8119041,Korb,3 -  6 Jahre,249,133,116
False,8119041,Korb,6 - 10 Jahre,366,178,188
False,8119041,Korb,10 - 15 Jahre,524,265,259
False,8119041,Korb,15 - 18 Jahre,371,177,194
False,8119041,Korb,18 - 20 Jahre,233,116,117
False,8119041,Korb,20 - 25 Jahre,529,265,264
False,8119041,Korb,25 - 30 Jahre,501,254,247
False,8119041,Korb,30 - 35 Jahre,588,291,297
False,8119041,Korb,35 - 40 Jahre,653,341,312
False,8119041,Korb,40 - 45 Jahre,906,451,455
False,8119041,Korb,45 - 50 Jahre,1004,516,488
False,8119041,Korb,50 - 55 Jahre,758,391,367
False,8119041,Korb,55 - 60 Jahre,645,330,315
False,8119041,Korb,60 - 65 Jahre,576,261,315
False,8119041,Korb,65 - 75 Jahre,1241,581,660
False,8119041,Korb,75 und mehr Jahre,934,405,529
False,8119041,Korb,Insgesamt,10329,5092,5237
False,8119042,Leutenbach,unter 3 Jahre,275,129,146
False,8119042,Leutenbach,3 -  6 Jahre,308,165,143
False,8119042,Leutenbach,6 - 10 Jahre,416,214,202
False,8119042,Leutenbach,10 - 15 Jahre,594,280,314
False,8119042,Leutenbach,15 - 18 Jahre,379,186,193
False,8119042,Leutenbach,18 - 20 Jahre,288,146,142
False,8119042,Leutenbach,20 - 25 Jahre,634,332,302
False,8119042,Leutenbach,25 - 30 Jahre,582,285,297
False,8119042,Leutenbach,30 - 35 Jahre,623,306,317
False,8119042,Leutenbach,35 - 40 Jahre,679,341,338
False,8119042,Leutenbach,40 - 45 Jahre,963,460,503
False,8119042,Leutenbach,45 - 50 Jahre,972,472,500
False,8119042,Leutenbach,50 - 55 Jahre,858,439,419
False,8119042,Leutenbach,55 - 60 Jahre,659,307,352
False,8119042,Leutenbach,60 - 65 Jahre,651,324,327
False,8119042,Leutenbach,65 - 75 Jahre,1254,612,642
False,8119042,Leutenbach,75 und mehr Jahre,814,346,468
False,8119042,Leutenbach,Insgesamt,10949,5344,5605
False,8119044,"Murrhardt, Stadt",unter 3 Jahre,300,141,159
False,8119044,"Murrhardt, Stadt",3 -  6 Jahre,339,168,171
False,8119044,"Murrhardt, Stadt",6 - 10 Jahre,516,239,277
False,8119044,"Murrhardt, Stadt",10 - 15 Jahre,758,365,393
False,8119044,"Murrhardt, Stadt",15 - 18 Jahre,454,243,211
False,8119044,"Murrhardt, Stadt",18 - 20 Jahre,315,147,168
False,8119044,"Murrhardt, Stadt",20 - 25 Jahre,764,420,344
False,8119044,"Murrhardt, Stadt",25 - 30 Jahre,726,363,363
False,8119044,"Murrhardt, Stadt",30 - 35 Jahre,686,359,327
False,8119044,"Murrhardt, Stadt",35 - 40 Jahre,758,388,370
False,8119044,"Murrhardt, Stadt",40 - 45 Jahre,1027,534,493
False,8119044,"Murrhardt, Stadt",45 - 50 Jahre,1205,604,601
False,8119044,"Murrhardt, Stadt",50 - 55 Jahre,1126,591,535
False,8119044,"Murrhardt, Stadt",55 - 60 Jahre,994,500,494
False,8119044,"Murrhardt, Stadt",60 - 65 Jahre,793,393,400
False,8119044,"Murrhardt, Stadt",65 - 75 Jahre,1676,816,860
False,8119044,"Murrhardt, Stadt",75 und mehr Jahre,1469,540,929
False,8119044,"Murrhardt, Stadt",Insgesamt,13906,6811,7095
False,8119053,Oppenweiler,unter 3 Jahre,88,42,46
False,8119053,Oppenweiler,3 -  6 Jahre,110,61,49
False,8119053,Oppenweiler,6 - 10 Jahre,173,88,85
False,8119053,Oppenweiler,10 - 15 Jahre,212,112,100
False,8119053,Oppenweiler,15 - 18 Jahre,135,69,66
False,8119053,Oppenweiler,18 - 20 Jahre,103,53,50
False,8119053,Oppenweiler,20 - 25 Jahre,251,149,102
False,8119053,Oppenweiler,25 - 30 Jahre,209,102,107
False,8119053,Oppenweiler,30 - 35 Jahre,213,109,104
False,8119053,Oppenweiler,35 - 40 Jahre,213,98,115
False,8119053,Oppenweiler,40 - 45 Jahre,319,162,157
False,8119053,Oppenweiler,45 - 50 Jahre,391,188,203
False,8119053,Oppenweiler,50 - 55 Jahre,352,179,173
False,8119053,Oppenweiler,55 - 60 Jahre,265,132,133
False,8119053,Oppenweiler,60 - 65 Jahre,226,115,111
False,8119053,Oppenweiler,65 - 75 Jahre,460,219,241
False,8119053,Oppenweiler,75 und mehr Jahre,371,156,215
False,8119053,Oppenweiler,Insgesamt,4091,2034,2057
False,8119055,Plüderhausen,unter 3 Jahre,199,96,103
False,8119055,Plüderhausen,3 -  6 Jahre,250,134,116
False,8119055,Plüderhausen,6 - 10 Jahre,348,174,174
False,8119055,Plüderhausen,10 - 15 Jahre,529,275,254
False,8119055,Plüderhausen,15 - 18 Jahre,313,182,131
False,8119055,Plüderhausen,18 - 20 Jahre,199,93,106
False,8119055,Plüderhausen,20 - 25 Jahre,503,257,246
False,8119055,Plüderhausen,25 - 30 Jahre,480,249,231
False,8119055,Plüderhausen,30 - 35 Jahre,467,246,221
False,8119055,Plüderhausen,35 - 40 Jahre,566,270,296
False,8119055,Plüderhausen,40 - 45 Jahre,802,409,393
False,8119055,Plüderhausen,45 - 50 Jahre,842,417,425
False,8119055,Plüderhausen,50 - 55 Jahre,724,366,358
False,8119055,Plüderhausen,55 - 60 Jahre,597,307,290
False,8119055,Plüderhausen,60 - 65 Jahre,551,249,302
False,8119055,Plüderhausen,65 - 75 Jahre,1094,533,561
False,8119055,Plüderhausen,75 und mehr Jahre,834,322,512
False,8119055,Plüderhausen,Insgesamt,9298,4579,4719
False,8119061,Rudersberg,unter 3 Jahre,266,140,126
False,8119061,Rudersberg,3 -  6 Jahre,286,152,134
False,8119061,Rudersberg,6 - 10 Jahre,426,198,228
False,8119061,Rudersberg,10 - 15 Jahre,734,385,349
False,8119061,Rudersberg,15 - 18 Jahre,417,217,200
False,8119061,Rudersberg,18 - 20 Jahre,301,151,150
False,8119061,Rudersberg,20 - 25 Jahre,658,356,302
False,8119061,Rudersberg,25 - 30 Jahre,616,321,295
False,8119061,Rudersberg,30 - 35 Jahre,573,269,304
False,8119061,Rudersberg,35 - 40 Jahre,612,330,282
False,8119061,Rudersberg,40 - 45 Jahre,949,450,499
False,8119061,Rudersberg,45 - 50 Jahre,1089,562,527
False,8119061,Rudersberg,50 - 55 Jahre,849,426,423
False,8119061,Rudersberg,55 - 60 Jahre,797,388,409
False,8119061,Rudersberg,60 - 65 Jahre,642,327,315
False,8119061,Rudersberg,65 - 75 Jahre,1216,585,631
False,8119061,Rudersberg,75 und mehr Jahre,996,419,577
False,8119061,Rudersberg,Insgesamt,11427,5676,5751
False,8119067,"Schorndorf, Stadt",unter 3 Jahre,1038,523,515
False,8119067,"Schorndorf, Stadt",3 -  6 Jahre,1049,570,479
False,8119067,"Schorndorf, Stadt",6 - 10 Jahre,1476,741,735
False,8119067,"Schorndorf, Stadt",10 - 15 Jahre,2089,1052,1037
False,8119067,"Schorndorf, Stadt",15 - 18 Jahre,1245,633,612
False,8119067,"Schorndorf, Stadt",18 - 20 Jahre,921,462,459
False,8119067,"Schorndorf, Stadt",20 - 25 Jahre,2156,1141,1015
False,8119067,"Schorndorf, Stadt",25 - 30 Jahre,2080,1028,1052
False,8119067,"Schorndorf, Stadt",30 - 35 Jahre,2230,1100,1130
False,8119067,"Schorndorf, Stadt",35 - 40 Jahre,2345,1163,1182
False,8119067,"Schorndorf, Stadt",40 - 45 Jahre,3171,1575,1596
False,8119067,"Schorndorf, Stadt",45 - 50 Jahre,3282,1703,1579
False,8119067,"Schorndorf, Stadt",50 - 55 Jahre,2842,1409,1433
False,8119067,"Schorndorf, Stadt",55 - 60 Jahre,2592,1251,1341
False,8119067,"Schorndorf, Stadt",60 - 65 Jahre,2284,1090,1194
False,8119067,"Schorndorf, Stadt",65 - 75 Jahre,4623,2144,2479
False,8119067,"Schorndorf, Stadt",75 und mehr Jahre,3813,1485,2328
False,8119067,"Schorndorf, Stadt",Insgesamt,39236,19070,20166
False,8119068,Schwaikheim,unter 3 Jahre,234,117,117
False,8119068,Schwaikheim,3 -  6 Jahre,276,127,149
False,8119068,Schwaikheim,6 - 10 Jahre,358,182,176
False,8119068,Schwaikheim,10 - 15 Jahre,572,276,296
False,8119068,Schwaikheim,15 - 18 Jahre,323,168,155
False,8119068,Schwaikheim,18 - 20 Jahre,219,119,100
False,8119068,Schwaikheim,20 - 25 Jahre,493,262,231
False,8119068,Schwaikheim,25 - 30 Jahre,502,246,256
False,8119068,Schwaikheim,30 - 35 Jahre,520,254,266
False,8119068,Schwaikheim,35 - 40 Jahre,595,298,297
False,8119068,Schwaikheim,40 - 45 Jahre,831,420,411
False,8119068,Schwaikheim,45 - 50 Jahre,873,437,436
False,8119068,Schwaikheim,50 - 55 Jahre,691,371,320
False,8119068,Schwaikheim,55 - 60 Jahre,569,264,305
False,8119068,Schwaikheim,60 - 65 Jahre,543,277,266
False,8119068,Schwaikheim,65 - 75 Jahre,1003,461,542
False,8119068,Schwaikheim,75 und mehr Jahre,743,306,437
False,8119068,Schwaikheim,Insgesamt,9345,4585,4760
False,8119069,Spiegelberg,unter 3 Jahre,47,27,20
False,8119069,Spiegelberg,3 -  6 Jahre,61,36,25
False,8119069,Spiegelberg,6 - 10 Jahre,67,34,33
False,8119069,Spiegelberg,10 - 15 Jahre,107,68,39
False,8119069,Spiegelberg,15 - 18 Jahre,85,48,37
False,8119069,Spiegelberg,18 - 20 Jahre,71,38,33
False,8119069,Spiegelberg,20 - 25 Jahre,138,77,61
False,8119069,Spiegelberg,25 - 30 Jahre,113,59,54
False,8119069,Spiegelberg,30 - 35 Jahre,104,53,51
False,8119069,Spiegelberg,35 - 40 Jahre,114,60,54
False,8119069,Spiegelberg,40 - 45 Jahre,182,107,75
False,8119069,Spiegelberg,45 - 50 Jahre,211,104,107
False,8119069,Spiegelberg,50 - 55 Jahre,207,116,91
False,8119069,Spiegelberg,55 - 60 Jahre,155,84,71
False,8119069,Spiegelberg,60 - 65 Jahre,94,57,37
False,8119069,Spiegelberg,65 - 75 Jahre,192,85,107
False,8119069,Spiegelberg,75 und mehr Jahre,187,65,122
False,8119069,Spiegelberg,Insgesamt,2135,1118,1017
False,8119075,Sulzbach an der Murr,unter 3 Jahre,113,45,68
False,8119075,Sulzbach an der Murr,3 -  6 Jahre,139,75,64
False,8119075,Sulzbach an der Murr,6 - 10 Jahre,193,101,92
False,8119075,Sulzbach an der Murr,10 - 15 Jahre,306,154,152
False,8119075,Sulzbach an der Murr,15 - 18 Jahre,218,104,114
False,8119075,Sulzbach an der Murr,18 - 20 Jahre,141,71,70
False,8119075,Sulzbach an der Murr,20 - 25 Jahre,328,165,163
False,8119075,Sulzbach an der Murr,25 - 30 Jahre,263,132,131
False,8119075,Sulzbach an der Murr,30 - 35 Jahre,259,135,124
False,8119075,Sulzbach an der Murr,35 - 40 Jahre,330,148,182
False,8119075,Sulzbach an der Murr,40 - 45 Jahre,450,219,231
False,8119075,Sulzbach an der Murr,45 - 50 Jahre,447,222,225
False,8119075,Sulzbach an der Murr,50 - 55 Jahre,416,207,209
False,8119075,Sulzbach an der Murr,55 - 60 Jahre,314,161,153
False,8119075,Sulzbach an der Murr,60 - 65 Jahre,306,152,154
False,8119075,Sulzbach an der Murr,65 - 75 Jahre,594,276,318
False,8119075,Sulzbach an der Murr,75 und mehr Jahre,494,178,316
False,8119075,Sulzbach an der Murr,Insgesamt,5311,2545,2766
False,8119076,Urbach,unter 3 Jahre,234,111,123
False,8119076,Urbach,3 -  6 Jahre,291,146,145
False,8119076,Urbach,6 - 10 Jahre,379,195,184
False,8119076,Urbach,10 - 15 Jahre,531,279,252
False,8119076,Urbach,15 - 18 Jahre,293,143,150
False,8119076,Urbach,18 - 20 Jahre,232,111,121
False,8119076,Urbach,20 - 25 Jahre,469,264,205
False,8119076,Urbach,25 - 30 Jahre,465,231,234
False,8119076,Urbach,30 - 35 Jahre,445,220,225
False,8119076,Urbach,35 - 40 Jahre,574,290,284
False,8119076,Urbach,40 - 45 Jahre,823,416,407
False,8119076,Urbach,45 - 50 Jahre,764,395,369
False,8119076,Urbach,50 - 55 Jahre,630,328,302
False,8119076,Urbach,55 - 60 Jahre,471,225,246
False,8119076,Urbach,60 - 65 Jahre,441,213,228
False,8119076,Urbach,65 - 75 Jahre,870,416,454
False,8119076,Urbach,75 und mehr Jahre,745,280,465
False,8119076,Urbach,Insgesamt,8657,4263,4394
False,8119079,"Waiblingen, Stadt",unter 3 Jahre,1394,725,669
False,8119079,"Waiblingen, Stadt",3 -  6 Jahre,1493,760,733
False,8119079,"Waiblingen, Stadt",6 - 10 Jahre,2026,1006,1020
False,8119079,"Waiblingen, Stadt",10 - 15 Jahre,2736,1390,1346
False,8119079,"Waiblingen, Stadt",15 - 18 Jahre,1740,876,864
False,8119079,"Waiblingen, Stadt",18 - 20 Jahre,1213,647,566
False,8119079,"Waiblingen, Stadt",20 - 25 Jahre,2903,1514,1389
False,8119079,"Waiblingen, Stadt",25 - 30 Jahre,3004,1454,1550
False,8119079,"Waiblingen, Stadt",30 - 35 Jahre,3343,1644,1699
False,8119079,"Waiblingen, Stadt",35 - 40 Jahre,3535,1786,1749
False,8119079,"Waiblingen, Stadt",40 - 45 Jahre,4441,2254,2187
False,8119079,"Waiblingen, Stadt",45 - 50 Jahre,4599,2366,2233
False,8119079,"Waiblingen, Stadt",50 - 55 Jahre,3965,2007,1958
False,8119079,"Waiblingen, Stadt",55 - 60 Jahre,3249,1565,1684
False,8119079,"Waiblingen, Stadt",60 - 65 Jahre,2920,1380,1540
False,8119079,"Waiblingen, Stadt",65 - 75 Jahre,6071,2853,3218
False,8119079,"Waiblingen, Stadt",75 und mehr Jahre,4268,1658,2610
False,8119079,"Waiblingen, Stadt",Insgesamt,52900,25885,27015
False,8119083,Weissach im Tal,unter 3 Jahre,125,62,63
False,8119083,Weissach im Tal,3 -  6 Jahre,181,80,101
False,8119083,Weissach im Tal,6 - 10 Jahre,239,119,120
False,8119083,Weissach im Tal,10 - 15 Jahre,415,220,195
False,8119083,Weissach im Tal,15 - 18 Jahre,280,150,130
False,8119083,Weissach im Tal,18 - 20 Jahre,182,104,78
False,8119083,Weissach im Tal,20 - 25 Jahre,400,200,200
False,8119083,Weissach im Tal,25 - 30 Jahre,362,192,170
False,8119083,Weissach im Tal,30 - 35 Jahre,342,158,184
False,8119083,Weissach im Tal,35 - 40 Jahre,387,189,198
False,8119083,Weissach im Tal,40 - 45 Jahre,534,256,278
False,8119083,Weissach im Tal,45 - 50 Jahre,676,343,333
False,8119083,Weissach im Tal,50 - 55 Jahre,565,282,283
False,8119083,Weissach im Tal,55 - 60 Jahre,497,246,251
False,8119083,Weissach im Tal,60 - 65 Jahre,408,216,192
False,8119083,Weissach im Tal,65 - 75 Jahre,807,388,419
False,8119083,Weissach im Tal,75 und mehr Jahre,629,253,376
False,8119083,Weissach im Tal,Insgesamt,7029,3458,3571
False,8119084,"Welzheim, Stadt",unter 3 Jahre,287,149,138
False,8119084,"Welzheim, Stadt",3 -  6 Jahre,290,154,136
False,8119084,"Welzheim, Stadt",6 - 10 Jahre,446,236,210
False,8119084,"Welzheim, Stadt",10 - 15 Jahre,631,317,314
False,8119084,"Welzheim, Stadt",15 - 18 Jahre,413,228,185
False,8119084,"Welzheim, Stadt",18 - 20 Jahre,288,160,128
False,8119084,"Welzheim, Stadt",20 - 25 Jahre,719,340,379
False,8119084,"Welzheim, Stadt",25 - 30 Jahre,646,330,316
False,8119084,"Welzheim, Stadt",30 - 35 Jahre,615,310,305
False,8119084,"Welzheim, Stadt",35 - 40 Jahre,680,363,317
False,8119084,"Welzheim, Stadt",40 - 45 Jahre,825,390,435
False,8119084,"Welzheim, Stadt",45 - 50 Jahre,987,509,478
False,8119084,"Welzheim, Stadt",50 - 55 Jahre,840,432,408
False,8119084,"Welzheim, Stadt",55 - 60 Jahre,676,316,360
False,8119084,"Welzheim, Stadt",60 - 65 Jahre,587,304,283
False,8119084,"Welzheim, Stadt",65 - 75 Jahre,1125,529,596
False,8119084,"Welzheim, Stadt",75 und mehr Jahre,970,347,623
False,8119084,"Welzheim, Stadt",Insgesamt,11025,5414,5611
False,8119085,"Winnenden, Stadt",unter 3 Jahre,623,323,300
False,8119085,"Winnenden, Stadt",3 -  6 Jahre,735,399,336
False,8119085,"Winnenden, Stadt",6 - 10 Jahre,1117,574,543
False,8119085,"Winnenden, Stadt",10 - 15 Jahre,1523,777,746
False,8119085,"Winnenden, Stadt",15 - 18 Jahre,990,485,505
False,8119085,"Winnenden, Stadt",18 - 20 Jahre,645,337,308
False,8119085,"Winnenden, Stadt",20 - 25 Jahre,1476,757,719
False,8119085,"Winnenden, Stadt",25 - 30 Jahre,1561,759,802
False,8119085,"Winnenden, Stadt",30 - 35 Jahre,1609,784,825
False,8119085,"Winnenden, Stadt",35 - 40 Jahre,1745,860,885
False,8119085,"Winnenden, Stadt",40 - 45 Jahre,2393,1205,1188
False,8119085,"Winnenden, Stadt",45 - 50 Jahre,2531,1311,1220
False,8119085,"Winnenden, Stadt",50 - 55 Jahre,2111,1104,1007
False,8119085,"Winnenden, Stadt",55 - 60 Jahre,1669,837,832
False,8119085,"Winnenden, Stadt",60 - 65 Jahre,1458,699,759
False,8119085,"Winnenden, Stadt",65 - 75 Jahre,3037,1423,1614
False,8119085,"Winnenden, Stadt",75 und mehr Jahre,2376,999,1377
False,8119085,"Winnenden, Stadt",Insgesamt,27599,13633,13966
False,8119086,Winterbach,unter 3 Jahre,207,104,103
False,8119086,Winterbach,3 -  6 Jahre,201,90,111
False,8119086,Winterbach,6 - 10 Jahre,306,170,136
False,8119086,Winterbach,10 - 15 Jahre,430,220,210
False,8119086,Winterbach,15 - 18 Jahre,273,121,152
False,8119086,Winterbach,18 - 20 Jahre,199,88,111
False,8119086,Winterbach,20 - 25 Jahre,415,227,188
False,8119086,Winterbach,25 - 30 Jahre,386,179,207
False,8119086,Winterbach,30 - 35 Jahre,383,194,189
False,8119086,Winterbach,35 - 40 Jahre,476,226,250
False,8119086,Winterbach,40 - 45 Jahre,640,311,329
False,8119086,Winterbach,45 - 50 Jahre,660,343,317
False,8119086,Winterbach,50 - 55 Jahre,563,278,285
False,8119086,Winterbach,55 - 60 Jahre,519,234,285
False,8119086,Winterbach,60 - 65 Jahre,464,233,231
False,8119086,Winterbach,65 - 75 Jahre,856,399,457
False,8119086,Winterbach,75 und mehr Jahre,700,245,455
False,8119086,Winterbach,Insgesamt,7678,3662,4016
False,8119087,Aspach,unter 3 Jahre,186,97,89
False,8119087,Aspach,3 -  6 Jahre,207,103,104
False,8119087,Aspach,6 - 10 Jahre,346,195,151
False,8119087,Aspach,10 - 15 Jahre,517,247,270
False,8119087,Aspach,15 - 18 Jahre,331,158,173
False,8119087,Aspach,18 - 20 Jahre,183,103,80
False,8119087,Aspach,20 - 25 Jahre,447,243,204
False,8119087,Aspach,25 - 30 Jahre,384,187,197
False,8119087,Aspach,30 - 35 Jahre,442,227,215
False,8119087,Aspach,35 - 40 Jahre,504,238,266
False,8119087,Aspach,40 - 45 Jahre,729,356,373
False,8119087,Aspach,45 - 50 Jahre,723,369,354
False,8119087,Aspach,50 - 55 Jahre,639,331,308
False,8119087,Aspach,55 - 60 Jahre,533,264,269
False,8119087,Aspach,60 - 65 Jahre,460,240,220
False,8119087,Aspach,65 - 75 Jahre,859,412,447
False,8119087,Aspach,75 und mehr Jahre,729,287,442
False,8119087,Aspach,Insgesamt,8219,4057,4162
False,8119089,Berglen,unter 3 Jahre,135,73,62
False,8119089,Berglen,3 -  6 Jahre,155,73,82
False,8119089,Berglen,6 - 10 Jahre,234,108,126
False,8119089,Berglen,10 - 15 Jahre,358,181,177
False,8119089,Berglen,15 - 18 Jahre,226,120,106
False,8119089,Berglen,18 - 20 Jahre,147,76,71
False,8119089,Berglen,20 - 25 Jahre,299,161,138
False,8119089,Berglen,25 - 30 Jahre,246,148,98
False,8119089,Berglen,30 - 35 Jahre,277,131,146
False,8119089,Berglen,35 - 40 Jahre,382,195,187
False,8119089,Berglen,40 - 45 Jahre,590,311,279
False,8119089,Berglen,45 - 50 Jahre,595,294,301
False,8119089,Berglen,50 - 55 Jahre,515,261,254
False,8119089,Berglen,55 - 60 Jahre,392,202,190
False,8119089,Berglen,60 - 65 Jahre,331,175,156
False,8119089,Berglen,65 - 75 Jahre,666,330,336
False,8119089,Berglen,75 und mehr Jahre,447,176,271
False,8119089,Berglen,Insgesamt,5995,3015,2980
False,8119090,Remshalden,unter 3 Jahre,318,181,137
False,8119090,Remshalden,3 -  6 Jahre,345,188,157
False,8119090,Remshalden,6 - 10 Jahre,494,267,227
False,8119090,Remshalden,10 - 15 Jahre,708,339,369
False,8119090,Remshalden,15 - 18 Jahre,442,235,207
False,8119090,Remshalden,18 - 20 Jahre,322,167,155
False,8119090,Remshalden,20 - 25 Jahre,745,389,356
False,8119090,Remshalden,25 - 30 Jahre,711,348,363
False,8119090,Remshalden,30 - 35 Jahre,661,320,341
False,8119090,Remshalden,35 - 40 Jahre,803,392,411
False,8119090,Remshalden,40 - 45 Jahre,1102,555,547
False,8119090,Remshalden,45 - 50 Jahre,1198,621,577
False,8119090,Remshalden,50 - 55 Jahre,973,484,489
False,8119090,Remshalden,55 - 60 Jahre,831,418,413
False,8119090,Remshalden,60 - 65 Jahre,821,377,444
False,8119090,Remshalden,65 - 75 Jahre,1670,800,870
False,8119090,Remshalden,75 und mehr Jahre,1242,523,719
False,8119090,Remshalden,Insgesamt,13386,6604,6782
False,8119091,"Weinstadt, Stadt",unter 3 Jahre,658,342,316
False,8119091,"Weinstadt, Stadt",3 -  6 Jahre,730,363,367
False,8119091,"Weinstadt, Stadt",6 - 10 Jahre,1020,546,474
False,8119091,"Weinstadt, Stadt",10 - 15 Jahre,1467,753,714
False,8119091,"Weinstadt, Stadt",15 - 18 Jahre,873,445,428
False,8119091,"Weinstadt, Stadt",18 - 20 Jahre,624,331,293
False,8119091,"Weinstadt, Stadt",20 - 25 Jahre,1277,643,634
False,8119091,"Weinstadt, Stadt",25 - 30 Jahre,1268,622,646
False,8119091,"Weinstadt, Stadt",30 - 35 Jahre,1456,692,764
False,8119091,"Weinstadt, Stadt",35 - 40 Jahre,1732,814,918
False,8119091,"Weinstadt, Stadt",40 - 45 Jahre,2373,1187,1186
False,8119091,"Weinstadt, Stadt",45 - 50 Jahre,2267,1179,1088
False,8119091,"Weinstadt, Stadt",50 - 55 Jahre,1863,940,923
False,8119091,"Weinstadt, Stadt",55 - 60 Jahre,1698,809,889
False,8119091,"Weinstadt, Stadt",60 - 65 Jahre,1481,706,775
False,8119091,"Weinstadt, Stadt",65 - 75 Jahre,3269,1564,1705
False,8119091,"Weinstadt, Stadt",75 und mehr Jahre,2365,933,1432
False,8119091,"Weinstadt, Stadt",Insgesamt,26421,12869,13552
False,8119093,Kernen im Remstal,unter 3 Jahre,348,161,187
False,8119093,Kernen im Remstal,3 -  6 Jahre,394,194,200
False,8119093,Kernen im Remstal,6 - 10 Jahre,564,282,282
False,8119093,Kernen im Remstal,10 - 15 Jahre,796,427,369
False,8119093,Kernen im Remstal,15 - 18 Jahre,469,251,218
False,8119093,Kernen im Remstal,18 - 20 Jahre,330,171,159
False,8119093,Kernen im Remstal,20 - 25 Jahre,813,403,410
False,8119093,Kernen im Remstal,25 - 30 Jahre,835,443,392
False,8119093,Kernen im Remstal,30 - 35 Jahre,901,429,472
False,8119093,Kernen im Remstal,35 - 40 Jahre,947,452,495
False,8119093,Kernen im Remstal,40 - 45 Jahre,1462,758,704
False,8119093,Kernen im Remstal,45 - 50 Jahre,1368,706,662
False,8119093,Kernen im Remstal,50 - 55 Jahre,1145,555,590
False,8119093,Kernen im Remstal,55 - 60 Jahre,940,471,469
False,8119093,Kernen im Remstal,60 - 65 Jahre,805,398,407
False,8119093,Kernen im Remstal,65 - 75 Jahre,1786,849,937
False,8119093,Kernen im Remstal,75 und mehr Jahre,1417,525,892
False,8119093,Kernen im Remstal,Insgesamt,15320,7475,7845
False,8121,Stadtkreis Heilbronn,unter 3 Jahre,3180,1654,1526
False,8121,Stadtkreis Heilbronn,3 -  6 Jahre,3375,1729,1646
False,8121,Stadtkreis Heilbronn,6 - 10 Jahre,4473,2347,2126
False,8121,Stadtkreis Heilbronn,10 - 15 Jahre,5880,3002,2878
False,8121,Stadtkreis Heilbronn,15 - 18 Jahre,3637,1850,1787
False,8121,Stadtkreis Heilbronn,18 - 20 Jahre,2647,1312,1335
False,8121,Stadtkreis Heilbronn,20 - 25 Jahre,7805,3893,3912
False,8121,Stadtkreis Heilbronn,25 - 30 Jahre,8386,4221,4165
False,8121,Stadtkreis Heilbronn,30 - 35 Jahre,8138,4202,3936
False,8121,Stadtkreis Heilbronn,35 - 40 Jahre,8285,4316,3969
False,8121,Stadtkreis Heilbronn,40 - 45 Jahre,9526,5020,4506
False,8121,Stadtkreis Heilbronn,45 - 50 Jahre,9946,5271,4675
False,8121,Stadtkreis Heilbronn,50 - 55 Jahre,8689,4442,4247
False,8121,Stadtkreis Heilbronn,55 - 60 Jahre,7463,3636,3827
False,8121,Stadtkreis Heilbronn,60 - 65 Jahre,6633,3231,3402
False,8121,Stadtkreis Heilbronn,65 - 75 Jahre,13505,6361,7144
False,8121,Stadtkreis Heilbronn,75 und mehr Jahre,11311,4235,7076
False,8121,Stadtkreis Heilbronn,Insgesamt,122879,60722,62157
False,8121000,"Heilbronn, Stadt",unter 3 Jahre,3180,1654,1526
False,8121000,"Heilbronn, Stadt",3 -  6 Jahre,3375,1729,1646
False,8121000,"Heilbronn, Stadt",6 - 10 Jahre,4473,2347,2126
False,8121000,"Heilbronn, Stadt",10 - 15 Jahre,5880,3002,2878
False,8121000,"Heilbronn, Stadt",15 - 18 Jahre,3637,1850,1787
False,8121000,"Heilbronn, Stadt",18 - 20 Jahre,2647,1312,1335
False,8121000,"Heilbronn, Stadt",20 - 25 Jahre,7805,3893,3912
False,8121000,"Heilbronn, Stadt",25 - 30 Jahre,8386,4221,4165
False,8121000,"Heilbronn, Stadt",30 - 35 Jahre,8138,4202,3936
False,8121000,"Heilbronn, Stadt",35 - 40 Jahre,8285,4316,3969
False,8121000,"Heilbronn, Stadt",40 - 45 Jahre,9526,5020,4506
False,8121000,"Heilbronn, Stadt",45 - 50 Jahre,9946,5271,4675
False,8121000,"Heilbronn, Stadt",50 - 55 Jahre,8689,4442,4247
False,8121000,"Heilbronn, Stadt",55 - 60 Jahre,7463,3636,3827
False,8121000,"Heilbronn, Stadt",60 - 65 Jahre,6633,3231,3402
False,8121000,"Heilbronn, Stadt",65 - 75 Jahre,13505,6361,7144
False,8121000,"Heilbronn, Stadt",75 und mehr Jahre,11311,4235,7076
False,8121000,"Heilbronn, Stadt",Insgesamt,122879,60722,62157
False,8125,Landkreis Heilbronn,unter 3 Jahre,8262,4164,4098
False,8125,Landkreis Heilbronn,3 -  6 Jahre,8781,4541,4240
False,8125,Landkreis Heilbronn,6 - 10 Jahre,13311,6693,6618
False,8125,Landkreis Heilbronn,10 - 15 Jahre,19275,9886,9389
False,8125,Landkreis Heilbronn,15 - 18 Jahre,11948,6181,5767
False,8125,Landkreis Heilbronn,18 - 20 Jahre,8145,4263,3882
False,8125,Landkreis Heilbronn,20 - 25 Jahre,19320,10165,9155
False,8125,Landkreis Heilbronn,25 - 30 Jahre,18172,9263,8909
False,8125,Landkreis Heilbronn,30 - 35 Jahre,19267,9684,9583
False,8125,Landkreis Heilbronn,35 - 40 Jahre,21130,10593,10537
False,8125,Landkreis Heilbronn,40 - 45 Jahre,27882,14261,13621
False,8125,Landkreis Heilbronn,45 - 50 Jahre,29364,14993,14371
False,8125,Landkreis Heilbronn,50 - 55 Jahre,25106,12960,12146
False,8125,Landkreis Heilbronn,55 - 60 Jahre,21090,10516,10574
False,8125,Landkreis Heilbronn,60 - 65 Jahre,17742,8729,9013
False,8125,Landkreis Heilbronn,65 - 75 Jahre,32896,15854,17042
False,8125,Landkreis Heilbronn,75 und mehr Jahre,26673,10416,16257
False,8125,Landkreis Heilbronn,Insgesamt,328364,163162,165202
False,8125001,Abstatt,unter 3 Jahre,113,48,65
False,8125001,Abstatt,3 -  6 Jahre,151,71,80
False,8125001,Abstatt,6 - 10 Jahre,183,87,96
False,8125001,Abstatt,10 - 15 Jahre,252,147,105
False,8125001,Abstatt,15 - 18 Jahre,168,86,82
False,8125001,Abstatt,18 - 20 Jahre,113,55,58
False,8125001,Abstatt,20 - 25 Jahre,237,117,120
False,8125001,Abstatt,25 - 30 Jahre,262,144,118
False,8125001,Abstatt,30 - 35 Jahre,262,131,131
False,8125001,Abstatt,35 - 40 Jahre,295,148,147
False,8125001,Abstatt,40 - 45 Jahre,435,217,218
False,8125001,Abstatt,45 - 50 Jahre,383,195,188
False,8125001,Abstatt,50 - 55 Jahre,344,182,162
False,8125001,Abstatt,55 - 60 Jahre,323,157,166
False,8125001,Abstatt,60 - 65 Jahre,245,114,131
False,8125001,Abstatt,65 - 75 Jahre,433,215,218
False,8125001,Abstatt,75 und mehr Jahre,287,109,178
False,8125001,Abstatt,Insgesamt,4486,2223,2263
False,8125005,"Bad Friedrichshall, Stadt",unter 3 Jahre,493,250,243
False,8125005,"Bad Friedrichshall, Stadt",3 -  6 Jahre,557,311,246
False,8125005,"Bad Friedrichshall, Stadt",6 - 10 Jahre,854,440,414
False,8125005,"Bad Friedrichshall, Stadt",10 - 15 Jahre,1125,571,554
False,8125005,"Bad Friedrichshall, Stadt",15 - 18 Jahre,700,381,319
False,8125005,"Bad Friedrichshall, Stadt",18 - 20 Jahre,471,231,240
False,8125005,"Bad Friedrichshall, Stadt",20 - 25 Jahre,1190,641,549
False,8125005,"Bad Friedrichshall, Stadt",25 - 30 Jahre,1174,588,586
False,8125005,"Bad Friedrichshall, Stadt",30 - 35 Jahre,1226,592,634
False,8125005,"Bad Friedrichshall, Stadt",35 - 40 Jahre,1343,711,632
False,8125005,"Bad Friedrichshall, Stadt",40 - 45 Jahre,1601,826,775
False,8125005,"Bad Friedrichshall, Stadt",45 - 50 Jahre,1717,824,893
False,8125005,"Bad Friedrichshall, Stadt",50 - 55 Jahre,1404,745,659
False,8125005,"Bad Friedrichshall, Stadt",55 - 60 Jahre,1148,590,558
False,8125005,"Bad Friedrichshall, Stadt",60 - 65 Jahre,905,453,452
False,8125005,"Bad Friedrichshall, Stadt",65 - 75 Jahre,1516,708,808
False,8125005,"Bad Friedrichshall, Stadt",75 und mehr Jahre,1338,519,819
False,8125005,"Bad Friedrichshall, Stadt",Insgesamt,18762,9381,9381
False,8125006,"Bad Rappenau, Stadt",unter 3 Jahre,490,233,257
False,8125006,"Bad Rappenau, Stadt",3 -  6 Jahre,528,289,239
False,8125006,"Bad Rappenau, Stadt",6 - 10 Jahre,774,360,414
False,8125006,"Bad Rappenau, Stadt",10 - 15 Jahre,1178,608,570
False,8125006,"Bad Rappenau, Stadt",15 - 18 Jahre,663,357,306
False,8125006,"Bad Rappenau, Stadt",18 - 20 Jahre,406,220,186
False,8125006,"Bad Rappenau, Stadt",20 - 25 Jahre,1065,542,523
False,8125006,"Bad Rappenau, Stadt",25 - 30 Jahre,1114,521,593
False,8125006,"Bad Rappenau, Stadt",30 - 35 Jahre,1211,599,612
False,8125006,"Bad Rappenau, Stadt",35 - 40 Jahre,1318,678,640
False,8125006,"Bad Rappenau, Stadt",40 - 45 Jahre,1649,854,795
False,8125006,"Bad Rappenau, Stadt",45 - 50 Jahre,1878,920,958
False,8125006,"Bad Rappenau, Stadt",50 - 55 Jahre,1650,839,811
False,8125006,"Bad Rappenau, Stadt",55 - 60 Jahre,1366,676,690
False,8125006,"Bad Rappenau, Stadt",60 - 65 Jahre,1154,537,617
False,8125006,"Bad Rappenau, Stadt",65 - 75 Jahre,2152,1026,1126
False,8125006,"Bad Rappenau, Stadt",75 und mehr Jahre,1909,714,1195
False,8125006,"Bad Rappenau, Stadt",Insgesamt,20505,9973,10532
False,8125007,"Bad Wimpfen, Stadt",unter 3 Jahre,148,93,55
False,8125007,"Bad Wimpfen, Stadt",3 -  6 Jahre,164,88,76
False,8125007,"Bad Wimpfen, Stadt",6 - 10 Jahre,243,124,119
False,8125007,"Bad Wimpfen, Stadt",10 - 15 Jahre,340,171,169
False,8125007,"Bad Wimpfen, Stadt",15 - 18 Jahre,188,102,86
False,8125007,"Bad Wimpfen, Stadt",18 - 20 Jahre,148,67,81
False,8125007,"Bad Wimpfen, Stadt",20 - 25 Jahre,350,189,161
False,8125007,"Bad Wimpfen, Stadt",25 - 30 Jahre,386,195,191
False,8125007,"Bad Wimpfen, Stadt",30 - 35 Jahre,383,196,187
False,8125007,"Bad Wimpfen, Stadt",35 - 40 Jahre,434,217,217
False,8125007,"Bad Wimpfen, Stadt",40 - 45 Jahre,527,265,262
False,8125007,"Bad Wimpfen, Stadt",45 - 50 Jahre,544,286,258
False,8125007,"Bad Wimpfen, Stadt",50 - 55 Jahre,501,238,263
False,8125007,"Bad Wimpfen, Stadt",55 - 60 Jahre,470,235,235
False,8125007,"Bad Wimpfen, Stadt",60 - 65 Jahre,435,213,222
False,8125007,"Bad Wimpfen, Stadt",65 - 75 Jahre,848,405,443
False,8125007,"Bad Wimpfen, Stadt",75 und mehr Jahre,715,289,426
False,8125007,"Bad Wimpfen, Stadt",Insgesamt,6824,3373,3451
False,8125008,"Beilstein, Stadt",unter 3 Jahre,137,78,59
False,8125008,"Beilstein, Stadt",3 -  6 Jahre,133,78,55
False,8125008,"Beilstein, Stadt",6 - 10 Jahre,201,99,102
False,8125008,"Beilstein, Stadt",10 - 15 Jahre,319,181,138
False,8125008,"Beilstein, Stadt",15 - 18 Jahre,209,110,99
False,8125008,"Beilstein, Stadt",18 - 20 Jahre,153,72,81
False,8125008,"Beilstein, Stadt",20 - 25 Jahre,363,171,192
False,8125008,"Beilstein, Stadt",25 - 30 Jahre,292,158,134
False,8125008,"Beilstein, Stadt",30 - 35 Jahre,287,137,150
False,8125008,"Beilstein, Stadt",35 - 40 Jahre,340,145,195
False,8125008,"Beilstein, Stadt",40 - 45 Jahre,539,261,278
False,8125008,"Beilstein, Stadt",45 - 50 Jahre,490,255,235
False,8125008,"Beilstein, Stadt",50 - 55 Jahre,440,223,217
False,8125008,"Beilstein, Stadt",55 - 60 Jahre,375,169,206
False,8125008,"Beilstein, Stadt",60 - 65 Jahre,441,218,223
False,8125008,"Beilstein, Stadt",65 - 75 Jahre,816,399,417
False,8125008,"Beilstein, Stadt",75 und mehr Jahre,528,212,316
False,8125008,"Beilstein, Stadt",Insgesamt,6063,2966,3097
False,8125013,"Brackenheim, Stadt",unter 3 Jahre,398,193,205
False,8125013,"Brackenheim, Stadt",3 -  6 Jahre,419,211,208
False,8125013,"Brackenheim, Stadt",6 - 10 Jahre,683,332,351
False,8125013,"Brackenheim, Stadt",10 - 15 Jahre,997,549,448
False,8125013,"Brackenheim, Stadt",15 - 18 Jahre,591,315,276
False,8125013,"Brackenheim, Stadt",18 - 20 Jahre,371,187,184
False,8125013,"Brackenheim, Stadt",20 - 25 Jahre,960,459,501
False,8125013,"Brackenheim, Stadt",25 - 30 Jahre,795,395,400
False,8125013,"Brackenheim, Stadt",30 - 35 Jahre,814,432,382
False,8125013,"Brackenheim, Stadt",35 - 40 Jahre,954,460,494
False,8125013,"Brackenheim, Stadt",40 - 45 Jahre,1341,661,680
False,8125013,"Brackenheim, Stadt",45 - 50 Jahre,1409,733,676
False,8125013,"Brackenheim, Stadt",50 - 55 Jahre,1149,590,559
False,8125013,"Brackenheim, Stadt",55 - 60 Jahre,988,487,501
False,8125013,"Brackenheim, Stadt",60 - 65 Jahre,754,396,358
False,8125013,"Brackenheim, Stadt",65 - 75 Jahre,1368,659,709
False,8125013,"Brackenheim, Stadt",75 und mehr Jahre,1137,432,705
False,8125013,"Brackenheim, Stadt",Insgesamt,15128,7491,7637
False,8125017,Cleebronn,unter 3 Jahre,78,38,40
False,8125017,Cleebronn,3 -  6 Jahre,94,43,51
False,8125017,Cleebronn,6 - 10 Jahre,124,66,58
False,8125017,Cleebronn,10 - 15 Jahre,150,78,72
False,8125017,Cleebronn,15 - 18 Jahre,108,61,47
False,8125017,Cleebronn,18 - 20 Jahre,69,47,22
False,8125017,Cleebronn,20 - 25 Jahre,164,91,73
False,8125017,Cleebronn,25 - 30 Jahre,154,77,77
False,8125017,Cleebronn,30 - 35 Jahre,142,77,65
False,8125017,Cleebronn,35 - 40 Jahre,175,80,95
False,8125017,Cleebronn,40 - 45 Jahre,258,137,121
False,8125017,Cleebronn,45 - 50 Jahre,245,131,114
False,8125017,Cleebronn,50 - 55 Jahre,201,97,104
False,8125017,Cleebronn,55 - 60 Jahre,168,85,83
False,8125017,Cleebronn,60 - 65 Jahre,137,71,66
False,8125017,Cleebronn,65 - 75 Jahre,268,132,136
False,8125017,Cleebronn,75 und mehr Jahre,157,59,98
False,8125017,Cleebronn,Insgesamt,2692,1370,1322
False,8125021,Eberstadt,unter 3 Jahre,67,31,36
False,8125021,Eberstadt,3 -  6 Jahre,77,37,40
False,8125021,Eberstadt,6 - 10 Jahre,117,59,58
False,8125021,Eberstadt,10 - 15 Jahre,193,88,105
False,8125021,Eberstadt,15 - 18 Jahre,107,53,54
False,8125021,Eberstadt,18 - 20 Jahre,92,42,50
False,8125021,Eberstadt,20 - 25 Jahre,181,96,85
False,8125021,Eberstadt,25 - 30 Jahre,169,86,83
False,8125021,Eberstadt,30 - 35 Jahre,159,92,67
False,8125021,Eberstadt,35 - 40 Jahre,219,94,125
False,8125021,Eberstadt,40 - 45 Jahre,261,134,127
False,8125021,Eberstadt,45 - 50 Jahre,269,123,146
False,8125021,Eberstadt,50 - 55 Jahre,241,131,110
False,8125021,Eberstadt,55 - 60 Jahre,198,96,102
False,8125021,Eberstadt,60 - 65 Jahre,166,84,82
False,8125021,Eberstadt,65 - 75 Jahre,335,158,177
False,8125021,Eberstadt,75 und mehr Jahre,310,124,186
False,8125021,Eberstadt,Insgesamt,3161,1528,1633
False,8125024,Ellhofen,unter 3 Jahre,68,37,31
False,8125024,Ellhofen,3 -  6 Jahre,83,40,43
False,8125024,Ellhofen,6 - 10 Jahre,135,67,68
False,8125024,Ellhofen,10 - 15 Jahre,194,108,86
False,8125024,Ellhofen,15 - 18 Jahre,144,70,74
False,8125024,Ellhofen,18 - 20 Jahre,86,50,36
False,8125024,Ellhofen,20 - 25 Jahre,201,104,97
False,8125024,Ellhofen,25 - 30 Jahre,174,86,88
False,8125024,Ellhofen,30 - 35 Jahre,175,96,79
False,8125024,Ellhofen,35 - 40 Jahre,219,110,109
False,8125024,Ellhofen,40 - 45 Jahre,268,125,143
False,8125024,Ellhofen,45 - 50 Jahre,286,155,131
False,8125024,Ellhofen,50 - 55 Jahre,290,142,148
False,8125024,Ellhofen,55 - 60 Jahre,258,131,127
False,8125024,Ellhofen,60 - 65 Jahre,186,99,87
False,8125024,Ellhofen,65 - 75 Jahre,348,159,189
False,8125024,Ellhofen,75 und mehr Jahre,213,92,121
False,8125024,Ellhofen,Insgesamt,3328,1671,1657
False,8125026,"Eppingen, Stadt",unter 3 Jahre,552,292,260
False,8125026,"Eppingen, Stadt",3 -  6 Jahre,610,315,295
False,8125026,"Eppingen, Stadt",6 - 10 Jahre,923,482,441
False,8125026,"Eppingen, Stadt",10 - 15 Jahre,1381,682,699
False,8125026,"Eppingen, Stadt",15 - 18 Jahre,825,418,407
False,8125026,"Eppingen, Stadt",18 - 20 Jahre,604,339,265
False,8125026,"Eppingen, Stadt",20 - 25 Jahre,1316,695,621
False,8125026,"Eppingen, Stadt",25 - 30 Jahre,1284,664,620
False,8125026,"Eppingen, Stadt",30 - 35 Jahre,1199,609,590
False,8125026,"Eppingen, Stadt",35 - 40 Jahre,1329,674,655
False,8125026,"Eppingen, Stadt",40 - 45 Jahre,1827,893,934
False,8125026,"Eppingen, Stadt",45 - 50 Jahre,1880,935,945
False,8125026,"Eppingen, Stadt",50 - 55 Jahre,1655,845,810
False,8125026,"Eppingen, Stadt",55 - 60 Jahre,1319,652,667
False,8125026,"Eppingen, Stadt",60 - 65 Jahre,1098,566,532
False,8125026,"Eppingen, Stadt",65 - 75 Jahre,1868,880,988
False,8125026,"Eppingen, Stadt",75 und mehr Jahre,1718,605,1113
False,8125026,"Eppingen, Stadt",Insgesamt,21388,10546,10842
False,8125027,Erlenbach,unter 3 Jahre,122,62,60
False,8125027,Erlenbach,3 -  6 Jahre,111,60,51
False,8125027,Erlenbach,6 - 10 Jahre,185,95,90
False,8125027,Erlenbach,10 - 15 Jahre,242,120,122
False,8125027,Erlenbach,15 - 18 Jahre,154,86,68
False,8125027,Erlenbach,18 - 20 Jahre,120,64,56
False,8125027,Erlenbach,20 - 25 Jahre,326,184,142
False,8125027,Erlenbach,25 - 30 Jahre,312,155,157
False,8125027,Erlenbach,30 - 35 Jahre,312,158,154
False,8125027,Erlenbach,35 - 40 Jahre,309,154,155
False,8125027,Erlenbach,40 - 45 Jahre,409,218,191
False,8125027,Erlenbach,45 - 50 Jahre,455,210,245
False,8125027,Erlenbach,50 - 55 Jahre,388,206,182
False,8125027,Erlenbach,55 - 60 Jahre,290,146,144
False,8125027,Erlenbach,60 - 65 Jahre,255,114,141
False,8125027,Erlenbach,65 - 75 Jahre,529,256,273
False,8125027,Erlenbach,75 und mehr Jahre,401,169,232
False,8125027,Erlenbach,Insgesamt,4920,2457,2463
False,8125030,Flein,unter 3 Jahre,141,70,71
False,8125030,Flein,3 -  6 Jahre,136,66,70
False,8125030,Flein,6 - 10 Jahre,268,133,135
False,8125030,Flein,10 - 15 Jahre,342,174,168
False,8125030,Flein,15 - 18 Jahre,196,94,102
False,8125030,Flein,18 - 20 Jahre,120,60,60
False,8125030,Flein,20 - 25 Jahre,302,151,151
False,8125030,Flein,25 - 30 Jahre,305,149,156
False,8125030,Flein,30 - 35 Jahre,340,141,199
False,8125030,Flein,35 - 40 Jahre,365,181,184
False,8125030,Flein,40 - 45 Jahre,590,269,321
False,8125030,Flein,45 - 50 Jahre,630,304,326
False,8125030,Flein,50 - 55 Jahre,484,237,247
False,8125030,Flein,55 - 60 Jahre,366,174,192
False,8125030,Flein,60 - 65 Jahre,410,179,231
False,8125030,Flein,65 - 75 Jahre,874,409,465
False,8125030,Flein,75 und mehr Jahre,778,376,402
False,8125030,Flein,Insgesamt,6647,3167,3480
False,8125034,Gemmingen,unter 3 Jahre,147,69,78
False,8125034,Gemmingen,3 -  6 Jahre,131,78,53
False,8125034,Gemmingen,6 - 10 Jahre,170,91,79
False,8125034,Gemmingen,10 - 15 Jahre,305,164,141
False,8125034,Gemmingen,15 - 18 Jahre,208,103,105
False,8125034,Gemmingen,18 - 20 Jahre,156,91,65
False,8125034,Gemmingen,20 - 25 Jahre,327,178,149
False,8125034,Gemmingen,25 - 30 Jahre,245,120,125
False,8125034,Gemmingen,30 - 35 Jahre,268,136,132
False,8125034,Gemmingen,35 - 40 Jahre,255,131,124
False,8125034,Gemmingen,40 - 45 Jahre,420,194,226
False,8125034,Gemmingen,45 - 50 Jahre,448,230,218
False,8125034,Gemmingen,50 - 55 Jahre,355,174,181
False,8125034,Gemmingen,55 - 60 Jahre,325,171,154
False,8125034,Gemmingen,60 - 65 Jahre,274,145,129
False,8125034,Gemmingen,65 - 75 Jahre,517,249,268
False,8125034,Gemmingen,75 und mehr Jahre,362,149,213
False,8125034,Gemmingen,Insgesamt,4913,2473,2440
False,8125038,"Güglingen, Stadt",unter 3 Jahre,163,69,94
False,8125038,"Güglingen, Stadt",3 -  6 Jahre,167,90,77
False,8125038,"Güglingen, Stadt",6 - 10 Jahre,254,139,115
False,8125038,"Güglingen, Stadt",10 - 15 Jahre,427,223,204
False,8125038,"Güglingen, Stadt",15 - 18 Jahre,243,116,127
False,8125038,"Güglingen, Stadt",18 - 20 Jahre,173,95,78
False,8125038,"Güglingen, Stadt",20 - 25 Jahre,408,211,197
False,8125038,"Güglingen, Stadt",25 - 30 Jahre,353,173,180
False,8125038,"Güglingen, Stadt",30 - 35 Jahre,357,187,170
False,8125038,"Güglingen, Stadt",35 - 40 Jahre,390,183,207
False,8125038,"Güglingen, Stadt",40 - 45 Jahre,546,301,245
False,8125038,"Güglingen, Stadt",45 - 50 Jahre,550,292,258
False,8125038,"Güglingen, Stadt",50 - 55 Jahre,437,232,205
False,8125038,"Güglingen, Stadt",55 - 60 Jahre,336,163,173
False,8125038,"Güglingen, Stadt",60 - 65 Jahre,306,151,155
False,8125038,"Güglingen, Stadt",65 - 75 Jahre,594,290,304
False,8125038,"Güglingen, Stadt",75 und mehr Jahre,428,171,257
False,8125038,"Güglingen, Stadt",Insgesamt,6132,3086,3046
False,8125039,"Gundelsheim, Stadt",unter 3 Jahre,161,73,88
False,8125039,"Gundelsheim, Stadt",3 -  6 Jahre,150,82,68
False,8125039,"Gundelsheim, Stadt",6 - 10 Jahre,292,145,147
False,8125039,"Gundelsheim, Stadt",10 - 15 Jahre,453,239,214
False,8125039,"Gundelsheim, Stadt",15 - 18 Jahre,269,127,142
False,8125039,"Gundelsheim, Stadt",18 - 20 Jahre,162,76,86
False,8125039,"Gundelsheim, Stadt",20 - 25 Jahre,444,259,185
False,8125039,"Gundelsheim, Stadt",25 - 30 Jahre,369,201,168
False,8125039,"Gundelsheim, Stadt",30 - 35 Jahre,401,201,200
False,8125039,"Gundelsheim, Stadt",35 - 40 Jahre,426,202,224
False,8125039,"Gundelsheim, Stadt",40 - 45 Jahre,594,299,295
False,8125039,"Gundelsheim, Stadt",45 - 50 Jahre,638,338,300
False,8125039,"Gundelsheim, Stadt",50 - 55 Jahre,521,275,246
False,8125039,"Gundelsheim, Stadt",55 - 60 Jahre,480,234,246
False,8125039,"Gundelsheim, Stadt",60 - 65 Jahre,409,204,205
False,8125039,"Gundelsheim, Stadt",65 - 75 Jahre,782,404,378
False,8125039,"Gundelsheim, Stadt",75 und mehr Jahre,670,238,432
False,8125039,"Gundelsheim, Stadt",Insgesamt,7221,3597,3624
False,8125046,Ilsfeld,unter 3 Jahre,254,133,121
False,8125046,Ilsfeld,3 -  6 Jahre,279,137,142
False,8125046,Ilsfeld,6 - 10 Jahre,345,181,164
False,8125046,Ilsfeld,10 - 15 Jahre,486,233,253
False,8125046,Ilsfeld,15 - 18 Jahre,294,140,154
False,8125046,Ilsfeld,18 - 20 Jahre,220,116,104
False,8125046,Ilsfeld,20 - 25 Jahre,456,228,228
False,8125046,Ilsfeld,25 - 30 Jahre,491,241,250
False,8125046,Ilsfeld,30 - 35 Jahre,577,296,281
False,8125046,Ilsfeld,35 - 40 Jahre,617,298,319
False,8125046,Ilsfeld,40 - 45 Jahre,727,394,333
False,8125046,Ilsfeld,45 - 50 Jahre,708,363,345
False,8125046,Ilsfeld,50 - 55 Jahre,594,316,278
False,8125046,Ilsfeld,55 - 60 Jahre,523,236,287
False,8125046,Ilsfeld,60 - 65 Jahre,496,249,247
False,8125046,Ilsfeld,65 - 75 Jahre,920,447,473
False,8125046,Ilsfeld,75 und mehr Jahre,526,222,304
False,8125046,Ilsfeld,Insgesamt,8513,4230,4283
False,8125047,Ittlingen,unter 3 Jahre,63,33,30
False,8125047,Ittlingen,3 -  6 Jahre,77,40,37
False,8125047,Ittlingen,6 - 10 Jahre,101,55,46
False,8125047,Ittlingen,10 - 15 Jahre,161,90,71
False,8125047,Ittlingen,15 - 18 Jahre,110,54,56
False,8125047,Ittlingen,18 - 20 Jahre,70,40,30
False,8125047,Ittlingen,20 - 25 Jahre,154,69,85
False,8125047,Ittlingen,25 - 30 Jahre,110,56,54
False,8125047,Ittlingen,30 - 35 Jahre,117,63,54
False,8125047,Ittlingen,35 - 40 Jahre,148,81,67
False,8125047,Ittlingen,40 - 45 Jahre,217,116,101
False,8125047,Ittlingen,45 - 50 Jahre,219,109,110
False,8125047,Ittlingen,50 - 55 Jahre,206,111,95
False,8125047,Ittlingen,55 - 60 Jahre,162,90,72
False,8125047,Ittlingen,60 - 65 Jahre,113,55,58
False,8125047,Ittlingen,65 - 75 Jahre,210,113,97
False,8125047,Ittlingen,75 und mehr Jahre,176,71,105
False,8125047,Ittlingen,Insgesamt,2414,1246,1168
False,8125048,Jagsthausen,unter 3 Jahre,37,17,20
False,8125048,Jagsthausen,3 -  6 Jahre,41,23,18
False,8125048,Jagsthausen,6 - 10 Jahre,55,23,32
False,8125048,Jagsthausen,10 - 15 Jahre,116,59,57
False,8125048,Jagsthausen,15 - 18 Jahre,51,25,26
False,8125048,Jagsthausen,18 - 20 Jahre,45,24,21
False,8125048,Jagsthausen,20 - 25 Jahre,73,36,37
False,8125048,Jagsthausen,25 - 30 Jahre,83,42,41
False,8125048,Jagsthausen,30 - 35 Jahre,90,50,40
False,8125048,Jagsthausen,35 - 40 Jahre,105,54,51
False,8125048,Jagsthausen,40 - 45 Jahre,103,67,36
False,8125048,Jagsthausen,45 - 50 Jahre,148,64,84
False,8125048,Jagsthausen,50 - 55 Jahre,124,67,57
False,8125048,Jagsthausen,55 - 60 Jahre,84,39,45
False,8125048,Jagsthausen,60 - 65 Jahre,84,34,50
False,8125048,Jagsthausen,65 - 75 Jahre,188,96,92
False,8125048,Jagsthausen,75 und mehr Jahre,124,67,57
False,8125048,Jagsthausen,Insgesamt,1551,787,764
False,8125049,Kirchardt,unter 3 Jahre,184,106,78
False,8125049,Kirchardt,3 -  6 Jahre,156,88,68
False,8125049,Kirchardt,6 - 10 Jahre,246,114,132
False,8125049,Kirchardt,10 - 15 Jahre,371,181,190
False,8125049,Kirchardt,15 - 18 Jahre,226,117,109
False,8125049,Kirchardt,18 - 20 Jahre,149,85,64
False,8125049,Kirchardt,20 - 25 Jahre,393,215,178
False,8125049,Kirchardt,25 - 30 Jahre,309,166,143
False,8125049,Kirchardt,30 - 35 Jahre,345,168,177
False,8125049,Kirchardt,35 - 40 Jahre,356,180,176
False,8125049,Kirchardt,40 - 45 Jahre,447,236,211
False,8125049,Kirchardt,45 - 50 Jahre,422,213,209
False,8125049,Kirchardt,50 - 55 Jahre,375,203,172
False,8125049,Kirchardt,55 - 60 Jahre,332,171,161
False,8125049,Kirchardt,60 - 65 Jahre,265,127,138
False,8125049,Kirchardt,65 - 75 Jahre,500,251,249
False,8125049,Kirchardt,75 und mehr Jahre,331,136,195
False,8125049,Kirchardt,Insgesamt,5407,2757,2650
False,8125056,"Lauffen am Neckar, Stadt",unter 3 Jahre,274,143,131
False,8125056,"Lauffen am Neckar, Stadt",3 -  6 Jahre,283,140,143
False,8125056,"Lauffen am Neckar, Stadt",6 - 10 Jahre,397,196,201
False,8125056,"Lauffen am Neckar, Stadt",10 - 15 Jahre,613,313,300
False,8125056,"Lauffen am Neckar, Stadt",15 - 18 Jahre,434,234,200
False,8125056,"Lauffen am Neckar, Stadt",18 - 20 Jahre,249,130,119
False,8125056,"Lauffen am Neckar, Stadt",20 - 25 Jahre,704,369,335
False,8125056,"Lauffen am Neckar, Stadt",25 - 30 Jahre,650,329,321
False,8125056,"Lauffen am Neckar, Stadt",30 - 35 Jahre,642,325,317
False,8125056,"Lauffen am Neckar, Stadt",35 - 40 Jahre,639,299,340
False,8125056,"Lauffen am Neckar, Stadt",40 - 45 Jahre,836,406,430
False,8125056,"Lauffen am Neckar, Stadt",45 - 50 Jahre,1041,563,478
False,8125056,"Lauffen am Neckar, Stadt",50 - 55 Jahre,808,419,389
False,8125056,"Lauffen am Neckar, Stadt",55 - 60 Jahre,686,330,356
False,8125056,"Lauffen am Neckar, Stadt",60 - 65 Jahre,610,288,322
False,8125056,"Lauffen am Neckar, Stadt",65 - 75 Jahre,1104,546,558
False,8125056,"Lauffen am Neckar, Stadt",75 und mehr Jahre,941,315,626
False,8125056,"Lauffen am Neckar, Stadt",Insgesamt,10911,5345,5566
False,8125057,Lehrensteinsfeld,unter 3 Jahre,63,30,33
False,8125057,Lehrensteinsfeld,3 -  6 Jahre,77,46,31
False,8125057,Lehrensteinsfeld,6 - 10 Jahre,123,62,61
False,8125057,Lehrensteinsfeld,10 - 15 Jahre,150,85,65
False,8125057,Lehrensteinsfeld,15 - 18 Jahre,88,49,39
False,8125057,Lehrensteinsfeld,18 - 20 Jahre,60,31,29
False,8125057,Lehrensteinsfeld,20 - 25 Jahre,97,60,37
False,8125057,Lehrensteinsfeld,25 - 30 Jahre,81,46,35
False,8125057,Lehrensteinsfeld,30 - 35 Jahre,100,38,62
False,8125057,Lehrensteinsfeld,35 - 40 Jahre,156,76,80
False,8125057,Lehrensteinsfeld,40 - 45 Jahre,211,111,100
False,8125057,Lehrensteinsfeld,45 - 50 Jahre,189,95,94
False,8125057,Lehrensteinsfeld,50 - 55 Jahre,135,78,57
False,8125057,Lehrensteinsfeld,55 - 60 Jahre,139,57,82
False,8125057,Lehrensteinsfeld,60 - 65 Jahre,134,66,68
False,8125057,Lehrensteinsfeld,65 - 75 Jahre,231,129,102
False,8125057,Lehrensteinsfeld,75 und mehr Jahre,130,47,83
False,8125057,Lehrensteinsfeld,Insgesamt,2164,1106,1058
False,8125058,Leingarten,unter 3 Jahre,281,136,145
False,8125058,Leingarten,3 -  6 Jahre,294,155,139
False,8125058,Leingarten,6 - 10 Jahre,424,220,204
False,8125058,Leingarten,10 - 15 Jahre,696,354,342
False,8125058,Leingarten,15 - 18 Jahre,365,192,173
False,8125058,Leingarten,18 - 20 Jahre,255,115,140
False,8125058,Leingarten,20 - 25 Jahre,603,299,304
False,8125058,Leingarten,25 - 30 Jahre,584,291,293
False,8125058,Leingarten,30 - 35 Jahre,656,321,335
False,8125058,Leingarten,35 - 40 Jahre,703,351,352
False,8125058,Leingarten,40 - 45 Jahre,928,491,437
False,8125058,Leingarten,45 - 50 Jahre,959,467,492
False,8125058,Leingarten,50 - 55 Jahre,790,390,400
False,8125058,Leingarten,55 - 60 Jahre,691,337,354
False,8125058,Leingarten,60 - 65 Jahre,569,272,297
False,8125058,Leingarten,65 - 75 Jahre,1131,536,595
False,8125058,Leingarten,75 und mehr Jahre,843,319,524
False,8125058,Leingarten,Insgesamt,10772,5246,5526
False,8125059,"Löwenstein, Stadt",unter 3 Jahre,76,44,32
False,8125059,"Löwenstein, Stadt",3 -  6 Jahre,100,46,54
False,8125059,"Löwenstein, Stadt",6 - 10 Jahre,119,61,58
False,8125059,"Löwenstein, Stadt",10 - 15 Jahre,131,65,66
False,8125059,"Löwenstein, Stadt",15 - 18 Jahre,96,56,40
False,8125059,"Löwenstein, Stadt",18 - 20 Jahre,78,42,36
False,8125059,"Löwenstein, Stadt",20 - 25 Jahre,147,75,72
False,8125059,"Löwenstein, Stadt",25 - 30 Jahre,153,68,85
False,8125059,"Löwenstein, Stadt",30 - 35 Jahre,168,83,85
False,8125059,"Löwenstein, Stadt",35 - 40 Jahre,197,91,106
False,8125059,"Löwenstein, Stadt",40 - 45 Jahre,286,150,136
False,8125059,"Löwenstein, Stadt",45 - 50 Jahre,319,166,153
False,8125059,"Löwenstein, Stadt",50 - 55 Jahre,286,144,142
False,8125059,"Löwenstein, Stadt",55 - 60 Jahre,260,129,131
False,8125059,"Löwenstein, Stadt",60 - 65 Jahre,194,109,85
False,8125059,"Löwenstein, Stadt",65 - 75 Jahre,276,128,148
False,8125059,"Löwenstein, Stadt",75 und mehr Jahre,248,99,149
False,8125059,"Löwenstein, Stadt",Insgesamt,3134,1556,1578
False,8125061,Massenbachhausen,unter 3 Jahre,70,33,37
False,8125061,Massenbachhausen,3 -  6 Jahre,82,46,36
False,8125061,Massenbachhausen,6 - 10 Jahre,106,57,49
False,8125061,Massenbachhausen,10 - 15 Jahre,171,89,82
False,8125061,Massenbachhausen,15 - 18 Jahre,134,71,63
False,8125061,Massenbachhausen,18 - 20 Jahre,99,62,37
False,8125061,Massenbachhausen,20 - 25 Jahre,237,141,96
False,8125061,Massenbachhausen,25 - 30 Jahre,188,98,90
False,8125061,Massenbachhausen,30 - 35 Jahre,193,93,100
False,8125061,Massenbachhausen,35 - 40 Jahre,214,108,106
False,8125061,Massenbachhausen,40 - 45 Jahre,298,149,149
False,8125061,Massenbachhausen,45 - 50 Jahre,363,199,164
False,8125061,Massenbachhausen,50 - 55 Jahre,297,141,156
False,8125061,Massenbachhausen,55 - 60 Jahre,259,127,132
False,8125061,Massenbachhausen,60 - 65 Jahre,185,97,88
False,8125061,Massenbachhausen,65 - 75 Jahre,350,172,178
False,8125061,Massenbachhausen,75 und mehr Jahre,258,99,159
False,8125061,Massenbachhausen,Insgesamt,3504,1782,1722
False,8125063,"Möckmühl, Stadt",unter 3 Jahre,169,79,90
False,8125063,"Möckmühl, Stadt",3 -  6 Jahre,181,97,84
False,8125063,"Möckmühl, Stadt",6 - 10 Jahre,318,163,155
False,8125063,"Möckmühl, Stadt",10 - 15 Jahre,459,240,219
False,8125063,"Möckmühl, Stadt",15 - 18 Jahre,326,166,160
False,8125063,"Möckmühl, Stadt",18 - 20 Jahre,217,106,111
False,8125063,"Möckmühl, Stadt",20 - 25 Jahre,488,275,213
False,8125063,"Möckmühl, Stadt",25 - 30 Jahre,449,262,187
False,8125063,"Möckmühl, Stadt",30 - 35 Jahre,441,224,217
False,8125063,"Möckmühl, Stadt",35 - 40 Jahre,527,282,245
False,8125063,"Möckmühl, Stadt",40 - 45 Jahre,682,377,305
False,8125063,"Möckmühl, Stadt",45 - 50 Jahre,715,398,317
False,8125063,"Möckmühl, Stadt",50 - 55 Jahre,664,357,307
False,8125063,"Möckmühl, Stadt",55 - 60 Jahre,567,299,268
False,8125063,"Möckmühl, Stadt",60 - 65 Jahre,414,194,220
False,8125063,"Möckmühl, Stadt",65 - 75 Jahre,752,358,394
False,8125063,"Möckmühl, Stadt",75 und mehr Jahre,715,278,437
False,8125063,"Möckmühl, Stadt",Insgesamt,8084,4155,3929
False,8125065,"Neckarsulm, Stadt",unter 3 Jahre,630,319,311
False,8125065,"Neckarsulm, Stadt",3 -  6 Jahre,653,327,326
False,8125065,"Neckarsulm, Stadt",6 - 10 Jahre,1010,474,536
False,8125065,"Neckarsulm, Stadt",10 - 15 Jahre,1480,751,729
False,8125065,"Neckarsulm, Stadt",15 - 18 Jahre,883,437,446
False,8125065,"Neckarsulm, Stadt",18 - 20 Jahre,675,371,304
False,8125065,"Neckarsulm, Stadt",20 - 25 Jahre,1602,859,743
False,8125065,"Neckarsulm, Stadt",25 - 30 Jahre,1663,819,844
False,8125065,"Neckarsulm, Stadt",30 - 35 Jahre,1771,907,864
False,8125065,"Neckarsulm, Stadt",35 - 40 Jahre,1770,904,866
False,8125065,"Neckarsulm, Stadt",40 - 45 Jahre,2183,1176,1007
False,8125065,"Neckarsulm, Stadt",45 - 50 Jahre,2160,1115,1045
False,8125065,"Neckarsulm, Stadt",50 - 55 Jahre,1953,1009,944
False,8125065,"Neckarsulm, Stadt",55 - 60 Jahre,1706,855,851
False,8125065,"Neckarsulm, Stadt",60 - 65 Jahre,1437,705,732
False,8125065,"Neckarsulm, Stadt",65 - 75 Jahre,2666,1265,1401
False,8125065,"Neckarsulm, Stadt",75 und mehr Jahre,2269,877,1392
False,8125065,"Neckarsulm, Stadt",Insgesamt,26511,13170,13341
False,8125066,Neckarwestheim,unter 3 Jahre,79,44,35
False,8125066,Neckarwestheim,3 -  6 Jahre,91,47,44
False,8125066,Neckarwestheim,6 - 10 Jahre,135,80,55
False,8125066,Neckarwestheim,10 - 15 Jahre,197,93,104
False,8125066,Neckarwestheim,15 - 18 Jahre,133,71,62
False,8125066,Neckarwestheim,18 - 20 Jahre,78,34,44
False,8125066,Neckarwestheim,20 - 25 Jahre,187,97,90
False,8125066,Neckarwestheim,25 - 30 Jahre,184,95,89
False,8125066,Neckarwestheim,30 - 35 Jahre,193,86,107
False,8125066,Neckarwestheim,35 - 40 Jahre,228,110,118
False,8125066,Neckarwestheim,40 - 45 Jahre,341,183,158
False,8125066,Neckarwestheim,45 - 50 Jahre,342,175,167
False,8125066,Neckarwestheim,50 - 55 Jahre,296,158,138
False,8125066,Neckarwestheim,55 - 60 Jahre,223,126,97
False,8125066,Neckarwestheim,60 - 65 Jahre,200,91,109
False,8125066,Neckarwestheim,65 - 75 Jahre,357,184,173
False,8125066,Neckarwestheim,75 und mehr Jahre,245,92,153
False,8125066,Neckarwestheim,Insgesamt,3509,1766,1743
False,8125068,"Neudenau, Stadt",unter 3 Jahre,122,69,53
False,8125068,"Neudenau, Stadt",3 -  6 Jahre,149,80,69
False,8125068,"Neudenau, Stadt",6 - 10 Jahre,235,114,121
False,8125068,"Neudenau, Stadt",10 - 15 Jahre,293,143,150
False,8125068,"Neudenau, Stadt",15 - 18 Jahre,197,96,101
False,8125068,"Neudenau, Stadt",18 - 20 Jahre,119,64,55
False,8125068,"Neudenau, Stadt",20 - 25 Jahre,294,140,154
False,8125068,"Neudenau, Stadt",25 - 30 Jahre,289,158,131
False,8125068,"Neudenau, Stadt",30 - 35 Jahre,286,146,140
False,8125068,"Neudenau, Stadt",35 - 40 Jahre,382,189,193
False,8125068,"Neudenau, Stadt",40 - 45 Jahre,462,238,224
False,8125068,"Neudenau, Stadt",45 - 50 Jahre,444,231,213
False,8125068,"Neudenau, Stadt",50 - 55 Jahre,409,213,196
False,8125068,"Neudenau, Stadt",55 - 60 Jahre,356,181,175
False,8125068,"Neudenau, Stadt",60 - 65 Jahre,270,144,126
False,8125068,"Neudenau, Stadt",65 - 75 Jahre,491,227,264
False,8125068,"Neudenau, Stadt",75 und mehr Jahre,383,136,247
False,8125068,"Neudenau, Stadt",Insgesamt,5181,2569,2612
False,8125069,"Neuenstadt am Kocher, Stadt",unter 3 Jahre,268,130,138
False,8125069,"Neuenstadt am Kocher, Stadt",3 -  6 Jahre,242,126,116
False,8125069,"Neuenstadt am Kocher, Stadt",6 - 10 Jahre,374,193,181
False,8125069,"Neuenstadt am Kocher, Stadt",10 - 15 Jahre,549,282,267
False,8125069,"Neuenstadt am Kocher, Stadt",15 - 18 Jahre,360,188,172
False,8125069,"Neuenstadt am Kocher, Stadt",18 - 20 Jahre,244,132,112
False,8125069,"Neuenstadt am Kocher, Stadt",20 - 25 Jahre,598,312,286
False,8125069,"Neuenstadt am Kocher, Stadt",25 - 30 Jahre,655,357,298
False,8125069,"Neuenstadt am Kocher, Stadt",30 - 35 Jahre,613,319,294
False,8125069,"Neuenstadt am Kocher, Stadt",35 - 40 Jahre,647,328,319
False,8125069,"Neuenstadt am Kocher, Stadt",40 - 45 Jahre,774,403,371
False,8125069,"Neuenstadt am Kocher, Stadt",45 - 50 Jahre,811,426,385
False,8125069,"Neuenstadt am Kocher, Stadt",50 - 55 Jahre,710,380,330
False,8125069,"Neuenstadt am Kocher, Stadt",55 - 60 Jahre,677,323,354
False,8125069,"Neuenstadt am Kocher, Stadt",60 - 65 Jahre,523,254,269
False,8125069,"Neuenstadt am Kocher, Stadt",65 - 75 Jahre,877,425,452
False,8125069,"Neuenstadt am Kocher, Stadt",75 und mehr Jahre,712,273,439
False,8125069,"Neuenstadt am Kocher, Stadt",Insgesamt,9634,4851,4783
False,8125074,Nordheim,unter 3 Jahre,190,95,95
False,8125074,Nordheim,3 -  6 Jahre,207,94,113
False,8125074,Nordheim,6 - 10 Jahre,348,191,157
False,8125074,Nordheim,10 - 15 Jahre,459,228,231
False,8125074,Nordheim,15 - 18 Jahre,266,133,133
False,8125074,Nordheim,18 - 20 Jahre,183,104,79
False,8125074,Nordheim,20 - 25 Jahre,415,212,203
False,8125074,Nordheim,25 - 30 Jahre,344,185,159
False,8125074,Nordheim,30 - 35 Jahre,430,214,216
False,8125074,Nordheim,35 - 40 Jahre,483,239,244
False,8125074,Nordheim,40 - 45 Jahre,664,339,325
False,8125074,Nordheim,45 - 50 Jahre,700,350,350
False,8125074,Nordheim,50 - 55 Jahre,509,257,252
False,8125074,Nordheim,55 - 60 Jahre,477,235,242
False,8125074,Nordheim,60 - 65 Jahre,421,208,213
False,8125074,Nordheim,65 - 75 Jahre,756,365,391
False,8125074,Nordheim,75 und mehr Jahre,584,234,350
False,8125074,Nordheim,Insgesamt,7436,3683,3753
False,8125078,Oedheim,unter 3 Jahre,138,69,69
False,8125078,Oedheim,3 -  6 Jahre,149,70,79
False,8125078,Oedheim,6 - 10 Jahre,237,107,130
False,8125078,Oedheim,10 - 15 Jahre,367,171,196
False,8125078,Oedheim,15 - 18 Jahre,239,129,110
False,8125078,Oedheim,18 - 20 Jahre,144,79,65
False,8125078,Oedheim,20 - 25 Jahre,341,179,162
False,8125078,Oedheim,25 - 30 Jahre,277,135,142
False,8125078,Oedheim,30 - 35 Jahre,377,181,196
False,8125078,Oedheim,35 - 40 Jahre,405,235,170
False,8125078,Oedheim,40 - 45 Jahre,552,275,277
False,8125078,Oedheim,45 - 50 Jahre,546,298,248
False,8125078,Oedheim,50 - 55 Jahre,466,235,231
False,8125078,Oedheim,55 - 60 Jahre,340,190,150
False,8125078,Oedheim,60 - 65 Jahre,296,139,157
False,8125078,Oedheim,65 - 75 Jahre,603,285,318
False,8125078,Oedheim,75 und mehr Jahre,446,195,251
False,8125078,Oedheim,Insgesamt,5923,2972,2951
False,8125079,Offenau,unter 3 Jahre,73,38,35
False,8125079,Offenau,3 -  6 Jahre,73,35,38
False,8125079,Offenau,6 - 10 Jahre,110,51,59
False,8125079,Offenau,10 - 15 Jahre,168,76,92
False,8125079,Offenau,15 - 18 Jahre,93,47,46
False,8125079,Offenau,18 - 20 Jahre,63,30,33
False,8125079,Offenau,20 - 25 Jahre,146,76,70
False,8125079,Offenau,25 - 30 Jahre,152,74,78
False,8125079,Offenau,30 - 35 Jahre,147,87,60
False,8125079,Offenau,35 - 40 Jahre,182,90,92
False,8125079,Offenau,40 - 45 Jahre,222,116,106
False,8125079,Offenau,45 - 50 Jahre,251,121,130
False,8125079,Offenau,50 - 55 Jahre,220,121,99
False,8125079,Offenau,55 - 60 Jahre,165,86,79
False,8125079,Offenau,60 - 65 Jahre,138,74,64
False,8125079,Offenau,65 - 75 Jahre,285,138,147
False,8125079,Offenau,75 und mehr Jahre,201,84,117
False,8125079,Offenau,Insgesamt,2689,1344,1345
False,8125081,Pfaffenhofen,unter 3 Jahre,64,34,30
False,8125081,Pfaffenhofen,3 -  6 Jahre,64,33,31
False,8125081,Pfaffenhofen,6 - 10 Jahre,96,46,50
False,8125081,Pfaffenhofen,10 - 15 Jahre,150,82,68
False,8125081,Pfaffenhofen,15 - 18 Jahre,98,55,43
False,8125081,Pfaffenhofen,18 - 20 Jahre,57,32,25
False,8125081,Pfaffenhofen,20 - 25 Jahre,171,96,75
False,8125081,Pfaffenhofen,25 - 30 Jahre,119,55,64
False,8125081,Pfaffenhofen,30 - 35 Jahre,122,54,68
False,8125081,Pfaffenhofen,35 - 40 Jahre,148,71,77
False,8125081,Pfaffenhofen,40 - 45 Jahre,176,92,84
False,8125081,Pfaffenhofen,45 - 50 Jahre,210,104,106
False,8125081,Pfaffenhofen,50 - 55 Jahre,242,129,113
False,8125081,Pfaffenhofen,55 - 60 Jahre,147,81,66
False,8125081,Pfaffenhofen,60 - 65 Jahre,140,66,74
False,8125081,Pfaffenhofen,65 - 75 Jahre,207,107,100
False,8125081,Pfaffenhofen,75 und mehr Jahre,185,74,111
False,8125081,Pfaffenhofen,Insgesamt,2396,1211,1185
False,8125084,Roigheim,unter 3 Jahre,29,14,15
False,8125084,Roigheim,3 -  6 Jahre,40,15,25
False,8125084,Roigheim,6 - 10 Jahre,67,36,31
False,8125084,Roigheim,10 - 15 Jahre,89,51,38
False,8125084,Roigheim,15 - 18 Jahre,59,34,25
False,8125084,Roigheim,18 - 20 Jahre,48,21,27
False,8125084,Roigheim,20 - 25 Jahre,70,40,30
False,8125084,Roigheim,25 - 30 Jahre,79,53,26
False,8125084,Roigheim,30 - 35 Jahre,74,43,31
False,8125084,Roigheim,35 - 40 Jahre,95,52,43
False,8125084,Roigheim,40 - 45 Jahre,105,55,50
False,8125084,Roigheim,45 - 50 Jahre,142,71,71
False,8125084,Roigheim,50 - 55 Jahre,112,50,62
False,8125084,Roigheim,55 - 60 Jahre,90,48,42
False,8125084,Roigheim,60 - 65 Jahre,75,40,35
False,8125084,Roigheim,65 - 75 Jahre,156,80,76
False,8125084,Roigheim,75 und mehr Jahre,111,37,74
False,8125084,Roigheim,Insgesamt,1441,740,701
False,8125086,"Schwaigern, Stadt",unter 3 Jahre,295,145,150
False,8125086,"Schwaigern, Stadt",3 -  6 Jahre,324,171,153
False,8125086,"Schwaigern, Stadt",6 - 10 Jahre,487,235,252
False,8125086,"Schwaigern, Stadt",10 - 15 Jahre,630,323,307
False,8125086,"Schwaigern, Stadt",15 - 18 Jahre,436,221,215
False,8125086,"Schwaigern, Stadt",18 - 20 Jahre,322,185,137
False,8125086,"Schwaigern, Stadt",20 - 25 Jahre,714,384,330
False,8125086,"Schwaigern, Stadt",25 - 30 Jahre,539,278,261
False,8125086,"Schwaigern, Stadt",30 - 35 Jahre,595,292,303
False,8125086,"Schwaigern, Stadt",35 - 40 Jahre,682,356,326
False,8125086,"Schwaigern, Stadt",40 - 45 Jahre,953,468,485
False,8125086,"Schwaigern, Stadt",45 - 50 Jahre,952,484,468
False,8125086,"Schwaigern, Stadt",50 - 55 Jahre,891,460,431
False,8125086,"Schwaigern, Stadt",55 - 60 Jahre,700,368,332
False,8125086,"Schwaigern, Stadt",60 - 65 Jahre,546,270,276
False,8125086,"Schwaigern, Stadt",65 - 75 Jahre,1088,501,587
False,8125086,"Schwaigern, Stadt",75 und mehr Jahre,865,334,531
False,8125086,"Schwaigern, Stadt",Insgesamt,11019,5475,5544
False,8125087,Siegelsbach,unter 3 Jahre,34,20,14
False,8125087,Siegelsbach,3 -  6 Jahre,60,32,28
False,8125087,Siegelsbach,6 - 10 Jahre,75,47,28
False,8125087,Siegelsbach,10 - 15 Jahre,119,73,46
False,8125087,Siegelsbach,15 - 18 Jahre,56,28,28
False,8125087,Siegelsbach,18 - 20 Jahre,38,16,22
False,8125087,Siegelsbach,20 - 25 Jahre,110,59,51
False,8125087,Siegelsbach,25 - 30 Jahre,66,37,29
False,8125087,Siegelsbach,30 - 35 Jahre,96,43,53
False,8125087,Siegelsbach,35 - 40 Jahre,105,54,51
False,8125087,Siegelsbach,40 - 45 Jahre,164,80,84
False,8125087,Siegelsbach,45 - 50 Jahre,155,76,79
False,8125087,Siegelsbach,50 - 55 Jahre,111,60,51
False,8125087,Siegelsbach,55 - 60 Jahre,99,53,46
False,8125087,Siegelsbach,60 - 65 Jahre,88,44,44
False,8125087,Siegelsbach,65 - 75 Jahre,151,67,84
False,8125087,Siegelsbach,75 und mehr Jahre,103,48,55
False,8125087,Siegelsbach,Insgesamt,1630,837,793
False,8125094,Talheim,unter 3 Jahre,132,66,66
False,8125094,Talheim,3 -  6 Jahre,129,77,52
False,8125094,Talheim,6 - 10 Jahre,189,85,104
False,8125094,Talheim,10 - 15 Jahre,244,132,112
False,8125094,Talheim,15 - 18 Jahre,169,85,84
False,8125094,Talheim,18 - 20 Jahre,103,53,50
False,8125094,Talheim,20 - 25 Jahre,273,153,120
False,8125094,Talheim,25 - 30 Jahre,221,116,105
False,8125094,Talheim,30 - 35 Jahre,276,122,154
False,8125094,Talheim,35 - 40 Jahre,305,139,166
False,8125094,Talheim,40 - 45 Jahre,436,218,218
False,8125094,Talheim,45 - 50 Jahre,444,228,216
False,8125094,Talheim,50 - 55 Jahre,391,203,188
False,8125094,Talheim,55 - 60 Jahre,343,184,159
False,8125094,Talheim,60 - 65 Jahre,289,134,155
False,8125094,Talheim,65 - 75 Jahre,532,262,270
False,8125094,Talheim,75 und mehr Jahre,344,143,201
False,8125094,Talheim,Insgesamt,4820,2400,2420
False,8125096,Untereisesheim,unter 3 Jahre,114,57,57
False,8125096,Untereisesheim,3 -  6 Jahre,136,66,70
False,8125096,Untereisesheim,6 - 10 Jahre,184,102,82
False,8125096,Untereisesheim,10 - 15 Jahre,233,132,101
False,8125096,Untereisesheim,15 - 18 Jahre,150,72,78
False,8125096,Untereisesheim,18 - 20 Jahre,98,48,50
False,8125096,Untereisesheim,20 - 25 Jahre,206,100,106
False,8125096,Untereisesheim,25 - 30 Jahre,234,117,117
False,8125096,Untereisesheim,30 - 35 Jahre,274,135,139
False,8125096,Untereisesheim,35 - 40 Jahre,283,133,150
False,8125096,Untereisesheim,40 - 45 Jahre,369,210,159
False,8125096,Untereisesheim,45 - 50 Jahre,319,150,169
False,8125096,Untereisesheim,50 - 55 Jahre,293,162,131
False,8125096,Untereisesheim,55 - 60 Jahre,290,132,158
False,8125096,Untereisesheim,60 - 65 Jahre,259,131,128
False,8125096,Untereisesheim,65 - 75 Jahre,381,178,203
False,8125096,Untereisesheim,75 und mehr Jahre,240,101,139
False,8125096,Untereisesheim,Insgesamt,4063,2026,2037
False,8125098,Untergruppenbach,unter 3 Jahre,213,101,112
False,8125098,Untergruppenbach,3 -  6 Jahre,197,91,106
False,8125098,Untergruppenbach,6 - 10 Jahre,294,153,141
False,8125098,Untergruppenbach,10 - 15 Jahre,418,222,196
False,8125098,Untergruppenbach,15 - 18 Jahre,237,116,121
False,8125098,Untergruppenbach,18 - 20 Jahre,162,72,90
False,8125098,Untergruppenbach,20 - 25 Jahre,376,190,186
False,8125098,Untergruppenbach,25 - 30 Jahre,456,222,234
False,8125098,Untergruppenbach,30 - 35 Jahre,512,263,249
False,8125098,Untergruppenbach,35 - 40 Jahre,502,251,251
False,8125098,Untergruppenbach,40 - 45 Jahre,678,325,353
False,8125098,Untergruppenbach,45 - 50 Jahre,710,391,319
False,8125098,Untergruppenbach,50 - 55 Jahre,577,299,278
False,8125098,Untergruppenbach,55 - 60 Jahre,509,239,270
False,8125098,Untergruppenbach,60 - 65 Jahre,440,210,230
False,8125098,Untergruppenbach,65 - 75 Jahre,900,438,462
False,8125098,Untergruppenbach,75 und mehr Jahre,680,286,394
False,8125098,Untergruppenbach,Insgesamt,7861,3869,3992
False,8125102,"Weinsberg, Stadt",unter 3 Jahre,304,154,150
False,8125102,"Weinsberg, Stadt",3 -  6 Jahre,266,143,123
False,8125102,"Weinsberg, Stadt",6 - 10 Jahre,429,214,215
False,8125102,"Weinsberg, Stadt",10 - 15 Jahre,605,296,309
False,8125102,"Weinsberg, Stadt",15 - 18 Jahre,395,215,180
False,8125102,"Weinsberg, Stadt",18 - 20 Jahre,262,130,132
False,8125102,"Weinsberg, Stadt",20 - 25 Jahre,633,343,290
False,8125102,"Weinsberg, Stadt",25 - 30 Jahre,679,362,317
False,8125102,"Weinsberg, Stadt",30 - 35 Jahre,692,343,349
False,8125102,"Weinsberg, Stadt",35 - 40 Jahre,770,397,373
False,8125102,"Weinsberg, Stadt",40 - 45 Jahre,979,509,470
False,8125102,"Weinsberg, Stadt",45 - 50 Jahre,1052,550,502
False,8125102,"Weinsberg, Stadt",50 - 55 Jahre,891,472,419
False,8125102,"Weinsberg, Stadt",55 - 60 Jahre,751,349,402
False,8125102,"Weinsberg, Stadt",60 - 65 Jahre,617,298,319
False,8125102,"Weinsberg, Stadt",65 - 75 Jahre,1208,569,639
False,8125102,"Weinsberg, Stadt",75 und mehr Jahre,1048,416,632
False,8125102,"Weinsberg, Stadt",Insgesamt,11581,5760,5821
False,8125103,"Widdern, Stadt",unter 3 Jahre,36,19,17
False,8125103,"Widdern, Stadt",3 -  6 Jahre,35,14,21
False,8125103,"Widdern, Stadt",6 - 10 Jahre,80,39,41
False,8125103,"Widdern, Stadt",10 - 15 Jahre,141,76,65
False,8125103,"Widdern, Stadt",15 - 18 Jahre,90,48,42
False,8125103,"Widdern, Stadt",18 - 20 Jahre,47,16,31
False,8125103,"Widdern, Stadt",20 - 25 Jahre,119,69,50
False,8125103,"Widdern, Stadt",25 - 30 Jahre,92,51,41
False,8125103,"Widdern, Stadt",30 - 35 Jahre,92,52,40
False,8125103,"Widdern, Stadt",35 - 40 Jahre,114,58,56
False,8125103,"Widdern, Stadt",40 - 45 Jahre,174,92,82
False,8125103,"Widdern, Stadt",45 - 50 Jahre,182,95,87
False,8125103,"Widdern, Stadt",50 - 55 Jahre,153,83,70
False,8125103,"Widdern, Stadt",55 - 60 Jahre,111,63,48
False,8125103,"Widdern, Stadt",60 - 65 Jahre,96,49,47
False,8125103,"Widdern, Stadt",65 - 75 Jahre,162,77,85
False,8125103,"Widdern, Stadt",75 und mehr Jahre,192,76,116
False,8125103,"Widdern, Stadt",Insgesamt,1916,977,939
False,8125107,Wüstenrot,unter 3 Jahre,149,71,78
False,8125107,Wüstenrot,3 -  6 Jahre,181,98,83
False,8125107,Wüstenrot,6 - 10 Jahre,249,118,131
False,8125107,Wüstenrot,10 - 15 Jahre,368,178,190
False,8125107,Wüstenrot,15 - 18 Jahre,238,130,108
False,8125107,Wüstenrot,18 - 20 Jahre,169,89,80
False,8125107,Wüstenrot,20 - 25 Jahre,373,187,186
False,8125107,Wüstenrot,25 - 30 Jahre,328,157,171
False,8125107,Wüstenrot,30 - 35 Jahre,319,171,148
False,8125107,Wüstenrot,35 - 40 Jahre,338,170,168
False,8125107,Wüstenrot,40 - 45 Jahre,518,254,264
False,8125107,Wüstenrot,45 - 50 Jahre,628,296,332
False,8125107,Wüstenrot,50 - 55 Jahre,529,276,253
False,8125107,Wüstenrot,55 - 60 Jahre,433,226,207
False,8125107,Wüstenrot,60 - 65 Jahre,355,180,175
False,8125107,Wüstenrot,65 - 75 Jahre,623,310,313
False,8125107,Wüstenrot,75 und mehr Jahre,835,294,541
False,8125107,Wüstenrot,Insgesamt,6633,3205,3428
False,8125108,Zaberfeld,unter 3 Jahre,73,43,30
False,8125108,Zaberfeld,3 -  6 Jahre,100,41,59
False,8125108,Zaberfeld,6 - 10 Jahre,173,86,87
False,8125108,Zaberfeld,10 - 15 Jahre,251,118,133
False,8125108,Zaberfeld,15 - 18 Jahre,157,82,75
False,8125108,Zaberfeld,18 - 20 Jahre,118,52,66
False,8125108,Zaberfeld,20 - 25 Jahre,222,127,95
False,8125108,Zaberfeld,25 - 30 Jahre,156,75,81
False,8125108,Zaberfeld,30 - 35 Jahre,202,95,107
False,8125108,Zaberfeld,35 - 40 Jahre,224,108,116
False,8125108,Zaberfeld,40 - 45 Jahre,319,153,166
False,8125108,Zaberfeld,45 - 50 Jahre,401,200,201
False,8125108,Zaberfeld,50 - 55 Jahre,347,165,182
False,8125108,Zaberfeld,55 - 60 Jahre,274,150,124
False,8125108,Zaberfeld,60 - 65 Jahre,221,117,104
False,8125108,Zaberfeld,65 - 75 Jahre,382,185,197
False,8125108,Zaberfeld,75 und mehr Jahre,295,116,179
False,8125108,Zaberfeld,Insgesamt,3915,1913,2002
False,8125110,Obersulm,unter 3 Jahre,343,165,178
False,8125110,Obersulm,3 -  6 Jahre,359,184,175
False,8125110,Obersulm,6 - 10 Jahre,574,305,269
False,8125110,Obersulm,10 - 15 Jahre,778,387,391
False,8125110,Obersulm,15 - 18 Jahre,495,255,240
False,8125110,Obersulm,18 - 20 Jahre,324,177,147
False,8125110,Obersulm,20 - 25 Jahre,807,432,375
False,8125110,Obersulm,25 - 30 Jahre,727,372,355
False,8125110,Obersulm,30 - 35 Jahre,847,445,402
False,8125110,Obersulm,35 - 40 Jahre,896,446,450
False,8125110,Obersulm,40 - 45 Jahre,1135,585,550
False,8125110,Obersulm,45 - 50 Jahre,1271,668,603
False,8125110,Obersulm,50 - 55 Jahre,1097,561,536
False,8125110,Obersulm,55 - 60 Jahre,839,428,411
False,8125110,Obersulm,60 - 65 Jahre,756,360,396
False,8125110,Obersulm,65 - 75 Jahre,1521,754,767
False,8125110,Obersulm,75 und mehr Jahre,1183,471,712
False,8125110,Obersulm,Insgesamt,13952,6995,6957
False,8125111,Hardthausen am Kocher,unter 3 Jahre,126,73,53
False,8125111,Hardthausen am Kocher,3 -  6 Jahre,118,59,59
False,8125111,Hardthausen am Kocher,6 - 10 Jahre,159,69,90
False,8125111,Hardthausen am Kocher,10 - 15 Jahre,273,143,130
False,8125111,Hardthausen am Kocher,15 - 18 Jahre,170,93,77
False,8125111,Hardthausen am Kocher,18 - 20 Jahre,113,65,48
False,8125111,Hardthausen am Kocher,20 - 25 Jahre,248,130,118
False,8125111,Hardthausen am Kocher,25 - 30 Jahre,212,115,97
False,8125111,Hardthausen am Kocher,30 - 35 Jahre,250,128,122
False,8125111,Hardthausen am Kocher,35 - 40 Jahre,250,116,134
False,8125111,Hardthausen am Kocher,40 - 45 Jahre,363,180,183
False,8125111,Hardthausen am Kocher,45 - 50 Jahre,409,229,180
False,8125111,Hardthausen am Kocher,50 - 55 Jahre,290,149,141
False,8125111,Hardthausen am Kocher,55 - 60 Jahre,235,118,117
False,8125111,Hardthausen am Kocher,60 - 65 Jahre,175,98,77
False,8125111,Hardthausen am Kocher,65 - 75 Jahre,337,155,182
False,8125111,Hardthausen am Kocher,75 und mehr Jahre,261,117,144
False,8125111,Hardthausen am Kocher,Insgesamt,3989,2037,1952
False,8125113,Langenbrettach,unter 3 Jahre,101,48,53
False,8125113,Langenbrettach,3 -  6 Jahre,127,61,66
False,8125113,Langenbrettach,6 - 10 Jahre,166,97,69
False,8125113,Langenbrettach,10 - 15 Jahre,211,117,94
False,8125113,Langenbrettach,15 - 18 Jahre,130,63,67
False,8125113,Langenbrettach,18 - 20 Jahre,92,46,46
False,8125113,Langenbrettach,20 - 25 Jahre,229,125,104
False,8125113,Langenbrettach,25 - 30 Jahre,214,119,95
False,8125113,Langenbrettach,30 - 35 Jahre,234,113,121
False,8125113,Langenbrettach,35 - 40 Jahre,288,159,129
False,8125113,Langenbrettach,40 - 45 Jahre,315,159,156
False,8125113,Langenbrettach,45 - 50 Jahre,330,167,163
False,8125113,Langenbrettach,50 - 55 Jahre,280,136,144
False,8125113,Langenbrettach,55 - 60 Jahre,212,100,112
False,8125113,Langenbrettach,60 - 65 Jahre,161,82,79
False,8125113,Langenbrettach,65 - 75 Jahre,303,157,146
False,8125113,Langenbrettach,75 und mehr Jahre,248,101,147
False,8125113,Langenbrettach,Insgesamt,3641,1850,1791
False,8126,Landkreis Hohenlohekreis,unter 3 Jahre,2826,1516,1310
False,8126,Landkreis Hohenlohekreis,3 -  6 Jahre,2929,1494,1435
False,8126,Landkreis Hohenlohekreis,6 - 10 Jahre,4346,2257,2089
False,8126,Landkreis Hohenlohekreis,10 - 15 Jahre,6293,3274,3019
False,8126,Landkreis Hohenlohekreis,15 - 18 Jahre,3990,2005,1985
False,8126,Landkreis Hohenlohekreis,18 - 20 Jahre,2827,1417,1410
False,8126,Landkreis Hohenlohekreis,20 - 25 Jahre,6833,3593,3240
False,8126,Landkreis Hohenlohekreis,25 - 30 Jahre,6233,3365,2868
False,8126,Landkreis Hohenlohekreis,30 - 35 Jahre,6249,3109,3140
False,8126,Landkreis Hohenlohekreis,35 - 40 Jahre,6738,3424,3314
False,8126,Landkreis Hohenlohekreis,40 - 45 Jahre,8852,4498,4354
False,8126,Landkreis Hohenlohekreis,45 - 50 Jahre,9533,4944,4589
False,8126,Landkreis Hohenlohekreis,50 - 55 Jahre,8492,4360,4132
False,8126,Landkreis Hohenlohekreis,55 - 60 Jahre,7107,3616,3491
False,8126,Landkreis Hohenlohekreis,60 - 65 Jahre,5691,2931,2760
False,8126,Landkreis Hohenlohekreis,65 - 75 Jahre,10414,4962,5452
False,8126,Landkreis Hohenlohekreis,75 und mehr Jahre,9560,3735,5825
False,8126,Landkreis Hohenlohekreis,Insgesamt,108913,54500,54413
False,8126011,Bretzfeld,unter 3 Jahre,302,172,130
False,8126011,Bretzfeld,3 -  6 Jahre,347,172,175
False,8126011,Bretzfeld,6 - 10 Jahre,523,263,260
False,8126011,Bretzfeld,10 - 15 Jahre,731,381,350
False,8126011,Bretzfeld,15 - 18 Jahre,475,226,249
False,8126011,Bretzfeld,18 - 20 Jahre,327,180,147
False,8126011,Bretzfeld,20 - 25 Jahre,820,429,391
False,8126011,Bretzfeld,25 - 30 Jahre,702,366,336
False,8126011,Bretzfeld,30 - 35 Jahre,692,344,348
False,8126011,Bretzfeld,35 - 40 Jahre,766,390,376
False,8126011,Bretzfeld,40 - 45 Jahre,1022,532,490
False,8126011,Bretzfeld,45 - 50 Jahre,1139,567,572
False,8126011,Bretzfeld,50 - 55 Jahre,960,483,477
False,8126011,Bretzfeld,55 - 60 Jahre,847,422,425
False,8126011,Bretzfeld,60 - 65 Jahre,668,353,315
False,8126011,Bretzfeld,65 - 75 Jahre,995,474,521
False,8126011,Bretzfeld,75 und mehr Jahre,928,393,535
False,8126011,Bretzfeld,Insgesamt,12244,6147,6097
False,8126020,Dörzbach,unter 3 Jahre,80,35,45
False,8126020,Dörzbach,3 -  6 Jahre,63,36,27
False,8126020,Dörzbach,6 - 10 Jahre,104,56,48
False,8126020,Dörzbach,10 - 15 Jahre,161,83,78
False,8126020,Dörzbach,15 - 18 Jahre,82,42,40
False,8126020,Dörzbach,18 - 20 Jahre,53,22,31
False,8126020,Dörzbach,20 - 25 Jahre,142,84,58
False,8126020,Dörzbach,25 - 30 Jahre,127,66,61
False,8126020,Dörzbach,30 - 35 Jahre,149,66,83
False,8126020,Dörzbach,35 - 40 Jahre,172,92,80
False,8126020,Dörzbach,40 - 45 Jahre,197,108,89
False,8126020,Dörzbach,45 - 50 Jahre,216,111,105
False,8126020,Dörzbach,50 - 55 Jahre,171,90,81
False,8126020,Dörzbach,55 - 60 Jahre,163,82,81
False,8126020,Dörzbach,60 - 65 Jahre,116,61,55
False,8126020,Dörzbach,65 - 75 Jahre,211,107,104
False,8126020,Dörzbach,75 und mehr Jahre,217,78,139
False,8126020,Dörzbach,Insgesamt,2424,1219,1205
False,8126028,"Forchtenberg, Stadt",unter 3 Jahre,141,79,62
False,8126028,"Forchtenberg, Stadt",3 -  6 Jahre,130,64,66
False,8126028,"Forchtenberg, Stadt",6 - 10 Jahre,203,106,97
False,8126028,"Forchtenberg, Stadt",10 - 15 Jahre,266,144,122
False,8126028,"Forchtenberg, Stadt",15 - 18 Jahre,214,106,108
False,8126028,"Forchtenberg, Stadt",18 - 20 Jahre,151,77,74
False,8126028,"Forchtenberg, Stadt",20 - 25 Jahre,303,155,148
False,8126028,"Forchtenberg, Stadt",25 - 30 Jahre,273,140,133
False,8126028,"Forchtenberg, Stadt",30 - 35 Jahre,308,142,166
False,8126028,"Forchtenberg, Stadt",35 - 40 Jahre,307,163,144
False,8126028,"Forchtenberg, Stadt",40 - 45 Jahre,421,220,201
False,8126028,"Forchtenberg, Stadt",45 - 50 Jahre,432,224,208
False,8126028,"Forchtenberg, Stadt",50 - 55 Jahre,365,177,188
False,8126028,"Forchtenberg, Stadt",55 - 60 Jahre,322,166,156
False,8126028,"Forchtenberg, Stadt",60 - 65 Jahre,269,139,130
False,8126028,"Forchtenberg, Stadt",65 - 75 Jahre,468,232,236
False,8126028,"Forchtenberg, Stadt",75 und mehr Jahre,407,160,247
False,8126028,"Forchtenberg, Stadt",Insgesamt,4980,2494,2486
False,8126039,"Ingelfingen, Stadt",unter 3 Jahre,137,74,63
False,8126039,"Ingelfingen, Stadt",3 -  6 Jahre,167,75,92
False,8126039,"Ingelfingen, Stadt",6 - 10 Jahre,250,128,122
False,8126039,"Ingelfingen, Stadt",10 - 15 Jahre,326,171,155
False,8126039,"Ingelfingen, Stadt",15 - 18 Jahre,223,121,102
False,8126039,"Ingelfingen, Stadt",18 - 20 Jahre,150,63,87
False,8126039,"Ingelfingen, Stadt",20 - 25 Jahre,338,172,166
False,8126039,"Ingelfingen, Stadt",25 - 30 Jahre,282,150,132
False,8126039,"Ingelfingen, Stadt",30 - 35 Jahre,304,143,161
False,8126039,"Ingelfingen, Stadt",35 - 40 Jahre,324,148,176
False,8126039,"Ingelfingen, Stadt",40 - 45 Jahre,502,244,258
False,8126039,"Ingelfingen, Stadt",45 - 50 Jahre,481,267,214
False,8126039,"Ingelfingen, Stadt",50 - 55 Jahre,405,214,191
False,8126039,"Ingelfingen, Stadt",55 - 60 Jahre,352,175,177
False,8126039,"Ingelfingen, Stadt",60 - 65 Jahre,299,152,147
False,8126039,"Ingelfingen, Stadt",65 - 75 Jahre,572,272,300
False,8126039,"Ingelfingen, Stadt",75 und mehr Jahre,579,211,368
False,8126039,"Ingelfingen, Stadt",Insgesamt,5691,2780,2911
False,8126045,"Krautheim, Stadt",unter 3 Jahre,121,65,56
False,8126045,"Krautheim, Stadt",3 -  6 Jahre,127,70,57
False,8126045,"Krautheim, Stadt",6 - 10 Jahre,182,95,87
False,8126045,"Krautheim, Stadt",10 - 15 Jahre,273,167,106
False,8126045,"Krautheim, Stadt",15 - 18 Jahre,182,103,79
False,8126045,"Krautheim, Stadt",18 - 20 Jahre,121,63,58
False,8126045,"Krautheim, Stadt",20 - 25 Jahre,288,147,141
False,8126045,"Krautheim, Stadt",25 - 30 Jahre,250,132,118
False,8126045,"Krautheim, Stadt",30 - 35 Jahre,231,129,102
False,8126045,"Krautheim, Stadt",35 - 40 Jahre,286,134,152
False,8126045,"Krautheim, Stadt",40 - 45 Jahre,408,217,191
False,8126045,"Krautheim, Stadt",45 - 50 Jahre,458,248,210
False,8126045,"Krautheim, Stadt",50 - 55 Jahre,395,201,194
False,8126045,"Krautheim, Stadt",55 - 60 Jahre,290,163,127
False,8126045,"Krautheim, Stadt",60 - 65 Jahre,237,115,122
False,8126045,"Krautheim, Stadt",65 - 75 Jahre,424,216,208
False,8126045,"Krautheim, Stadt",75 und mehr Jahre,444,184,260
False,8126045,"Krautheim, Stadt",Insgesamt,4717,2449,2268
False,8126046,"Künzelsau, Stadt",unter 3 Jahre,364,187,177
False,8126046,"Künzelsau, Stadt",3 -  6 Jahre,381,194,187
False,8126046,"Künzelsau, Stadt",6 - 10 Jahre,551,265,286
False,8126046,"Künzelsau, Stadt",10 - 15 Jahre,777,379,398
False,8126046,"Künzelsau, Stadt",15 - 18 Jahre,460,209,251
False,8126046,"Künzelsau, Stadt",18 - 20 Jahre,372,183,189
False,8126046,"Künzelsau, Stadt",20 - 25 Jahre,1010,551,459
False,8126046,"Künzelsau, Stadt",25 - 30 Jahre,953,539,414
False,8126046,"Künzelsau, Stadt",30 - 35 Jahre,849,431,418
False,8126046,"Künzelsau, Stadt",35 - 40 Jahre,898,445,453
False,8126046,"Künzelsau, Stadt",40 - 45 Jahre,1091,553,538
False,8126046,"Künzelsau, Stadt",45 - 50 Jahre,1172,595,577
False,8126046,"Künzelsau, Stadt",50 - 55 Jahre,1188,598,590
False,8126046,"Künzelsau, Stadt",55 - 60 Jahre,986,487,499
False,8126046,"Künzelsau, Stadt",60 - 65 Jahre,749,378,371
False,8126046,"Künzelsau, Stadt",65 - 75 Jahre,1517,714,803
False,8126046,"Künzelsau, Stadt",75 und mehr Jahre,1504,568,936
False,8126046,"Künzelsau, Stadt",Insgesamt,14822,7276,7546
False,8126047,Kupferzell,unter 3 Jahre,155,75,80
False,8126047,Kupferzell,3 -  6 Jahre,158,87,71
False,8126047,Kupferzell,6 - 10 Jahre,234,133,101
False,8126047,Kupferzell,10 - 15 Jahre,316,161,155
False,8126047,Kupferzell,15 - 18 Jahre,231,126,105
False,8126047,Kupferzell,18 - 20 Jahre,156,79,77
False,8126047,Kupferzell,20 - 25 Jahre,405,195,210
False,8126047,Kupferzell,25 - 30 Jahre,411,216,195
False,8126047,Kupferzell,30 - 35 Jahre,360,192,168
False,8126047,Kupferzell,35 - 40 Jahre,378,188,190
False,8126047,Kupferzell,40 - 45 Jahre,514,272,242
False,8126047,Kupferzell,45 - 50 Jahre,527,255,272
False,8126047,Kupferzell,50 - 55 Jahre,452,235,217
False,8126047,Kupferzell,55 - 60 Jahre,361,180,181
False,8126047,Kupferzell,60 - 65 Jahre,279,151,128
False,8126047,Kupferzell,65 - 75 Jahre,434,203,231
False,8126047,Kupferzell,75 und mehr Jahre,412,163,249
False,8126047,Kupferzell,Insgesamt,5783,2911,2872
False,8126056,Mulfingen,unter 3 Jahre,84,50,34
False,8126056,Mulfingen,3 -  6 Jahre,115,58,57
False,8126056,Mulfingen,6 - 10 Jahre,186,95,91
False,8126056,Mulfingen,10 - 15 Jahre,245,133,112
False,8126056,Mulfingen,15 - 18 Jahre,154,80,74
False,8126056,Mulfingen,18 - 20 Jahre,97,49,48
False,8126056,Mulfingen,20 - 25 Jahre,277,162,115
False,8126056,Mulfingen,25 - 30 Jahre,202,108,94
False,8126056,Mulfingen,30 - 35 Jahre,161,87,74
False,8126056,Mulfingen,35 - 40 Jahre,235,125,110
False,8126056,Mulfingen,40 - 45 Jahre,264,145,119
False,8126056,Mulfingen,45 - 50 Jahre,343,176,167
False,8126056,Mulfingen,50 - 55 Jahre,308,166,142
False,8126056,Mulfingen,55 - 60 Jahre,223,118,105
False,8126056,Mulfingen,60 - 65 Jahre,197,110,87
False,8126056,Mulfingen,65 - 75 Jahre,294,144,150
False,8126056,Mulfingen,75 und mehr Jahre,333,124,209
False,8126056,Mulfingen,Insgesamt,3718,1930,1788
False,8126058,"Neuenstein, Stadt",unter 3 Jahre,170,87,83
False,8126058,"Neuenstein, Stadt",3 -  6 Jahre,185,107,78
False,8126058,"Neuenstein, Stadt",6 - 10 Jahre,247,128,119
False,8126058,"Neuenstein, Stadt",10 - 15 Jahre,393,211,182
False,8126058,"Neuenstein, Stadt",15 - 18 Jahre,236,123,113
False,8126058,"Neuenstein, Stadt",18 - 20 Jahre,175,90,85
False,8126058,"Neuenstein, Stadt",20 - 25 Jahre,372,190,182
False,8126058,"Neuenstein, Stadt",25 - 30 Jahre,343,186,157
False,8126058,"Neuenstein, Stadt",30 - 35 Jahre,378,172,206
False,8126058,"Neuenstein, Stadt",35 - 40 Jahre,365,188,177
False,8126058,"Neuenstein, Stadt",40 - 45 Jahre,502,264,238
False,8126058,"Neuenstein, Stadt",45 - 50 Jahre,583,297,286
False,8126058,"Neuenstein, Stadt",50 - 55 Jahre,493,274,219
False,8126058,"Neuenstein, Stadt",55 - 60 Jahre,421,222,199
False,8126058,"Neuenstein, Stadt",60 - 65 Jahre,329,180,149
False,8126058,"Neuenstein, Stadt",65 - 75 Jahre,532,245,287
False,8126058,"Neuenstein, Stadt",75 und mehr Jahre,517,203,314
False,8126058,"Neuenstein, Stadt",Insgesamt,6241,3167,3074
False,8126060,"Niedernhall, Stadt",unter 3 Jahre,92,46,46
False,8126060,"Niedernhall, Stadt",3 -  6 Jahre,104,44,60
False,8126060,"Niedernhall, Stadt",6 - 10 Jahre,153,87,66
False,8126060,"Niedernhall, Stadt",10 - 15 Jahre,242,118,124
False,8126060,"Niedernhall, Stadt",15 - 18 Jahre,117,61,56
False,8126060,"Niedernhall, Stadt",18 - 20 Jahre,97,50,47
False,8126060,"Niedernhall, Stadt",20 - 25 Jahre,205,101,104
False,8126060,"Niedernhall, Stadt",25 - 30 Jahre,209,120,89
False,8126060,"Niedernhall, Stadt",30 - 35 Jahre,230,118,112
False,8126060,"Niedernhall, Stadt",35 - 40 Jahre,263,159,104
False,8126060,"Niedernhall, Stadt",40 - 45 Jahre,344,180,164
False,8126060,"Niedernhall, Stadt",45 - 50 Jahre,334,180,154
False,8126060,"Niedernhall, Stadt",50 - 55 Jahre,313,169,144
False,8126060,"Niedernhall, Stadt",55 - 60 Jahre,266,136,130
False,8126060,"Niedernhall, Stadt",60 - 65 Jahre,270,130,140
False,8126060,"Niedernhall, Stadt",65 - 75 Jahre,401,200,201
False,8126060,"Niedernhall, Stadt",75 und mehr Jahre,305,141,164
False,8126060,"Niedernhall, Stadt",Insgesamt,3945,2040,1905
False,8126066,"Öhringen, Stadt",unter 3 Jahre,625,357,268
False,8126066,"Öhringen, Stadt",3 -  6 Jahre,584,302,282
False,8126066,"Öhringen, Stadt",6 - 10 Jahre,872,447,425
False,8126066,"Öhringen, Stadt",10 - 15 Jahre,1242,653,589
False,8126066,"Öhringen, Stadt",15 - 18 Jahre,787,409,378
False,8126066,"Öhringen, Stadt",18 - 20 Jahre,539,271,268
False,8126066,"Öhringen, Stadt",20 - 25 Jahre,1303,694,609
False,8126066,"Öhringen, Stadt",25 - 30 Jahre,1346,717,629
False,8126066,"Öhringen, Stadt",30 - 35 Jahre,1449,711,738
False,8126066,"Öhringen, Stadt",35 - 40 Jahre,1380,695,685
False,8126066,"Öhringen, Stadt",40 - 45 Jahre,1700,847,853
False,8126066,"Öhringen, Stadt",45 - 50 Jahre,1923,994,929
False,8126066,"Öhringen, Stadt",50 - 55 Jahre,1864,932,932
False,8126066,"Öhringen, Stadt",55 - 60 Jahre,1531,751,780
False,8126066,"Öhringen, Stadt",60 - 65 Jahre,1173,603,570
False,8126066,"Öhringen, Stadt",65 - 75 Jahre,2287,1035,1252
False,8126066,"Öhringen, Stadt",75 und mehr Jahre,2157,811,1346
False,8126066,"Öhringen, Stadt",Insgesamt,22762,11229,11533
False,8126069,Pfedelbach,unter 3 Jahre,260,137,123
False,8126069,Pfedelbach,3 -  6 Jahre,246,129,117
False,8126069,Pfedelbach,6 - 10 Jahre,383,187,196
False,8126069,Pfedelbach,10 - 15 Jahre,563,280,283
False,8126069,Pfedelbach,15 - 18 Jahre,340,155,185
False,8126069,Pfedelbach,18 - 20 Jahre,213,122,91
False,8126069,Pfedelbach,20 - 25 Jahre,484,249,235
False,8126069,Pfedelbach,25 - 30 Jahre,467,244,223
False,8126069,Pfedelbach,30 - 35 Jahre,492,235,257
False,8126069,Pfedelbach,35 - 40 Jahre,605,313,292
False,8126069,Pfedelbach,40 - 45 Jahre,750,359,391
False,8126069,Pfedelbach,45 - 50 Jahre,780,414,366
False,8126069,Pfedelbach,50 - 55 Jahre,671,354,317
False,8126069,Pfedelbach,55 - 60 Jahre,549,281,268
False,8126069,Pfedelbach,60 - 65 Jahre,487,232,255
False,8126069,Pfedelbach,65 - 75 Jahre,967,466,501
False,8126069,Pfedelbach,75 und mehr Jahre,729,294,435
False,8126069,Pfedelbach,Insgesamt,8986,4451,4535
False,8126072,Schöntal,unter 3 Jahre,128,63,65
False,8126072,Schöntal,3 -  6 Jahre,145,66,79
False,8126072,Schöntal,6 - 10 Jahre,214,128,86
False,8126072,Schöntal,10 - 15 Jahre,353,196,157
False,8126072,Schöntal,15 - 18 Jahre,214,113,101
False,8126072,Schöntal,18 - 20 Jahre,154,66,88
False,8126072,Schöntal,20 - 25 Jahre,360,199,161
False,8126072,Schöntal,25 - 30 Jahre,263,151,112
False,8126072,Schöntal,30 - 35 Jahre,265,145,120
False,8126072,Schöntal,35 - 40 Jahre,348,174,174
False,8126072,Schöntal,40 - 45 Jahre,497,251,246
False,8126072,Schöntal,45 - 50 Jahre,535,297,238
False,8126072,Schöntal,50 - 55 Jahre,440,227,213
False,8126072,Schöntal,55 - 60 Jahre,365,194,171
False,8126072,Schöntal,60 - 65 Jahre,288,154,134
False,8126072,Schöntal,65 - 75 Jahre,618,303,315
False,8126072,Schöntal,75 und mehr Jahre,509,199,310
False,8126072,Schöntal,Insgesamt,5696,2926,2770
False,8126085,"Waldenburg, Stadt",unter 3 Jahre,68,32,36
False,8126085,"Waldenburg, Stadt",3 -  6 Jahre,85,42,43
False,8126085,"Waldenburg, Stadt",6 - 10 Jahre,105,61,44
False,8126085,"Waldenburg, Stadt",10 - 15 Jahre,173,82,91
False,8126085,"Waldenburg, Stadt",15 - 18 Jahre,119,54,65
False,8126085,"Waldenburg, Stadt",18 - 20 Jahre,116,48,68
False,8126085,"Waldenburg, Stadt",20 - 25 Jahre,282,143,139
False,8126085,"Waldenburg, Stadt",25 - 30 Jahre,186,111,75
False,8126085,"Waldenburg, Stadt",30 - 35 Jahre,163,86,77
False,8126085,"Waldenburg, Stadt",35 - 40 Jahre,143,63,80
False,8126085,"Waldenburg, Stadt",40 - 45 Jahre,299,129,170
False,8126085,"Waldenburg, Stadt",45 - 50 Jahre,274,139,135
False,8126085,"Waldenburg, Stadt",50 - 55 Jahre,184,95,89
False,8126085,"Waldenburg, Stadt",55 - 60 Jahre,179,101,78
False,8126085,"Waldenburg, Stadt",60 - 65 Jahre,135,72,63
False,8126085,"Waldenburg, Stadt",65 - 75 Jahre,292,155,137
False,8126085,"Waldenburg, Stadt",75 und mehr Jahre,201,67,134
False,8126085,"Waldenburg, Stadt",Insgesamt,3004,1480,1524
False,8126086,Weißbach,unter 3 Jahre,50,31,19
False,8126086,Weißbach,3 -  6 Jahre,53,23,30
False,8126086,Weißbach,6 - 10 Jahre,80,49,31
False,8126086,Weißbach,10 - 15 Jahre,111,58,53
False,8126086,Weißbach,15 - 18 Jahre,85,38,47
False,8126086,Weißbach,18 - 20 Jahre,64,29,35
False,8126086,Weißbach,20 - 25 Jahre,143,73,70
False,8126086,Weißbach,25 - 30 Jahre,132,73,59
False,8126086,Weißbach,30 - 35 Jahre,118,67,51
False,8126086,Weißbach,35 - 40 Jahre,138,78,60
False,8126086,Weißbach,40 - 45 Jahre,182,91,91
False,8126086,Weißbach,45 - 50 Jahre,169,85,84
False,8126086,Weißbach,50 - 55 Jahre,166,80,86
False,8126086,Weißbach,55 - 60 Jahre,135,75,60
False,8126086,Weißbach,60 - 65 Jahre,105,49,56
False,8126086,Weißbach,65 - 75 Jahre,227,104,123
False,8126086,Weißbach,75 und mehr Jahre,154,65,89
False,8126086,Weißbach,Insgesamt,2112,1068,1044
False,8126094,Zweiflingen,unter 3 Jahre,49,26,23
False,8126094,Zweiflingen,3 -  6 Jahre,39,25,14
False,8126094,Zweiflingen,6 - 10 Jahre,59,29,30
False,8126094,Zweiflingen,10 - 15 Jahre,121,57,64
False,8126094,Zweiflingen,15 - 18 Jahre,71,39,32
False,8126094,Zweiflingen,18 - 20 Jahre,42,25,17
False,8126094,Zweiflingen,20 - 25 Jahre,101,49,52
False,8126094,Zweiflingen,25 - 30 Jahre,87,46,41
False,8126094,Zweiflingen,30 - 35 Jahre,100,41,59
False,8126094,Zweiflingen,35 - 40 Jahre,130,69,61
False,8126094,Zweiflingen,40 - 45 Jahre,159,86,73
False,8126094,Zweiflingen,45 - 50 Jahre,167,95,72
False,8126094,Zweiflingen,50 - 55 Jahre,117,65,52
False,8126094,Zweiflingen,55 - 60 Jahre,117,63,54
False,8126094,Zweiflingen,60 - 65 Jahre,90,52,38
False,8126094,Zweiflingen,65 - 75 Jahre,175,92,83
False,8126094,Zweiflingen,75 und mehr Jahre,164,74,90
False,8126094,Zweiflingen,Insgesamt,1788,933,855
False,8127,Landkreis Schwäbisch Hall,unter 3 Jahre,4893,2439,2454
False,8127,Landkreis Schwäbisch Hall,3 -  6 Jahre,5214,2631,2583
False,8127,Landkreis Schwäbisch Hall,6 - 10 Jahre,7641,3968,3673
False,8127,Landkreis Schwäbisch Hall,10 - 15 Jahre,11028,5691,5337
False,8127,Landkreis Schwäbisch Hall,15 - 18 Jahre,7132,3621,3511
False,8127,Landkreis Schwäbisch Hall,18 - 20 Jahre,4863,2526,2337
False,8127,Landkreis Schwäbisch Hall,20 - 25 Jahre,11437,6034,5403
False,8127,Landkreis Schwäbisch Hall,25 - 30 Jahre,11190,5923,5267
False,8127,Landkreis Schwäbisch Hall,30 - 35 Jahre,10902,5570,5332
False,8127,Landkreis Schwäbisch Hall,35 - 40 Jahre,11409,5768,5641
False,8127,Landkreis Schwäbisch Hall,40 - 45 Jahre,15262,7837,7425
False,8127,Landkreis Schwäbisch Hall,45 - 50 Jahre,16099,8194,7905
False,8127,Landkreis Schwäbisch Hall,50 - 55 Jahre,14595,7417,7178
False,8127,Landkreis Schwäbisch Hall,55 - 60 Jahre,12595,6277,6318
False,8127,Landkreis Schwäbisch Hall,60 - 65 Jahre,10123,5112,5011
False,8127,Landkreis Schwäbisch Hall,65 - 75 Jahre,17885,8472,9413
False,8127,Landkreis Schwäbisch Hall,75 und mehr Jahre,16152,6056,10096
False,8127,Landkreis Schwäbisch Hall,Insgesamt,188420,93536,94884
False,8127008,Blaufelden,unter 3 Jahre,139,70,69
False,8127008,Blaufelden,3 -  6 Jahre,146,65,81
False,8127008,Blaufelden,6 - 10 Jahre,234,119,115
False,8127008,Blaufelden,10 - 15 Jahre,331,184,147
False,8127008,Blaufelden,15 - 18 Jahre,191,87,104
False,8127008,Blaufelden,18 - 20 Jahre,146,75,71
False,8127008,Blaufelden,20 - 25 Jahre,305,171,134
False,8127008,Blaufelden,25 - 30 Jahre,332,204,128
False,8127008,Blaufelden,30 - 35 Jahre,316,167,149
False,8127008,Blaufelden,35 - 40 Jahre,301,164,137
False,8127008,Blaufelden,40 - 45 Jahre,394,209,185
False,8127008,Blaufelden,45 - 50 Jahre,433,244,189
False,8127008,Blaufelden,50 - 55 Jahre,374,190,184
False,8127008,Blaufelden,55 - 60 Jahre,327,177,150
False,8127008,Blaufelden,60 - 65 Jahre,277,139,138
False,8127008,Blaufelden,65 - 75 Jahre,500,246,254
False,8127008,Blaufelden,75 und mehr Jahre,450,173,277
False,8127008,Blaufelden,Insgesamt,5196,2684,2512
False,8127009,Braunsbach,unter 3 Jahre,68,34,34
False,8127009,Braunsbach,3 -  6 Jahre,70,34,36
False,8127009,Braunsbach,6 - 10 Jahre,88,42,46
False,8127009,Braunsbach,10 - 15 Jahre,140,66,74
False,8127009,Braunsbach,15 - 18 Jahre,105,48,57
False,8127009,Braunsbach,18 - 20 Jahre,56,33,23
False,8127009,Braunsbach,20 - 25 Jahre,155,84,71
False,8127009,Braunsbach,25 - 30 Jahre,131,85,46
False,8127009,Braunsbach,30 - 35 Jahre,124,58,66
False,8127009,Braunsbach,35 - 40 Jahre,119,62,57
False,8127009,Braunsbach,40 - 45 Jahre,153,71,82
False,8127009,Braunsbach,45 - 50 Jahre,200,94,106
False,8127009,Braunsbach,50 - 55 Jahre,216,123,93
False,8127009,Braunsbach,55 - 60 Jahre,147,74,73
False,8127009,Braunsbach,60 - 65 Jahre,110,60,50
False,8127009,Braunsbach,65 - 75 Jahre,242,111,131
False,8127009,Braunsbach,75 und mehr Jahre,206,78,128
False,8127009,Braunsbach,Insgesamt,2330,1157,1173
False,8127012,Bühlertann,unter 3 Jahre,67,28,39
False,8127012,Bühlertann,3 -  6 Jahre,75,30,45
False,8127012,Bühlertann,6 - 10 Jahre,113,70,43
False,8127012,Bühlertann,10 - 15 Jahre,211,90,121
False,8127012,Bühlertann,15 - 18 Jahre,157,77,80
False,8127012,Bühlertann,18 - 20 Jahre,94,39,55
False,8127012,Bühlertann,20 - 25 Jahre,193,102,91
False,8127012,Bühlertann,25 - 30 Jahre,175,99,76
False,8127012,Bühlertann,30 - 35 Jahre,158,92,66
False,8127012,Bühlertann,35 - 40 Jahre,194,101,93
False,8127012,Bühlertann,40 - 45 Jahre,299,159,140
False,8127012,Bühlertann,45 - 50 Jahre,287,154,133
False,8127012,Bühlertann,50 - 55 Jahre,212,110,102
False,8127012,Bühlertann,55 - 60 Jahre,187,99,88
False,8127012,Bühlertann,60 - 65 Jahre,150,79,71
False,8127012,Bühlertann,65 - 75 Jahre,266,121,145
False,8127012,Bühlertann,75 und mehr Jahre,211,79,132
False,8127012,Bühlertann,Insgesamt,3049,1529,1520
False,8127013,Bühlerzell,unter 3 Jahre,45,25,20
False,8127013,Bühlerzell,3 -  6 Jahre,69,33,36
False,8127013,Bühlerzell,6 - 10 Jahre,83,46,37
False,8127013,Bühlerzell,10 - 15 Jahre,132,63,69
False,8127013,Bühlerzell,15 - 18 Jahre,87,35,52
False,8127013,Bühlerzell,18 - 20 Jahre,52,27,25
False,8127013,Bühlerzell,20 - 25 Jahre,110,73,37
False,8127013,Bühlerzell,25 - 30 Jahre,107,63,44
False,8127013,Bühlerzell,30 - 35 Jahre,126,73,53
False,8127013,Bühlerzell,35 - 40 Jahre,137,69,68
False,8127013,Bühlerzell,40 - 45 Jahre,150,76,74
False,8127013,Bühlerzell,45 - 50 Jahre,199,99,100
False,8127013,Bühlerzell,50 - 55 Jahre,170,101,69
False,8127013,Bühlerzell,55 - 60 Jahre,136,76,60
False,8127013,Bühlerzell,60 - 65 Jahre,87,49,38
False,8127013,Bühlerzell,65 - 75 Jahre,208,94,114
False,8127013,Bühlerzell,75 und mehr Jahre,202,74,128
False,8127013,Bühlerzell,Insgesamt,2100,1076,1024
False,8127014,"Crailsheim, Stadt",unter 3 Jahre,855,458,397
False,8127014,"Crailsheim, Stadt",3 -  6 Jahre,902,439,463
False,8127014,"Crailsheim, Stadt",6 - 10 Jahre,1295,673,622
False,8127014,"Crailsheim, Stadt",10 - 15 Jahre,1688,839,849
False,8127014,"Crailsheim, Stadt",15 - 18 Jahre,1125,567,558
False,8127014,"Crailsheim, Stadt",18 - 20 Jahre,780,383,397
False,8127014,"Crailsheim, Stadt",20 - 25 Jahre,2045,1088,957
False,8127014,"Crailsheim, Stadt",25 - 30 Jahre,2200,1144,1056
False,8127014,"Crailsheim, Stadt",30 - 35 Jahre,2081,1075,1006
False,8127014,"Crailsheim, Stadt",35 - 40 Jahre,2012,1037,975
False,8127014,"Crailsheim, Stadt",40 - 45 Jahre,2524,1363,1161
False,8127014,"Crailsheim, Stadt",45 - 50 Jahre,2650,1355,1295
False,8127014,"Crailsheim, Stadt",50 - 55 Jahre,2625,1341,1284
False,8127014,"Crailsheim, Stadt",55 - 60 Jahre,2223,1080,1143
False,8127014,"Crailsheim, Stadt",60 - 65 Jahre,1752,863,889
False,8127014,"Crailsheim, Stadt",65 - 75 Jahre,3251,1504,1747
False,8127014,"Crailsheim, Stadt",75 und mehr Jahre,3013,1089,1924
False,8127014,"Crailsheim, Stadt",Insgesamt,33021,16298,16723
False,8127023,Fichtenberg,unter 3 Jahre,59,23,36
False,8127023,Fichtenberg,3 -  6 Jahre,63,29,34
False,8127023,Fichtenberg,6 - 10 Jahre,112,56,56
False,8127023,Fichtenberg,10 - 15 Jahre,178,96,82
False,8127023,Fichtenberg,15 - 18 Jahre,116,57,59
False,8127023,Fichtenberg,18 - 20 Jahre,64,37,27
False,8127023,Fichtenberg,20 - 25 Jahre,156,90,66
False,8127023,Fichtenberg,25 - 30 Jahre,156,91,65
False,8127023,Fichtenberg,30 - 35 Jahre,150,69,81
False,8127023,Fichtenberg,35 - 40 Jahre,154,72,82
False,8127023,Fichtenberg,40 - 45 Jahre,241,111,130
False,8127023,Fichtenberg,45 - 50 Jahre,241,121,120
False,8127023,Fichtenberg,50 - 55 Jahre,243,128,115
False,8127023,Fichtenberg,55 - 60 Jahre,186,89,97
False,8127023,Fichtenberg,60 - 65 Jahre,173,91,82
False,8127023,Fichtenberg,65 - 75 Jahre,282,141,141
False,8127023,Fichtenberg,75 und mehr Jahre,247,87,160
False,8127023,Fichtenberg,Insgesamt,2821,1388,1433
False,8127025,"Gaildorf, Stadt",unter 3 Jahre,287,144,143
False,8127025,"Gaildorf, Stadt",3 -  6 Jahre,342,181,161
False,8127025,"Gaildorf, Stadt",6 - 10 Jahre,542,274,268
False,8127025,"Gaildorf, Stadt",10 - 15 Jahre,726,378,348
False,8127025,"Gaildorf, Stadt",15 - 18 Jahre,461,228,233
False,8127025,"Gaildorf, Stadt",18 - 20 Jahre,300,164,136
False,8127025,"Gaildorf, Stadt",20 - 25 Jahre,729,374,355
False,8127025,"Gaildorf, Stadt",25 - 30 Jahre,710,363,347
False,8127025,"Gaildorf, Stadt",30 - 35 Jahre,717,376,341
False,8127025,"Gaildorf, Stadt",35 - 40 Jahre,757,396,361
False,8127025,"Gaildorf, Stadt",40 - 45 Jahre,945,478,467
False,8127025,"Gaildorf, Stadt",45 - 50 Jahre,1002,511,491
False,8127025,"Gaildorf, Stadt",50 - 55 Jahre,975,468,507
False,8127025,"Gaildorf, Stadt",55 - 60 Jahre,845,431,414
False,8127025,"Gaildorf, Stadt",60 - 65 Jahre,663,322,341
False,8127025,"Gaildorf, Stadt",65 - 75 Jahre,1212,598,614
False,8127025,"Gaildorf, Stadt",75 und mehr Jahre,1119,443,676
False,8127025,"Gaildorf, Stadt",Insgesamt,12332,6129,6203
False,8127032,"Gerabronn, Stadt",unter 3 Jahre,87,47,40
False,8127032,"Gerabronn, Stadt",3 -  6 Jahre,109,61,48
False,8127032,"Gerabronn, Stadt",6 - 10 Jahre,134,68,66
False,8127032,"Gerabronn, Stadt",10 - 15 Jahre,241,129,112
False,8127032,"Gerabronn, Stadt",15 - 18 Jahre,167,78,89
False,8127032,"Gerabronn, Stadt",18 - 20 Jahre,117,61,56
False,8127032,"Gerabronn, Stadt",20 - 25 Jahre,235,128,107
False,8127032,"Gerabronn, Stadt",25 - 30 Jahre,246,142,104
False,8127032,"Gerabronn, Stadt",30 - 35 Jahre,239,121,118
False,8127032,"Gerabronn, Stadt",35 - 40 Jahre,236,126,110
False,8127032,"Gerabronn, Stadt",40 - 45 Jahre,326,178,148
False,8127032,"Gerabronn, Stadt",45 - 50 Jahre,359,192,167
False,8127032,"Gerabronn, Stadt",50 - 55 Jahre,345,170,175
False,8127032,"Gerabronn, Stadt",55 - 60 Jahre,320,177,143
False,8127032,"Gerabronn, Stadt",60 - 65 Jahre,222,123,99
False,8127032,"Gerabronn, Stadt",65 - 75 Jahre,432,205,227
False,8127032,"Gerabronn, Stadt",75 und mehr Jahre,462,178,284
False,8127032,"Gerabronn, Stadt",Insgesamt,4277,2184,2093
False,8127043,"Ilshofen, Stadt",unter 3 Jahre,193,86,107
False,8127043,"Ilshofen, Stadt",3 -  6 Jahre,191,110,81
False,8127043,"Ilshofen, Stadt",6 - 10 Jahre,292,155,137
False,8127043,"Ilshofen, Stadt",10 - 15 Jahre,440,224,216
False,8127043,"Ilshofen, Stadt",15 - 18 Jahre,257,131,126
False,8127043,"Ilshofen, Stadt",18 - 20 Jahre,161,94,67
False,8127043,"Ilshofen, Stadt",20 - 25 Jahre,397,205,192
False,8127043,"Ilshofen, Stadt",25 - 30 Jahre,377,208,169
False,8127043,"Ilshofen, Stadt",30 - 35 Jahre,367,206,161
False,8127043,"Ilshofen, Stadt",35 - 40 Jahre,413,208,205
False,8127043,"Ilshofen, Stadt",40 - 45 Jahre,558,291,267
False,8127043,"Ilshofen, Stadt",45 - 50 Jahre,560,300,260
False,8127043,"Ilshofen, Stadt",50 - 55 Jahre,433,233,200
False,8127043,"Ilshofen, Stadt",55 - 60 Jahre,347,174,173
False,8127043,"Ilshofen, Stadt",60 - 65 Jahre,260,130,130
False,8127043,"Ilshofen, Stadt",65 - 75 Jahre,522,239,283
False,8127043,"Ilshofen, Stadt",75 und mehr Jahre,452,173,279
False,8127043,"Ilshofen, Stadt",Insgesamt,6220,3167,3053
False,8127046,"Kirchberg an der Jagst, Stadt",unter 3 Jahre,89,50,39
False,8127046,"Kirchberg an der Jagst, Stadt",3 -  6 Jahre,107,48,59
False,8127046,"Kirchberg an der Jagst, Stadt",6 - 10 Jahre,150,81,69
False,8127046,"Kirchberg an der Jagst, Stadt",10 - 15 Jahre,213,119,94
False,8127046,"Kirchberg an der Jagst, Stadt",15 - 18 Jahre,169,81,88
False,8127046,"Kirchberg an der Jagst, Stadt",18 - 20 Jahre,125,66,59
False,8127046,"Kirchberg an der Jagst, Stadt",20 - 25 Jahre,284,150,134
False,8127046,"Kirchberg an der Jagst, Stadt",25 - 30 Jahre,283,169,114
False,8127046,"Kirchberg an der Jagst, Stadt",30 - 35 Jahre,254,134,120
False,8127046,"Kirchberg an der Jagst, Stadt",35 - 40 Jahre,270,148,122
False,8127046,"Kirchberg an der Jagst, Stadt",40 - 45 Jahre,415,235,180
False,8127046,"Kirchberg an der Jagst, Stadt",45 - 50 Jahre,360,180,180
False,8127046,"Kirchberg an der Jagst, Stadt",50 - 55 Jahre,329,161,168
False,8127046,"Kirchberg an der Jagst, Stadt",55 - 60 Jahre,313,172,141
False,8127046,"Kirchberg an der Jagst, Stadt",60 - 65 Jahre,207,113,94
False,8127046,"Kirchberg an der Jagst, Stadt",65 - 75 Jahre,380,186,194
False,8127046,"Kirchberg an der Jagst, Stadt",75 und mehr Jahre,347,144,203
False,8127046,"Kirchberg an der Jagst, Stadt",Insgesamt,4295,2237,2058
False,8127047,"Langenburg, Stadt",unter 3 Jahre,42,18,24
False,8127047,"Langenburg, Stadt",3 -  6 Jahre,43,24,19
False,8127047,"Langenburg, Stadt",6 - 10 Jahre,55,27,28
False,8127047,"Langenburg, Stadt",10 - 15 Jahre,102,61,41
False,8127047,"Langenburg, Stadt",15 - 18 Jahre,80,47,33
False,8127047,"Langenburg, Stadt",18 - 20 Jahre,47,26,21
False,8127047,"Langenburg, Stadt",20 - 25 Jahre,89,48,41
False,8127047,"Langenburg, Stadt",25 - 30 Jahre,70,34,36
False,8127047,"Langenburg, Stadt",30 - 35 Jahre,70,31,39
False,8127047,"Langenburg, Stadt",35 - 40 Jahre,89,52,37
False,8127047,"Langenburg, Stadt",40 - 45 Jahre,125,61,64
False,8127047,"Langenburg, Stadt",45 - 50 Jahre,166,66,100
False,8127047,"Langenburg, Stadt",50 - 55 Jahre,139,80,59
False,8127047,"Langenburg, Stadt",55 - 60 Jahre,110,56,54
False,8127047,"Langenburg, Stadt",60 - 65 Jahre,125,61,64
False,8127047,"Langenburg, Stadt",65 - 75 Jahre,223,102,121
False,8127047,"Langenburg, Stadt",75 und mehr Jahre,200,96,104
False,8127047,"Langenburg, Stadt",Insgesamt,1775,890,885
False,8127052,Mainhardt,unter 3 Jahre,164,77,87
False,8127052,Mainhardt,3 -  6 Jahre,153,71,82
False,8127052,Mainhardt,6 - 10 Jahre,270,158,112
False,8127052,Mainhardt,10 - 15 Jahre,387,187,200
False,8127052,Mainhardt,15 - 18 Jahre,219,97,122
False,8127052,Mainhardt,18 - 20 Jahre,154,69,85
False,8127052,Mainhardt,20 - 25 Jahre,326,149,177
False,8127052,Mainhardt,25 - 30 Jahre,330,163,167
False,8127052,Mainhardt,30 - 35 Jahre,285,153,132
False,8127052,Mainhardt,35 - 40 Jahre,344,178,166
False,8127052,Mainhardt,40 - 45 Jahre,465,235,230
False,8127052,Mainhardt,45 - 50 Jahre,541,277,264
False,8127052,Mainhardt,50 - 55 Jahre,441,218,223
False,8127052,Mainhardt,55 - 60 Jahre,351,182,169
False,8127052,Mainhardt,60 - 65 Jahre,290,139,151
False,8127052,Mainhardt,65 - 75 Jahre,549,271,278
False,8127052,Mainhardt,75 und mehr Jahre,440,178,262
False,8127052,Mainhardt,Insgesamt,5709,2802,2907
False,8127056,Michelbach an der Bilz,unter 3 Jahre,104,54,50
False,8127056,Michelbach an der Bilz,3 -  6 Jahre,79,48,31
False,8127056,Michelbach an der Bilz,6 - 10 Jahre,121,60,61
False,8127056,Michelbach an der Bilz,10 - 15 Jahre,191,113,78
False,8127056,Michelbach an der Bilz,15 - 18 Jahre,116,66,50
False,8127056,Michelbach an der Bilz,18 - 20 Jahre,106,56,50
False,8127056,Michelbach an der Bilz,20 - 25 Jahre,198,95,103
False,8127056,Michelbach an der Bilz,25 - 30 Jahre,174,99,75
False,8127056,Michelbach an der Bilz,30 - 35 Jahre,131,58,73
False,8127056,Michelbach an der Bilz,35 - 40 Jahre,168,78,90
False,8127056,Michelbach an der Bilz,40 - 45 Jahre,303,154,149
False,8127056,Michelbach an der Bilz,45 - 50 Jahre,285,136,149
False,8127056,Michelbach an der Bilz,50 - 55 Jahre,272,140,132
False,8127056,Michelbach an der Bilz,55 - 60 Jahre,247,107,140
False,8127056,Michelbach an der Bilz,60 - 65 Jahre,196,104,92
False,8127056,Michelbach an der Bilz,65 - 75 Jahre,384,195,189
False,8127056,Michelbach an der Bilz,75 und mehr Jahre,300,127,173
False,8127056,Michelbach an der Bilz,Insgesamt,3375,1690,1685
False,8127059,Michelfeld,unter 3 Jahre,111,62,49
False,8127059,Michelfeld,3 -  6 Jahre,96,53,43
False,8127059,Michelfeld,6 - 10 Jahre,162,90,72
False,8127059,Michelfeld,10 - 15 Jahre,180,95,85
False,8127059,Michelfeld,15 - 18 Jahre,124,63,61
False,8127059,Michelfeld,18 - 20 Jahre,99,57,42
False,8127059,Michelfeld,20 - 25 Jahre,200,99,101
False,8127059,Michelfeld,25 - 30 Jahre,246,121,125
False,8127059,Michelfeld,30 - 35 Jahre,222,108,114
False,8127059,Michelfeld,35 - 40 Jahre,253,136,117
False,8127059,Michelfeld,40 - 45 Jahre,332,162,170
False,8127059,Michelfeld,45 - 50 Jahre,315,159,156
False,8127059,Michelfeld,50 - 55 Jahre,312,158,154
False,8127059,Michelfeld,55 - 60 Jahre,290,143,147
False,8127059,Michelfeld,60 - 65 Jahre,208,109,99
False,8127059,Michelfeld,65 - 75 Jahre,291,135,156
False,8127059,Michelfeld,75 und mehr Jahre,257,92,165
False,8127059,Michelfeld,Insgesamt,3698,1842,1856
False,8127062,Oberrot,unter 3 Jahre,82,33,49
False,8127062,Oberrot,3 -  6 Jahre,125,51,74
False,8127062,Oberrot,6 - 10 Jahre,138,69,69
False,8127062,Oberrot,10 - 15 Jahre,228,119,109
False,8127062,Oberrot,15 - 18 Jahre,176,100,76
False,8127062,Oberrot,18 - 20 Jahre,99,52,47
False,8127062,Oberrot,20 - 25 Jahre,239,112,127
False,8127062,Oberrot,25 - 30 Jahre,183,98,85
False,8127062,Oberrot,30 - 35 Jahre,186,81,105
False,8127062,Oberrot,35 - 40 Jahre,199,103,96
False,8127062,Oberrot,40 - 45 Jahre,288,150,138
False,8127062,Oberrot,45 - 50 Jahre,319,167,152
False,8127062,Oberrot,50 - 55 Jahre,282,137,145
False,8127062,Oberrot,55 - 60 Jahre,262,136,126
False,8127062,Oberrot,60 - 65 Jahre,199,113,86
False,8127062,Oberrot,65 - 75 Jahre,321,153,168
False,8127062,Oberrot,75 und mehr Jahre,354,137,217
False,8127062,Oberrot,Insgesamt,3680,1811,1869
False,8127063,Obersontheim,unter 3 Jahre,122,59,63
False,8127063,Obersontheim,3 -  6 Jahre,124,71,53
False,8127063,Obersontheim,6 - 10 Jahre,188,88,100
False,8127063,Obersontheim,10 - 15 Jahre,273,150,123
False,8127063,Obersontheim,15 - 18 Jahre,199,94,105
False,8127063,Obersontheim,18 - 20 Jahre,151,72,79
False,8127063,Obersontheim,20 - 25 Jahre,309,173,136
False,8127063,Obersontheim,25 - 30 Jahre,247,132,115
False,8127063,Obersontheim,30 - 35 Jahre,227,109,118
False,8127063,Obersontheim,35 - 40 Jahre,293,149,144
False,8127063,Obersontheim,40 - 45 Jahre,408,196,212
False,8127063,Obersontheim,45 - 50 Jahre,423,223,200
False,8127063,Obersontheim,50 - 55 Jahre,424,221,203
False,8127063,Obersontheim,55 - 60 Jahre,298,148,150
False,8127063,Obersontheim,60 - 65 Jahre,230,118,112
False,8127063,Obersontheim,65 - 75 Jahre,405,179,226
False,8127063,Obersontheim,75 und mehr Jahre,415,158,257
False,8127063,Obersontheim,Insgesamt,4736,2340,2396
False,8127071,Rot am See,unter 3 Jahre,143,64,79
False,8127071,Rot am See,3 -  6 Jahre,142,94,48
False,8127071,Rot am See,6 - 10 Jahre,210,109,101
False,8127071,Rot am See,10 - 15 Jahre,294,145,149
False,8127071,Rot am See,15 - 18 Jahre,204,109,95
False,8127071,Rot am See,18 - 20 Jahre,139,74,65
False,8127071,Rot am See,20 - 25 Jahre,334,171,163
False,8127071,Rot am See,25 - 30 Jahre,295,153,142
False,8127071,Rot am See,30 - 35 Jahre,329,179,150
False,8127071,Rot am See,35 - 40 Jahre,326,174,152
False,8127071,Rot am See,40 - 45 Jahre,435,230,205
False,8127071,Rot am See,45 - 50 Jahre,417,223,194
False,8127071,Rot am See,50 - 55 Jahre,406,207,199
False,8127071,Rot am See,55 - 60 Jahre,353,182,171
False,8127071,Rot am See,60 - 65 Jahre,271,145,126
False,8127071,Rot am See,65 - 75 Jahre,454,217,237
False,8127071,Rot am See,75 und mehr Jahre,482,187,295
False,8127071,Rot am See,Insgesamt,5234,2663,2571
False,8127073,Satteldorf,unter 3 Jahre,119,66,53
False,8127073,Satteldorf,3 -  6 Jahre,146,71,75
False,8127073,Satteldorf,6 - 10 Jahre,237,140,97
False,8127073,Satteldorf,10 - 15 Jahre,327,172,155
False,8127073,Satteldorf,15 - 18 Jahre,198,105,93
False,8127073,Satteldorf,18 - 20 Jahre,152,72,80
False,8127073,Satteldorf,20 - 25 Jahre,325,179,146
False,8127073,Satteldorf,25 - 30 Jahre,299,152,147
False,8127073,Satteldorf,30 - 35 Jahre,324,163,161
False,8127073,Satteldorf,35 - 40 Jahre,314,151,163
False,8127073,Satteldorf,40 - 45 Jahre,421,222,199
False,8127073,Satteldorf,45 - 50 Jahre,459,219,240
False,8127073,Satteldorf,50 - 55 Jahre,408,216,192
False,8127073,Satteldorf,55 - 60 Jahre,362,185,177
False,8127073,Satteldorf,60 - 65 Jahre,276,132,144
False,8127073,Satteldorf,65 - 75 Jahre,428,219,209
False,8127073,Satteldorf,75 und mehr Jahre,401,140,261
False,8127073,Satteldorf,Insgesamt,5196,2604,2592
False,8127075,"Schrozberg, Stadt",unter 3 Jahre,143,73,70
False,8127075,"Schrozberg, Stadt",3 -  6 Jahre,144,75,69
False,8127075,"Schrozberg, Stadt",6 - 10 Jahre,212,108,104
False,8127075,"Schrozberg, Stadt",10 - 15 Jahre,349,189,160
False,8127075,"Schrozberg, Stadt",15 - 18 Jahre,227,121,106
False,8127075,"Schrozberg, Stadt",18 - 20 Jahre,152,83,69
False,8127075,"Schrozberg, Stadt",20 - 25 Jahre,383,212,171
False,8127075,"Schrozberg, Stadt",25 - 30 Jahre,329,186,143
False,8127075,"Schrozberg, Stadt",30 - 35 Jahre,320,182,138
False,8127075,"Schrozberg, Stadt",35 - 40 Jahre,346,194,152
False,8127075,"Schrozberg, Stadt",40 - 45 Jahre,429,221,208
False,8127075,"Schrozberg, Stadt",45 - 50 Jahre,475,240,235
False,8127075,"Schrozberg, Stadt",50 - 55 Jahre,427,225,202
False,8127075,"Schrozberg, Stadt",55 - 60 Jahre,389,200,189
False,8127075,"Schrozberg, Stadt",60 - 65 Jahre,346,177,169
False,8127075,"Schrozberg, Stadt",65 - 75 Jahre,623,295,328
False,8127075,"Schrozberg, Stadt",75 und mehr Jahre,595,232,363
False,8127075,"Schrozberg, Stadt",Insgesamt,5889,3013,2876
False,8127076,"Schwäbisch Hall, Stadt",unter 3 Jahre,1031,520,511
False,8127076,"Schwäbisch Hall, Stadt",3 -  6 Jahre,1075,528,547
False,8127076,"Schwäbisch Hall, Stadt",6 - 10 Jahre,1394,729,665
False,8127076,"Schwäbisch Hall, Stadt",10 - 15 Jahre,2043,1049,994
False,8127076,"Schwäbisch Hall, Stadt",15 - 18 Jahre,1205,625,580
False,8127076,"Schwäbisch Hall, Stadt",18 - 20 Jahre,871,433,438
False,8127076,"Schwäbisch Hall, Stadt",20 - 25 Jahre,2250,1134,1116
False,8127076,"Schwäbisch Hall, Stadt",25 - 30 Jahre,2279,1154,1125
False,8127076,"Schwäbisch Hall, Stadt",30 - 35 Jahre,2285,1140,1145
False,8127076,"Schwäbisch Hall, Stadt",35 - 40 Jahre,2289,1073,1216
False,8127076,"Schwäbisch Hall, Stadt",40 - 45 Jahre,3130,1561,1569
False,8127076,"Schwäbisch Hall, Stadt",45 - 50 Jahre,3051,1511,1540
False,8127076,"Schwäbisch Hall, Stadt",50 - 55 Jahre,2716,1313,1403
False,8127076,"Schwäbisch Hall, Stadt",55 - 60 Jahre,2465,1139,1326
False,8127076,"Schwäbisch Hall, Stadt",60 - 65 Jahre,2148,1033,1115
False,8127076,"Schwäbisch Hall, Stadt",65 - 75 Jahre,3780,1739,2041
False,8127076,"Schwäbisch Hall, Stadt",75 und mehr Jahre,3125,1090,2035
False,8127076,"Schwäbisch Hall, Stadt",Insgesamt,37137,17771,19366
False,8127079,Sulzbach-Laufen,unter 3 Jahre,73,35,38
False,8127079,Sulzbach-Laufen,3 -  6 Jahre,70,31,39
False,8127079,Sulzbach-Laufen,6 - 10 Jahre,125,71,54
False,8127079,Sulzbach-Laufen,10 - 15 Jahre,159,81,78
False,8127079,Sulzbach-Laufen,15 - 18 Jahre,85,43,42
False,8127079,Sulzbach-Laufen,18 - 20 Jahre,72,44,28
False,8127079,Sulzbach-Laufen,20 - 25 Jahre,142,82,60
False,8127079,Sulzbach-Laufen,25 - 30 Jahre,145,75,70
False,8127079,Sulzbach-Laufen,30 - 35 Jahre,142,65,77
False,8127079,Sulzbach-Laufen,35 - 40 Jahre,148,73,75
False,8127079,Sulzbach-Laufen,40 - 45 Jahre,189,103,86
False,8127079,Sulzbach-Laufen,45 - 50 Jahre,229,119,110
False,8127079,Sulzbach-Laufen,50 - 55 Jahre,202,104,98
False,8127079,Sulzbach-Laufen,55 - 60 Jahre,151,79,72
False,8127079,Sulzbach-Laufen,60 - 65 Jahre,123,67,56
False,8127079,Sulzbach-Laufen,65 - 75 Jahre,250,122,128
False,8127079,Sulzbach-Laufen,75 und mehr Jahre,201,84,117
False,8127079,Sulzbach-Laufen,Insgesamt,2506,1278,1228
False,8127086,Untermünkheim,unter 3 Jahre,67,35,32
False,8127086,Untermünkheim,3 -  6 Jahre,99,46,53
False,8127086,Untermünkheim,6 - 10 Jahre,126,61,65
False,8127086,Untermünkheim,10 - 15 Jahre,196,107,89
False,8127086,Untermünkheim,15 - 18 Jahre,136,69,67
False,8127086,Untermünkheim,18 - 20 Jahre,86,52,34
False,8127086,Untermünkheim,20 - 25 Jahre,178,99,79
False,8127086,Untermünkheim,25 - 30 Jahre,174,98,76
False,8127086,Untermünkheim,30 - 35 Jahre,136,67,69
False,8127086,Untermünkheim,35 - 40 Jahre,167,71,96
False,8127086,Untermünkheim,40 - 45 Jahre,258,129,129
False,8127086,Untermünkheim,45 - 50 Jahre,277,150,127
False,8127086,Untermünkheim,50 - 55 Jahre,241,119,122
False,8127086,Untermünkheim,55 - 60 Jahre,195,104,91
False,8127086,Untermünkheim,60 - 65 Jahre,184,96,88
False,8127086,Untermünkheim,65 - 75 Jahre,254,134,120
False,8127086,Untermünkheim,75 und mehr Jahre,230,85,145
False,8127086,Untermünkheim,Insgesamt,3004,1522,1482
False,8127089,"Vellberg, Stadt",unter 3 Jahre,103,42,61
False,8127089,"Vellberg, Stadt",3 -  6 Jahre,107,60,47
False,8127089,"Vellberg, Stadt",6 - 10 Jahre,185,88,97
False,8127089,"Vellberg, Stadt",10 - 15 Jahre,280,152,128
False,8127089,"Vellberg, Stadt",15 - 18 Jahre,177,81,96
False,8127089,"Vellberg, Stadt",18 - 20 Jahre,98,52,46
False,8127089,"Vellberg, Stadt",20 - 25 Jahre,237,125,112
False,8127089,"Vellberg, Stadt",25 - 30 Jahre,212,100,112
False,8127089,"Vellberg, Stadt",30 - 35 Jahre,193,110,83
False,8127089,"Vellberg, Stadt",35 - 40 Jahre,261,128,133
False,8127089,"Vellberg, Stadt",40 - 45 Jahre,324,155,169
False,8127089,"Vellberg, Stadt",45 - 50 Jahre,383,210,173
False,8127089,"Vellberg, Stadt",50 - 55 Jahre,345,172,173
False,8127089,"Vellberg, Stadt",55 - 60 Jahre,312,176,136
False,8127089,"Vellberg, Stadt",60 - 65 Jahre,267,119,148
False,8127089,"Vellberg, Stadt",65 - 75 Jahre,389,185,204
False,8127089,"Vellberg, Stadt",75 und mehr Jahre,351,145,206
False,8127089,"Vellberg, Stadt",Insgesamt,4224,2100,2124
False,8127091,Wallhausen,unter 3 Jahre,101,56,45
False,8127091,Wallhausen,3 -  6 Jahre,98,47,51
False,8127091,Wallhausen,6 - 10 Jahre,178,86,92
False,8127091,Wallhausen,10 - 15 Jahre,266,142,124
False,8127091,Wallhausen,15 - 18 Jahre,140,82,58
False,8127091,Wallhausen,18 - 20 Jahre,97,42,55
False,8127091,Wallhausen,20 - 25 Jahre,201,110,91
False,8127091,Wallhausen,25 - 30 Jahre,239,121,118
False,8127091,Wallhausen,30 - 35 Jahre,226,110,116
False,8127091,Wallhausen,35 - 40 Jahre,250,132,118
False,8127091,Wallhausen,40 - 45 Jahre,307,153,154
False,8127091,Wallhausen,45 - 50 Jahre,349,159,190
False,8127091,Wallhausen,50 - 55 Jahre,281,154,127
False,8127091,Wallhausen,55 - 60 Jahre,207,114,93
False,8127091,Wallhausen,60 - 65 Jahre,146,72,74
False,8127091,Wallhausen,65 - 75 Jahre,271,131,140
False,8127091,Wallhausen,75 und mehr Jahre,234,100,134
False,8127091,Wallhausen,Insgesamt,3591,1811,1780
False,8127099,Wolpertshausen,unter 3 Jahre,49,19,30
False,8127099,Wolpertshausen,3 -  6 Jahre,76,38,38
False,8127099,Wolpertshausen,6 - 10 Jahre,112,53,59
False,8127099,Wolpertshausen,10 - 15 Jahre,133,64,69
False,8127099,Wolpertshausen,15 - 18 Jahre,98,55,43
False,8127099,Wolpertshausen,18 - 20 Jahre,69,35,34
False,8127099,Wolpertshausen,20 - 25 Jahre,128,72,56
False,8127099,Wolpertshausen,25 - 30 Jahre,115,61,54
False,8127099,Wolpertshausen,30 - 35 Jahre,130,65,65
False,8127099,Wolpertshausen,35 - 40 Jahre,124,64,60
False,8127099,Wolpertshausen,40 - 45 Jahre,196,107,89
False,8127099,Wolpertshausen,45 - 50 Jahre,199,98,101
False,8127099,Wolpertshausen,50 - 55 Jahre,148,80,68
False,8127099,Wolpertshausen,55 - 60 Jahre,117,62,55
False,8127099,Wolpertshausen,60 - 65 Jahre,89,45,44
False,8127099,Wolpertshausen,65 - 75 Jahre,116,57,59
False,8127099,Wolpertshausen,75 und mehr Jahre,134,53,81
False,8127099,Wolpertshausen,Insgesamt,2033,1028,1005
False,8127100,Rosengarten,unter 3 Jahre,136,52,84
False,8127100,Rosengarten,3 -  6 Jahre,114,65,49
False,8127100,Rosengarten,6 - 10 Jahre,227,112,115
False,8127100,Rosengarten,10 - 15 Jahre,325,159,166
False,8127100,Rosengarten,15 - 18 Jahre,217,111,106
False,8127100,Rosengarten,18 - 20 Jahre,129,81,48
False,8127100,Rosengarten,20 - 25 Jahre,322,173,149
False,8127100,Rosengarten,25 - 30 Jahre,253,135,118
False,8127100,Rosengarten,30 - 35 Jahre,277,132,145
False,8127100,Rosengarten,35 - 40 Jahre,272,124,148
False,8127100,Rosengarten,40 - 45 Jahre,416,205,211
False,8127100,Rosengarten,45 - 50 Jahre,523,252,271
False,8127100,Rosengarten,50 - 55 Jahre,391,205,186
False,8127100,Rosengarten,55 - 60 Jahre,331,160,171
False,8127100,Rosengarten,60 - 65 Jahre,248,128,120
False,8127100,Rosengarten,65 - 75 Jahre,491,245,246
False,8127100,Rosengarten,75 und mehr Jahre,410,132,278
False,8127100,Rosengarten,Insgesamt,5082,2471,2611
False,8127101,Kreßberg,unter 3 Jahre,79,35,44
False,8127101,Kreßberg,3 -  6 Jahre,103,49,54
False,8127101,Kreßberg,6 - 10 Jahre,151,72,79
False,8127101,Kreßberg,10 - 15 Jahre,226,110,116
False,8127101,Kreßberg,15 - 18 Jahre,150,75,75
False,8127101,Kreßberg,18 - 20 Jahre,118,64,54
False,8127101,Kreßberg,20 - 25 Jahre,242,136,106
False,8127101,Kreßberg,25 - 30 Jahre,176,100,76
False,8127101,Kreßberg,30 - 35 Jahre,190,95,95
False,8127101,Kreßberg,35 - 40 Jahre,231,117,114
False,8127101,Kreßberg,40 - 45 Jahre,321,157,164
False,8127101,Kreßberg,45 - 50 Jahre,334,168,166
False,8127101,Kreßberg,50 - 55 Jahre,306,169,137
False,8127101,Kreßberg,55 - 60 Jahre,267,133,134
False,8127101,Kreßberg,60 - 65 Jahre,236,133,103
False,8127101,Kreßberg,65 - 75 Jahre,334,168,166
False,8127101,Kreßberg,75 und mehr Jahre,324,132,192
False,8127101,Kreßberg,Insgesamt,3788,1913,1875
False,8127102,Fichtenau,unter 3 Jahre,134,76,58
False,8127102,Fichtenau,3 -  6 Jahre,136,69,67
False,8127102,Fichtenau,6 - 10 Jahre,186,88,98
False,8127102,Fichtenau,10 - 15 Jahre,282,144,138
False,8127102,Fichtenau,15 - 18 Jahre,196,113,83
False,8127102,Fichtenau,18 - 20 Jahre,132,73,59
False,8127102,Fichtenau,20 - 25 Jahre,262,138,124
False,8127102,Fichtenau,25 - 30 Jahre,265,147,118
False,8127102,Fichtenau,30 - 35 Jahre,268,131,137
False,8127102,Fichtenau,35 - 40 Jahre,293,149,144
False,8127102,Fichtenau,40 - 45 Jahre,365,187,178
False,8127102,Fichtenau,45 - 50 Jahre,399,235,164
False,8127102,Fichtenau,50 - 55 Jahre,324,157,167
False,8127102,Fichtenau,55 - 60 Jahre,290,146,144
False,8127102,Fichtenau,60 - 65 Jahre,233,120,113
False,8127102,Fichtenau,65 - 75 Jahre,392,177,215
False,8127102,Fichtenau,75 und mehr Jahre,357,124,233
False,8127102,Fichtenau,Insgesamt,4514,2274,2240
False,8127103,Frankenhardt,unter 3 Jahre,122,57,65
False,8127103,Frankenhardt,3 -  6 Jahre,131,65,66
False,8127103,Frankenhardt,6 - 10 Jahre,218,118,100
False,8127103,Frankenhardt,10 - 15 Jahre,304,174,130
False,8127103,Frankenhardt,15 - 18 Jahre,220,105,115
False,8127103,Frankenhardt,18 - 20 Jahre,137,72,65
False,8127103,Frankenhardt,20 - 25 Jahre,277,158,119
False,8127103,Frankenhardt,25 - 30 Jahre,242,129,113
False,8127103,Frankenhardt,30 - 35 Jahre,258,132,126
False,8127103,Frankenhardt,35 - 40 Jahre,271,145,126
False,8127103,Frankenhardt,40 - 45 Jahre,335,172,163
False,8127103,Frankenhardt,45 - 50 Jahre,402,203,199
False,8127103,Frankenhardt,50 - 55 Jahre,375,197,178
False,8127103,Frankenhardt,55 - 60 Jahre,353,173,180
False,8127103,Frankenhardt,60 - 65 Jahre,232,137,95
False,8127103,Frankenhardt,65 - 75 Jahre,389,181,208
False,8127103,Frankenhardt,75 und mehr Jahre,398,162,236
False,8127103,Frankenhardt,Insgesamt,4664,2380,2284
False,8127104,Stimpfach,unter 3 Jahre,79,41,38
False,8127104,Stimpfach,3 -  6 Jahre,79,45,34
False,8127104,Stimpfach,6 - 10 Jahre,103,57,46
False,8127104,Stimpfach,10 - 15 Jahre,183,90,93
False,8127104,Stimpfach,15 - 18 Jahre,130,71,59
False,8127104,Stimpfach,18 - 20 Jahre,60,38,22
False,8127104,Stimpfach,20 - 25 Jahre,186,104,82
False,8127104,Stimpfach,25 - 30 Jahre,200,97,103
False,8127104,Stimpfach,30 - 35 Jahre,171,88,83
False,8127104,Stimpfach,35 - 40 Jahre,178,94,84
False,8127104,Stimpfach,40 - 45 Jahre,210,106,104
False,8127104,Stimpfach,45 - 50 Jahre,262,129,133
False,8127104,Stimpfach,50 - 55 Jahre,233,120,113
False,8127104,Stimpfach,55 - 60 Jahre,214,103,111
False,8127104,Stimpfach,60 - 65 Jahre,175,95,80
False,8127104,Stimpfach,65 - 75 Jahre,246,122,124
False,8127104,Stimpfach,75 und mehr Jahre,235,84,151
False,8127104,Stimpfach,Insgesamt,2944,1484,1460
False,8128,Landkreis Main-Tauber-Kreis,unter 3 Jahre,3054,1531,1523
False,8128,Landkreis Main-Tauber-Kreis,3 -  6 Jahre,3293,1641,1652
False,8128,Landkreis Main-Tauber-Kreis,6 - 10 Jahre,4947,2557,2390
False,8128,Landkreis Main-Tauber-Kreis,10 - 15 Jahre,7189,3661,3528
False,8128,Landkreis Main-Tauber-Kreis,15 - 18 Jahre,4712,2428,2284
False,8128,Landkreis Main-Tauber-Kreis,18 - 20 Jahre,3224,1728,1496
False,8128,Landkreis Main-Tauber-Kreis,20 - 25 Jahre,7582,3960,3622
False,8128,Landkreis Main-Tauber-Kreis,25 - 30 Jahre,7214,3815,3399
False,8128,Landkreis Main-Tauber-Kreis,30 - 35 Jahre,7205,3600,3605
False,8128,Landkreis Main-Tauber-Kreis,35 - 40 Jahre,7767,3864,3903
False,8128,Landkreis Main-Tauber-Kreis,40 - 45 Jahre,10463,5419,5044
False,8128,Landkreis Main-Tauber-Kreis,45 - 50 Jahre,11487,5874,5613
False,8128,Landkreis Main-Tauber-Kreis,50 - 55 Jahre,10384,5250,5134
False,8128,Landkreis Main-Tauber-Kreis,55 - 60 Jahre,9269,4635,4634
False,8128,Landkreis Main-Tauber-Kreis,60 - 65 Jahre,7808,3893,3915
False,8128,Landkreis Main-Tauber-Kreis,65 - 75 Jahre,14208,6852,7356
False,8128,Landkreis Main-Tauber-Kreis,75 und mehr Jahre,13545,5136,8409
False,8128,Landkreis Main-Tauber-Kreis,Insgesamt,133351,65844,67507
False,8128006,Assamstadt,unter 3 Jahre,52,24,28
False,8128006,Assamstadt,3 -  6 Jahre,62,30,32
False,8128006,Assamstadt,6 - 10 Jahre,87,42,45
False,8128006,Assamstadt,10 - 15 Jahre,146,66,80
False,8128006,Assamstadt,15 - 18 Jahre,86,51,35
False,8128006,Assamstadt,18 - 20 Jahre,66,38,28
False,8128006,Assamstadt,20 - 25 Jahre,115,56,59
False,8128006,Assamstadt,25 - 30 Jahre,139,78,61
False,8128006,Assamstadt,30 - 35 Jahre,123,62,61
False,8128006,Assamstadt,35 - 40 Jahre,146,75,71
False,8128006,Assamstadt,40 - 45 Jahre,146,77,69
False,8128006,Assamstadt,45 - 50 Jahre,175,79,96
False,8128006,Assamstadt,50 - 55 Jahre,165,88,77
False,8128006,Assamstadt,55 - 60 Jahre,128,67,61
False,8128006,Assamstadt,60 - 65 Jahre,103,50,53
False,8128006,Assamstadt,65 - 75 Jahre,155,71,84
False,8128006,Assamstadt,75 und mehr Jahre,162,66,96
False,8128006,Assamstadt,Insgesamt,2056,1020,1036
False,8128007,"Bad Mergentheim, Stadt",unter 3 Jahre,521,265,256
False,8128007,"Bad Mergentheim, Stadt",3 -  6 Jahre,549,262,287
False,8128007,"Bad Mergentheim, Stadt",6 - 10 Jahre,799,414,385
False,8128007,"Bad Mergentheim, Stadt",10 - 15 Jahre,1110,540,570
False,8128007,"Bad Mergentheim, Stadt",15 - 18 Jahre,715,355,360
False,8128007,"Bad Mergentheim, Stadt",18 - 20 Jahre,489,247,242
False,8128007,"Bad Mergentheim, Stadt",20 - 25 Jahre,1333,675,658
False,8128007,"Bad Mergentheim, Stadt",25 - 30 Jahre,1287,653,634
False,8128007,"Bad Mergentheim, Stadt",30 - 35 Jahre,1257,647,610
False,8128007,"Bad Mergentheim, Stadt",35 - 40 Jahre,1304,654,650
False,8128007,"Bad Mergentheim, Stadt",40 - 45 Jahre,1687,859,828
False,8128007,"Bad Mergentheim, Stadt",45 - 50 Jahre,1716,858,858
False,8128007,"Bad Mergentheim, Stadt",50 - 55 Jahre,1603,716,887
False,8128007,"Bad Mergentheim, Stadt",55 - 60 Jahre,1584,761,823
False,8128007,"Bad Mergentheim, Stadt",60 - 65 Jahre,1333,593,740
False,8128007,"Bad Mergentheim, Stadt",65 - 75 Jahre,2503,1137,1366
False,8128007,"Bad Mergentheim, Stadt",75 und mehr Jahre,2604,925,1679
False,8128007,"Bad Mergentheim, Stadt",Insgesamt,22394,10561,11833
False,8128014,"Boxberg, Stadt",unter 3 Jahre,156,77,79
False,8128014,"Boxberg, Stadt",3 -  6 Jahre,185,77,108
False,8128014,"Boxberg, Stadt",6 - 10 Jahre,276,143,133
False,8128014,"Boxberg, Stadt",10 - 15 Jahre,369,192,177
False,8128014,"Boxberg, Stadt",15 - 18 Jahre,247,130,117
False,8128014,"Boxberg, Stadt",18 - 20 Jahre,164,82,82
False,8128014,"Boxberg, Stadt",20 - 25 Jahre,417,227,190
False,8128014,"Boxberg, Stadt",25 - 30 Jahre,366,187,179
False,8128014,"Boxberg, Stadt",30 - 35 Jahre,382,193,189
False,8128014,"Boxberg, Stadt",35 - 40 Jahre,424,213,211
False,8128014,"Boxberg, Stadt",40 - 45 Jahre,577,297,280
False,8128014,"Boxberg, Stadt",45 - 50 Jahre,588,295,293
False,8128014,"Boxberg, Stadt",50 - 55 Jahre,541,293,248
False,8128014,"Boxberg, Stadt",55 - 60 Jahre,525,249,276
False,8128014,"Boxberg, Stadt",60 - 65 Jahre,413,217,196
False,8128014,"Boxberg, Stadt",65 - 75 Jahre,691,360,331
False,8128014,"Boxberg, Stadt",75 und mehr Jahre,646,228,418
False,8128014,"Boxberg, Stadt",Insgesamt,6967,3460,3507
False,8128020,"Creglingen, Stadt",unter 3 Jahre,119,67,52
False,8128020,"Creglingen, Stadt",3 -  6 Jahre,127,63,64
False,8128020,"Creglingen, Stadt",6 - 10 Jahre,187,94,93
False,8128020,"Creglingen, Stadt",10 - 15 Jahre,315,174,141
False,8128020,"Creglingen, Stadt",15 - 18 Jahre,204,112,92
False,8128020,"Creglingen, Stadt",18 - 20 Jahre,115,67,48
False,8128020,"Creglingen, Stadt",20 - 25 Jahre,222,112,110
False,8128020,"Creglingen, Stadt",25 - 30 Jahre,222,126,96
False,8128020,"Creglingen, Stadt",30 - 35 Jahre,235,125,110
False,8128020,"Creglingen, Stadt",35 - 40 Jahre,278,126,152
False,8128020,"Creglingen, Stadt",40 - 45 Jahre,357,216,141
False,8128020,"Creglingen, Stadt",45 - 50 Jahre,359,181,178
False,8128020,"Creglingen, Stadt",50 - 55 Jahre,344,165,179
False,8128020,"Creglingen, Stadt",55 - 60 Jahre,292,162,130
False,8128020,"Creglingen, Stadt",60 - 65 Jahre,260,143,117
False,8128020,"Creglingen, Stadt",65 - 75 Jahre,495,226,269
False,8128020,"Creglingen, Stadt",75 und mehr Jahre,548,219,329
False,8128020,"Creglingen, Stadt",Insgesamt,4679,2378,2301
False,8128039,"Freudenberg, Stadt",unter 3 Jahre,82,40,42
False,8128039,"Freudenberg, Stadt",3 -  6 Jahre,93,46,47
False,8128039,"Freudenberg, Stadt",6 - 10 Jahre,135,81,54
False,8128039,"Freudenberg, Stadt",10 - 15 Jahre,215,117,98
False,8128039,"Freudenberg, Stadt",15 - 18 Jahre,132,55,77
False,8128039,"Freudenberg, Stadt",18 - 20 Jahre,86,45,41
False,8128039,"Freudenberg, Stadt",20 - 25 Jahre,189,98,91
False,8128039,"Freudenberg, Stadt",25 - 30 Jahre,214,111,103
False,8128039,"Freudenberg, Stadt",30 - 35 Jahre,218,110,108
False,8128039,"Freudenberg, Stadt",35 - 40 Jahre,223,115,108
False,8128039,"Freudenberg, Stadt",40 - 45 Jahre,290,153,137
False,8128039,"Freudenberg, Stadt",45 - 50 Jahre,321,166,155
False,8128039,"Freudenberg, Stadt",50 - 55 Jahre,274,136,138
False,8128039,"Freudenberg, Stadt",55 - 60 Jahre,295,150,145
False,8128039,"Freudenberg, Stadt",60 - 65 Jahre,206,110,96
False,8128039,"Freudenberg, Stadt",65 - 75 Jahre,437,206,231
False,8128039,"Freudenberg, Stadt",75 und mehr Jahre,474,184,290
False,8128039,"Freudenberg, Stadt",Insgesamt,3884,1923,1961
False,8128045,Großrinderfeld,unter 3 Jahre,138,73,65
False,8128045,Großrinderfeld,3 -  6 Jahre,112,56,56
False,8128045,Großrinderfeld,6 - 10 Jahre,137,65,72
False,8128045,Großrinderfeld,10 - 15 Jahre,213,120,93
False,8128045,Großrinderfeld,15 - 18 Jahre,148,82,66
False,8128045,Großrinderfeld,18 - 20 Jahre,116,60,56
False,8128045,Großrinderfeld,20 - 25 Jahre,232,126,106
False,8128045,Großrinderfeld,25 - 30 Jahre,241,105,136
False,8128045,Großrinderfeld,30 - 35 Jahre,258,125,133
False,8128045,Großrinderfeld,35 - 40 Jahre,260,143,117
False,8128045,Großrinderfeld,40 - 45 Jahre,343,172,171
False,8128045,Großrinderfeld,45 - 50 Jahre,364,186,178
False,8128045,Großrinderfeld,50 - 55 Jahre,341,173,168
False,8128045,Großrinderfeld,55 - 60 Jahre,301,158,143
False,8128045,Großrinderfeld,60 - 65 Jahre,261,140,121
False,8128045,Großrinderfeld,65 - 75 Jahre,323,151,172
False,8128045,Großrinderfeld,75 und mehr Jahre,265,109,156
False,8128045,Großrinderfeld,Insgesamt,4053,2044,2009
False,8128047,"Grünsfeld, Stadt",unter 3 Jahre,75,39,36
False,8128047,"Grünsfeld, Stadt",3 -  6 Jahre,85,43,42
False,8128047,"Grünsfeld, Stadt",6 - 10 Jahre,138,75,63
False,8128047,"Grünsfeld, Stadt",10 - 15 Jahre,212,114,98
False,8128047,"Grünsfeld, Stadt",15 - 18 Jahre,150,75,75
False,8128047,"Grünsfeld, Stadt",18 - 20 Jahre,100,58,42
False,8128047,"Grünsfeld, Stadt",20 - 25 Jahre,203,117,86
False,8128047,"Grünsfeld, Stadt",25 - 30 Jahre,178,101,77
False,8128047,"Grünsfeld, Stadt",30 - 35 Jahre,163,80,83
False,8128047,"Grünsfeld, Stadt",35 - 40 Jahre,232,116,116
False,8128047,"Grünsfeld, Stadt",40 - 45 Jahre,308,142,166
False,8128047,"Grünsfeld, Stadt",45 - 50 Jahre,409,227,182
False,8128047,"Grünsfeld, Stadt",50 - 55 Jahre,308,172,136
False,8128047,"Grünsfeld, Stadt",55 - 60 Jahre,240,125,115
False,8128047,"Grünsfeld, Stadt",60 - 65 Jahre,192,95,97
False,8128047,"Grünsfeld, Stadt",65 - 75 Jahre,361,173,188
False,8128047,"Grünsfeld, Stadt",75 und mehr Jahre,349,143,206
False,8128047,"Grünsfeld, Stadt",Insgesamt,3703,1895,1808
False,8128058,Igersheim,unter 3 Jahre,127,64,63
False,8128058,Igersheim,3 -  6 Jahre,128,61,67
False,8128058,Igersheim,6 - 10 Jahre,226,123,103
False,8128058,Igersheim,10 - 15 Jahre,315,166,149
False,8128058,Igersheim,15 - 18 Jahre,200,103,97
False,8128058,Igersheim,18 - 20 Jahre,118,49,69
False,8128058,Igersheim,20 - 25 Jahre,348,163,185
False,8128058,Igersheim,25 - 30 Jahre,348,176,172
False,8128058,Igersheim,30 - 35 Jahre,330,174,156
False,8128058,Igersheim,35 - 40 Jahre,359,169,190
False,8128058,Igersheim,40 - 45 Jahre,436,225,211
False,8128058,Igersheim,45 - 50 Jahre,469,232,237
False,8128058,Igersheim,50 - 55 Jahre,413,185,228
False,8128058,Igersheim,55 - 60 Jahre,437,214,223
False,8128058,Igersheim,60 - 65 Jahre,312,166,146
False,8128058,Igersheim,65 - 75 Jahre,594,300,294
False,8128058,Igersheim,75 und mehr Jahre,493,201,292
False,8128058,Igersheim,Insgesamt,5653,2771,2882
False,8128061,Königheim,unter 3 Jahre,80,47,33
False,8128061,Königheim,3 -  6 Jahre,84,43,41
False,8128061,Königheim,6 - 10 Jahre,118,56,62
False,8128061,Königheim,10 - 15 Jahre,160,87,73
False,8128061,Königheim,15 - 18 Jahre,113,57,56
False,8128061,Königheim,18 - 20 Jahre,80,40,40
False,8128061,Königheim,20 - 25 Jahre,179,96,83
False,8128061,Königheim,25 - 30 Jahre,151,68,83
False,8128061,Königheim,30 - 35 Jahre,151,76,75
False,8128061,Königheim,35 - 40 Jahre,179,87,92
False,8128061,Königheim,40 - 45 Jahre,244,132,112
False,8128061,Königheim,45 - 50 Jahre,272,148,124
False,8128061,Königheim,50 - 55 Jahre,251,135,116
False,8128061,Königheim,55 - 60 Jahre,196,109,87
False,8128061,Königheim,60 - 65 Jahre,205,96,109
False,8128061,Königheim,65 - 75 Jahre,361,189,172
False,8128061,Königheim,75 und mehr Jahre,329,120,209
False,8128061,Königheim,Insgesamt,3153,1586,1567
False,8128064,"Külsheim, Stadt",unter 3 Jahre,113,48,65
False,8128064,"Külsheim, Stadt",3 -  6 Jahre,134,75,59
False,8128064,"Külsheim, Stadt",6 - 10 Jahre,192,110,82
False,8128064,"Külsheim, Stadt",10 - 15 Jahre,321,171,150
False,8128064,"Külsheim, Stadt",15 - 18 Jahre,189,95,94
False,8128064,"Külsheim, Stadt",18 - 20 Jahre,161,88,73
False,8128064,"Külsheim, Stadt",20 - 25 Jahre,309,182,127
False,8128064,"Külsheim, Stadt",25 - 30 Jahre,272,155,117
False,8128064,"Külsheim, Stadt",30 - 35 Jahre,248,128,120
False,8128064,"Külsheim, Stadt",35 - 40 Jahre,282,142,140
False,8128064,"Külsheim, Stadt",40 - 45 Jahre,493,273,220
False,8128064,"Külsheim, Stadt",45 - 50 Jahre,532,294,238
False,8128064,"Külsheim, Stadt",50 - 55 Jahre,441,221,220
False,8128064,"Külsheim, Stadt",55 - 60 Jahre,392,202,190
False,8128064,"Külsheim, Stadt",60 - 65 Jahre,324,168,156
False,8128064,"Külsheim, Stadt",65 - 75 Jahre,577,297,280
False,8128064,"Külsheim, Stadt",75 und mehr Jahre,457,167,290
False,8128064,"Külsheim, Stadt",Insgesamt,5437,2816,2621
False,8128082,"Niederstetten, Stadt",unter 3 Jahre,109,57,52
False,8128082,"Niederstetten, Stadt",3 -  6 Jahre,139,69,70
False,8128082,"Niederstetten, Stadt",6 - 10 Jahre,216,104,112
False,8128082,"Niederstetten, Stadt",10 - 15 Jahre,292,141,151
False,8128082,"Niederstetten, Stadt",15 - 18 Jahre,181,82,99
False,8128082,"Niederstetten, Stadt",18 - 20 Jahre,123,66,57
False,8128082,"Niederstetten, Stadt",20 - 25 Jahre,297,173,124
False,8128082,"Niederstetten, Stadt",25 - 30 Jahre,298,174,124
False,8128082,"Niederstetten, Stadt",30 - 35 Jahre,284,142,142
False,8128082,"Niederstetten, Stadt",35 - 40 Jahre,310,167,143
False,8128082,"Niederstetten, Stadt",40 - 45 Jahre,431,243,188
False,8128082,"Niederstetten, Stadt",45 - 50 Jahre,570,347,223
False,8128082,"Niederstetten, Stadt",50 - 55 Jahre,395,196,199
False,8128082,"Niederstetten, Stadt",55 - 60 Jahre,335,176,159
False,8128082,"Niederstetten, Stadt",60 - 65 Jahre,288,146,142
False,8128082,"Niederstetten, Stadt",65 - 75 Jahre,528,267,261
False,8128082,"Niederstetten, Stadt",75 und mehr Jahre,426,180,246
False,8128082,"Niederstetten, Stadt",Insgesamt,5222,2730,2492
False,8128115,"Tauberbischofsheim, Stadt",unter 3 Jahre,297,143,154
False,8128115,"Tauberbischofsheim, Stadt",3 -  6 Jahre,302,158,144
False,8128115,"Tauberbischofsheim, Stadt",6 - 10 Jahre,505,263,242
False,8128115,"Tauberbischofsheim, Stadt",10 - 15 Jahre,664,335,329
False,8128115,"Tauberbischofsheim, Stadt",15 - 18 Jahre,435,234,201
False,8128115,"Tauberbischofsheim, Stadt",18 - 20 Jahre,325,177,148
False,8128115,"Tauberbischofsheim, Stadt",20 - 25 Jahre,753,365,388
False,8128115,"Tauberbischofsheim, Stadt",25 - 30 Jahre,718,388,330
False,8128115,"Tauberbischofsheim, Stadt",30 - 35 Jahre,698,330,368
False,8128115,"Tauberbischofsheim, Stadt",35 - 40 Jahre,844,411,433
False,8128115,"Tauberbischofsheim, Stadt",40 - 45 Jahre,1056,551,505
False,8128115,"Tauberbischofsheim, Stadt",45 - 50 Jahre,1077,564,513
False,8128115,"Tauberbischofsheim, Stadt",50 - 55 Jahre,996,500,496
False,8128115,"Tauberbischofsheim, Stadt",55 - 60 Jahre,928,477,451
False,8128115,"Tauberbischofsheim, Stadt",60 - 65 Jahre,779,379,400
False,8128115,"Tauberbischofsheim, Stadt",65 - 75 Jahre,1404,681,723
False,8128115,"Tauberbischofsheim, Stadt",75 und mehr Jahre,1320,482,838
False,8128115,"Tauberbischofsheim, Stadt",Insgesamt,13101,6438,6663
False,8128126,"Weikersheim, Stadt",unter 3 Jahre,168,85,83
False,8128126,"Weikersheim, Stadt",3 -  6 Jahre,223,100,123
False,8128126,"Weikersheim, Stadt",6 - 10 Jahre,306,145,161
False,8128126,"Weikersheim, Stadt",10 - 15 Jahre,422,216,206
False,8128126,"Weikersheim, Stadt",15 - 18 Jahre,254,133,121
False,8128126,"Weikersheim, Stadt",18 - 20 Jahre,173,104,69
False,8128126,"Weikersheim, Stadt",20 - 25 Jahre,421,221,200
False,8128126,"Weikersheim, Stadt",25 - 30 Jahre,349,179,170
False,8128126,"Weikersheim, Stadt",30 - 35 Jahre,385,175,210
False,8128126,"Weikersheim, Stadt",35 - 40 Jahre,409,205,204
False,8128126,"Weikersheim, Stadt",40 - 45 Jahre,655,317,338
False,8128126,"Weikersheim, Stadt",45 - 50 Jahre,597,308,289
False,8128126,"Weikersheim, Stadt",50 - 55 Jahre,585,309,276
False,8128126,"Weikersheim, Stadt",55 - 60 Jahre,472,238,234
False,8128126,"Weikersheim, Stadt",60 - 65 Jahre,417,212,205
False,8128126,"Weikersheim, Stadt",65 - 75 Jahre,873,428,445
False,8128126,"Weikersheim, Stadt",75 und mehr Jahre,722,284,438
False,8128126,"Weikersheim, Stadt",Insgesamt,7431,3659,3772
False,8128128,Werbach,unter 3 Jahre,65,31,34
False,8128128,Werbach,3 -  6 Jahre,79,42,37
False,8128128,Werbach,6 - 10 Jahre,116,59,57
False,8128128,Werbach,10 - 15 Jahre,180,90,90
False,8128128,Werbach,15 - 18 Jahre,167,76,91
False,8128128,Werbach,18 - 20 Jahre,75,42,33
False,8128128,Werbach,20 - 25 Jahre,202,115,87
False,8128128,Werbach,25 - 30 Jahre,169,90,79
False,8128128,Werbach,30 - 35 Jahre,167,80,87
False,8128128,Werbach,35 - 40 Jahre,178,78,100
False,8128128,Werbach,40 - 45 Jahre,298,164,134
False,8128128,Werbach,45 - 50 Jahre,338,169,169
False,8128128,Werbach,50 - 55 Jahre,312,171,141
False,8128128,Werbach,55 - 60 Jahre,236,117,119
False,8128128,Werbach,60 - 65 Jahre,197,110,87
False,8128128,Werbach,65 - 75 Jahre,348,175,173
False,8128128,Werbach,75 und mehr Jahre,351,134,217
False,8128128,Werbach,Insgesamt,3478,1743,1735
False,8128131,"Wertheim, Stadt",unter 3 Jahre,550,276,274
False,8128131,"Wertheim, Stadt",3 -  6 Jahre,550,292,258
False,8128131,"Wertheim, Stadt",6 - 10 Jahre,804,395,409
False,8128131,"Wertheim, Stadt",10 - 15 Jahre,1228,623,605
False,8128131,"Wertheim, Stadt",15 - 18 Jahre,840,440,400
False,8128131,"Wertheim, Stadt",18 - 20 Jahre,537,290,247
False,8128131,"Wertheim, Stadt",20 - 25 Jahre,1314,683,631
False,8128131,"Wertheim, Stadt",25 - 30 Jahre,1284,697,587
False,8128131,"Wertheim, Stadt",30 - 35 Jahre,1317,646,671
False,8128131,"Wertheim, Stadt",35 - 40 Jahre,1293,648,645
False,8128131,"Wertheim, Stadt",40 - 45 Jahre,1737,864,873
False,8128131,"Wertheim, Stadt",45 - 50 Jahre,2093,1016,1077
False,8128131,"Wertheim, Stadt",50 - 55 Jahre,1896,1018,878
False,8128131,"Wertheim, Stadt",55 - 60 Jahre,1608,766,842
False,8128131,"Wertheim, Stadt",60 - 65 Jahre,1397,705,692
False,8128131,"Wertheim, Stadt",65 - 75 Jahre,2482,1173,1309
False,8128131,"Wertheim, Stadt",75 und mehr Jahre,2622,1006,1616
False,8128131,"Wertheim, Stadt",Insgesamt,23552,11538,12014
False,8128137,Wittighausen,unter 3 Jahre,37,18,19
False,8128137,Wittighausen,3 -  6 Jahre,52,27,25
False,8128137,Wittighausen,6 - 10 Jahre,66,35,31
False,8128137,Wittighausen,10 - 15 Jahre,103,53,50
False,8128137,Wittighausen,15 - 18 Jahre,55,30,25
False,8128137,Wittighausen,18 - 20 Jahre,45,15,30
False,8128137,Wittighausen,20 - 25 Jahre,102,50,52
False,8128137,Wittighausen,25 - 30 Jahre,88,54,34
False,8128137,Wittighausen,30 - 35 Jahre,83,42,41
False,8128137,Wittighausen,35 - 40 Jahre,108,51,57
False,8128137,Wittighausen,40 - 45 Jahre,150,86,64
False,8128137,Wittighausen,45 - 50 Jahre,136,64,72
False,8128137,Wittighausen,50 - 55 Jahre,146,90,56
False,8128137,Wittighausen,55 - 60 Jahre,115,65,50
False,8128137,Wittighausen,60 - 65 Jahre,95,47,48
False,8128137,Wittighausen,65 - 75 Jahre,175,92,83
False,8128137,Wittighausen,75 und mehr Jahre,145,54,91
False,8128137,Wittighausen,Insgesamt,1701,873,828
False,8128138,Ahorn,unter 3 Jahre,44,23,21
False,8128138,Ahorn,3 -  6 Jahre,44,26,18
False,8128138,Ahorn,6 - 10 Jahre,85,47,38
False,8128138,Ahorn,10 - 15 Jahre,138,73,65
False,8128138,Ahorn,15 - 18 Jahre,85,47,38
False,8128138,Ahorn,18 - 20 Jahre,72,43,29
False,8128138,Ahorn,20 - 25 Jahre,139,70,69
False,8128138,Ahorn,25 - 30 Jahre,103,53,50
False,8128138,Ahorn,30 - 35 Jahre,103,54,49
False,8128138,Ahorn,35 - 40 Jahre,110,49,61
False,8128138,Ahorn,40 - 45 Jahre,187,99,88
False,8128138,Ahorn,45 - 50 Jahre,239,122,117
False,8128138,Ahorn,50 - 55 Jahre,189,106,83
False,8128138,Ahorn,55 - 60 Jahre,143,76,67
False,8128138,Ahorn,60 - 65 Jahre,134,71,63
False,8128138,Ahorn,65 - 75 Jahre,208,95,113
False,8128138,Ahorn,75 und mehr Jahre,240,87,153
False,8128138,Ahorn,Insgesamt,2263,1141,1122
False,8128139,"Lauda-Königshofen, Stadt",unter 3 Jahre,321,154,167
False,8128139,"Lauda-Königshofen, Stadt",3 -  6 Jahre,345,171,174
False,8128139,"Lauda-Königshofen, Stadt",6 - 10 Jahre,554,306,248
False,8128139,"Lauda-Königshofen, Stadt",10 - 15 Jahre,786,383,403
False,8128139,"Lauda-Königshofen, Stadt",15 - 18 Jahre,511,271,240
False,8128139,"Lauda-Königshofen, Stadt",18 - 20 Jahre,379,217,162
False,8128139,"Lauda-Königshofen, Stadt",20 - 25 Jahre,807,431,376
False,8128139,"Lauda-Königshofen, Stadt",25 - 30 Jahre,787,420,367
False,8128139,"Lauda-Königshofen, Stadt",30 - 35 Jahre,803,411,392
False,8128139,"Lauda-Königshofen, Stadt",35 - 40 Jahre,828,415,413
False,8128139,"Lauda-Königshofen, Stadt",40 - 45 Jahre,1068,549,519
False,8128139,"Lauda-Königshofen, Stadt",45 - 50 Jahre,1232,618,614
False,8128139,"Lauda-Königshofen, Stadt",50 - 55 Jahre,1184,576,608
False,8128139,"Lauda-Königshofen, Stadt",55 - 60 Jahre,1042,523,519
False,8128139,"Lauda-Königshofen, Stadt",60 - 65 Jahre,892,445,447
False,8128139,"Lauda-Königshofen, Stadt",65 - 75 Jahre,1693,831,862
False,8128139,"Lauda-Königshofen, Stadt",75 und mehr Jahre,1392,547,845
False,8128139,"Lauda-Königshofen, Stadt",Insgesamt,14624,7268,7356
False,8135,Landkreis Heidenheim,unter 3 Jahre,3085,1575,1510
False,8135,Landkreis Heidenheim,3 -  6 Jahre,3322,1701,1621
False,8135,Landkreis Heidenheim,6 - 10 Jahre,4929,2542,2387
False,8135,Landkreis Heidenheim,10 - 15 Jahre,7187,3743,3444
False,8135,Landkreis Heidenheim,15 - 18 Jahre,4585,2288,2297
False,8135,Landkreis Heidenheim,18 - 20 Jahre,3217,1681,1536
False,8135,Landkreis Heidenheim,20 - 25 Jahre,7621,4165,3456
False,8135,Landkreis Heidenheim,25 - 30 Jahre,7100,3697,3403
False,8135,Landkreis Heidenheim,30 - 35 Jahre,6921,3496,3425
False,8135,Landkreis Heidenheim,35 - 40 Jahre,7759,3867,3892
False,8135,Landkreis Heidenheim,40 - 45 Jahre,10407,5269,5138
False,8135,Landkreis Heidenheim,45 - 50 Jahre,10896,5577,5319
False,8135,Landkreis Heidenheim,50 - 55 Jahre,9860,4934,4926
False,8135,Landkreis Heidenheim,55 - 60 Jahre,8479,4301,4178
False,8135,Landkreis Heidenheim,60 - 65 Jahre,7425,3694,3731
False,8135,Landkreis Heidenheim,65 - 75 Jahre,14692,6885,7807
False,8135,Landkreis Heidenheim,75 und mehr Jahre,13631,5247,8384
False,8135,Landkreis Heidenheim,Insgesamt,131116,64662,66454
False,8135010,Dischingen,unter 3 Jahre,100,48,52
False,8135010,Dischingen,3 -  6 Jahre,116,64,52
False,8135010,Dischingen,6 - 10 Jahre,172,85,87
False,8135010,Dischingen,10 - 15 Jahre,251,132,119
False,8135010,Dischingen,15 - 18 Jahre,180,103,77
False,8135010,Dischingen,18 - 20 Jahre,115,68,47
False,8135010,Dischingen,20 - 25 Jahre,277,158,119
False,8135010,Dischingen,25 - 30 Jahre,235,142,93
False,8135010,Dischingen,30 - 35 Jahre,217,114,103
False,8135010,Dischingen,35 - 40 Jahre,263,131,132
False,8135010,Dischingen,40 - 45 Jahre,354,189,165
False,8135010,Dischingen,45 - 50 Jahre,375,191,184
False,8135010,Dischingen,50 - 55 Jahre,372,205,167
False,8135010,Dischingen,55 - 60 Jahre,303,164,139
False,8135010,Dischingen,60 - 65 Jahre,250,127,123
False,8135010,Dischingen,65 - 75 Jahre,425,210,215
False,8135010,Dischingen,75 und mehr Jahre,414,164,250
False,8135010,Dischingen,Insgesamt,4419,2295,2124
False,8135015,Gerstetten,unter 3 Jahre,265,126,139
False,8135015,Gerstetten,3 -  6 Jahre,341,154,187
False,8135015,Gerstetten,6 - 10 Jahre,468,246,222
False,8135015,Gerstetten,10 - 15 Jahre,729,356,373
False,8135015,Gerstetten,15 - 18 Jahre,455,222,233
False,8135015,Gerstetten,18 - 20 Jahre,286,168,118
False,8135015,Gerstetten,20 - 25 Jahre,675,367,308
False,8135015,Gerstetten,25 - 30 Jahre,552,278,274
False,8135015,Gerstetten,30 - 35 Jahre,589,283,306
False,8135015,Gerstetten,35 - 40 Jahre,737,367,370
False,8135015,Gerstetten,40 - 45 Jahre,970,479,491
False,8135015,Gerstetten,45 - 50 Jahre,977,518,459
False,8135015,Gerstetten,50 - 55 Jahre,913,466,447
False,8135015,Gerstetten,55 - 60 Jahre,736,379,357
False,8135015,Gerstetten,60 - 65 Jahre,657,356,301
False,8135015,Gerstetten,65 - 75 Jahre,1219,572,647
False,8135015,Gerstetten,75 und mehr Jahre,1098,414,684
False,8135015,Gerstetten,Insgesamt,11667,5751,5916
False,8135016,"Giengen an der Brenz, Stadt",unter 3 Jahre,436,229,207
False,8135016,"Giengen an der Brenz, Stadt",3 -  6 Jahre,495,246,249
False,8135016,"Giengen an der Brenz, Stadt",6 - 10 Jahre,742,401,341
False,8135016,"Giengen an der Brenz, Stadt",10 - 15 Jahre,1030,557,473
False,8135016,"Giengen an der Brenz, Stadt",15 - 18 Jahre,682,331,351
False,8135016,"Giengen an der Brenz, Stadt",18 - 20 Jahre,517,287,230
False,8135016,"Giengen an der Brenz, Stadt",20 - 25 Jahre,1136,636,500
False,8135016,"Giengen an der Brenz, Stadt",25 - 30 Jahre,1011,542,469
False,8135016,"Giengen an der Brenz, Stadt",30 - 35 Jahre,1025,501,524
False,8135016,"Giengen an der Brenz, Stadt",35 - 40 Jahre,1148,563,585
False,8135016,"Giengen an der Brenz, Stadt",40 - 45 Jahre,1610,802,808
False,8135016,"Giengen an der Brenz, Stadt",45 - 50 Jahre,1585,824,761
False,8135016,"Giengen an der Brenz, Stadt",50 - 55 Jahre,1397,705,692
False,8135016,"Giengen an der Brenz, Stadt",55 - 60 Jahre,1271,656,615
False,8135016,"Giengen an der Brenz, Stadt",60 - 65 Jahre,1073,520,553
False,8135016,"Giengen an der Brenz, Stadt",65 - 75 Jahre,2183,1019,1164
False,8135016,"Giengen an der Brenz, Stadt",75 und mehr Jahre,2093,832,1261
False,8135016,"Giengen an der Brenz, Stadt",Insgesamt,19434,9651,9783
False,8135019,"Heidenheim an der Brenz, Stadt",unter 3 Jahre,1200,620,580
False,8135019,"Heidenheim an der Brenz, Stadt",3 -  6 Jahre,1210,628,582
False,8135019,"Heidenheim an der Brenz, Stadt",6 - 10 Jahre,1749,866,883
False,8135019,"Heidenheim an der Brenz, Stadt",10 - 15 Jahre,2466,1282,1184
False,8135019,"Heidenheim an der Brenz, Stadt",15 - 18 Jahre,1546,765,781
False,8135019,"Heidenheim an der Brenz, Stadt",18 - 20 Jahre,1137,567,570
False,8135019,"Heidenheim an der Brenz, Stadt",20 - 25 Jahre,2820,1494,1326
False,8135019,"Heidenheim an der Brenz, Stadt",25 - 30 Jahre,2855,1468,1387
False,8135019,"Heidenheim an der Brenz, Stadt",30 - 35 Jahre,2718,1343,1375
False,8135019,"Heidenheim an der Brenz, Stadt",35 - 40 Jahre,2937,1473,1464
False,8135019,"Heidenheim an der Brenz, Stadt",40 - 45 Jahre,3566,1834,1732
False,8135019,"Heidenheim an der Brenz, Stadt",45 - 50 Jahre,3862,1929,1933
False,8135019,"Heidenheim an der Brenz, Stadt",50 - 55 Jahre,3465,1737,1728
False,8135019,"Heidenheim an der Brenz, Stadt",55 - 60 Jahre,3050,1510,1540
False,8135019,"Heidenheim an der Brenz, Stadt",60 - 65 Jahre,2767,1355,1412
False,8135019,"Heidenheim an der Brenz, Stadt",65 - 75 Jahre,5533,2541,2992
False,8135019,"Heidenheim an der Brenz, Stadt",75 und mehr Jahre,5283,1972,3311
False,8135019,"Heidenheim an der Brenz, Stadt",Insgesamt,48164,23384,24780
False,8135020,"Herbrechtingen, Stadt",unter 3 Jahre,305,152,153
False,8135020,"Herbrechtingen, Stadt",3 -  6 Jahre,323,183,140
False,8135020,"Herbrechtingen, Stadt",6 - 10 Jahre,526,271,255
False,8135020,"Herbrechtingen, Stadt",10 - 15 Jahre,736,384,352
False,8135020,"Herbrechtingen, Stadt",15 - 18 Jahre,434,232,202
False,8135020,"Herbrechtingen, Stadt",18 - 20 Jahre,299,152,147
False,8135020,"Herbrechtingen, Stadt",20 - 25 Jahre,695,384,311
False,8135020,"Herbrechtingen, Stadt",25 - 30 Jahre,678,350,328
False,8135020,"Herbrechtingen, Stadt",30 - 35 Jahre,674,338,336
False,8135020,"Herbrechtingen, Stadt",35 - 40 Jahre,784,359,425
False,8135020,"Herbrechtingen, Stadt",40 - 45 Jahre,1072,541,531
False,8135020,"Herbrechtingen, Stadt",45 - 50 Jahre,1089,577,512
False,8135020,"Herbrechtingen, Stadt",50 - 55 Jahre,1028,499,529
False,8135020,"Herbrechtingen, Stadt",55 - 60 Jahre,839,424,415
False,8135020,"Herbrechtingen, Stadt",60 - 65 Jahre,731,360,371
False,8135020,"Herbrechtingen, Stadt",65 - 75 Jahre,1403,652,751
False,8135020,"Herbrechtingen, Stadt",75 und mehr Jahre,1462,562,900
False,8135020,"Herbrechtingen, Stadt",Insgesamt,13078,6420,6658
False,8135021,Hermaringen,unter 3 Jahre,49,21,28
False,8135021,Hermaringen,3 -  6 Jahre,64,36,28
False,8135021,Hermaringen,6 - 10 Jahre,88,54,34
False,8135021,Hermaringen,10 - 15 Jahre,121,64,57
False,8135021,Hermaringen,15 - 18 Jahre,101,44,57
False,8135021,Hermaringen,18 - 20 Jahre,71,34,37
False,8135021,Hermaringen,20 - 25 Jahre,159,92,67
False,8135021,Hermaringen,25 - 30 Jahre,101,54,47
False,8135021,Hermaringen,30 - 35 Jahre,105,61,44
False,8135021,Hermaringen,35 - 40 Jahre,132,71,61
False,8135021,Hermaringen,40 - 45 Jahre,209,111,98
False,8135021,Hermaringen,45 - 50 Jahre,215,118,97
False,8135021,Hermaringen,50 - 55 Jahre,189,97,92
False,8135021,Hermaringen,55 - 60 Jahre,129,72,57
False,8135021,Hermaringen,60 - 65 Jahre,116,63,53
False,8135021,Hermaringen,65 - 75 Jahre,244,111,133
False,8135021,Hermaringen,75 und mehr Jahre,220,87,133
False,8135021,Hermaringen,Insgesamt,2313,1190,1123
False,8135025,Königsbronn,unter 3 Jahre,128,68,60
False,8135025,Königsbronn,3 -  6 Jahre,141,73,68
False,8135025,Königsbronn,6 - 10 Jahre,232,116,116
False,8135025,Königsbronn,10 - 15 Jahre,397,208,189
False,8135025,Königsbronn,15 - 18 Jahre,278,140,138
False,8135025,Königsbronn,18 - 20 Jahre,188,100,88
False,8135025,Königsbronn,20 - 25 Jahre,368,202,166
False,8135025,Königsbronn,25 - 30 Jahre,304,156,148
False,8135025,Königsbronn,30 - 35 Jahre,288,149,139
False,8135025,Königsbronn,35 - 40 Jahre,378,198,180
False,8135025,Königsbronn,40 - 45 Jahre,572,292,280
False,8135025,Königsbronn,45 - 50 Jahre,604,318,286
False,8135025,Königsbronn,50 - 55 Jahre,547,268,279
False,8135025,Königsbronn,55 - 60 Jahre,521,263,258
False,8135025,Königsbronn,60 - 65 Jahre,439,208,231
False,8135025,Königsbronn,65 - 75 Jahre,929,439,490
False,8135025,Königsbronn,75 und mehr Jahre,771,306,465
False,8135025,Königsbronn,Insgesamt,7085,3504,3581
False,8135026,Nattheim,unter 3 Jahre,171,97,74
False,8135026,Nattheim,3 -  6 Jahre,150,76,74
False,8135026,Nattheim,6 - 10 Jahre,233,118,115
False,8135026,Nattheim,10 - 15 Jahre,360,186,174
False,8135026,Nattheim,15 - 18 Jahre,229,114,115
False,8135026,Nattheim,18 - 20 Jahre,128,64,64
False,8135026,Nattheim,20 - 25 Jahre,370,216,154
False,8135026,Nattheim,25 - 30 Jahre,348,164,184
False,8135026,Nattheim,30 - 35 Jahre,325,167,158
False,8135026,Nattheim,35 - 40 Jahre,340,172,168
False,8135026,Nattheim,40 - 45 Jahre,548,270,278
False,8135026,Nattheim,45 - 50 Jahre,565,296,269
False,8135026,Nattheim,50 - 55 Jahre,443,206,237
False,8135026,Nattheim,55 - 60 Jahre,419,212,207
False,8135026,Nattheim,60 - 65 Jahre,337,162,175
False,8135026,Nattheim,65 - 75 Jahre,735,370,365
False,8135026,Nattheim,75 und mehr Jahre,519,206,313
False,8135026,Nattheim,Insgesamt,6220,3096,3124
False,8135027,"Niederstotzingen, Stadt",unter 3 Jahre,96,51,45
False,8135027,"Niederstotzingen, Stadt",3 -  6 Jahre,124,66,58
False,8135027,"Niederstotzingen, Stadt",6 - 10 Jahre,167,78,89
False,8135027,"Niederstotzingen, Stadt",10 - 15 Jahre,256,129,127
False,8135027,"Niederstotzingen, Stadt",15 - 18 Jahre,161,79,82
False,8135027,"Niederstotzingen, Stadt",18 - 20 Jahre,108,55,53
False,8135027,"Niederstotzingen, Stadt",20 - 25 Jahre,306,160,146
False,8135027,"Niederstotzingen, Stadt",25 - 30 Jahre,257,135,122
False,8135027,"Niederstotzingen, Stadt",30 - 35 Jahre,248,139,109
False,8135027,"Niederstotzingen, Stadt",35 - 40 Jahre,280,148,132
False,8135027,"Niederstotzingen, Stadt",40 - 45 Jahre,388,183,205
False,8135027,"Niederstotzingen, Stadt",45 - 50 Jahre,406,207,199
False,8135027,"Niederstotzingen, Stadt",50 - 55 Jahre,414,216,198
False,8135027,"Niederstotzingen, Stadt",55 - 60 Jahre,302,154,148
False,8135027,"Niederstotzingen, Stadt",60 - 65 Jahre,261,136,125
False,8135027,"Niederstotzingen, Stadt",65 - 75 Jahre,456,220,236
False,8135027,"Niederstotzingen, Stadt",75 und mehr Jahre,415,160,255
False,8135027,"Niederstotzingen, Stadt",Insgesamt,4645,2316,2329
False,8135031,Sontheim an der Brenz,unter 3 Jahre,138,71,67
False,8135031,Sontheim an der Brenz,3 -  6 Jahre,147,71,76
False,8135031,Sontheim an der Brenz,6 - 10 Jahre,221,126,95
False,8135031,Sontheim an der Brenz,10 - 15 Jahre,331,172,159
False,8135031,Sontheim an der Brenz,15 - 18 Jahre,179,87,92
False,8135031,Sontheim an der Brenz,18 - 20 Jahre,144,77,67
False,8135031,Sontheim an der Brenz,20 - 25 Jahre,322,175,147
False,8135031,Sontheim an der Brenz,25 - 30 Jahre,316,173,143
False,8135031,Sontheim an der Brenz,30 - 35 Jahre,304,159,145
False,8135031,Sontheim an der Brenz,35 - 40 Jahre,303,161,142
False,8135031,Sontheim an der Brenz,40 - 45 Jahre,460,233,227
False,8135031,Sontheim an der Brenz,45 - 50 Jahre,502,246,256
False,8135031,Sontheim an der Brenz,50 - 55 Jahre,450,231,219
False,8135031,Sontheim an der Brenz,55 - 60 Jahre,341,173,168
False,8135031,Sontheim an der Brenz,60 - 65 Jahre,317,164,153
False,8135031,Sontheim an der Brenz,65 - 75 Jahre,560,277,283
False,8135031,Sontheim an der Brenz,75 und mehr Jahre,490,198,292
False,8135031,Sontheim an der Brenz,Insgesamt,5525,2794,2731
False,8135032,Steinheim am Albuch,unter 3 Jahre,197,92,105
False,8135032,Steinheim am Albuch,3 -  6 Jahre,211,104,107
False,8135032,Steinheim am Albuch,6 - 10 Jahre,331,181,150
False,8135032,Steinheim am Albuch,10 - 15 Jahre,510,273,237
False,8135032,Steinheim am Albuch,15 - 18 Jahre,340,171,169
False,8135032,Steinheim am Albuch,18 - 20 Jahre,224,109,115
False,8135032,Steinheim am Albuch,20 - 25 Jahre,493,281,212
False,8135032,Steinheim am Albuch,25 - 30 Jahre,443,235,208
False,8135032,Steinheim am Albuch,30 - 35 Jahre,428,242,186
False,8135032,Steinheim am Albuch,35 - 40 Jahre,457,224,233
False,8135032,Steinheim am Albuch,40 - 45 Jahre,658,335,323
False,8135032,Steinheim am Albuch,45 - 50 Jahre,716,353,363
False,8135032,Steinheim am Albuch,50 - 55 Jahre,642,304,338
False,8135032,Steinheim am Albuch,55 - 60 Jahre,568,294,274
False,8135032,Steinheim am Albuch,60 - 65 Jahre,477,243,234
False,8135032,Steinheim am Albuch,65 - 75 Jahre,1005,474,531
False,8135032,Steinheim am Albuch,75 und mehr Jahre,866,346,520
False,8135032,Steinheim am Albuch,Insgesamt,8566,4261,4305
False,8136,Landkreis Ostalbkreis,unter 3 Jahre,8000,4109,3891
False,8136,Landkreis Ostalbkreis,3 -  6 Jahre,8578,4333,4245
False,8136,Landkreis Ostalbkreis,6 - 10 Jahre,12473,6367,6106
False,8136,Landkreis Ostalbkreis,10 - 15 Jahre,17983,9178,8805
False,8136,Landkreis Ostalbkreis,15 - 18 Jahre,11376,5930,5446
False,8136,Landkreis Ostalbkreis,18 - 20 Jahre,7825,3992,3833
False,8136,Landkreis Ostalbkreis,20 - 25 Jahre,18604,9609,8995
False,8136,Landkreis Ostalbkreis,25 - 30 Jahre,17400,8894,8506
False,8136,Landkreis Ostalbkreis,30 - 35 Jahre,17452,8774,8678
False,8136,Landkreis Ostalbkreis,35 - 40 Jahre,19522,9930,9592
False,8136,Landkreis Ostalbkreis,40 - 45 Jahre,24881,12716,12165
False,8136,Landkreis Ostalbkreis,45 - 50 Jahre,26252,13513,12739
False,8136,Landkreis Ostalbkreis,50 - 55 Jahre,23482,11911,11571
False,8136,Landkreis Ostalbkreis,55 - 60 Jahre,19919,9885,10034
False,8136,Landkreis Ostalbkreis,60 - 65 Jahre,16821,8415,8406
False,8136,Landkreis Ostalbkreis,65 - 75 Jahre,32187,15318,16869
False,8136,Landkreis Ostalbkreis,75 und mehr Jahre,27978,10656,17322
False,8136,Landkreis Ostalbkreis,Insgesamt,310733,153530,157203
False,8136002,Abtsgmünd,unter 3 Jahre,195,90,105
False,8136002,Abtsgmünd,3 -  6 Jahre,226,110,116
False,8136002,Abtsgmünd,6 - 10 Jahre,290,140,150
False,8136002,Abtsgmünd,10 - 15 Jahre,440,235,205
False,8136002,Abtsgmünd,15 - 18 Jahre,265,138,127
False,8136002,Abtsgmünd,18 - 20 Jahre,194,104,90
False,8136002,Abtsgmünd,20 - 25 Jahre,453,224,229
False,8136002,Abtsgmünd,25 - 30 Jahre,411,221,190
False,8136002,Abtsgmünd,30 - 35 Jahre,411,199,212
False,8136002,Abtsgmünd,35 - 40 Jahre,461,254,207
False,8136002,Abtsgmünd,40 - 45 Jahre,643,325,318
False,8136002,Abtsgmünd,45 - 50 Jahre,660,333,327
False,8136002,Abtsgmünd,50 - 55 Jahre,614,311,303
False,8136002,Abtsgmünd,55 - 60 Jahre,473,244,229
False,8136002,Abtsgmünd,60 - 65 Jahre,335,184,151
False,8136002,Abtsgmünd,65 - 75 Jahre,715,331,384
False,8136002,Abtsgmünd,75 und mehr Jahre,606,221,385
False,8136002,Abtsgmünd,Insgesamt,7392,3664,3728
False,8136003,Adelmannsfelden,unter 3 Jahre,35,18,17
False,8136003,Adelmannsfelden,3 -  6 Jahre,41,24,17
False,8136003,Adelmannsfelden,6 - 10 Jahre,94,48,46
False,8136003,Adelmannsfelden,10 - 15 Jahre,145,64,81
False,8136003,Adelmannsfelden,15 - 18 Jahre,90,49,41
False,8136003,Adelmannsfelden,18 - 20 Jahre,54,23,31
False,8136003,Adelmannsfelden,20 - 25 Jahre,97,47,50
False,8136003,Adelmannsfelden,25 - 30 Jahre,75,32,43
False,8136003,Adelmannsfelden,30 - 35 Jahre,90,41,49
False,8136003,Adelmannsfelden,35 - 40 Jahre,99,46,53
False,8136003,Adelmannsfelden,40 - 45 Jahre,157,89,68
False,8136003,Adelmannsfelden,45 - 50 Jahre,187,97,90
False,8136003,Adelmannsfelden,50 - 55 Jahre,152,87,65
False,8136003,Adelmannsfelden,55 - 60 Jahre,108,65,43
False,8136003,Adelmannsfelden,60 - 65 Jahre,87,45,42
False,8136003,Adelmannsfelden,65 - 75 Jahre,171,80,91
False,8136003,Adelmannsfelden,75 und mehr Jahre,134,48,86
False,8136003,Adelmannsfelden,Insgesamt,1816,903,913
False,8136007,Bartholomä,unter 3 Jahre,50,28,22
False,8136007,Bartholomä,3 -  6 Jahre,52,21,31
False,8136007,Bartholomä,6 - 10 Jahre,74,44,30
False,8136007,Bartholomä,10 - 15 Jahre,108,47,61
False,8136007,Bartholomä,15 - 18 Jahre,92,48,44
False,8136007,Bartholomä,18 - 20 Jahre,58,25,33
False,8136007,Bartholomä,20 - 25 Jahre,124,60,64
False,8136007,Bartholomä,25 - 30 Jahre,102,52,50
False,8136007,Bartholomä,30 - 35 Jahre,108,49,59
False,8136007,Bartholomä,35 - 40 Jahre,126,57,69
False,8136007,Bartholomä,40 - 45 Jahre,171,78,93
False,8136007,Bartholomä,45 - 50 Jahre,197,100,97
False,8136007,Bartholomä,50 - 55 Jahre,179,89,90
False,8136007,Bartholomä,55 - 60 Jahre,155,81,74
False,8136007,Bartholomä,60 - 65 Jahre,136,71,65
False,8136007,Bartholomä,65 - 75 Jahre,196,95,101
False,8136007,Bartholomä,75 und mehr Jahre,197,78,119
False,8136007,Bartholomä,Insgesamt,2125,1023,1102
False,8136009,Böbingen an der Rems,unter 3 Jahre,114,59,55
False,8136009,Böbingen an der Rems,3 -  6 Jahre,119,52,67
False,8136009,Böbingen an der Rems,6 - 10 Jahre,223,108,115
False,8136009,Böbingen an der Rems,10 - 15 Jahre,291,170,121
False,8136009,Böbingen an der Rems,15 - 18 Jahre,184,95,89
False,8136009,Böbingen an der Rems,18 - 20 Jahre,131,74,57
False,8136009,Böbingen an der Rems,20 - 25 Jahre,259,136,123
False,8136009,Böbingen an der Rems,25 - 30 Jahre,249,114,135
False,8136009,Böbingen an der Rems,30 - 35 Jahre,261,136,125
False,8136009,Böbingen an der Rems,35 - 40 Jahre,295,147,148
False,8136009,Böbingen an der Rems,40 - 45 Jahre,433,210,223
False,8136009,Böbingen an der Rems,45 - 50 Jahre,379,197,182
False,8136009,Böbingen an der Rems,50 - 55 Jahre,316,169,147
False,8136009,Böbingen an der Rems,55 - 60 Jahre,273,135,138
False,8136009,Böbingen an der Rems,60 - 65 Jahre,253,113,140
False,8136009,Böbingen an der Rems,65 - 75 Jahre,488,230,258
False,8136009,Böbingen an der Rems,75 und mehr Jahre,346,140,206
False,8136009,Böbingen an der Rems,Insgesamt,4614,2285,2329
False,8136010,"Bopfingen, Stadt",unter 3 Jahre,311,176,135
False,8136010,"Bopfingen, Stadt",3 -  6 Jahre,342,178,164
False,8136010,"Bopfingen, Stadt",6 - 10 Jahre,553,278,275
False,8136010,"Bopfingen, Stadt",10 - 15 Jahre,745,369,376
False,8136010,"Bopfingen, Stadt",15 - 18 Jahre,422,219,203
False,8136010,"Bopfingen, Stadt",18 - 20 Jahre,309,156,153
False,8136010,"Bopfingen, Stadt",20 - 25 Jahre,765,386,379
False,8136010,"Bopfingen, Stadt",25 - 30 Jahre,656,330,326
False,8136010,"Bopfingen, Stadt",30 - 35 Jahre,679,331,348
False,8136010,"Bopfingen, Stadt",35 - 40 Jahre,744,398,346
False,8136010,"Bopfingen, Stadt",40 - 45 Jahre,877,460,417
False,8136010,"Bopfingen, Stadt",45 - 50 Jahre,993,512,481
False,8136010,"Bopfingen, Stadt",50 - 55 Jahre,919,474,445
False,8136010,"Bopfingen, Stadt",55 - 60 Jahre,833,414,419
False,8136010,"Bopfingen, Stadt",60 - 65 Jahre,682,353,329
False,8136010,"Bopfingen, Stadt",65 - 75 Jahre,1229,576,653
False,8136010,"Bopfingen, Stadt",75 und mehr Jahre,1108,398,710
False,8136010,"Bopfingen, Stadt",Insgesamt,12167,6008,6159
False,8136015,Durlangen,unter 3 Jahre,83,47,36
False,8136015,Durlangen,3 -  6 Jahre,89,41,48
False,8136015,Durlangen,6 - 10 Jahre,127,64,63
False,8136015,Durlangen,10 - 15 Jahre,170,95,75
False,8136015,Durlangen,15 - 18 Jahre,127,70,57
False,8136015,Durlangen,18 - 20 Jahre,76,45,31
False,8136015,Durlangen,20 - 25 Jahre,171,85,86
False,8136015,Durlangen,25 - 30 Jahre,141,66,75
False,8136015,Durlangen,30 - 35 Jahre,141,76,65
False,8136015,Durlangen,35 - 40 Jahre,168,81,87
False,8136015,Durlangen,40 - 45 Jahre,228,123,105
False,8136015,Durlangen,45 - 50 Jahre,261,130,131
False,8136015,Durlangen,50 - 55 Jahre,222,117,105
False,8136015,Durlangen,55 - 60 Jahre,211,107,104
False,8136015,Durlangen,60 - 65 Jahre,161,86,75
False,8136015,Durlangen,65 - 75 Jahre,298,139,159
False,8136015,Durlangen,75 und mehr Jahre,219,97,122
False,8136015,Durlangen,Insgesamt,2893,1469,1424
False,8136018,Ellenberg,unter 3 Jahre,31,16,15
False,8136018,Ellenberg,3 -  6 Jahre,44,20,24
False,8136018,Ellenberg,6 - 10 Jahre,73,31,42
False,8136018,Ellenberg,10 - 15 Jahre,113,49,64
False,8136018,Ellenberg,15 - 18 Jahre,66,32,34
False,8136018,Ellenberg,18 - 20 Jahre,44,26,18
False,8136018,Ellenberg,20 - 25 Jahre,105,51,54
False,8136018,Ellenberg,25 - 30 Jahre,90,46,44
False,8136018,Ellenberg,30 - 35 Jahre,109,64,45
False,8136018,Ellenberg,35 - 40 Jahre,89,49,40
False,8136018,Ellenberg,40 - 45 Jahre,125,62,63
False,8136018,Ellenberg,45 - 50 Jahre,169,95,74
False,8136018,Ellenberg,50 - 55 Jahre,156,86,70
False,8136018,Ellenberg,55 - 60 Jahre,125,69,56
False,8136018,Ellenberg,60 - 65 Jahre,82,51,31
False,8136018,Ellenberg,65 - 75 Jahre,144,67,77
False,8136018,Ellenberg,75 und mehr Jahre,129,45,84
False,8136018,Ellenberg,Insgesamt,1694,859,835
False,8136019,"Ellwangen (Jagst), Stadt",unter 3 Jahre,618,324,294
False,8136019,"Ellwangen (Jagst), Stadt",3 -  6 Jahre,711,355,356
False,8136019,"Ellwangen (Jagst), Stadt",6 - 10 Jahre,994,491,503
False,8136019,"Ellwangen (Jagst), Stadt",10 - 15 Jahre,1510,760,750
False,8136019,"Ellwangen (Jagst), Stadt",15 - 18 Jahre,906,446,460
False,8136019,"Ellwangen (Jagst), Stadt",18 - 20 Jahre,644,336,308
False,8136019,"Ellwangen (Jagst), Stadt",20 - 25 Jahre,1408,744,664
False,8136019,"Ellwangen (Jagst), Stadt",25 - 30 Jahre,1334,656,678
False,8136019,"Ellwangen (Jagst), Stadt",30 - 35 Jahre,1371,664,707
False,8136019,"Ellwangen (Jagst), Stadt",35 - 40 Jahre,1594,797,797
False,8136019,"Ellwangen (Jagst), Stadt",40 - 45 Jahre,2009,1030,979
False,8136019,"Ellwangen (Jagst), Stadt",45 - 50 Jahre,2073,1097,976
False,8136019,"Ellwangen (Jagst), Stadt",50 - 55 Jahre,1871,981,890
False,8136019,"Ellwangen (Jagst), Stadt",55 - 60 Jahre,1586,808,778
False,8136019,"Ellwangen (Jagst), Stadt",60 - 65 Jahre,1233,623,610
False,8136019,"Ellwangen (Jagst), Stadt",65 - 75 Jahre,2351,1137,1214
False,8136019,"Ellwangen (Jagst), Stadt",75 und mehr Jahre,2376,881,1495
False,8136019,"Ellwangen (Jagst), Stadt",Insgesamt,24589,12130,12459
False,8136020,Eschach,unter 3 Jahre,48,26,22
False,8136020,Eschach,3 -  6 Jahre,62,27,35
False,8136020,Eschach,6 - 10 Jahre,89,43,46
False,8136020,Eschach,10 - 15 Jahre,105,49,56
False,8136020,Eschach,15 - 18 Jahre,85,41,44
False,8136020,Eschach,18 - 20 Jahre,63,39,24
False,8136020,Eschach,20 - 25 Jahre,102,69,33
False,8136020,Eschach,25 - 30 Jahre,80,41,39
False,8136020,Eschach,30 - 35 Jahre,83,43,40
False,8136020,Eschach,35 - 40 Jahre,109,51,58
False,8136020,Eschach,40 - 45 Jahre,167,87,80
False,8136020,Eschach,45 - 50 Jahre,176,86,90
False,8136020,Eschach,50 - 55 Jahre,149,76,73
False,8136020,Eschach,55 - 60 Jahre,113,64,49
False,8136020,Eschach,60 - 65 Jahre,83,49,34
False,8136020,Eschach,65 - 75 Jahre,154,72,82
False,8136020,Eschach,75 und mehr Jahre,135,53,82
False,8136020,Eschach,Insgesamt,1803,916,887
False,8136021,Essingen,unter 3 Jahre,184,108,76
False,8136021,Essingen,3 -  6 Jahre,178,82,96
False,8136021,Essingen,6 - 10 Jahre,272,134,138
False,8136021,Essingen,10 - 15 Jahre,347,172,175
False,8136021,Essingen,15 - 18 Jahre,237,122,115
False,8136021,Essingen,18 - 20 Jahre,165,85,80
False,8136021,Essingen,20 - 25 Jahre,349,202,147
False,8136021,Essingen,25 - 30 Jahre,330,166,164
False,8136021,Essingen,30 - 35 Jahre,399,190,209
False,8136021,Essingen,35 - 40 Jahre,433,232,201
False,8136021,Essingen,40 - 45 Jahre,493,261,232
False,8136021,Essingen,45 - 50 Jahre,563,277,286
False,8136021,Essingen,50 - 55 Jahre,506,250,256
False,8136021,Essingen,55 - 60 Jahre,416,211,205
False,8136021,Essingen,60 - 65 Jahre,349,171,178
False,8136021,Essingen,65 - 75 Jahre,654,319,335
False,8136021,Essingen,75 und mehr Jahre,496,202,294
False,8136021,Essingen,Insgesamt,6371,3184,3187
False,8136024,Göggingen,unter 3 Jahre,65,34,31
False,8136024,Göggingen,3 -  6 Jahre,58,27,31
False,8136024,Göggingen,6 - 10 Jahre,101,50,51
False,8136024,Göggingen,10 - 15 Jahre,173,93,80
False,8136024,Göggingen,15 - 18 Jahre,102,54,48
False,8136024,Göggingen,18 - 20 Jahre,70,33,37
False,8136024,Göggingen,20 - 25 Jahre,156,85,71
False,8136024,Göggingen,25 - 30 Jahre,132,62,70
False,8136024,Göggingen,30 - 35 Jahre,133,63,70
False,8136024,Göggingen,35 - 40 Jahre,158,69,89
False,8136024,Göggingen,40 - 45 Jahre,200,100,100
False,8136024,Göggingen,45 - 50 Jahre,265,114,151
False,8136024,Göggingen,50 - 55 Jahre,215,114,101
False,8136024,Göggingen,55 - 60 Jahre,153,79,74
False,8136024,Göggingen,60 - 65 Jahre,127,67,60
False,8136024,Göggingen,65 - 75 Jahre,201,95,106
False,8136024,Göggingen,75 und mehr Jahre,129,53,76
False,8136024,Göggingen,Insgesamt,2438,1192,1246
False,8136027,Gschwend,unter 3 Jahre,132,74,58
False,8136027,Gschwend,3 -  6 Jahre,133,73,60
False,8136027,Gschwend,6 - 10 Jahre,210,95,115
False,8136027,Gschwend,10 - 15 Jahre,261,143,118
False,8136027,Gschwend,15 - 18 Jahre,182,109,73
False,8136027,Gschwend,18 - 20 Jahre,138,76,62
False,8136027,Gschwend,20 - 25 Jahre,280,144,136
False,8136027,Gschwend,25 - 30 Jahre,265,138,127
False,8136027,Gschwend,30 - 35 Jahre,263,133,130
False,8136027,Gschwend,35 - 40 Jahre,279,136,143
False,8136027,Gschwend,40 - 45 Jahre,414,217,197
False,8136027,Gschwend,45 - 50 Jahre,436,213,223
False,8136027,Gschwend,50 - 55 Jahre,425,214,211
False,8136027,Gschwend,55 - 60 Jahre,324,166,158
False,8136027,Gschwend,60 - 65 Jahre,253,139,114
False,8136027,Gschwend,65 - 75 Jahre,496,228,268
False,8136027,Gschwend,75 und mehr Jahre,465,180,285
False,8136027,Gschwend,Insgesamt,4956,2478,2478
False,8136028,"Heubach, Stadt",unter 3 Jahre,262,132,130
False,8136028,"Heubach, Stadt",3 -  6 Jahre,282,146,136
False,8136028,"Heubach, Stadt",6 - 10 Jahre,405,206,199
False,8136028,"Heubach, Stadt",10 - 15 Jahre,543,283,260
False,8136028,"Heubach, Stadt",15 - 18 Jahre,336,190,146
False,8136028,"Heubach, Stadt",18 - 20 Jahre,248,118,130
False,8136028,"Heubach, Stadt",20 - 25 Jahre,597,324,273
False,8136028,"Heubach, Stadt",25 - 30 Jahre,585,321,264
False,8136028,"Heubach, Stadt",30 - 35 Jahre,583,285,298
False,8136028,"Heubach, Stadt",35 - 40 Jahre,605,316,289
False,8136028,"Heubach, Stadt",40 - 45 Jahre,735,365,370
False,8136028,"Heubach, Stadt",45 - 50 Jahre,827,432,395
False,8136028,"Heubach, Stadt",50 - 55 Jahre,808,388,420
False,8136028,"Heubach, Stadt",55 - 60 Jahre,688,316,372
False,8136028,"Heubach, Stadt",60 - 65 Jahre,588,287,301
False,8136028,"Heubach, Stadt",65 - 75 Jahre,1083,526,557
False,8136028,"Heubach, Stadt",75 und mehr Jahre,853,311,542
False,8136028,"Heubach, Stadt",Insgesamt,10028,4946,5082
False,8136029,Heuchlingen,unter 3 Jahre,47,19,28
False,8136029,Heuchlingen,3 -  6 Jahre,56,29,27
False,8136029,Heuchlingen,6 - 10 Jahre,76,36,40
False,8136029,Heuchlingen,10 - 15 Jahre,100,54,46
False,8136029,Heuchlingen,15 - 18 Jahre,65,31,34
False,8136029,Heuchlingen,18 - 20 Jahre,53,29,24
False,8136029,Heuchlingen,20 - 25 Jahre,125,71,54
False,8136029,Heuchlingen,25 - 30 Jahre,94,48,46
False,8136029,Heuchlingen,30 - 35 Jahre,86,41,45
False,8136029,Heuchlingen,35 - 40 Jahre,128,54,74
False,8136029,Heuchlingen,40 - 45 Jahre,160,95,65
False,8136029,Heuchlingen,45 - 50 Jahre,177,93,84
False,8136029,Heuchlingen,50 - 55 Jahre,138,74,64
False,8136029,Heuchlingen,55 - 60 Jahre,96,44,52
False,8136029,Heuchlingen,60 - 65 Jahre,79,48,31
False,8136029,Heuchlingen,65 - 75 Jahre,205,91,114
False,8136029,Heuchlingen,75 und mehr Jahre,155,74,81
False,8136029,Heuchlingen,Insgesamt,1840,931,909
False,8136033,Hüttlingen,unter 3 Jahre,186,85,101
False,8136033,Hüttlingen,3 -  6 Jahre,190,102,88
False,8136033,Hüttlingen,6 - 10 Jahre,241,128,113
False,8136033,Hüttlingen,10 - 15 Jahre,349,182,167
False,8136033,Hüttlingen,15 - 18 Jahre,211,129,82
False,8136033,Hüttlingen,18 - 20 Jahre,141,68,73
False,8136033,Hüttlingen,20 - 25 Jahre,320,175,145
False,8136033,Hüttlingen,25 - 30 Jahre,321,165,156
False,8136033,Hüttlingen,30 - 35 Jahre,325,150,175
False,8136033,Hüttlingen,35 - 40 Jahre,390,185,205
False,8136033,Hüttlingen,40 - 45 Jahre,490,268,222
False,8136033,Hüttlingen,45 - 50 Jahre,511,263,248
False,8136033,Hüttlingen,50 - 55 Jahre,446,228,218
False,8136033,Hüttlingen,55 - 60 Jahre,349,175,174
False,8136033,Hüttlingen,60 - 65 Jahre,289,144,145
False,8136033,Hüttlingen,65 - 75 Jahre,633,298,335
False,8136033,Hüttlingen,75 und mehr Jahre,472,187,285
False,8136033,Hüttlingen,Insgesamt,5864,2932,2932
False,8136034,Iggingen,unter 3 Jahre,70,30,40
False,8136034,Iggingen,3 -  6 Jahre,67,31,36
False,8136034,Iggingen,6 - 10 Jahre,101,59,42
False,8136034,Iggingen,10 - 15 Jahre,181,99,82
False,8136034,Iggingen,15 - 18 Jahre,95,46,49
False,8136034,Iggingen,18 - 20 Jahre,70,40,30
False,8136034,Iggingen,20 - 25 Jahre,140,79,61
False,8136034,Iggingen,25 - 30 Jahre,154,72,82
False,8136034,Iggingen,30 - 35 Jahre,145,87,58
False,8136034,Iggingen,35 - 40 Jahre,146,53,93
False,8136034,Iggingen,40 - 45 Jahre,246,137,109
False,8136034,Iggingen,45 - 50 Jahre,234,115,119
False,8136034,Iggingen,50 - 55 Jahre,189,95,94
False,8136034,Iggingen,55 - 60 Jahre,151,82,69
False,8136034,Iggingen,60 - 65 Jahre,132,55,77
False,8136034,Iggingen,65 - 75 Jahre,260,129,131
False,8136034,Iggingen,75 und mehr Jahre,179,68,111
False,8136034,Iggingen,Insgesamt,2560,1277,1283
False,8136035,Jagstzell,unter 3 Jahre,81,39,42
False,8136035,Jagstzell,3 -  6 Jahre,82,40,42
False,8136035,Jagstzell,6 - 10 Jahre,102,54,48
False,8136035,Jagstzell,10 - 15 Jahre,139,73,66
False,8136035,Jagstzell,15 - 18 Jahre,101,50,51
False,8136035,Jagstzell,18 - 20 Jahre,74,36,38
False,8136035,Jagstzell,20 - 25 Jahre,173,88,85
False,8136035,Jagstzell,25 - 30 Jahre,127,71,56
False,8136035,Jagstzell,30 - 35 Jahre,127,67,60
False,8136035,Jagstzell,35 - 40 Jahre,142,76,66
False,8136035,Jagstzell,40 - 45 Jahre,208,110,98
False,8136035,Jagstzell,45 - 50 Jahre,204,106,98
False,8136035,Jagstzell,50 - 55 Jahre,182,101,81
False,8136035,Jagstzell,55 - 60 Jahre,165,87,78
False,8136035,Jagstzell,60 - 65 Jahre,104,54,50
False,8136035,Jagstzell,65 - 75 Jahre,195,93,102
False,8136035,Jagstzell,75 und mehr Jahre,195,76,119
False,8136035,Jagstzell,Insgesamt,2401,1221,1180
False,8136037,Kirchheim am Ries,unter 3 Jahre,49,33,16
False,8136037,Kirchheim am Ries,3 -  6 Jahre,53,31,22
False,8136037,Kirchheim am Ries,6 - 10 Jahre,100,53,47
False,8136037,Kirchheim am Ries,10 - 15 Jahre,136,63,73
False,8136037,Kirchheim am Ries,15 - 18 Jahre,91,50,41
False,8136037,Kirchheim am Ries,18 - 20 Jahre,47,20,27
False,8136037,Kirchheim am Ries,20 - 25 Jahre,100,50,50
False,8136037,Kirchheim am Ries,25 - 30 Jahre,96,56,40
False,8136037,Kirchheim am Ries,30 - 35 Jahre,92,46,46
False,8136037,Kirchheim am Ries,35 - 40 Jahre,132,64,68
False,8136037,Kirchheim am Ries,40 - 45 Jahre,165,95,70
False,8136037,Kirchheim am Ries,45 - 50 Jahre,165,84,81
False,8136037,Kirchheim am Ries,50 - 55 Jahre,133,67,66
False,8136037,Kirchheim am Ries,55 - 60 Jahre,111,58,53
False,8136037,Kirchheim am Ries,60 - 65 Jahre,106,56,50
False,8136037,Kirchheim am Ries,65 - 75 Jahre,183,85,98
False,8136037,Kirchheim am Ries,75 und mehr Jahre,156,55,101
False,8136037,Kirchheim am Ries,Insgesamt,1915,966,949
False,8136038,"Lauchheim, Stadt",unter 3 Jahre,122,59,63
False,8136038,"Lauchheim, Stadt",3 -  6 Jahre,160,72,88
False,8136038,"Lauchheim, Stadt",6 - 10 Jahre,198,111,87
False,8136038,"Lauchheim, Stadt",10 - 15 Jahre,267,141,126
False,8136038,"Lauchheim, Stadt",15 - 18 Jahre,188,104,84
False,8136038,"Lauchheim, Stadt",18 - 20 Jahre,126,57,69
False,8136038,"Lauchheim, Stadt",20 - 25 Jahre,300,140,160
False,8136038,"Lauchheim, Stadt",25 - 30 Jahre,285,132,153
False,8136038,"Lauchheim, Stadt",30 - 35 Jahre,285,147,138
False,8136038,"Lauchheim, Stadt",35 - 40 Jahre,302,140,162
False,8136038,"Lauchheim, Stadt",40 - 45 Jahre,373,192,181
False,8136038,"Lauchheim, Stadt",45 - 50 Jahre,386,192,194
False,8136038,"Lauchheim, Stadt",50 - 55 Jahre,374,195,179
False,8136038,"Lauchheim, Stadt",55 - 60 Jahre,331,170,161
False,8136038,"Lauchheim, Stadt",60 - 65 Jahre,247,137,110
False,8136038,"Lauchheim, Stadt",65 - 75 Jahre,404,191,213
False,8136038,"Lauchheim, Stadt",75 und mehr Jahre,298,128,170
False,8136038,"Lauchheim, Stadt",Insgesamt,4646,2308,2338
False,8136040,Leinzell,unter 3 Jahre,44,19,25
False,8136040,Leinzell,3 -  6 Jahre,43,24,19
False,8136040,Leinzell,6 - 10 Jahre,68,37,31
False,8136040,Leinzell,10 - 15 Jahre,120,58,62
False,8136040,Leinzell,15 - 18 Jahre,67,31,36
False,8136040,Leinzell,18 - 20 Jahre,47,26,21
False,8136040,Leinzell,20 - 25 Jahre,124,63,61
False,8136040,Leinzell,25 - 30 Jahre,104,52,52
False,8136040,Leinzell,30 - 35 Jahre,113,52,61
False,8136040,Leinzell,35 - 40 Jahre,123,73,50
False,8136040,Leinzell,40 - 45 Jahre,167,77,90
False,8136040,Leinzell,45 - 50 Jahre,180,89,91
False,8136040,Leinzell,50 - 55 Jahre,163,70,93
False,8136040,Leinzell,55 - 60 Jahre,157,69,88
False,8136040,Leinzell,60 - 65 Jahre,138,74,64
False,8136040,Leinzell,65 - 75 Jahre,227,111,116
False,8136040,Leinzell,75 und mehr Jahre,199,72,127
False,8136040,Leinzell,Insgesamt,2084,997,1087
False,8136042,"Lorch, Stadt",unter 3 Jahre,232,109,123
False,8136042,"Lorch, Stadt",3 -  6 Jahre,280,144,136
False,8136042,"Lorch, Stadt",6 - 10 Jahre,396,206,190
False,8136042,"Lorch, Stadt",10 - 15 Jahre,606,309,297
False,8136042,"Lorch, Stadt",15 - 18 Jahre,419,216,203
False,8136042,"Lorch, Stadt",18 - 20 Jahre,267,131,136
False,8136042,"Lorch, Stadt",20 - 25 Jahre,610,293,317
False,8136042,"Lorch, Stadt",25 - 30 Jahre,636,332,304
False,8136042,"Lorch, Stadt",30 - 35 Jahre,579,322,257
False,8136042,"Lorch, Stadt",35 - 40 Jahre,661,356,305
False,8136042,"Lorch, Stadt",40 - 45 Jahre,889,442,447
False,8136042,"Lorch, Stadt",45 - 50 Jahre,1038,560,478
False,8136042,"Lorch, Stadt",50 - 55 Jahre,896,447,449
False,8136042,"Lorch, Stadt",55 - 60 Jahre,732,359,373
False,8136042,"Lorch, Stadt",60 - 65 Jahre,643,315,328
False,8136042,"Lorch, Stadt",65 - 75 Jahre,1194,586,608
False,8136042,"Lorch, Stadt",75 und mehr Jahre,996,395,601
False,8136042,"Lorch, Stadt",Insgesamt,11074,5522,5552
False,8136043,Mögglingen,unter 3 Jahre,113,52,61
False,8136043,Mögglingen,3 -  6 Jahre,131,64,67
False,8136043,Mögglingen,6 - 10 Jahre,176,77,99
False,8136043,Mögglingen,10 - 15 Jahre,240,122,118
False,8136043,Mögglingen,15 - 18 Jahre,172,94,78
False,8136043,Mögglingen,18 - 20 Jahre,100,47,53
False,8136043,Mögglingen,20 - 25 Jahre,244,128,116
False,8136043,Mögglingen,25 - 30 Jahre,244,118,126
False,8136043,Mögglingen,30 - 35 Jahre,243,115,128
False,8136043,Mögglingen,35 - 40 Jahre,272,138,134
False,8136043,Mögglingen,40 - 45 Jahre,328,186,142
False,8136043,Mögglingen,45 - 50 Jahre,346,165,181
False,8136043,Mögglingen,50 - 55 Jahre,345,184,161
False,8136043,Mögglingen,55 - 60 Jahre,234,108,126
False,8136043,Mögglingen,60 - 65 Jahre,240,121,119
False,8136043,Mögglingen,65 - 75 Jahre,427,209,218
False,8136043,Mögglingen,75 und mehr Jahre,310,121,189
False,8136043,Mögglingen,Insgesamt,4165,2049,2116
False,8136044,Mutlangen,unter 3 Jahre,171,84,87
False,8136044,Mutlangen,3 -  6 Jahre,222,118,104
False,8136044,Mutlangen,6 - 10 Jahre,294,151,143
False,8136044,Mutlangen,10 - 15 Jahre,466,256,210
False,8136044,Mutlangen,15 - 18 Jahre,252,133,119
False,8136044,Mutlangen,18 - 20 Jahre,171,90,81
False,8136044,Mutlangen,20 - 25 Jahre,368,180,188
False,8136044,Mutlangen,25 - 30 Jahre,308,149,159
False,8136044,Mutlangen,30 - 35 Jahre,353,162,191
False,8136044,Mutlangen,35 - 40 Jahre,428,227,201
False,8136044,Mutlangen,40 - 45 Jahre,556,254,302
False,8136044,Mutlangen,45 - 50 Jahre,560,254,306
False,8136044,Mutlangen,50 - 55 Jahre,505,270,235
False,8136044,Mutlangen,55 - 60 Jahre,429,217,212
False,8136044,Mutlangen,60 - 65 Jahre,325,157,168
False,8136044,Mutlangen,65 - 75 Jahre,622,281,341
False,8136044,Mutlangen,75 und mehr Jahre,531,208,323
False,8136044,Mutlangen,Insgesamt,6561,3191,3370
False,8136045,"Neresheim, Stadt",unter 3 Jahre,212,88,124
False,8136045,"Neresheim, Stadt",3 -  6 Jahre,201,100,101
False,8136045,"Neresheim, Stadt",6 - 10 Jahre,315,157,158
False,8136045,"Neresheim, Stadt",10 - 15 Jahre,500,255,245
False,8136045,"Neresheim, Stadt",15 - 18 Jahre,297,160,137
False,8136045,"Neresheim, Stadt",18 - 20 Jahre,229,108,121
False,8136045,"Neresheim, Stadt",20 - 25 Jahre,450,234,216
False,8136045,"Neresheim, Stadt",25 - 30 Jahre,431,224,207
False,8136045,"Neresheim, Stadt",30 - 35 Jahre,478,245,233
False,8136045,"Neresheim, Stadt",35 - 40 Jahre,548,282,266
False,8136045,"Neresheim, Stadt",40 - 45 Jahre,630,347,283
False,8136045,"Neresheim, Stadt",45 - 50 Jahre,687,361,326
False,8136045,"Neresheim, Stadt",50 - 55 Jahre,652,348,304
False,8136045,"Neresheim, Stadt",55 - 60 Jahre,556,280,276
False,8136045,"Neresheim, Stadt",60 - 65 Jahre,417,230,187
False,8136045,"Neresheim, Stadt",65 - 75 Jahre,724,367,357
False,8136045,"Neresheim, Stadt",75 und mehr Jahre,693,264,429
False,8136045,"Neresheim, Stadt",Insgesamt,8020,4050,3970
False,8136046,Neuler,unter 3 Jahre,104,59,45
False,8136046,Neuler,3 -  6 Jahre,114,49,65
False,8136046,Neuler,6 - 10 Jahre,133,70,63
False,8136046,Neuler,10 - 15 Jahre,182,90,92
False,8136046,Neuler,15 - 18 Jahre,114,52,62
False,8136046,Neuler,18 - 20 Jahre,104,58,46
False,8136046,Neuler,20 - 25 Jahre,214,116,98
False,8136046,Neuler,25 - 30 Jahre,188,106,82
False,8136046,Neuler,30 - 35 Jahre,192,100,92
False,8136046,Neuler,35 - 40 Jahre,228,111,117
False,8136046,Neuler,40 - 45 Jahre,241,118,123
False,8136046,Neuler,45 - 50 Jahre,296,152,144
False,8136046,Neuler,50 - 55 Jahre,239,126,113
False,8136046,Neuler,55 - 60 Jahre,188,94,94
False,8136046,Neuler,60 - 65 Jahre,171,93,78
False,8136046,Neuler,65 - 75 Jahre,269,135,134
False,8136046,Neuler,75 und mehr Jahre,187,76,111
False,8136046,Neuler,Insgesamt,3164,1605,1559
False,8136049,Obergröningen,unter 3 Jahre,18,10,8
False,8136049,Obergröningen,3 -  6 Jahre,13,8,5
False,8136049,Obergröningen,6 - 10 Jahre,24,16,8
False,8136049,Obergröningen,10 - 15 Jahre,34,15,19
False,8136049,Obergröningen,15 - 18 Jahre,18,10,8
False,8136049,Obergröningen,18 - 20 Jahre,7,6,1
False,8136049,Obergröningen,20 - 25 Jahre,21,12,9
False,8136049,Obergröningen,25 - 30 Jahre,12,4,8
False,8136049,Obergröningen,30 - 35 Jahre,22,8,14
False,8136049,Obergröningen,35 - 40 Jahre,34,18,16
False,8136049,Obergröningen,40 - 45 Jahre,48,27,21
False,8136049,Obergröningen,45 - 50 Jahre,37,24,13
False,8136049,Obergröningen,50 - 55 Jahre,37,19,18
False,8136049,Obergröningen,55 - 60 Jahre,22,11,11
False,8136049,Obergröningen,60 - 65 Jahre,42,22,20
False,8136049,Obergröningen,65 - 75 Jahre,44,23,21
False,8136049,Obergröningen,75 und mehr Jahre,31,13,18
False,8136049,Obergröningen,Insgesamt,464,246,218
False,8136050,"Oberkochen, Stadt",unter 3 Jahre,194,103,91
False,8136050,"Oberkochen, Stadt",3 -  6 Jahre,189,96,93
False,8136050,"Oberkochen, Stadt",6 - 10 Jahre,273,122,151
False,8136050,"Oberkochen, Stadt",10 - 15 Jahre,407,199,208
False,8136050,"Oberkochen, Stadt",15 - 18 Jahre,259,138,121
False,8136050,"Oberkochen, Stadt",18 - 20 Jahre,161,85,76
False,8136050,"Oberkochen, Stadt",20 - 25 Jahre,425,224,201
False,8136050,"Oberkochen, Stadt",25 - 30 Jahre,419,234,185
False,8136050,"Oberkochen, Stadt",30 - 35 Jahre,386,189,197
False,8136050,"Oberkochen, Stadt",35 - 40 Jahre,404,217,187
False,8136050,"Oberkochen, Stadt",40 - 45 Jahre,572,301,271
False,8136050,"Oberkochen, Stadt",45 - 50 Jahre,655,330,325
False,8136050,"Oberkochen, Stadt",50 - 55 Jahre,595,319,276
False,8136050,"Oberkochen, Stadt",55 - 60 Jahre,496,251,245
False,8136050,"Oberkochen, Stadt",60 - 65 Jahre,410,188,222
False,8136050,"Oberkochen, Stadt",65 - 75 Jahre,983,445,538
False,8136050,"Oberkochen, Stadt",75 und mehr Jahre,971,383,588
False,8136050,"Oberkochen, Stadt",Insgesamt,7799,3824,3975
False,8136060,Rosenberg,unter 3 Jahre,75,39,36
False,8136060,Rosenberg,3 -  6 Jahre,81,42,39
False,8136060,Rosenberg,6 - 10 Jahre,119,72,47
False,8136060,Rosenberg,10 - 15 Jahre,171,86,85
False,8136060,Rosenberg,15 - 18 Jahre,122,65,57
False,8136060,Rosenberg,18 - 20 Jahre,86,45,41
False,8136060,Rosenberg,20 - 25 Jahre,152,89,63
False,8136060,Rosenberg,25 - 30 Jahre,148,78,70
False,8136060,Rosenberg,30 - 35 Jahre,143,71,72
False,8136060,Rosenberg,35 - 40 Jahre,126,74,52
False,8136060,Rosenberg,40 - 45 Jahre,192,94,98
False,8136060,Rosenberg,45 - 50 Jahre,253,137,116
False,8136060,Rosenberg,50 - 55 Jahre,209,109,100
False,8136060,Rosenberg,55 - 60 Jahre,179,93,86
False,8136060,Rosenberg,60 - 65 Jahre,116,65,51
False,8136060,Rosenberg,65 - 75 Jahre,206,110,96
False,8136060,Rosenberg,75 und mehr Jahre,215,85,130
False,8136060,Rosenberg,Insgesamt,2593,1354,1239
False,8136061,Ruppertshofen,unter 3 Jahre,48,28,20
False,8136061,Ruppertshofen,3 -  6 Jahre,55,35,20
False,8136061,Ruppertshofen,6 - 10 Jahre,85,39,46
False,8136061,Ruppertshofen,10 - 15 Jahre,117,59,58
False,8136061,Ruppertshofen,15 - 18 Jahre,96,58,38
False,8136061,Ruppertshofen,18 - 20 Jahre,68,43,25
False,8136061,Ruppertshofen,20 - 25 Jahre,116,56,60
False,8136061,Ruppertshofen,25 - 30 Jahre,100,48,52
False,8136061,Ruppertshofen,30 - 35 Jahre,96,48,48
False,8136061,Ruppertshofen,35 - 40 Jahre,102,53,49
False,8136061,Ruppertshofen,40 - 45 Jahre,165,71,94
False,8136061,Ruppertshofen,45 - 50 Jahre,170,86,84
False,8136061,Ruppertshofen,50 - 55 Jahre,159,86,73
False,8136061,Ruppertshofen,55 - 60 Jahre,128,71,57
False,8136061,Ruppertshofen,60 - 65 Jahre,73,42,31
False,8136061,Ruppertshofen,65 - 75 Jahre,135,63,72
False,8136061,Ruppertshofen,75 und mehr Jahre,120,49,71
False,8136061,Ruppertshofen,Insgesamt,1833,935,898
False,8136062,Schechingen,unter 3 Jahre,67,38,29
False,8136062,Schechingen,3 -  6 Jahre,45,23,22
False,8136062,Schechingen,6 - 10 Jahre,95,47,48
False,8136062,Schechingen,10 - 15 Jahre,161,76,85
False,8136062,Schechingen,15 - 18 Jahre,102,52,50
False,8136062,Schechingen,18 - 20 Jahre,86,41,45
False,8136062,Schechingen,20 - 25 Jahre,150,80,70
False,8136062,Schechingen,25 - 30 Jahre,133,71,62
False,8136062,Schechingen,30 - 35 Jahre,131,55,76
False,8136062,Schechingen,35 - 40 Jahre,143,77,66
False,8136062,Schechingen,40 - 45 Jahre,190,86,104
False,8136062,Schechingen,45 - 50 Jahre,235,113,122
False,8136062,Schechingen,50 - 55 Jahre,201,101,100
False,8136062,Schechingen,55 - 60 Jahre,154,77,77
False,8136062,Schechingen,60 - 65 Jahre,124,69,55
False,8136062,Schechingen,65 - 75 Jahre,178,81,97
False,8136062,Schechingen,75 und mehr Jahre,175,51,124
False,8136062,Schechingen,Insgesamt,2370,1138,1232
False,8136065,"Schwäbisch Gmünd, Stadt",unter 3 Jahre,1484,785,699
False,8136065,"Schwäbisch Gmünd, Stadt",3 -  6 Jahre,1614,802,812
False,8136065,"Schwäbisch Gmünd, Stadt",6 - 10 Jahre,2189,1132,1057
False,8136065,"Schwäbisch Gmünd, Stadt",10 - 15 Jahre,3056,1564,1492
False,8136065,"Schwäbisch Gmünd, Stadt",15 - 18 Jahre,2021,1033,988
False,8136065,"Schwäbisch Gmünd, Stadt",18 - 20 Jahre,1388,682,706
False,8136065,"Schwäbisch Gmünd, Stadt",20 - 25 Jahre,3943,1937,2006
False,8136065,"Schwäbisch Gmünd, Stadt",25 - 30 Jahre,3645,1846,1799
False,8136065,"Schwäbisch Gmünd, Stadt",30 - 35 Jahre,3392,1716,1676
False,8136065,"Schwäbisch Gmünd, Stadt",35 - 40 Jahre,3714,1916,1798
False,8136065,"Schwäbisch Gmünd, Stadt",40 - 45 Jahre,4441,2287,2154
False,8136065,"Schwäbisch Gmünd, Stadt",45 - 50 Jahre,4596,2340,2256
False,8136065,"Schwäbisch Gmünd, Stadt",50 - 55 Jahre,4395,2161,2234
False,8136065,"Schwäbisch Gmünd, Stadt",55 - 60 Jahre,3758,1783,1975
False,8136065,"Schwäbisch Gmünd, Stadt",60 - 65 Jahre,3441,1676,1765
False,8136065,"Schwäbisch Gmünd, Stadt",65 - 75 Jahre,6678,3121,3557
False,8136065,"Schwäbisch Gmünd, Stadt",75 und mehr Jahre,5899,2151,3748
False,8136065,"Schwäbisch Gmünd, Stadt",Insgesamt,59654,28932,30722
False,8136066,Spraitbach,unter 3 Jahre,72,36,36
False,8136066,Spraitbach,3 -  6 Jahre,79,46,33
False,8136066,Spraitbach,6 - 10 Jahre,114,53,61
False,8136066,Spraitbach,10 - 15 Jahre,207,90,117
False,8136066,Spraitbach,15 - 18 Jahre,114,61,53
False,8136066,Spraitbach,18 - 20 Jahre,91,47,44
False,8136066,Spraitbach,20 - 25 Jahre,205,104,101
False,8136066,Spraitbach,25 - 30 Jahre,153,82,71
False,8136066,Spraitbach,30 - 35 Jahre,145,67,78
False,8136066,Spraitbach,35 - 40 Jahre,209,110,99
False,8136066,Spraitbach,40 - 45 Jahre,281,138,143
False,8136066,Spraitbach,45 - 50 Jahre,300,168,132
False,8136066,Spraitbach,50 - 55 Jahre,289,134,155
False,8136066,Spraitbach,55 - 60 Jahre,214,105,109
False,8136066,Spraitbach,60 - 65 Jahre,223,107,116
False,8136066,Spraitbach,65 - 75 Jahre,380,190,190
False,8136066,Spraitbach,75 und mehr Jahre,292,112,180
False,8136066,Spraitbach,Insgesamt,3368,1650,1718
False,8136068,Stödtlen,unter 3 Jahre,60,29,31
False,8136068,Stödtlen,3 -  6 Jahre,48,23,25
False,8136068,Stödtlen,6 - 10 Jahre,92,48,44
False,8136068,Stödtlen,10 - 15 Jahre,128,50,78
False,8136068,Stödtlen,15 - 18 Jahre,79,50,29
False,8136068,Stödtlen,18 - 20 Jahre,50,24,26
False,8136068,Stödtlen,20 - 25 Jahre,100,48,52
False,8136068,Stödtlen,25 - 30 Jahre,90,42,48
False,8136068,Stödtlen,30 - 35 Jahre,128,67,61
False,8136068,Stödtlen,35 - 40 Jahre,126,60,66
False,8136068,Stödtlen,40 - 45 Jahre,187,94,93
False,8136068,Stödtlen,45 - 50 Jahre,181,95,86
False,8136068,Stödtlen,50 - 55 Jahre,132,78,54
False,8136068,Stödtlen,55 - 60 Jahre,120,55,65
False,8136068,Stödtlen,60 - 65 Jahre,114,61,53
False,8136068,Stödtlen,65 - 75 Jahre,154,84,70
False,8136068,Stödtlen,75 und mehr Jahre,192,71,121
False,8136068,Stödtlen,Insgesamt,1981,979,1002
False,8136070,Täferrot,unter 3 Jahre,34,23,11
False,8136070,Täferrot,3 -  6 Jahre,37,21,16
False,8136070,Täferrot,6 - 10 Jahre,57,28,29
False,8136070,Täferrot,10 - 15 Jahre,65,28,37
False,8136070,Täferrot,15 - 18 Jahre,46,27,19
False,8136070,Täferrot,18 - 20 Jahre,23,7,16
False,8136070,Täferrot,20 - 25 Jahre,50,26,24
False,8136070,Täferrot,25 - 30 Jahre,48,26,22
False,8136070,Täferrot,30 - 35 Jahre,49,27,22
False,8136070,Täferrot,35 - 40 Jahre,86,38,48
False,8136070,Täferrot,40 - 45 Jahre,96,59,37
False,8136070,Täferrot,45 - 50 Jahre,98,47,51
False,8136070,Täferrot,50 - 55 Jahre,64,30,34
False,8136070,Täferrot,55 - 60 Jahre,51,24,27
False,8136070,Täferrot,60 - 65 Jahre,55,29,26
False,8136070,Täferrot,65 - 75 Jahre,107,58,49
False,8136070,Täferrot,75 und mehr Jahre,81,35,46
False,8136070,Täferrot,Insgesamt,1047,533,514
False,8136071,Tannhausen,unter 3 Jahre,44,18,26
False,8136071,Tannhausen,3 -  6 Jahre,48,24,24
False,8136071,Tannhausen,6 - 10 Jahre,85,42,43
False,8136071,Tannhausen,10 - 15 Jahre,136,76,60
False,8136071,Tannhausen,15 - 18 Jahre,61,28,33
False,8136071,Tannhausen,18 - 20 Jahre,59,30,29
False,8136071,Tannhausen,20 - 25 Jahre,118,61,57
False,8136071,Tannhausen,25 - 30 Jahre,114,69,45
False,8136071,Tannhausen,30 - 35 Jahre,94,51,43
False,8136071,Tannhausen,35 - 40 Jahre,104,51,53
False,8136071,Tannhausen,40 - 45 Jahre,133,63,70
False,8136071,Tannhausen,45 - 50 Jahre,164,93,71
False,8136071,Tannhausen,50 - 55 Jahre,110,56,54
False,8136071,Tannhausen,55 - 60 Jahre,106,50,56
False,8136071,Tannhausen,60 - 65 Jahre,90,50,40
False,8136071,Tannhausen,65 - 75 Jahre,174,87,87
False,8136071,Tannhausen,75 und mehr Jahre,195,63,132
False,8136071,Tannhausen,Insgesamt,1835,912,923
False,8136075,Unterschneidheim,unter 3 Jahre,152,90,62
False,8136075,Unterschneidheim,3 -  6 Jahre,156,90,66
False,8136075,Unterschneidheim,6 - 10 Jahre,221,104,117
False,8136075,Unterschneidheim,10 - 15 Jahre,276,140,136
False,8136075,Unterschneidheim,15 - 18 Jahre,160,94,66
False,8136075,Unterschneidheim,18 - 20 Jahre,131,76,55
False,8136075,Unterschneidheim,20 - 25 Jahre,310,174,136
False,8136075,Unterschneidheim,25 - 30 Jahre,248,129,119
False,8136075,Unterschneidheim,30 - 35 Jahre,278,139,139
False,8136075,Unterschneidheim,35 - 40 Jahre,335,171,164
False,8136075,Unterschneidheim,40 - 45 Jahre,341,193,148
False,8136075,Unterschneidheim,45 - 50 Jahre,371,181,190
False,8136075,Unterschneidheim,50 - 55 Jahre,344,186,158
False,8136075,Unterschneidheim,55 - 60 Jahre,315,170,145
False,8136075,Unterschneidheim,60 - 65 Jahre,229,116,113
False,8136075,Unterschneidheim,65 - 75 Jahre,409,204,205
False,8136075,Unterschneidheim,75 und mehr Jahre,324,133,191
False,8136075,Unterschneidheim,Insgesamt,4600,2390,2210
False,8136079,Waldstetten,unter 3 Jahre,176,89,87
False,8136079,Waldstetten,3 -  6 Jahre,197,99,98
False,8136079,Waldstetten,6 - 10 Jahre,276,146,130
False,8136079,Waldstetten,10 - 15 Jahre,451,224,227
False,8136079,Waldstetten,15 - 18 Jahre,289,140,149
False,8136079,Waldstetten,18 - 20 Jahre,174,98,76
False,8136079,Waldstetten,20 - 25 Jahre,360,194,166
False,8136079,Waldstetten,25 - 30 Jahre,379,203,176
False,8136079,Waldstetten,30 - 35 Jahre,324,155,169
False,8136079,Waldstetten,35 - 40 Jahre,437,215,222
False,8136079,Waldstetten,40 - 45 Jahre,627,324,303
False,8136079,Waldstetten,45 - 50 Jahre,611,323,288
False,8136079,Waldstetten,50 - 55 Jahre,515,235,280
False,8136079,Waldstetten,55 - 60 Jahre,468,248,220
False,8136079,Waldstetten,60 - 65 Jahre,430,204,226
False,8136079,Waldstetten,65 - 75 Jahre,826,380,446
False,8136079,Waldstetten,75 und mehr Jahre,600,253,347
False,8136079,Waldstetten,Insgesamt,7140,3530,3610
False,8136082,Westhausen,unter 3 Jahre,158,82,76
False,8136082,Westhausen,3 -  6 Jahre,153,73,80
False,8136082,Westhausen,6 - 10 Jahre,264,151,113
False,8136082,Westhausen,10 - 15 Jahre,369,174,195
False,8136082,Westhausen,15 - 18 Jahre,239,130,109
False,8136082,Westhausen,18 - 20 Jahre,125,62,63
False,8136082,Westhausen,20 - 25 Jahre,329,171,158
False,8136082,Westhausen,25 - 30 Jahre,317,165,152
False,8136082,Westhausen,30 - 35 Jahre,372,188,184
False,8136082,Westhausen,35 - 40 Jahre,391,188,203
False,8136082,Westhausen,40 - 45 Jahre,523,262,261
False,8136082,Westhausen,45 - 50 Jahre,479,243,236
False,8136082,Westhausen,50 - 55 Jahre,398,205,193
False,8136082,Westhausen,55 - 60 Jahre,368,187,181
False,8136082,Westhausen,60 - 65 Jahre,306,136,170
False,8136082,Westhausen,65 - 75 Jahre,635,323,312
False,8136082,Westhausen,75 und mehr Jahre,436,165,271
False,8136082,Westhausen,Insgesamt,5862,2905,2957
False,8136084,Wört,unter 3 Jahre,36,16,20
False,8136084,Wört,3 -  6 Jahre,35,18,17
False,8136084,Wört,6 - 10 Jahre,58,37,21
False,8136084,Wört,10 - 15 Jahre,82,39,43
False,8136084,Wört,15 - 18 Jahre,54,28,26
False,8136084,Wört,18 - 20 Jahre,36,17,19
False,8136084,Wört,20 - 25 Jahre,88,51,37
False,8136084,Wört,25 - 30 Jahre,88,34,54
False,8136084,Wört,30 - 35 Jahre,69,32,37
False,8136084,Wört,35 - 40 Jahre,122,64,58
False,8136084,Wört,40 - 45 Jahre,96,45,51
False,8136084,Wört,45 - 50 Jahre,124,65,59
False,8136084,Wört,50 - 55 Jahre,132,79,53
False,8136084,Wört,55 - 60 Jahre,81,41,40
False,8136084,Wört,60 - 65 Jahre,74,38,36
False,8136084,Wört,65 - 75 Jahre,115,48,67
False,8136084,Wört,75 und mehr Jahre,96,44,52
False,8136084,Wört,Insgesamt,1386,696,690
False,8136087,Riesbürg,unter 3 Jahre,51,28,23
False,8136087,Riesbürg,3 -  6 Jahre,62,31,31
False,8136087,Riesbürg,6 - 10 Jahre,93,35,58
False,8136087,Riesbürg,10 - 15 Jahre,135,72,63
False,8136087,Riesbürg,15 - 18 Jahre,73,38,35
False,8136087,Riesbürg,18 - 20 Jahre,63,29,34
False,8136087,Riesbürg,20 - 25 Jahre,126,69,57
False,8136087,Riesbürg,25 - 30 Jahre,144,73,71
False,8136087,Riesbürg,30 - 35 Jahre,106,50,56
False,8136087,Riesbürg,35 - 40 Jahre,110,53,57
False,8136087,Riesbürg,40 - 45 Jahre,158,83,75
False,8136087,Riesbürg,45 - 50 Jahre,189,104,85
False,8136087,Riesbürg,50 - 55 Jahre,187,91,96
False,8136087,Riesbürg,55 - 60 Jahre,157,88,69
False,8136087,Riesbürg,60 - 65 Jahre,131,70,61
False,8136087,Riesbürg,65 - 75 Jahre,209,97,112
False,8136087,Riesbürg,75 und mehr Jahre,214,88,126
False,8136087,Riesbürg,Insgesamt,2208,1099,1109
False,8136088,"Aalen, Stadt",unter 3 Jahre,1691,839,852
False,8136088,"Aalen, Stadt",3 -  6 Jahre,1732,891,841
False,8136088,"Aalen, Stadt",6 - 10 Jahre,2565,1343,1222
False,8136088,"Aalen, Stadt",10 - 15 Jahre,3746,1939,1807
False,8136088,"Aalen, Stadt",15 - 18 Jahre,2324,1196,1128
False,8136088,"Aalen, Stadt",18 - 20 Jahre,1561,805,756
False,8136088,"Aalen, Stadt",20 - 25 Jahre,3864,2038,1826
False,8136088,"Aalen, Stadt",25 - 30 Jahre,3736,1923,1813
False,8136088,"Aalen, Stadt",30 - 35 Jahre,3883,1990,1893
False,8136088,"Aalen, Stadt",35 - 40 Jahre,4194,2109,2085
False,8136088,"Aalen, Stadt",40 - 45 Jahre,5458,2730,2728
False,8136088,"Aalen, Stadt",45 - 50 Jahre,5481,2884,2597
False,8136088,"Aalen, Stadt",50 - 55 Jahre,4677,2338,2339
False,8136088,"Aalen, Stadt",55 - 60 Jahre,4106,2012,2094
False,8136088,"Aalen, Stadt",60 - 65 Jahre,3538,1737,1801
False,8136088,"Aalen, Stadt",65 - 75 Jahre,7180,3417,3763
False,8136088,"Aalen, Stadt",75 und mehr Jahre,6377,2441,3936
False,8136088,"Aalen, Stadt",Insgesamt,66113,32632,33481
False,8136089,Rainau,unter 3 Jahre,81,48,33
False,8136089,Rainau,3 -  6 Jahre,98,51,47
False,8136089,Rainau,6 - 10 Jahre,158,81,77
False,8136089,Rainau,10 - 15 Jahre,205,116,89
False,8136089,Rainau,15 - 18 Jahre,153,73,80
False,8136089,Rainau,18 - 20 Jahre,93,45,48
False,8136089,Rainau,20 - 25 Jahre,213,101,112
False,8136089,Rainau,25 - 30 Jahre,188,97,91
False,8136089,Rainau,30 - 35 Jahre,185,113,72
False,8136089,Rainau,35 - 40 Jahre,225,124,101
False,8136089,Rainau,40 - 45 Jahre,268,131,137
False,8136089,Rainau,45 - 50 Jahre,338,163,175
False,8136089,Rainau,50 - 55 Jahre,244,123,121
False,8136089,Rainau,55 - 60 Jahre,239,117,122
False,8136089,Rainau,60 - 65 Jahre,165,82,83
False,8136089,Rainau,65 - 75 Jahre,251,116,135
False,8136089,Rainau,75 und mehr Jahre,196,88,108
False,8136089,Rainau,Insgesamt,3300,1669,1631
False,82,Regierungsbezirk Karlsruhe,unter 3 Jahre,67568,34722,32846
False,82,Regierungsbezirk Karlsruhe,3 -  6 Jahre,68835,35374,33461
False,82,Regierungsbezirk Karlsruhe,6 - 10 Jahre,96951,49897,47054
False,82,Regierungsbezirk Karlsruhe,10 - 15 Jahre,136796,70042,66754
False,82,Regierungsbezirk Karlsruhe,15 - 18 Jahre,85077,43867,41210
False,82,Regierungsbezirk Karlsruhe,18 - 20 Jahre,61963,31834,30129
False,82,Regierungsbezirk Karlsruhe,20 - 25 Jahre,171806,88110,83696
False,82,Regierungsbezirk Karlsruhe,25 - 30 Jahre,171850,86538,85312
False,82,Regierungsbezirk Karlsruhe,30 - 35 Jahre,164518,82681,81837
False,82,Regierungsbezirk Karlsruhe,35 - 40 Jahre,169675,84721,84954
False,82,Regierungsbezirk Karlsruhe,40 - 45 Jahre,226029,114964,111065
False,82,Regierungsbezirk Karlsruhe,45 - 50 Jahre,242443,123788,118655
False,82,Regierungsbezirk Karlsruhe,50 - 55 Jahre,209275,106324,102951
False,82,Regierungsbezirk Karlsruhe,55 - 60 Jahre,177089,87788,89301
False,82,Regierungsbezirk Karlsruhe,60 - 65 Jahre,154358,75804,78554
False,82,Regierungsbezirk Karlsruhe,65 - 75 Jahre,292323,139064,153259
False,82,Regierungsbezirk Karlsruhe,75 und mehr Jahre,247670,94213,153457
False,82,Regierungsbezirk Karlsruhe,Insgesamt,2744226,1349731,1394495
False,8211,Stadtkreis Baden-Baden,unter 3 Jahre,1093,565,528
False,8211,Stadtkreis Baden-Baden,3 -  6 Jahre,1147,591,556
False,8211,Stadtkreis Baden-Baden,6 - 10 Jahre,1664,826,838
False,8211,Stadtkreis Baden-Baden,10 - 15 Jahre,2347,1188,1159
False,8211,Stadtkreis Baden-Baden,15 - 18 Jahre,1433,752,681
False,8211,Stadtkreis Baden-Baden,18 - 20 Jahre,1053,541,512
False,8211,Stadtkreis Baden-Baden,20 - 25 Jahre,2544,1328,1216
False,8211,Stadtkreis Baden-Baden,25 - 30 Jahre,2673,1316,1357
False,8211,Stadtkreis Baden-Baden,30 - 35 Jahre,2786,1337,1449
False,8211,Stadtkreis Baden-Baden,35 - 40 Jahre,2870,1344,1526
False,8211,Stadtkreis Baden-Baden,40 - 45 Jahre,4412,2106,2306
False,8211,Stadtkreis Baden-Baden,45 - 50 Jahre,4522,2222,2300
False,8211,Stadtkreis Baden-Baden,50 - 55 Jahre,4092,1952,2140
False,8211,Stadtkreis Baden-Baden,55 - 60 Jahre,3648,1736,1912
False,8211,Stadtkreis Baden-Baden,60 - 65 Jahre,3644,1694,1950
False,8211,Stadtkreis Baden-Baden,65 - 75 Jahre,7411,3319,4092
False,8211,Stadtkreis Baden-Baden,75 und mehr Jahre,7106,2583,4523
False,8211,Stadtkreis Baden-Baden,Insgesamt,54445,25400,29045
False,8211000,"Baden-Baden, Stadt",unter 3 Jahre,1093,565,528
False,8211000,"Baden-Baden, Stadt",3 -  6 Jahre,1147,591,556
False,8211000,"Baden-Baden, Stadt",6 - 10 Jahre,1664,826,838
False,8211000,"Baden-Baden, Stadt",10 - 15 Jahre,2347,1188,1159
False,8211000,"Baden-Baden, Stadt",15 - 18 Jahre,1433,752,681
False,8211000,"Baden-Baden, Stadt",18 - 20 Jahre,1053,541,512
False,8211000,"Baden-Baden, Stadt",20 - 25 Jahre,2544,1328,1216
False,8211000,"Baden-Baden, Stadt",25 - 30 Jahre,2673,1316,1357
False,8211000,"Baden-Baden, Stadt",30 - 35 Jahre,2786,1337,1449
False,8211000,"Baden-Baden, Stadt",35 - 40 Jahre,2870,1344,1526
False,8211000,"Baden-Baden, Stadt",40 - 45 Jahre,4412,2106,2306
False,8211000,"Baden-Baden, Stadt",45 - 50 Jahre,4522,2222,2300
False,8211000,"Baden-Baden, Stadt",50 - 55 Jahre,4092,1952,2140
False,8211000,"Baden-Baden, Stadt",55 - 60 Jahre,3648,1736,1912
False,8211000,"Baden-Baden, Stadt",60 - 65 Jahre,3644,1694,1950
False,8211000,"Baden-Baden, Stadt",65 - 75 Jahre,7411,3319,4092
False,8211000,"Baden-Baden, Stadt",75 und mehr Jahre,7106,2583,4523
False,8211000,"Baden-Baden, Stadt",Insgesamt,54445,25400,29045
False,8212,Stadtkreis Karlsruhe,unter 3 Jahre,7523,3865,3658
False,8212,Stadtkreis Karlsruhe,3 -  6 Jahre,6992,3502,3490
False,8212,Stadtkreis Karlsruhe,6 - 10 Jahre,9086,4725,4361
False,8212,Stadtkreis Karlsruhe,10 - 15 Jahre,11756,5942,5814
False,8212,Stadtkreis Karlsruhe,15 - 18 Jahre,7152,3739,3413
False,8212,Stadtkreis Karlsruhe,18 - 20 Jahre,5987,3115,2872
False,8212,Stadtkreis Karlsruhe,20 - 25 Jahre,23234,12810,10424
False,8212,Stadtkreis Karlsruhe,25 - 30 Jahre,24008,12724,11284
False,8212,Stadtkreis Karlsruhe,30 - 35 Jahre,21291,11237,10054
False,8212,Stadtkreis Karlsruhe,35 - 40 Jahre,19853,10431,9422
False,8212,Stadtkreis Karlsruhe,40 - 45 Jahre,23906,12532,11374
False,8212,Stadtkreis Karlsruhe,45 - 50 Jahre,23896,12392,11504
False,8212,Stadtkreis Karlsruhe,50 - 55 Jahre,20791,10830,9961
False,8212,Stadtkreis Karlsruhe,55 - 60 Jahre,17328,8548,8780
False,8212,Stadtkreis Karlsruhe,60 - 65 Jahre,15322,7387,7935
False,8212,Stadtkreis Karlsruhe,65 - 75 Jahre,29896,13862,16034
False,8212,Stadtkreis Karlsruhe,75 und mehr Jahre,26740,9751,16989
False,8212,Stadtkreis Karlsruhe,Insgesamt,294761,147392,147369
False,8212000,"Karlsruhe, Stadt",unter 3 Jahre,7523,3865,3658
False,8212000,"Karlsruhe, Stadt",3 -  6 Jahre,6992,3502,3490
False,8212000,"Karlsruhe, Stadt",6 - 10 Jahre,9086,4725,4361
False,8212000,"Karlsruhe, Stadt",10 - 15 Jahre,11756,5942,5814
False,8212000,"Karlsruhe, Stadt",15 - 18 Jahre,7152,3739,3413
False,8212000,"Karlsruhe, Stadt",18 - 20 Jahre,5987,3115,2872
False,8212000,"Karlsruhe, Stadt",20 - 25 Jahre,23234,12810,10424
False,8212000,"Karlsruhe, Stadt",25 - 30 Jahre,24008,12724,11284
False,8212000,"Karlsruhe, Stadt",30 - 35 Jahre,21291,11237,10054
False,8212000,"Karlsruhe, Stadt",35 - 40 Jahre,19853,10431,9422
False,8212000,"Karlsruhe, Stadt",40 - 45 Jahre,23906,12532,11374
False,8212000,"Karlsruhe, Stadt",45 - 50 Jahre,23896,12392,11504
False,8212000,"Karlsruhe, Stadt",50 - 55 Jahre,20791,10830,9961
False,8212000,"Karlsruhe, Stadt",55 - 60 Jahre,17328,8548,8780
False,8212000,"Karlsruhe, Stadt",60 - 65 Jahre,15322,7387,7935
False,8212000,"Karlsruhe, Stadt",65 - 75 Jahre,29896,13862,16034
False,8212000,"Karlsruhe, Stadt",75 und mehr Jahre,26740,9751,16989
False,8212000,"Karlsruhe, Stadt",Insgesamt,294761,147392,147369
False,8215,Landkreis Karlsruhe,unter 3 Jahre,10573,5490,5083
False,8215,Landkreis Karlsruhe,3 -  6 Jahre,11194,5770,5424
False,8215,Landkreis Karlsruhe,6 - 10 Jahre,15852,8252,7600
False,8215,Landkreis Karlsruhe,10 - 15 Jahre,23365,12113,11252
False,8215,Landkreis Karlsruhe,15 - 18 Jahre,14485,7479,7006
False,8215,Landkreis Karlsruhe,18 - 20 Jahre,10008,5152,4856
False,8215,Landkreis Karlsruhe,20 - 25 Jahre,24239,12601,11638
False,8215,Landkreis Karlsruhe,25 - 30 Jahre,23671,12100,11571
False,8215,Landkreis Karlsruhe,30 - 35 Jahre,24086,11846,12240
False,8215,Landkreis Karlsruhe,35 - 40 Jahre,26389,13076,13313
False,8215,Landkreis Karlsruhe,40 - 45 Jahre,35842,17980,17862
False,8215,Landkreis Karlsruhe,45 - 50 Jahre,38953,19833,19120
False,8215,Landkreis Karlsruhe,50 - 55 Jahre,34033,17203,16830
False,8215,Landkreis Karlsruhe,55 - 60 Jahre,29327,14547,14780
False,8215,Landkreis Karlsruhe,60 - 65 Jahre,25257,12519,12738
False,8215,Landkreis Karlsruhe,65 - 75 Jahre,46657,22342,24315
False,8215,Landkreis Karlsruhe,75 und mehr Jahre,38340,14881,23459
False,8215,Landkreis Karlsruhe,Insgesamt,432271,213184,219087
False,8215007,"Bretten, Stadt",unter 3 Jahre,710,391,319
False,8215007,"Bretten, Stadt",3 -  6 Jahre,788,420,368
False,8215007,"Bretten, Stadt",6 - 10 Jahre,1148,602,546
False,8215007,"Bretten, Stadt",10 - 15 Jahre,1631,870,761
False,8215007,"Bretten, Stadt",15 - 18 Jahre,1018,521,497
False,8215007,"Bretten, Stadt",18 - 20 Jahre,629,329,300
False,8215007,"Bretten, Stadt",20 - 25 Jahre,1666,864,802
False,8215007,"Bretten, Stadt",25 - 30 Jahre,1580,831,749
False,8215007,"Bretten, Stadt",30 - 35 Jahre,1680,792,888
False,8215007,"Bretten, Stadt",35 - 40 Jahre,1891,906,985
False,8215007,"Bretten, Stadt",40 - 45 Jahre,2336,1182,1154
False,8215007,"Bretten, Stadt",45 - 50 Jahre,2364,1207,1157
False,8215007,"Bretten, Stadt",50 - 55 Jahre,2070,1014,1056
False,8215007,"Bretten, Stadt",55 - 60 Jahre,2038,1023,1015
False,8215007,"Bretten, Stadt",60 - 65 Jahre,1611,803,808
False,8215007,"Bretten, Stadt",65 - 75 Jahre,2912,1393,1519
False,8215007,"Bretten, Stadt",75 und mehr Jahre,2394,959,1435
False,8215007,"Bretten, Stadt",Insgesamt,28466,14107,14359
False,8215009,"Bruchsal, Stadt",unter 3 Jahre,1074,577,497
False,8215009,"Bruchsal, Stadt",3 -  6 Jahre,1175,582,593
False,8215009,"Bruchsal, Stadt",6 - 10 Jahre,1604,844,760
False,8215009,"Bruchsal, Stadt",10 - 15 Jahre,2212,1152,1060
False,8215009,"Bruchsal, Stadt",15 - 18 Jahre,1294,668,626
False,8215009,"Bruchsal, Stadt",18 - 20 Jahre,938,463,475
False,8215009,"Bruchsal, Stadt",20 - 25 Jahre,2570,1319,1251
False,8215009,"Bruchsal, Stadt",25 - 30 Jahre,2657,1372,1285
False,8215009,"Bruchsal, Stadt",30 - 35 Jahre,2826,1455,1371
False,8215009,"Bruchsal, Stadt",35 - 40 Jahre,2810,1456,1354
False,8215009,"Bruchsal, Stadt",40 - 45 Jahre,3543,1782,1761
False,8215009,"Bruchsal, Stadt",45 - 50 Jahre,3657,1945,1712
False,8215009,"Bruchsal, Stadt",50 - 55 Jahre,3313,1763,1550
False,8215009,"Bruchsal, Stadt",55 - 60 Jahre,2882,1451,1431
False,8215009,"Bruchsal, Stadt",60 - 65 Jahre,2464,1252,1212
False,8215009,"Bruchsal, Stadt",65 - 75 Jahre,4449,2093,2356
False,8215009,"Bruchsal, Stadt",75 und mehr Jahre,3756,1367,2389
False,8215009,"Bruchsal, Stadt",Insgesamt,43224,21541,21683
False,8215017,"Ettlingen, Stadt",unter 3 Jahre,857,426,431
False,8215017,"Ettlingen, Stadt",3 -  6 Jahre,879,480,399
False,8215017,"Ettlingen, Stadt",6 - 10 Jahre,1202,629,573
False,8215017,"Ettlingen, Stadt",10 - 15 Jahre,1876,976,900
False,8215017,"Ettlingen, Stadt",15 - 18 Jahre,1198,631,567
False,8215017,"Ettlingen, Stadt",18 - 20 Jahre,834,426,408
False,8215017,"Ettlingen, Stadt",20 - 25 Jahre,1901,952,949
False,8215017,"Ettlingen, Stadt",25 - 30 Jahre,1820,920,900
False,8215017,"Ettlingen, Stadt",30 - 35 Jahre,1941,975,966
False,8215017,"Ettlingen, Stadt",35 - 40 Jahre,2211,1074,1137
False,8215017,"Ettlingen, Stadt",40 - 45 Jahre,2966,1485,1481
False,8215017,"Ettlingen, Stadt",45 - 50 Jahre,3487,1730,1757
False,8215017,"Ettlingen, Stadt",50 - 55 Jahre,2922,1440,1482
False,8215017,"Ettlingen, Stadt",55 - 60 Jahre,2616,1214,1402
False,8215017,"Ettlingen, Stadt",60 - 65 Jahre,2423,1149,1274
False,8215017,"Ettlingen, Stadt",65 - 75 Jahre,5249,2459,2790
False,8215017,"Ettlingen, Stadt",75 und mehr Jahre,4171,1646,2525
False,8215017,"Ettlingen, Stadt",Insgesamt,38553,18612,19941
False,8215021,Forst,unter 3 Jahre,209,114,95
False,8215021,Forst,3 -  6 Jahre,209,110,99
False,8215021,Forst,6 - 10 Jahre,304,145,159
False,8215021,Forst,10 - 15 Jahre,376,201,175
False,8215021,Forst,15 - 18 Jahre,242,128,114
False,8215021,Forst,18 - 20 Jahre,169,90,79
False,8215021,Forst,20 - 25 Jahre,409,225,184
False,8215021,Forst,25 - 30 Jahre,443,230,213
False,8215021,Forst,30 - 35 Jahre,472,233,239
False,8215021,Forst,35 - 40 Jahre,528,273,255
False,8215021,Forst,40 - 45 Jahre,660,335,325
False,8215021,Forst,45 - 50 Jahre,745,393,352
False,8215021,Forst,50 - 55 Jahre,626,307,319
False,8215021,Forst,55 - 60 Jahre,536,272,264
False,8215021,Forst,60 - 65 Jahre,489,251,238
False,8215021,Forst,65 - 75 Jahre,791,378,413
False,8215021,Forst,75 und mehr Jahre,628,258,370
False,8215021,Forst,Insgesamt,7836,3943,3893
False,8215025,Gondelsheim,unter 3 Jahre,87,43,44
False,8215025,Gondelsheim,3 -  6 Jahre,84,39,45
False,8215025,Gondelsheim,6 - 10 Jahre,113,62,51
False,8215025,Gondelsheim,10 - 15 Jahre,210,122,88
False,8215025,Gondelsheim,15 - 18 Jahre,123,58,65
False,8215025,Gondelsheim,18 - 20 Jahre,79,36,43
False,8215025,Gondelsheim,20 - 25 Jahre,192,112,80
False,8215025,Gondelsheim,25 - 30 Jahre,217,115,102
False,8215025,Gondelsheim,30 - 35 Jahre,179,96,83
False,8215025,Gondelsheim,35 - 40 Jahre,223,97,126
False,8215025,Gondelsheim,40 - 45 Jahre,271,136,135
False,8215025,Gondelsheim,45 - 50 Jahre,289,151,138
False,8215025,Gondelsheim,50 - 55 Jahre,271,150,121
False,8215025,Gondelsheim,55 - 60 Jahre,234,117,117
False,8215025,Gondelsheim,60 - 65 Jahre,192,93,99
False,8215025,Gondelsheim,65 - 75 Jahre,323,143,180
False,8215025,Gondelsheim,75 und mehr Jahre,224,92,132
False,8215025,Gondelsheim,Insgesamt,3311,1662,1649
False,8215029,Hambrücken,unter 3 Jahre,142,66,76
False,8215029,Hambrücken,3 -  6 Jahre,161,86,75
False,8215029,Hambrücken,6 - 10 Jahre,233,118,115
False,8215029,Hambrücken,10 - 15 Jahre,328,167,161
False,8215029,Hambrücken,15 - 18 Jahre,192,101,91
False,8215029,Hambrücken,18 - 20 Jahre,148,67,81
False,8215029,Hambrücken,20 - 25 Jahre,319,166,153
False,8215029,Hambrücken,25 - 30 Jahre,298,162,136
False,8215029,Hambrücken,30 - 35 Jahre,352,157,195
False,8215029,Hambrücken,35 - 40 Jahre,372,182,190
False,8215029,Hambrücken,40 - 45 Jahre,481,236,245
False,8215029,Hambrücken,45 - 50 Jahre,515,261,254
False,8215029,Hambrücken,50 - 55 Jahre,466,248,218
False,8215029,Hambrücken,55 - 60 Jahre,346,174,172
False,8215029,Hambrücken,60 - 65 Jahre,293,158,135
False,8215029,Hambrücken,65 - 75 Jahre,483,241,242
False,8215029,Hambrücken,75 und mehr Jahre,327,133,194
False,8215029,Hambrücken,Insgesamt,5456,2723,2733
False,8215039,Kronau,unter 3 Jahre,147,79,68
False,8215039,Kronau,3 -  6 Jahre,127,65,62
False,8215039,Kronau,6 - 10 Jahre,194,105,89
False,8215039,Kronau,10 - 15 Jahre,284,139,145
False,8215039,Kronau,15 - 18 Jahre,206,111,95
False,8215039,Kronau,18 - 20 Jahre,143,60,83
False,8215039,Kronau,20 - 25 Jahre,357,200,157
False,8215039,Kronau,25 - 30 Jahre,315,143,172
False,8215039,Kronau,30 - 35 Jahre,321,165,156
False,8215039,Kronau,35 - 40 Jahre,321,147,174
False,8215039,Kronau,40 - 45 Jahre,486,247,239
False,8215039,Kronau,45 - 50 Jahre,517,257,260
False,8215039,Kronau,50 - 55 Jahre,481,239,242
False,8215039,Kronau,55 - 60 Jahre,419,209,210
False,8215039,Kronau,60 - 65 Jahre,331,176,155
False,8215039,Kronau,65 - 75 Jahre,509,244,265
False,8215039,Kronau,75 und mehr Jahre,408,155,253
False,8215039,Kronau,Insgesamt,5566,2741,2825
False,8215040,Kürnbach,unter 3 Jahre,49,27,22
False,8215040,Kürnbach,3 -  6 Jahre,53,27,26
False,8215040,Kürnbach,6 - 10 Jahre,69,29,40
False,8215040,Kürnbach,10 - 15 Jahre,111,62,49
False,8215040,Kürnbach,15 - 18 Jahre,71,44,27
False,8215040,Kürnbach,18 - 20 Jahre,52,22,30
False,8215040,Kürnbach,20 - 25 Jahre,123,64,59
False,8215040,Kürnbach,25 - 30 Jahre,122,78,44
False,8215040,Kürnbach,30 - 35 Jahre,102,49,53
False,8215040,Kürnbach,35 - 40 Jahre,114,50,64
False,8215040,Kürnbach,40 - 45 Jahre,187,103,84
False,8215040,Kürnbach,45 - 50 Jahre,209,105,104
False,8215040,Kürnbach,50 - 55 Jahre,177,95,82
False,8215040,Kürnbach,55 - 60 Jahre,158,74,84
False,8215040,Kürnbach,60 - 65 Jahre,145,74,71
False,8215040,Kürnbach,65 - 75 Jahre,248,119,129
False,8215040,Kürnbach,75 und mehr Jahre,287,111,176
False,8215040,Kürnbach,Insgesamt,2277,1133,1144
False,8215046,Malsch,unter 3 Jahre,341,181,160
False,8215046,Malsch,3 -  6 Jahre,395,197,198
False,8215046,Malsch,6 - 10 Jahre,556,291,265
False,8215046,Malsch,10 - 15 Jahre,801,422,379
False,8215046,Malsch,15 - 18 Jahre,517,265,252
False,8215046,Malsch,18 - 20 Jahre,318,175,143
False,8215046,Malsch,20 - 25 Jahre,781,392,389
False,8215046,Malsch,25 - 30 Jahre,721,369,352
False,8215046,Malsch,30 - 35 Jahre,755,371,384
False,8215046,Malsch,35 - 40 Jahre,837,391,446
False,8215046,Malsch,40 - 45 Jahre,1319,651,668
False,8215046,Malsch,45 - 50 Jahre,1413,732,681
False,8215046,Malsch,50 - 55 Jahre,1178,593,585
False,8215046,Malsch,55 - 60 Jahre,963,480,483
False,8215046,Malsch,60 - 65 Jahre,839,419,420
False,8215046,Malsch,65 - 75 Jahre,1482,718,764
False,8215046,Malsch,75 und mehr Jahre,1272,502,770
False,8215046,Malsch,Insgesamt,14488,7149,7339
False,8215047,Marxzell,unter 3 Jahre,103,53,50
False,8215047,Marxzell,3 -  6 Jahre,109,53,56
False,8215047,Marxzell,6 - 10 Jahre,174,99,75
False,8215047,Marxzell,10 - 15 Jahre,244,138,106
False,8215047,Marxzell,15 - 18 Jahre,186,99,87
False,8215047,Marxzell,18 - 20 Jahre,126,67,59
False,8215047,Marxzell,20 - 25 Jahre,307,166,141
False,8215047,Marxzell,25 - 30 Jahre,231,117,114
False,8215047,Marxzell,30 - 35 Jahre,247,115,132
False,8215047,Marxzell,35 - 40 Jahre,274,150,124
False,8215047,Marxzell,40 - 45 Jahre,408,210,198
False,8215047,Marxzell,45 - 50 Jahre,493,230,263
False,8215047,Marxzell,50 - 55 Jahre,473,239,234
False,8215047,Marxzell,55 - 60 Jahre,365,195,170
False,8215047,Marxzell,60 - 65 Jahre,316,172,144
False,8215047,Marxzell,65 - 75 Jahre,613,305,308
False,8215047,Marxzell,75 und mehr Jahre,689,261,428
False,8215047,Marxzell,Insgesamt,5358,2669,2689
False,8215059,Oberderdingen,unter 3 Jahre,264,128,136
False,8215059,Oberderdingen,3 -  6 Jahre,317,165,152
False,8215059,Oberderdingen,6 - 10 Jahre,447,238,209
False,8215059,Oberderdingen,10 - 15 Jahre,645,338,307
False,8215059,Oberderdingen,15 - 18 Jahre,411,232,179
False,8215059,Oberderdingen,18 - 20 Jahre,275,146,129
False,8215059,Oberderdingen,20 - 25 Jahre,612,303,309
False,8215059,Oberderdingen,25 - 30 Jahre,605,300,305
False,8215059,Oberderdingen,30 - 35 Jahre,612,295,317
False,8215059,Oberderdingen,35 - 40 Jahre,663,339,324
False,8215059,Oberderdingen,40 - 45 Jahre,921,437,484
False,8215059,Oberderdingen,45 - 50 Jahre,911,478,433
False,8215059,Oberderdingen,50 - 55 Jahre,777,402,375
False,8215059,Oberderdingen,55 - 60 Jahre,650,325,325
False,8215059,Oberderdingen,60 - 65 Jahre,513,241,272
False,8215059,Oberderdingen,65 - 75 Jahre,962,458,504
False,8215059,Oberderdingen,75 und mehr Jahre,889,327,562
False,8215059,Oberderdingen,Insgesamt,10474,5152,5322
False,8215064,"Östringen, Stadt",unter 3 Jahre,300,161,139
False,8215064,"Östringen, Stadt",3 -  6 Jahre,337,192,145
False,8215064,"Östringen, Stadt",6 - 10 Jahre,517,269,248
False,8215064,"Östringen, Stadt",10 - 15 Jahre,750,359,391
False,8215064,"Östringen, Stadt",15 - 18 Jahre,433,221,212
False,8215064,"Östringen, Stadt",18 - 20 Jahre,326,179,147
False,8215064,"Östringen, Stadt",20 - 25 Jahre,799,417,382
False,8215064,"Östringen, Stadt",25 - 30 Jahre,750,387,363
False,8215064,"Östringen, Stadt",30 - 35 Jahre,664,331,333
False,8215064,"Östringen, Stadt",35 - 40 Jahre,815,417,398
False,8215064,"Östringen, Stadt",40 - 45 Jahre,1084,560,524
False,8215064,"Östringen, Stadt",45 - 50 Jahre,1187,601,586
False,8215064,"Östringen, Stadt",50 - 55 Jahre,1008,506,502
False,8215064,"Östringen, Stadt",55 - 60 Jahre,849,429,420
False,8215064,"Östringen, Stadt",60 - 65 Jahre,765,392,373
False,8215064,"Östringen, Stadt",65 - 75 Jahre,1231,594,637
False,8215064,"Östringen, Stadt",75 und mehr Jahre,1016,424,592
False,8215064,"Östringen, Stadt",Insgesamt,12831,6439,6392
False,8215066,"Philippsburg, Stadt",unter 3 Jahre,320,168,152
False,8215066,"Philippsburg, Stadt",3 -  6 Jahre,363,184,179
False,8215066,"Philippsburg, Stadt",6 - 10 Jahre,511,268,243
False,8215066,"Philippsburg, Stadt",10 - 15 Jahre,739,399,340
False,8215066,"Philippsburg, Stadt",15 - 18 Jahre,398,225,173
False,8215066,"Philippsburg, Stadt",18 - 20 Jahre,326,177,149
False,8215066,"Philippsburg, Stadt",20 - 25 Jahre,745,381,364
False,8215066,"Philippsburg, Stadt",25 - 30 Jahre,754,402,352
False,8215066,"Philippsburg, Stadt",30 - 35 Jahre,782,400,382
False,8215066,"Philippsburg, Stadt",35 - 40 Jahre,765,377,388
False,8215066,"Philippsburg, Stadt",40 - 45 Jahre,944,473,471
False,8215066,"Philippsburg, Stadt",45 - 50 Jahre,1020,531,489
False,8215066,"Philippsburg, Stadt",50 - 55 Jahre,923,470,453
False,8215066,"Philippsburg, Stadt",55 - 60 Jahre,879,424,455
False,8215066,"Philippsburg, Stadt",60 - 65 Jahre,737,396,341
False,8215066,"Philippsburg, Stadt",65 - 75 Jahre,1250,602,648
False,8215066,"Philippsburg, Stadt",75 und mehr Jahre,962,350,612
False,8215066,"Philippsburg, Stadt",Insgesamt,12418,6227,6191
False,8215082,Sulzfeld,unter 3 Jahre,106,63,43
False,8215082,Sulzfeld,3 -  6 Jahre,108,56,52
False,8215082,Sulzfeld,6 - 10 Jahre,182,103,79
False,8215082,Sulzfeld,10 - 15 Jahre,266,159,107
False,8215082,Sulzfeld,15 - 18 Jahre,195,95,100
False,8215082,Sulzfeld,18 - 20 Jahre,121,56,65
False,8215082,Sulzfeld,20 - 25 Jahre,286,141,145
False,8215082,Sulzfeld,25 - 30 Jahre,246,129,117
False,8215082,Sulzfeld,30 - 35 Jahre,226,119,107
False,8215082,Sulzfeld,35 - 40 Jahre,283,150,133
False,8215082,Sulzfeld,40 - 45 Jahre,385,194,191
False,8215082,Sulzfeld,45 - 50 Jahre,446,212,234
False,8215082,Sulzfeld,50 - 55 Jahre,350,193,157
False,8215082,Sulzfeld,55 - 60 Jahre,270,139,131
False,8215082,Sulzfeld,60 - 65 Jahre,227,99,128
False,8215082,Sulzfeld,65 - 75 Jahre,529,252,277
False,8215082,Sulzfeld,75 und mehr Jahre,414,185,229
False,8215082,Sulzfeld,Insgesamt,4640,2345,2295
False,8215084,Ubstadt-Weiher,unter 3 Jahre,324,169,155
False,8215084,Ubstadt-Weiher,3 -  6 Jahre,327,178,149
False,8215084,Ubstadt-Weiher,6 - 10 Jahre,484,242,242
False,8215084,Ubstadt-Weiher,10 - 15 Jahre,733,394,339
False,8215084,Ubstadt-Weiher,15 - 18 Jahre,410,220,190
False,8215084,Ubstadt-Weiher,18 - 20 Jahre,332,180,152
False,8215084,Ubstadt-Weiher,20 - 25 Jahre,828,451,377
False,8215084,Ubstadt-Weiher,25 - 30 Jahre,763,357,406
False,8215084,Ubstadt-Weiher,30 - 35 Jahre,737,383,354
False,8215084,Ubstadt-Weiher,35 - 40 Jahre,805,401,404
False,8215084,Ubstadt-Weiher,40 - 45 Jahre,1056,530,526
False,8215084,Ubstadt-Weiher,45 - 50 Jahre,1214,622,592
False,8215084,Ubstadt-Weiher,50 - 55 Jahre,1068,520,548
False,8215084,Ubstadt-Weiher,55 - 60 Jahre,846,433,413
False,8215084,Ubstadt-Weiher,60 - 65 Jahre,662,339,323
False,8215084,Ubstadt-Weiher,65 - 75 Jahre,1241,593,648
False,8215084,Ubstadt-Weiher,75 und mehr Jahre,1084,422,662
False,8215084,Ubstadt-Weiher,Insgesamt,12914,6434,6480
False,8215089,Walzbachtal,unter 3 Jahre,224,120,104
False,8215089,Walzbachtal,3 -  6 Jahre,216,102,114
False,8215089,Walzbachtal,6 - 10 Jahre,351,186,165
False,8215089,Walzbachtal,10 - 15 Jahre,517,248,269
False,8215089,Walzbachtal,15 - 18 Jahre,359,185,174
False,8215089,Walzbachtal,18 - 20 Jahre,222,101,121
False,8215089,Walzbachtal,20 - 25 Jahre,486,246,240
False,8215089,Walzbachtal,25 - 30 Jahre,505,241,264
False,8215089,Walzbachtal,30 - 35 Jahre,481,244,237
False,8215089,Walzbachtal,35 - 40 Jahre,524,266,258
False,8215089,Walzbachtal,40 - 45 Jahre,802,361,441
False,8215089,Walzbachtal,45 - 50 Jahre,829,419,410
False,8215089,Walzbachtal,50 - 55 Jahre,754,367,387
False,8215089,Walzbachtal,55 - 60 Jahre,619,321,298
False,8215089,Walzbachtal,60 - 65 Jahre,507,236,271
False,8215089,Walzbachtal,65 - 75 Jahre,936,462,474
False,8215089,Walzbachtal,75 und mehr Jahre,809,311,498
False,8215089,Walzbachtal,Insgesamt,9141,4416,4725
False,8215090,Weingarten (Baden),unter 3 Jahre,303,163,140
False,8215090,Weingarten (Baden),3 -  6 Jahre,302,166,136
False,8215090,Weingarten (Baden),6 - 10 Jahre,400,196,204
False,8215090,Weingarten (Baden),10 - 15 Jahre,547,286,261
False,8215090,Weingarten (Baden),15 - 18 Jahre,334,177,157
False,8215090,Weingarten (Baden),18 - 20 Jahre,188,94,94
False,8215090,Weingarten (Baden),20 - 25 Jahre,485,269,216
False,8215090,Weingarten (Baden),25 - 30 Jahre,508,261,247
False,8215090,Weingarten (Baden),30 - 35 Jahre,570,265,305
False,8215090,Weingarten (Baden),35 - 40 Jahre,660,319,341
False,8215090,Weingarten (Baden),40 - 45 Jahre,892,446,446
False,8215090,Weingarten (Baden),45 - 50 Jahre,929,478,451
False,8215090,Weingarten (Baden),50 - 55 Jahre,651,316,335
False,8215090,Weingarten (Baden),55 - 60 Jahre,624,310,314
False,8215090,Weingarten (Baden),60 - 65 Jahre,518,252,266
False,8215090,Weingarten (Baden),65 - 75 Jahre,1054,489,565
False,8215090,Weingarten (Baden),75 und mehr Jahre,984,363,621
False,8215090,Weingarten (Baden),Insgesamt,9949,4850,5099
False,8215094,Zaisenhausen,unter 3 Jahre,45,24,21
False,8215094,Zaisenhausen,3 -  6 Jahre,47,21,26
False,8215094,Zaisenhausen,6 - 10 Jahre,63,37,26
False,8215094,Zaisenhausen,10 - 15 Jahre,102,62,40
False,8215094,Zaisenhausen,15 - 18 Jahre,61,35,26
False,8215094,Zaisenhausen,18 - 20 Jahre,40,29,11
False,8215094,Zaisenhausen,20 - 25 Jahre,120,61,59
False,8215094,Zaisenhausen,25 - 30 Jahre,120,60,60
False,8215094,Zaisenhausen,30 - 35 Jahre,74,41,33
False,8215094,Zaisenhausen,35 - 40 Jahre,95,53,42
False,8215094,Zaisenhausen,40 - 45 Jahre,147,80,67
False,8215094,Zaisenhausen,45 - 50 Jahre,162,81,81
False,8215094,Zaisenhausen,50 - 55 Jahre,135,69,66
False,8215094,Zaisenhausen,55 - 60 Jahre,89,44,45
False,8215094,Zaisenhausen,60 - 65 Jahre,86,46,40
False,8215094,Zaisenhausen,65 - 75 Jahre,192,90,102
False,8215094,Zaisenhausen,75 und mehr Jahre,133,44,89
False,8215094,Zaisenhausen,Insgesamt,1711,877,834
False,8215096,Karlsbad,unter 3 Jahre,381,182,199
False,8215096,Karlsbad,3 -  6 Jahre,366,189,177
False,8215096,Karlsbad,6 - 10 Jahre,557,286,271
False,8215096,Karlsbad,10 - 15 Jahre,890,442,448
False,8215096,Karlsbad,15 - 18 Jahre,551,287,264
False,8215096,Karlsbad,18 - 20 Jahre,404,219,185
False,8215096,Karlsbad,20 - 25 Jahre,887,481,406
False,8215096,Karlsbad,25 - 30 Jahre,832,423,409
False,8215096,Karlsbad,30 - 35 Jahre,855,398,457
False,8215096,Karlsbad,35 - 40 Jahre,901,421,480
False,8215096,Karlsbad,40 - 45 Jahre,1292,617,675
False,8215096,Karlsbad,45 - 50 Jahre,1405,685,720
False,8215096,Karlsbad,50 - 55 Jahre,1284,615,669
False,8215096,Karlsbad,55 - 60 Jahre,1166,545,621
False,8215096,Karlsbad,60 - 65 Jahre,970,518,452
False,8215096,Karlsbad,65 - 75 Jahre,1699,837,862
False,8215096,Karlsbad,75 und mehr Jahre,1368,543,825
False,8215096,Karlsbad,Insgesamt,15808,7688,8120
False,8215097,"Kraichtal, Stadt",unter 3 Jahre,361,186,175
False,8215097,"Kraichtal, Stadt",3 -  6 Jahre,427,220,207
False,8215097,"Kraichtal, Stadt",6 - 10 Jahre,564,292,272
False,8215097,"Kraichtal, Stadt",10 - 15 Jahre,862,455,407
False,8215097,"Kraichtal, Stadt",15 - 18 Jahre,571,294,277
False,8215097,"Kraichtal, Stadt",18 - 20 Jahre,371,186,185
False,8215097,"Kraichtal, Stadt",20 - 25 Jahre,861,439,422
False,8215097,"Kraichtal, Stadt",25 - 30 Jahre,775,416,359
False,8215097,"Kraichtal, Stadt",30 - 35 Jahre,804,386,418
False,8215097,"Kraichtal, Stadt",35 - 40 Jahre,960,485,475
False,8215097,"Kraichtal, Stadt",40 - 45 Jahre,1226,636,590
False,8215097,"Kraichtal, Stadt",45 - 50 Jahre,1422,725,697
False,8215097,"Kraichtal, Stadt",50 - 55 Jahre,1172,597,575
False,8215097,"Kraichtal, Stadt",55 - 60 Jahre,943,484,459
False,8215097,"Kraichtal, Stadt",60 - 65 Jahre,826,400,426
False,8215097,"Kraichtal, Stadt",65 - 75 Jahre,1478,703,775
False,8215097,"Kraichtal, Stadt",75 und mehr Jahre,1216,470,746
False,8215097,"Kraichtal, Stadt",Insgesamt,14839,7374,7465
False,8215099,Graben-Neudorf,unter 3 Jahre,288,152,136
False,8215099,Graben-Neudorf,3 -  6 Jahre,293,158,135
False,8215099,Graben-Neudorf,6 - 10 Jahre,434,210,224
False,8215099,Graben-Neudorf,10 - 15 Jahre,606,320,286
False,8215099,Graben-Neudorf,15 - 18 Jahre,414,210,204
False,8215099,Graben-Neudorf,18 - 20 Jahre,297,157,140
False,8215099,Graben-Neudorf,20 - 25 Jahre,740,396,344
False,8215099,Graben-Neudorf,25 - 30 Jahre,700,364,336
False,8215099,Graben-Neudorf,30 - 35 Jahre,618,323,295
False,8215099,Graben-Neudorf,35 - 40 Jahre,616,302,314
False,8215099,Graben-Neudorf,40 - 45 Jahre,943,469,474
False,8215099,Graben-Neudorf,45 - 50 Jahre,1113,572,541
False,8215099,Graben-Neudorf,50 - 55 Jahre,1033,512,521
False,8215099,Graben-Neudorf,55 - 60 Jahre,819,429,390
False,8215099,Graben-Neudorf,60 - 65 Jahre,635,331,304
False,8215099,Graben-Neudorf,65 - 75 Jahre,1127,532,595
False,8215099,Graben-Neudorf,75 und mehr Jahre,935,352,583
False,8215099,Graben-Neudorf,Insgesamt,11611,5789,5822
False,8215100,Bad Schönborn,unter 3 Jahre,317,157,160
False,8215100,Bad Schönborn,3 -  6 Jahre,354,175,179
False,8215100,Bad Schönborn,6 - 10 Jahre,514,272,242
False,8215100,Bad Schönborn,10 - 15 Jahre,759,396,363
False,8215100,Bad Schönborn,15 - 18 Jahre,444,229,215
False,8215100,Bad Schönborn,18 - 20 Jahre,286,139,147
False,8215100,Bad Schönborn,20 - 25 Jahre,733,358,375
False,8215100,Bad Schönborn,25 - 30 Jahre,808,411,397
False,8215100,Bad Schönborn,30 - 35 Jahre,760,354,406
False,8215100,Bad Schönborn,35 - 40 Jahre,736,367,369
False,8215100,Bad Schönborn,40 - 45 Jahre,986,513,473
False,8215100,Bad Schönborn,45 - 50 Jahre,1064,558,506
False,8215100,Bad Schönborn,50 - 55 Jahre,922,474,448
False,8215100,Bad Schönborn,55 - 60 Jahre,786,390,396
False,8215100,Bad Schönborn,60 - 65 Jahre,667,330,337
False,8215100,Bad Schönborn,65 - 75 Jahre,1148,577,571
False,8215100,Bad Schönborn,75 und mehr Jahre,1246,429,817
False,8215100,Bad Schönborn,Insgesamt,12530,6129,6401
False,8215101,Pfinztal,unter 3 Jahre,431,220,211
False,8215101,Pfinztal,3 -  6 Jahre,449,224,225
False,8215101,Pfinztal,6 - 10 Jahre,642,340,302
False,8215101,Pfinztal,10 - 15 Jahre,976,510,466
False,8215101,Pfinztal,15 - 18 Jahre,565,268,297
False,8215101,Pfinztal,18 - 20 Jahre,439,226,213
False,8215101,Pfinztal,20 - 25 Jahre,1046,534,512
False,8215101,Pfinztal,25 - 30 Jahre,925,489,436
False,8215101,Pfinztal,30 - 35 Jahre,894,436,458
False,8215101,Pfinztal,35 - 40 Jahre,1012,508,504
False,8215101,Pfinztal,40 - 45 Jahre,1463,728,735
False,8215101,Pfinztal,45 - 50 Jahre,1595,792,803
False,8215101,Pfinztal,50 - 55 Jahre,1389,690,699
False,8215101,Pfinztal,55 - 60 Jahre,1250,645,605
False,8215101,Pfinztal,60 - 65 Jahre,1078,518,560
False,8215101,Pfinztal,65 - 75 Jahre,2041,967,1074
False,8215101,Pfinztal,75 und mehr Jahre,1712,653,1059
False,8215101,Pfinztal,Insgesamt,17907,8748,9159
False,8215102,Eggenstein-Leopoldshafen,unter 3 Jahre,397,215,182
False,8215102,Eggenstein-Leopoldshafen,3 -  6 Jahre,399,191,208
False,8215102,Eggenstein-Leopoldshafen,6 - 10 Jahre,545,284,261
False,8215102,Eggenstein-Leopoldshafen,10 - 15 Jahre,832,424,408
False,8215102,Eggenstein-Leopoldshafen,15 - 18 Jahre,452,231,221
False,8215102,Eggenstein-Leopoldshafen,18 - 20 Jahre,349,180,169
False,8215102,Eggenstein-Leopoldshafen,20 - 25 Jahre,736,366,370
False,8215102,Eggenstein-Leopoldshafen,25 - 30 Jahre,871,442,429
False,8215102,Eggenstein-Leopoldshafen,30 - 35 Jahre,931,431,500
False,8215102,Eggenstein-Leopoldshafen,35 - 40 Jahre,965,466,499
False,8215102,Eggenstein-Leopoldshafen,40 - 45 Jahre,1357,698,659
False,8215102,Eggenstein-Leopoldshafen,45 - 50 Jahre,1395,717,678
False,8215102,Eggenstein-Leopoldshafen,50 - 55 Jahre,1238,612,626
False,8215102,Eggenstein-Leopoldshafen,55 - 60 Jahre,1051,511,540
False,8215102,Eggenstein-Leopoldshafen,60 - 65 Jahre,988,450,538
False,8215102,Eggenstein-Leopoldshafen,65 - 75 Jahre,1930,911,1019
False,8215102,Eggenstein-Leopoldshafen,75 und mehr Jahre,1384,592,792
False,8215102,Eggenstein-Leopoldshafen,Insgesamt,15820,7721,8099
False,8215103,Karlsdorf-Neuthard,unter 3 Jahre,276,144,132
False,8215103,Karlsdorf-Neuthard,3 -  6 Jahre,255,123,132
False,8215103,Karlsdorf-Neuthard,6 - 10 Jahre,371,192,179
False,8215103,Karlsdorf-Neuthard,10 - 15 Jahre,545,272,273
False,8215103,Karlsdorf-Neuthard,15 - 18 Jahre,381,192,189
False,8215103,Karlsdorf-Neuthard,18 - 20 Jahre,234,121,113
False,8215103,Karlsdorf-Neuthard,20 - 25 Jahre,529,276,253
False,8215103,Karlsdorf-Neuthard,25 - 30 Jahre,555,293,262
False,8215103,Karlsdorf-Neuthard,30 - 35 Jahre,594,292,302
False,8215103,Karlsdorf-Neuthard,35 - 40 Jahre,671,334,337
False,8215103,Karlsdorf-Neuthard,40 - 45 Jahre,923,487,436
False,8215103,Karlsdorf-Neuthard,45 - 50 Jahre,878,466,412
False,8215103,Karlsdorf-Neuthard,50 - 55 Jahre,794,407,387
False,8215103,Karlsdorf-Neuthard,55 - 60 Jahre,629,313,316
False,8215103,Karlsdorf-Neuthard,60 - 65 Jahre,565,282,283
False,8215103,Karlsdorf-Neuthard,65 - 75 Jahre,1049,517,532
False,8215103,Karlsdorf-Neuthard,75 und mehr Jahre,723,258,465
False,8215103,Karlsdorf-Neuthard,Insgesamt,9972,4969,5003
False,8215105,Linkenheim-Hochstetten,unter 3 Jahre,281,143,138
False,8215105,Linkenheim-Hochstetten,3 -  6 Jahre,325,174,151
False,8215105,Linkenheim-Hochstetten,6 - 10 Jahre,416,214,202
False,8215105,Linkenheim-Hochstetten,10 - 15 Jahre,685,348,337
False,8215105,Linkenheim-Hochstetten,15 - 18 Jahre,471,234,237
False,8215105,Linkenheim-Hochstetten,18 - 20 Jahre,287,151,136
False,8215105,Linkenheim-Hochstetten,20 - 25 Jahre,618,318,300
False,8215105,Linkenheim-Hochstetten,25 - 30 Jahre,596,302,294
False,8215105,Linkenheim-Hochstetten,30 - 35 Jahre,651,327,324
False,8215105,Linkenheim-Hochstetten,35 - 40 Jahre,744,365,379
False,8215105,Linkenheim-Hochstetten,40 - 45 Jahre,1095,542,553
False,8215105,Linkenheim-Hochstetten,45 - 50 Jahre,1097,554,543
False,8215105,Linkenheim-Hochstetten,50 - 55 Jahre,965,493,472
False,8215105,Linkenheim-Hochstetten,55 - 60 Jahre,817,420,397
False,8215105,Linkenheim-Hochstetten,60 - 65 Jahre,692,338,354
False,8215105,Linkenheim-Hochstetten,65 - 75 Jahre,1208,576,632
False,8215105,Linkenheim-Hochstetten,75 und mehr Jahre,996,396,600
False,8215105,Linkenheim-Hochstetten,Insgesamt,11944,5895,6049
False,8215106,"Waghäusel, Stadt",unter 3 Jahre,570,296,274
False,8215106,"Waghäusel, Stadt",3 -  6 Jahre,529,290,239
False,8215106,"Waghäusel, Stadt",6 - 10 Jahre,753,387,366
False,8215106,"Waghäusel, Stadt",10 - 15 Jahre,1057,530,527
False,8215106,"Waghäusel, Stadt",15 - 18 Jahre,670,348,322
False,8215106,"Waghäusel, Stadt",18 - 20 Jahre,426,205,221
False,8215106,"Waghäusel, Stadt",20 - 25 Jahre,1233,628,605
False,8215106,"Waghäusel, Stadt",25 - 30 Jahre,1272,626,646
False,8215106,"Waghäusel, Stadt",30 - 35 Jahre,1244,632,612
False,8215106,"Waghäusel, Stadt",35 - 40 Jahre,1384,698,686
False,8215106,"Waghäusel, Stadt",40 - 45 Jahre,1755,884,871
False,8215106,"Waghäusel, Stadt",45 - 50 Jahre,1773,902,871
False,8215106,"Waghäusel, Stadt",50 - 55 Jahre,1581,776,805
False,8215106,"Waghäusel, Stadt",55 - 60 Jahre,1406,710,696
False,8215106,"Waghäusel, Stadt",60 - 65 Jahre,1170,570,600
False,8215106,"Waghäusel, Stadt",65 - 75 Jahre,2154,1056,1098
False,8215106,"Waghäusel, Stadt",75 und mehr Jahre,1643,630,1013
False,8215106,"Waghäusel, Stadt",Insgesamt,20620,10168,10452
False,8215107,Oberhausen-Rheinhausen,unter 3 Jahre,221,107,114
False,8215107,Oberhausen-Rheinhausen,3 -  6 Jahre,210,107,103
False,8215107,Oberhausen-Rheinhausen,6 - 10 Jahre,269,141,128
False,8215107,Oberhausen-Rheinhausen,10 - 15 Jahre,470,205,265
False,8215107,Oberhausen-Rheinhausen,15 - 18 Jahre,313,139,174
False,8215107,Oberhausen-Rheinhausen,18 - 20 Jahre,235,127,108
False,8215107,Oberhausen-Rheinhausen,20 - 25 Jahre,574,313,261
False,8215107,Oberhausen-Rheinhausen,25 - 30 Jahre,510,264,246
False,8215107,Oberhausen-Rheinhausen,30 - 35 Jahre,499,237,262
False,8215107,Oberhausen-Rheinhausen,35 - 40 Jahre,537,262,275
False,8215107,Oberhausen-Rheinhausen,40 - 45 Jahre,743,374,369
False,8215107,Oberhausen-Rheinhausen,45 - 50 Jahre,925,466,459
False,8215107,Oberhausen-Rheinhausen,50 - 55 Jahre,870,465,405
False,8215107,Oberhausen-Rheinhausen,55 - 60 Jahre,680,330,350
False,8215107,Oberhausen-Rheinhausen,60 - 65 Jahre,607,302,305
False,8215107,Oberhausen-Rheinhausen,65 - 75 Jahre,1000,495,505
False,8215107,Oberhausen-Rheinhausen,75 und mehr Jahre,927,353,574
False,8215107,Oberhausen-Rheinhausen,Insgesamt,9590,4687,4903
False,8215108,"Rheinstetten, Stadt",unter 3 Jahre,433,227,206
False,8215108,"Rheinstetten, Stadt",3 -  6 Jahre,487,257,230
False,8215108,"Rheinstetten, Stadt",6 - 10 Jahre,667,334,333
False,8215108,"Rheinstetten, Stadt",10 - 15 Jahre,1048,546,502
False,8215108,"Rheinstetten, Stadt",15 - 18 Jahre,678,342,336
False,8215108,"Rheinstetten, Stadt",18 - 20 Jahre,486,255,231
False,8215108,"Rheinstetten, Stadt",20 - 25 Jahre,1051,549,502
False,8215108,"Rheinstetten, Stadt",25 - 30 Jahre,1032,511,521
False,8215108,"Rheinstetten, Stadt",30 - 35 Jahre,1006,474,532
False,8215108,"Rheinstetten, Stadt",35 - 40 Jahre,1169,570,599
False,8215108,"Rheinstetten, Stadt",40 - 45 Jahre,1697,837,860
False,8215108,"Rheinstetten, Stadt",45 - 50 Jahre,1918,940,978
False,8215108,"Rheinstetten, Stadt",50 - 55 Jahre,1643,835,808
False,8215108,"Rheinstetten, Stadt",55 - 60 Jahre,1375,674,701
False,8215108,"Rheinstetten, Stadt",60 - 65 Jahre,1279,596,683
False,8215108,"Rheinstetten, Stadt",65 - 75 Jahre,2585,1196,1389
False,8215108,"Rheinstetten, Stadt",75 und mehr Jahre,1998,775,1223
False,8215108,"Rheinstetten, Stadt",Insgesamt,20552,9918,10634
False,8215109,"Stutensee, Stadt",unter 3 Jahre,584,279,305
False,8215109,"Stutensee, Stadt",3 -  6 Jahre,661,322,339
False,8215109,"Stutensee, Stadt",6 - 10 Jahre,916,487,429
False,8215109,"Stutensee, Stadt",10 - 15 Jahre,1337,672,665
False,8215109,"Stutensee, Stadt",15 - 18 Jahre,766,390,376
False,8215109,"Stutensee, Stadt",18 - 20 Jahre,534,292,242
False,8215109,"Stutensee, Stadt",20 - 25 Jahre,1267,673,594
False,8215109,"Stutensee, Stadt",25 - 30 Jahre,1237,633,604
False,8215109,"Stutensee, Stadt",30 - 35 Jahre,1277,606,671
False,8215109,"Stutensee, Stadt",35 - 40 Jahre,1409,715,694
False,8215109,"Stutensee, Stadt",40 - 45 Jahre,2019,1026,993
False,8215109,"Stutensee, Stadt",45 - 50 Jahre,2252,1152,1100
False,8215109,"Stutensee, Stadt",50 - 55 Jahre,1882,966,916
False,8215109,"Stutensee, Stadt",55 - 60 Jahre,1689,802,887
False,8215109,"Stutensee, Stadt",60 - 65 Jahre,1448,734,714
False,8215109,"Stutensee, Stadt",65 - 75 Jahre,2482,1219,1263
False,8215109,"Stutensee, Stadt",75 und mehr Jahre,1823,715,1108
False,8215109,"Stutensee, Stadt",Insgesamt,23583,11683,11900
False,8215110,Waldbronn,unter 3 Jahre,282,146,136
False,8215110,Waldbronn,3 -  6 Jahre,316,155,161
False,8215110,Waldbronn,6 - 10 Jahre,442,234,208
False,8215110,Waldbronn,10 - 15 Jahre,566,300,266
False,8215110,Waldbronn,15 - 18 Jahre,350,187,163
False,8215110,Waldbronn,18 - 20 Jahre,246,124,122
False,8215110,Waldbronn,20 - 25 Jahre,566,326,240
False,8215110,Waldbronn,25 - 30 Jahre,614,297,317
False,8215110,Waldbronn,30 - 35 Jahre,620,316,304
False,8215110,Waldbronn,35 - 40 Jahre,721,349,372
False,8215110,Waldbronn,40 - 45 Jahre,957,474,483
False,8215110,Waldbronn,45 - 50 Jahre,1092,561,531
False,8215110,Waldbronn,50 - 55 Jahre,983,488,495
False,8215110,Waldbronn,55 - 60 Jahre,828,408,420
False,8215110,Waldbronn,60 - 65 Jahre,770,377,393
False,8215110,Waldbronn,65 - 75 Jahre,1634,790,844
False,8215110,Waldbronn,75 und mehr Jahre,1399,603,796
False,8215110,Waldbronn,Insgesamt,12386,6135,6251
False,8215111,Dettenheim,unter 3 Jahre,146,83,63
False,8215111,Dettenheim,3 -  6 Jahre,126,62,64
False,8215111,Dettenheim,6 - 10 Jahre,210,116,94
False,8215111,Dettenheim,10 - 15 Jahre,360,199,161
False,8215111,Dettenheim,15 - 18 Jahre,211,112,99
False,8215111,Dettenheim,18 - 20 Jahre,148,73,75
False,8215111,Dettenheim,20 - 25 Jahre,412,215,197
False,8215111,Dettenheim,25 - 30 Jahre,289,155,134
False,8215111,Dettenheim,30 - 35 Jahre,312,148,164
False,8215111,Dettenheim,35 - 40 Jahre,373,186,187
False,8215111,Dettenheim,40 - 45 Jahre,498,247,251
False,8215111,Dettenheim,45 - 50 Jahre,637,310,327
False,8215111,Dettenheim,50 - 55 Jahre,634,342,292
False,8215111,Dettenheim,55 - 60 Jahre,505,252,253
False,8215111,Dettenheim,60 - 65 Jahre,444,225,219
False,8215111,Dettenheim,65 - 75 Jahre,668,333,335
False,8215111,Dettenheim,75 und mehr Jahre,523,202,321
False,8215111,Dettenheim,Insgesamt,6496,3260,3236
False,8216,Landkreis Rastatt,unter 3 Jahre,5240,2749,2491
False,8216,Landkreis Rastatt,3 -  6 Jahre,5621,2896,2725
False,8216,Landkreis Rastatt,6 - 10 Jahre,8410,4318,4092
False,8216,Landkreis Rastatt,10 - 15 Jahre,11980,6125,5855
False,8216,Landkreis Rastatt,15 - 18 Jahre,7691,3980,3711
False,8216,Landkreis Rastatt,18 - 20 Jahre,5264,2734,2530
False,8216,Landkreis Rastatt,20 - 25 Jahre,12640,6604,6036
False,8216,Landkreis Rastatt,25 - 30 Jahre,12500,6289,6211
False,8216,Landkreis Rastatt,30 - 35 Jahre,12121,5967,6154
False,8216,Landkreis Rastatt,35 - 40 Jahre,13461,6574,6887
False,8216,Landkreis Rastatt,40 - 45 Jahre,18445,9286,9159
False,8216,Landkreis Rastatt,45 - 50 Jahre,20445,10406,10039
False,8216,Landkreis Rastatt,50 - 55 Jahre,18263,9320,8943
False,8216,Landkreis Rastatt,55 - 60 Jahre,15773,7870,7903
False,8216,Landkreis Rastatt,60 - 65 Jahre,12767,6387,6380
False,8216,Landkreis Rastatt,65 - 75 Jahre,24770,11714,13056
False,8216,Landkreis Rastatt,75 und mehr Jahre,21398,8322,13076
False,8216,Landkreis Rastatt,Insgesamt,226789,111541,115248
False,8216002,Au am Rhein,unter 3 Jahre,83,43,40
False,8216002,Au am Rhein,3 -  6 Jahre,68,35,33
False,8216002,Au am Rhein,6 - 10 Jahre,122,63,59
False,8216002,Au am Rhein,10 - 15 Jahre,205,108,97
False,8216002,Au am Rhein,15 - 18 Jahre,143,69,74
False,8216002,Au am Rhein,18 - 20 Jahre,76,36,40
False,8216002,Au am Rhein,20 - 25 Jahre,169,84,85
False,8216002,Au am Rhein,25 - 30 Jahre,151,86,65
False,8216002,Au am Rhein,30 - 35 Jahre,177,86,91
False,8216002,Au am Rhein,35 - 40 Jahre,193,82,111
False,8216002,Au am Rhein,40 - 45 Jahre,310,168,142
False,8216002,Au am Rhein,45 - 50 Jahre,344,163,181
False,8216002,Au am Rhein,50 - 55 Jahre,314,165,149
False,8216002,Au am Rhein,55 - 60 Jahre,203,107,96
False,8216002,Au am Rhein,60 - 65 Jahre,184,95,89
False,8216002,Au am Rhein,65 - 75 Jahre,336,148,188
False,8216002,Au am Rhein,75 und mehr Jahre,272,108,164
False,8216002,Au am Rhein,Insgesamt,3350,1646,1704
False,8216005,Bietigheim,unter 3 Jahre,143,80,63
False,8216005,Bietigheim,3 -  6 Jahre,146,69,77
False,8216005,Bietigheim,6 - 10 Jahre,197,106,91
False,8216005,Bietigheim,10 - 15 Jahre,299,152,147
False,8216005,Bietigheim,15 - 18 Jahre,187,88,99
False,8216005,Bietigheim,18 - 20 Jahre,138,69,69
False,8216005,Bietigheim,20 - 25 Jahre,343,177,166
False,8216005,Bietigheim,25 - 30 Jahre,336,164,172
False,8216005,Bietigheim,30 - 35 Jahre,308,152,156
False,8216005,Bietigheim,35 - 40 Jahre,338,181,157
False,8216005,Bietigheim,40 - 45 Jahre,539,269,270
False,8216005,Bietigheim,45 - 50 Jahre,517,256,261
False,8216005,Bietigheim,50 - 55 Jahre,502,241,261
False,8216005,Bietigheim,55 - 60 Jahre,425,221,204
False,8216005,Bietigheim,60 - 65 Jahre,355,177,178
False,8216005,Bietigheim,65 - 75 Jahre,614,279,335
False,8216005,Bietigheim,75 und mehr Jahre,589,205,384
False,8216005,Bietigheim,Insgesamt,5976,2886,3090
False,8216006,Bischweier,unter 3 Jahre,64,28,36
False,8216006,Bischweier,3 -  6 Jahre,70,33,37
False,8216006,Bischweier,6 - 10 Jahre,115,62,53
False,8216006,Bischweier,10 - 15 Jahre,175,83,92
False,8216006,Bischweier,15 - 18 Jahre,104,49,55
False,8216006,Bischweier,18 - 20 Jahre,66,33,33
False,8216006,Bischweier,20 - 25 Jahre,138,76,62
False,8216006,Bischweier,25 - 30 Jahre,182,90,92
False,8216006,Bischweier,30 - 35 Jahre,165,80,85
False,8216006,Bischweier,35 - 40 Jahre,199,82,117
False,8216006,Bischweier,40 - 45 Jahre,309,147,162
False,8216006,Bischweier,45 - 50 Jahre,299,156,143
False,8216006,Bischweier,50 - 55 Jahre,223,108,115
False,8216006,Bischweier,55 - 60 Jahre,229,116,113
False,8216006,Bischweier,60 - 65 Jahre,163,79,84
False,8216006,Bischweier,65 - 75 Jahre,336,160,176
False,8216006,Bischweier,75 und mehr Jahre,263,121,142
False,8216006,Bischweier,Insgesamt,3100,1503,1597
False,8216007,"Bühl, Stadt",unter 3 Jahre,698,373,325
False,8216007,"Bühl, Stadt",3 -  6 Jahre,759,388,371
False,8216007,"Bühl, Stadt",6 - 10 Jahre,1138,569,569
False,8216007,"Bühl, Stadt",10 - 15 Jahre,1668,852,816
False,8216007,"Bühl, Stadt",15 - 18 Jahre,1074,554,520
False,8216007,"Bühl, Stadt",18 - 20 Jahre,684,362,322
False,8216007,"Bühl, Stadt",20 - 25 Jahre,1516,799,717
False,8216007,"Bühl, Stadt",25 - 30 Jahre,1575,811,764
False,8216007,"Bühl, Stadt",30 - 35 Jahre,1609,799,810
False,8216007,"Bühl, Stadt",35 - 40 Jahre,1892,904,988
False,8216007,"Bühl, Stadt",40 - 45 Jahre,2460,1234,1226
False,8216007,"Bühl, Stadt",45 - 50 Jahre,2709,1339,1370
False,8216007,"Bühl, Stadt",50 - 55 Jahre,2253,1132,1121
False,8216007,"Bühl, Stadt",55 - 60 Jahre,1977,952,1025
False,8216007,"Bühl, Stadt",60 - 65 Jahre,1625,813,812
False,8216007,"Bühl, Stadt",65 - 75 Jahre,3065,1474,1591
False,8216007,"Bühl, Stadt",75 und mehr Jahre,2750,1026,1724
False,8216007,"Bühl, Stadt",Insgesamt,29452,14381,15071
False,8216008,Bühlertal,unter 3 Jahre,187,91,96
False,8216008,Bühlertal,3 -  6 Jahre,197,100,97
False,8216008,Bühlertal,6 - 10 Jahre,283,156,127
False,8216008,Bühlertal,10 - 15 Jahre,374,189,185
False,8216008,Bühlertal,15 - 18 Jahre,237,111,126
False,8216008,Bühlertal,18 - 20 Jahre,159,87,72
False,8216008,Bühlertal,20 - 25 Jahre,439,218,221
False,8216008,Bühlertal,25 - 30 Jahre,447,240,207
False,8216008,Bühlertal,30 - 35 Jahre,438,225,213
False,8216008,Bühlertal,35 - 40 Jahre,452,224,228
False,8216008,Bühlertal,40 - 45 Jahre,622,341,281
False,8216008,Bühlertal,45 - 50 Jahre,746,373,373
False,8216008,Bühlertal,50 - 55 Jahre,635,312,323
False,8216008,Bühlertal,55 - 60 Jahre,568,302,266
False,8216008,Bühlertal,60 - 65 Jahre,443,242,201
False,8216008,Bühlertal,65 - 75 Jahre,920,441,479
False,8216008,Bühlertal,75 und mehr Jahre,799,304,495
False,8216008,Bühlertal,Insgesamt,7946,3956,3990
False,8216009,Durmersheim,unter 3 Jahre,303,149,154
False,8216009,Durmersheim,3 -  6 Jahre,312,166,146
False,8216009,Durmersheim,6 - 10 Jahre,476,245,231
False,8216009,Durmersheim,10 - 15 Jahre,648,347,301
False,8216009,Durmersheim,15 - 18 Jahre,373,199,174
False,8216009,Durmersheim,18 - 20 Jahre,239,128,111
False,8216009,Durmersheim,20 - 25 Jahre,639,314,325
False,8216009,Durmersheim,25 - 30 Jahre,664,325,339
False,8216009,Durmersheim,30 - 35 Jahre,642,311,331
False,8216009,Durmersheim,35 - 40 Jahre,858,422,436
False,8216009,Durmersheim,40 - 45 Jahre,1062,531,531
False,8216009,Durmersheim,45 - 50 Jahre,1151,577,574
False,8216009,Durmersheim,50 - 55 Jahre,1008,510,498
False,8216009,Durmersheim,55 - 60 Jahre,810,377,433
False,8216009,Durmersheim,60 - 65 Jahre,734,381,353
False,8216009,Durmersheim,65 - 75 Jahre,1258,605,653
False,8216009,Durmersheim,75 und mehr Jahre,1012,434,578
False,8216009,Durmersheim,Insgesamt,12189,6021,6168
False,8216012,Elchesheim-Illingen,unter 3 Jahre,83,43,40
False,8216012,Elchesheim-Illingen,3 -  6 Jahre,90,57,33
False,8216012,Elchesheim-Illingen,6 - 10 Jahre,123,48,75
False,8216012,Elchesheim-Illingen,10 - 15 Jahre,211,109,102
False,8216012,Elchesheim-Illingen,15 - 18 Jahre,108,56,52
False,8216012,Elchesheim-Illingen,18 - 20 Jahre,80,44,36
False,8216012,Elchesheim-Illingen,20 - 25 Jahre,159,85,74
False,8216012,Elchesheim-Illingen,25 - 30 Jahre,173,80,93
False,8216012,Elchesheim-Illingen,30 - 35 Jahre,160,72,88
False,8216012,Elchesheim-Illingen,35 - 40 Jahre,205,100,105
False,8216012,Elchesheim-Illingen,40 - 45 Jahre,283,137,146
False,8216012,Elchesheim-Illingen,45 - 50 Jahre,277,144,133
False,8216012,Elchesheim-Illingen,50 - 55 Jahre,311,147,164
False,8216012,Elchesheim-Illingen,55 - 60 Jahre,241,132,109
False,8216012,Elchesheim-Illingen,60 - 65 Jahre,181,97,84
False,8216012,Elchesheim-Illingen,65 - 75 Jahre,327,162,165
False,8216012,Elchesheim-Illingen,75 und mehr Jahre,278,117,161
False,8216012,Elchesheim-Illingen,Insgesamt,3290,1630,1660
False,8216013,Forbach,unter 3 Jahre,82,44,38
False,8216013,Forbach,3 -  6 Jahre,102,46,56
False,8216013,Forbach,6 - 10 Jahre,172,91,81
False,8216013,Forbach,10 - 15 Jahre,312,166,146
False,8216013,Forbach,15 - 18 Jahre,182,92,90
False,8216013,Forbach,18 - 20 Jahre,143,83,60
False,8216013,Forbach,20 - 25 Jahre,265,151,114
False,8216013,Forbach,25 - 30 Jahre,235,105,130
False,8216013,Forbach,30 - 35 Jahre,230,128,102
False,8216013,Forbach,35 - 40 Jahre,286,126,160
False,8216013,Forbach,40 - 45 Jahre,440,214,226
False,8216013,Forbach,45 - 50 Jahre,509,265,244
False,8216013,Forbach,50 - 55 Jahre,422,230,192
False,8216013,Forbach,55 - 60 Jahre,383,196,187
False,8216013,Forbach,60 - 65 Jahre,278,136,142
False,8216013,Forbach,65 - 75 Jahre,661,316,345
False,8216013,Forbach,75 und mehr Jahre,589,223,366
False,8216013,Forbach,Insgesamt,5291,2612,2679
False,8216015,"Gaggenau, Stadt",unter 3 Jahre,609,342,267
False,8216015,"Gaggenau, Stadt",3 -  6 Jahre,693,347,346
False,8216015,"Gaggenau, Stadt",6 - 10 Jahre,1057,533,524
False,8216015,"Gaggenau, Stadt",10 - 15 Jahre,1452,723,729
False,8216015,"Gaggenau, Stadt",15 - 18 Jahre,975,509,466
False,8216015,"Gaggenau, Stadt",18 - 20 Jahre,622,315,307
False,8216015,"Gaggenau, Stadt",20 - 25 Jahre,1473,748,725
False,8216015,"Gaggenau, Stadt",25 - 30 Jahre,1426,713,713
False,8216015,"Gaggenau, Stadt",30 - 35 Jahre,1522,754,768
False,8216015,"Gaggenau, Stadt",35 - 40 Jahre,1658,836,822
False,8216015,"Gaggenau, Stadt",40 - 45 Jahre,2287,1136,1151
False,8216015,"Gaggenau, Stadt",45 - 50 Jahre,2523,1274,1249
False,8216015,"Gaggenau, Stadt",50 - 55 Jahre,2149,1083,1066
False,8216015,"Gaggenau, Stadt",55 - 60 Jahre,1982,963,1019
False,8216015,"Gaggenau, Stadt",60 - 65 Jahre,1824,918,906
False,8216015,"Gaggenau, Stadt",65 - 75 Jahre,3671,1724,1947
False,8216015,"Gaggenau, Stadt",75 und mehr Jahre,3109,1188,1921
False,8216015,"Gaggenau, Stadt",Insgesamt,29032,14106,14926
False,8216017,"Gernsbach, Stadt",unter 3 Jahre,276,155,121
False,8216017,"Gernsbach, Stadt",3 -  6 Jahre,312,176,136
False,8216017,"Gernsbach, Stadt",6 - 10 Jahre,486,263,223
False,8216017,"Gernsbach, Stadt",10 - 15 Jahre,713,364,349
False,8216017,"Gernsbach, Stadt",15 - 18 Jahre,460,219,241
False,8216017,"Gernsbach, Stadt",18 - 20 Jahre,334,177,157
False,8216017,"Gernsbach, Stadt",20 - 25 Jahre,778,400,378
False,8216017,"Gernsbach, Stadt",25 - 30 Jahre,693,380,313
False,8216017,"Gernsbach, Stadt",30 - 35 Jahre,684,330,354
False,8216017,"Gernsbach, Stadt",35 - 40 Jahre,814,415,399
False,8216017,"Gernsbach, Stadt",40 - 45 Jahre,1163,543,620
False,8216017,"Gernsbach, Stadt",45 - 50 Jahre,1289,686,603
False,8216017,"Gernsbach, Stadt",50 - 55 Jahre,1166,586,580
False,8216017,"Gernsbach, Stadt",55 - 60 Jahre,1007,497,510
False,8216017,"Gernsbach, Stadt",60 - 65 Jahre,878,426,452
False,8216017,"Gernsbach, Stadt",65 - 75 Jahre,1758,843,915
False,8216017,"Gernsbach, Stadt",75 und mehr Jahre,1478,569,909
False,8216017,"Gernsbach, Stadt",Insgesamt,14289,7029,7260
False,8216022,Hügelsheim,unter 3 Jahre,143,71,72
False,8216022,Hügelsheim,3 -  6 Jahre,150,86,64
False,8216022,Hügelsheim,6 - 10 Jahre,221,133,88
False,8216022,Hügelsheim,10 - 15 Jahre,367,187,180
False,8216022,Hügelsheim,15 - 18 Jahre,210,103,107
False,8216022,Hügelsheim,18 - 20 Jahre,140,69,71
False,8216022,Hügelsheim,20 - 25 Jahre,313,162,151
False,8216022,Hügelsheim,25 - 30 Jahre,350,178,172
False,8216022,Hügelsheim,30 - 35 Jahre,298,139,159
False,8216022,Hügelsheim,35 - 40 Jahre,344,153,191
False,8216022,Hügelsheim,40 - 45 Jahre,403,202,201
False,8216022,Hügelsheim,45 - 50 Jahre,501,256,245
False,8216022,Hügelsheim,50 - 55 Jahre,445,235,210
False,8216022,Hügelsheim,55 - 60 Jahre,295,149,146
False,8216022,Hügelsheim,60 - 65 Jahre,166,80,86
False,8216022,Hügelsheim,65 - 75 Jahre,311,152,159
False,8216022,Hügelsheim,75 und mehr Jahre,234,101,133
False,8216022,Hügelsheim,Insgesamt,4891,2456,2435
False,8216023,Iffezheim,unter 3 Jahre,99,49,50
False,8216023,Iffezheim,3 -  6 Jahre,104,66,38
False,8216023,Iffezheim,6 - 10 Jahre,173,82,91
False,8216023,Iffezheim,10 - 15 Jahre,259,148,111
False,8216023,Iffezheim,15 - 18 Jahre,188,91,97
False,8216023,Iffezheim,18 - 20 Jahre,123,63,60
False,8216023,Iffezheim,20 - 25 Jahre,314,154,160
False,8216023,Iffezheim,25 - 30 Jahre,297,149,148
False,8216023,Iffezheim,30 - 35 Jahre,257,127,130
False,8216023,Iffezheim,35 - 40 Jahre,277,144,133
False,8216023,Iffezheim,40 - 45 Jahre,409,200,209
False,8216023,Iffezheim,45 - 50 Jahre,492,243,249
False,8216023,Iffezheim,50 - 55 Jahre,425,224,201
False,8216023,Iffezheim,55 - 60 Jahre,367,192,175
False,8216023,Iffezheim,60 - 65 Jahre,237,122,115
False,8216023,Iffezheim,65 - 75 Jahre,480,231,249
False,8216023,Iffezheim,75 und mehr Jahre,396,156,240
False,8216023,Iffezheim,Insgesamt,4897,2441,2456
False,8216024,"Kuppenheim, Stadt",unter 3 Jahre,190,95,95
False,8216024,"Kuppenheim, Stadt",3 -  6 Jahre,213,110,103
False,8216024,"Kuppenheim, Stadt",6 - 10 Jahre,257,125,132
False,8216024,"Kuppenheim, Stadt",10 - 15 Jahre,378,205,173
False,8216024,"Kuppenheim, Stadt",15 - 18 Jahre,253,134,119
False,8216024,"Kuppenheim, Stadt",18 - 20 Jahre,172,87,85
False,8216024,"Kuppenheim, Stadt",20 - 25 Jahre,418,227,191
False,8216024,"Kuppenheim, Stadt",25 - 30 Jahre,424,205,219
False,8216024,"Kuppenheim, Stadt",30 - 35 Jahre,425,225,200
False,8216024,"Kuppenheim, Stadt",35 - 40 Jahre,519,264,255
False,8216024,"Kuppenheim, Stadt",40 - 45 Jahre,642,334,308
False,8216024,"Kuppenheim, Stadt",45 - 50 Jahre,675,346,329
False,8216024,"Kuppenheim, Stadt",50 - 55 Jahre,575,275,300
False,8216024,"Kuppenheim, Stadt",55 - 60 Jahre,536,268,268
False,8216024,"Kuppenheim, Stadt",60 - 65 Jahre,478,235,243
False,8216024,"Kuppenheim, Stadt",65 - 75 Jahre,938,431,507
False,8216024,"Kuppenheim, Stadt",75 und mehr Jahre,746,298,448
False,8216024,"Kuppenheim, Stadt",Insgesamt,7839,3864,3975
False,8216028,"Lichtenau, Stadt",unter 3 Jahre,107,52,55
False,8216028,"Lichtenau, Stadt",3 -  6 Jahre,139,82,57
False,8216028,"Lichtenau, Stadt",6 - 10 Jahre,225,112,113
False,8216028,"Lichtenau, Stadt",10 - 15 Jahre,270,129,141
False,8216028,"Lichtenau, Stadt",15 - 18 Jahre,206,111,95
False,8216028,"Lichtenau, Stadt",18 - 20 Jahre,135,70,65
False,8216028,"Lichtenau, Stadt",20 - 25 Jahre,287,150,137
False,8216028,"Lichtenau, Stadt",25 - 30 Jahre,253,124,129
False,8216028,"Lichtenau, Stadt",30 - 35 Jahre,266,133,133
False,8216028,"Lichtenau, Stadt",35 - 40 Jahre,313,147,166
False,8216028,"Lichtenau, Stadt",40 - 45 Jahre,424,208,216
False,8216028,"Lichtenau, Stadt",45 - 50 Jahre,463,234,229
False,8216028,"Lichtenau, Stadt",50 - 55 Jahre,444,227,217
False,8216028,"Lichtenau, Stadt",55 - 60 Jahre,328,163,165
False,8216028,"Lichtenau, Stadt",60 - 65 Jahre,281,151,130
False,8216028,"Lichtenau, Stadt",65 - 75 Jahre,469,234,235
False,8216028,"Lichtenau, Stadt",75 und mehr Jahre,370,147,223
False,8216028,"Lichtenau, Stadt",Insgesamt,4980,2474,2506
False,8216029,Loffenau,unter 3 Jahre,49,23,26
False,8216029,Loffenau,3 -  6 Jahre,47,23,24
False,8216029,Loffenau,6 - 10 Jahre,94,42,52
False,8216029,Loffenau,10 - 15 Jahre,149,79,70
False,8216029,Loffenau,15 - 18 Jahre,100,48,52
False,8216029,Loffenau,18 - 20 Jahre,64,31,33
False,8216029,Loffenau,20 - 25 Jahre,157,86,71
False,8216029,Loffenau,25 - 30 Jahre,117,53,64
False,8216029,Loffenau,30 - 35 Jahre,85,49,36
False,8216029,Loffenau,35 - 40 Jahre,145,71,74
False,8216029,Loffenau,40 - 45 Jahre,239,116,123
False,8216029,Loffenau,45 - 50 Jahre,268,147,121
False,8216029,Loffenau,50 - 55 Jahre,213,120,93
False,8216029,Loffenau,55 - 60 Jahre,165,87,78
False,8216029,Loffenau,60 - 65 Jahre,149,83,66
False,8216029,Loffenau,65 - 75 Jahre,313,146,167
False,8216029,Loffenau,75 und mehr Jahre,221,100,121
False,8216029,Loffenau,Insgesamt,2575,1304,1271
False,8216033,Muggensturm,unter 3 Jahre,136,71,65
False,8216033,Muggensturm,3 -  6 Jahre,171,81,90
False,8216033,Muggensturm,6 - 10 Jahre,232,125,107
False,8216033,Muggensturm,10 - 15 Jahre,326,151,175
False,8216033,Muggensturm,15 - 18 Jahre,187,93,94
False,8216033,Muggensturm,18 - 20 Jahre,155,76,79
False,8216033,Muggensturm,20 - 25 Jahre,344,175,169
False,8216033,Muggensturm,25 - 30 Jahre,325,179,146
False,8216033,Muggensturm,30 - 35 Jahre,325,149,176
False,8216033,Muggensturm,35 - 40 Jahre,356,193,163
False,8216033,Muggensturm,40 - 45 Jahre,509,259,250
False,8216033,Muggensturm,45 - 50 Jahre,568,277,291
False,8216033,Muggensturm,50 - 55 Jahre,541,263,278
False,8216033,Muggensturm,55 - 60 Jahre,463,235,228
False,8216033,Muggensturm,60 - 65 Jahre,355,182,173
False,8216033,Muggensturm,65 - 75 Jahre,652,316,336
False,8216033,Muggensturm,75 und mehr Jahre,494,194,300
False,8216033,Muggensturm,Insgesamt,6139,3019,3120
False,8216039,Ötigheim,unter 3 Jahre,113,61,52
False,8216039,Ötigheim,3 -  6 Jahre,104,50,54
False,8216039,Ötigheim,6 - 10 Jahre,158,87,71
False,8216039,Ötigheim,10 - 15 Jahre,260,132,128
False,8216039,Ötigheim,15 - 18 Jahre,161,94,67
False,8216039,Ötigheim,18 - 20 Jahre,103,51,52
False,8216039,Ötigheim,20 - 25 Jahre,247,131,116
False,8216039,Ötigheim,25 - 30 Jahre,288,146,142
False,8216039,Ötigheim,30 - 35 Jahre,220,106,114
False,8216039,Ötigheim,35 - 40 Jahre,272,129,143
False,8216039,Ötigheim,40 - 45 Jahre,394,193,201
False,8216039,Ötigheim,45 - 50 Jahre,362,173,189
False,8216039,Ötigheim,50 - 55 Jahre,364,192,172
False,8216039,Ötigheim,55 - 60 Jahre,333,154,179
False,8216039,Ötigheim,60 - 65 Jahre,295,149,146
False,8216039,Ötigheim,65 - 75 Jahre,463,233,230
False,8216039,Ötigheim,75 und mehr Jahre,356,152,204
False,8216039,Ötigheim,Insgesamt,4493,2233,2260
False,8216041,Ottersweier,unter 3 Jahre,116,50,66
False,8216041,Ottersweier,3 -  6 Jahre,166,79,87
False,8216041,Ottersweier,6 - 10 Jahre,238,132,106
False,8216041,Ottersweier,10 - 15 Jahre,358,185,173
False,8216041,Ottersweier,15 - 18 Jahre,219,109,110
False,8216041,Ottersweier,18 - 20 Jahre,167,83,84
False,8216041,Ottersweier,20 - 25 Jahre,362,204,158
False,8216041,Ottersweier,25 - 30 Jahre,276,134,142
False,8216041,Ottersweier,30 - 35 Jahre,297,149,148
False,8216041,Ottersweier,35 - 40 Jahre,342,184,158
False,8216041,Ottersweier,40 - 45 Jahre,529,259,270
False,8216041,Ottersweier,45 - 50 Jahre,577,309,268
False,8216041,Ottersweier,50 - 55 Jahre,520,265,255
False,8216041,Ottersweier,55 - 60 Jahre,435,231,204
False,8216041,Ottersweier,60 - 65 Jahre,360,174,186
False,8216041,Ottersweier,65 - 75 Jahre,623,323,300
False,8216041,Ottersweier,75 und mehr Jahre,550,210,340
False,8216041,Ottersweier,Insgesamt,6135,3080,3055
False,8216043,"Rastatt, Stadt",unter 3 Jahre,1235,663,572
False,8216043,"Rastatt, Stadt",3 -  6 Jahre,1230,625,605
False,8216043,"Rastatt, Stadt",6 - 10 Jahre,1749,895,854
False,8216043,"Rastatt, Stadt",10 - 15 Jahre,2125,1089,1036
False,8216043,"Rastatt, Stadt",15 - 18 Jahre,1456,771,685
False,8216043,"Rastatt, Stadt",18 - 20 Jahre,1088,573,515
False,8216043,"Rastatt, Stadt",20 - 25 Jahre,2994,1589,1405
False,8216043,"Rastatt, Stadt",25 - 30 Jahre,3119,1522,1597
False,8216043,"Rastatt, Stadt",30 - 35 Jahre,2792,1373,1419
False,8216043,"Rastatt, Stadt",35 - 40 Jahre,2651,1295,1356
False,8216043,"Rastatt, Stadt",40 - 45 Jahre,3250,1729,1521
False,8216043,"Rastatt, Stadt",45 - 50 Jahre,3856,1976,1880
False,8216043,"Rastatt, Stadt",50 - 55 Jahre,3826,1995,1831
False,8216043,"Rastatt, Stadt",55 - 60 Jahre,3385,1689,1696
False,8216043,"Rastatt, Stadt",60 - 65 Jahre,2570,1226,1344
False,8216043,"Rastatt, Stadt",65 - 75 Jahre,5254,2378,2876
False,8216043,"Rastatt, Stadt",75 und mehr Jahre,4974,1910,3064
False,8216043,"Rastatt, Stadt",Insgesamt,47554,23298,24256
False,8216049,Sinzheim,unter 3 Jahre,259,112,147
False,8216049,Sinzheim,3 -  6 Jahre,268,132,136
False,8216049,Sinzheim,6 - 10 Jahre,432,219,213
False,8216049,Sinzheim,10 - 15 Jahre,652,339,313
False,8216049,Sinzheim,15 - 18 Jahre,385,220,165
False,8216049,Sinzheim,18 - 20 Jahre,263,137,126
False,8216049,Sinzheim,20 - 25 Jahre,575,294,281
False,8216049,Sinzheim,25 - 30 Jahre,558,285,273
False,8216049,Sinzheim,30 - 35 Jahre,575,263,312
False,8216049,Sinzheim,35 - 40 Jahre,630,268,362
False,8216049,Sinzheim,40 - 45 Jahre,1068,517,551
False,8216049,Sinzheim,45 - 50 Jahre,1116,570,546
False,8216049,Sinzheim,50 - 55 Jahre,932,446,486
False,8216049,Sinzheim,55 - 60 Jahre,787,416,371
False,8216049,Sinzheim,60 - 65 Jahre,605,294,311
False,8216049,Sinzheim,65 - 75 Jahre,1163,570,593
False,8216049,Sinzheim,75 und mehr Jahre,954,365,589
False,8216049,Sinzheim,Insgesamt,11222,5447,5775
False,8216052,Steinmauern,unter 3 Jahre,52,32,20
False,8216052,Steinmauern,3 -  6 Jahre,73,38,35
False,8216052,Steinmauern,6 - 10 Jahre,96,54,42
False,8216052,Steinmauern,10 - 15 Jahre,182,87,95
False,8216052,Steinmauern,15 - 18 Jahre,140,85,55
False,8216052,Steinmauern,18 - 20 Jahre,74,37,37
False,8216052,Steinmauern,20 - 25 Jahre,173,84,89
False,8216052,Steinmauern,25 - 30 Jahre,134,67,67
False,8216052,Steinmauern,30 - 35 Jahre,170,93,77
False,8216052,Steinmauern,35 - 40 Jahre,173,83,90
False,8216052,Steinmauern,40 - 45 Jahre,265,123,142
False,8216052,Steinmauern,45 - 50 Jahre,308,155,153
False,8216052,Steinmauern,50 - 55 Jahre,252,137,115
False,8216052,Steinmauern,55 - 60 Jahre,181,94,87
False,8216052,Steinmauern,60 - 65 Jahre,151,81,70
False,8216052,Steinmauern,65 - 75 Jahre,274,126,148
False,8216052,Steinmauern,75 und mehr Jahre,244,91,153
False,8216052,Steinmauern,Insgesamt,2942,1467,1475
False,8216059,Weisenbach,unter 3 Jahre,43,20,23
False,8216059,Weisenbach,3 -  6 Jahre,48,22,26
False,8216059,Weisenbach,6 - 10 Jahre,93,42,51
False,8216059,Weisenbach,10 - 15 Jahre,168,87,81
False,8216059,Weisenbach,15 - 18 Jahre,91,45,46
False,8216059,Weisenbach,18 - 20 Jahre,81,43,38
False,8216059,Weisenbach,20 - 25 Jahre,154,89,65
False,8216059,Weisenbach,25 - 30 Jahre,127,70,57
False,8216059,Weisenbach,30 - 35 Jahre,110,57,53
False,8216059,Weisenbach,35 - 40 Jahre,131,75,56
False,8216059,Weisenbach,40 - 45 Jahre,214,95,119
False,8216059,Weisenbach,45 - 50 Jahre,246,137,109
False,8216059,Weisenbach,50 - 55 Jahre,224,132,92
False,8216059,Weisenbach,55 - 60 Jahre,181,74,107
False,8216059,Weisenbach,60 - 65 Jahre,134,86,48
False,8216059,Weisenbach,65 - 75 Jahre,274,122,152
False,8216059,Weisenbach,75 und mehr Jahre,242,106,136
False,8216059,Weisenbach,Insgesamt,2561,1302,1259
False,8216063,Rheinmünster,unter 3 Jahre,170,102,68
False,8216063,Rheinmünster,3 -  6 Jahre,159,85,74
False,8216063,Rheinmünster,6 - 10 Jahre,273,134,139
False,8216063,Rheinmünster,10 - 15 Jahre,429,214,215
False,8216063,Rheinmünster,15 - 18 Jahre,252,130,122
False,8216063,Rheinmünster,18 - 20 Jahre,158,80,78
False,8216063,Rheinmünster,20 - 25 Jahre,383,207,176
False,8216063,Rheinmünster,25 - 30 Jahre,350,183,167
False,8216063,Rheinmünster,30 - 35 Jahre,366,167,199
False,8216063,Rheinmünster,35 - 40 Jahre,413,196,217
False,8216063,Rheinmünster,40 - 45 Jahre,624,331,293
False,8216063,Rheinmünster,45 - 50 Jahre,649,350,299
False,8216063,Rheinmünster,50 - 55 Jahre,519,295,224
False,8216063,Rheinmünster,55 - 60 Jahre,492,255,237
False,8216063,Rheinmünster,60 - 65 Jahre,321,160,161
False,8216063,Rheinmünster,65 - 75 Jahre,610,300,310
False,8216063,Rheinmünster,75 und mehr Jahre,478,197,281
False,8216063,Rheinmünster,Insgesamt,6646,3386,3260
False,8221,Stadtkreis Heidelberg,unter 3 Jahre,3759,1926,1833
False,8221,Stadtkreis Heidelberg,3 -  6 Jahre,3327,1675,1652
False,8221,Stadtkreis Heidelberg,6 - 10 Jahre,3959,2044,1915
False,8221,Stadtkreis Heidelberg,10 - 15 Jahre,5235,2657,2578
False,8221,Stadtkreis Heidelberg,15 - 18 Jahre,3203,1642,1561
False,8221,Stadtkreis Heidelberg,18 - 20 Jahre,2970,1433,1537
False,8221,Stadtkreis Heidelberg,20 - 25 Jahre,14101,5906,8195
False,8221,Stadtkreis Heidelberg,25 - 30 Jahre,14859,6729,8130
False,8221,Stadtkreis Heidelberg,30 - 35 Jahre,11843,5807,6036
False,8221,Stadtkreis Heidelberg,35 - 40 Jahre,9928,4918,5010
False,8221,Stadtkreis Heidelberg,40 - 45 Jahre,11790,5861,5929
False,8221,Stadtkreis Heidelberg,45 - 50 Jahre,12769,6416,6353
False,8221,Stadtkreis Heidelberg,50 - 55 Jahre,10058,5035,5023
False,8221,Stadtkreis Heidelberg,55 - 60 Jahre,8316,4075,4241
False,8221,Stadtkreis Heidelberg,60 - 65 Jahre,7067,3461,3606
False,8221,Stadtkreis Heidelberg,65 - 75 Jahre,12828,6036,6792
False,8221,Stadtkreis Heidelberg,75 und mehr Jahre,11300,4059,7241
False,8221,Stadtkreis Heidelberg,Insgesamt,147312,69680,77632
False,8221000,"Heidelberg, Stadt",unter 3 Jahre,3759,1926,1833
False,8221000,"Heidelberg, Stadt",3 -  6 Jahre,3327,1675,1652
False,8221000,"Heidelberg, Stadt",6 - 10 Jahre,3959,2044,1915
False,8221000,"Heidelberg, Stadt",10 - 15 Jahre,5235,2657,2578
False,8221000,"Heidelberg, Stadt",15 - 18 Jahre,3203,1642,1561
False,8221000,"Heidelberg, Stadt",18 - 20 Jahre,2970,1433,1537
False,8221000,"Heidelberg, Stadt",20 - 25 Jahre,14101,5906,8195
False,8221000,"Heidelberg, Stadt",25 - 30 Jahre,14859,6729,8130
False,8221000,"Heidelberg, Stadt",30 - 35 Jahre,11843,5807,6036
False,8221000,"Heidelberg, Stadt",35 - 40 Jahre,9928,4918,5010
False,8221000,"Heidelberg, Stadt",40 - 45 Jahre,11790,5861,5929
False,8221000,"Heidelberg, Stadt",45 - 50 Jahre,12769,6416,6353
False,8221000,"Heidelberg, Stadt",50 - 55 Jahre,10058,5035,5023
False,8221000,"Heidelberg, Stadt",55 - 60 Jahre,8316,4075,4241
False,8221000,"Heidelberg, Stadt",60 - 65 Jahre,7067,3461,3606
False,8221000,"Heidelberg, Stadt",65 - 75 Jahre,12828,6036,6792
False,8221000,"Heidelberg, Stadt",75 und mehr Jahre,11300,4059,7241
False,8221000,"Heidelberg, Stadt",Insgesamt,147312,69680,77632
False,8222,Stadtkreis Mannheim,unter 3 Jahre,8096,4047,4049
False,8222,Stadtkreis Mannheim,3 -  6 Jahre,7618,3927,3691
False,8222,Stadtkreis Mannheim,6 - 10 Jahre,9856,5017,4839
False,8222,Stadtkreis Mannheim,10 - 15 Jahre,13237,6662,6575
False,8222,Stadtkreis Mannheim,15 - 18 Jahre,8147,4236,3911
False,8222,Stadtkreis Mannheim,18 - 20 Jahre,6372,3190,3182
False,8222,Stadtkreis Mannheim,20 - 25 Jahre,21636,10767,10869
False,8222,Stadtkreis Mannheim,25 - 30 Jahre,23656,11862,11794
False,8222,Stadtkreis Mannheim,30 - 35 Jahre,21999,11383,10616
False,8222,Stadtkreis Mannheim,35 - 40 Jahre,20598,10636,9962
False,8222,Stadtkreis Mannheim,40 - 45 Jahre,25076,13158,11918
False,8222,Stadtkreis Mannheim,45 - 50 Jahre,27803,14572,13231
False,8222,Stadtkreis Mannheim,50 - 55 Jahre,22795,11931,10864
False,8222,Stadtkreis Mannheim,55 - 60 Jahre,19084,9651,9433
False,8222,Stadtkreis Mannheim,60 - 65 Jahre,17581,8628,8953
False,8222,Stadtkreis Mannheim,65 - 75 Jahre,32172,15618,16554
False,8222,Stadtkreis Mannheim,75 und mehr Jahre,27448,10417,17031
False,8222,Stadtkreis Mannheim,Insgesamt,313174,155702,157472
False,8222000,"Mannheim, Universitätsstadt",unter 3 Jahre,8096,4047,4049
False,8222000,"Mannheim, Universitätsstadt",3 -  6 Jahre,7618,3927,3691
False,8222000,"Mannheim, Universitätsstadt",6 - 10 Jahre,9856,5017,4839
False,8222000,"Mannheim, Universitätsstadt",10 - 15 Jahre,13237,6662,6575
False,8222000,"Mannheim, Universitätsstadt",15 - 18 Jahre,8147,4236,3911
False,8222000,"Mannheim, Universitätsstadt",18 - 20 Jahre,6372,3190,3182
False,8222000,"Mannheim, Universitätsstadt",20 - 25 Jahre,21636,10767,10869
False,8222000,"Mannheim, Universitätsstadt",25 - 30 Jahre,23656,11862,11794
False,8222000,"Mannheim, Universitätsstadt",30 - 35 Jahre,21999,11383,10616
False,8222000,"Mannheim, Universitätsstadt",35 - 40 Jahre,20598,10636,9962
False,8222000,"Mannheim, Universitätsstadt",40 - 45 Jahre,25076,13158,11918
False,8222000,"Mannheim, Universitätsstadt",45 - 50 Jahre,27803,14572,13231
False,8222000,"Mannheim, Universitätsstadt",50 - 55 Jahre,22795,11931,10864
False,8222000,"Mannheim, Universitätsstadt",55 - 60 Jahre,19084,9651,9433
False,8222000,"Mannheim, Universitätsstadt",60 - 65 Jahre,17581,8628,8953
False,8222000,"Mannheim, Universitätsstadt",65 - 75 Jahre,32172,15618,16554
False,8222000,"Mannheim, Universitätsstadt",75 und mehr Jahre,27448,10417,17031
False,8222000,"Mannheim, Universitätsstadt",Insgesamt,313174,155702,157472
False,8225,Landkreis Neckar-Odenwald-Kreis,unter 3 Jahre,3325,1706,1619
False,8225,Landkreis Neckar-Odenwald-Kreis,3 -  6 Jahre,3721,1885,1836
False,8225,Landkreis Neckar-Odenwald-Kreis,6 - 10 Jahre,5642,2920,2722
False,8225,Landkreis Neckar-Odenwald-Kreis,10 - 15 Jahre,8059,4239,3820
False,8225,Landkreis Neckar-Odenwald-Kreis,15 - 18 Jahre,5090,2641,2449
False,8225,Landkreis Neckar-Odenwald-Kreis,18 - 20 Jahre,3696,1921,1775
False,8225,Landkreis Neckar-Odenwald-Kreis,20 - 25 Jahre,8554,4540,4014
False,8225,Landkreis Neckar-Odenwald-Kreis,25 - 30 Jahre,7904,4112,3792
False,8225,Landkreis Neckar-Odenwald-Kreis,30 - 35 Jahre,7734,3948,3786
False,8225,Landkreis Neckar-Odenwald-Kreis,35 - 40 Jahre,8651,4262,4389
False,8225,Landkreis Neckar-Odenwald-Kreis,40 - 45 Jahre,12153,6475,5678
False,8225,Landkreis Neckar-Odenwald-Kreis,45 - 50 Jahre,13347,6937,6410
False,8225,Landkreis Neckar-Odenwald-Kreis,50 - 55 Jahre,11874,6048,5826
False,8225,Landkreis Neckar-Odenwald-Kreis,55 - 60 Jahre,9966,5048,4918
False,8225,Landkreis Neckar-Odenwald-Kreis,60 - 65 Jahre,8471,4274,4197
False,8225,Landkreis Neckar-Odenwald-Kreis,65 - 75 Jahre,15306,7425,7881
False,8225,Landkreis Neckar-Odenwald-Kreis,75 und mehr Jahre,13513,5147,8366
False,8225,Landkreis Neckar-Odenwald-Kreis,Insgesamt,147006,73528,73478
False,8225001,"Adelsheim, Stadt",unter 3 Jahre,106,55,51
False,8225001,"Adelsheim, Stadt",3 -  6 Jahre,132,74,58
False,8225001,"Adelsheim, Stadt",6 - 10 Jahre,218,113,105
False,8225001,"Adelsheim, Stadt",10 - 15 Jahre,262,144,118
False,8225001,"Adelsheim, Stadt",15 - 18 Jahre,149,78,71
False,8225001,"Adelsheim, Stadt",18 - 20 Jahre,134,65,69
False,8225001,"Adelsheim, Stadt",20 - 25 Jahre,249,142,107
False,8225001,"Adelsheim, Stadt",25 - 30 Jahre,255,130,125
False,8225001,"Adelsheim, Stadt",30 - 35 Jahre,242,121,121
False,8225001,"Adelsheim, Stadt",35 - 40 Jahre,336,167,169
False,8225001,"Adelsheim, Stadt",40 - 45 Jahre,736,514,222
False,8225001,"Adelsheim, Stadt",45 - 50 Jahre,462,244,218
False,8225001,"Adelsheim, Stadt",50 - 55 Jahre,388,220,168
False,8225001,"Adelsheim, Stadt",55 - 60 Jahre,315,156,159
False,8225001,"Adelsheim, Stadt",60 - 65 Jahre,267,137,130
False,8225001,"Adelsheim, Stadt",65 - 75 Jahre,554,280,274
False,8225001,"Adelsheim, Stadt",75 und mehr Jahre,502,186,316
False,8225001,"Adelsheim, Stadt",Insgesamt,5307,2826,2481
False,8225002,Aglasterhausen,unter 3 Jahre,116,65,51
False,8225002,Aglasterhausen,3 -  6 Jahre,118,48,70
False,8225002,Aglasterhausen,6 - 10 Jahre,215,115,100
False,8225002,Aglasterhausen,10 - 15 Jahre,296,135,161
False,8225002,Aglasterhausen,15 - 18 Jahre,174,92,82
False,8225002,Aglasterhausen,18 - 20 Jahre,113,71,42
False,8225002,Aglasterhausen,20 - 25 Jahre,266,136,130
False,8225002,Aglasterhausen,25 - 30 Jahre,250,124,126
False,8225002,Aglasterhausen,30 - 35 Jahre,276,138,138
False,8225002,Aglasterhausen,35 - 40 Jahre,299,137,162
False,8225002,Aglasterhausen,40 - 45 Jahre,427,224,203
False,8225002,Aglasterhausen,45 - 50 Jahre,413,217,196
False,8225002,Aglasterhausen,50 - 55 Jahre,415,218,197
False,8225002,Aglasterhausen,55 - 60 Jahre,317,146,171
False,8225002,Aglasterhausen,60 - 65 Jahre,267,134,133
False,8225002,Aglasterhausen,65 - 75 Jahre,446,212,234
False,8225002,Aglasterhausen,75 und mehr Jahre,474,173,301
False,8225002,Aglasterhausen,Insgesamt,4882,2385,2497
False,8225009,Billigheim,unter 3 Jahre,127,65,62
False,8225009,Billigheim,3 -  6 Jahre,160,91,69
False,8225009,Billigheim,6 - 10 Jahre,246,124,122
False,8225009,Billigheim,10 - 15 Jahre,377,216,161
False,8225009,Billigheim,15 - 18 Jahre,200,106,94
False,8225009,Billigheim,18 - 20 Jahre,137,66,71
False,8225009,Billigheim,20 - 25 Jahre,321,174,147
False,8225009,Billigheim,25 - 30 Jahre,290,136,154
False,8225009,Billigheim,30 - 35 Jahre,313,166,147
False,8225009,Billigheim,35 - 40 Jahre,379,191,188
False,8225009,Billigheim,40 - 45 Jahre,484,241,243
False,8225009,Billigheim,45 - 50 Jahre,532,275,257
False,8225009,Billigheim,50 - 55 Jahre,493,269,224
False,8225009,Billigheim,55 - 60 Jahre,360,190,170
False,8225009,Billigheim,60 - 65 Jahre,310,155,155
False,8225009,Billigheim,65 - 75 Jahre,586,294,292
False,8225009,Billigheim,75 und mehr Jahre,427,166,261
False,8225009,Billigheim,Insgesamt,5742,2925,2817
False,8225010,Binau,unter 3 Jahre,26,11,15
False,8225010,Binau,3 -  6 Jahre,34,19,15
False,8225010,Binau,6 - 10 Jahre,43,18,25
False,8225010,Binau,10 - 15 Jahre,72,49,23
False,8225010,Binau,15 - 18 Jahre,33,18,15
False,8225010,Binau,18 - 20 Jahre,30,17,13
False,8225010,Binau,20 - 25 Jahre,63,41,22
False,8225010,Binau,25 - 30 Jahre,69,31,38
False,8225010,Binau,30 - 35 Jahre,69,37,32
False,8225010,Binau,35 - 40 Jahre,94,48,46
False,8225010,Binau,40 - 45 Jahre,131,64,67
False,8225010,Binau,45 - 50 Jahre,119,62,57
False,8225010,Binau,50 - 55 Jahre,114,56,58
False,8225010,Binau,55 - 60 Jahre,108,56,52
False,8225010,Binau,60 - 65 Jahre,102,52,50
False,8225010,Binau,65 - 75 Jahre,166,84,82
False,8225010,Binau,75 und mehr Jahre,105,57,48
False,8225010,Binau,Insgesamt,1378,720,658
False,8225014,"Buchen (Odenwald), Stadt",unter 3 Jahre,446,224,222
False,8225014,"Buchen (Odenwald), Stadt",3 -  6 Jahre,492,228,264
False,8225014,"Buchen (Odenwald), Stadt",6 - 10 Jahre,707,352,355
False,8225014,"Buchen (Odenwald), Stadt",10 - 15 Jahre,1050,544,506
False,8225014,"Buchen (Odenwald), Stadt",15 - 18 Jahre,640,342,298
False,8225014,"Buchen (Odenwald), Stadt",18 - 20 Jahre,480,247,233
False,8225014,"Buchen (Odenwald), Stadt",20 - 25 Jahre,1074,594,480
False,8225014,"Buchen (Odenwald), Stadt",25 - 30 Jahre,1012,539,473
False,8225014,"Buchen (Odenwald), Stadt",30 - 35 Jahre,1003,485,518
False,8225014,"Buchen (Odenwald), Stadt",35 - 40 Jahre,1025,531,494
False,8225014,"Buchen (Odenwald), Stadt",40 - 45 Jahre,1368,741,627
False,8225014,"Buchen (Odenwald), Stadt",45 - 50 Jahre,1527,756,771
False,8225014,"Buchen (Odenwald), Stadt",50 - 55 Jahre,1455,722,733
False,8225014,"Buchen (Odenwald), Stadt",55 - 60 Jahre,1260,621,639
False,8225014,"Buchen (Odenwald), Stadt",60 - 65 Jahre,1104,563,541
False,8225014,"Buchen (Odenwald), Stadt",65 - 75 Jahre,1885,914,971
False,8225014,"Buchen (Odenwald), Stadt",75 und mehr Jahre,1748,666,1082
False,8225014,"Buchen (Odenwald), Stadt",Insgesamt,18276,9069,9207
False,8225024,Fahrenbach,unter 3 Jahre,62,35,27
False,8225024,Fahrenbach,3 -  6 Jahre,67,35,32
False,8225024,Fahrenbach,6 - 10 Jahre,127,67,60
False,8225024,Fahrenbach,10 - 15 Jahre,145,73,72
False,8225024,Fahrenbach,15 - 18 Jahre,84,43,41
False,8225024,Fahrenbach,18 - 20 Jahre,63,30,33
False,8225024,Fahrenbach,20 - 25 Jahre,173,84,89
False,8225024,Fahrenbach,25 - 30 Jahre,130,63,67
False,8225024,Fahrenbach,30 - 35 Jahre,142,75,67
False,8225024,Fahrenbach,35 - 40 Jahre,178,79,99
False,8225024,Fahrenbach,40 - 45 Jahre,216,108,108
False,8225024,Fahrenbach,45 - 50 Jahre,263,132,131
False,8225024,Fahrenbach,50 - 55 Jahre,210,120,90
False,8225024,Fahrenbach,55 - 60 Jahre,182,95,87
False,8225024,Fahrenbach,60 - 65 Jahre,153,71,82
False,8225024,Fahrenbach,65 - 75 Jahre,296,143,153
False,8225024,Fahrenbach,75 und mehr Jahre,287,112,175
False,8225024,Fahrenbach,Insgesamt,2778,1365,1413
False,8225032,Hardheim,unter 3 Jahre,186,100,86
False,8225032,Hardheim,3 -  6 Jahre,182,92,90
False,8225032,Hardheim,6 - 10 Jahre,263,131,132
False,8225032,Hardheim,10 - 15 Jahre,352,194,158
False,8225032,Hardheim,15 - 18 Jahre,240,127,113
False,8225032,Hardheim,18 - 20 Jahre,182,92,90
False,8225032,Hardheim,20 - 25 Jahre,470,262,208
False,8225032,Hardheim,25 - 30 Jahre,385,221,164
False,8225032,Hardheim,30 - 35 Jahre,391,205,186
False,8225032,Hardheim,35 - 40 Jahre,406,197,209
False,8225032,Hardheim,40 - 45 Jahre,595,318,277
False,8225032,Hardheim,45 - 50 Jahre,691,371,320
False,8225032,Hardheim,50 - 55 Jahre,574,288,286
False,8225032,Hardheim,55 - 60 Jahre,484,250,234
False,8225032,Hardheim,60 - 65 Jahre,391,201,190
False,8225032,Hardheim,65 - 75 Jahre,703,328,375
False,8225032,Hardheim,75 und mehr Jahre,728,280,448
False,8225032,Hardheim,Insgesamt,7223,3657,3566
False,8225033,Haßmersheim,unter 3 Jahre,129,63,66
False,8225033,Haßmersheim,3 -  6 Jahre,109,56,53
False,8225033,Haßmersheim,6 - 10 Jahre,196,100,96
False,8225033,Haßmersheim,10 - 15 Jahre,318,159,159
False,8225033,Haßmersheim,15 - 18 Jahre,190,93,97
False,8225033,Haßmersheim,18 - 20 Jahre,126,65,61
False,8225033,Haßmersheim,20 - 25 Jahre,290,155,135
False,8225033,Haßmersheim,25 - 30 Jahre,276,144,132
False,8225033,Haßmersheim,30 - 35 Jahre,274,143,131
False,8225033,Haßmersheim,35 - 40 Jahre,295,134,161
False,8225033,Haßmersheim,40 - 45 Jahre,424,214,210
False,8225033,Haßmersheim,45 - 50 Jahre,419,221,198
False,8225033,Haßmersheim,50 - 55 Jahre,395,196,199
False,8225033,Haßmersheim,55 - 60 Jahre,294,157,137
False,8225033,Haßmersheim,60 - 65 Jahre,244,118,126
False,8225033,Haßmersheim,65 - 75 Jahre,524,260,264
False,8225033,Haßmersheim,75 und mehr Jahre,405,160,245
False,8225033,Haßmersheim,Insgesamt,4908,2438,2470
False,8225039,Höpfingen,unter 3 Jahre,75,46,29
False,8225039,Höpfingen,3 -  6 Jahre,71,34,37
False,8225039,Höpfingen,6 - 10 Jahre,116,57,59
False,8225039,Höpfingen,10 - 15 Jahre,179,96,83
False,8225039,Höpfingen,15 - 18 Jahre,130,63,67
False,8225039,Höpfingen,18 - 20 Jahre,83,46,37
False,8225039,Höpfingen,20 - 25 Jahre,206,105,101
False,8225039,Höpfingen,25 - 30 Jahre,173,91,82
False,8225039,Höpfingen,30 - 35 Jahre,145,75,70
False,8225039,Höpfingen,35 - 40 Jahre,178,87,91
False,8225039,Höpfingen,40 - 45 Jahre,247,124,123
False,8225039,Höpfingen,45 - 50 Jahre,293,149,144
False,8225039,Höpfingen,50 - 55 Jahre,292,150,142
False,8225039,Höpfingen,55 - 60 Jahre,201,106,95
False,8225039,Höpfingen,60 - 65 Jahre,179,88,91
False,8225039,Höpfingen,65 - 75 Jahre,306,142,164
False,8225039,Höpfingen,75 und mehr Jahre,278,103,175
False,8225039,Höpfingen,Insgesamt,3152,1562,1590
False,8225042,Hüffenhardt,unter 3 Jahre,41,28,13
False,8225042,Hüffenhardt,3 -  6 Jahre,50,26,24
False,8225042,Hüffenhardt,6 - 10 Jahre,74,44,30
False,8225042,Hüffenhardt,10 - 15 Jahre,99,55,44
False,8225042,Hüffenhardt,15 - 18 Jahre,64,38,26
False,8225042,Hüffenhardt,18 - 20 Jahre,46,22,24
False,8225042,Hüffenhardt,20 - 25 Jahre,126,62,64
False,8225042,Hüffenhardt,25 - 30 Jahre,95,41,54
False,8225042,Hüffenhardt,30 - 35 Jahre,112,58,54
False,8225042,Hüffenhardt,35 - 40 Jahre,109,49,60
False,8225042,Hüffenhardt,40 - 45 Jahre,153,71,82
False,8225042,Hüffenhardt,45 - 50 Jahre,193,109,84
False,8225042,Hüffenhardt,50 - 55 Jahre,170,91,79
False,8225042,Hüffenhardt,55 - 60 Jahre,144,62,82
False,8225042,Hüffenhardt,60 - 65 Jahre,95,52,43
False,8225042,Hüffenhardt,65 - 75 Jahre,198,91,107
False,8225042,Hüffenhardt,75 und mehr Jahre,273,94,179
False,8225042,Hüffenhardt,Insgesamt,2042,993,1049
False,8225052,Limbach,unter 3 Jahre,99,46,53
False,8225052,Limbach,3 -  6 Jahre,112,51,61
False,8225052,Limbach,6 - 10 Jahre,150,65,85
False,8225052,Limbach,10 - 15 Jahre,241,135,106
False,8225052,Limbach,15 - 18 Jahre,164,85,79
False,8225052,Limbach,18 - 20 Jahre,115,59,56
False,8225052,Limbach,20 - 25 Jahre,269,142,127
False,8225052,Limbach,25 - 30 Jahre,226,106,120
False,8225052,Limbach,30 - 35 Jahre,220,107,113
False,8225052,Limbach,35 - 40 Jahre,233,133,100
False,8225052,Limbach,40 - 45 Jahre,354,193,161
False,8225052,Limbach,45 - 50 Jahre,442,216,226
False,8225052,Limbach,50 - 55 Jahre,387,192,195
False,8225052,Limbach,55 - 60 Jahre,337,186,151
False,8225052,Limbach,60 - 65 Jahre,239,134,105
False,8225052,Limbach,65 - 75 Jahre,449,226,223
False,8225052,Limbach,75 und mehr Jahre,464,173,291
False,8225052,Limbach,Insgesamt,4501,2249,2252
False,8225058,"Mosbach, Stadt",unter 3 Jahre,538,277,261
False,8225058,"Mosbach, Stadt",3 -  6 Jahre,584,282,302
False,8225058,"Mosbach, Stadt",6 - 10 Jahre,846,446,400
False,8225058,"Mosbach, Stadt",10 - 15 Jahre,1234,650,584
False,8225058,"Mosbach, Stadt",15 - 18 Jahre,795,414,381
False,8225058,"Mosbach, Stadt",18 - 20 Jahre,604,330,274
False,8225058,"Mosbach, Stadt",20 - 25 Jahre,1521,767,754
False,8225058,"Mosbach, Stadt",25 - 30 Jahre,1421,739,682
False,8225058,"Mosbach, Stadt",30 - 35 Jahre,1381,707,674
False,8225058,"Mosbach, Stadt",35 - 40 Jahre,1435,699,736
False,8225058,"Mosbach, Stadt",40 - 45 Jahre,1906,1014,892
False,8225058,"Mosbach, Stadt",45 - 50 Jahre,2113,1096,1017
False,8225058,"Mosbach, Stadt",50 - 55 Jahre,1866,908,958
False,8225058,"Mosbach, Stadt",55 - 60 Jahre,1722,841,881
False,8225058,"Mosbach, Stadt",60 - 65 Jahre,1559,745,814
False,8225058,"Mosbach, Stadt",65 - 75 Jahre,2711,1303,1408
False,8225058,"Mosbach, Stadt",75 und mehr Jahre,2254,850,1404
False,8225058,"Mosbach, Stadt",Insgesamt,24490,12068,12422
False,8225060,Mudau,unter 3 Jahre,96,46,50
False,8225060,Mudau,3 -  6 Jahre,119,73,46
False,8225060,Mudau,6 - 10 Jahre,189,86,103
False,8225060,Mudau,10 - 15 Jahre,269,150,119
False,8225060,Mudau,15 - 18 Jahre,180,82,98
False,8225060,Mudau,18 - 20 Jahre,136,68,68
False,8225060,Mudau,20 - 25 Jahre,305,163,142
False,8225060,Mudau,25 - 30 Jahre,262,162,100
False,8225060,Mudau,30 - 35 Jahre,227,108,119
False,8225060,Mudau,35 - 40 Jahre,284,142,142
False,8225060,Mudau,40 - 45 Jahre,408,207,201
False,8225060,Mudau,45 - 50 Jahre,492,262,230
False,8225060,Mudau,50 - 55 Jahre,457,237,220
False,8225060,Mudau,55 - 60 Jahre,374,215,159
False,8225060,Mudau,60 - 65 Jahre,252,144,108
False,8225060,Mudau,65 - 75 Jahre,459,218,241
False,8225060,Mudau,75 und mehr Jahre,434,151,283
False,8225060,Mudau,Insgesamt,4943,2514,2429
False,8225064,Neckargerach,unter 3 Jahre,49,20,29
False,8225064,Neckargerach,3 -  6 Jahre,56,26,30
False,8225064,Neckargerach,6 - 10 Jahre,86,45,41
False,8225064,Neckargerach,10 - 15 Jahre,138,66,72
False,8225064,Neckargerach,15 - 18 Jahre,87,46,41
False,8225064,Neckargerach,18 - 20 Jahre,73,34,39
False,8225064,Neckargerach,20 - 25 Jahre,148,76,72
False,8225064,Neckargerach,25 - 30 Jahre,119,53,66
False,8225064,Neckargerach,30 - 35 Jahre,111,56,55
False,8225064,Neckargerach,35 - 40 Jahre,125,63,62
False,8225064,Neckargerach,40 - 45 Jahre,180,97,83
False,8225064,Neckargerach,45 - 50 Jahre,211,105,106
False,8225064,Neckargerach,50 - 55 Jahre,184,105,79
False,8225064,Neckargerach,55 - 60 Jahre,166,75,91
False,8225064,Neckargerach,60 - 65 Jahre,125,59,66
False,8225064,Neckargerach,65 - 75 Jahre,276,141,135
False,8225064,Neckargerach,75 und mehr Jahre,196,67,129
False,8225064,Neckargerach,Insgesamt,2330,1134,1196
False,8225067,Neckarzimmern,unter 3 Jahre,53,27,26
False,8225067,Neckarzimmern,3 -  6 Jahre,47,28,19
False,8225067,Neckarzimmern,6 - 10 Jahre,59,36,23
False,8225067,Neckarzimmern,10 - 15 Jahre,96,55,41
False,8225067,Neckarzimmern,15 - 18 Jahre,56,29,27
False,8225067,Neckarzimmern,18 - 20 Jahre,38,25,13
False,8225067,Neckarzimmern,20 - 25 Jahre,91,41,50
False,8225067,Neckarzimmern,25 - 30 Jahre,92,43,49
False,8225067,Neckarzimmern,30 - 35 Jahre,84,31,53
False,8225067,Neckarzimmern,35 - 40 Jahre,95,41,54
False,8225067,Neckarzimmern,40 - 45 Jahre,144,74,70
False,8225067,Neckarzimmern,45 - 50 Jahre,124,59,65
False,8225067,Neckarzimmern,50 - 55 Jahre,123,59,64
False,8225067,Neckarzimmern,55 - 60 Jahre,101,49,52
False,8225067,Neckarzimmern,60 - 65 Jahre,103,43,60
False,8225067,Neckarzimmern,65 - 75 Jahre,139,75,64
False,8225067,Neckarzimmern,75 und mehr Jahre,86,35,51
False,8225067,Neckarzimmern,Insgesamt,1531,750,781
False,8225068,Neunkirchen,unter 3 Jahre,49,19,30
False,8225068,Neunkirchen,3 -  6 Jahre,40,19,21
False,8225068,Neunkirchen,6 - 10 Jahre,69,30,39
False,8225068,Neunkirchen,10 - 15 Jahre,116,61,55
False,8225068,Neunkirchen,15 - 18 Jahre,77,39,38
False,8225068,Neunkirchen,18 - 20 Jahre,52,24,28
False,8225068,Neunkirchen,20 - 25 Jahre,99,43,56
False,8225068,Neunkirchen,25 - 30 Jahre,89,49,40
False,8225068,Neunkirchen,30 - 35 Jahre,90,43,47
False,8225068,Neunkirchen,35 - 40 Jahre,99,57,42
False,8225068,Neunkirchen,40 - 45 Jahre,129,67,62
False,8225068,Neunkirchen,45 - 50 Jahre,206,105,101
False,8225068,Neunkirchen,50 - 55 Jahre,161,86,75
False,8225068,Neunkirchen,55 - 60 Jahre,121,65,56
False,8225068,Neunkirchen,60 - 65 Jahre,91,47,44
False,8225068,Neunkirchen,65 - 75 Jahre,175,80,95
False,8225068,Neunkirchen,75 und mehr Jahre,179,58,121
False,8225068,Neunkirchen,Insgesamt,1842,892,950
False,8225074,Obrigheim,unter 3 Jahre,137,72,65
False,8225074,Obrigheim,3 -  6 Jahre,136,70,66
False,8225074,Obrigheim,6 - 10 Jahre,207,106,101
False,8225074,Obrigheim,10 - 15 Jahre,269,141,128
False,8225074,Obrigheim,15 - 18 Jahre,174,81,93
False,8225074,Obrigheim,18 - 20 Jahre,133,54,79
False,8225074,Obrigheim,20 - 25 Jahre,297,121,176
False,8225074,Obrigheim,25 - 30 Jahre,257,113,144
False,8225074,Obrigheim,30 - 35 Jahre,265,129,136
False,8225074,Obrigheim,35 - 40 Jahre,328,168,160
False,8225074,Obrigheim,40 - 45 Jahre,430,234,196
False,8225074,Obrigheim,45 - 50 Jahre,435,233,202
False,8225074,Obrigheim,50 - 55 Jahre,396,201,195
False,8225074,Obrigheim,55 - 60 Jahre,345,175,170
False,8225074,Obrigheim,60 - 65 Jahre,317,150,167
False,8225074,Obrigheim,65 - 75 Jahre,631,308,323
False,8225074,Obrigheim,75 und mehr Jahre,464,192,272
False,8225074,Obrigheim,Insgesamt,5221,2548,2673
False,8225075,"Osterburken, Stadt",unter 3 Jahre,156,84,72
False,8225075,"Osterburken, Stadt",3 -  6 Jahre,208,120,88
False,8225075,"Osterburken, Stadt",6 - 10 Jahre,262,140,122
False,8225075,"Osterburken, Stadt",10 - 15 Jahre,331,177,154
False,8225075,"Osterburken, Stadt",15 - 18 Jahre,195,108,87
False,8225075,"Osterburken, Stadt",18 - 20 Jahre,153,78,75
False,8225075,"Osterburken, Stadt",20 - 25 Jahre,349,194,155
False,8225075,"Osterburken, Stadt",25 - 30 Jahre,350,186,164
False,8225075,"Osterburken, Stadt",30 - 35 Jahre,405,203,202
False,8225075,"Osterburken, Stadt",35 - 40 Jahre,428,219,209
False,8225075,"Osterburken, Stadt",40 - 45 Jahre,486,246,240
False,8225075,"Osterburken, Stadt",45 - 50 Jahre,547,283,264
False,8225075,"Osterburken, Stadt",50 - 55 Jahre,474,262,212
False,8225075,"Osterburken, Stadt",55 - 60 Jahre,439,227,212
False,8225075,"Osterburken, Stadt",60 - 65 Jahre,357,179,178
False,8225075,"Osterburken, Stadt",65 - 75 Jahre,631,302,329
False,8225075,"Osterburken, Stadt",75 und mehr Jahre,717,268,449
False,8225075,"Osterburken, Stadt",Insgesamt,6488,3276,3212
False,8225082,Rosenberg,unter 3 Jahre,42,21,21
False,8225082,Rosenberg,3 -  6 Jahre,54,29,25
False,8225082,Rosenberg,6 - 10 Jahre,105,52,53
False,8225082,Rosenberg,10 - 15 Jahre,115,47,68
False,8225082,Rosenberg,15 - 18 Jahre,72,29,43
False,8225082,Rosenberg,18 - 20 Jahre,54,33,21
False,8225082,Rosenberg,20 - 25 Jahre,109,60,49
False,8225082,Rosenberg,25 - 30 Jahre,87,49,38
False,8225082,Rosenberg,30 - 35 Jahre,96,58,38
False,8225082,Rosenberg,35 - 40 Jahre,140,69,71
False,8225082,Rosenberg,40 - 45 Jahre,179,98,81
False,8225082,Rosenberg,45 - 50 Jahre,199,109,90
False,8225082,Rosenberg,50 - 55 Jahre,157,77,80
False,8225082,Rosenberg,55 - 60 Jahre,152,65,87
False,8225082,Rosenberg,60 - 65 Jahre,143,73,70
False,8225082,Rosenberg,65 - 75 Jahre,240,119,121
False,8225082,Rosenberg,75 und mehr Jahre,222,93,129
False,8225082,Rosenberg,Insgesamt,2166,1081,1085
False,8225091,Seckach,unter 3 Jahre,104,49,55
False,8225091,Seckach,3 -  6 Jahre,126,61,65
False,8225091,Seckach,6 - 10 Jahre,209,122,87
False,8225091,Seckach,10 - 15 Jahre,317,163,154
False,8225091,Seckach,15 - 18 Jahre,166,88,78
False,8225091,Seckach,18 - 20 Jahre,111,56,55
False,8225091,Seckach,20 - 25 Jahre,233,141,92
False,8225091,Seckach,25 - 30 Jahre,273,139,134
False,8225091,Seckach,30 - 35 Jahre,243,139,104
False,8225091,Seckach,35 - 40 Jahre,223,103,120
False,8225091,Seckach,40 - 45 Jahre,334,168,166
False,8225091,Seckach,45 - 50 Jahre,396,210,186
False,8225091,Seckach,50 - 55 Jahre,350,181,169
False,8225091,Seckach,55 - 60 Jahre,300,141,159
False,8225091,Seckach,60 - 65 Jahre,231,118,113
False,8225091,Seckach,65 - 75 Jahre,390,184,206
False,8225091,Seckach,75 und mehr Jahre,325,121,204
False,8225091,Seckach,Insgesamt,4331,2184,2147
False,8225109,"Walldürn, Stadt",unter 3 Jahre,242,131,111
False,8225109,"Walldürn, Stadt",3 -  6 Jahre,288,150,138
False,8225109,"Walldürn, Stadt",6 - 10 Jahre,460,244,216
False,8225109,"Walldürn, Stadt",10 - 15 Jahre,626,330,296
False,8225109,"Walldürn, Stadt",15 - 18 Jahre,421,220,201
False,8225109,"Walldürn, Stadt",18 - 20 Jahre,318,171,147
False,8225109,"Walldürn, Stadt",20 - 25 Jahre,655,353,302
False,8225109,"Walldürn, Stadt",25 - 30 Jahre,665,344,321
False,8225109,"Walldürn, Stadt",30 - 35 Jahre,619,320,299
False,8225109,"Walldürn, Stadt",35 - 40 Jahre,640,303,337
False,8225109,"Walldürn, Stadt",40 - 45 Jahre,957,499,458
False,8225109,"Walldürn, Stadt",45 - 50 Jahre,1066,561,505
False,8225109,"Walldürn, Stadt",50 - 55 Jahre,946,467,479
False,8225109,"Walldürn, Stadt",55 - 60 Jahre,770,396,374
False,8225109,"Walldürn, Stadt",60 - 65 Jahre,657,336,321
False,8225109,"Walldürn, Stadt",65 - 75 Jahre,1351,662,689
False,8225109,"Walldürn, Stadt",75 und mehr Jahre,1021,364,657
False,8225109,"Walldürn, Stadt",Insgesamt,11702,5851,5851
False,8225113,Zwingenberg,unter 3 Jahre,16,8,8
False,8225113,Zwingenberg,3 -  6 Jahre,18,9,9
False,8225113,Zwingenberg,6 - 10 Jahre,27,18,9
False,8225113,Zwingenberg,10 - 15 Jahre,32,17,15
False,8225113,Zwingenberg,15 - 18 Jahre,20,10,10
False,8225113,Zwingenberg,18 - 20 Jahre,19,6,13
False,8225113,Zwingenberg,20 - 25 Jahre,36,15,21
False,8225113,Zwingenberg,25 - 30 Jahre,39,21,18
False,8225113,Zwingenberg,30 - 35 Jahre,29,12,17
False,8225113,Zwingenberg,35 - 40 Jahre,37,19,18
False,8225113,Zwingenberg,40 - 45 Jahre,43,31,12
False,8225113,Zwingenberg,45 - 50 Jahre,50,22,28
False,8225113,Zwingenberg,50 - 55 Jahre,73,34,39
False,8225113,Zwingenberg,55 - 60 Jahre,45,19,26
False,8225113,Zwingenberg,60 - 65 Jahre,45,26,19
False,8225113,Zwingenberg,65 - 75 Jahre,68,32,36
False,8225113,Zwingenberg,75 und mehr Jahre,82,34,48
False,8225113,Zwingenberg,Insgesamt,679,333,346
False,8225114,"Ravenstein, Stadt",unter 3 Jahre,63,29,34
False,8225114,"Ravenstein, Stadt",3 -  6 Jahre,75,39,36
False,8225114,"Ravenstein, Stadt",6 - 10 Jahre,124,63,61
False,8225114,"Ravenstein, Stadt",10 - 15 Jahre,169,94,75
False,8225114,"Ravenstein, Stadt",15 - 18 Jahre,113,59,54
False,8225114,"Ravenstein, Stadt",18 - 20 Jahre,63,39,24
False,8225114,"Ravenstein, Stadt",20 - 25 Jahre,176,101,75
False,8225114,"Ravenstein, Stadt",25 - 30 Jahre,168,85,83
False,8225114,"Ravenstein, Stadt",30 - 35 Jahre,150,83,67
False,8225114,"Ravenstein, Stadt",35 - 40 Jahre,186,87,99
False,8225114,"Ravenstein, Stadt",40 - 45 Jahre,265,142,123
False,8225114,"Ravenstein, Stadt",45 - 50 Jahre,288,156,132
False,8225114,"Ravenstein, Stadt",50 - 55 Jahre,239,114,125
False,8225114,"Ravenstein, Stadt",55 - 60 Jahre,184,106,78
False,8225114,"Ravenstein, Stadt",60 - 65 Jahre,140,73,67
False,8225114,"Ravenstein, Stadt",65 - 75 Jahre,280,135,145
False,8225114,"Ravenstein, Stadt",75 und mehr Jahre,277,117,160
False,8225114,"Ravenstein, Stadt",Insgesamt,2960,1522,1438
False,8225115,Schefflenz,unter 3 Jahre,90,46,44
False,8225115,Schefflenz,3 -  6 Jahre,102,55,47
False,8225115,Schefflenz,6 - 10 Jahre,160,99,61
False,8225115,Schefflenz,10 - 15 Jahre,231,115,116
False,8225115,Schefflenz,15 - 18 Jahre,132,72,60
False,8225115,Schefflenz,18 - 20 Jahre,111,52,59
False,8225115,Schefflenz,20 - 25 Jahre,259,130,129
False,8225115,Schefflenz,25 - 30 Jahre,231,123,108
False,8225115,Schefflenz,30 - 35 Jahre,177,90,87
False,8225115,Schefflenz,35 - 40 Jahre,250,130,120
False,8225115,Schefflenz,40 - 45 Jahre,322,153,169
False,8225115,Schefflenz,45 - 50 Jahre,372,180,192
False,8225115,Schefflenz,50 - 55 Jahre,344,183,161
False,8225115,Schefflenz,55 - 60 Jahre,299,150,149
False,8225115,Schefflenz,60 - 65 Jahre,276,144,132
False,8225115,Schefflenz,65 - 75 Jahre,412,200,212
False,8225115,Schefflenz,75 und mehr Jahre,376,134,242
False,8225115,Schefflenz,Insgesamt,4144,2056,2088
False,8225116,Schwarzach,unter 3 Jahre,63,35,28
False,8225116,Schwarzach,3 -  6 Jahre,62,33,29
False,8225116,Schwarzach,6 - 10 Jahre,81,43,38
False,8225116,Schwarzach,10 - 15 Jahre,101,54,47
False,8225116,Schwarzach,15 - 18 Jahre,114,67,47
False,8225116,Schwarzach,18 - 20 Jahre,65,42,23
False,8225116,Schwarzach,20 - 25 Jahre,170,96,74
False,8225116,Schwarzach,25 - 30 Jahre,175,93,82
False,8225116,Schwarzach,30 - 35 Jahre,169,102,67
False,8225116,Schwarzach,35 - 40 Jahre,212,117,95
False,8225116,Schwarzach,40 - 45 Jahre,359,195,164
False,8225116,Schwarzach,45 - 50 Jahre,469,269,200
False,8225116,Schwarzach,50 - 55 Jahre,298,164,134
False,8225116,Schwarzach,55 - 60 Jahre,228,119,109
False,8225116,Schwarzach,60 - 65 Jahre,179,105,74
False,8225116,Schwarzach,65 - 75 Jahre,258,125,133
False,8225116,Schwarzach,75 und mehr Jahre,195,68,127
False,8225116,Schwarzach,Insgesamt,3198,1727,1471
False,8225117,Elztal,unter 3 Jahre,127,61,66
False,8225117,Elztal,3 -  6 Jahre,167,84,83
False,8225117,Elztal,6 - 10 Jahre,230,115,115
False,8225117,Elztal,10 - 15 Jahre,347,171,176
False,8225117,Elztal,15 - 18 Jahre,234,121,113
False,8225117,Elztal,18 - 20 Jahre,149,81,68
False,8225117,Elztal,20 - 25 Jahre,348,207,141
False,8225117,Elztal,25 - 30 Jahre,316,175,141
False,8225117,Elztal,30 - 35 Jahre,324,159,165
False,8225117,Elztal,35 - 40 Jahre,364,165,199
False,8225117,Elztal,40 - 45 Jahre,453,234,219
False,8225117,Elztal,45 - 50 Jahre,559,289,270
False,8225117,Elztal,50 - 55 Jahre,516,263,253
False,8225117,Elztal,55 - 60 Jahre,377,194,183
False,8225117,Elztal,60 - 65 Jahre,361,177,184
False,8225117,Elztal,65 - 75 Jahre,614,302,312
False,8225117,Elztal,75 und mehr Jahre,483,230,253
False,8225117,Elztal,Insgesamt,5969,3028,2941
False,8225118,Waldbrunn,unter 3 Jahre,87,43,44
False,8225118,Waldbrunn,3 -  6 Jahre,112,53,59
False,8225118,Waldbrunn,6 - 10 Jahre,173,89,84
False,8225118,Waldbrunn,10 - 15 Jahre,277,148,129
False,8225118,Waldbrunn,15 - 18 Jahre,186,91,95
False,8225118,Waldbrunn,18 - 20 Jahre,108,48,60
False,8225118,Waldbrunn,20 - 25 Jahre,251,135,116
False,8225118,Waldbrunn,25 - 30 Jahre,199,112,87
False,8225118,Waldbrunn,30 - 35 Jahre,177,98,79
False,8225118,Waldbrunn,35 - 40 Jahre,273,127,146
False,8225118,Waldbrunn,40 - 45 Jahre,423,204,219
False,8225118,Waldbrunn,45 - 50 Jahre,466,246,220
False,8225118,Waldbrunn,50 - 55 Jahre,397,185,212
False,8225118,Waldbrunn,55 - 60 Jahre,341,186,155
False,8225118,Waldbrunn,60 - 65 Jahre,284,150,134
False,8225118,Waldbrunn,65 - 75 Jahre,558,265,293
False,8225118,Waldbrunn,75 und mehr Jahre,511,195,316
False,8225118,Waldbrunn,Insgesamt,4823,2375,2448
False,8226,Landkreis Rhein-Neckar-Kreis,unter 3 Jahre,13475,6924,6551
False,8226,Landkreis Rhein-Neckar-Kreis,3 -  6 Jahre,13866,7181,6685
False,8226,Landkreis Rhein-Neckar-Kreis,6 - 10 Jahre,19654,10026,9628
False,8226,Landkreis Rhein-Neckar-Kreis,10 - 15 Jahre,27612,14090,13522
False,8226,Landkreis Rhein-Neckar-Kreis,15 - 18 Jahre,17044,8624,8420
False,8226,Landkreis Rhein-Neckar-Kreis,18 - 20 Jahre,11915,6154,5761
False,8226,Landkreis Rhein-Neckar-Kreis,20 - 25 Jahre,29879,15283,14596
False,8226,Landkreis Rhein-Neckar-Kreis,25 - 30 Jahre,29986,14845,15141
False,8226,Landkreis Rhein-Neckar-Kreis,30 - 35 Jahre,30518,14962,15556
False,8226,Landkreis Rhein-Neckar-Kreis,35 - 40 Jahre,32533,16045,16488
False,8226,Landkreis Rhein-Neckar-Kreis,40 - 45 Jahre,46205,23330,22875
False,8226,Landkreis Rhein-Neckar-Kreis,45 - 50 Jahre,48478,24451,24027
False,8226,Landkreis Rhein-Neckar-Kreis,50 - 55 Jahre,41892,20961,20931
False,8226,Landkreis Rhein-Neckar-Kreis,55 - 60 Jahre,35200,17208,17992
False,8226,Landkreis Rhein-Neckar-Kreis,60 - 65 Jahre,31998,15558,16440
False,8226,Landkreis Rhein-Neckar-Kreis,65 - 75 Jahre,59872,28646,31226
False,8226,Landkreis Rhein-Neckar-Kreis,75 und mehr Jahre,47498,18576,28922
False,8226,Landkreis Rhein-Neckar-Kreis,Insgesamt,537625,262864,274761
False,8226003,Altlußheim,unter 3 Jahre,116,63,53
False,8226003,Altlußheim,3 -  6 Jahre,104,59,45
False,8226003,Altlußheim,6 - 10 Jahre,185,99,86
False,8226003,Altlußheim,10 - 15 Jahre,259,117,142
False,8226003,Altlußheim,15 - 18 Jahre,151,65,86
False,8226003,Altlußheim,18 - 20 Jahre,141,70,71
False,8226003,Altlußheim,20 - 25 Jahre,287,144,143
False,8226003,Altlußheim,25 - 30 Jahre,272,137,135
False,8226003,Altlußheim,30 - 35 Jahre,227,117,110
False,8226003,Altlußheim,35 - 40 Jahre,302,151,151
False,8226003,Altlußheim,40 - 45 Jahre,451,223,228
False,8226003,Altlußheim,45 - 50 Jahre,534,249,285
False,8226003,Altlußheim,50 - 55 Jahre,414,212,202
False,8226003,Altlußheim,55 - 60 Jahre,376,192,184
False,8226003,Altlußheim,60 - 65 Jahre,313,157,156
False,8226003,Altlußheim,65 - 75 Jahre,650,311,339
False,8226003,Altlußheim,75 und mehr Jahre,457,178,279
False,8226003,Altlußheim,Insgesamt,5239,2544,2695
False,8226006,Bammental,unter 3 Jahre,130,54,76
False,8226006,Bammental,3 -  6 Jahre,147,81,66
False,8226006,Bammental,6 - 10 Jahre,201,100,101
False,8226006,Bammental,10 - 15 Jahre,368,190,178
False,8226006,Bammental,15 - 18 Jahre,216,114,102
False,8226006,Bammental,18 - 20 Jahre,156,84,72
False,8226006,Bammental,20 - 25 Jahre,361,204,157
False,8226006,Bammental,25 - 30 Jahre,283,150,133
False,8226006,Bammental,30 - 35 Jahre,351,172,179
False,8226006,Bammental,35 - 40 Jahre,414,227,187
False,8226006,Bammental,40 - 45 Jahre,470,243,227
False,8226006,Bammental,45 - 50 Jahre,593,277,316
False,8226006,Bammental,50 - 55 Jahre,521,246,275
False,8226006,Bammental,55 - 60 Jahre,480,226,254
False,8226006,Bammental,60 - 65 Jahre,372,198,174
False,8226006,Bammental,65 - 75 Jahre,761,362,399
False,8226006,Bammental,75 und mehr Jahre,644,222,422
False,8226006,Bammental,Insgesamt,6468,3150,3318
False,8226009,Brühl,unter 3 Jahre,282,147,135
False,8226009,Brühl,3 -  6 Jahre,295,141,154
False,8226009,Brühl,6 - 10 Jahre,437,233,204
False,8226009,Brühl,10 - 15 Jahre,620,316,304
False,8226009,Brühl,15 - 18 Jahre,393,188,205
False,8226009,Brühl,18 - 20 Jahre,314,157,157
False,8226009,Brühl,20 - 25 Jahre,749,406,343
False,8226009,Brühl,25 - 30 Jahre,711,352,359
False,8226009,Brühl,30 - 35 Jahre,762,327,435
False,8226009,Brühl,35 - 40 Jahre,742,364,378
False,8226009,Brühl,40 - 45 Jahre,1181,573,608
False,8226009,Brühl,45 - 50 Jahre,1215,580,635
False,8226009,Brühl,50 - 55 Jahre,1195,591,604
False,8226009,Brühl,55 - 60 Jahre,1006,486,520
False,8226009,Brühl,60 - 65 Jahre,1053,517,536
False,8226009,Brühl,65 - 75 Jahre,1772,867,905
False,8226009,Brühl,75 und mehr Jahre,1432,528,904
False,8226009,Brühl,Insgesamt,14159,6773,7386
False,8226010,Dielheim,unter 3 Jahre,210,116,94
False,8226010,Dielheim,3 -  6 Jahre,207,105,102
False,8226010,Dielheim,6 - 10 Jahre,359,193,166
False,8226010,Dielheim,10 - 15 Jahre,538,283,255
False,8226010,Dielheim,15 - 18 Jahre,341,166,175
False,8226010,Dielheim,18 - 20 Jahre,195,101,94
False,8226010,Dielheim,20 - 25 Jahre,508,263,245
False,8226010,Dielheim,25 - 30 Jahre,488,238,250
False,8226010,Dielheim,30 - 35 Jahre,480,238,242
False,8226010,Dielheim,35 - 40 Jahre,504,255,249
False,8226010,Dielheim,40 - 45 Jahre,840,427,413
False,8226010,Dielheim,45 - 50 Jahre,850,396,454
False,8226010,Dielheim,50 - 55 Jahre,695,343,352
False,8226010,Dielheim,55 - 60 Jahre,590,287,303
False,8226010,Dielheim,60 - 65 Jahre,537,272,265
False,8226010,Dielheim,65 - 75 Jahre,901,448,453
False,8226010,Dielheim,75 und mehr Jahre,659,261,398
False,8226010,Dielheim,Insgesamt,8902,4392,4510
False,8226012,Dossenheim,unter 3 Jahre,399,210,189
False,8226012,Dossenheim,3 -  6 Jahre,362,200,162
False,8226012,Dossenheim,6 - 10 Jahre,460,226,234
False,8226012,Dossenheim,10 - 15 Jahre,545,300,245
False,8226012,Dossenheim,15 - 18 Jahre,290,151,139
False,8226012,Dossenheim,18 - 20 Jahre,270,133,137
False,8226012,Dossenheim,20 - 25 Jahre,881,377,504
False,8226012,Dossenheim,25 - 30 Jahre,1018,466,552
False,8226012,Dossenheim,30 - 35 Jahre,947,469,478
False,8226012,Dossenheim,35 - 40 Jahre,820,417,403
False,8226012,Dossenheim,40 - 45 Jahre,1102,519,583
False,8226012,Dossenheim,45 - 50 Jahre,1113,571,542
False,8226012,Dossenheim,50 - 55 Jahre,915,441,474
False,8226012,Dossenheim,55 - 60 Jahre,702,320,382
False,8226012,Dossenheim,60 - 65 Jahre,633,305,328
False,8226012,Dossenheim,65 - 75 Jahre,1130,522,608
False,8226012,Dossenheim,75 und mehr Jahre,920,350,570
False,8226012,Dossenheim,Insgesamt,12507,5977,6530
False,8226013,"Eberbach, Stadt",unter 3 Jahre,286,130,156
False,8226013,"Eberbach, Stadt",3 -  6 Jahre,332,160,172
False,8226013,"Eberbach, Stadt",6 - 10 Jahre,501,249,252
False,8226013,"Eberbach, Stadt",10 - 15 Jahre,788,404,384
False,8226013,"Eberbach, Stadt",15 - 18 Jahre,512,253,259
False,8226013,"Eberbach, Stadt",18 - 20 Jahre,329,167,162
False,8226013,"Eberbach, Stadt",20 - 25 Jahre,796,437,359
False,8226013,"Eberbach, Stadt",25 - 30 Jahre,698,337,361
False,8226013,"Eberbach, Stadt",30 - 35 Jahre,761,355,406
False,8226013,"Eberbach, Stadt",35 - 40 Jahre,788,373,415
False,8226013,"Eberbach, Stadt",40 - 45 Jahre,1205,597,608
False,8226013,"Eberbach, Stadt",45 - 50 Jahre,1267,621,646
False,8226013,"Eberbach, Stadt",50 - 55 Jahre,1138,577,561
False,8226013,"Eberbach, Stadt",55 - 60 Jahre,992,477,515
False,8226013,"Eberbach, Stadt",60 - 65 Jahre,952,436,516
False,8226013,"Eberbach, Stadt",65 - 75 Jahre,1855,882,973
False,8226013,"Eberbach, Stadt",75 und mehr Jahre,1717,641,1076
False,8226013,"Eberbach, Stadt",Insgesamt,14917,7096,7821
False,8226017,Epfenbach,unter 3 Jahre,59,34,25
False,8226017,Epfenbach,3 -  6 Jahre,70,32,38
False,8226017,Epfenbach,6 - 10 Jahre,109,54,55
False,8226017,Epfenbach,10 - 15 Jahre,150,86,64
False,8226017,Epfenbach,15 - 18 Jahre,88,42,46
False,8226017,Epfenbach,18 - 20 Jahre,68,37,31
False,8226017,Epfenbach,20 - 25 Jahre,138,79,59
False,8226017,Epfenbach,25 - 30 Jahre,135,69,66
False,8226017,Epfenbach,30 - 35 Jahre,140,63,77
False,8226017,Epfenbach,35 - 40 Jahre,149,76,73
False,8226017,Epfenbach,40 - 45 Jahre,205,103,102
False,8226017,Epfenbach,45 - 50 Jahre,211,121,90
False,8226017,Epfenbach,50 - 55 Jahre,202,102,100
False,8226017,Epfenbach,55 - 60 Jahre,181,87,94
False,8226017,Epfenbach,60 - 65 Jahre,155,89,66
False,8226017,Epfenbach,65 - 75 Jahre,229,115,114
False,8226017,Epfenbach,75 und mehr Jahre,215,95,120
False,8226017,Epfenbach,Insgesamt,2504,1284,1220
False,8226018,"Eppelheim, Stadt",unter 3 Jahre,419,207,212
False,8226018,"Eppelheim, Stadt",3 -  6 Jahre,392,205,187
False,8226018,"Eppelheim, Stadt",6 - 10 Jahre,502,275,227
False,8226018,"Eppelheim, Stadt",10 - 15 Jahre,699,360,339
False,8226018,"Eppelheim, Stadt",15 - 18 Jahre,408,217,191
False,8226018,"Eppelheim, Stadt",18 - 20 Jahre,344,178,166
False,8226018,"Eppelheim, Stadt",20 - 25 Jahre,1109,537,572
False,8226018,"Eppelheim, Stadt",25 - 30 Jahre,1177,579,598
False,8226018,"Eppelheim, Stadt",30 - 35 Jahre,1031,533,498
False,8226018,"Eppelheim, Stadt",35 - 40 Jahre,931,494,437
False,8226018,"Eppelheim, Stadt",40 - 45 Jahre,1218,653,565
False,8226018,"Eppelheim, Stadt",45 - 50 Jahre,1314,697,617
False,8226018,"Eppelheim, Stadt",50 - 55 Jahre,1058,550,508
False,8226018,"Eppelheim, Stadt",55 - 60 Jahre,897,429,468
False,8226018,"Eppelheim, Stadt",60 - 65 Jahre,790,390,400
False,8226018,"Eppelheim, Stadt",65 - 75 Jahre,1534,692,842
False,8226018,"Eppelheim, Stadt",75 und mehr Jahre,1191,466,725
False,8226018,"Eppelheim, Stadt",Insgesamt,15014,7462,7552
False,8226020,Eschelbronn,unter 3 Jahre,70,43,27
False,8226020,Eschelbronn,3 -  6 Jahre,76,35,41
False,8226020,Eschelbronn,6 - 10 Jahre,114,64,50
False,8226020,Eschelbronn,10 - 15 Jahre,152,74,78
False,8226020,Eschelbronn,15 - 18 Jahre,90,46,44
False,8226020,Eschelbronn,18 - 20 Jahre,73,42,31
False,8226020,Eschelbronn,20 - 25 Jahre,156,80,76
False,8226020,Eschelbronn,25 - 30 Jahre,138,72,66
False,8226020,Eschelbronn,30 - 35 Jahre,138,84,54
False,8226020,Eschelbronn,35 - 40 Jahre,154,79,75
False,8226020,Eschelbronn,40 - 45 Jahre,195,97,98
False,8226020,Eschelbronn,45 - 50 Jahre,203,104,99
False,8226020,Eschelbronn,50 - 55 Jahre,181,92,89
False,8226020,Eschelbronn,55 - 60 Jahre,185,87,98
False,8226020,Eschelbronn,60 - 65 Jahre,152,81,71
False,8226020,Eschelbronn,65 - 75 Jahre,225,112,113
False,8226020,Eschelbronn,75 und mehr Jahre,208,87,121
False,8226020,Eschelbronn,Insgesamt,2510,1279,1231
False,8226022,Gaiberg,unter 3 Jahre,69,34,35
False,8226022,Gaiberg,3 -  6 Jahre,66,38,28
False,8226022,Gaiberg,6 - 10 Jahre,93,47,46
False,8226022,Gaiberg,10 - 15 Jahre,143,81,62
False,8226022,Gaiberg,15 - 18 Jahre,80,39,41
False,8226022,Gaiberg,18 - 20 Jahre,51,27,24
False,8226022,Gaiberg,20 - 25 Jahre,139,87,52
False,8226022,Gaiberg,25 - 30 Jahre,127,88,39
False,8226022,Gaiberg,30 - 35 Jahre,145,82,63
False,8226022,Gaiberg,35 - 40 Jahre,174,102,72
False,8226022,Gaiberg,40 - 45 Jahre,257,138,119
False,8226022,Gaiberg,45 - 50 Jahre,275,143,132
False,8226022,Gaiberg,50 - 55 Jahre,234,142,92
False,8226022,Gaiberg,55 - 60 Jahre,189,89,100
False,8226022,Gaiberg,60 - 65 Jahre,177,81,96
False,8226022,Gaiberg,65 - 75 Jahre,275,138,137
False,8226022,Gaiberg,75 und mehr Jahre,210,90,120
False,8226022,Gaiberg,Insgesamt,2704,1446,1258
False,8226027,Heddesbach,unter 3 Jahre,4,2,2
False,8226027,Heddesbach,3 -  6 Jahre,5,4,1
False,8226027,Heddesbach,6 - 10 Jahre,15,8,7
False,8226027,Heddesbach,10 - 15 Jahre,40,15,25
False,8226027,Heddesbach,15 - 18 Jahre,9,4,5
False,8226027,Heddesbach,18 - 20 Jahre,17,10,7
False,8226027,Heddesbach,20 - 25 Jahre,24,13,11
False,8226027,Heddesbach,25 - 30 Jahre,18,9,9
False,8226027,Heddesbach,30 - 35 Jahre,15,6,9
False,8226027,Heddesbach,35 - 40 Jahre,13,5,8
False,8226027,Heddesbach,40 - 45 Jahre,40,21,19
False,8226027,Heddesbach,45 - 50 Jahre,46,25,21
False,8226027,Heddesbach,50 - 55 Jahre,40,18,22
False,8226027,Heddesbach,55 - 60 Jahre,30,16,14
False,8226027,Heddesbach,60 - 65 Jahre,26,11,15
False,8226027,Heddesbach,65 - 75 Jahre,57,31,26
False,8226027,Heddesbach,75 und mehr Jahre,64,28,36
False,8226027,Heddesbach,Insgesamt,463,226,237
False,8226028,Heddesheim,unter 3 Jahre,275,140,135
False,8226028,Heddesheim,3 -  6 Jahre,271,136,135
False,8226028,Heddesheim,6 - 10 Jahre,382,174,208
False,8226028,Heddesheim,10 - 15 Jahre,589,279,310
False,8226028,Heddesheim,15 - 18 Jahre,339,171,168
False,8226028,Heddesheim,18 - 20 Jahre,221,116,105
False,8226028,Heddesheim,20 - 25 Jahre,568,290,278
False,8226028,Heddesheim,25 - 30 Jahre,678,320,358
False,8226028,Heddesheim,30 - 35 Jahre,608,310,298
False,8226028,Heddesheim,35 - 40 Jahre,661,327,334
False,8226028,Heddesheim,40 - 45 Jahre,1031,541,490
False,8226028,Heddesheim,45 - 50 Jahre,1029,501,528
False,8226028,Heddesheim,50 - 55 Jahre,934,463,471
False,8226028,Heddesheim,55 - 60 Jahre,774,365,409
False,8226028,Heddesheim,60 - 65 Jahre,823,413,410
False,8226028,Heddesheim,65 - 75 Jahre,1359,628,731
False,8226028,Heddesheim,75 und mehr Jahre,1089,429,660
False,8226028,Heddesheim,Insgesamt,11631,5603,6028
False,8226029,Heiligkreuzsteinach,unter 3 Jahre,62,33,29
False,8226029,Heiligkreuzsteinach,3 -  6 Jahre,60,28,32
False,8226029,Heiligkreuzsteinach,6 - 10 Jahre,86,45,41
False,8226029,Heiligkreuzsteinach,10 - 15 Jahre,146,71,75
False,8226029,Heiligkreuzsteinach,15 - 18 Jahre,90,50,40
False,8226029,Heiligkreuzsteinach,18 - 20 Jahre,61,28,33
False,8226029,Heiligkreuzsteinach,20 - 25 Jahre,151,80,71
False,8226029,Heiligkreuzsteinach,25 - 30 Jahre,132,68,64
False,8226029,Heiligkreuzsteinach,30 - 35 Jahre,124,65,59
False,8226029,Heiligkreuzsteinach,35 - 40 Jahre,149,76,73
False,8226029,Heiligkreuzsteinach,40 - 45 Jahre,285,146,139
False,8226029,Heiligkreuzsteinach,45 - 50 Jahre,253,132,121
False,8226029,Heiligkreuzsteinach,50 - 55 Jahre,252,147,105
False,8226029,Heiligkreuzsteinach,55 - 60 Jahre,200,105,95
False,8226029,Heiligkreuzsteinach,60 - 65 Jahre,170,87,83
False,8226029,Heiligkreuzsteinach,65 - 75 Jahre,395,211,184
False,8226029,Heiligkreuzsteinach,75 und mehr Jahre,303,127,176
False,8226029,Heiligkreuzsteinach,Insgesamt,2919,1499,1420
False,8226031,"Hemsbach, Stadt",unter 3 Jahre,283,148,135
False,8226031,"Hemsbach, Stadt",3 -  6 Jahre,302,159,143
False,8226031,"Hemsbach, Stadt",6 - 10 Jahre,399,204,195
False,8226031,"Hemsbach, Stadt",10 - 15 Jahre,627,326,301
False,8226031,"Hemsbach, Stadt",15 - 18 Jahre,375,183,192
False,8226031,"Hemsbach, Stadt",18 - 20 Jahre,236,132,104
False,8226031,"Hemsbach, Stadt",20 - 25 Jahre,658,337,321
False,8226031,"Hemsbach, Stadt",25 - 30 Jahre,713,337,376
False,8226031,"Hemsbach, Stadt",30 - 35 Jahre,641,348,293
False,8226031,"Hemsbach, Stadt",35 - 40 Jahre,737,374,363
False,8226031,"Hemsbach, Stadt",40 - 45 Jahre,1051,551,500
False,8226031,"Hemsbach, Stadt",45 - 50 Jahre,1054,544,510
False,8226031,"Hemsbach, Stadt",50 - 55 Jahre,925,473,452
False,8226031,"Hemsbach, Stadt",55 - 60 Jahre,784,393,391
False,8226031,"Hemsbach, Stadt",60 - 65 Jahre,716,343,373
False,8226031,"Hemsbach, Stadt",65 - 75 Jahre,1656,778,878
False,8226031,"Hemsbach, Stadt",75 und mehr Jahre,1133,474,659
False,8226031,"Hemsbach, Stadt",Insgesamt,12290,6104,6186
False,8226032,"Hockenheim, Stadt",unter 3 Jahre,508,274,234
False,8226032,"Hockenheim, Stadt",3 -  6 Jahre,588,312,276
False,8226032,"Hockenheim, Stadt",6 - 10 Jahre,798,424,374
False,8226032,"Hockenheim, Stadt",10 - 15 Jahre,1115,563,552
False,8226032,"Hockenheim, Stadt",15 - 18 Jahre,695,336,359
False,8226032,"Hockenheim, Stadt",18 - 20 Jahre,459,233,226
False,8226032,"Hockenheim, Stadt",20 - 25 Jahre,1267,655,612
False,8226032,"Hockenheim, Stadt",25 - 30 Jahre,1263,638,625
False,8226032,"Hockenheim, Stadt",30 - 35 Jahre,1257,613,644
False,8226032,"Hockenheim, Stadt",35 - 40 Jahre,1315,665,650
False,8226032,"Hockenheim, Stadt",40 - 45 Jahre,1815,925,890
False,8226032,"Hockenheim, Stadt",45 - 50 Jahre,1926,960,966
False,8226032,"Hockenheim, Stadt",50 - 55 Jahre,1663,810,853
False,8226032,"Hockenheim, Stadt",55 - 60 Jahre,1329,678,651
False,8226032,"Hockenheim, Stadt",60 - 65 Jahre,1196,587,609
False,8226032,"Hockenheim, Stadt",65 - 75 Jahre,2118,1023,1095
False,8226032,"Hockenheim, Stadt",75 und mehr Jahre,1806,683,1123
False,8226032,"Hockenheim, Stadt",Insgesamt,21118,10379,10739
False,8226036,Ilvesheim,unter 3 Jahre,252,123,129
False,8226036,Ilvesheim,3 -  6 Jahre,246,137,109
False,8226036,Ilvesheim,6 - 10 Jahre,327,150,177
False,8226036,Ilvesheim,10 - 15 Jahre,403,215,188
False,8226036,Ilvesheim,15 - 18 Jahre,231,130,101
False,8226036,Ilvesheim,18 - 20 Jahre,122,67,55
False,8226036,Ilvesheim,20 - 25 Jahre,382,190,192
False,8226036,Ilvesheim,25 - 30 Jahre,413,192,221
False,8226036,Ilvesheim,30 - 35 Jahre,522,244,278
False,8226036,Ilvesheim,35 - 40 Jahre,582,281,301
False,8226036,Ilvesheim,40 - 45 Jahre,784,403,381
False,8226036,Ilvesheim,45 - 50 Jahre,710,345,365
False,8226036,Ilvesheim,50 - 55 Jahre,648,317,331
False,8226036,Ilvesheim,55 - 60 Jahre,567,277,290
False,8226036,Ilvesheim,60 - 65 Jahre,480,236,244
False,8226036,Ilvesheim,65 - 75 Jahre,892,421,471
False,8226036,Ilvesheim,75 und mehr Jahre,910,371,539
False,8226036,Ilvesheim,Insgesamt,8471,4099,4372
False,8226037,Ketsch,unter 3 Jahre,259,133,126
False,8226037,Ketsch,3 -  6 Jahre,260,131,129
False,8226037,Ketsch,6 - 10 Jahre,417,195,222
False,8226037,Ketsch,10 - 15 Jahre,678,344,334
False,8226037,Ketsch,15 - 18 Jahre,370,177,193
False,8226037,Ketsch,18 - 20 Jahre,281,146,135
False,8226037,Ketsch,20 - 25 Jahre,652,335,317
False,8226037,Ketsch,25 - 30 Jahre,647,304,343
False,8226037,Ketsch,30 - 35 Jahre,605,291,314
False,8226037,Ketsch,35 - 40 Jahre,699,331,368
False,8226037,Ketsch,40 - 45 Jahre,1144,554,590
False,8226037,Ketsch,45 - 50 Jahre,1148,617,531
False,8226037,Ketsch,50 - 55 Jahre,984,496,488
False,8226037,Ketsch,55 - 60 Jahre,820,411,409
False,8226037,Ketsch,60 - 65 Jahre,875,416,459
False,8226037,Ketsch,65 - 75 Jahre,1739,845,894
False,8226037,Ketsch,75 und mehr Jahre,1204,493,711
False,8226037,Ketsch,Insgesamt,12782,6219,6563
False,8226038,"Ladenburg, Stadt",unter 3 Jahre,305,163,142
False,8226038,"Ladenburg, Stadt",3 -  6 Jahre,295,148,147
False,8226038,"Ladenburg, Stadt",6 - 10 Jahre,378,182,196
False,8226038,"Ladenburg, Stadt",10 - 15 Jahre,576,294,282
False,8226038,"Ladenburg, Stadt",15 - 18 Jahre,374,196,178
False,8226038,"Ladenburg, Stadt",18 - 20 Jahre,243,126,117
False,8226038,"Ladenburg, Stadt",20 - 25 Jahre,526,284,242
False,8226038,"Ladenburg, Stadt",25 - 30 Jahre,532,272,260
False,8226038,"Ladenburg, Stadt",30 - 35 Jahre,605,294,311
False,8226038,"Ladenburg, Stadt",35 - 40 Jahre,685,326,359
False,8226038,"Ladenburg, Stadt",40 - 45 Jahre,881,414,467
False,8226038,"Ladenburg, Stadt",45 - 50 Jahre,942,472,470
False,8226038,"Ladenburg, Stadt",50 - 55 Jahre,896,425,471
False,8226038,"Ladenburg, Stadt",55 - 60 Jahre,872,406,466
False,8226038,"Ladenburg, Stadt",60 - 65 Jahre,754,372,382
False,8226038,"Ladenburg, Stadt",65 - 75 Jahre,1566,743,823
False,8226038,"Ladenburg, Stadt",75 und mehr Jahre,1083,426,657
False,8226038,"Ladenburg, Stadt",Insgesamt,11513,5543,5970
False,8226040,Laudenbach,unter 3 Jahre,143,78,65
False,8226040,Laudenbach,3 -  6 Jahre,156,84,72
False,8226040,Laudenbach,6 - 10 Jahre,266,148,118
False,8226040,Laudenbach,10 - 15 Jahre,332,170,162
False,8226040,Laudenbach,15 - 18 Jahre,219,114,105
False,8226040,Laudenbach,18 - 20 Jahre,131,70,61
False,8226040,Laudenbach,20 - 25 Jahre,319,149,170
False,8226040,Laudenbach,25 - 30 Jahre,258,134,124
False,8226040,Laudenbach,30 - 35 Jahre,310,144,166
False,8226040,Laudenbach,35 - 40 Jahre,359,170,189
False,8226040,Laudenbach,40 - 45 Jahre,547,263,284
False,8226040,Laudenbach,45 - 50 Jahre,526,271,255
False,8226040,Laudenbach,50 - 55 Jahre,503,227,276
False,8226040,Laudenbach,55 - 60 Jahre,397,200,197
False,8226040,Laudenbach,60 - 65 Jahre,400,171,229
False,8226040,Laudenbach,65 - 75 Jahre,716,374,342
False,8226040,Laudenbach,75 und mehr Jahre,469,189,280
False,8226040,Laudenbach,Insgesamt,6051,2956,3095
False,8226041,"Leimen, Stadt",unter 3 Jahre,766,416,350
False,8226041,"Leimen, Stadt",3 -  6 Jahre,719,384,335
False,8226041,"Leimen, Stadt",6 - 10 Jahre,933,464,469
False,8226041,"Leimen, Stadt",10 - 15 Jahre,1320,699,621
False,8226041,"Leimen, Stadt",15 - 18 Jahre,833,407,426
False,8226041,"Leimen, Stadt",18 - 20 Jahre,601,311,290
False,8226041,"Leimen, Stadt",20 - 25 Jahre,1811,905,906
False,8226041,"Leimen, Stadt",25 - 30 Jahre,1912,929,983
False,8226041,"Leimen, Stadt",30 - 35 Jahre,1799,899,900
False,8226041,"Leimen, Stadt",35 - 40 Jahre,1580,765,815
False,8226041,"Leimen, Stadt",40 - 45 Jahre,2085,1076,1009
False,8226041,"Leimen, Stadt",45 - 50 Jahre,2392,1205,1187
False,8226041,"Leimen, Stadt",50 - 55 Jahre,2211,1107,1104
False,8226041,"Leimen, Stadt",55 - 60 Jahre,1849,901,948
False,8226041,"Leimen, Stadt",60 - 65 Jahre,1505,739,766
False,8226041,"Leimen, Stadt",65 - 75 Jahre,2649,1249,1400
False,8226041,"Leimen, Stadt",75 und mehr Jahre,2260,904,1356
False,8226041,"Leimen, Stadt",Insgesamt,27225,13360,13865
False,8226046,Malsch,unter 3 Jahre,86,40,46
False,8226046,Malsch,3 -  6 Jahre,95,55,40
False,8226046,Malsch,6 - 10 Jahre,134,62,72
False,8226046,Malsch,10 - 15 Jahre,164,88,76
False,8226046,Malsch,15 - 18 Jahre,106,61,45
False,8226046,Malsch,18 - 20 Jahre,79,35,44
False,8226046,Malsch,20 - 25 Jahre,200,118,82
False,8226046,Malsch,25 - 30 Jahre,164,75,89
False,8226046,Malsch,30 - 35 Jahre,184,82,102
False,8226046,Malsch,35 - 40 Jahre,216,115,101
False,8226046,Malsch,40 - 45 Jahre,301,148,153
False,8226046,Malsch,45 - 50 Jahre,353,182,171
False,8226046,Malsch,50 - 55 Jahre,326,166,160
False,8226046,Malsch,55 - 60 Jahre,233,120,113
False,8226046,Malsch,60 - 65 Jahre,188,103,85
False,8226046,Malsch,65 - 75 Jahre,332,172,160
False,8226046,Malsch,75 und mehr Jahre,307,101,206
False,8226046,Malsch,Insgesamt,3468,1723,1745
False,8226048,Mauer,unter 3 Jahre,97,50,47
False,8226048,Mauer,3 -  6 Jahre,130,68,62
False,8226048,Mauer,6 - 10 Jahre,201,100,101
False,8226048,Mauer,10 - 15 Jahre,223,107,116
False,8226048,Mauer,15 - 18 Jahre,135,57,78
False,8226048,Mauer,18 - 20 Jahre,106,49,57
False,8226048,Mauer,20 - 25 Jahre,202,99,103
False,8226048,Mauer,25 - 30 Jahre,210,97,113
False,8226048,Mauer,30 - 35 Jahre,205,93,112
False,8226048,Mauer,35 - 40 Jahre,281,138,143
False,8226048,Mauer,40 - 45 Jahre,364,200,164
False,8226048,Mauer,45 - 50 Jahre,326,166,160
False,8226048,Mauer,50 - 55 Jahre,307,155,152
False,8226048,Mauer,55 - 60 Jahre,246,130,116
False,8226048,Mauer,60 - 65 Jahre,221,99,122
False,8226048,Mauer,65 - 75 Jahre,387,202,185
False,8226048,Mauer,75 und mehr Jahre,287,104,183
False,8226048,Mauer,Insgesamt,3928,1914,2014
False,8226049,Meckesheim,unter 3 Jahre,122,64,58
False,8226049,Meckesheim,3 -  6 Jahre,124,68,56
False,8226049,Meckesheim,6 - 10 Jahre,170,81,89
False,8226049,Meckesheim,10 - 15 Jahre,271,138,133
False,8226049,Meckesheim,15 - 18 Jahre,160,88,72
False,8226049,Meckesheim,18 - 20 Jahre,129,61,68
False,8226049,Meckesheim,20 - 25 Jahre,305,166,139
False,8226049,Meckesheim,25 - 30 Jahre,279,126,153
False,8226049,Meckesheim,30 - 35 Jahre,270,147,123
False,8226049,Meckesheim,35 - 40 Jahre,303,157,146
False,8226049,Meckesheim,40 - 45 Jahre,489,261,228
False,8226049,Meckesheim,45 - 50 Jahre,433,222,211
False,8226049,Meckesheim,50 - 55 Jahre,439,225,214
False,8226049,Meckesheim,55 - 60 Jahre,343,168,175
False,8226049,Meckesheim,60 - 65 Jahre,377,184,193
False,8226049,Meckesheim,65 - 75 Jahre,606,309,297
False,8226049,Meckesheim,75 und mehr Jahre,458,178,280
False,8226049,Meckesheim,Insgesamt,5278,2643,2635
False,8226054,Mühlhausen,unter 3 Jahre,207,116,91
False,8226054,Mühlhausen,3 -  6 Jahre,192,97,95
False,8226054,Mühlhausen,6 - 10 Jahre,381,203,178
False,8226054,Mühlhausen,10 - 15 Jahre,500,264,236
False,8226054,Mühlhausen,15 - 18 Jahre,324,183,141
False,8226054,Mühlhausen,18 - 20 Jahre,200,102,98
False,8226054,Mühlhausen,20 - 25 Jahre,445,228,217
False,8226054,Mühlhausen,25 - 30 Jahre,446,217,229
False,8226054,Mühlhausen,30 - 35 Jahre,462,202,260
False,8226054,Mühlhausen,35 - 40 Jahre,490,247,243
False,8226054,Mühlhausen,40 - 45 Jahre,789,377,412
False,8226054,Mühlhausen,45 - 50 Jahre,880,474,406
False,8226054,Mühlhausen,50 - 55 Jahre,684,370,314
False,8226054,Mühlhausen,55 - 60 Jahre,515,231,284
False,8226054,Mühlhausen,60 - 65 Jahre,447,223,224
False,8226054,Mühlhausen,65 - 75 Jahre,730,375,355
False,8226054,Mühlhausen,75 und mehr Jahre,553,211,342
False,8226054,Mühlhausen,Insgesamt,8245,4120,4125
False,8226055,"Neckarbischofsheim, Stadt",unter 3 Jahre,90,49,41
False,8226055,"Neckarbischofsheim, Stadt",3 -  6 Jahre,97,42,55
False,8226055,"Neckarbischofsheim, Stadt",6 - 10 Jahre,141,66,75
False,8226055,"Neckarbischofsheim, Stadt",10 - 15 Jahre,176,84,92
False,8226055,"Neckarbischofsheim, Stadt",15 - 18 Jahre,130,66,64
False,8226055,"Neckarbischofsheim, Stadt",18 - 20 Jahre,97,57,40
False,8226055,"Neckarbischofsheim, Stadt",20 - 25 Jahre,238,125,113
False,8226055,"Neckarbischofsheim, Stadt",25 - 30 Jahre,247,131,116
False,8226055,"Neckarbischofsheim, Stadt",30 - 35 Jahre,208,101,107
False,8226055,"Neckarbischofsheim, Stadt",35 - 40 Jahre,212,121,91
False,8226055,"Neckarbischofsheim, Stadt",40 - 45 Jahre,299,153,146
False,8226055,"Neckarbischofsheim, Stadt",45 - 50 Jahre,374,181,193
False,8226055,"Neckarbischofsheim, Stadt",50 - 55 Jahre,339,171,168
False,8226055,"Neckarbischofsheim, Stadt",55 - 60 Jahre,239,121,118
False,8226055,"Neckarbischofsheim, Stadt",60 - 65 Jahre,230,122,108
False,8226055,"Neckarbischofsheim, Stadt",65 - 75 Jahre,382,184,198
False,8226055,"Neckarbischofsheim, Stadt",75 und mehr Jahre,364,140,224
False,8226055,"Neckarbischofsheim, Stadt",Insgesamt,3863,1914,1949
False,8226056,"Neckargemünd, Stadt",unter 3 Jahre,301,161,140
False,8226056,"Neckargemünd, Stadt",3 -  6 Jahre,304,162,142
False,8226056,"Neckargemünd, Stadt",6 - 10 Jahre,445,221,224
False,8226056,"Neckargemünd, Stadt",10 - 15 Jahre,608,309,299
False,8226056,"Neckargemünd, Stadt",15 - 18 Jahre,397,228,169
False,8226056,"Neckargemünd, Stadt",18 - 20 Jahre,303,163,140
False,8226056,"Neckargemünd, Stadt",20 - 25 Jahre,821,413,408
False,8226056,"Neckargemünd, Stadt",25 - 30 Jahre,712,367,345
False,8226056,"Neckargemünd, Stadt",30 - 35 Jahre,759,397,362
False,8226056,"Neckargemünd, Stadt",35 - 40 Jahre,806,409,397
False,8226056,"Neckargemünd, Stadt",40 - 45 Jahre,1178,602,576
False,8226056,"Neckargemünd, Stadt",45 - 50 Jahre,1294,674,620
False,8226056,"Neckargemünd, Stadt",50 - 55 Jahre,1045,518,527
False,8226056,"Neckargemünd, Stadt",55 - 60 Jahre,1019,496,523
False,8226056,"Neckargemünd, Stadt",60 - 65 Jahre,858,389,469
False,8226056,"Neckargemünd, Stadt",65 - 75 Jahre,1722,780,942
False,8226056,"Neckargemünd, Stadt",75 und mehr Jahre,1333,561,772
False,8226056,"Neckargemünd, Stadt",Insgesamt,13905,6850,7055
False,8226058,Neidenstein,unter 3 Jahre,46,30,16
False,8226058,Neidenstein,3 -  6 Jahre,52,22,30
False,8226058,Neidenstein,6 - 10 Jahre,76,41,35
False,8226058,Neidenstein,10 - 15 Jahre,108,61,47
False,8226058,Neidenstein,15 - 18 Jahre,82,40,42
False,8226058,Neidenstein,18 - 20 Jahre,42,15,27
False,8226058,Neidenstein,20 - 25 Jahre,102,50,52
False,8226058,Neidenstein,25 - 30 Jahre,88,39,49
False,8226058,Neidenstein,30 - 35 Jahre,76,33,43
False,8226058,Neidenstein,35 - 40 Jahre,92,45,47
False,8226058,Neidenstein,40 - 45 Jahre,173,86,87
False,8226058,Neidenstein,45 - 50 Jahre,165,74,91
False,8226058,Neidenstein,50 - 55 Jahre,144,69,75
False,8226058,Neidenstein,55 - 60 Jahre,126,70,56
False,8226058,Neidenstein,60 - 65 Jahre,91,47,44
False,8226058,Neidenstein,65 - 75 Jahre,186,96,90
False,8226058,Neidenstein,75 und mehr Jahre,137,55,82
False,8226058,Neidenstein,Insgesamt,1786,873,913
False,8226059,Neulußheim,unter 3 Jahre,148,68,80
False,8226059,Neulußheim,3 -  6 Jahre,173,83,90
False,8226059,Neulußheim,6 - 10 Jahre,248,110,138
False,8226059,Neulußheim,10 - 15 Jahre,394,189,205
False,8226059,Neulußheim,15 - 18 Jahre,235,131,104
False,8226059,Neulußheim,18 - 20 Jahre,136,62,74
False,8226059,Neulußheim,20 - 25 Jahre,337,176,161
False,8226059,Neulußheim,25 - 30 Jahre,340,185,155
False,8226059,Neulußheim,30 - 35 Jahre,363,179,184
False,8226059,Neulußheim,35 - 40 Jahre,415,198,217
False,8226059,Neulußheim,40 - 45 Jahre,648,303,345
False,8226059,Neulußheim,45 - 50 Jahre,672,353,319
False,8226059,Neulußheim,50 - 55 Jahre,569,288,281
False,8226059,Neulußheim,55 - 60 Jahre,416,208,208
False,8226059,Neulußheim,60 - 65 Jahre,359,175,184
False,8226059,Neulußheim,65 - 75 Jahre,640,297,343
False,8226059,Neulußheim,75 und mehr Jahre,533,205,328
False,8226059,Neulußheim,Insgesamt,6626,3210,3416
False,8226060,Nußloch,unter 3 Jahre,291,169,122
False,8226060,Nußloch,3 -  6 Jahre,278,147,131
False,8226060,Nußloch,6 - 10 Jahre,367,211,156
False,8226060,Nußloch,10 - 15 Jahre,531,278,253
False,8226060,Nußloch,15 - 18 Jahre,303,149,154
False,8226060,Nußloch,18 - 20 Jahre,228,120,108
False,8226060,Nußloch,20 - 25 Jahre,592,282,310
False,8226060,Nußloch,25 - 30 Jahre,706,355,351
False,8226060,Nußloch,30 - 35 Jahre,588,292,296
False,8226060,Nußloch,35 - 40 Jahre,621,307,314
False,8226060,Nußloch,40 - 45 Jahre,944,475,469
False,8226060,Nußloch,45 - 50 Jahre,947,468,479
False,8226060,Nußloch,50 - 55 Jahre,848,402,446
False,8226060,Nußloch,55 - 60 Jahre,743,366,377
False,8226060,Nußloch,60 - 65 Jahre,655,311,344
False,8226060,Nußloch,65 - 75 Jahre,1148,561,587
False,8226060,Nußloch,75 und mehr Jahre,910,338,572
False,8226060,Nußloch,Insgesamt,10700,5231,5469
False,8226062,Oftersheim,unter 3 Jahre,333,177,156
False,8226062,Oftersheim,3 -  6 Jahre,318,181,137
False,8226062,Oftersheim,6 - 10 Jahre,455,246,209
False,8226062,Oftersheim,10 - 15 Jahre,524,254,270
False,8226062,Oftersheim,15 - 18 Jahre,324,159,165
False,8226062,Oftersheim,18 - 20 Jahre,207,109,98
False,8226062,Oftersheim,20 - 25 Jahre,568,307,261
False,8226062,Oftersheim,25 - 30 Jahre,621,293,328
False,8226062,Oftersheim,30 - 35 Jahre,677,310,367
False,8226062,Oftersheim,35 - 40 Jahre,720,356,364
False,8226062,Oftersheim,40 - 45 Jahre,976,456,520
False,8226062,Oftersheim,45 - 50 Jahre,971,494,477
False,8226062,Oftersheim,50 - 55 Jahre,781,368,413
False,8226062,Oftersheim,55 - 60 Jahre,724,316,408
False,8226062,Oftersheim,60 - 65 Jahre,705,349,356
False,8226062,Oftersheim,65 - 75 Jahre,1271,593,678
False,8226062,Oftersheim,75 und mehr Jahre,1017,414,603
False,8226062,Oftersheim,Insgesamt,11192,5382,5810
False,8226063,Plankstadt,unter 3 Jahre,234,128,106
False,8226063,Plankstadt,3 -  6 Jahre,254,126,128
False,8226063,Plankstadt,6 - 10 Jahre,313,151,162
False,8226063,Plankstadt,10 - 15 Jahre,486,258,228
False,8226063,Plankstadt,15 - 18 Jahre,318,165,153
False,8226063,Plankstadt,18 - 20 Jahre,210,101,109
False,8226063,Plankstadt,20 - 25 Jahre,528,281,247
False,8226063,Plankstadt,25 - 30 Jahre,512,269,243
False,8226063,Plankstadt,30 - 35 Jahre,490,216,274
False,8226063,Plankstadt,35 - 40 Jahre,578,276,302
False,8226063,Plankstadt,40 - 45 Jahre,813,403,410
False,8226063,Plankstadt,45 - 50 Jahre,868,416,452
False,8226063,Plankstadt,50 - 55 Jahre,729,374,355
False,8226063,Plankstadt,55 - 60 Jahre,665,307,358
False,8226063,Plankstadt,60 - 65 Jahre,622,300,322
False,8226063,Plankstadt,65 - 75 Jahre,1146,542,604
False,8226063,Plankstadt,75 und mehr Jahre,919,345,574
False,8226063,Plankstadt,Insgesamt,9685,4658,5027
False,8226065,"Rauenberg, Stadt",unter 3 Jahre,249,131,118
False,8226065,"Rauenberg, Stadt",3 -  6 Jahre,246,126,120
False,8226065,"Rauenberg, Stadt",6 - 10 Jahre,302,154,148
False,8226065,"Rauenberg, Stadt",10 - 15 Jahre,425,215,210
False,8226065,"Rauenberg, Stadt",15 - 18 Jahre,256,120,136
False,8226065,"Rauenberg, Stadt",18 - 20 Jahre,152,77,75
False,8226065,"Rauenberg, Stadt",20 - 25 Jahre,404,209,195
False,8226065,"Rauenberg, Stadt",25 - 30 Jahre,480,225,255
False,8226065,"Rauenberg, Stadt",30 - 35 Jahre,546,263,283
False,8226065,"Rauenberg, Stadt",35 - 40 Jahre,581,285,296
False,8226065,"Rauenberg, Stadt",40 - 45 Jahre,705,385,320
False,8226065,"Rauenberg, Stadt",45 - 50 Jahre,769,422,347
False,8226065,"Rauenberg, Stadt",50 - 55 Jahre,605,306,299
False,8226065,"Rauenberg, Stadt",55 - 60 Jahre,504,252,252
False,8226065,"Rauenberg, Stadt",60 - 65 Jahre,433,225,208
False,8226065,"Rauenberg, Stadt",65 - 75 Jahre,724,352,372
False,8226065,"Rauenberg, Stadt",75 und mehr Jahre,578,227,351
False,8226065,"Rauenberg, Stadt",Insgesamt,7959,3974,3985
False,8226066,Reichartshausen,unter 3 Jahre,62,32,30
False,8226066,Reichartshausen,3 -  6 Jahre,68,40,28
False,8226066,Reichartshausen,6 - 10 Jahre,90,42,48
False,8226066,Reichartshausen,10 - 15 Jahre,144,70,74
False,8226066,Reichartshausen,15 - 18 Jahre,52,23,29
False,8226066,Reichartshausen,18 - 20 Jahre,52,25,27
False,8226066,Reichartshausen,20 - 25 Jahre,142,85,57
False,8226066,Reichartshausen,25 - 30 Jahre,110,54,56
False,8226066,Reichartshausen,30 - 35 Jahre,110,53,57
False,8226066,Reichartshausen,35 - 40 Jahre,130,71,59
False,8226066,Reichartshausen,40 - 45 Jahre,176,85,91
False,8226066,Reichartshausen,45 - 50 Jahre,178,89,89
False,8226066,Reichartshausen,50 - 55 Jahre,165,94,71
False,8226066,Reichartshausen,55 - 60 Jahre,120,58,62
False,8226066,Reichartshausen,60 - 65 Jahre,94,47,47
False,8226066,Reichartshausen,65 - 75 Jahre,184,89,95
False,8226066,Reichartshausen,75 und mehr Jahre,158,60,98
False,8226066,Reichartshausen,Insgesamt,2035,1017,1018
False,8226068,Reilingen,unter 3 Jahre,169,79,90
False,8226068,Reilingen,3 -  6 Jahre,179,89,90
False,8226068,Reilingen,6 - 10 Jahre,247,119,128
False,8226068,Reilingen,10 - 15 Jahre,388,195,193
False,8226068,Reilingen,15 - 18 Jahre,225,120,105
False,8226068,Reilingen,18 - 20 Jahre,166,87,79
False,8226068,Reilingen,20 - 25 Jahre,375,181,194
False,8226068,Reilingen,25 - 30 Jahre,378,203,175
False,8226068,Reilingen,30 - 35 Jahre,398,195,203
False,8226068,Reilingen,35 - 40 Jahre,450,226,224
False,8226068,Reilingen,40 - 45 Jahre,618,300,318
False,8226068,Reilingen,45 - 50 Jahre,688,353,335
False,8226068,Reilingen,50 - 55 Jahre,584,303,281
False,8226068,Reilingen,55 - 60 Jahre,481,243,238
False,8226068,Reilingen,60 - 65 Jahre,442,207,235
False,8226068,Reilingen,65 - 75 Jahre,776,390,386
False,8226068,Reilingen,75 und mehr Jahre,575,213,362
False,8226068,Reilingen,Insgesamt,7139,3503,3636
False,8226076,Sandhausen,unter 3 Jahre,358,168,190
False,8226076,Sandhausen,3 -  6 Jahre,367,175,192
False,8226076,Sandhausen,6 - 10 Jahre,541,268,273
False,8226076,Sandhausen,10 - 15 Jahre,722,400,322
False,8226076,Sandhausen,15 - 18 Jahre,456,215,241
False,8226076,Sandhausen,18 - 20 Jahre,320,163,157
False,8226076,Sandhausen,20 - 25 Jahre,776,385,391
False,8226076,Sandhausen,25 - 30 Jahre,854,440,414
False,8226076,Sandhausen,30 - 35 Jahre,880,426,454
False,8226076,Sandhausen,35 - 40 Jahre,924,443,481
False,8226076,Sandhausen,40 - 45 Jahre,1224,619,605
False,8226076,Sandhausen,45 - 50 Jahre,1234,601,633
False,8226076,Sandhausen,50 - 55 Jahre,1090,513,577
False,8226076,Sandhausen,55 - 60 Jahre,997,495,502
False,8226076,Sandhausen,60 - 65 Jahre,917,429,488
False,8226076,Sandhausen,65 - 75 Jahre,1670,781,889
False,8226076,Sandhausen,75 und mehr Jahre,1212,489,723
False,8226076,Sandhausen,Insgesamt,14542,7010,7532
False,8226080,"Schönau, Stadt",unter 3 Jahre,103,52,51
False,8226080,"Schönau, Stadt",3 -  6 Jahre,112,60,52
False,8226080,"Schönau, Stadt",6 - 10 Jahre,161,90,71
False,8226080,"Schönau, Stadt",10 - 15 Jahre,237,128,109
False,8226080,"Schönau, Stadt",15 - 18 Jahre,170,86,84
False,8226080,"Schönau, Stadt",18 - 20 Jahre,92,54,38
False,8226080,"Schönau, Stadt",20 - 25 Jahre,223,132,91
False,8226080,"Schönau, Stadt",25 - 30 Jahre,188,99,89
False,8226080,"Schönau, Stadt",30 - 35 Jahre,193,87,106
False,8226080,"Schönau, Stadt",35 - 40 Jahre,235,104,131
False,8226080,"Schönau, Stadt",40 - 45 Jahre,382,190,192
False,8226080,"Schönau, Stadt",45 - 50 Jahre,405,193,212
False,8226080,"Schönau, Stadt",50 - 55 Jahre,375,211,164
False,8226080,"Schönau, Stadt",55 - 60 Jahre,351,165,186
False,8226080,"Schönau, Stadt",60 - 65 Jahre,281,138,143
False,8226080,"Schönau, Stadt",65 - 75 Jahre,566,263,303
False,8226080,"Schönau, Stadt",75 und mehr Jahre,452,171,281
False,8226080,"Schönau, Stadt",Insgesamt,4526,2223,2303
False,8226081,Schönbrunn,unter 3 Jahre,57,25,32
False,8226081,Schönbrunn,3 -  6 Jahre,66,35,31
False,8226081,Schönbrunn,6 - 10 Jahre,95,55,40
False,8226081,Schönbrunn,10 - 15 Jahre,159,84,75
False,8226081,Schönbrunn,15 - 18 Jahre,103,51,52
False,8226081,Schönbrunn,18 - 20 Jahre,80,43,37
False,8226081,Schönbrunn,20 - 25 Jahre,163,94,69
False,8226081,Schönbrunn,25 - 30 Jahre,138,76,62
False,8226081,Schönbrunn,30 - 35 Jahre,131,67,64
False,8226081,Schönbrunn,35 - 40 Jahre,147,73,74
False,8226081,Schönbrunn,40 - 45 Jahre,265,141,124
False,8226081,Schönbrunn,45 - 50 Jahre,270,134,136
False,8226081,Schönbrunn,50 - 55 Jahre,252,125,127
False,8226081,Schönbrunn,55 - 60 Jahre,214,109,105
False,8226081,Schönbrunn,60 - 65 Jahre,194,96,98
False,8226081,Schönbrunn,65 - 75 Jahre,336,181,155
False,8226081,Schönbrunn,75 und mehr Jahre,271,113,158
False,8226081,Schönbrunn,Insgesamt,2941,1502,1439
False,8226082,"Schriesheim, Stadt",unter 3 Jahre,408,198,210
False,8226082,"Schriesheim, Stadt",3 -  6 Jahre,438,243,195
False,8226082,"Schriesheim, Stadt",6 - 10 Jahre,588,321,267
False,8226082,"Schriesheim, Stadt",10 - 15 Jahre,698,348,350
False,8226082,"Schriesheim, Stadt",15 - 18 Jahre,435,219,216
False,8226082,"Schriesheim, Stadt",18 - 20 Jahre,287,159,128
False,8226082,"Schriesheim, Stadt",20 - 25 Jahre,814,416,398
False,8226082,"Schriesheim, Stadt",25 - 30 Jahre,836,422,414
False,8226082,"Schriesheim, Stadt",30 - 35 Jahre,876,409,467
False,8226082,"Schriesheim, Stadt",35 - 40 Jahre,904,445,459
False,8226082,"Schriesheim, Stadt",40 - 45 Jahre,1247,637,610
False,8226082,"Schriesheim, Stadt",45 - 50 Jahre,1354,660,694
False,8226082,"Schriesheim, Stadt",50 - 55 Jahre,1116,556,560
False,8226082,"Schriesheim, Stadt",55 - 60 Jahre,984,469,515
False,8226082,"Schriesheim, Stadt",60 - 65 Jahre,956,455,501
False,8226082,"Schriesheim, Stadt",65 - 75 Jahre,1690,825,865
False,8226082,"Schriesheim, Stadt",75 und mehr Jahre,1277,482,795
False,8226082,"Schriesheim, Stadt",Insgesamt,14908,7264,7644
False,8226084,"Schwetzingen, Stadt",unter 3 Jahre,571,276,295
False,8226084,"Schwetzingen, Stadt",3 -  6 Jahre,524,269,255
False,8226084,"Schwetzingen, Stadt",6 - 10 Jahre,667,322,345
False,8226084,"Schwetzingen, Stadt",10 - 15 Jahre,969,471,498
False,8226084,"Schwetzingen, Stadt",15 - 18 Jahre,634,312,322
False,8226084,"Schwetzingen, Stadt",18 - 20 Jahre,449,229,220
False,8226084,"Schwetzingen, Stadt",20 - 25 Jahre,1265,625,640
False,8226084,"Schwetzingen, Stadt",25 - 30 Jahre,1413,703,710
False,8226084,"Schwetzingen, Stadt",30 - 35 Jahre,1506,733,773
False,8226084,"Schwetzingen, Stadt",35 - 40 Jahre,1501,755,746
False,8226084,"Schwetzingen, Stadt",40 - 45 Jahre,1981,1032,949
False,8226084,"Schwetzingen, Stadt",45 - 50 Jahre,2005,1034,971
False,8226084,"Schwetzingen, Stadt",50 - 55 Jahre,1750,860,890
False,8226084,"Schwetzingen, Stadt",55 - 60 Jahre,1326,649,677
False,8226084,"Schwetzingen, Stadt",60 - 65 Jahre,1247,629,618
False,8226084,"Schwetzingen, Stadt",65 - 75 Jahre,2304,1059,1245
False,8226084,"Schwetzingen, Stadt",75 und mehr Jahre,1677,592,1085
False,8226084,"Schwetzingen, Stadt",Insgesamt,21789,10550,11239
False,8226085,"Sinsheim, Stadt",unter 3 Jahre,886,441,445
False,8226085,"Sinsheim, Stadt",3 -  6 Jahre,966,490,476
False,8226085,"Sinsheim, Stadt",6 - 10 Jahre,1492,743,749
False,8226085,"Sinsheim, Stadt",10 - 15 Jahre,2035,1016,1019
False,8226085,"Sinsheim, Stadt",15 - 18 Jahre,1263,625,638
False,8226085,"Sinsheim, Stadt",18 - 20 Jahre,960,490,470
False,8226085,"Sinsheim, Stadt",20 - 25 Jahre,2194,1173,1021
False,8226085,"Sinsheim, Stadt",25 - 30 Jahre,1916,956,960
False,8226085,"Sinsheim, Stadt",30 - 35 Jahre,2017,1030,987
False,8226085,"Sinsheim, Stadt",35 - 40 Jahre,2210,1046,1164
False,8226085,"Sinsheim, Stadt",40 - 45 Jahre,2922,1481,1441
False,8226085,"Sinsheim, Stadt",45 - 50 Jahre,3171,1628,1543
False,8226085,"Sinsheim, Stadt",50 - 55 Jahre,2792,1388,1404
False,8226085,"Sinsheim, Stadt",55 - 60 Jahre,2392,1158,1234
False,8226085,"Sinsheim, Stadt",60 - 65 Jahre,1983,1016,967
False,8226085,"Sinsheim, Stadt",65 - 75 Jahre,3465,1703,1762
False,8226085,"Sinsheim, Stadt",75 und mehr Jahre,2728,1021,1707
False,8226085,"Sinsheim, Stadt",Insgesamt,35392,17405,17987
False,8226086,Spechbach,unter 3 Jahre,31,14,17
False,8226086,Spechbach,3 -  6 Jahre,55,29,26
False,8226086,Spechbach,6 - 10 Jahre,81,43,38
False,8226086,Spechbach,10 - 15 Jahre,92,43,49
False,8226086,Spechbach,15 - 18 Jahre,51,34,17
False,8226086,Spechbach,18 - 20 Jahre,49,21,28
False,8226086,Spechbach,20 - 25 Jahre,105,61,44
False,8226086,Spechbach,25 - 30 Jahre,77,38,39
False,8226086,Spechbach,30 - 35 Jahre,84,43,41
False,8226086,Spechbach,35 - 40 Jahre,114,57,57
False,8226086,Spechbach,40 - 45 Jahre,140,69,71
False,8226086,Spechbach,45 - 50 Jahre,142,74,68
False,8226086,Spechbach,50 - 55 Jahre,152,78,74
False,8226086,Spechbach,55 - 60 Jahre,106,48,58
False,8226086,Spechbach,60 - 65 Jahre,96,54,42
False,8226086,Spechbach,65 - 75 Jahre,184,81,103
False,8226086,Spechbach,75 und mehr Jahre,175,60,115
False,8226086,Spechbach,Insgesamt,1734,847,887
False,8226091,"Waibstadt, Stadt",unter 3 Jahre,137,56,81
False,8226091,"Waibstadt, Stadt",3 -  6 Jahre,129,70,59
False,8226091,"Waibstadt, Stadt",6 - 10 Jahre,210,100,110
False,8226091,"Waibstadt, Stadt",10 - 15 Jahre,319,141,178
False,8226091,"Waibstadt, Stadt",15 - 18 Jahre,241,132,109
False,8226091,"Waibstadt, Stadt",18 - 20 Jahre,153,90,63
False,8226091,"Waibstadt, Stadt",20 - 25 Jahre,364,185,179
False,8226091,"Waibstadt, Stadt",25 - 30 Jahre,317,163,154
False,8226091,"Waibstadt, Stadt",30 - 35 Jahre,279,144,135
False,8226091,"Waibstadt, Stadt",35 - 40 Jahre,351,175,176
False,8226091,"Waibstadt, Stadt",40 - 45 Jahre,461,241,220
False,8226091,"Waibstadt, Stadt",45 - 50 Jahre,514,264,250
False,8226091,"Waibstadt, Stadt",50 - 55 Jahre,444,223,221
False,8226091,"Waibstadt, Stadt",55 - 60 Jahre,386,189,197
False,8226091,"Waibstadt, Stadt",60 - 65 Jahre,318,172,146
False,8226091,"Waibstadt, Stadt",65 - 75 Jahre,614,285,329
False,8226091,"Waibstadt, Stadt",75 und mehr Jahre,486,179,307
False,8226091,"Waibstadt, Stadt",Insgesamt,5723,2809,2914
False,8226095,"Walldorf, Stadt",unter 3 Jahre,359,196,163
False,8226095,"Walldorf, Stadt",3 -  6 Jahre,443,246,197
False,8226095,"Walldorf, Stadt",6 - 10 Jahre,659,352,307
False,8226095,"Walldorf, Stadt",10 - 15 Jahre,859,438,421
False,8226095,"Walldorf, Stadt",15 - 18 Jahre,489,274,215
False,8226095,"Walldorf, Stadt",18 - 20 Jahre,314,160,154
False,8226095,"Walldorf, Stadt",20 - 25 Jahre,762,400,362
False,8226095,"Walldorf, Stadt",25 - 30 Jahre,754,360,394
False,8226095,"Walldorf, Stadt",30 - 35 Jahre,860,443,417
False,8226095,"Walldorf, Stadt",35 - 40 Jahre,876,425,451
False,8226095,"Walldorf, Stadt",40 - 45 Jahre,1442,729,713
False,8226095,"Walldorf, Stadt",45 - 50 Jahre,1399,732,667
False,8226095,"Walldorf, Stadt",50 - 55 Jahre,1025,545,480
False,8226095,"Walldorf, Stadt",55 - 60 Jahre,841,415,426
False,8226095,"Walldorf, Stadt",60 - 65 Jahre,813,384,429
False,8226095,"Walldorf, Stadt",65 - 75 Jahre,1666,764,902
False,8226095,"Walldorf, Stadt",75 und mehr Jahre,1263,537,726
False,8226095,"Walldorf, Stadt",Insgesamt,14824,7400,7424
False,8226096,"Weinheim, Stadt",unter 3 Jahre,1079,562,517
False,8226096,"Weinheim, Stadt",3 -  6 Jahre,1127,579,548
False,8226096,"Weinheim, Stadt",6 - 10 Jahre,1502,789,713
False,8226096,"Weinheim, Stadt",10 - 15 Jahre,2121,1089,1032
False,8226096,"Weinheim, Stadt",15 - 18 Jahre,1286,636,650
False,8226096,"Weinheim, Stadt",18 - 20 Jahre,901,489,412
False,8226096,"Weinheim, Stadt",20 - 25 Jahre,2077,1027,1050
False,8226096,"Weinheim, Stadt",25 - 30 Jahre,2188,1067,1121
False,8226096,"Weinheim, Stadt",30 - 35 Jahre,2347,1111,1236
False,8226096,"Weinheim, Stadt",35 - 40 Jahre,2695,1293,1402
False,8226096,"Weinheim, Stadt",40 - 45 Jahre,3749,1933,1816
False,8226096,"Weinheim, Stadt",45 - 50 Jahre,3870,1989,1881
False,8226096,"Weinheim, Stadt",50 - 55 Jahre,3264,1652,1612
False,8226096,"Weinheim, Stadt",55 - 60 Jahre,2736,1347,1389
False,8226096,"Weinheim, Stadt",60 - 65 Jahre,2570,1177,1393
False,8226096,"Weinheim, Stadt",65 - 75 Jahre,5686,2683,3003
False,8226096,"Weinheim, Stadt",75 und mehr Jahre,4484,1813,2671
False,8226096,"Weinheim, Stadt",Insgesamt,43682,21236,22446
False,8226097,Wiesenbach,unter 3 Jahre,57,27,30
False,8226097,Wiesenbach,3 -  6 Jahre,78,34,44
False,8226097,Wiesenbach,6 - 10 Jahre,115,62,53
False,8226097,Wiesenbach,10 - 15 Jahre,180,98,82
False,8226097,Wiesenbach,15 - 18 Jahre,133,63,70
False,8226097,Wiesenbach,18 - 20 Jahre,85,39,46
False,8226097,Wiesenbach,20 - 25 Jahre,133,75,58
False,8226097,Wiesenbach,25 - 30 Jahre,148,74,74
False,8226097,Wiesenbach,30 - 35 Jahre,151,83,68
False,8226097,Wiesenbach,35 - 40 Jahre,151,71,80
False,8226097,Wiesenbach,40 - 45 Jahre,262,124,138
False,8226097,Wiesenbach,45 - 50 Jahre,278,127,151
False,8226097,Wiesenbach,50 - 55 Jahre,236,114,122
False,8226097,Wiesenbach,55 - 60 Jahre,185,92,93
False,8226097,Wiesenbach,60 - 65 Jahre,180,79,101
False,8226097,Wiesenbach,65 - 75 Jahre,413,196,217
False,8226097,Wiesenbach,75 und mehr Jahre,286,130,156
False,8226097,Wiesenbach,Insgesamt,3071,1488,1583
False,8226098,"Wiesloch, Stadt",unter 3 Jahre,680,358,322
False,8226098,"Wiesloch, Stadt",3 -  6 Jahre,692,351,341
False,8226098,"Wiesloch, Stadt",6 - 10 Jahre,999,530,469
False,8226098,"Wiesloch, Stadt",10 - 15 Jahre,1367,713,654
False,8226098,"Wiesloch, Stadt",15 - 18 Jahre,830,405,425
False,8226098,"Wiesloch, Stadt",18 - 20 Jahre,592,284,308
False,8226098,"Wiesloch, Stadt",20 - 25 Jahre,1455,740,715
False,8226098,"Wiesloch, Stadt",25 - 30 Jahre,1477,747,730
False,8226098,"Wiesloch, Stadt",30 - 35 Jahre,1522,762,760
False,8226098,"Wiesloch, Stadt",35 - 40 Jahre,1603,791,812
False,8226098,"Wiesloch, Stadt",40 - 45 Jahre,2299,1169,1130
False,8226098,"Wiesloch, Stadt",45 - 50 Jahre,2353,1144,1209
False,8226098,"Wiesloch, Stadt",50 - 55 Jahre,2023,993,1030
False,8226098,"Wiesloch, Stadt",55 - 60 Jahre,1715,878,837
False,8226098,"Wiesloch, Stadt",60 - 65 Jahre,1468,720,748
False,8226098,"Wiesloch, Stadt",65 - 75 Jahre,2736,1344,1392
False,8226098,"Wiesloch, Stadt",75 und mehr Jahre,2223,842,1381
False,8226098,"Wiesloch, Stadt",Insgesamt,26034,12771,13263
False,8226099,Wilhelmsfeld,unter 3 Jahre,79,34,45
False,8226099,Wilhelmsfeld,3 -  6 Jahre,71,33,38
False,8226099,Wilhelmsfeld,6 - 10 Jahre,108,52,56
False,8226099,Wilhelmsfeld,10 - 15 Jahre,173,83,90
False,8226099,Wilhelmsfeld,15 - 18 Jahre,112,58,54
False,8226099,Wilhelmsfeld,18 - 20 Jahre,77,35,42
False,8226099,Wilhelmsfeld,20 - 25 Jahre,171,78,93
False,8226099,Wilhelmsfeld,25 - 30 Jahre,150,72,78
False,8226099,Wilhelmsfeld,30 - 35 Jahre,154,77,77
False,8226099,Wilhelmsfeld,35 - 40 Jahre,182,92,90
False,8226099,Wilhelmsfeld,40 - 45 Jahre,251,136,115
False,8226099,Wilhelmsfeld,45 - 50 Jahre,304,145,159
False,8226099,Wilhelmsfeld,50 - 55 Jahre,273,135,138
False,8226099,Wilhelmsfeld,55 - 60 Jahre,231,131,100
False,8226099,Wilhelmsfeld,60 - 65 Jahre,193,103,90
False,8226099,Wilhelmsfeld,65 - 75 Jahre,398,191,207
False,8226099,Wilhelmsfeld,75 und mehr Jahre,331,128,203
False,8226099,Wilhelmsfeld,Insgesamt,3258,1583,1675
False,8226101,Zuzenhausen,unter 3 Jahre,63,29,34
False,8226101,Zuzenhausen,3 -  6 Jahre,68,35,33
False,8226101,Zuzenhausen,6 - 10 Jahre,92,49,43
False,8226101,Zuzenhausen,10 - 15 Jahre,123,62,61
False,8226101,Zuzenhausen,15 - 18 Jahre,75,36,39
False,8226101,Zuzenhausen,18 - 20 Jahre,59,34,25
False,8226101,Zuzenhausen,20 - 25 Jahre,117,58,59
False,8226101,Zuzenhausen,25 - 30 Jahre,117,65,52
False,8226101,Zuzenhausen,30 - 35 Jahre,117,51,66
False,8226101,Zuzenhausen,35 - 40 Jahre,138,68,70
False,8226101,Zuzenhausen,40 - 45 Jahre,204,105,99
False,8226101,Zuzenhausen,45 - 50 Jahre,206,109,97
False,8226101,Zuzenhausen,50 - 55 Jahre,150,76,74
False,8226101,Zuzenhausen,55 - 60 Jahre,127,57,70
False,8226101,Zuzenhausen,60 - 65 Jahre,131,65,66
False,8226101,Zuzenhausen,65 - 75 Jahre,222,106,116
False,8226101,Zuzenhausen,75 und mehr Jahre,173,70,103
False,8226101,Zuzenhausen,Insgesamt,2182,1075,1107
False,8226102,Angelbachtal,unter 3 Jahre,126,56,70
False,8226102,Angelbachtal,3 -  6 Jahre,132,65,67
False,8226102,Angelbachtal,6 - 10 Jahre,173,76,97
False,8226102,Angelbachtal,10 - 15 Jahre,304,148,156
False,8226102,Angelbachtal,15 - 18 Jahre,189,94,95
False,8226102,Angelbachtal,18 - 20 Jahre,135,78,57
False,8226102,Angelbachtal,20 - 25 Jahre,264,142,122
False,8226102,Angelbachtal,25 - 30 Jahre,232,99,133
False,8226102,Angelbachtal,30 - 35 Jahre,230,120,110
False,8226102,Angelbachtal,35 - 40 Jahre,345,157,188
False,8226102,Angelbachtal,40 - 45 Jahre,477,239,238
False,8226102,Angelbachtal,45 - 50 Jahre,485,247,238
False,8226102,Angelbachtal,50 - 55 Jahre,375,201,174
False,8226102,Angelbachtal,55 - 60 Jahre,275,142,133
False,8226102,Angelbachtal,60 - 65 Jahre,280,130,150
False,8226102,Angelbachtal,65 - 75 Jahre,493,230,263
False,8226102,Angelbachtal,75 und mehr Jahre,445,138,307
False,8226102,Angelbachtal,Insgesamt,4960,2362,2598
False,8226103,St. Leon-Rot,unter 3 Jahre,370,191,179
False,8226103,St. Leon-Rot,3 -  6 Jahre,355,193,162
False,8226103,St. Leon-Rot,6 - 10 Jahre,547,299,248
False,8226103,St. Leon-Rot,10 - 15 Jahre,749,374,375
False,8226103,St. Leon-Rot,15 - 18 Jahre,495,259,236
False,8226103,St. Leon-Rot,18 - 20 Jahre,353,197,156
False,8226103,St. Leon-Rot,20 - 25 Jahre,762,390,372
False,8226103,St. Leon-Rot,25 - 30 Jahre,675,364,311
False,8226103,St. Leon-Rot,30 - 35 Jahre,693,344,349
False,8226103,St. Leon-Rot,35 - 40 Jahre,813,400,413
False,8226103,St. Leon-Rot,40 - 45 Jahre,1122,527,595
False,8226103,St. Leon-Rot,45 - 50 Jahre,1240,636,604
False,8226103,St. Leon-Rot,50 - 55 Jahre,1081,555,526
False,8226103,St. Leon-Rot,55 - 60 Jahre,793,402,391
False,8226103,St. Leon-Rot,60 - 65 Jahre,692,351,341
False,8226103,St. Leon-Rot,65 - 75 Jahre,1150,560,590
False,8226103,St. Leon-Rot,75 und mehr Jahre,949,360,589
False,8226103,St. Leon-Rot,Insgesamt,12839,6402,6437
False,8226104,Lobbach,unter 3 Jahre,65,38,27
False,8226104,Lobbach,3 -  6 Jahre,61,29,32
False,8226104,Lobbach,6 - 10 Jahre,84,47,37
False,8226104,Lobbach,10 - 15 Jahre,142,82,60
False,8226104,Lobbach,15 - 18 Jahre,96,49,47
False,8226104,Lobbach,18 - 20 Jahre,49,24,25
False,8226104,Lobbach,20 - 25 Jahre,132,76,56
False,8226104,Lobbach,25 - 30 Jahre,105,57,48
False,8226104,Lobbach,30 - 35 Jahre,137,62,75
False,8226104,Lobbach,35 - 40 Jahre,118,58,60
False,8226104,Lobbach,40 - 45 Jahre,216,107,109
False,8226104,Lobbach,45 - 50 Jahre,210,95,115
False,8226104,Lobbach,50 - 55 Jahre,205,100,105
False,8226104,Lobbach,55 - 60 Jahre,191,100,91
False,8226104,Lobbach,60 - 65 Jahre,150,77,73
False,8226104,Lobbach,65 - 75 Jahre,250,131,119
False,8226104,Lobbach,75 und mehr Jahre,189,64,125
False,8226104,Lobbach,Insgesamt,2400,1196,1204
False,8226105,Edingen-Neckarhausen,unter 3 Jahre,369,192,177
False,8226105,Edingen-Neckarhausen,3 -  6 Jahre,382,187,195
False,8226105,Edingen-Neckarhausen,6 - 10 Jahre,529,251,278
False,8226105,Edingen-Neckarhausen,10 - 15 Jahre,679,345,334
False,8226105,Edingen-Neckarhausen,15 - 18 Jahre,437,227,210
False,8226105,Edingen-Neckarhausen,18 - 20 Jahre,275,137,138
False,8226105,Edingen-Neckarhausen,20 - 25 Jahre,705,345,360
False,8226105,Edingen-Neckarhausen,25 - 30 Jahre,833,401,432
False,8226105,Edingen-Neckarhausen,30 - 35 Jahre,832,412,420
False,8226105,Edingen-Neckarhausen,35 - 40 Jahre,809,411,398
False,8226105,Edingen-Neckarhausen,40 - 45 Jahre,1197,576,621
False,8226105,Edingen-Neckarhausen,45 - 50 Jahre,1263,616,647
False,8226105,Edingen-Neckarhausen,50 - 55 Jahre,1063,549,514
False,8226105,Edingen-Neckarhausen,55 - 60 Jahre,919,455,464
False,8226105,Edingen-Neckarhausen,60 - 65 Jahre,864,398,466
False,8226105,Edingen-Neckarhausen,65 - 75 Jahre,1676,784,892
False,8226105,Edingen-Neckarhausen,75 und mehr Jahre,1547,654,893
False,8226105,Edingen-Neckarhausen,Insgesamt,14379,6940,7439
False,8226106,Helmstadt-Bargen,unter 3 Jahre,83,45,38
False,8226106,Helmstadt-Bargen,3 -  6 Jahre,80,50,30
False,8226106,Helmstadt-Bargen,6 - 10 Jahre,142,73,69
False,8226106,Helmstadt-Bargen,10 - 15 Jahre,229,108,121
False,8226106,Helmstadt-Bargen,15 - 18 Jahre,153,79,74
False,8226106,Helmstadt-Bargen,18 - 20 Jahre,115,58,57
False,8226106,Helmstadt-Bargen,20 - 25 Jahre,246,121,125
False,8226106,Helmstadt-Bargen,25 - 30 Jahre,189,102,87
False,8226106,Helmstadt-Bargen,30 - 35 Jahre,185,86,99
False,8226106,Helmstadt-Bargen,35 - 40 Jahre,214,113,101
False,8226106,Helmstadt-Bargen,40 - 45 Jahre,265,134,131
False,8226106,Helmstadt-Bargen,45 - 50 Jahre,341,169,172
False,8226106,Helmstadt-Bargen,50 - 55 Jahre,356,177,179
False,8226106,Helmstadt-Bargen,55 - 60 Jahre,240,117,123
False,8226106,Helmstadt-Bargen,60 - 65 Jahre,219,104,115
False,8226106,Helmstadt-Bargen,65 - 75 Jahre,350,179,171
False,8226106,Helmstadt-Bargen,75 und mehr Jahre,299,122,177
False,8226106,Helmstadt-Bargen,Insgesamt,3706,1837,1869
False,8226107,Hirschberg an der Bergstraße,unter 3 Jahre,262,124,138
False,8226107,Hirschberg an der Bergstraße,3 -  6 Jahre,257,123,134
False,8226107,Hirschberg an der Bergstraße,6 - 10 Jahre,337,163,174
False,8226107,Hirschberg an der Bergstraße,10 - 15 Jahre,425,222,203
False,8226107,Hirschberg an der Bergstraße,15 - 18 Jahre,245,131,114
False,8226107,Hirschberg an der Bergstraße,18 - 20 Jahre,150,72,78
False,8226107,Hirschberg an der Bergstraße,20 - 25 Jahre,410,188,222
False,8226107,Hirschberg an der Bergstraße,25 - 30 Jahre,473,213,260
False,8226107,Hirschberg an der Bergstraße,30 - 35 Jahre,520,255,265
False,8226107,Hirschberg an der Bergstraße,35 - 40 Jahre,550,259,291
False,8226107,Hirschberg an der Bergstraße,40 - 45 Jahre,839,440,399
False,8226107,Hirschberg an der Bergstraße,45 - 50 Jahre,915,455,460
False,8226107,Hirschberg an der Bergstraße,50 - 55 Jahre,696,322,374
False,8226107,Hirschberg an der Bergstraße,55 - 60 Jahre,597,272,325
False,8226107,Hirschberg an der Bergstraße,60 - 65 Jahre,645,299,346
False,8226107,Hirschberg an der Bergstraße,65 - 75 Jahre,1290,606,684
False,8226107,Hirschberg an der Bergstraße,75 und mehr Jahre,928,417,511
False,8226107,Hirschberg an der Bergstraße,Insgesamt,9539,4561,4978
False,8231,Stadtkreis Pforzheim,unter 3 Jahre,3148,1635,1513
False,8231,Stadtkreis Pforzheim,3 -  6 Jahre,3213,1645,1568
False,8231,Stadtkreis Pforzheim,6 - 10 Jahre,4251,2206,2045
False,8231,Stadtkreis Pforzheim,10 - 15 Jahre,5964,3034,2930
False,8231,Stadtkreis Pforzheim,15 - 18 Jahre,3622,1865,1757
False,8231,Stadtkreis Pforzheim,18 - 20 Jahre,2702,1346,1356
False,8231,Stadtkreis Pforzheim,20 - 25 Jahre,7725,3985,3740
False,8231,Stadtkreis Pforzheim,25 - 30 Jahre,7911,4004,3907
False,8231,Stadtkreis Pforzheim,30 - 35 Jahre,7359,3767,3592
False,8231,Stadtkreis Pforzheim,35 - 40 Jahre,7126,3567,3559
False,8231,Stadtkreis Pforzheim,40 - 45 Jahre,8956,4590,4366
False,8231,Stadtkreis Pforzheim,45 - 50 Jahre,9885,5080,4805
False,8231,Stadtkreis Pforzheim,50 - 55 Jahre,8784,4438,4346
False,8231,Stadtkreis Pforzheim,55 - 60 Jahre,7421,3591,3830
False,8231,Stadtkreis Pforzheim,60 - 65 Jahre,6586,3043,3543
False,8231,Stadtkreis Pforzheim,65 - 75 Jahre,13013,5928,7085
False,8231,Stadtkreis Pforzheim,75 und mehr Jahre,12115,4304,7811
False,8231,Stadtkreis Pforzheim,Insgesamt,119781,58028,61753
False,8231000,"Pforzheim, Stadt",unter 3 Jahre,3148,1635,1513
False,8231000,"Pforzheim, Stadt",3 -  6 Jahre,3213,1645,1568
False,8231000,"Pforzheim, Stadt",6 - 10 Jahre,4251,2206,2045
False,8231000,"Pforzheim, Stadt",10 - 15 Jahre,5964,3034,2930
False,8231000,"Pforzheim, Stadt",15 - 18 Jahre,3622,1865,1757
False,8231000,"Pforzheim, Stadt",18 - 20 Jahre,2702,1346,1356
False,8231000,"Pforzheim, Stadt",20 - 25 Jahre,7725,3985,3740
False,8231000,"Pforzheim, Stadt",25 - 30 Jahre,7911,4004,3907
False,8231000,"Pforzheim, Stadt",30 - 35 Jahre,7359,3767,3592
False,8231000,"Pforzheim, Stadt",35 - 40 Jahre,7126,3567,3559
False,8231000,"Pforzheim, Stadt",40 - 45 Jahre,8956,4590,4366
False,8231000,"Pforzheim, Stadt",45 - 50 Jahre,9885,5080,4805
False,8231000,"Pforzheim, Stadt",50 - 55 Jahre,8784,4438,4346
False,8231000,"Pforzheim, Stadt",55 - 60 Jahre,7421,3591,3830
False,8231000,"Pforzheim, Stadt",60 - 65 Jahre,6586,3043,3543
False,8231000,"Pforzheim, Stadt",65 - 75 Jahre,13013,5928,7085
False,8231000,"Pforzheim, Stadt",75 und mehr Jahre,12115,4304,7811
False,8231000,"Pforzheim, Stadt",Insgesamt,119781,58028,61753
False,8235,Landkreis Calw,unter 3 Jahre,3788,1914,1874
False,8235,Landkreis Calw,3 -  6 Jahre,4090,2158,1932
False,8235,Landkreis Calw,6 - 10 Jahre,6193,3167,3026
False,8235,Landkreis Calw,10 - 15 Jahre,9063,4634,4429
False,8235,Landkreis Calw,15 - 18 Jahre,5666,2972,2694
False,8235,Landkreis Calw,18 - 20 Jahre,3965,2049,1916
False,8235,Landkreis Calw,20 - 25 Jahre,9280,4843,4437
False,8235,Landkreis Calw,25 - 30 Jahre,8206,4246,3960
False,8235,Landkreis Calw,30 - 35 Jahre,8363,4199,4164
False,8235,Landkreis Calw,35 - 40 Jahre,9430,4644,4786
False,8235,Landkreis Calw,40 - 45 Jahre,12797,6419,6378
False,8235,Landkreis Calw,45 - 50 Jahre,14250,7274,6976
False,8235,Landkreis Calw,50 - 55 Jahre,12222,6151,6071
False,8235,Landkreis Calw,55 - 60 Jahre,10439,5179,5260
False,8235,Landkreis Calw,60 - 65 Jahre,8626,4301,4325
False,8235,Landkreis Calw,65 - 75 Jahre,16634,7945,8689
False,8235,Landkreis Calw,75 und mehr Jahre,14259,5570,8689
False,8235,Landkreis Calw,Insgesamt,157271,77665,79606
False,8235006,"Altensteig, Stadt",unter 3 Jahre,269,126,143
False,8235006,"Altensteig, Stadt",3 -  6 Jahre,328,173,155
False,8235006,"Altensteig, Stadt",6 - 10 Jahre,447,242,205
False,8235006,"Altensteig, Stadt",10 - 15 Jahre,716,369,347
False,8235006,"Altensteig, Stadt",15 - 18 Jahre,448,202,246
False,8235006,"Altensteig, Stadt",18 - 20 Jahre,302,145,157
False,8235006,"Altensteig, Stadt",20 - 25 Jahre,693,361,332
False,8235006,"Altensteig, Stadt",25 - 30 Jahre,591,277,314
False,8235006,"Altensteig, Stadt",30 - 35 Jahre,603,294,309
False,8235006,"Altensteig, Stadt",35 - 40 Jahre,669,344,325
False,8235006,"Altensteig, Stadt",40 - 45 Jahre,868,437,431
False,8235006,"Altensteig, Stadt",45 - 50 Jahre,886,449,437
False,8235006,"Altensteig, Stadt",50 - 55 Jahre,781,401,380
False,8235006,"Altensteig, Stadt",55 - 60 Jahre,646,318,328
False,8235006,"Altensteig, Stadt",60 - 65 Jahre,517,280,237
False,8235006,"Altensteig, Stadt",65 - 75 Jahre,1043,514,529
False,8235006,"Altensteig, Stadt",75 und mehr Jahre,1039,405,634
False,8235006,"Altensteig, Stadt",Insgesamt,10846,5337,5509
False,8235007,Althengstett,unter 3 Jahre,213,94,119
False,8235007,Althengstett,3 -  6 Jahre,229,128,101
False,8235007,Althengstett,6 - 10 Jahre,321,167,154
False,8235007,Althengstett,10 - 15 Jahre,503,256,247
False,8235007,Althengstett,15 - 18 Jahre,329,171,158
False,8235007,Althengstett,18 - 20 Jahre,208,92,116
False,8235007,Althengstett,20 - 25 Jahre,468,237,231
False,8235007,Althengstett,25 - 30 Jahre,377,201,176
False,8235007,Althengstett,30 - 35 Jahre,458,220,238
False,8235007,Althengstett,35 - 40 Jahre,511,256,255
False,8235007,Althengstett,40 - 45 Jahre,624,308,316
False,8235007,Althengstett,45 - 50 Jahre,772,378,394
False,8235007,Althengstett,50 - 55 Jahre,637,332,305
False,8235007,Althengstett,55 - 60 Jahre,578,278,300
False,8235007,Althengstett,60 - 65 Jahre,452,240,212
False,8235007,Althengstett,65 - 75 Jahre,721,361,360
False,8235007,Althengstett,75 und mehr Jahre,484,194,290
False,8235007,Althengstett,Insgesamt,7885,3913,3972
False,8235008,"Bad Liebenzell, Stadt",unter 3 Jahre,190,92,98
False,8235008,"Bad Liebenzell, Stadt",3 -  6 Jahre,242,131,111
False,8235008,"Bad Liebenzell, Stadt",6 - 10 Jahre,302,160,142
False,8235008,"Bad Liebenzell, Stadt",10 - 15 Jahre,418,176,242
False,8235008,"Bad Liebenzell, Stadt",15 - 18 Jahre,268,147,121
False,8235008,"Bad Liebenzell, Stadt",18 - 20 Jahre,220,139,81
False,8235008,"Bad Liebenzell, Stadt",20 - 25 Jahre,526,284,242
False,8235008,"Bad Liebenzell, Stadt",25 - 30 Jahre,512,255,257
False,8235008,"Bad Liebenzell, Stadt",30 - 35 Jahre,523,260,263
False,8235008,"Bad Liebenzell, Stadt",35 - 40 Jahre,549,256,293
False,8235008,"Bad Liebenzell, Stadt",40 - 45 Jahre,778,415,363
False,8235008,"Bad Liebenzell, Stadt",45 - 50 Jahre,904,448,456
False,8235008,"Bad Liebenzell, Stadt",50 - 55 Jahre,739,351,388
False,8235008,"Bad Liebenzell, Stadt",55 - 60 Jahre,661,338,323
False,8235008,"Bad Liebenzell, Stadt",60 - 65 Jahre,524,256,268
False,8235008,"Bad Liebenzell, Stadt",65 - 75 Jahre,1027,443,584
False,8235008,"Bad Liebenzell, Stadt",75 und mehr Jahre,930,318,612
False,8235008,"Bad Liebenzell, Stadt",Insgesamt,9313,4469,4844
False,8235018,Dobel,unter 3 Jahre,36,19,17
False,8235018,Dobel,3 -  6 Jahre,46,27,19
False,8235018,Dobel,6 - 10 Jahre,90,50,40
False,8235018,Dobel,10 - 15 Jahre,118,68,50
False,8235018,Dobel,15 - 18 Jahre,73,47,26
False,8235018,Dobel,18 - 20 Jahre,49,27,22
False,8235018,Dobel,20 - 25 Jahre,99,47,52
False,8235018,Dobel,25 - 30 Jahre,112,70,42
False,8235018,Dobel,30 - 35 Jahre,90,46,44
False,8235018,Dobel,35 - 40 Jahre,110,50,60
False,8235018,Dobel,40 - 45 Jahre,176,76,100
False,8235018,Dobel,45 - 50 Jahre,210,105,105
False,8235018,Dobel,50 - 55 Jahre,190,96,94
False,8235018,Dobel,55 - 60 Jahre,164,95,69
False,8235018,Dobel,60 - 65 Jahre,155,68,87
False,8235018,Dobel,65 - 75 Jahre,265,131,134
False,8235018,Dobel,75 und mehr Jahre,268,113,155
False,8235018,Dobel,Insgesamt,2251,1135,1116
False,8235020,Ebhausen,unter 3 Jahre,136,80,56
False,8235020,Ebhausen,3 -  6 Jahre,135,75,60
False,8235020,Ebhausen,6 - 10 Jahre,255,133,122
False,8235020,Ebhausen,10 - 15 Jahre,296,149,147
False,8235020,Ebhausen,15 - 18 Jahre,226,125,101
False,8235020,Ebhausen,18 - 20 Jahre,152,81,71
False,8235020,Ebhausen,20 - 25 Jahre,293,131,162
False,8235020,Ebhausen,25 - 30 Jahre,275,149,126
False,8235020,Ebhausen,30 - 35 Jahre,252,128,124
False,8235020,Ebhausen,35 - 40 Jahre,295,152,143
False,8235020,Ebhausen,40 - 45 Jahre,414,203,211
False,8235020,Ebhausen,45 - 50 Jahre,455,233,222
False,8235020,Ebhausen,50 - 55 Jahre,369,198,171
False,8235020,Ebhausen,55 - 60 Jahre,264,133,131
False,8235020,Ebhausen,60 - 65 Jahre,201,105,96
False,8235020,Ebhausen,65 - 75 Jahre,413,196,217
False,8235020,Ebhausen,75 und mehr Jahre,324,128,196
False,8235020,Ebhausen,Insgesamt,4755,2399,2356
False,8235022,Egenhausen,unter 3 Jahre,55,35,20
False,8235022,Egenhausen,3 -  6 Jahre,65,41,24
False,8235022,Egenhausen,6 - 10 Jahre,90,42,48
False,8235022,Egenhausen,10 - 15 Jahre,161,80,81
False,8235022,Egenhausen,15 - 18 Jahre,79,44,35
False,8235022,Egenhausen,18 - 20 Jahre,66,34,32
False,8235022,Egenhausen,20 - 25 Jahre,131,73,58
False,8235022,Egenhausen,25 - 30 Jahre,85,44,41
False,8235022,Egenhausen,30 - 35 Jahre,109,48,61
False,8235022,Egenhausen,35 - 40 Jahre,119,54,65
False,8235022,Egenhausen,40 - 45 Jahre,143,70,73
False,8235022,Egenhausen,45 - 50 Jahre,170,95,75
False,8235022,Egenhausen,50 - 55 Jahre,125,60,65
False,8235022,Egenhausen,55 - 60 Jahre,86,47,39
False,8235022,Egenhausen,60 - 65 Jahre,92,46,46
False,8235022,Egenhausen,65 - 75 Jahre,202,96,106
False,8235022,Egenhausen,75 und mehr Jahre,135,55,80
False,8235022,Egenhausen,Insgesamt,1913,964,949
False,8235025,Enzklösterle,unter 3 Jahre,26,13,13
False,8235025,Enzklösterle,3 -  6 Jahre,33,19,14
False,8235025,Enzklösterle,6 - 10 Jahre,39,15,24
False,8235025,Enzklösterle,10 - 15 Jahre,60,26,34
False,8235025,Enzklösterle,15 - 18 Jahre,42,22,20
False,8235025,Enzklösterle,18 - 20 Jahre,32,15,17
False,8235025,Enzklösterle,20 - 25 Jahre,65,45,20
False,8235025,Enzklösterle,25 - 30 Jahre,33,18,15
False,8235025,Enzklösterle,30 - 35 Jahre,58,20,38
False,8235025,Enzklösterle,35 - 40 Jahre,64,31,33
False,8235025,Enzklösterle,40 - 45 Jahre,81,34,47
False,8235025,Enzklösterle,45 - 50 Jahre,88,43,45
False,8235025,Enzklösterle,50 - 55 Jahre,96,51,45
False,8235025,Enzklösterle,55 - 60 Jahre,76,33,43
False,8235025,Enzklösterle,60 - 65 Jahre,85,41,44
False,8235025,Enzklösterle,65 - 75 Jahre,164,85,79
False,8235025,Enzklösterle,75 und mehr Jahre,144,54,90
False,8235025,Enzklösterle,Insgesamt,1186,565,621
False,8235029,Gechingen,unter 3 Jahre,80,41,39
False,8235029,Gechingen,3 -  6 Jahre,101,50,51
False,8235029,Gechingen,6 - 10 Jahre,144,72,72
False,8235029,Gechingen,10 - 15 Jahre,253,127,126
False,8235029,Gechingen,15 - 18 Jahre,125,66,59
False,8235029,Gechingen,18 - 20 Jahre,95,49,46
False,8235029,Gechingen,20 - 25 Jahre,197,100,97
False,8235029,Gechingen,25 - 30 Jahre,173,77,96
False,8235029,Gechingen,30 - 35 Jahre,175,92,83
False,8235029,Gechingen,35 - 40 Jahre,265,130,135
False,8235029,Gechingen,40 - 45 Jahre,331,159,172
False,8235029,Gechingen,45 - 50 Jahre,377,182,195
False,8235029,Gechingen,50 - 55 Jahre,330,181,149
False,8235029,Gechingen,55 - 60 Jahre,251,126,125
False,8235029,Gechingen,60 - 65 Jahre,192,85,107
False,8235029,Gechingen,65 - 75 Jahre,403,202,201
False,8235029,Gechingen,75 und mehr Jahre,282,126,156
False,8235029,Gechingen,Insgesamt,3774,1865,1909
False,8235032,"Haiterbach, Stadt",unter 3 Jahre,167,90,77
False,8235032,"Haiterbach, Stadt",3 -  6 Jahre,163,78,85
False,8235032,"Haiterbach, Stadt",6 - 10 Jahre,231,114,117
False,8235032,"Haiterbach, Stadt",10 - 15 Jahre,359,180,179
False,8235032,"Haiterbach, Stadt",15 - 18 Jahre,218,100,118
False,8235032,"Haiterbach, Stadt",18 - 20 Jahre,154,77,77
False,8235032,"Haiterbach, Stadt",20 - 25 Jahre,349,181,168
False,8235032,"Haiterbach, Stadt",25 - 30 Jahre,357,184,173
False,8235032,"Haiterbach, Stadt",30 - 35 Jahre,341,177,164
False,8235032,"Haiterbach, Stadt",35 - 40 Jahre,388,210,178
False,8235032,"Haiterbach, Stadt",40 - 45 Jahre,434,222,212
False,8235032,"Haiterbach, Stadt",45 - 50 Jahre,502,252,250
False,8235032,"Haiterbach, Stadt",50 - 55 Jahre,393,197,196
False,8235032,"Haiterbach, Stadt",55 - 60 Jahre,345,177,168
False,8235032,"Haiterbach, Stadt",60 - 65 Jahre,276,137,139
False,8235032,"Haiterbach, Stadt",65 - 75 Jahre,527,230,297
False,8235032,"Haiterbach, Stadt",75 und mehr Jahre,496,191,305
False,8235032,"Haiterbach, Stadt",Insgesamt,5700,2797,2903
False,8235033,"Bad Herrenalb, Stadt",unter 3 Jahre,144,78,66
False,8235033,"Bad Herrenalb, Stadt",3 -  6 Jahre,132,68,64
False,8235033,"Bad Herrenalb, Stadt",6 - 10 Jahre,169,90,79
False,8235033,"Bad Herrenalb, Stadt",10 - 15 Jahre,295,143,152
False,8235033,"Bad Herrenalb, Stadt",15 - 18 Jahre,199,110,89
False,8235033,"Bad Herrenalb, Stadt",18 - 20 Jahre,134,62,72
False,8235033,"Bad Herrenalb, Stadt",20 - 25 Jahre,365,187,178
False,8235033,"Bad Herrenalb, Stadt",25 - 30 Jahre,321,158,163
False,8235033,"Bad Herrenalb, Stadt",30 - 35 Jahre,353,167,186
False,8235033,"Bad Herrenalb, Stadt",35 - 40 Jahre,333,167,166
False,8235033,"Bad Herrenalb, Stadt",40 - 45 Jahre,550,270,280
False,8235033,"Bad Herrenalb, Stadt",45 - 50 Jahre,611,295,316
False,8235033,"Bad Herrenalb, Stadt",50 - 55 Jahre,613,313,300
False,8235033,"Bad Herrenalb, Stadt",55 - 60 Jahre,546,281,265
False,8235033,"Bad Herrenalb, Stadt",60 - 65 Jahre,500,239,261
False,8235033,"Bad Herrenalb, Stadt",65 - 75 Jahre,1042,481,561
False,8235033,"Bad Herrenalb, Stadt",75 und mehr Jahre,1023,415,608
False,8235033,"Bad Herrenalb, Stadt",Insgesamt,7330,3524,3806
False,8235035,Höfen an der Enz,unter 3 Jahre,36,21,15
False,8235035,Höfen an der Enz,3 -  6 Jahre,34,15,19
False,8235035,Höfen an der Enz,6 - 10 Jahre,39,20,19
False,8235035,Höfen an der Enz,10 - 15 Jahre,92,56,36
False,8235035,Höfen an der Enz,15 - 18 Jahre,44,28,16
False,8235035,Höfen an der Enz,18 - 20 Jahre,40,22,18
False,8235035,Höfen an der Enz,20 - 25 Jahre,96,49,47
False,8235035,Höfen an der Enz,25 - 30 Jahre,100,43,57
False,8235035,Höfen an der Enz,30 - 35 Jahre,92,52,40
False,8235035,Höfen an der Enz,35 - 40 Jahre,118,68,50
False,8235035,Höfen an der Enz,40 - 45 Jahre,128,66,62
False,8235035,Höfen an der Enz,45 - 50 Jahre,135,70,65
False,8235035,Höfen an der Enz,50 - 55 Jahre,139,68,71
False,8235035,Höfen an der Enz,55 - 60 Jahre,118,64,54
False,8235035,Höfen an der Enz,60 - 65 Jahre,91,45,46
False,8235035,Höfen an der Enz,65 - 75 Jahre,174,79,95
False,8235035,Höfen an der Enz,75 und mehr Jahre,175,72,103
False,8235035,Höfen an der Enz,Insgesamt,1651,838,813
False,8235046,"Nagold, Stadt",unter 3 Jahre,557,294,263
False,8235046,"Nagold, Stadt",3 -  6 Jahre,574,295,279
False,8235046,"Nagold, Stadt",6 - 10 Jahre,843,416,427
False,8235046,"Nagold, Stadt",10 - 15 Jahre,1188,626,562
False,8235046,"Nagold, Stadt",15 - 18 Jahre,780,391,389
False,8235046,"Nagold, Stadt",18 - 20 Jahre,529,275,254
False,8235046,"Nagold, Stadt",20 - 25 Jahre,1373,692,681
False,8235046,"Nagold, Stadt",25 - 30 Jahre,1290,662,628
False,8235046,"Nagold, Stadt",30 - 35 Jahre,1307,638,669
False,8235046,"Nagold, Stadt",35 - 40 Jahre,1431,728,703
False,8235046,"Nagold, Stadt",40 - 45 Jahre,1793,904,889
False,8235046,"Nagold, Stadt",45 - 50 Jahre,1907,925,982
False,8235046,"Nagold, Stadt",50 - 55 Jahre,1733,837,896
False,8235046,"Nagold, Stadt",55 - 60 Jahre,1632,770,862
False,8235046,"Nagold, Stadt",60 - 65 Jahre,1238,599,639
False,8235046,"Nagold, Stadt",65 - 75 Jahre,2367,1139,1228
False,8235046,"Nagold, Stadt",75 und mehr Jahre,2000,812,1188
False,8235046,"Nagold, Stadt",Insgesamt,22542,11003,11539
False,8235047,"Neubulach, Stadt",unter 3 Jahre,154,64,90
False,8235047,"Neubulach, Stadt",3 -  6 Jahre,172,94,78
False,8235047,"Neubulach, Stadt",6 - 10 Jahre,268,146,122
False,8235047,"Neubulach, Stadt",10 - 15 Jahre,345,167,178
False,8235047,"Neubulach, Stadt",15 - 18 Jahre,272,140,132
False,8235047,"Neubulach, Stadt",18 - 20 Jahre,184,104,80
False,8235047,"Neubulach, Stadt",20 - 25 Jahre,316,171,145
False,8235047,"Neubulach, Stadt",25 - 30 Jahre,290,158,132
False,8235047,"Neubulach, Stadt",30 - 35 Jahre,286,155,131
False,8235047,"Neubulach, Stadt",35 - 40 Jahre,324,139,185
False,8235047,"Neubulach, Stadt",40 - 45 Jahre,439,236,203
False,8235047,"Neubulach, Stadt",45 - 50 Jahre,510,258,252
False,8235047,"Neubulach, Stadt",50 - 55 Jahre,374,184,190
False,8235047,"Neubulach, Stadt",55 - 60 Jahre,370,196,174
False,8235047,"Neubulach, Stadt",60 - 65 Jahre,275,137,138
False,8235047,"Neubulach, Stadt",65 - 75 Jahre,480,229,251
False,8235047,"Neubulach, Stadt",75 und mehr Jahre,473,176,297
False,8235047,"Neubulach, Stadt",Insgesamt,5532,2754,2778
False,8235050,Neuweiler,unter 3 Jahre,71,37,34
False,8235050,Neuweiler,3 -  6 Jahre,72,39,33
False,8235050,Neuweiler,6 - 10 Jahre,158,90,68
False,8235050,Neuweiler,10 - 15 Jahre,196,95,101
False,8235050,Neuweiler,15 - 18 Jahre,118,63,55
False,8235050,Neuweiler,18 - 20 Jahre,96,50,46
False,8235050,Neuweiler,20 - 25 Jahre,205,124,81
False,8235050,Neuweiler,25 - 30 Jahre,170,84,86
False,8235050,Neuweiler,30 - 35 Jahre,126,76,50
False,8235050,Neuweiler,35 - 40 Jahre,176,83,93
False,8235050,Neuweiler,40 - 45 Jahre,256,130,126
False,8235050,Neuweiler,45 - 50 Jahre,315,176,139
False,8235050,Neuweiler,50 - 55 Jahre,263,131,132
False,8235050,Neuweiler,55 - 60 Jahre,167,92,75
False,8235050,Neuweiler,60 - 65 Jahre,140,67,73
False,8235050,Neuweiler,65 - 75 Jahre,324,173,151
False,8235050,Neuweiler,75 und mehr Jahre,259,106,153
False,8235050,Neuweiler,Insgesamt,3112,1616,1496
False,8235055,Oberreichenbach,unter 3 Jahre,64,38,26
False,8235055,Oberreichenbach,3 -  6 Jahre,71,35,36
False,8235055,Oberreichenbach,6 - 10 Jahre,134,66,68
False,8235055,Oberreichenbach,10 - 15 Jahre,169,100,69
False,8235055,Oberreichenbach,15 - 18 Jahre,99,48,51
False,8235055,Oberreichenbach,18 - 20 Jahre,69,44,25
False,8235055,Oberreichenbach,20 - 25 Jahre,165,82,83
False,8235055,Oberreichenbach,25 - 30 Jahre,153,80,73
False,8235055,Oberreichenbach,30 - 35 Jahre,135,89,46
False,8235055,Oberreichenbach,35 - 40 Jahre,149,68,81
False,8235055,Oberreichenbach,40 - 45 Jahre,264,125,139
False,8235055,Oberreichenbach,45 - 50 Jahre,252,124,128
False,8235055,Oberreichenbach,50 - 55 Jahre,227,110,117
False,8235055,Oberreichenbach,55 - 60 Jahre,189,95,94
False,8235055,Oberreichenbach,60 - 65 Jahre,162,79,83
False,8235055,Oberreichenbach,65 - 75 Jahre,278,130,148
False,8235055,Oberreichenbach,75 und mehr Jahre,230,90,140
False,8235055,Oberreichenbach,Insgesamt,2810,1403,1407
False,8235057,Ostelsheim,unter 3 Jahre,57,31,26
False,8235057,Ostelsheim,3 -  6 Jahre,66,35,31
False,8235057,Ostelsheim,6 - 10 Jahre,130,74,56
False,8235057,Ostelsheim,10 - 15 Jahre,152,70,82
False,8235057,Ostelsheim,15 - 18 Jahre,86,47,39
False,8235057,Ostelsheim,18 - 20 Jahre,54,26,28
False,8235057,Ostelsheim,20 - 25 Jahre,134,69,65
False,8235057,Ostelsheim,25 - 30 Jahre,143,84,59
False,8235057,Ostelsheim,30 - 35 Jahre,122,60,62
False,8235057,Ostelsheim,35 - 40 Jahre,149,75,74
False,8235057,Ostelsheim,40 - 45 Jahre,231,114,117
False,8235057,Ostelsheim,45 - 50 Jahre,223,107,116
False,8235057,Ostelsheim,50 - 55 Jahre,226,125,101
False,8235057,Ostelsheim,55 - 60 Jahre,140,70,70
False,8235057,Ostelsheim,60 - 65 Jahre,103,49,54
False,8235057,Ostelsheim,65 - 75 Jahre,259,120,139
False,8235057,Ostelsheim,75 und mehr Jahre,164,81,83
False,8235057,Ostelsheim,Insgesamt,2439,1237,1202
False,8235060,Rohrdorf,unter 3 Jahre,49,25,24
False,8235060,Rohrdorf,3 -  6 Jahre,66,34,32
False,8235060,Rohrdorf,6 - 10 Jahre,76,39,37
False,8235060,Rohrdorf,10 - 15 Jahre,86,54,32
False,8235060,Rohrdorf,15 - 18 Jahre,77,35,42
False,8235060,Rohrdorf,18 - 20 Jahre,52,29,23
False,8235060,Rohrdorf,20 - 25 Jahre,89,46,43
False,8235060,Rohrdorf,25 - 30 Jahre,101,56,45
False,8235060,Rohrdorf,30 - 35 Jahre,95,43,52
False,8235060,Rohrdorf,35 - 40 Jahre,120,52,68
False,8235060,Rohrdorf,40 - 45 Jahre,165,84,81
False,8235060,Rohrdorf,45 - 50 Jahre,185,112,73
False,8235060,Rohrdorf,50 - 55 Jahre,151,73,78
False,8235060,Rohrdorf,55 - 60 Jahre,128,67,61
False,8235060,Rohrdorf,60 - 65 Jahre,120,55,65
False,8235060,Rohrdorf,65 - 75 Jahre,198,103,95
False,8235060,Rohrdorf,75 und mehr Jahre,151,58,93
False,8235060,Rohrdorf,Insgesamt,1909,965,944
False,8235065,Schömberg,unter 3 Jahre,165,75,90
False,8235065,Schömberg,3 -  6 Jahre,195,85,110
False,8235065,Schömberg,6 - 10 Jahre,299,143,156
False,8235065,Schömberg,10 - 15 Jahre,494,259,235
False,8235065,Schömberg,15 - 18 Jahre,282,149,133
False,8235065,Schömberg,18 - 20 Jahre,199,97,102
False,8235065,Schömberg,20 - 25 Jahre,458,252,206
False,8235065,Schömberg,25 - 30 Jahre,445,246,199
False,8235065,Schömberg,30 - 35 Jahre,394,201,193
False,8235065,Schömberg,35 - 40 Jahre,442,197,245
False,8235065,Schömberg,40 - 45 Jahre,711,355,356
False,8235065,Schömberg,45 - 50 Jahre,963,532,431
False,8235065,Schömberg,50 - 55 Jahre,724,380,344
False,8235065,Schömberg,55 - 60 Jahre,568,270,298
False,8235065,Schömberg,60 - 65 Jahre,486,265,221
False,8235065,Schömberg,65 - 75 Jahre,890,425,465
False,8235065,Schömberg,75 und mehr Jahre,806,289,517
False,8235065,Schömberg,Insgesamt,8521,4220,4301
False,8235066,Simmersfeld,unter 3 Jahre,52,24,28
False,8235066,Simmersfeld,3 -  6 Jahre,70,28,42
False,8235066,Simmersfeld,6 - 10 Jahre,106,51,55
False,8235066,Simmersfeld,10 - 15 Jahre,165,83,82
False,8235066,Simmersfeld,15 - 18 Jahre,75,43,32
False,8235066,Simmersfeld,18 - 20 Jahre,57,34,23
False,8235066,Simmersfeld,20 - 25 Jahre,147,88,59
False,8235066,Simmersfeld,25 - 30 Jahre,97,45,52
False,8235066,Simmersfeld,30 - 35 Jahre,99,51,48
False,8235066,Simmersfeld,35 - 40 Jahre,130,66,64
False,8235066,Simmersfeld,40 - 45 Jahre,201,112,89
False,8235066,Simmersfeld,45 - 50 Jahre,200,98,102
False,8235066,Simmersfeld,50 - 55 Jahre,148,75,73
False,8235066,Simmersfeld,55 - 60 Jahre,132,71,61
False,8235066,Simmersfeld,60 - 65 Jahre,103,56,47
False,8235066,Simmersfeld,65 - 75 Jahre,199,92,107
False,8235066,Simmersfeld,75 und mehr Jahre,167,67,100
False,8235066,Simmersfeld,Insgesamt,2148,1084,1064
False,8235067,Simmozheim,unter 3 Jahre,95,45,50
False,8235067,Simmozheim,3 -  6 Jahre,91,51,40
False,8235067,Simmozheim,6 - 10 Jahre,126,62,64
False,8235067,Simmozheim,10 - 15 Jahre,176,97,79
False,8235067,Simmozheim,15 - 18 Jahre,112,59,53
False,8235067,Simmozheim,18 - 20 Jahre,75,32,43
False,8235067,Simmozheim,20 - 25 Jahre,181,87,94
False,8235067,Simmozheim,25 - 30 Jahre,148,65,83
False,8235067,Simmozheim,30 - 35 Jahre,174,87,87
False,8235067,Simmozheim,35 - 40 Jahre,179,83,96
False,8235067,Simmozheim,40 - 45 Jahre,249,125,124
False,8235067,Simmozheim,45 - 50 Jahre,247,124,123
False,8235067,Simmozheim,50 - 55 Jahre,227,114,113
False,8235067,Simmozheim,55 - 60 Jahre,190,98,92
False,8235067,Simmozheim,60 - 65 Jahre,146,75,71
False,8235067,Simmozheim,65 - 75 Jahre,261,119,142
False,8235067,Simmozheim,75 und mehr Jahre,137,63,74
False,8235067,Simmozheim,Insgesamt,2814,1386,1428
False,8235073,Unterreichenbach,unter 3 Jahre,50,23,27
False,8235073,Unterreichenbach,3 -  6 Jahre,56,31,25
False,8235073,Unterreichenbach,6 - 10 Jahre,92,40,52
False,8235073,Unterreichenbach,10 - 15 Jahre,138,68,70
False,8235073,Unterreichenbach,15 - 18 Jahre,85,48,37
False,8235073,Unterreichenbach,18 - 20 Jahre,50,26,24
False,8235073,Unterreichenbach,20 - 25 Jahre,137,66,71
False,8235073,Unterreichenbach,25 - 30 Jahre,109,58,51
False,8235073,Unterreichenbach,30 - 35 Jahre,116,68,48
False,8235073,Unterreichenbach,35 - 40 Jahre,114,55,59
False,8235073,Unterreichenbach,40 - 45 Jahre,192,91,101
False,8235073,Unterreichenbach,45 - 50 Jahre,212,113,99
False,8235073,Unterreichenbach,50 - 55 Jahre,184,94,90
False,8235073,Unterreichenbach,55 - 60 Jahre,149,67,82
False,8235073,Unterreichenbach,60 - 65 Jahre,142,77,65
False,8235073,Unterreichenbach,65 - 75 Jahre,240,115,125
False,8235073,Unterreichenbach,75 und mehr Jahre,181,70,111
False,8235073,Unterreichenbach,Insgesamt,2247,1110,1137
False,8235079,"Bad Wildbad, Stadt",unter 3 Jahre,217,120,97
False,8235079,"Bad Wildbad, Stadt",3 -  6 Jahre,212,118,94
False,8235079,"Bad Wildbad, Stadt",6 - 10 Jahre,337,165,172
False,8235079,"Bad Wildbad, Stadt",10 - 15 Jahre,504,273,231
False,8235079,"Bad Wildbad, Stadt",15 - 18 Jahre,299,148,151
False,8235079,"Bad Wildbad, Stadt",18 - 20 Jahre,235,110,125
False,8235079,"Bad Wildbad, Stadt",20 - 25 Jahre,627,320,307
False,8235079,"Bad Wildbad, Stadt",25 - 30 Jahre,503,259,244
False,8235079,"Bad Wildbad, Stadt",30 - 35 Jahre,491,252,239
False,8235079,"Bad Wildbad, Stadt",35 - 40 Jahre,570,288,282
False,8235079,"Bad Wildbad, Stadt",40 - 45 Jahre,802,399,403
False,8235079,"Bad Wildbad, Stadt",45 - 50 Jahre,955,519,436
False,8235079,"Bad Wildbad, Stadt",50 - 55 Jahre,799,393,406
False,8235079,"Bad Wildbad, Stadt",55 - 60 Jahre,699,362,337
False,8235079,"Bad Wildbad, Stadt",60 - 65 Jahre,606,289,317
False,8235079,"Bad Wildbad, Stadt",65 - 75 Jahre,1357,613,744
False,8235079,"Bad Wildbad, Stadt",75 und mehr Jahre,1308,504,804
False,8235079,"Bad Wildbad, Stadt",Insgesamt,10521,5132,5389
False,8235080,"Wildberg, Stadt",unter 3 Jahre,260,125,135
False,8235080,"Wildberg, Stadt",3 -  6 Jahre,230,119,111
False,8235080,"Wildberg, Stadt",6 - 10 Jahre,402,185,217
False,8235080,"Wildberg, Stadt",10 - 15 Jahre,563,286,277
False,8235080,"Wildberg, Stadt",15 - 18 Jahre,380,221,159
False,8235080,"Wildberg, Stadt",18 - 20 Jahre,270,141,129
False,8235080,"Wildberg, Stadt",20 - 25 Jahre,630,317,313
False,8235080,"Wildberg, Stadt",25 - 30 Jahre,450,246,204
False,8235080,"Wildberg, Stadt",30 - 35 Jahre,489,215,274
False,8235080,"Wildberg, Stadt",35 - 40 Jahre,603,315,288
False,8235080,"Wildberg, Stadt",40 - 45 Jahre,800,397,403
False,8235080,"Wildberg, Stadt",45 - 50 Jahre,930,462,468
False,8235080,"Wildberg, Stadt",50 - 55 Jahre,789,400,389
False,8235080,"Wildberg, Stadt",55 - 60 Jahre,705,346,359
False,8235080,"Wildberg, Stadt",60 - 65 Jahre,561,277,284
False,8235080,"Wildberg, Stadt",65 - 75 Jahre,1041,526,515
False,8235080,"Wildberg, Stadt",75 und mehr Jahre,786,280,506
False,8235080,"Wildberg, Stadt",Insgesamt,9889,4858,5031
False,8235084,"Bad Teinach-Zavelstein, Stadt",unter 3 Jahre,60,29,31
False,8235084,"Bad Teinach-Zavelstein, Stadt",3 -  6 Jahre,58,28,30
False,8235084,"Bad Teinach-Zavelstein, Stadt",6 - 10 Jahre,124,63,61
False,8235084,"Bad Teinach-Zavelstein, Stadt",10 - 15 Jahre,204,110,94
False,8235084,"Bad Teinach-Zavelstein, Stadt",15 - 18 Jahre,104,53,51
False,8235084,"Bad Teinach-Zavelstein, Stadt",18 - 20 Jahre,75,44,31
False,8235084,"Bad Teinach-Zavelstein, Stadt",20 - 25 Jahre,185,91,94
False,8235084,"Bad Teinach-Zavelstein, Stadt",25 - 30 Jahre,159,81,78
False,8235084,"Bad Teinach-Zavelstein, Stadt",30 - 35 Jahre,118,60,58
False,8235084,"Bad Teinach-Zavelstein, Stadt",35 - 40 Jahre,175,76,99
False,8235084,"Bad Teinach-Zavelstein, Stadt",40 - 45 Jahre,230,127,103
False,8235084,"Bad Teinach-Zavelstein, Stadt",45 - 50 Jahre,299,153,146
False,8235084,"Bad Teinach-Zavelstein, Stadt",50 - 55 Jahre,245,122,123
False,8235084,"Bad Teinach-Zavelstein, Stadt",55 - 60 Jahre,199,97,102
False,8235084,"Bad Teinach-Zavelstein, Stadt",60 - 65 Jahre,143,71,72
False,8235084,"Bad Teinach-Zavelstein, Stadt",65 - 75 Jahre,296,143,153
False,8235084,"Bad Teinach-Zavelstein, Stadt",75 und mehr Jahre,279,114,165
False,8235084,"Bad Teinach-Zavelstein, Stadt",Insgesamt,2953,1462,1491
False,8235085,"Calw, Stadt",unter 3 Jahre,585,295,290
False,8235085,"Calw, Stadt",3 -  6 Jahre,649,361,288
False,8235085,"Calw, Stadt",6 - 10 Jahre,971,522,449
False,8235085,"Calw, Stadt",10 - 15 Jahre,1412,716,696
False,8235085,"Calw, Stadt",15 - 18 Jahre,846,465,381
False,8235085,"Calw, Stadt",18 - 20 Jahre,568,294,274
False,8235085,"Calw, Stadt",20 - 25 Jahre,1351,743,608
False,8235085,"Calw, Stadt",25 - 30 Jahre,1212,646,566
False,8235085,"Calw, Stadt",30 - 35 Jahre,1357,700,657
False,8235085,"Calw, Stadt",35 - 40 Jahre,1447,701,746
False,8235085,"Calw, Stadt",40 - 45 Jahre,1937,960,977
False,8235085,"Calw, Stadt",45 - 50 Jahre,1942,1021,921
False,8235085,"Calw, Stadt",50 - 55 Jahre,1720,865,855
False,8235085,"Calw, Stadt",55 - 60 Jahre,1436,688,748
False,8235085,"Calw, Stadt",60 - 65 Jahre,1316,663,653
False,8235085,"Calw, Stadt",65 - 75 Jahre,2463,1200,1263
False,8235085,"Calw, Stadt",75 und mehr Jahre,2018,789,1229
False,8235085,"Calw, Stadt",Insgesamt,23230,11629,11601
False,8236,Landkreis Enzkreis,unter 3 Jahre,4565,2372,2193
False,8236,Landkreis Enzkreis,3 -  6 Jahre,4914,2521,2393
False,8236,Landkreis Enzkreis,6 - 10 Jahre,7643,3910,3733
False,8236,Landkreis Enzkreis,10 - 15 Jahre,11402,5847,5555
False,8236,Landkreis Enzkreis,15 - 18 Jahre,7084,3611,3473
False,8236,Landkreis Enzkreis,18 - 20 Jahre,4952,2622,2330
False,8236,Landkreis Enzkreis,20 - 25 Jahre,10814,5763,5051
False,8236,Landkreis Enzkreis,25 - 30 Jahre,9827,5013,4814
False,8236,Landkreis Enzkreis,30 - 35 Jahre,9938,4956,4982
False,8236,Landkreis Enzkreis,35 - 40 Jahre,11342,5579,5763
False,8236,Landkreis Enzkreis,40 - 45 Jahre,16363,8141,8222
False,8236,Landkreis Enzkreis,45 - 50 Jahre,17640,8970,8670
False,8236,Landkreis Enzkreis,50 - 55 Jahre,15235,7737,7498
False,8236,Landkreis Enzkreis,55 - 60 Jahre,12729,6327,6402
False,8236,Landkreis Enzkreis,60 - 65 Jahre,10773,5351,5422
False,8236,Landkreis Enzkreis,65 - 75 Jahre,21510,10442,11068
False,8236,Landkreis Enzkreis,75 und mehr Jahre,17182,6629,10553
False,8236,Landkreis Enzkreis,Insgesamt,193913,95791,98122
False,8236004,Birkenfeld,unter 3 Jahre,226,113,113
False,8236004,Birkenfeld,3 -  6 Jahre,235,121,114
False,8236004,Birkenfeld,6 - 10 Jahre,404,206,198
False,8236004,Birkenfeld,10 - 15 Jahre,598,318,280
False,8236004,Birkenfeld,15 - 18 Jahre,341,182,159
False,8236004,Birkenfeld,18 - 20 Jahre,281,148,133
False,8236004,Birkenfeld,20 - 25 Jahre,598,302,296
False,8236004,Birkenfeld,25 - 30 Jahre,538,293,245
False,8236004,Birkenfeld,30 - 35 Jahre,537,248,289
False,8236004,Birkenfeld,35 - 40 Jahre,637,326,311
False,8236004,Birkenfeld,40 - 45 Jahre,885,449,436
False,8236004,Birkenfeld,45 - 50 Jahre,942,470,472
False,8236004,Birkenfeld,50 - 55 Jahre,852,442,410
False,8236004,Birkenfeld,55 - 60 Jahre,704,346,358
False,8236004,Birkenfeld,60 - 65 Jahre,533,236,297
False,8236004,Birkenfeld,65 - 75 Jahre,1249,611,638
False,8236004,Birkenfeld,75 und mehr Jahre,1040,413,627
False,8236004,Birkenfeld,Insgesamt,10600,5224,5376
False,8236011,Eisingen,unter 3 Jahre,101,53,48
False,8236011,Eisingen,3 -  6 Jahre,150,77,73
False,8236011,Eisingen,6 - 10 Jahre,189,96,93
False,8236011,Eisingen,10 - 15 Jahre,284,141,143
False,8236011,Eisingen,15 - 18 Jahre,141,66,75
False,8236011,Eisingen,18 - 20 Jahre,119,68,51
False,8236011,Eisingen,20 - 25 Jahre,232,122,110
False,8236011,Eisingen,25 - 30 Jahre,237,115,122
False,8236011,Eisingen,30 - 35 Jahre,235,121,114
False,8236011,Eisingen,35 - 40 Jahre,270,133,137
False,8236011,Eisingen,40 - 45 Jahre,372,178,194
False,8236011,Eisingen,45 - 50 Jahre,365,178,187
False,8236011,Eisingen,50 - 55 Jahre,310,140,170
False,8236011,Eisingen,55 - 60 Jahre,284,131,153
False,8236011,Eisingen,60 - 65 Jahre,276,140,136
False,8236011,Eisingen,65 - 75 Jahre,560,269,291
False,8236011,Eisingen,75 und mehr Jahre,360,141,219
False,8236011,Eisingen,Insgesamt,4485,2169,2316
False,8236013,Engelsbrand,unter 3 Jahre,79,39,40
False,8236013,Engelsbrand,3 -  6 Jahre,94,57,37
False,8236013,Engelsbrand,6 - 10 Jahre,157,77,80
False,8236013,Engelsbrand,10 - 15 Jahre,248,120,128
False,8236013,Engelsbrand,15 - 18 Jahre,153,75,78
False,8236013,Engelsbrand,18 - 20 Jahre,90,42,48
False,8236013,Engelsbrand,20 - 25 Jahre,211,116,95
False,8236013,Engelsbrand,25 - 30 Jahre,135,64,71
False,8236013,Engelsbrand,30 - 35 Jahre,195,90,105
False,8236013,Engelsbrand,35 - 40 Jahre,199,92,107
False,8236013,Engelsbrand,40 - 45 Jahre,357,184,173
False,8236013,Engelsbrand,45 - 50 Jahre,395,196,199
False,8236013,Engelsbrand,50 - 55 Jahre,334,164,170
False,8236013,Engelsbrand,55 - 60 Jahre,299,130,169
False,8236013,Engelsbrand,60 - 65 Jahre,301,160,141
False,8236013,Engelsbrand,65 - 75 Jahre,573,275,298
False,8236013,Engelsbrand,75 und mehr Jahre,440,181,259
False,8236013,Engelsbrand,Insgesamt,4260,2062,2198
False,8236019,Friolzheim,unter 3 Jahre,92,50,42
False,8236019,Friolzheim,3 -  6 Jahre,107,52,55
False,8236019,Friolzheim,6 - 10 Jahre,150,77,73
False,8236019,Friolzheim,10 - 15 Jahre,239,123,116
False,8236019,Friolzheim,15 - 18 Jahre,122,68,54
False,8236019,Friolzheim,18 - 20 Jahre,110,55,55
False,8236019,Friolzheim,20 - 25 Jahre,196,99,97
False,8236019,Friolzheim,25 - 30 Jahre,187,99,88
False,8236019,Friolzheim,30 - 35 Jahre,208,94,114
False,8236019,Friolzheim,35 - 40 Jahre,219,106,113
False,8236019,Friolzheim,40 - 45 Jahre,309,152,157
False,8236019,Friolzheim,45 - 50 Jahre,303,165,138
False,8236019,Friolzheim,50 - 55 Jahre,248,124,124
False,8236019,Friolzheim,55 - 60 Jahre,277,133,144
False,8236019,Friolzheim,60 - 65 Jahre,224,116,108
False,8236019,Friolzheim,65 - 75 Jahre,377,195,182
False,8236019,Friolzheim,75 und mehr Jahre,261,90,171
False,8236019,Friolzheim,Insgesamt,3629,1798,1831
False,8236025,"Heimsheim, Stadt",unter 3 Jahre,128,63,65
False,8236025,"Heimsheim, Stadt",3 -  6 Jahre,126,71,55
False,8236025,"Heimsheim, Stadt",6 - 10 Jahre,186,93,93
False,8236025,"Heimsheim, Stadt",10 - 15 Jahre,274,140,134
False,8236025,"Heimsheim, Stadt",15 - 18 Jahre,163,88,75
False,8236025,"Heimsheim, Stadt",18 - 20 Jahre,107,57,50
False,8236025,"Heimsheim, Stadt",20 - 25 Jahre,270,141,129
False,8236025,"Heimsheim, Stadt",25 - 30 Jahre,302,187,115
False,8236025,"Heimsheim, Stadt",30 - 35 Jahre,315,186,129
False,8236025,"Heimsheim, Stadt",35 - 40 Jahre,308,179,129
False,8236025,"Heimsheim, Stadt",40 - 45 Jahre,443,243,200
False,8236025,"Heimsheim, Stadt",45 - 50 Jahre,508,311,197
False,8236025,"Heimsheim, Stadt",50 - 55 Jahre,505,338,167
False,8236025,"Heimsheim, Stadt",55 - 60 Jahre,388,242,146
False,8236025,"Heimsheim, Stadt",60 - 65 Jahre,355,202,153
False,8236025,"Heimsheim, Stadt",65 - 75 Jahre,630,379,251
False,8236025,"Heimsheim, Stadt",75 und mehr Jahre,431,178,253
False,8236025,"Heimsheim, Stadt",Insgesamt,5439,3098,2341
False,8236028,Illingen,unter 3 Jahre,170,85,85
False,8236028,Illingen,3 -  6 Jahre,177,94,83
False,8236028,Illingen,6 - 10 Jahre,295,158,137
False,8236028,Illingen,10 - 15 Jahre,429,227,202
False,8236028,Illingen,15 - 18 Jahre,262,144,118
False,8236028,Illingen,18 - 20 Jahre,186,97,89
False,8236028,Illingen,20 - 25 Jahre,370,216,154
False,8236028,Illingen,25 - 30 Jahre,323,164,159
False,8236028,Illingen,30 - 35 Jahre,380,199,181
False,8236028,Illingen,35 - 40 Jahre,423,205,218
False,8236028,Illingen,40 - 45 Jahre,538,258,280
False,8236028,Illingen,45 - 50 Jahre,627,320,307
False,8236028,Illingen,50 - 55 Jahre,529,255,274
False,8236028,Illingen,55 - 60 Jahre,474,231,243
False,8236028,Illingen,60 - 65 Jahre,468,236,232
False,8236028,Illingen,65 - 75 Jahre,822,402,420
False,8236028,Illingen,75 und mehr Jahre,658,237,421
False,8236028,Illingen,Insgesamt,7131,3528,3603
False,8236030,Ispringen,unter 3 Jahre,152,72,80
False,8236030,Ispringen,3 -  6 Jahre,137,75,62
False,8236030,Ispringen,6 - 10 Jahre,186,84,102
False,8236030,Ispringen,10 - 15 Jahre,304,157,147
False,8236030,Ispringen,15 - 18 Jahre,186,77,109
False,8236030,Ispringen,18 - 20 Jahre,134,76,58
False,8236030,Ispringen,20 - 25 Jahre,345,165,180
False,8236030,Ispringen,25 - 30 Jahre,366,198,168
False,8236030,Ispringen,30 - 35 Jahre,333,167,166
False,8236030,Ispringen,35 - 40 Jahre,316,161,155
False,8236030,Ispringen,40 - 45 Jahre,459,214,245
False,8236030,Ispringen,45 - 50 Jahre,495,253,242
False,8236030,Ispringen,50 - 55 Jahre,468,238,230
False,8236030,Ispringen,55 - 60 Jahre,376,179,197
False,8236030,Ispringen,60 - 65 Jahre,324,168,156
False,8236030,Ispringen,65 - 75 Jahre,695,306,389
False,8236030,Ispringen,75 und mehr Jahre,703,273,430
False,8236030,Ispringen,Insgesamt,5979,2863,3116
False,8236031,Kieselbronn,unter 3 Jahre,77,43,34
False,8236031,Kieselbronn,3 -  6 Jahre,86,41,45
False,8236031,Kieselbronn,6 - 10 Jahre,122,60,62
False,8236031,Kieselbronn,10 - 15 Jahre,191,91,100
False,8236031,Kieselbronn,15 - 18 Jahre,94,40,54
False,8236031,Kieselbronn,18 - 20 Jahre,61,30,31
False,8236031,Kieselbronn,20 - 25 Jahre,129,65,64
False,8236031,Kieselbronn,25 - 30 Jahre,138,73,65
False,8236031,Kieselbronn,30 - 35 Jahre,157,72,85
False,8236031,Kieselbronn,35 - 40 Jahre,176,92,84
False,8236031,Kieselbronn,40 - 45 Jahre,259,118,141
False,8236031,Kieselbronn,45 - 50 Jahre,299,155,144
False,8236031,Kieselbronn,50 - 55 Jahre,239,121,118
False,8236031,Kieselbronn,55 - 60 Jahre,189,85,104
False,8236031,Kieselbronn,60 - 65 Jahre,167,99,68
False,8236031,Kieselbronn,65 - 75 Jahre,319,140,179
False,8236031,Kieselbronn,75 und mehr Jahre,287,127,160
False,8236031,Kieselbronn,Insgesamt,2990,1452,1538
False,8236033,"Knittlingen, Stadt",unter 3 Jahre,207,96,111
False,8236033,"Knittlingen, Stadt",3 -  6 Jahre,211,97,114
False,8236033,"Knittlingen, Stadt",6 - 10 Jahre,336,165,171
False,8236033,"Knittlingen, Stadt",10 - 15 Jahre,456,237,219
False,8236033,"Knittlingen, Stadt",15 - 18 Jahre,314,168,146
False,8236033,"Knittlingen, Stadt",18 - 20 Jahre,216,116,100
False,8236033,"Knittlingen, Stadt",20 - 25 Jahre,438,226,212
False,8236033,"Knittlingen, Stadt",25 - 30 Jahre,408,198,210
False,8236033,"Knittlingen, Stadt",30 - 35 Jahre,386,176,210
False,8236033,"Knittlingen, Stadt",35 - 40 Jahre,508,253,255
False,8236033,"Knittlingen, Stadt",40 - 45 Jahre,627,308,319
False,8236033,"Knittlingen, Stadt",45 - 50 Jahre,707,340,367
False,8236033,"Knittlingen, Stadt",50 - 55 Jahre,586,293,293
False,8236033,"Knittlingen, Stadt",55 - 60 Jahre,492,221,271
False,8236033,"Knittlingen, Stadt",60 - 65 Jahre,406,190,216
False,8236033,"Knittlingen, Stadt",65 - 75 Jahre,782,384,398
False,8236033,"Knittlingen, Stadt",75 und mehr Jahre,537,209,328
False,8236033,"Knittlingen, Stadt",Insgesamt,7617,3677,3940
False,8236038,"Maulbronn, Stadt",unter 3 Jahre,141,70,71
False,8236038,"Maulbronn, Stadt",3 -  6 Jahre,176,86,90
False,8236038,"Maulbronn, Stadt",6 - 10 Jahre,281,146,135
False,8236038,"Maulbronn, Stadt",10 - 15 Jahre,418,222,196
False,8236038,"Maulbronn, Stadt",15 - 18 Jahre,266,119,147
False,8236038,"Maulbronn, Stadt",18 - 20 Jahre,169,69,100
False,8236038,"Maulbronn, Stadt",20 - 25 Jahre,355,201,154
False,8236038,"Maulbronn, Stadt",25 - 30 Jahre,307,165,142
False,8236038,"Maulbronn, Stadt",30 - 35 Jahre,293,154,139
False,8236038,"Maulbronn, Stadt",35 - 40 Jahre,385,168,217
False,8236038,"Maulbronn, Stadt",40 - 45 Jahre,556,281,275
False,8236038,"Maulbronn, Stadt",45 - 50 Jahre,612,309,303
False,8236038,"Maulbronn, Stadt",50 - 55 Jahre,500,233,267
False,8236038,"Maulbronn, Stadt",55 - 60 Jahre,386,198,188
False,8236038,"Maulbronn, Stadt",60 - 65 Jahre,299,152,147
False,8236038,"Maulbronn, Stadt",65 - 75 Jahre,750,358,392
False,8236038,"Maulbronn, Stadt",75 und mehr Jahre,620,257,363
False,8236038,"Maulbronn, Stadt",Insgesamt,6514,3188,3326
False,8236039,Mönsheim,unter 3 Jahre,65,33,32
False,8236039,Mönsheim,3 -  6 Jahre,65,43,22
False,8236039,Mönsheim,6 - 10 Jahre,125,65,60
False,8236039,Mönsheim,10 - 15 Jahre,168,77,91
False,8236039,Mönsheim,15 - 18 Jahre,102,53,49
False,8236039,Mönsheim,18 - 20 Jahre,70,37,33
False,8236039,Mönsheim,20 - 25 Jahre,142,71,71
False,8236039,Mönsheim,25 - 30 Jahre,116,62,54
False,8236039,Mönsheim,30 - 35 Jahre,128,68,60
False,8236039,Mönsheim,35 - 40 Jahre,160,71,89
False,8236039,Mönsheim,40 - 45 Jahre,236,122,114
False,8236039,Mönsheim,45 - 50 Jahre,265,130,135
False,8236039,Mönsheim,50 - 55 Jahre,210,100,110
False,8236039,Mönsheim,55 - 60 Jahre,178,92,86
False,8236039,Mönsheim,60 - 65 Jahre,149,76,73
False,8236039,Mönsheim,65 - 75 Jahre,285,137,148
False,8236039,Mönsheim,75 und mehr Jahre,216,94,122
False,8236039,Mönsheim,Insgesamt,2680,1331,1349
False,8236040,"Mühlacker, Stadt",unter 3 Jahre,620,328,292
False,8236040,"Mühlacker, Stadt",3 -  6 Jahre,695,355,340
False,8236040,"Mühlacker, Stadt",6 - 10 Jahre,1071,531,540
False,8236040,"Mühlacker, Stadt",10 - 15 Jahre,1389,732,657
False,8236040,"Mühlacker, Stadt",15 - 18 Jahre,860,454,406
False,8236040,"Mühlacker, Stadt",18 - 20 Jahre,662,347,315
False,8236040,"Mühlacker, Stadt",20 - 25 Jahre,1503,817,686
False,8236040,"Mühlacker, Stadt",25 - 30 Jahre,1330,670,660
False,8236040,"Mühlacker, Stadt",30 - 35 Jahre,1336,702,634
False,8236040,"Mühlacker, Stadt",35 - 40 Jahre,1521,796,725
False,8236040,"Mühlacker, Stadt",40 - 45 Jahre,2073,1036,1037
False,8236040,"Mühlacker, Stadt",45 - 50 Jahre,2207,1151,1056
False,8236040,"Mühlacker, Stadt",50 - 55 Jahre,1918,968,950
False,8236040,"Mühlacker, Stadt",55 - 60 Jahre,1572,779,793
False,8236040,"Mühlacker, Stadt",60 - 65 Jahre,1360,645,715
False,8236040,"Mühlacker, Stadt",65 - 75 Jahre,2908,1424,1484
False,8236040,"Mühlacker, Stadt",75 und mehr Jahre,2344,877,1467
False,8236040,"Mühlacker, Stadt",Insgesamt,25369,12612,12757
False,8236043,"Neuenbürg, Stadt",unter 3 Jahre,168,88,80
False,8236043,"Neuenbürg, Stadt",3 -  6 Jahre,179,96,83
False,8236043,"Neuenbürg, Stadt",6 - 10 Jahre,248,135,113
False,8236043,"Neuenbürg, Stadt",10 - 15 Jahre,415,222,193
False,8236043,"Neuenbürg, Stadt",15 - 18 Jahre,251,117,134
False,8236043,"Neuenbürg, Stadt",18 - 20 Jahre,187,112,75
False,8236043,"Neuenbürg, Stadt",20 - 25 Jahre,441,257,184
False,8236043,"Neuenbürg, Stadt",25 - 30 Jahre,376,202,174
False,8236043,"Neuenbürg, Stadt",30 - 35 Jahre,339,153,186
False,8236043,"Neuenbürg, Stadt",35 - 40 Jahre,416,214,202
False,8236043,"Neuenbürg, Stadt",40 - 45 Jahre,631,329,302
False,8236043,"Neuenbürg, Stadt",45 - 50 Jahre,683,306,377
False,8236043,"Neuenbürg, Stadt",50 - 55 Jahre,622,309,313
False,8236043,"Neuenbürg, Stadt",55 - 60 Jahre,515,271,244
False,8236043,"Neuenbürg, Stadt",60 - 65 Jahre,406,189,217
False,8236043,"Neuenbürg, Stadt",65 - 75 Jahre,926,426,500
False,8236043,"Neuenbürg, Stadt",75 und mehr Jahre,715,273,442
False,8236043,"Neuenbürg, Stadt",Insgesamt,7518,3699,3819
False,8236044,Neuhausen,unter 3 Jahre,101,51,50
False,8236044,Neuhausen,3 -  6 Jahre,125,65,60
False,8236044,Neuhausen,6 - 10 Jahre,198,85,113
False,8236044,Neuhausen,10 - 15 Jahre,342,154,188
False,8236044,Neuhausen,15 - 18 Jahre,214,95,119
False,8236044,Neuhausen,18 - 20 Jahre,148,72,76
False,8236044,Neuhausen,20 - 25 Jahre,291,180,111
False,8236044,Neuhausen,25 - 30 Jahre,246,123,123
False,8236044,Neuhausen,30 - 35 Jahre,242,123,119
False,8236044,Neuhausen,35 - 40 Jahre,313,147,166
False,8236044,Neuhausen,40 - 45 Jahre,484,246,238
False,8236044,Neuhausen,45 - 50 Jahre,519,253,266
False,8236044,Neuhausen,50 - 55 Jahre,438,233,205
False,8236044,Neuhausen,55 - 60 Jahre,367,176,191
False,8236044,Neuhausen,60 - 65 Jahre,312,161,151
False,8236044,Neuhausen,65 - 75 Jahre,524,256,268
False,8236044,Neuhausen,75 und mehr Jahre,443,187,256
False,8236044,Neuhausen,Insgesamt,5307,2607,2700
False,8236046,Niefern-Öschelbronn,unter 3 Jahre,296,161,135
False,8236046,Niefern-Öschelbronn,3 -  6 Jahre,295,159,136
False,8236046,Niefern-Öschelbronn,6 - 10 Jahre,441,236,205
False,8236046,Niefern-Öschelbronn,10 - 15 Jahre,702,354,348
False,8236046,Niefern-Öschelbronn,15 - 18 Jahre,411,198,213
False,8236046,Niefern-Öschelbronn,18 - 20 Jahre,317,151,166
False,8236046,Niefern-Öschelbronn,20 - 25 Jahre,653,329,324
False,8236046,Niefern-Öschelbronn,25 - 30 Jahre,678,322,356
False,8236046,Niefern-Öschelbronn,30 - 35 Jahre,653,324,329
False,8236046,Niefern-Öschelbronn,35 - 40 Jahre,678,303,375
False,8236046,Niefern-Öschelbronn,40 - 45 Jahre,928,452,476
False,8236046,Niefern-Öschelbronn,45 - 50 Jahre,1015,508,507
False,8236046,Niefern-Öschelbronn,50 - 55 Jahre,901,456,445
False,8236046,Niefern-Öschelbronn,55 - 60 Jahre,769,362,407
False,8236046,Niefern-Öschelbronn,60 - 65 Jahre,613,306,307
False,8236046,Niefern-Öschelbronn,65 - 75 Jahre,1274,584,690
False,8236046,Niefern-Öschelbronn,75 und mehr Jahre,1233,436,797
False,8236046,Niefern-Öschelbronn,Insgesamt,11857,5641,6216
False,8236050,Ötisheim,unter 3 Jahre,101,48,53
False,8236050,Ötisheim,3 -  6 Jahre,111,52,59
False,8236050,Ötisheim,6 - 10 Jahre,182,104,78
False,8236050,Ötisheim,10 - 15 Jahre,274,139,135
False,8236050,Ötisheim,15 - 18 Jahre,190,108,82
False,8236050,Ötisheim,18 - 20 Jahre,111,53,58
False,8236050,Ötisheim,20 - 25 Jahre,276,137,139
False,8236050,Ötisheim,25 - 30 Jahre,256,138,118
False,8236050,Ötisheim,30 - 35 Jahre,241,127,114
False,8236050,Ötisheim,35 - 40 Jahre,259,118,141
False,8236050,Ötisheim,40 - 45 Jahre,451,222,229
False,8236050,Ötisheim,45 - 50 Jahre,417,220,197
False,8236050,Ötisheim,50 - 55 Jahre,373,180,193
False,8236050,Ötisheim,55 - 60 Jahre,359,188,171
False,8236050,Ötisheim,60 - 65 Jahre,239,127,112
False,8236050,Ötisheim,65 - 75 Jahre,588,286,302
False,8236050,Ötisheim,75 und mehr Jahre,391,149,242
False,8236050,Ötisheim,Insgesamt,4819,2396,2423
False,8236061,Sternenfels,unter 3 Jahre,66,38,28
False,8236061,Sternenfels,3 -  6 Jahre,81,47,34
False,8236061,Sternenfels,6 - 10 Jahre,105,49,56
False,8236061,Sternenfels,10 - 15 Jahre,157,76,81
False,8236061,Sternenfels,15 - 18 Jahre,106,60,46
False,8236061,Sternenfels,18 - 20 Jahre,76,41,35
False,8236061,Sternenfels,20 - 25 Jahre,187,104,83
False,8236061,Sternenfels,25 - 30 Jahre,113,63,50
False,8236061,Sternenfels,30 - 35 Jahre,132,62,70
False,8236061,Sternenfels,35 - 40 Jahre,168,86,82
False,8236061,Sternenfels,40 - 45 Jahre,221,104,117
False,8236061,Sternenfels,45 - 50 Jahre,283,148,135
False,8236061,Sternenfels,50 - 55 Jahre,239,127,112
False,8236061,Sternenfels,55 - 60 Jahre,210,101,109
False,8236061,Sternenfels,60 - 65 Jahre,149,75,74
False,8236061,Sternenfels,65 - 75 Jahre,267,128,139
False,8236061,Sternenfels,75 und mehr Jahre,215,75,140
False,8236061,Sternenfels,Insgesamt,2775,1384,1391
False,8236062,Tiefenbronn,unter 3 Jahre,114,68,46
False,8236062,Tiefenbronn,3 -  6 Jahre,106,54,52
False,8236062,Tiefenbronn,6 - 10 Jahre,195,96,99
False,8236062,Tiefenbronn,10 - 15 Jahre,315,142,173
False,8236062,Tiefenbronn,15 - 18 Jahre,236,116,120
False,8236062,Tiefenbronn,18 - 20 Jahre,151,93,58
False,8236062,Tiefenbronn,20 - 25 Jahre,314,179,135
False,8236062,Tiefenbronn,25 - 30 Jahre,241,120,121
False,8236062,Tiefenbronn,30 - 35 Jahre,234,107,127
False,8236062,Tiefenbronn,35 - 40 Jahre,273,134,139
False,8236062,Tiefenbronn,40 - 45 Jahre,466,237,229
False,8236062,Tiefenbronn,45 - 50 Jahre,495,236,259
False,8236062,Tiefenbronn,50 - 55 Jahre,472,244,228
False,8236062,Tiefenbronn,55 - 60 Jahre,386,207,179
False,8236062,Tiefenbronn,60 - 65 Jahre,337,168,169
False,8236062,Tiefenbronn,65 - 75 Jahre,582,295,287
False,8236062,Tiefenbronn,75 und mehr Jahre,376,161,215
False,8236062,Tiefenbronn,Insgesamt,5293,2657,2636
False,8236065,Wiernsheim,unter 3 Jahre,148,85,63
False,8236065,Wiernsheim,3 -  6 Jahre,167,86,81
False,8236065,Wiernsheim,6 - 10 Jahre,258,144,114
False,8236065,Wiernsheim,10 - 15 Jahre,400,215,185
False,8236065,Wiernsheim,15 - 18 Jahre,269,136,133
False,8236065,Wiernsheim,18 - 20 Jahre,159,94,65
False,8236065,Wiernsheim,20 - 25 Jahre,360,188,172
False,8236065,Wiernsheim,25 - 30 Jahre,293,145,148
False,8236065,Wiernsheim,30 - 35 Jahre,362,175,187
False,8236065,Wiernsheim,35 - 40 Jahre,377,206,171
False,8236065,Wiernsheim,40 - 45 Jahre,564,276,288
False,8236065,Wiernsheim,45 - 50 Jahre,636,317,319
False,8236065,Wiernsheim,50 - 55 Jahre,546,275,271
False,8236065,Wiernsheim,55 - 60 Jahre,447,233,214
False,8236065,Wiernsheim,60 - 65 Jahre,366,190,176
False,8236065,Wiernsheim,65 - 75 Jahre,646,320,326
False,8236065,Wiernsheim,75 und mehr Jahre,444,178,266
False,8236065,Wiernsheim,Insgesamt,6442,3263,3179
False,8236067,Wimsheim,unter 3 Jahre,73,41,32
False,8236067,Wimsheim,3 -  6 Jahre,69,32,37
False,8236067,Wimsheim,6 - 10 Jahre,111,47,64
False,8236067,Wimsheim,10 - 15 Jahre,151,77,74
False,8236067,Wimsheim,15 - 18 Jahre,113,55,58
False,8236067,Wimsheim,18 - 20 Jahre,79,46,33
False,8236067,Wimsheim,20 - 25 Jahre,146,80,66
False,8236067,Wimsheim,25 - 30 Jahre,137,70,67
False,8236067,Wimsheim,30 - 35 Jahre,149,72,77
False,8236067,Wimsheim,35 - 40 Jahre,161,85,76
False,8236067,Wimsheim,40 - 45 Jahre,234,108,126
False,8236067,Wimsheim,45 - 50 Jahre,284,160,124
False,8236067,Wimsheim,50 - 55 Jahre,226,108,118
False,8236067,Wimsheim,55 - 60 Jahre,191,93,98
False,8236067,Wimsheim,60 - 65 Jahre,141,74,67
False,8236067,Wimsheim,65 - 75 Jahre,240,124,116
False,8236067,Wimsheim,75 und mehr Jahre,182,72,110
False,8236067,Wimsheim,Insgesamt,2687,1344,1343
False,8236068,Wurmberg,unter 3 Jahre,101,48,53
False,8236068,Wurmberg,3 -  6 Jahre,107,56,51
False,8236068,Wurmberg,6 - 10 Jahre,152,74,78
False,8236068,Wurmberg,10 - 15 Jahre,206,107,99
False,8236068,Wurmberg,15 - 18 Jahre,141,71,70
False,8236068,Wurmberg,18 - 20 Jahre,97,56,41
False,8236068,Wurmberg,20 - 25 Jahre,202,86,116
False,8236068,Wurmberg,25 - 30 Jahre,184,95,89
False,8236068,Wurmberg,30 - 35 Jahre,137,60,77
False,8236068,Wurmberg,35 - 40 Jahre,164,72,92
False,8236068,Wurmberg,40 - 45 Jahre,226,116,110
False,8236068,Wurmberg,45 - 50 Jahre,271,141,130
False,8236068,Wurmberg,50 - 55 Jahre,221,113,108
False,8236068,Wurmberg,55 - 60 Jahre,152,90,62
False,8236068,Wurmberg,60 - 65 Jahre,123,62,61
False,8236068,Wurmberg,65 - 75 Jahre,274,124,150
False,8236068,Wurmberg,75 und mehr Jahre,256,92,164
False,8236068,Wurmberg,Insgesamt,3014,1463,1551
False,8236070,Keltern,unter 3 Jahre,208,108,100
False,8236070,Keltern,3 -  6 Jahre,199,94,105
False,8236070,Keltern,6 - 10 Jahre,328,164,164
False,8236070,Keltern,10 - 15 Jahre,547,259,288
False,8236070,Keltern,15 - 18 Jahre,333,167,166
False,8236070,Keltern,18 - 20 Jahre,211,109,102
False,8236070,Keltern,20 - 25 Jahre,468,256,212
False,8236070,Keltern,25 - 30 Jahre,403,199,204
False,8236070,Keltern,30 - 35 Jahre,472,222,250
False,8236070,Keltern,35 - 40 Jahre,513,250,263
False,8236070,Keltern,40 - 45 Jahre,771,372,399
False,8236070,Keltern,45 - 50 Jahre,836,423,413
False,8236070,Keltern,50 - 55 Jahre,695,348,347
False,8236070,Keltern,55 - 60 Jahre,571,271,300
False,8236070,Keltern,60 - 65 Jahre,525,253,272
False,8236070,Keltern,65 - 75 Jahre,1053,506,547
False,8236070,Keltern,75 und mehr Jahre,873,353,520
False,8236070,Keltern,Insgesamt,9006,4354,4652
False,8236071,Remchingen,unter 3 Jahre,300,156,144
False,8236071,Remchingen,3 -  6 Jahre,297,151,146
False,8236071,Remchingen,6 - 10 Jahre,500,257,243
False,8236071,Remchingen,10 - 15 Jahre,691,372,319
False,8236071,Remchingen,15 - 18 Jahre,439,236,203
False,8236071,Remchingen,18 - 20 Jahre,271,137,134
False,8236071,Remchingen,20 - 25 Jahre,682,374,308
False,8236071,Remchingen,25 - 30 Jahre,614,309,305
False,8236071,Remchingen,30 - 35 Jahre,678,345,333
False,8236071,Remchingen,35 - 40 Jahre,676,346,330
False,8236071,Remchingen,40 - 45 Jahre,1025,490,535
False,8236071,Remchingen,45 - 50 Jahre,999,520,479
False,8236071,Remchingen,50 - 55 Jahre,850,401,449
False,8236071,Remchingen,55 - 60 Jahre,814,399,415
False,8236071,Remchingen,60 - 65 Jahre,666,324,342
False,8236071,Remchingen,65 - 75 Jahre,1249,604,645
False,8236071,Remchingen,75 und mehr Jahre,962,384,578
False,8236071,Remchingen,Insgesamt,11713,5805,5908
False,8236072,Straubenhardt,unter 3 Jahre,241,124,117
False,8236072,Straubenhardt,3 -  6 Jahre,282,142,140
False,8236072,Straubenhardt,6 - 10 Jahre,411,229,182
False,8236072,Straubenhardt,10 - 15 Jahre,645,325,320
False,8236072,Straubenhardt,15 - 18 Jahre,398,210,188
False,8236072,Straubenhardt,18 - 20 Jahre,293,173,120
False,8236072,Straubenhardt,20 - 25 Jahre,606,330,276
False,8236072,Straubenhardt,25 - 30 Jahre,498,247,251
False,8236072,Straubenhardt,30 - 35 Jahre,486,242,244
False,8236072,Straubenhardt,35 - 40 Jahre,618,301,317
False,8236072,Straubenhardt,40 - 45 Jahre,955,483,472
False,8236072,Straubenhardt,45 - 50 Jahre,1080,553,527
False,8236072,Straubenhardt,50 - 55 Jahre,891,474,417
False,8236072,Straubenhardt,55 - 60 Jahre,663,337,326
False,8236072,Straubenhardt,60 - 65 Jahre,626,309,317
False,8236072,Straubenhardt,65 - 75 Jahre,1147,564,583
False,8236072,Straubenhardt,75 und mehr Jahre,925,339,586
False,8236072,Straubenhardt,Insgesamt,10765,5382,5383
False,8236073,Neulingen,unter 3 Jahre,127,67,60
False,8236073,Neulingen,3 -  6 Jahre,164,84,80
False,8236073,Neulingen,6 - 10 Jahre,288,148,140
False,8236073,Neulingen,10 - 15 Jahre,434,228,206
False,8236073,Neulingen,15 - 18 Jahre,253,134,119
False,8236073,Neulingen,18 - 20 Jahre,163,92,71
False,8236073,Neulingen,20 - 25 Jahre,401,212,189
False,8236073,Neulingen,25 - 30 Jahre,350,182,168
False,8236073,Neulingen,30 - 35 Jahre,318,153,165
False,8236073,Neulingen,35 - 40 Jahre,389,179,210
False,8236073,Neulingen,40 - 45 Jahre,591,286,305
False,8236073,Neulingen,45 - 50 Jahre,618,317,301
False,8236073,Neulingen,50 - 55 Jahre,563,295,268
False,8236073,Neulingen,55 - 60 Jahre,439,221,218
False,8236073,Neulingen,60 - 65 Jahre,321,163,158
False,8236073,Neulingen,65 - 75 Jahre,586,280,306
False,8236073,Neulingen,75 und mehr Jahre,610,200,410
False,8236073,Neulingen,Insgesamt,6615,3241,3374
False,8236074,Kämpfelbach,unter 3 Jahre,155,85,70
False,8236074,Kämpfelbach,3 -  6 Jahre,148,67,81
False,8236074,Kämpfelbach,6 - 10 Jahre,218,124,94
False,8236074,Kämpfelbach,10 - 15 Jahre,349,189,160
False,8236074,Kämpfelbach,15 - 18 Jahre,226,115,111
False,8236074,Kämpfelbach,18 - 20 Jahre,158,78,80
False,8236074,Kämpfelbach,20 - 25 Jahre,320,162,158
False,8236074,Kämpfelbach,25 - 30 Jahre,360,174,186
False,8236074,Kämpfelbach,30 - 35 Jahre,322,171,151
False,8236074,Kämpfelbach,35 - 40 Jahre,388,168,220
False,8236074,Kämpfelbach,40 - 45 Jahre,488,272,216
False,8236074,Kämpfelbach,45 - 50 Jahre,573,288,285
False,8236074,Kämpfelbach,50 - 55 Jahre,519,269,250
False,8236074,Kämpfelbach,55 - 60 Jahre,393,189,204
False,8236074,Kämpfelbach,60 - 65 Jahre,340,174,166
False,8236074,Kämpfelbach,65 - 75 Jahre,668,321,347
False,8236074,Kämpfelbach,75 und mehr Jahre,583,227,356
False,8236074,Kämpfelbach,Insgesamt,6208,3073,3135
False,8236075,Ölbronn-Dürrn,unter 3 Jahre,89,42,47
False,8236075,Ölbronn-Dürrn,3 -  6 Jahre,85,40,45
False,8236075,Ölbronn-Dürrn,6 - 10 Jahre,136,67,69
False,8236075,Ölbronn-Dürrn,10 - 15 Jahre,207,100,107
False,8236075,Ölbronn-Dürrn,15 - 18 Jahre,138,73,65
False,8236075,Ölbronn-Dürrn,18 - 20 Jahre,81,42,39
False,8236075,Ölbronn-Dürrn,20 - 25 Jahre,198,119,79
False,8236075,Ölbronn-Dürrn,25 - 30 Jahre,183,84,99
False,8236075,Ölbronn-Dürrn,30 - 35 Jahre,169,84,85
False,8236075,Ölbronn-Dürrn,35 - 40 Jahre,187,92,95
False,8236075,Ölbronn-Dürrn,40 - 45 Jahre,310,144,166
False,8236075,Ölbronn-Dürrn,45 - 50 Jahre,338,173,165
False,8236075,Ölbronn-Dürrn,50 - 55 Jahre,272,135,137
False,8236075,Ölbronn-Dürrn,55 - 60 Jahre,222,118,104
False,8236075,Ölbronn-Dürrn,60 - 65 Jahre,166,91,75
False,8236075,Ölbronn-Dürrn,65 - 75 Jahre,363,168,195
False,8236075,Ölbronn-Dürrn,75 und mehr Jahre,285,121,164
False,8236075,Ölbronn-Dürrn,Insgesamt,3429,1693,1736
False,8236076,Königsbach-Stein,unter 3 Jahre,219,117,102
False,8236076,Königsbach-Stein,3 -  6 Jahre,240,127,113
False,8236076,Königsbach-Stein,6 - 10 Jahre,370,193,177
False,8236076,Königsbach-Stein,10 - 15 Jahre,569,303,266
False,8236076,Königsbach-Stein,15 - 18 Jahre,362,186,176
False,8236076,Königsbach-Stein,18 - 20 Jahre,245,131,114
False,8236076,Königsbach-Stein,20 - 25 Jahre,480,229,251
False,8236076,Königsbach-Stein,25 - 30 Jahre,508,252,256
False,8236076,Königsbach-Stein,30 - 35 Jahre,501,259,242
False,8236076,Königsbach-Stein,35 - 40 Jahre,640,296,344
False,8236076,Königsbach-Stein,40 - 45 Jahre,904,461,443
False,8236076,Königsbach-Stein,45 - 50 Jahre,868,429,439
False,8236076,Königsbach-Stein,50 - 55 Jahre,708,354,354
False,8236076,Königsbach-Stein,55 - 60 Jahre,612,304,308
False,8236076,Königsbach-Stein,60 - 65 Jahre,581,265,316
False,8236076,Königsbach-Stein,65 - 75 Jahre,1173,576,597
False,8236076,Königsbach-Stein,75 und mehr Jahre,792,305,487
False,8236076,Königsbach-Stein,Insgesamt,9772,4787,4985
False,8237,Landkreis Freudenstadt,unter 3 Jahre,2983,1529,1454
False,8237,Landkreis Freudenstadt,3 -  6 Jahre,3132,1623,1509
False,8237,Landkreis Freudenstadt,6 - 10 Jahre,4741,2486,2255
False,8237,Landkreis Freudenstadt,10 - 15 Jahre,6776,3511,3265
False,8237,Landkreis Freudenstadt,15 - 18 Jahre,4460,2326,2134
False,8237,Landkreis Freudenstadt,18 - 20 Jahre,3079,1577,1502
False,8237,Landkreis Freudenstadt,20 - 25 Jahre,7160,3680,3480
False,8237,Landkreis Freudenstadt,25 - 30 Jahre,6649,3298,3351
False,8237,Landkreis Freudenstadt,30 - 35 Jahre,6480,3272,3208
False,8237,Landkreis Freudenstadt,35 - 40 Jahre,7494,3645,3849
False,8237,Landkreis Freudenstadt,40 - 45 Jahre,10084,5086,4998
False,8237,Landkreis Freudenstadt,45 - 50 Jahre,10455,5235,5220
False,8237,Landkreis Freudenstadt,50 - 55 Jahre,9236,4718,4518
False,8237,Landkreis Freudenstadt,55 - 60 Jahre,7858,4008,3850
False,8237,Landkreis Freudenstadt,60 - 65 Jahre,6266,3201,3065
False,8237,Landkreis Freudenstadt,65 - 75 Jahre,12254,5787,6467
False,8237,Landkreis Freudenstadt,75 und mehr Jahre,10771,3974,6797
False,8237,Landkreis Freudenstadt,Insgesamt,119878,58956,60922
False,8237002,"Alpirsbach, Stadt",unter 3 Jahre,153,94,59
False,8237002,"Alpirsbach, Stadt",3 -  6 Jahre,167,87,80
False,8237002,"Alpirsbach, Stadt",6 - 10 Jahre,260,126,134
False,8237002,"Alpirsbach, Stadt",10 - 15 Jahre,373,192,181
False,8237002,"Alpirsbach, Stadt",15 - 18 Jahre,228,121,107
False,8237002,"Alpirsbach, Stadt",18 - 20 Jahre,160,78,82
False,8237002,"Alpirsbach, Stadt",20 - 25 Jahre,398,199,199
False,8237002,"Alpirsbach, Stadt",25 - 30 Jahre,330,158,172
False,8237002,"Alpirsbach, Stadt",30 - 35 Jahre,289,164,125
False,8237002,"Alpirsbach, Stadt",35 - 40 Jahre,350,170,180
False,8237002,"Alpirsbach, Stadt",40 - 45 Jahre,522,265,257
False,8237002,"Alpirsbach, Stadt",45 - 50 Jahre,617,303,314
False,8237002,"Alpirsbach, Stadt",50 - 55 Jahre,504,253,251
False,8237002,"Alpirsbach, Stadt",55 - 60 Jahre,440,232,208
False,8237002,"Alpirsbach, Stadt",60 - 65 Jahre,361,182,179
False,8237002,"Alpirsbach, Stadt",65 - 75 Jahre,720,361,359
False,8237002,"Alpirsbach, Stadt",75 und mehr Jahre,711,256,455
False,8237002,"Alpirsbach, Stadt",Insgesamt,6583,3241,3342
False,8237004,Baiersbronn,unter 3 Jahre,334,183,151
False,8237004,Baiersbronn,3 -  6 Jahre,346,179,167
False,8237004,Baiersbronn,6 - 10 Jahre,582,304,278
False,8237004,Baiersbronn,10 - 15 Jahre,802,404,398
False,8237004,Baiersbronn,15 - 18 Jahre,542,293,249
False,8237004,Baiersbronn,18 - 20 Jahre,391,207,184
False,8237004,Baiersbronn,20 - 25 Jahre,987,482,505
False,8237004,Baiersbronn,25 - 30 Jahre,874,435,439
False,8237004,Baiersbronn,30 - 35 Jahre,841,441,400
False,8237004,Baiersbronn,35 - 40 Jahre,984,469,515
False,8237004,Baiersbronn,40 - 45 Jahre,1460,690,770
False,8237004,Baiersbronn,45 - 50 Jahre,1365,683,682
False,8237004,Baiersbronn,50 - 55 Jahre,1110,578,532
False,8237004,Baiersbronn,55 - 60 Jahre,941,484,457
False,8237004,Baiersbronn,60 - 65 Jahre,747,361,386
False,8237004,Baiersbronn,65 - 75 Jahre,1693,787,906
False,8237004,Baiersbronn,75 und mehr Jahre,1499,565,934
False,8237004,Baiersbronn,Insgesamt,15498,7545,7953
False,8237019,"Dornstetten, Stadt",unter 3 Jahre,234,110,124
False,8237019,"Dornstetten, Stadt",3 -  6 Jahre,228,131,97
False,8237019,"Dornstetten, Stadt",6 - 10 Jahre,320,167,153
False,8237019,"Dornstetten, Stadt",10 - 15 Jahre,490,236,254
False,8237019,"Dornstetten, Stadt",15 - 18 Jahre,266,143,123
False,8237019,"Dornstetten, Stadt",18 - 20 Jahre,183,98,85
False,8237019,"Dornstetten, Stadt",20 - 25 Jahre,491,268,223
False,8237019,"Dornstetten, Stadt",25 - 30 Jahre,474,254,220
False,8237019,"Dornstetten, Stadt",30 - 35 Jahre,490,244,246
False,8237019,"Dornstetten, Stadt",35 - 40 Jahre,550,290,260
False,8237019,"Dornstetten, Stadt",40 - 45 Jahre,630,311,319
False,8237019,"Dornstetten, Stadt",45 - 50 Jahre,662,325,337
False,8237019,"Dornstetten, Stadt",50 - 55 Jahre,607,306,301
False,8237019,"Dornstetten, Stadt",55 - 60 Jahre,562,278,284
False,8237019,"Dornstetten, Stadt",60 - 65 Jahre,442,237,205
False,8237019,"Dornstetten, Stadt",65 - 75 Jahre,727,347,380
False,8237019,"Dornstetten, Stadt",75 und mehr Jahre,628,210,418
False,8237019,"Dornstetten, Stadt",Insgesamt,7984,3955,4029
False,8237024,Empfingen,unter 3 Jahre,102,44,58
False,8237024,Empfingen,3 -  6 Jahre,98,54,44
False,8237024,Empfingen,6 - 10 Jahre,157,94,63
False,8237024,Empfingen,10 - 15 Jahre,218,113,105
False,8237024,Empfingen,15 - 18 Jahre,134,75,59
False,8237024,Empfingen,18 - 20 Jahre,99,50,49
False,8237024,Empfingen,20 - 25 Jahre,178,80,98
False,8237024,Empfingen,25 - 30 Jahre,166,80,86
False,8237024,Empfingen,30 - 35 Jahre,195,99,96
False,8237024,Empfingen,35 - 40 Jahre,406,176,230
False,8237024,Empfingen,40 - 45 Jahre,490,269,221
False,8237024,Empfingen,45 - 50 Jahre,344,180,164
False,8237024,Empfingen,50 - 55 Jahre,390,226,164
False,8237024,Empfingen,55 - 60 Jahre,310,170,140
False,8237024,Empfingen,60 - 65 Jahre,236,102,134
False,8237024,Empfingen,65 - 75 Jahre,275,140,135
False,8237024,Empfingen,75 und mehr Jahre,339,122,217
False,8237024,Empfingen,Insgesamt,4137,2074,2063
False,8237027,Eutingen im Gäu,unter 3 Jahre,145,68,77
False,8237027,Eutingen im Gäu,3 -  6 Jahre,161,87,74
False,8237027,Eutingen im Gäu,6 - 10 Jahre,237,130,107
False,8237027,Eutingen im Gäu,10 - 15 Jahre,407,216,191
False,8237027,Eutingen im Gäu,15 - 18 Jahre,242,123,119
False,8237027,Eutingen im Gäu,18 - 20 Jahre,162,89,73
False,8237027,Eutingen im Gäu,20 - 25 Jahre,318,166,152
False,8237027,Eutingen im Gäu,25 - 30 Jahre,279,143,136
False,8237027,Eutingen im Gäu,30 - 35 Jahre,277,143,134
False,8237027,Eutingen im Gäu,35 - 40 Jahre,362,179,183
False,8237027,Eutingen im Gäu,40 - 45 Jahre,513,254,259
False,8237027,Eutingen im Gäu,45 - 50 Jahre,522,261,261
False,8237027,Eutingen im Gäu,50 - 55 Jahre,404,213,191
False,8237027,Eutingen im Gäu,55 - 60 Jahre,337,170,167
False,8237027,Eutingen im Gäu,60 - 65 Jahre,264,143,121
False,8237027,Eutingen im Gäu,65 - 75 Jahre,470,229,241
False,8237027,Eutingen im Gäu,75 und mehr Jahre,341,138,203
False,8237027,Eutingen im Gäu,Insgesamt,5441,2752,2689
False,8237028,"Freudenstadt, Stadt",unter 3 Jahre,583,283,300
False,8237028,"Freudenstadt, Stadt",3 -  6 Jahre,595,307,288
False,8237028,"Freudenstadt, Stadt",6 - 10 Jahre,807,421,386
False,8237028,"Freudenstadt, Stadt",10 - 15 Jahre,1193,623,570
False,8237028,"Freudenstadt, Stadt",15 - 18 Jahre,761,384,377
False,8237028,"Freudenstadt, Stadt",18 - 20 Jahre,555,273,282
False,8237028,"Freudenstadt, Stadt",20 - 25 Jahre,1381,706,675
False,8237028,"Freudenstadt, Stadt",25 - 30 Jahre,1375,657,718
False,8237028,"Freudenstadt, Stadt",30 - 35 Jahre,1290,642,648
False,8237028,"Freudenstadt, Stadt",35 - 40 Jahre,1335,625,710
False,8237028,"Freudenstadt, Stadt",40 - 45 Jahre,1874,914,960
False,8237028,"Freudenstadt, Stadt",45 - 50 Jahre,1889,946,943
False,8237028,"Freudenstadt, Stadt",50 - 55 Jahre,1764,864,900
False,8237028,"Freudenstadt, Stadt",55 - 60 Jahre,1574,774,800
False,8237028,"Freudenstadt, Stadt",60 - 65 Jahre,1302,659,643
False,8237028,"Freudenstadt, Stadt",65 - 75 Jahre,2739,1228,1511
False,8237028,"Freudenstadt, Stadt",75 und mehr Jahre,2534,896,1638
False,8237028,"Freudenstadt, Stadt",Insgesamt,23551,11202,12349
False,8237030,Glatten,unter 3 Jahre,76,43,33
False,8237030,Glatten,3 -  6 Jahre,71,42,29
False,8237030,Glatten,6 - 10 Jahre,110,56,54
False,8237030,Glatten,10 - 15 Jahre,145,68,77
False,8237030,Glatten,15 - 18 Jahre,82,50,32
False,8237030,Glatten,18 - 20 Jahre,80,39,41
False,8237030,Glatten,20 - 25 Jahre,121,60,61
False,8237030,Glatten,25 - 30 Jahre,154,76,78
False,8237030,Glatten,30 - 35 Jahre,138,70,68
False,8237030,Glatten,35 - 40 Jahre,118,63,55
False,8237030,Glatten,40 - 45 Jahre,153,91,62
False,8237030,Glatten,45 - 50 Jahre,177,79,98
False,8237030,Glatten,50 - 55 Jahre,180,83,97
False,8237030,Glatten,55 - 60 Jahre,177,99,78
False,8237030,Glatten,60 - 65 Jahre,118,62,56
False,8237030,Glatten,65 - 75 Jahre,245,120,125
False,8237030,Glatten,75 und mehr Jahre,181,62,119
False,8237030,Glatten,Insgesamt,2326,1163,1163
False,8237032,Grömbach,unter 3 Jahre,10,5,5
False,8237032,Grömbach,3 -  6 Jahre,20,11,9
False,8237032,Grömbach,6 - 10 Jahre,28,18,10
False,8237032,Grömbach,10 - 15 Jahre,50,23,27
False,8237032,Grömbach,15 - 18 Jahre,23,13,10
False,8237032,Grömbach,18 - 20 Jahre,23,12,11
False,8237032,Grömbach,20 - 25 Jahre,43,24,19
False,8237032,Grömbach,25 - 30 Jahre,33,19,14
False,8237032,Grömbach,30 - 35 Jahre,30,16,14
False,8237032,Grömbach,35 - 40 Jahre,52,24,28
False,8237032,Grömbach,40 - 45 Jahre,70,36,34
False,8237032,Grömbach,45 - 50 Jahre,57,28,29
False,8237032,Grömbach,50 - 55 Jahre,42,21,21
False,8237032,Grömbach,55 - 60 Jahre,44,23,21
False,8237032,Grömbach,60 - 65 Jahre,43,17,26
False,8237032,Grömbach,65 - 75 Jahre,62,36,26
False,8237032,Grömbach,75 und mehr Jahre,50,17,33
False,8237032,Grömbach,Insgesamt,680,343,337
False,8237040,"Horb am Neckar, Stadt",unter 3 Jahre,617,319,298
False,8237040,"Horb am Neckar, Stadt",3 -  6 Jahre,672,346,326
False,8237040,"Horb am Neckar, Stadt",6 - 10 Jahre,1048,553,495
False,8237040,"Horb am Neckar, Stadt",10 - 15 Jahre,1448,766,682
False,8237040,"Horb am Neckar, Stadt",15 - 18 Jahre,980,502,478
False,8237040,"Horb am Neckar, Stadt",18 - 20 Jahre,690,358,332
False,8237040,"Horb am Neckar, Stadt",20 - 25 Jahre,1618,841,777
False,8237040,"Horb am Neckar, Stadt",25 - 30 Jahre,1468,697,771
False,8237040,"Horb am Neckar, Stadt",30 - 35 Jahre,1478,753,725
False,8237040,"Horb am Neckar, Stadt",35 - 40 Jahre,1678,837,841
False,8237040,"Horb am Neckar, Stadt",40 - 45 Jahre,2110,1088,1022
False,8237040,"Horb am Neckar, Stadt",45 - 50 Jahre,2280,1147,1133
False,8237040,"Horb am Neckar, Stadt",50 - 55 Jahre,2027,1035,992
False,8237040,"Horb am Neckar, Stadt",55 - 60 Jahre,1691,856,835
False,8237040,"Horb am Neckar, Stadt",60 - 65 Jahre,1346,706,640
False,8237040,"Horb am Neckar, Stadt",65 - 75 Jahre,2495,1225,1270
False,8237040,"Horb am Neckar, Stadt",75 und mehr Jahre,1957,755,1202
False,8237040,"Horb am Neckar, Stadt",Insgesamt,25603,12784,12819
False,8237045,Loßburg,unter 3 Jahre,167,76,91
False,8237045,Loßburg,3 -  6 Jahre,165,83,82
False,8237045,Loßburg,6 - 10 Jahre,300,172,128
False,8237045,Loßburg,10 - 15 Jahre,435,231,204
False,8237045,Loßburg,15 - 18 Jahre,331,174,157
False,8237045,Loßburg,18 - 20 Jahre,207,110,97
False,8237045,Loßburg,20 - 25 Jahre,443,229,214
False,8237045,Loßburg,25 - 30 Jahre,402,205,197
False,8237045,Loßburg,30 - 35 Jahre,397,184,213
False,8237045,Loßburg,35 - 40 Jahre,398,193,205
False,8237045,Loßburg,40 - 45 Jahre,622,328,294
False,8237045,Loßburg,45 - 50 Jahre,744,392,352
False,8237045,Loßburg,50 - 55 Jahre,643,317,326
False,8237045,Loßburg,55 - 60 Jahre,467,250,217
False,8237045,Loßburg,60 - 65 Jahre,384,209,175
False,8237045,Loßburg,65 - 75 Jahre,794,378,416
False,8237045,Loßburg,75 und mehr Jahre,714,283,431
False,8237045,Loßburg,Insgesamt,7613,3814,3799
False,8237054,Pfalzgrafenweiler,unter 3 Jahre,223,123,100
False,8237054,Pfalzgrafenweiler,3 -  6 Jahre,223,105,118
False,8237054,Pfalzgrafenweiler,6 - 10 Jahre,367,196,171
False,8237054,Pfalzgrafenweiler,10 - 15 Jahre,471,242,229
False,8237054,Pfalzgrafenweiler,15 - 18 Jahre,305,159,146
False,8237054,Pfalzgrafenweiler,18 - 20 Jahre,201,96,105
False,8237054,Pfalzgrafenweiler,20 - 25 Jahre,434,232,202
False,8237054,Pfalzgrafenweiler,25 - 30 Jahre,395,206,189
False,8237054,Pfalzgrafenweiler,30 - 35 Jahre,369,189,180
False,8237054,Pfalzgrafenweiler,35 - 40 Jahre,451,222,229
False,8237054,Pfalzgrafenweiler,40 - 45 Jahre,609,305,304
False,8237054,Pfalzgrafenweiler,45 - 50 Jahre,610,299,311
False,8237054,Pfalzgrafenweiler,50 - 55 Jahre,525,260,265
False,8237054,Pfalzgrafenweiler,55 - 60 Jahre,441,224,217
False,8237054,Pfalzgrafenweiler,60 - 65 Jahre,294,144,150
False,8237054,Pfalzgrafenweiler,65 - 75 Jahre,653,300,353
False,8237054,Pfalzgrafenweiler,75 und mehr Jahre,680,259,421
False,8237054,Pfalzgrafenweiler,Insgesamt,7251,3561,3690
False,8237061,Schopfloch,unter 3 Jahre,96,49,47
False,8237061,Schopfloch,3 -  6 Jahre,98,57,41
False,8237061,Schopfloch,6 - 10 Jahre,125,55,70
False,8237061,Schopfloch,10 - 15 Jahre,166,95,71
False,8237061,Schopfloch,15 - 18 Jahre,104,56,48
False,8237061,Schopfloch,18 - 20 Jahre,59,33,26
False,8237061,Schopfloch,20 - 25 Jahre,149,76,73
False,8237061,Schopfloch,25 - 30 Jahre,138,73,65
False,8237061,Schopfloch,30 - 35 Jahre,149,69,80
False,8237061,Schopfloch,35 - 40 Jahre,175,79,96
False,8237061,Schopfloch,40 - 45 Jahre,205,113,92
False,8237061,Schopfloch,45 - 50 Jahre,232,113,119
False,8237061,Schopfloch,50 - 55 Jahre,179,91,88
False,8237061,Schopfloch,55 - 60 Jahre,173,93,80
False,8237061,Schopfloch,60 - 65 Jahre,121,62,59
False,8237061,Schopfloch,65 - 75 Jahre,250,115,135
False,8237061,Schopfloch,75 und mehr Jahre,193,74,119
False,8237061,Schopfloch,Insgesamt,2612,1303,1309
False,8237072,Wörnersberg,unter 3 Jahre,10,3,7
False,8237072,Wörnersberg,3 -  6 Jahre,11,5,6
False,8237072,Wörnersberg,6 - 10 Jahre,19,9,10
False,8237072,Wörnersberg,10 - 15 Jahre,16,8,8
False,8237072,Wörnersberg,15 - 18 Jahre,9,7,2
False,8237072,Wörnersberg,18 - 20 Jahre,10,6,4
False,8237072,Wörnersberg,20 - 25 Jahre,22,12,10
False,8237072,Wörnersberg,25 - 30 Jahre,18,8,10
False,8237072,Wörnersberg,30 - 35 Jahre,10,6,4
False,8237072,Wörnersberg,35 - 40 Jahre,16,6,10
False,8237072,Wörnersberg,40 - 45 Jahre,16,7,9
False,8237072,Wörnersberg,45 - 50 Jahre,23,14,9
False,8237072,Wörnersberg,50 - 55 Jahre,21,6,15
False,8237072,Wörnersberg,55 - 60 Jahre,9,7,2
False,8237072,Wörnersberg,60 - 65 Jahre,8,4,4
False,8237072,Wörnersberg,65 - 75 Jahre,14,6,8
False,8237072,Wörnersberg,75 und mehr Jahre,17,6,11
False,8237072,Wörnersberg,Insgesamt,249,120,129
False,8237073,Seewald,unter 3 Jahre,55,29,26
False,8237073,Seewald,3 -  6 Jahre,63,25,38
False,8237073,Seewald,6 - 10 Jahre,72,32,40
False,8237073,Seewald,10 - 15 Jahre,113,58,55
False,8237073,Seewald,15 - 18 Jahre,100,54,46
False,8237073,Seewald,18 - 20 Jahre,54,26,28
False,8237073,Seewald,20 - 25 Jahre,112,58,54
False,8237073,Seewald,25 - 30 Jahre,131,71,60
False,8237073,Seewald,30 - 35 Jahre,105,55,50
False,8237073,Seewald,35 - 40 Jahre,121,61,60
False,8237073,Seewald,40 - 45 Jahre,186,105,81
False,8237073,Seewald,45 - 50 Jahre,219,107,112
False,8237073,Seewald,50 - 55 Jahre,184,94,90
False,8237073,Seewald,55 - 60 Jahre,129,63,66
False,8237073,Seewald,60 - 65 Jahre,127,70,57
False,8237073,Seewald,65 - 75 Jahre,271,117,154
False,8237073,Seewald,75 und mehr Jahre,283,102,181
False,8237073,Seewald,Insgesamt,2325,1127,1198
False,8237074,Waldachtal,unter 3 Jahre,133,78,55
False,8237074,Waldachtal,3 -  6 Jahre,148,75,73
False,8237074,Waldachtal,6 - 10 Jahre,218,109,109
False,8237074,Waldachtal,10 - 15 Jahre,322,166,156
False,8237074,Waldachtal,15 - 18 Jahre,258,126,132
False,8237074,Waldachtal,18 - 20 Jahre,163,78,85
False,8237074,Waldachtal,20 - 25 Jahre,364,196,168
False,8237074,Waldachtal,25 - 30 Jahre,304,156,148
False,8237074,Waldachtal,30 - 35 Jahre,312,147,165
False,8237074,Waldachtal,35 - 40 Jahre,365,178,187
False,8237074,Waldachtal,40 - 45 Jahre,461,222,239
False,8237074,Waldachtal,45 - 50 Jahre,512,258,254
False,8237074,Waldachtal,50 - 55 Jahre,483,258,225
False,8237074,Waldachtal,55 - 60 Jahre,442,222,220
False,8237074,Waldachtal,60 - 65 Jahre,337,172,165
False,8237074,Waldachtal,65 - 75 Jahre,578,279,299
False,8237074,Waldachtal,75 und mehr Jahre,391,119,272
False,8237074,Waldachtal,Insgesamt,5791,2839,2952
False,8237075,Bad Rippoldsau-Schapbach,unter 3 Jahre,45,22,23
False,8237075,Bad Rippoldsau-Schapbach,3 -  6 Jahre,66,29,37
False,8237075,Bad Rippoldsau-Schapbach,6 - 10 Jahre,91,44,47
False,8237075,Bad Rippoldsau-Schapbach,10 - 15 Jahre,127,70,57
False,8237075,Bad Rippoldsau-Schapbach,15 - 18 Jahre,95,46,49
False,8237075,Bad Rippoldsau-Schapbach,18 - 20 Jahre,42,24,18
False,8237075,Bad Rippoldsau-Schapbach,20 - 25 Jahre,101,51,50
False,8237075,Bad Rippoldsau-Schapbach,25 - 30 Jahre,108,60,48
False,8237075,Bad Rippoldsau-Schapbach,30 - 35 Jahre,110,50,60
False,8237075,Bad Rippoldsau-Schapbach,35 - 40 Jahre,133,73,60
False,8237075,Bad Rippoldsau-Schapbach,40 - 45 Jahre,163,88,75
False,8237075,Bad Rippoldsau-Schapbach,45 - 50 Jahre,202,100,102
False,8237075,Bad Rippoldsau-Schapbach,50 - 55 Jahre,173,113,60
False,8237075,Bad Rippoldsau-Schapbach,55 - 60 Jahre,121,63,58
False,8237075,Bad Rippoldsau-Schapbach,60 - 65 Jahre,136,71,65
False,8237075,Bad Rippoldsau-Schapbach,65 - 75 Jahre,268,119,149
False,8237075,Bad Rippoldsau-Schapbach,75 und mehr Jahre,253,110,143
False,8237075,Bad Rippoldsau-Schapbach,Insgesamt,2234,1133,1101
False,83,Regierungsbezirk Freiburg,unter 3 Jahre,56196,28793,27403
False,83,Regierungsbezirk Freiburg,3 -  6 Jahre,58185,29562,28623
False,83,Regierungsbezirk Freiburg,6 - 10 Jahre,82237,42325,39912
False,83,Regierungsbezirk Freiburg,10 - 15 Jahre,118910,61135,57775
False,83,Regierungsbezirk Freiburg,15 - 18 Jahre,73569,37861,35708
False,83,Regierungsbezirk Freiburg,18 - 20 Jahre,52395,26731,25664
False,83,Regierungsbezirk Freiburg,20 - 25 Jahre,139427,69959,69468
False,83,Regierungsbezirk Freiburg,25 - 30 Jahre,131270,65896,65374
False,83,Regierungsbezirk Freiburg,30 - 35 Jahre,124029,61385,62644
False,83,Regierungsbezirk Freiburg,35 - 40 Jahre,131577,65275,66302
False,83,Regierungsbezirk Freiburg,40 - 45 Jahre,179861,90167,89694
False,83,Regierungsbezirk Freiburg,45 - 50 Jahre,192095,97129,94966
False,83,Regierungsbezirk Freiburg,50 - 55 Jahre,167565,84508,83057
False,83,Regierungsbezirk Freiburg,55 - 60 Jahre,142100,70387,71713
False,83,Regierungsbezirk Freiburg,60 - 65 Jahre,117637,58129,59508
False,83,Regierungsbezirk Freiburg,65 - 75 Jahre,232121,109650,122471
False,83,Regierungsbezirk Freiburg,75 und mehr Jahre,199951,76732,123219
False,83,Regierungsbezirk Freiburg,Insgesamt,2199125,1075624,1123501
False,8311,Stadtkreis Freiburg im Breisgau,unter 3 Jahre,6179,3266,2913
False,8311,Stadtkreis Freiburg im Breisgau,3 -  6 Jahre,5625,2769,2856
False,8311,Stadtkreis Freiburg im Breisgau,6 - 10 Jahre,7081,3643,3438
False,8311,Stadtkreis Freiburg im Breisgau,10 - 15 Jahre,9338,4879,4459
False,8311,Stadtkreis Freiburg im Breisgau,15 - 18 Jahre,5318,2732,2586
False,8311,Stadtkreis Freiburg im Breisgau,18 - 20 Jahre,4417,1985,2432
False,8311,Stadtkreis Freiburg im Breisgau,20 - 25 Jahre,20261,8731,11530
False,8311,Stadtkreis Freiburg im Breisgau,25 - 30 Jahre,20586,9833,10753
False,8311,Stadtkreis Freiburg im Breisgau,30 - 35 Jahre,17048,8551,8497
False,8311,Stadtkreis Freiburg im Breisgau,35 - 40 Jahre,15038,7572,7466
False,8311,Stadtkreis Freiburg im Breisgau,40 - 45 Jahre,18359,9144,9215
False,8311,Stadtkreis Freiburg im Breisgau,45 - 50 Jahre,19845,9979,9866
False,8311,Stadtkreis Freiburg im Breisgau,50 - 55 Jahre,16195,8239,7956
False,8311,Stadtkreis Freiburg im Breisgau,55 - 60 Jahre,12657,6254,6403
False,8311,Stadtkreis Freiburg im Breisgau,60 - 65 Jahre,10031,4852,5179
False,8311,Stadtkreis Freiburg im Breisgau,65 - 75 Jahre,19022,8615,10407
False,8311,Stadtkreis Freiburg im Breisgau,75 und mehr Jahre,17191,6053,11138
False,8311,Stadtkreis Freiburg im Breisgau,Insgesamt,224191,107097,117094
False,8311000,"Freiburg im Breisgau, Stadt",unter 3 Jahre,6179,3266,2913
False,8311000,"Freiburg im Breisgau, Stadt",3 -  6 Jahre,5625,2769,2856
False,8311000,"Freiburg im Breisgau, Stadt",6 - 10 Jahre,7081,3643,3438
False,8311000,"Freiburg im Breisgau, Stadt",10 - 15 Jahre,9338,4879,4459
False,8311000,"Freiburg im Breisgau, Stadt",15 - 18 Jahre,5318,2732,2586
False,8311000,"Freiburg im Breisgau, Stadt",18 - 20 Jahre,4417,1985,2432
False,8311000,"Freiburg im Breisgau, Stadt",20 - 25 Jahre,20261,8731,11530
False,8311000,"Freiburg im Breisgau, Stadt",25 - 30 Jahre,20586,9833,10753
False,8311000,"Freiburg im Breisgau, Stadt",30 - 35 Jahre,17048,8551,8497
False,8311000,"Freiburg im Breisgau, Stadt",35 - 40 Jahre,15038,7572,7466
False,8311000,"Freiburg im Breisgau, Stadt",40 - 45 Jahre,18359,9144,9215
False,8311000,"Freiburg im Breisgau, Stadt",45 - 50 Jahre,19845,9979,9866
False,8311000,"Freiburg im Breisgau, Stadt",50 - 55 Jahre,16195,8239,7956
False,8311000,"Freiburg im Breisgau, Stadt",55 - 60 Jahre,12657,6254,6403
False,8311000,"Freiburg im Breisgau, Stadt",60 - 65 Jahre,10031,4852,5179
False,8311000,"Freiburg im Breisgau, Stadt",65 - 75 Jahre,19022,8615,10407
False,8311000,"Freiburg im Breisgau, Stadt",75 und mehr Jahre,17191,6053,11138
False,8311000,"Freiburg im Breisgau, Stadt",Insgesamt,224191,107097,117094
False,8315,Landkreis Breisgau-Hochschwarzwald,unter 3 Jahre,6429,3286,3143
False,8315,Landkreis Breisgau-Hochschwarzwald,3 -  6 Jahre,6774,3458,3316
False,8315,Landkreis Breisgau-Hochschwarzwald,6 - 10 Jahre,9817,5097,4720
False,8315,Landkreis Breisgau-Hochschwarzwald,10 - 15 Jahre,13951,7315,6636
False,8315,Landkreis Breisgau-Hochschwarzwald,15 - 18 Jahre,8851,4617,4234
False,8315,Landkreis Breisgau-Hochschwarzwald,18 - 20 Jahre,6146,3210,2936
False,8315,Landkreis Breisgau-Hochschwarzwald,20 - 25 Jahre,14073,7161,6912
False,8315,Landkreis Breisgau-Hochschwarzwald,25 - 30 Jahre,13180,6592,6588
False,8315,Landkreis Breisgau-Hochschwarzwald,30 - 35 Jahre,13139,6389,6750
False,8315,Landkreis Breisgau-Hochschwarzwald,35 - 40 Jahre,14687,7032,7655
False,8315,Landkreis Breisgau-Hochschwarzwald,40 - 45 Jahre,21065,10391,10674
False,8315,Landkreis Breisgau-Hochschwarzwald,45 - 50 Jahre,22015,11018,10997
False,8315,Landkreis Breisgau-Hochschwarzwald,50 - 55 Jahre,19325,9668,9657
False,8315,Landkreis Breisgau-Hochschwarzwald,55 - 60 Jahre,16923,8211,8712
False,8315,Landkreis Breisgau-Hochschwarzwald,60 - 65 Jahre,14399,7052,7347
False,8315,Landkreis Breisgau-Hochschwarzwald,65 - 75 Jahre,27875,13306,14569
False,8315,Landkreis Breisgau-Hochschwarzwald,75 und mehr Jahre,22617,9054,13563
False,8315,Landkreis Breisgau-Hochschwarzwald,Insgesamt,251266,122857,128409
False,8315003,Au,unter 3 Jahre,39,21,18
False,8315003,Au,3 -  6 Jahre,52,28,24
False,8315003,Au,6 - 10 Jahre,56,32,24
False,8315003,Au,10 - 15 Jahre,100,55,45
False,8315003,Au,15 - 18 Jahre,62,31,31
False,8315003,Au,18 - 20 Jahre,34,20,14
False,8315003,Au,20 - 25 Jahre,61,33,28
False,8315003,Au,25 - 30 Jahre,61,31,30
False,8315003,Au,30 - 35 Jahre,79,45,34
False,8315003,Au,35 - 40 Jahre,85,37,48
False,8315003,Au,40 - 45 Jahre,147,75,72
False,8315003,Au,45 - 50 Jahre,136,66,70
False,8315003,Au,50 - 55 Jahre,118,53,65
False,8315003,Au,55 - 60 Jahre,92,44,48
False,8315003,Au,60 - 65 Jahre,81,43,38
False,8315003,Au,65 - 75 Jahre,148,72,76
False,8315003,Au,75 und mehr Jahre,102,41,61
False,8315003,Au,Insgesamt,1453,727,726
False,8315004,Auggen,unter 3 Jahre,68,36,32
False,8315004,Auggen,3 -  6 Jahre,74,41,33
False,8315004,Auggen,6 - 10 Jahre,104,53,51
False,8315004,Auggen,10 - 15 Jahre,153,75,78
False,8315004,Auggen,15 - 18 Jahre,99,52,47
False,8315004,Auggen,18 - 20 Jahre,56,35,21
False,8315004,Auggen,20 - 25 Jahre,113,48,65
False,8315004,Auggen,25 - 30 Jahre,141,70,71
False,8315004,Auggen,30 - 35 Jahre,160,79,81
False,8315004,Auggen,35 - 40 Jahre,144,66,78
False,8315004,Auggen,40 - 45 Jahre,240,119,121
False,8315004,Auggen,45 - 50 Jahre,184,103,81
False,8315004,Auggen,50 - 55 Jahre,164,84,80
False,8315004,Auggen,55 - 60 Jahre,163,69,94
False,8315004,Auggen,60 - 65 Jahre,164,88,76
False,8315004,Auggen,65 - 75 Jahre,262,134,128
False,8315004,Auggen,75 und mehr Jahre,190,73,117
False,8315004,Auggen,Insgesamt,2479,1225,1254
False,8315006,"Bad Krozingen, Stadt",unter 3 Jahre,400,202,198
False,8315006,"Bad Krozingen, Stadt",3 -  6 Jahre,418,210,208
False,8315006,"Bad Krozingen, Stadt",6 - 10 Jahre,587,301,286
False,8315006,"Bad Krozingen, Stadt",10 - 15 Jahre,908,476,432
False,8315006,"Bad Krozingen, Stadt",15 - 18 Jahre,545,275,270
False,8315006,"Bad Krozingen, Stadt",18 - 20 Jahre,359,174,185
False,8315006,"Bad Krozingen, Stadt",20 - 25 Jahre,899,470,429
False,8315006,"Bad Krozingen, Stadt",25 - 30 Jahre,827,432,395
False,8315006,"Bad Krozingen, Stadt",30 - 35 Jahre,852,409,443
False,8315006,"Bad Krozingen, Stadt",35 - 40 Jahre,963,437,526
False,8315006,"Bad Krozingen, Stadt",40 - 45 Jahre,1268,612,656
False,8315006,"Bad Krozingen, Stadt",45 - 50 Jahre,1330,672,658
False,8315006,"Bad Krozingen, Stadt",50 - 55 Jahre,1208,577,631
False,8315006,"Bad Krozingen, Stadt",55 - 60 Jahre,1170,529,641
False,8315006,"Bad Krozingen, Stadt",60 - 65 Jahre,1033,483,550
False,8315006,"Bad Krozingen, Stadt",65 - 75 Jahre,2131,969,1162
False,8315006,"Bad Krozingen, Stadt",75 und mehr Jahre,2165,812,1353
False,8315006,"Bad Krozingen, Stadt",Insgesamt,17063,8040,9023
False,8315007,Badenweiler,unter 3 Jahre,55,31,24
False,8315007,Badenweiler,3 -  6 Jahre,67,34,33
False,8315007,Badenweiler,6 - 10 Jahre,103,45,58
False,8315007,Badenweiler,10 - 15 Jahre,154,76,78
False,8315007,Badenweiler,15 - 18 Jahre,114,63,51
False,8315007,Badenweiler,18 - 20 Jahre,82,38,44
False,8315007,Badenweiler,20 - 25 Jahre,197,92,105
False,8315007,Badenweiler,25 - 30 Jahre,189,99,90
False,8315007,Badenweiler,30 - 35 Jahre,154,78,76
False,8315007,Badenweiler,35 - 40 Jahre,157,71,86
False,8315007,Badenweiler,40 - 45 Jahre,274,137,137
False,8315007,Badenweiler,45 - 50 Jahre,293,135,158
False,8315007,Badenweiler,50 - 55 Jahre,309,148,161
False,8315007,Badenweiler,55 - 60 Jahre,303,154,149
False,8315007,Badenweiler,60 - 65 Jahre,274,115,159
False,8315007,Badenweiler,65 - 75 Jahre,650,308,342
False,8315007,Badenweiler,75 und mehr Jahre,532,221,311
False,8315007,Badenweiler,Insgesamt,3907,1845,2062
False,8315008,Ballrechten-Dottingen,unter 3 Jahre,58,22,36
False,8315008,Ballrechten-Dottingen,3 -  6 Jahre,58,29,29
False,8315008,Ballrechten-Dottingen,6 - 10 Jahre,88,42,46
False,8315008,Ballrechten-Dottingen,10 - 15 Jahre,151,79,72
False,8315008,Ballrechten-Dottingen,15 - 18 Jahre,98,52,46
False,8315008,Ballrechten-Dottingen,18 - 20 Jahre,67,30,37
False,8315008,Ballrechten-Dottingen,20 - 25 Jahre,149,83,66
False,8315008,Ballrechten-Dottingen,25 - 30 Jahre,141,66,75
False,8315008,Ballrechten-Dottingen,30 - 35 Jahre,120,57,63
False,8315008,Ballrechten-Dottingen,35 - 40 Jahre,142,74,68
False,8315008,Ballrechten-Dottingen,40 - 45 Jahre,233,111,122
False,8315008,Ballrechten-Dottingen,45 - 50 Jahre,212,101,111
False,8315008,Ballrechten-Dottingen,50 - 55 Jahre,182,88,94
False,8315008,Ballrechten-Dottingen,55 - 60 Jahre,148,76,72
False,8315008,Ballrechten-Dottingen,60 - 65 Jahre,137,68,69
False,8315008,Ballrechten-Dottingen,65 - 75 Jahre,191,99,92
False,8315008,Ballrechten-Dottingen,75 und mehr Jahre,128,51,77
False,8315008,Ballrechten-Dottingen,Insgesamt,2303,1128,1175
False,8315013,Bötzingen,unter 3 Jahre,139,60,79
False,8315013,Bötzingen,3 -  6 Jahre,195,103,92
False,8315013,Bötzingen,6 - 10 Jahre,243,124,119
False,8315013,Bötzingen,10 - 15 Jahre,311,149,162
False,8315013,Bötzingen,15 - 18 Jahre,216,115,101
False,8315013,Bötzingen,18 - 20 Jahre,123,71,52
False,8315013,Bötzingen,20 - 25 Jahre,329,175,154
False,8315013,Bötzingen,25 - 30 Jahre,332,160,172
False,8315013,Bötzingen,30 - 35 Jahre,315,169,146
False,8315013,Bötzingen,35 - 40 Jahre,327,162,165
False,8315013,Bötzingen,40 - 45 Jahre,451,220,231
False,8315013,Bötzingen,45 - 50 Jahre,491,258,233
False,8315013,Bötzingen,50 - 55 Jahre,368,194,174
False,8315013,Bötzingen,55 - 60 Jahre,319,145,174
False,8315013,Bötzingen,60 - 65 Jahre,270,129,141
False,8315013,Bötzingen,65 - 75 Jahre,545,271,274
False,8315013,Bötzingen,75 und mehr Jahre,377,165,212
False,8315013,Bötzingen,Insgesamt,5351,2670,2681
False,8315014,Bollschweil,unter 3 Jahre,55,24,31
False,8315014,Bollschweil,3 -  6 Jahre,63,34,29
False,8315014,Bollschweil,6 - 10 Jahre,108,54,54
False,8315014,Bollschweil,10 - 15 Jahre,111,55,56
False,8315014,Bollschweil,15 - 18 Jahre,74,45,29
False,8315014,Bollschweil,18 - 20 Jahre,65,37,28
False,8315014,Bollschweil,20 - 25 Jahre,102,47,55
False,8315014,Bollschweil,25 - 30 Jahre,93,45,48
False,8315014,Bollschweil,30 - 35 Jahre,104,42,62
False,8315014,Bollschweil,35 - 40 Jahre,112,53,59
False,8315014,Bollschweil,40 - 45 Jahre,206,97,109
False,8315014,Bollschweil,45 - 50 Jahre,241,138,103
False,8315014,Bollschweil,50 - 55 Jahre,187,92,95
False,8315014,Bollschweil,55 - 60 Jahre,166,74,92
False,8315014,Bollschweil,60 - 65 Jahre,148,67,81
False,8315014,Bollschweil,65 - 75 Jahre,262,129,133
False,8315014,Bollschweil,75 und mehr Jahre,184,95,89
False,8315014,Bollschweil,Insgesamt,2281,1128,1153
False,8315015,"Breisach am Rhein, Stadt",unter 3 Jahre,366,181,185
False,8315015,"Breisach am Rhein, Stadt",3 -  6 Jahre,393,193,200
False,8315015,"Breisach am Rhein, Stadt",6 - 10 Jahre,559,302,257
False,8315015,"Breisach am Rhein, Stadt",10 - 15 Jahre,920,483,437
False,8315015,"Breisach am Rhein, Stadt",15 - 18 Jahre,594,310,284
False,8315015,"Breisach am Rhein, Stadt",18 - 20 Jahre,373,201,172
False,8315015,"Breisach am Rhein, Stadt",20 - 25 Jahre,804,444,360
False,8315015,"Breisach am Rhein, Stadt",25 - 30 Jahre,727,389,338
False,8315015,"Breisach am Rhein, Stadt",30 - 35 Jahre,760,371,389
False,8315015,"Breisach am Rhein, Stadt",35 - 40 Jahre,884,445,439
False,8315015,"Breisach am Rhein, Stadt",40 - 45 Jahre,1222,627,595
False,8315015,"Breisach am Rhein, Stadt",45 - 50 Jahre,1244,619,625
False,8315015,"Breisach am Rhein, Stadt",50 - 55 Jahre,1197,571,626
False,8315015,"Breisach am Rhein, Stadt",55 - 60 Jahre,1002,511,491
False,8315015,"Breisach am Rhein, Stadt",60 - 65 Jahre,850,444,406
False,8315015,"Breisach am Rhein, Stadt",65 - 75 Jahre,1459,715,744
False,8315015,"Breisach am Rhein, Stadt",75 und mehr Jahre,1151,442,709
False,8315015,"Breisach am Rhein, Stadt",Insgesamt,14505,7248,7257
False,8315016,Breitnau,unter 3 Jahre,55,29,26
False,8315016,Breitnau,3 -  6 Jahre,55,26,29
False,8315016,Breitnau,6 - 10 Jahre,100,39,61
False,8315016,Breitnau,10 - 15 Jahre,101,50,51
False,8315016,Breitnau,15 - 18 Jahre,49,29,20
False,8315016,Breitnau,18 - 20 Jahre,68,48,20
False,8315016,Breitnau,20 - 25 Jahre,100,52,48
False,8315016,Breitnau,25 - 30 Jahre,116,59,57
False,8315016,Breitnau,30 - 35 Jahre,124,64,60
False,8315016,Breitnau,35 - 40 Jahre,196,92,104
False,8315016,Breitnau,40 - 45 Jahre,198,108,90
False,8315016,Breitnau,45 - 50 Jahre,137,76,61
False,8315016,Breitnau,50 - 55 Jahre,125,72,53
False,8315016,Breitnau,55 - 60 Jahre,109,58,51
False,8315016,Breitnau,60 - 65 Jahre,96,49,47
False,8315016,Breitnau,65 - 75 Jahre,177,85,92
False,8315016,Breitnau,75 und mehr Jahre,152,72,80
False,8315016,Breitnau,Insgesamt,1958,1008,950
False,8315020,Buchenbach,unter 3 Jahre,92,53,39
False,8315020,Buchenbach,3 -  6 Jahre,83,39,44
False,8315020,Buchenbach,6 - 10 Jahre,153,82,71
False,8315020,Buchenbach,10 - 15 Jahre,201,111,90
False,8315020,Buchenbach,15 - 18 Jahre,124,63,61
False,8315020,Buchenbach,18 - 20 Jahre,95,47,48
False,8315020,Buchenbach,20 - 25 Jahre,182,81,101
False,8315020,Buchenbach,25 - 30 Jahre,146,65,81
False,8315020,Buchenbach,30 - 35 Jahre,177,96,81
False,8315020,Buchenbach,35 - 40 Jahre,189,89,100
False,8315020,Buchenbach,40 - 45 Jahre,280,143,137
False,8315020,Buchenbach,45 - 50 Jahre,302,144,158
False,8315020,Buchenbach,50 - 55 Jahre,229,117,112
False,8315020,Buchenbach,55 - 60 Jahre,205,91,114
False,8315020,Buchenbach,60 - 65 Jahre,169,85,84
False,8315020,Buchenbach,65 - 75 Jahre,337,152,185
False,8315020,Buchenbach,75 und mehr Jahre,231,89,142
False,8315020,Buchenbach,Insgesamt,3195,1547,1648
False,8315022,Buggingen,unter 3 Jahre,109,53,56
False,8315022,Buggingen,3 -  6 Jahre,107,67,40
False,8315022,Buggingen,6 - 10 Jahre,153,76,77
False,8315022,Buggingen,10 - 15 Jahre,220,121,99
False,8315022,Buggingen,15 - 18 Jahre,141,74,67
False,8315022,Buggingen,18 - 20 Jahre,86,47,39
False,8315022,Buggingen,20 - 25 Jahre,228,129,99
False,8315022,Buggingen,25 - 30 Jahre,237,118,119
False,8315022,Buggingen,30 - 35 Jahre,207,104,103
False,8315022,Buggingen,35 - 40 Jahre,253,117,136
False,8315022,Buggingen,40 - 45 Jahre,333,173,160
False,8315022,Buggingen,45 - 50 Jahre,351,178,173
False,8315022,Buggingen,50 - 55 Jahre,294,149,145
False,8315022,Buggingen,55 - 60 Jahre,282,154,128
False,8315022,Buggingen,60 - 65 Jahre,211,100,111
False,8315022,Buggingen,65 - 75 Jahre,371,189,182
False,8315022,Buggingen,75 und mehr Jahre,318,125,193
False,8315022,Buggingen,Insgesamt,3901,1974,1927
False,8315028,Ebringen,unter 3 Jahre,77,39,38
False,8315028,Ebringen,3 -  6 Jahre,78,45,33
False,8315028,Ebringen,6 - 10 Jahre,105,61,44
False,8315028,Ebringen,10 - 15 Jahre,149,76,73
False,8315028,Ebringen,15 - 18 Jahre,89,35,54
False,8315028,Ebringen,18 - 20 Jahre,77,39,38
False,8315028,Ebringen,20 - 25 Jahre,160,96,64
False,8315028,Ebringen,25 - 30 Jahre,169,79,90
False,8315028,Ebringen,30 - 35 Jahre,143,62,81
False,8315028,Ebringen,35 - 40 Jahre,177,95,82
False,8315028,Ebringen,40 - 45 Jahre,247,119,128
False,8315028,Ebringen,45 - 50 Jahre,276,137,139
False,8315028,Ebringen,50 - 55 Jahre,207,114,93
False,8315028,Ebringen,55 - 60 Jahre,183,90,93
False,8315028,Ebringen,60 - 65 Jahre,169,84,85
False,8315028,Ebringen,65 - 75 Jahre,257,130,127
False,8315028,Ebringen,75 und mehr Jahre,208,80,128
False,8315028,Ebringen,Insgesamt,2771,1381,1390
False,8315030,Eichstetten am Kaiserstuhl,unter 3 Jahre,113,59,54
False,8315030,Eichstetten am Kaiserstuhl,3 -  6 Jahre,97,53,44
False,8315030,Eichstetten am Kaiserstuhl,6 - 10 Jahre,172,87,85
False,8315030,Eichstetten am Kaiserstuhl,10 - 15 Jahre,207,113,94
False,8315030,Eichstetten am Kaiserstuhl,15 - 18 Jahre,113,57,56
False,8315030,Eichstetten am Kaiserstuhl,18 - 20 Jahre,105,54,51
False,8315030,Eichstetten am Kaiserstuhl,20 - 25 Jahre,211,109,102
False,8315030,Eichstetten am Kaiserstuhl,25 - 30 Jahre,190,87,103
False,8315030,Eichstetten am Kaiserstuhl,30 - 35 Jahre,174,90,84
False,8315030,Eichstetten am Kaiserstuhl,35 - 40 Jahre,197,88,109
False,8315030,Eichstetten am Kaiserstuhl,40 - 45 Jahre,298,152,146
False,8315030,Eichstetten am Kaiserstuhl,45 - 50 Jahre,310,159,151
False,8315030,Eichstetten am Kaiserstuhl,50 - 55 Jahre,257,136,121
False,8315030,Eichstetten am Kaiserstuhl,55 - 60 Jahre,223,107,116
False,8315030,Eichstetten am Kaiserstuhl,60 - 65 Jahre,180,97,83
False,8315030,Eichstetten am Kaiserstuhl,65 - 75 Jahre,252,118,134
False,8315030,Eichstetten am Kaiserstuhl,75 und mehr Jahre,222,75,147
False,8315030,Eichstetten am Kaiserstuhl,Insgesamt,3321,1641,1680
False,8315031,Eisenbach (Hochschwarzwald),unter 3 Jahre,49,28,21
False,8315031,Eisenbach (Hochschwarzwald),3 -  6 Jahre,55,27,28
False,8315031,Eisenbach (Hochschwarzwald),6 - 10 Jahre,84,39,45
False,8315031,Eisenbach (Hochschwarzwald),10 - 15 Jahre,138,70,68
False,8315031,Eisenbach (Hochschwarzwald),15 - 18 Jahre,94,54,40
False,8315031,Eisenbach (Hochschwarzwald),18 - 20 Jahre,57,32,25
False,8315031,Eisenbach (Hochschwarzwald),20 - 25 Jahre,108,54,54
False,8315031,Eisenbach (Hochschwarzwald),25 - 30 Jahre,87,53,34
False,8315031,Eisenbach (Hochschwarzwald),30 - 35 Jahre,100,44,56
False,8315031,Eisenbach (Hochschwarzwald),35 - 40 Jahre,108,59,49
False,8315031,Eisenbach (Hochschwarzwald),40 - 45 Jahre,174,80,94
False,8315031,Eisenbach (Hochschwarzwald),45 - 50 Jahre,194,101,93
False,8315031,Eisenbach (Hochschwarzwald),50 - 55 Jahre,165,93,72
False,8315031,Eisenbach (Hochschwarzwald),55 - 60 Jahre,122,56,66
False,8315031,Eisenbach (Hochschwarzwald),60 - 65 Jahre,122,61,61
False,8315031,Eisenbach (Hochschwarzwald),65 - 75 Jahre,282,147,135
False,8315031,Eisenbach (Hochschwarzwald),75 und mehr Jahre,210,92,118
False,8315031,Eisenbach (Hochschwarzwald),Insgesamt,2149,1090,1059
False,8315033,Eschbach,unter 3 Jahre,78,37,41
False,8315033,Eschbach,3 -  6 Jahre,74,36,38
False,8315033,Eschbach,6 - 10 Jahre,88,43,45
False,8315033,Eschbach,10 - 15 Jahre,169,83,86
False,8315033,Eschbach,15 - 18 Jahre,107,53,54
False,8315033,Eschbach,18 - 20 Jahre,68,35,33
False,8315033,Eschbach,20 - 25 Jahre,135,71,64
False,8315033,Eschbach,25 - 30 Jahre,124,59,65
False,8315033,Eschbach,30 - 35 Jahre,182,88,94
False,8315033,Eschbach,35 - 40 Jahre,164,78,86
False,8315033,Eschbach,40 - 45 Jahre,252,150,102
False,8315033,Eschbach,45 - 50 Jahre,238,130,108
False,8315033,Eschbach,50 - 55 Jahre,199,94,105
False,8315033,Eschbach,55 - 60 Jahre,150,86,64
False,8315033,Eschbach,60 - 65 Jahre,118,56,62
False,8315033,Eschbach,65 - 75 Jahre,170,89,81
False,8315033,Eschbach,75 und mehr Jahre,100,43,57
False,8315033,Eschbach,Insgesamt,2416,1231,1185
False,8315037,Feldberg (Schwarzwald),unter 3 Jahre,32,18,14
False,8315037,Feldberg (Schwarzwald),3 -  6 Jahre,39,22,17
False,8315037,Feldberg (Schwarzwald),6 - 10 Jahre,57,28,29
False,8315037,Feldberg (Schwarzwald),10 - 15 Jahre,88,40,48
False,8315037,Feldberg (Schwarzwald),15 - 18 Jahre,51,24,27
False,8315037,Feldberg (Schwarzwald),18 - 20 Jahre,37,20,17
False,8315037,Feldberg (Schwarzwald),20 - 25 Jahre,100,51,49
False,8315037,Feldberg (Schwarzwald),25 - 30 Jahre,90,42,48
False,8315037,Feldberg (Schwarzwald),30 - 35 Jahre,76,31,45
False,8315037,Feldberg (Schwarzwald),35 - 40 Jahre,113,49,64
False,8315037,Feldberg (Schwarzwald),40 - 45 Jahre,169,91,78
False,8315037,Feldberg (Schwarzwald),45 - 50 Jahre,173,96,77
False,8315037,Feldberg (Schwarzwald),50 - 55 Jahre,152,79,73
False,8315037,Feldberg (Schwarzwald),55 - 60 Jahre,143,64,79
False,8315037,Feldberg (Schwarzwald),60 - 65 Jahre,107,56,51
False,8315037,Feldberg (Schwarzwald),65 - 75 Jahre,220,110,110
False,8315037,Feldberg (Schwarzwald),75 und mehr Jahre,194,84,110
False,8315037,Feldberg (Schwarzwald),Insgesamt,1841,905,936
False,8315039,Friedenweiler,unter 3 Jahre,44,22,22
False,8315039,Friedenweiler,3 -  6 Jahre,59,34,25
False,8315039,Friedenweiler,6 - 10 Jahre,71,40,31
False,8315039,Friedenweiler,10 - 15 Jahre,108,55,53
False,8315039,Friedenweiler,15 - 18 Jahre,78,40,38
False,8315039,Friedenweiler,18 - 20 Jahre,50,28,22
False,8315039,Friedenweiler,20 - 25 Jahre,126,71,55
False,8315039,Friedenweiler,25 - 30 Jahre,100,52,48
False,8315039,Friedenweiler,30 - 35 Jahre,79,42,37
False,8315039,Friedenweiler,35 - 40 Jahre,105,57,48
False,8315039,Friedenweiler,40 - 45 Jahre,157,78,79
False,8315039,Friedenweiler,45 - 50 Jahre,178,89,89
False,8315039,Friedenweiler,50 - 55 Jahre,141,69,72
False,8315039,Friedenweiler,55 - 60 Jahre,138,69,69
False,8315039,Friedenweiler,60 - 65 Jahre,111,56,55
False,8315039,Friedenweiler,65 - 75 Jahre,196,86,110
False,8315039,Friedenweiler,75 und mehr Jahre,208,86,122
False,8315039,Friedenweiler,Insgesamt,1949,974,975
False,8315041,Glottertal,unter 3 Jahre,81,49,32
False,8315041,Glottertal,3 -  6 Jahre,102,52,50
False,8315041,Glottertal,6 - 10 Jahre,148,72,76
False,8315041,Glottertal,10 - 15 Jahre,170,85,85
False,8315041,Glottertal,15 - 18 Jahre,105,57,48
False,8315041,Glottertal,18 - 20 Jahre,72,37,35
False,8315041,Glottertal,20 - 25 Jahre,168,80,88
False,8315041,Glottertal,25 - 30 Jahre,157,81,76
False,8315041,Glottertal,30 - 35 Jahre,154,71,83
False,8315041,Glottertal,35 - 40 Jahre,184,85,99
False,8315041,Glottertal,40 - 45 Jahre,275,140,135
False,8315041,Glottertal,45 - 50 Jahre,282,141,141
False,8315041,Glottertal,50 - 55 Jahre,229,122,107
False,8315041,Glottertal,55 - 60 Jahre,188,104,84
False,8315041,Glottertal,60 - 65 Jahre,170,85,85
False,8315041,Glottertal,65 - 75 Jahre,264,137,127
False,8315041,Glottertal,75 und mehr Jahre,276,111,165
False,8315041,Glottertal,Insgesamt,3025,1509,1516
False,8315043,Gottenheim,unter 3 Jahre,89,46,43
False,8315043,Gottenheim,3 -  6 Jahre,89,47,42
False,8315043,Gottenheim,6 - 10 Jahre,107,54,53
False,8315043,Gottenheim,10 - 15 Jahre,125,66,59
False,8315043,Gottenheim,15 - 18 Jahre,96,46,50
False,8315043,Gottenheim,18 - 20 Jahre,60,32,28
False,8315043,Gottenheim,20 - 25 Jahre,176,78,98
False,8315043,Gottenheim,25 - 30 Jahre,127,65,62
False,8315043,Gottenheim,30 - 35 Jahre,161,88,73
False,8315043,Gottenheim,35 - 40 Jahre,176,86,90
False,8315043,Gottenheim,40 - 45 Jahre,219,112,107
False,8315043,Gottenheim,45 - 50 Jahre,218,97,121
False,8315043,Gottenheim,50 - 55 Jahre,209,105,104
False,8315043,Gottenheim,55 - 60 Jahre,173,77,96
False,8315043,Gottenheim,60 - 65 Jahre,131,65,66
False,8315043,Gottenheim,65 - 75 Jahre,215,107,108
False,8315043,Gottenheim,75 und mehr Jahre,237,93,144
False,8315043,Gottenheim,Insgesamt,2608,1264,1344
False,8315047,Gundelfingen,unter 3 Jahre,291,131,160
False,8315047,Gundelfingen,3 -  6 Jahre,324,165,159
False,8315047,Gundelfingen,6 - 10 Jahre,392,208,184
False,8315047,Gundelfingen,10 - 15 Jahre,519,259,260
False,8315047,Gundelfingen,15 - 18 Jahre,316,167,149
False,8315047,Gundelfingen,18 - 20 Jahre,232,133,99
False,8315047,Gundelfingen,20 - 25 Jahre,587,264,323
False,8315047,Gundelfingen,25 - 30 Jahre,648,311,337
False,8315047,Gundelfingen,30 - 35 Jahre,631,318,313
False,8315047,Gundelfingen,35 - 40 Jahre,669,339,330
False,8315047,Gundelfingen,40 - 45 Jahre,939,466,473
False,8315047,Gundelfingen,45 - 50 Jahre,1129,556,573
False,8315047,Gundelfingen,50 - 55 Jahre,908,455,453
False,8315047,Gundelfingen,55 - 60 Jahre,813,371,442
False,8315047,Gundelfingen,60 - 65 Jahre,726,331,395
False,8315047,Gundelfingen,65 - 75 Jahre,1412,661,751
False,8315047,Gundelfingen,75 und mehr Jahre,1104,436,668
False,8315047,Gundelfingen,Insgesamt,11640,5571,6069
False,8315048,Hartheim,unter 3 Jahre,136,65,71
False,8315048,Hartheim,3 -  6 Jahre,152,80,72
False,8315048,Hartheim,6 - 10 Jahre,209,108,101
False,8315048,Hartheim,10 - 15 Jahre,302,163,139
False,8315048,Hartheim,15 - 18 Jahre,164,89,75
False,8315048,Hartheim,18 - 20 Jahre,127,67,60
False,8315048,Hartheim,20 - 25 Jahre,290,161,129
False,8315048,Hartheim,25 - 30 Jahre,309,145,164
False,8315048,Hartheim,30 - 35 Jahre,313,154,159
False,8315048,Hartheim,35 - 40 Jahre,298,145,153
False,8315048,Hartheim,40 - 45 Jahre,362,184,178
False,8315048,Hartheim,45 - 50 Jahre,431,220,211
False,8315048,Hartheim,50 - 55 Jahre,364,190,174
False,8315048,Hartheim,55 - 60 Jahre,339,169,170
False,8315048,Hartheim,60 - 65 Jahre,245,128,117
False,8315048,Hartheim,65 - 75 Jahre,371,195,176
False,8315048,Hartheim,75 und mehr Jahre,233,92,141
False,8315048,Hartheim,Insgesamt,4645,2355,2290
False,8315050,"Heitersheim, Stadt",unter 3 Jahre,136,67,69
False,8315050,"Heitersheim, Stadt",3 -  6 Jahre,169,77,92
False,8315050,"Heitersheim, Stadt",6 - 10 Jahre,250,141,109
False,8315050,"Heitersheim, Stadt",10 - 15 Jahre,355,180,175
False,8315050,"Heitersheim, Stadt",15 - 18 Jahre,236,127,109
False,8315050,"Heitersheim, Stadt",18 - 20 Jahre,144,62,82
False,8315050,"Heitersheim, Stadt",20 - 25 Jahre,332,173,159
False,8315050,"Heitersheim, Stadt",25 - 30 Jahre,335,158,177
False,8315050,"Heitersheim, Stadt",30 - 35 Jahre,293,146,147
False,8315050,"Heitersheim, Stadt",35 - 40 Jahre,403,189,214
False,8315050,"Heitersheim, Stadt",40 - 45 Jahre,537,273,264
False,8315050,"Heitersheim, Stadt",45 - 50 Jahre,530,256,274
False,8315050,"Heitersheim, Stadt",50 - 55 Jahre,486,243,243
False,8315050,"Heitersheim, Stadt",55 - 60 Jahre,373,183,190
False,8315050,"Heitersheim, Stadt",60 - 65 Jahre,330,156,174
False,8315050,"Heitersheim, Stadt",65 - 75 Jahre,612,306,306
False,8315050,"Heitersheim, Stadt",75 und mehr Jahre,497,182,315
False,8315050,"Heitersheim, Stadt",Insgesamt,6018,2919,3099
False,8315051,Heuweiler,unter 3 Jahre,28,15,13
False,8315051,Heuweiler,3 -  6 Jahre,29,19,10
False,8315051,Heuweiler,6 - 10 Jahre,40,21,19
False,8315051,Heuweiler,10 - 15 Jahre,52,29,23
False,8315051,Heuweiler,15 - 18 Jahre,37,17,20
False,8315051,Heuweiler,18 - 20 Jahre,21,11,10
False,8315051,Heuweiler,20 - 25 Jahre,61,24,37
False,8315051,Heuweiler,25 - 30 Jahre,42,23,19
False,8315051,Heuweiler,30 - 35 Jahre,53,29,24
False,8315051,Heuweiler,35 - 40 Jahre,63,29,34
False,8315051,Heuweiler,40 - 45 Jahre,119,60,59
False,8315051,Heuweiler,45 - 50 Jahre,99,50,49
False,8315051,Heuweiler,50 - 55 Jahre,94,39,55
False,8315051,Heuweiler,55 - 60 Jahre,82,41,41
False,8315051,Heuweiler,60 - 65 Jahre,60,37,23
False,8315051,Heuweiler,65 - 75 Jahre,97,47,50
False,8315051,Heuweiler,75 und mehr Jahre,90,37,53
False,8315051,Heuweiler,Insgesamt,1067,528,539
False,8315052,Hinterzarten,unter 3 Jahre,45,26,19
False,8315052,Hinterzarten,3 -  6 Jahre,55,34,21
False,8315052,Hinterzarten,6 - 10 Jahre,87,45,42
False,8315052,Hinterzarten,10 - 15 Jahre,106,47,59
False,8315052,Hinterzarten,15 - 18 Jahre,82,44,38
False,8315052,Hinterzarten,18 - 20 Jahre,88,31,57
False,8315052,Hinterzarten,20 - 25 Jahre,159,85,74
False,8315052,Hinterzarten,25 - 30 Jahre,136,57,79
False,8315052,Hinterzarten,30 - 35 Jahre,146,69,77
False,8315052,Hinterzarten,35 - 40 Jahre,198,85,113
False,8315052,Hinterzarten,40 - 45 Jahre,237,103,134
False,8315052,Hinterzarten,45 - 50 Jahre,202,94,108
False,8315052,Hinterzarten,50 - 55 Jahre,177,83,94
False,8315052,Hinterzarten,55 - 60 Jahre,136,56,80
False,8315052,Hinterzarten,60 - 65 Jahre,169,80,89
False,8315052,Hinterzarten,65 - 75 Jahre,346,160,186
False,8315052,Hinterzarten,75 und mehr Jahre,258,108,150
False,8315052,Hinterzarten,Insgesamt,2627,1207,1420
False,8315056,Horben,unter 3 Jahre,29,14,15
False,8315056,Horben,3 -  6 Jahre,31,18,13
False,8315056,Horben,6 - 10 Jahre,38,13,25
False,8315056,Horben,10 - 15 Jahre,56,34,22
False,8315056,Horben,15 - 18 Jahre,44,22,22
False,8315056,Horben,18 - 20 Jahre,27,14,13
False,8315056,Horben,20 - 25 Jahre,57,28,29
False,8315056,Horben,25 - 30 Jahre,35,19,16
False,8315056,Horben,30 - 35 Jahre,54,26,28
False,8315056,Horben,35 - 40 Jahre,81,40,41
False,8315056,Horben,40 - 45 Jahre,101,51,50
False,8315056,Horben,45 - 50 Jahre,118,54,64
False,8315056,Horben,50 - 55 Jahre,100,58,42
False,8315056,Horben,55 - 60 Jahre,57,29,28
False,8315056,Horben,60 - 65 Jahre,58,32,26
False,8315056,Horben,65 - 75 Jahre,136,66,70
False,8315056,Horben,75 und mehr Jahre,78,35,43
False,8315056,Horben,Insgesamt,1100,553,547
False,8315059,Ihringen,unter 3 Jahre,145,79,66
False,8315059,Ihringen,3 -  6 Jahre,166,77,89
False,8315059,Ihringen,6 - 10 Jahre,220,116,104
False,8315059,Ihringen,10 - 15 Jahre,305,150,155
False,8315059,Ihringen,15 - 18 Jahre,193,99,94
False,8315059,Ihringen,18 - 20 Jahre,156,78,78
False,8315059,Ihringen,20 - 25 Jahre,365,175,190
False,8315059,Ihringen,25 - 30 Jahre,336,164,172
False,8315059,Ihringen,30 - 35 Jahre,312,150,162
False,8315059,Ihringen,35 - 40 Jahre,351,190,161
False,8315059,Ihringen,40 - 45 Jahre,522,242,280
False,8315059,Ihringen,45 - 50 Jahre,529,259,270
False,8315059,Ihringen,50 - 55 Jahre,494,254,240
False,8315059,Ihringen,55 - 60 Jahre,417,216,201
False,8315059,Ihringen,60 - 65 Jahre,295,148,147
False,8315059,Ihringen,65 - 75 Jahre,634,292,342
False,8315059,Ihringen,75 und mehr Jahre,472,201,271
False,8315059,Ihringen,Insgesamt,5912,2890,3022
False,8315064,Kirchzarten,unter 3 Jahre,236,126,110
False,8315064,Kirchzarten,3 -  6 Jahre,251,113,138
False,8315064,Kirchzarten,6 - 10 Jahre,395,210,185
False,8315064,Kirchzarten,10 - 15 Jahre,586,288,298
False,8315064,Kirchzarten,15 - 18 Jahre,298,153,145
False,8315064,Kirchzarten,18 - 20 Jahre,225,126,99
False,8315064,Kirchzarten,20 - 25 Jahre,489,233,256
False,8315064,Kirchzarten,25 - 30 Jahre,411,212,199
False,8315064,Kirchzarten,30 - 35 Jahre,465,221,244
False,8315064,Kirchzarten,35 - 40 Jahre,537,267,270
False,8315064,Kirchzarten,40 - 45 Jahre,804,381,423
False,8315064,Kirchzarten,45 - 50 Jahre,822,396,426
False,8315064,Kirchzarten,50 - 55 Jahre,767,380,387
False,8315064,Kirchzarten,55 - 60 Jahre,635,282,353
False,8315064,Kirchzarten,60 - 65 Jahre,542,245,297
False,8315064,Kirchzarten,65 - 75 Jahre,1326,603,723
False,8315064,Kirchzarten,75 und mehr Jahre,981,389,592
False,8315064,Kirchzarten,Insgesamt,9770,4625,5145
False,8315068,Lenzkirch,unter 3 Jahre,126,71,55
False,8315068,Lenzkirch,3 -  6 Jahre,131,72,59
False,8315068,Lenzkirch,6 - 10 Jahre,188,102,86
False,8315068,Lenzkirch,10 - 15 Jahre,243,120,123
False,8315068,Lenzkirch,15 - 18 Jahre,130,72,58
False,8315068,Lenzkirch,18 - 20 Jahre,90,50,40
False,8315068,Lenzkirch,20 - 25 Jahre,257,126,131
False,8315068,Lenzkirch,25 - 30 Jahre,288,132,156
False,8315068,Lenzkirch,30 - 35 Jahre,250,128,122
False,8315068,Lenzkirch,35 - 40 Jahre,282,136,146
False,8315068,Lenzkirch,40 - 45 Jahre,423,182,241
False,8315068,Lenzkirch,45 - 50 Jahre,399,230,169
False,8315068,Lenzkirch,50 - 55 Jahre,376,200,176
False,8315068,Lenzkirch,55 - 60 Jahre,346,177,169
False,8315068,Lenzkirch,60 - 65 Jahre,310,150,160
False,8315068,Lenzkirch,65 - 75 Jahre,616,289,327
False,8315068,Lenzkirch,75 und mehr Jahre,578,219,359
False,8315068,Lenzkirch,Insgesamt,5033,2456,2577
False,8315070,"Löffingen, Stadt",unter 3 Jahre,212,94,118
False,8315070,"Löffingen, Stadt",3 -  6 Jahre,210,106,104
False,8315070,"Löffingen, Stadt",6 - 10 Jahre,351,181,170
False,8315070,"Löffingen, Stadt",10 - 15 Jahre,473,255,218
False,8315070,"Löffingen, Stadt",15 - 18 Jahre,259,137,122
False,8315070,"Löffingen, Stadt",18 - 20 Jahre,200,106,94
False,8315070,"Löffingen, Stadt",20 - 25 Jahre,465,232,233
False,8315070,"Löffingen, Stadt",25 - 30 Jahre,416,227,189
False,8315070,"Löffingen, Stadt",30 - 35 Jahre,391,198,193
False,8315070,"Löffingen, Stadt",35 - 40 Jahre,436,216,220
False,8315070,"Löffingen, Stadt",40 - 45 Jahre,643,328,315
False,8315070,"Löffingen, Stadt",45 - 50 Jahre,631,332,299
False,8315070,"Löffingen, Stadt",50 - 55 Jahre,582,279,303
False,8315070,"Löffingen, Stadt",55 - 60 Jahre,541,271,270
False,8315070,"Löffingen, Stadt",60 - 65 Jahre,391,198,193
False,8315070,"Löffingen, Stadt",65 - 75 Jahre,769,383,386
False,8315070,"Löffingen, Stadt",75 und mehr Jahre,687,279,408
False,8315070,"Löffingen, Stadt",Insgesamt,7657,3822,3835
False,8315072,Merdingen,unter 3 Jahre,76,32,44
False,8315072,Merdingen,3 -  6 Jahre,71,27,44
False,8315072,Merdingen,6 - 10 Jahre,113,48,65
False,8315072,Merdingen,10 - 15 Jahre,151,82,69
False,8315072,Merdingen,15 - 18 Jahre,88,38,50
False,8315072,Merdingen,18 - 20 Jahre,51,27,24
False,8315072,Merdingen,20 - 25 Jahre,145,59,86
False,8315072,Merdingen,25 - 30 Jahre,145,69,76
False,8315072,Merdingen,30 - 35 Jahre,119,62,57
False,8315072,Merdingen,35 - 40 Jahre,181,88,93
False,8315072,Merdingen,40 - 45 Jahre,220,114,106
False,8315072,Merdingen,45 - 50 Jahre,272,141,131
False,8315072,Merdingen,50 - 55 Jahre,199,95,104
False,8315072,Merdingen,55 - 60 Jahre,188,89,99
False,8315072,Merdingen,60 - 65 Jahre,140,69,71
False,8315072,Merdingen,65 - 75 Jahre,227,118,109
False,8315072,Merdingen,75 und mehr Jahre,172,72,100
False,8315072,Merdingen,Insgesamt,2558,1230,1328
False,8315073,Merzhausen,unter 3 Jahre,146,84,62
False,8315073,Merzhausen,3 -  6 Jahre,113,72,41
False,8315073,Merzhausen,6 - 10 Jahre,149,67,82
False,8315073,Merzhausen,10 - 15 Jahre,204,118,86
False,8315073,Merzhausen,15 - 18 Jahre,136,68,68
False,8315073,Merzhausen,18 - 20 Jahre,76,41,35
False,8315073,Merzhausen,20 - 25 Jahre,227,105,122
False,8315073,Merzhausen,25 - 30 Jahre,250,124,126
False,8315073,Merzhausen,30 - 35 Jahre,267,107,160
False,8315073,Merzhausen,35 - 40 Jahre,295,141,154
False,8315073,Merzhausen,40 - 45 Jahre,387,202,185
False,8315073,Merzhausen,45 - 50 Jahre,415,183,232
False,8315073,Merzhausen,50 - 55 Jahre,327,176,151
False,8315073,Merzhausen,55 - 60 Jahre,273,106,167
False,8315073,Merzhausen,60 - 65 Jahre,317,136,181
False,8315073,Merzhausen,65 - 75 Jahre,741,318,423
False,8315073,Merzhausen,75 und mehr Jahre,501,215,286
False,8315073,Merzhausen,Insgesamt,4824,2263,2561
False,8315074,"Müllheim, Stadt",unter 3 Jahre,443,223,220
False,8315074,"Müllheim, Stadt",3 -  6 Jahre,462,244,218
False,8315074,"Müllheim, Stadt",6 - 10 Jahre,719,373,346
False,8315074,"Müllheim, Stadt",10 - 15 Jahre,1032,563,469
False,8315074,"Müllheim, Stadt",15 - 18 Jahre,683,353,330
False,8315074,"Müllheim, Stadt",18 - 20 Jahre,461,235,226
False,8315074,"Müllheim, Stadt",20 - 25 Jahre,1127,578,549
False,8315074,"Müllheim, Stadt",25 - 30 Jahre,978,489,489
False,8315074,"Müllheim, Stadt",30 - 35 Jahre,942,460,482
False,8315074,"Müllheim, Stadt",35 - 40 Jahre,1066,500,566
False,8315074,"Müllheim, Stadt",40 - 45 Jahre,1468,694,774
False,8315074,"Müllheim, Stadt",45 - 50 Jahre,1552,743,809
False,8315074,"Müllheim, Stadt",50 - 55 Jahre,1365,669,696
False,8315074,"Müllheim, Stadt",55 - 60 Jahre,1185,563,622
False,8315074,"Müllheim, Stadt",60 - 65 Jahre,1004,477,527
False,8315074,"Müllheim, Stadt",65 - 75 Jahre,2043,949,1094
False,8315074,"Müllheim, Stadt",75 und mehr Jahre,1840,685,1155
False,8315074,"Müllheim, Stadt",Insgesamt,18370,8798,9572
False,8315076,"Neuenburg am Rhein, Stadt",unter 3 Jahre,308,170,138
False,8315076,"Neuenburg am Rhein, Stadt",3 -  6 Jahre,341,169,172
False,8315076,"Neuenburg am Rhein, Stadt",6 - 10 Jahre,508,284,224
False,8315076,"Neuenburg am Rhein, Stadt",10 - 15 Jahre,749,408,341
False,8315076,"Neuenburg am Rhein, Stadt",15 - 18 Jahre,460,245,215
False,8315076,"Neuenburg am Rhein, Stadt",18 - 20 Jahre,351,170,181
False,8315076,"Neuenburg am Rhein, Stadt",20 - 25 Jahre,683,350,333
False,8315076,"Neuenburg am Rhein, Stadt",25 - 30 Jahre,700,345,355
False,8315076,"Neuenburg am Rhein, Stadt",30 - 35 Jahre,679,325,354
False,8315076,"Neuenburg am Rhein, Stadt",35 - 40 Jahre,759,346,413
False,8315076,"Neuenburg am Rhein, Stadt",40 - 45 Jahre,1078,543,535
False,8315076,"Neuenburg am Rhein, Stadt",45 - 50 Jahre,1091,570,521
False,8315076,"Neuenburg am Rhein, Stadt",50 - 55 Jahre,928,477,451
False,8315076,"Neuenburg am Rhein, Stadt",55 - 60 Jahre,786,404,382
False,8315076,"Neuenburg am Rhein, Stadt",60 - 65 Jahre,637,329,308
False,8315076,"Neuenburg am Rhein, Stadt",65 - 75 Jahre,1136,549,587
False,8315076,"Neuenburg am Rhein, Stadt",75 und mehr Jahre,834,328,506
False,8315076,"Neuenburg am Rhein, Stadt",Insgesamt,12028,6012,6016
False,8315084,Oberried,unter 3 Jahre,71,33,38
False,8315084,Oberried,3 -  6 Jahre,73,36,37
False,8315084,Oberried,6 - 10 Jahre,139,79,60
False,8315084,Oberried,10 - 15 Jahre,205,94,111
False,8315084,Oberried,15 - 18 Jahre,125,70,55
False,8315084,Oberried,18 - 20 Jahre,80,45,35
False,8315084,Oberried,20 - 25 Jahre,153,78,75
False,8315084,Oberried,25 - 30 Jahre,122,54,68
False,8315084,Oberried,30 - 35 Jahre,140,73,67
False,8315084,Oberried,35 - 40 Jahre,184,90,94
False,8315084,Oberried,40 - 45 Jahre,254,116,138
False,8315084,Oberried,45 - 50 Jahre,273,148,125
False,8315084,Oberried,50 - 55 Jahre,200,112,88
False,8315084,Oberried,55 - 60 Jahre,172,91,81
False,8315084,Oberried,60 - 65 Jahre,139,68,71
False,8315084,Oberried,65 - 75 Jahre,294,143,151
False,8315084,Oberried,75 und mehr Jahre,191,93,98
False,8315084,Oberried,Insgesamt,2815,1423,1392
False,8315089,Pfaffenweiler,unter 3 Jahre,59,20,39
False,8315089,Pfaffenweiler,3 -  6 Jahre,84,35,49
False,8315089,Pfaffenweiler,6 - 10 Jahre,111,64,47
False,8315089,Pfaffenweiler,10 - 15 Jahre,140,73,67
False,8315089,Pfaffenweiler,15 - 18 Jahre,64,27,37
False,8315089,Pfaffenweiler,18 - 20 Jahre,62,35,27
False,8315089,Pfaffenweiler,20 - 25 Jahre,136,71,65
False,8315089,Pfaffenweiler,25 - 30 Jahre,128,64,64
False,8315089,Pfaffenweiler,30 - 35 Jahre,130,56,74
False,8315089,Pfaffenweiler,35 - 40 Jahre,142,59,83
False,8315089,Pfaffenweiler,40 - 45 Jahre,209,101,108
False,8315089,Pfaffenweiler,45 - 50 Jahre,207,110,97
False,8315089,Pfaffenweiler,50 - 55 Jahre,205,96,109
False,8315089,Pfaffenweiler,55 - 60 Jahre,168,77,91
False,8315089,Pfaffenweiler,60 - 65 Jahre,170,92,78
False,8315089,Pfaffenweiler,65 - 75 Jahre,311,141,170
False,8315089,Pfaffenweiler,75 und mehr Jahre,176,81,95
False,8315089,Pfaffenweiler,Insgesamt,2502,1202,1300
False,8315094,St. Märgen,unter 3 Jahre,69,32,37
False,8315094,St. Märgen,3 -  6 Jahre,71,36,35
False,8315094,St. Märgen,6 - 10 Jahre,102,59,43
False,8315094,St. Märgen,10 - 15 Jahre,115,64,51
False,8315094,St. Märgen,15 - 18 Jahre,80,42,38
False,8315094,St. Märgen,18 - 20 Jahre,52,24,28
False,8315094,St. Märgen,20 - 25 Jahre,88,52,36
False,8315094,St. Märgen,25 - 30 Jahre,93,48,45
False,8315094,St. Märgen,30 - 35 Jahre,99,41,58
False,8315094,St. Märgen,35 - 40 Jahre,107,54,53
False,8315094,St. Märgen,40 - 45 Jahre,147,81,66
False,8315094,St. Märgen,45 - 50 Jahre,166,83,83
False,8315094,St. Märgen,50 - 55 Jahre,128,72,56
False,8315094,St. Märgen,55 - 60 Jahre,110,63,47
False,8315094,St. Märgen,60 - 65 Jahre,95,46,49
False,8315094,St. Märgen,65 - 75 Jahre,190,88,102
False,8315094,St. Märgen,75 und mehr Jahre,173,69,104
False,8315094,St. Märgen,Insgesamt,1885,954,931
False,8315095,St. Peter,unter 3 Jahre,85,46,39
False,8315095,St. Peter,3 -  6 Jahre,79,36,43
False,8315095,St. Peter,6 - 10 Jahre,112,64,48
False,8315095,St. Peter,10 - 15 Jahre,169,72,97
False,8315095,St. Peter,15 - 18 Jahre,102,55,47
False,8315095,St. Peter,18 - 20 Jahre,65,47,18
False,8315095,St. Peter,20 - 25 Jahre,155,81,74
False,8315095,St. Peter,25 - 30 Jahre,111,62,49
False,8315095,St. Peter,30 - 35 Jahre,122,58,64
False,8315095,St. Peter,35 - 40 Jahre,145,69,76
False,8315095,St. Peter,40 - 45 Jahre,194,98,96
False,8315095,St. Peter,45 - 50 Jahre,230,130,100
False,8315095,St. Peter,50 - 55 Jahre,200,107,93
False,8315095,St. Peter,55 - 60 Jahre,138,79,59
False,8315095,St. Peter,60 - 65 Jahre,142,66,76
False,8315095,St. Peter,65 - 75 Jahre,277,127,150
False,8315095,St. Peter,75 und mehr Jahre,221,114,107
False,8315095,St. Peter,Insgesamt,2547,1311,1236
False,8315098,Schallstadt,unter 3 Jahre,167,78,89
False,8315098,Schallstadt,3 -  6 Jahre,171,74,97
False,8315098,Schallstadt,6 - 10 Jahre,215,109,106
False,8315098,Schallstadt,10 - 15 Jahre,327,185,142
False,8315098,Schallstadt,15 - 18 Jahre,211,101,110
False,8315098,Schallstadt,18 - 20 Jahre,156,79,77
False,8315098,Schallstadt,20 - 25 Jahre,341,157,184
False,8315098,Schallstadt,25 - 30 Jahre,301,145,156
False,8315098,Schallstadt,30 - 35 Jahre,324,157,167
False,8315098,Schallstadt,35 - 40 Jahre,353,159,194
False,8315098,Schallstadt,40 - 45 Jahre,510,246,264
False,8315098,Schallstadt,45 - 50 Jahre,545,260,285
False,8315098,Schallstadt,50 - 55 Jahre,484,233,251
False,8315098,Schallstadt,55 - 60 Jahre,416,207,209
False,8315098,Schallstadt,60 - 65 Jahre,385,179,206
False,8315098,Schallstadt,65 - 75 Jahre,658,341,317
False,8315098,Schallstadt,75 und mehr Jahre,449,190,259
False,8315098,Schallstadt,Insgesamt,6013,2900,3113
False,8315102,Schluchsee,unter 3 Jahre,49,25,24
False,8315102,Schluchsee,3 -  6 Jahre,46,22,24
False,8315102,Schluchsee,6 - 10 Jahre,64,40,24
False,8315102,Schluchsee,10 - 15 Jahre,80,43,37
False,8315102,Schluchsee,15 - 18 Jahre,66,30,36
False,8315102,Schluchsee,18 - 20 Jahre,55,31,24
False,8315102,Schluchsee,20 - 25 Jahre,125,58,67
False,8315102,Schluchsee,25 - 30 Jahre,162,81,81
False,8315102,Schluchsee,30 - 35 Jahre,150,74,76
False,8315102,Schluchsee,35 - 40 Jahre,149,77,72
False,8315102,Schluchsee,40 - 45 Jahre,252,117,135
False,8315102,Schluchsee,45 - 50 Jahre,175,86,89
False,8315102,Schluchsee,50 - 55 Jahre,202,118,84
False,8315102,Schluchsee,55 - 60 Jahre,168,71,97
False,8315102,Schluchsee,60 - 65 Jahre,171,79,92
False,8315102,Schluchsee,65 - 75 Jahre,354,179,175
False,8315102,Schluchsee,75 und mehr Jahre,270,117,153
False,8315102,Schluchsee,Insgesamt,2538,1248,1290
False,8315107,Sölden,unter 3 Jahre,28,16,12
False,8315107,Sölden,3 -  6 Jahre,27,11,16
False,8315107,Sölden,6 - 10 Jahre,51,24,27
False,8315107,Sölden,10 - 15 Jahre,72,34,38
False,8315107,Sölden,15 - 18 Jahre,43,20,23
False,8315107,Sölden,18 - 20 Jahre,25,14,11
False,8315107,Sölden,20 - 25 Jahre,65,35,30
False,8315107,Sölden,25 - 30 Jahre,59,33,26
False,8315107,Sölden,30 - 35 Jahre,52,22,30
False,8315107,Sölden,35 - 40 Jahre,69,35,34
False,8315107,Sölden,40 - 45 Jahre,70,35,35
False,8315107,Sölden,45 - 50 Jahre,87,40,47
False,8315107,Sölden,50 - 55 Jahre,128,58,70
False,8315107,Sölden,55 - 60 Jahre,93,45,48
False,8315107,Sölden,60 - 65 Jahre,77,39,38
False,8315107,Sölden,65 - 75 Jahre,129,52,77
False,8315107,Sölden,75 und mehr Jahre,92,43,49
False,8315107,Sölden,Insgesamt,1167,556,611
False,8315108,"Staufen im Breisgau, Stadt",unter 3 Jahre,174,84,90
False,8315108,"Staufen im Breisgau, Stadt",3 -  6 Jahre,165,76,89
False,8315108,"Staufen im Breisgau, Stadt",6 - 10 Jahre,270,139,131
False,8315108,"Staufen im Breisgau, Stadt",10 - 15 Jahre,362,182,180
False,8315108,"Staufen im Breisgau, Stadt",15 - 18 Jahre,259,128,131
False,8315108,"Staufen im Breisgau, Stadt",18 - 20 Jahre,161,89,72
False,8315108,"Staufen im Breisgau, Stadt",20 - 25 Jahre,358,186,172
False,8315108,"Staufen im Breisgau, Stadt",25 - 30 Jahre,258,137,121
False,8315108,"Staufen im Breisgau, Stadt",30 - 35 Jahre,320,154,166
False,8315108,"Staufen im Breisgau, Stadt",35 - 40 Jahre,355,162,193
False,8315108,"Staufen im Breisgau, Stadt",40 - 45 Jahre,659,309,350
False,8315108,"Staufen im Breisgau, Stadt",45 - 50 Jahre,661,302,359
False,8315108,"Staufen im Breisgau, Stadt",50 - 55 Jahre,596,265,331
False,8315108,"Staufen im Breisgau, Stadt",55 - 60 Jahre,572,273,299
False,8315108,"Staufen im Breisgau, Stadt",60 - 65 Jahre,540,256,284
False,8315108,"Staufen im Breisgau, Stadt",65 - 75 Jahre,999,483,516
False,8315108,"Staufen im Breisgau, Stadt",75 und mehr Jahre,919,319,600
False,8315108,"Staufen im Breisgau, Stadt",Insgesamt,7628,3544,4084
False,8315109,Stegen,unter 3 Jahre,107,57,50
False,8315109,Stegen,3 -  6 Jahre,129,72,57
False,8315109,Stegen,6 - 10 Jahre,186,102,84
False,8315109,Stegen,10 - 15 Jahre,276,146,130
False,8315109,Stegen,15 - 18 Jahre,180,105,75
False,8315109,Stegen,18 - 20 Jahre,112,55,57
False,8315109,Stegen,20 - 25 Jahre,264,135,129
False,8315109,Stegen,25 - 30 Jahre,214,111,103
False,8315109,Stegen,30 - 35 Jahre,199,73,126
False,8315109,Stegen,35 - 40 Jahre,211,89,122
False,8315109,Stegen,40 - 45 Jahre,309,149,160
False,8315109,Stegen,45 - 50 Jahre,389,178,211
False,8315109,Stegen,50 - 55 Jahre,330,159,171
False,8315109,Stegen,55 - 60 Jahre,284,131,153
False,8315109,Stegen,60 - 65 Jahre,215,104,111
False,8315109,Stegen,65 - 75 Jahre,522,233,289
False,8315109,Stegen,75 und mehr Jahre,384,178,206
False,8315109,Stegen,Insgesamt,4311,2077,2234
False,8315111,"Sulzburg, Stadt",unter 3 Jahre,61,37,24
False,8315111,"Sulzburg, Stadt",3 -  6 Jahre,75,40,35
False,8315111,"Sulzburg, Stadt",6 - 10 Jahre,109,44,65
False,8315111,"Sulzburg, Stadt",10 - 15 Jahre,179,90,89
False,8315111,"Sulzburg, Stadt",15 - 18 Jahre,103,52,51
False,8315111,"Sulzburg, Stadt",18 - 20 Jahre,79,47,32
False,8315111,"Sulzburg, Stadt",20 - 25 Jahre,121,56,65
False,8315111,"Sulzburg, Stadt",25 - 30 Jahre,127,54,73
False,8315111,"Sulzburg, Stadt",30 - 35 Jahre,114,56,58
False,8315111,"Sulzburg, Stadt",35 - 40 Jahre,132,62,70
False,8315111,"Sulzburg, Stadt",40 - 45 Jahre,254,104,150
False,8315111,"Sulzburg, Stadt",45 - 50 Jahre,247,130,117
False,8315111,"Sulzburg, Stadt",50 - 55 Jahre,208,102,106
False,8315111,"Sulzburg, Stadt",55 - 60 Jahre,194,99,95
False,8315111,"Sulzburg, Stadt",60 - 65 Jahre,163,75,88
False,8315111,"Sulzburg, Stadt",65 - 75 Jahre,320,152,168
False,8315111,"Sulzburg, Stadt",75 und mehr Jahre,256,96,160
False,8315111,"Sulzburg, Stadt",Insgesamt,2742,1296,1446
False,8315113,"Titisee-Neustadt, Stadt",unter 3 Jahre,326,172,154
False,8315113,"Titisee-Neustadt, Stadt",3 -  6 Jahre,316,174,142
False,8315113,"Titisee-Neustadt, Stadt",6 - 10 Jahre,470,249,221
False,8315113,"Titisee-Neustadt, Stadt",10 - 15 Jahre,595,319,276
False,8315113,"Titisee-Neustadt, Stadt",15 - 18 Jahre,403,213,190
False,8315113,"Titisee-Neustadt, Stadt",18 - 20 Jahre,287,121,166
False,8315113,"Titisee-Neustadt, Stadt",20 - 25 Jahre,696,348,348
False,8315113,"Titisee-Neustadt, Stadt",25 - 30 Jahre,711,360,351
False,8315113,"Titisee-Neustadt, Stadt",30 - 35 Jahre,703,333,370
False,8315113,"Titisee-Neustadt, Stadt",35 - 40 Jahre,729,354,375
False,8315113,"Titisee-Neustadt, Stadt",40 - 45 Jahre,921,495,426
False,8315113,"Titisee-Neustadt, Stadt",45 - 50 Jahre,883,424,459
False,8315113,"Titisee-Neustadt, Stadt",50 - 55 Jahre,870,426,444
False,8315113,"Titisee-Neustadt, Stadt",55 - 60 Jahre,832,433,399
False,8315113,"Titisee-Neustadt, Stadt",60 - 65 Jahre,664,333,331
False,8315113,"Titisee-Neustadt, Stadt",65 - 75 Jahre,1225,584,641
False,8315113,"Titisee-Neustadt, Stadt",75 und mehr Jahre,1225,487,738
False,8315113,"Titisee-Neustadt, Stadt",Insgesamt,11856,5825,6031
False,8315115,Umkirch,unter 3 Jahre,132,81,51
False,8315115,Umkirch,3 -  6 Jahre,136,69,67
False,8315115,Umkirch,6 - 10 Jahre,190,100,90
False,8315115,Umkirch,10 - 15 Jahre,254,145,109
False,8315115,Umkirch,15 - 18 Jahre,173,97,76
False,8315115,Umkirch,18 - 20 Jahre,134,62,72
False,8315115,Umkirch,20 - 25 Jahre,343,189,154
False,8315115,Umkirch,25 - 30 Jahre,304,159,145
False,8315115,Umkirch,30 - 35 Jahre,296,133,163
False,8315115,Umkirch,35 - 40 Jahre,267,135,132
False,8315115,Umkirch,40 - 45 Jahre,358,182,176
False,8315115,Umkirch,45 - 50 Jahre,453,221,232
False,8315115,Umkirch,50 - 55 Jahre,404,211,193
False,8315115,Umkirch,55 - 60 Jahre,383,177,206
False,8315115,Umkirch,60 - 65 Jahre,327,161,166
False,8315115,Umkirch,65 - 75 Jahre,669,322,347
False,8315115,Umkirch,75 und mehr Jahre,394,169,225
False,8315115,Umkirch,Insgesamt,5217,2613,2604
False,8315125,Wittnau,unter 3 Jahre,36,18,18
False,8315125,Wittnau,3 -  6 Jahre,36,20,16
False,8315125,Wittnau,6 - 10 Jahre,46,28,18
False,8315125,Wittnau,10 - 15 Jahre,82,44,38
False,8315125,Wittnau,15 - 18 Jahre,53,28,25
False,8315125,Wittnau,18 - 20 Jahre,47,23,24
False,8315125,Wittnau,20 - 25 Jahre,96,56,40
False,8315125,Wittnau,25 - 30 Jahre,68,35,33
False,8315125,Wittnau,30 - 35 Jahre,57,29,28
False,8315125,Wittnau,35 - 40 Jahre,61,22,39
False,8315125,Wittnau,40 - 45 Jahre,115,52,63
False,8315125,Wittnau,45 - 50 Jahre,140,66,74
False,8315125,Wittnau,50 - 55 Jahre,134,75,59
False,8315125,Wittnau,55 - 60 Jahre,113,55,58
False,8315125,Wittnau,60 - 65 Jahre,84,39,45
False,8315125,Wittnau,65 - 75 Jahre,175,91,84
False,8315125,Wittnau,75 und mehr Jahre,118,52,66
False,8315125,Wittnau,Insgesamt,1461,733,728
False,8315130,Münstertal/Schwarzwald,unter 3 Jahre,118,64,54
False,8315130,Münstertal/Schwarzwald,3 -  6 Jahre,138,79,59
False,8315130,Münstertal/Schwarzwald,6 - 10 Jahre,193,97,96
False,8315130,Münstertal/Schwarzwald,10 - 15 Jahre,291,154,137
False,8315130,Münstertal/Schwarzwald,15 - 18 Jahre,216,115,101
False,8315130,Münstertal/Schwarzwald,18 - 20 Jahre,130,64,66
False,8315130,Münstertal/Schwarzwald,20 - 25 Jahre,277,145,132
False,8315130,Münstertal/Schwarzwald,25 - 30 Jahre,254,141,113
False,8315130,Münstertal/Schwarzwald,30 - 35 Jahre,250,119,131
False,8315130,Münstertal/Schwarzwald,35 - 40 Jahre,258,124,134
False,8315130,Münstertal/Schwarzwald,40 - 45 Jahre,446,219,227
False,8315130,Münstertal/Schwarzwald,45 - 50 Jahre,485,243,242
False,8315130,Münstertal/Schwarzwald,50 - 55 Jahre,362,182,180
False,8315130,Münstertal/Schwarzwald,55 - 60 Jahre,359,178,181
False,8315130,Münstertal/Schwarzwald,60 - 65 Jahre,264,146,118
False,8315130,Münstertal/Schwarzwald,65 - 75 Jahre,605,285,320
False,8315130,Münstertal/Schwarzwald,75 und mehr Jahre,509,205,304
False,8315130,Münstertal/Schwarzwald,Insgesamt,5155,2560,2595
False,8315131,Ehrenkirchen,unter 3 Jahre,179,100,79
False,8315131,Ehrenkirchen,3 -  6 Jahre,209,96,113
False,8315131,Ehrenkirchen,6 - 10 Jahre,328,170,158
False,8315131,Ehrenkirchen,10 - 15 Jahre,447,251,196
False,8315131,Ehrenkirchen,15 - 18 Jahre,282,142,140
False,8315131,Ehrenkirchen,18 - 20 Jahre,177,96,81
False,8315131,Ehrenkirchen,20 - 25 Jahre,396,208,188
False,8315131,Ehrenkirchen,25 - 30 Jahre,353,164,189
False,8315131,Ehrenkirchen,30 - 35 Jahre,387,206,181
False,8315131,Ehrenkirchen,35 - 40 Jahre,438,206,232
False,8315131,Ehrenkirchen,40 - 45 Jahre,684,313,371
False,8315131,Ehrenkirchen,45 - 50 Jahre,699,362,337
False,8315131,Ehrenkirchen,50 - 55 Jahre,610,321,289
False,8315131,Ehrenkirchen,55 - 60 Jahre,405,196,209
False,8315131,Ehrenkirchen,60 - 65 Jahre,357,189,168
False,8315131,Ehrenkirchen,65 - 75 Jahre,770,367,403
False,8315131,Ehrenkirchen,75 und mehr Jahre,549,231,318
False,8315131,Ehrenkirchen,Insgesamt,7270,3618,3652
False,8315132,March,unter 3 Jahre,264,150,114
False,8315132,March,3 -  6 Jahre,210,113,97
False,8315132,March,6 - 10 Jahre,291,142,149
False,8315132,March,10 - 15 Jahre,430,241,189
False,8315132,March,15 - 18 Jahre,306,166,140
False,8315132,March,18 - 20 Jahre,208,120,88
False,8315132,March,20 - 25 Jahre,548,280,268
False,8315132,March,25 - 30 Jahre,532,270,262
False,8315132,March,30 - 35 Jahre,491,233,258
False,8315132,March,35 - 40 Jahre,492,236,256
False,8315132,March,40 - 45 Jahre,693,354,339
False,8315132,March,45 - 50 Jahre,850,439,411
False,8315132,March,50 - 55 Jahre,749,376,373
False,8315132,March,55 - 60 Jahre,644,307,337
False,8315132,March,60 - 65 Jahre,494,245,249
False,8315132,March,65 - 75 Jahre,893,434,459
False,8315132,March,75 und mehr Jahre,659,261,398
False,8315132,March,Insgesamt,8754,4367,4387
False,8315133,"Vogtsburg im Kaiserstuhl, Stadt",unter 3 Jahre,148,66,82
False,8315133,"Vogtsburg im Kaiserstuhl, Stadt",3 -  6 Jahre,146,76,70
False,8315133,"Vogtsburg im Kaiserstuhl, Stadt",6 - 10 Jahre,195,96,99
False,8315133,"Vogtsburg im Kaiserstuhl, Stadt",10 - 15 Jahre,310,164,146
False,8315133,"Vogtsburg im Kaiserstuhl, Stadt",15 - 18 Jahre,210,120,90
False,8315133,"Vogtsburg im Kaiserstuhl, Stadt",18 - 20 Jahre,133,82,51
False,8315133,"Vogtsburg im Kaiserstuhl, Stadt",20 - 25 Jahre,319,169,150
False,8315133,"Vogtsburg im Kaiserstuhl, Stadt",25 - 30 Jahre,300,147,153
False,8315133,"Vogtsburg im Kaiserstuhl, Stadt",30 - 35 Jahre,269,149,120
False,8315133,"Vogtsburg im Kaiserstuhl, Stadt",35 - 40 Jahre,300,148,152
False,8315133,"Vogtsburg im Kaiserstuhl, Stadt",40 - 45 Jahre,507,253,254
False,8315133,"Vogtsburg im Kaiserstuhl, Stadt",45 - 50 Jahre,515,272,243
False,8315133,"Vogtsburg im Kaiserstuhl, Stadt",50 - 55 Jahre,408,200,208
False,8315133,"Vogtsburg im Kaiserstuhl, Stadt",55 - 60 Jahre,422,214,208
False,8315133,"Vogtsburg im Kaiserstuhl, Stadt",60 - 65 Jahre,347,188,159
False,8315133,"Vogtsburg im Kaiserstuhl, Stadt",65 - 75 Jahre,629,301,328
False,8315133,"Vogtsburg im Kaiserstuhl, Stadt",75 und mehr Jahre,522,221,301
False,8315133,"Vogtsburg im Kaiserstuhl, Stadt",Insgesamt,5680,2866,2814
False,8316,Landkreis Emmendingen,unter 3 Jahre,4031,2083,1948
False,8316,Landkreis Emmendingen,3 -  6 Jahre,4385,2258,2127
False,8316,Landkreis Emmendingen,6 - 10 Jahre,6112,3204,2908
False,8316,Landkreis Emmendingen,10 - 15 Jahre,9010,4554,4456
False,8316,Landkreis Emmendingen,15 - 18 Jahre,5543,2851,2692
False,8316,Landkreis Emmendingen,18 - 20 Jahre,3766,1927,1839
False,8316,Landkreis Emmendingen,20 - 25 Jahre,9086,4713,4373
False,8316,Landkreis Emmendingen,25 - 30 Jahre,8490,4359,4131
False,8316,Landkreis Emmendingen,30 - 35 Jahre,8415,4146,4269
False,8316,Landkreis Emmendingen,35 - 40 Jahre,9512,4622,4890
False,8316,Landkreis Emmendingen,40 - 45 Jahre,13327,6761,6566
False,8316,Landkreis Emmendingen,45 - 50 Jahre,14110,7083,7027
False,8316,Landkreis Emmendingen,50 - 55 Jahre,12458,6176,6282
False,8316,Landkreis Emmendingen,55 - 60 Jahre,10800,5379,5421
False,8316,Landkreis Emmendingen,60 - 65 Jahre,8763,4350,4413
False,8316,Landkreis Emmendingen,65 - 75 Jahre,16826,7967,8859
False,8316,Landkreis Emmendingen,75 und mehr Jahre,13708,5313,8395
False,8316,Landkreis Emmendingen,Insgesamt,158342,77746,80596
False,8316002,Bahlingen am Kaiserstuhl,unter 3 Jahre,113,62,51
False,8316002,Bahlingen am Kaiserstuhl,3 -  6 Jahre,110,63,47
False,8316002,Bahlingen am Kaiserstuhl,6 - 10 Jahre,138,67,71
False,8316002,Bahlingen am Kaiserstuhl,10 - 15 Jahre,221,118,103
False,8316002,Bahlingen am Kaiserstuhl,15 - 18 Jahre,125,67,58
False,8316002,Bahlingen am Kaiserstuhl,18 - 20 Jahre,92,50,42
False,8316002,Bahlingen am Kaiserstuhl,20 - 25 Jahre,273,129,144
False,8316002,Bahlingen am Kaiserstuhl,25 - 30 Jahre,236,117,119
False,8316002,Bahlingen am Kaiserstuhl,30 - 35 Jahre,255,119,136
False,8316002,Bahlingen am Kaiserstuhl,35 - 40 Jahre,211,110,101
False,8316002,Bahlingen am Kaiserstuhl,40 - 45 Jahre,330,172,158
False,8316002,Bahlingen am Kaiserstuhl,45 - 50 Jahre,364,181,183
False,8316002,Bahlingen am Kaiserstuhl,50 - 55 Jahre,336,163,173
False,8316002,Bahlingen am Kaiserstuhl,55 - 60 Jahre,296,148,148
False,8316002,Bahlingen am Kaiserstuhl,60 - 65 Jahre,200,112,88
False,8316002,Bahlingen am Kaiserstuhl,65 - 75 Jahre,344,166,178
False,8316002,Bahlingen am Kaiserstuhl,75 und mehr Jahre,320,127,193
False,8316002,Bahlingen am Kaiserstuhl,Insgesamt,3964,1971,1993
False,8316003,Biederbach,unter 3 Jahre,55,36,19
False,8316003,Biederbach,3 -  6 Jahre,58,29,29
False,8316003,Biederbach,6 - 10 Jahre,86,45,41
False,8316003,Biederbach,10 - 15 Jahre,105,62,43
False,8316003,Biederbach,15 - 18 Jahre,66,31,35
False,8316003,Biederbach,18 - 20 Jahre,44,19,25
False,8316003,Biederbach,20 - 25 Jahre,100,50,50
False,8316003,Biederbach,25 - 30 Jahre,86,47,39
False,8316003,Biederbach,30 - 35 Jahre,106,49,57
False,8316003,Biederbach,35 - 40 Jahre,125,70,55
False,8316003,Biederbach,40 - 45 Jahre,166,79,87
False,8316003,Biederbach,45 - 50 Jahre,159,94,65
False,8316003,Biederbach,50 - 55 Jahre,127,66,61
False,8316003,Biederbach,55 - 60 Jahre,88,45,43
False,8316003,Biederbach,60 - 65 Jahre,77,35,42
False,8316003,Biederbach,65 - 75 Jahre,159,83,76
False,8316003,Biederbach,75 und mehr Jahre,142,59,83
False,8316003,Biederbach,Insgesamt,1749,899,850
False,8316009,Denzlingen,unter 3 Jahre,372,190,182
False,8316009,Denzlingen,3 -  6 Jahre,402,220,182
False,8316009,Denzlingen,6 - 10 Jahre,494,239,255
False,8316009,Denzlingen,10 - 15 Jahre,693,353,340
False,8316009,Denzlingen,15 - 18 Jahre,403,221,182
False,8316009,Denzlingen,18 - 20 Jahre,316,160,156
False,8316009,Denzlingen,20 - 25 Jahre,691,355,336
False,8316009,Denzlingen,25 - 30 Jahre,784,398,386
False,8316009,Denzlingen,30 - 35 Jahre,724,354,370
False,8316009,Denzlingen,35 - 40 Jahre,828,402,426
False,8316009,Denzlingen,40 - 45 Jahre,1107,550,557
False,8316009,Denzlingen,45 - 50 Jahre,1180,584,596
False,8316009,Denzlingen,50 - 55 Jahre,1011,479,532
False,8316009,Denzlingen,55 - 60 Jahre,943,449,494
False,8316009,Denzlingen,60 - 65 Jahre,869,394,475
False,8316009,Denzlingen,65 - 75 Jahre,1675,785,890
False,8316009,Denzlingen,75 und mehr Jahre,1220,492,728
False,8316009,Denzlingen,Insgesamt,13712,6625,7087
False,8316010,"Elzach, Stadt",unter 3 Jahre,147,68,79
False,8316010,"Elzach, Stadt",3 -  6 Jahre,203,94,109
False,8316010,"Elzach, Stadt",6 - 10 Jahre,290,154,136
False,8316010,"Elzach, Stadt",10 - 15 Jahre,470,241,229
False,8316010,"Elzach, Stadt",15 - 18 Jahre,253,115,138
False,8316010,"Elzach, Stadt",18 - 20 Jahre,177,84,93
False,8316010,"Elzach, Stadt",20 - 25 Jahre,445,224,221
False,8316010,"Elzach, Stadt",25 - 30 Jahre,343,188,155
False,8316010,"Elzach, Stadt",30 - 35 Jahre,357,170,187
False,8316010,"Elzach, Stadt",35 - 40 Jahre,429,214,215
False,8316010,"Elzach, Stadt",40 - 45 Jahre,576,300,276
False,8316010,"Elzach, Stadt",45 - 50 Jahre,583,313,270
False,8316010,"Elzach, Stadt",50 - 55 Jahre,544,291,253
False,8316010,"Elzach, Stadt",55 - 60 Jahre,461,229,232
False,8316010,"Elzach, Stadt",60 - 65 Jahre,330,166,164
False,8316010,"Elzach, Stadt",65 - 75 Jahre,682,323,359
False,8316010,"Elzach, Stadt",75 und mehr Jahre,660,257,403
False,8316010,"Elzach, Stadt",Insgesamt,6950,3431,3519
False,8316011,"Emmendingen, Stadt",unter 3 Jahre,715,371,344
False,8316011,"Emmendingen, Stadt",3 -  6 Jahre,800,403,397
False,8316011,"Emmendingen, Stadt",6 - 10 Jahre,991,536,455
False,8316011,"Emmendingen, Stadt",10 - 15 Jahre,1402,712,690
False,8316011,"Emmendingen, Stadt",15 - 18 Jahre,931,480,451
False,8316011,"Emmendingen, Stadt",18 - 20 Jahre,622,308,314
False,8316011,"Emmendingen, Stadt",20 - 25 Jahre,1537,794,743
False,8316011,"Emmendingen, Stadt",25 - 30 Jahre,1486,750,736
False,8316011,"Emmendingen, Stadt",30 - 35 Jahre,1444,733,711
False,8316011,"Emmendingen, Stadt",35 - 40 Jahre,1569,767,802
False,8316011,"Emmendingen, Stadt",40 - 45 Jahre,2174,1132,1042
False,8316011,"Emmendingen, Stadt",45 - 50 Jahre,2275,1103,1172
False,8316011,"Emmendingen, Stadt",50 - 55 Jahre,2084,1009,1075
False,8316011,"Emmendingen, Stadt",55 - 60 Jahre,1891,894,997
False,8316011,"Emmendingen, Stadt",60 - 65 Jahre,1554,750,804
False,8316011,"Emmendingen, Stadt",65 - 75 Jahre,3013,1436,1577
False,8316011,"Emmendingen, Stadt",75 und mehr Jahre,2386,884,1502
False,8316011,"Emmendingen, Stadt",Insgesamt,26874,13062,13812
False,8316012,"Endingen am Kaiserstuhl, Stadt",unter 3 Jahre,240,131,109
False,8316012,"Endingen am Kaiserstuhl, Stadt",3 -  6 Jahre,265,142,123
False,8316012,"Endingen am Kaiserstuhl, Stadt",6 - 10 Jahre,359,185,174
False,8316012,"Endingen am Kaiserstuhl, Stadt",10 - 15 Jahre,492,235,257
False,8316012,"Endingen am Kaiserstuhl, Stadt",15 - 18 Jahre,309,136,173
False,8316012,"Endingen am Kaiserstuhl, Stadt",18 - 20 Jahre,220,107,113
False,8316012,"Endingen am Kaiserstuhl, Stadt",20 - 25 Jahre,533,296,237
False,8316012,"Endingen am Kaiserstuhl, Stadt",25 - 30 Jahre,493,250,243
False,8316012,"Endingen am Kaiserstuhl, Stadt",30 - 35 Jahre,521,268,253
False,8316012,"Endingen am Kaiserstuhl, Stadt",35 - 40 Jahre,582,286,296
False,8316012,"Endingen am Kaiserstuhl, Stadt",40 - 45 Jahre,709,347,362
False,8316012,"Endingen am Kaiserstuhl, Stadt",45 - 50 Jahre,778,394,384
False,8316012,"Endingen am Kaiserstuhl, Stadt",50 - 55 Jahre,695,354,341
False,8316012,"Endingen am Kaiserstuhl, Stadt",55 - 60 Jahre,661,339,322
False,8316012,"Endingen am Kaiserstuhl, Stadt",60 - 65 Jahre,488,232,256
False,8316012,"Endingen am Kaiserstuhl, Stadt",65 - 75 Jahre,932,454,478
False,8316012,"Endingen am Kaiserstuhl, Stadt",75 und mehr Jahre,827,307,520
False,8316012,"Endingen am Kaiserstuhl, Stadt",Insgesamt,9104,4463,4641
False,8316013,Forchheim,unter 3 Jahre,51,21,30
False,8316013,Forchheim,3 -  6 Jahre,38,15,23
False,8316013,Forchheim,6 - 10 Jahre,59,38,21
False,8316013,Forchheim,10 - 15 Jahre,80,40,40
False,8316013,Forchheim,15 - 18 Jahre,41,21,20
False,8316013,Forchheim,18 - 20 Jahre,22,11,11
False,8316013,Forchheim,20 - 25 Jahre,76,37,39
False,8316013,Forchheim,25 - 30 Jahre,73,40,33
False,8316013,Forchheim,30 - 35 Jahre,71,31,40
False,8316013,Forchheim,35 - 40 Jahre,73,38,35
False,8316013,Forchheim,40 - 45 Jahre,103,54,49
False,8316013,Forchheim,45 - 50 Jahre,110,62,48
False,8316013,Forchheim,50 - 55 Jahre,91,44,47
False,8316013,Forchheim,55 - 60 Jahre,71,34,37
False,8316013,Forchheim,60 - 65 Jahre,66,31,35
False,8316013,Forchheim,65 - 75 Jahre,107,49,58
False,8316013,Forchheim,75 und mehr Jahre,95,40,55
False,8316013,Forchheim,Insgesamt,1227,606,621
False,8316014,Gutach im Breisgau,unter 3 Jahre,105,61,44
False,8316014,Gutach im Breisgau,3 -  6 Jahre,112,57,55
False,8316014,Gutach im Breisgau,6 - 10 Jahre,206,117,89
False,8316014,Gutach im Breisgau,10 - 15 Jahre,275,130,145
False,8316014,Gutach im Breisgau,15 - 18 Jahre,175,92,83
False,8316014,Gutach im Breisgau,18 - 20 Jahre,114,58,56
False,8316014,Gutach im Breisgau,20 - 25 Jahre,236,136,100
False,8316014,Gutach im Breisgau,25 - 30 Jahre,243,111,132
False,8316014,Gutach im Breisgau,30 - 35 Jahre,248,119,129
False,8316014,Gutach im Breisgau,35 - 40 Jahre,289,146,143
False,8316014,Gutach im Breisgau,40 - 45 Jahre,398,195,203
False,8316014,Gutach im Breisgau,45 - 50 Jahre,455,227,228
False,8316014,Gutach im Breisgau,50 - 55 Jahre,323,147,176
False,8316014,Gutach im Breisgau,55 - 60 Jahre,333,167,166
False,8316014,Gutach im Breisgau,60 - 65 Jahre,224,132,92
False,8316014,Gutach im Breisgau,65 - 75 Jahre,402,182,220
False,8316014,Gutach im Breisgau,75 und mehr Jahre,319,126,193
False,8316014,Gutach im Breisgau,Insgesamt,4457,2203,2254
False,8316017,"Herbolzheim, Stadt",unter 3 Jahre,267,138,129
False,8316017,"Herbolzheim, Stadt",3 -  6 Jahre,277,141,136
False,8316017,"Herbolzheim, Stadt",6 - 10 Jahre,421,208,213
False,8316017,"Herbolzheim, Stadt",10 - 15 Jahre,586,302,284
False,8316017,"Herbolzheim, Stadt",15 - 18 Jahre,354,202,152
False,8316017,"Herbolzheim, Stadt",18 - 20 Jahre,240,116,124
False,8316017,"Herbolzheim, Stadt",20 - 25 Jahre,622,319,303
False,8316017,"Herbolzheim, Stadt",25 - 30 Jahre,576,299,277
False,8316017,"Herbolzheim, Stadt",30 - 35 Jahre,562,289,273
False,8316017,"Herbolzheim, Stadt",35 - 40 Jahre,632,310,322
False,8316017,"Herbolzheim, Stadt",40 - 45 Jahre,820,420,400
False,8316017,"Herbolzheim, Stadt",45 - 50 Jahre,850,434,416
False,8316017,"Herbolzheim, Stadt",50 - 55 Jahre,787,390,397
False,8316017,"Herbolzheim, Stadt",55 - 60 Jahre,634,327,307
False,8316017,"Herbolzheim, Stadt",60 - 65 Jahre,509,244,265
False,8316017,"Herbolzheim, Stadt",65 - 75 Jahre,969,458,511
False,8316017,"Herbolzheim, Stadt",75 und mehr Jahre,841,321,520
False,8316017,"Herbolzheim, Stadt",Insgesamt,9947,4918,5029
False,8316020,"Kenzingen, Stadt",unter 3 Jahre,248,120,128
False,8316020,"Kenzingen, Stadt",3 -  6 Jahre,261,138,123
False,8316020,"Kenzingen, Stadt",6 - 10 Jahre,340,181,159
False,8316020,"Kenzingen, Stadt",10 - 15 Jahre,594,283,311
False,8316020,"Kenzingen, Stadt",15 - 18 Jahre,362,179,183
False,8316020,"Kenzingen, Stadt",18 - 20 Jahre,229,125,104
False,8316020,"Kenzingen, Stadt",20 - 25 Jahre,555,285,270
False,8316020,"Kenzingen, Stadt",25 - 30 Jahre,520,259,261
False,8316020,"Kenzingen, Stadt",30 - 35 Jahre,447,222,225
False,8316020,"Kenzingen, Stadt",35 - 40 Jahre,552,258,294
False,8316020,"Kenzingen, Stadt",40 - 45 Jahre,723,379,344
False,8316020,"Kenzingen, Stadt",45 - 50 Jahre,769,372,397
False,8316020,"Kenzingen, Stadt",50 - 55 Jahre,762,389,373
False,8316020,"Kenzingen, Stadt",55 - 60 Jahre,638,312,326
False,8316020,"Kenzingen, Stadt",60 - 65 Jahre,519,263,256
False,8316020,"Kenzingen, Stadt",65 - 75 Jahre,896,443,453
False,8316020,"Kenzingen, Stadt",75 und mehr Jahre,817,286,531
False,8316020,"Kenzingen, Stadt",Insgesamt,9232,4494,4738
False,8316024,Malterdingen,unter 3 Jahre,68,39,29
False,8316024,Malterdingen,3 -  6 Jahre,92,49,43
False,8316024,Malterdingen,6 - 10 Jahre,124,64,60
False,8316024,Malterdingen,10 - 15 Jahre,189,99,90
False,8316024,Malterdingen,15 - 18 Jahre,115,63,52
False,8316024,Malterdingen,18 - 20 Jahre,71,43,28
False,8316024,Malterdingen,20 - 25 Jahre,181,103,78
False,8316024,Malterdingen,25 - 30 Jahre,153,75,78
False,8316024,Malterdingen,30 - 35 Jahre,181,92,89
False,8316024,Malterdingen,35 - 40 Jahre,191,96,95
False,8316024,Malterdingen,40 - 45 Jahre,263,131,132
False,8316024,Malterdingen,45 - 50 Jahre,278,140,138
False,8316024,Malterdingen,50 - 55 Jahre,262,137,125
False,8316024,Malterdingen,55 - 60 Jahre,224,118,106
False,8316024,Malterdingen,60 - 65 Jahre,167,86,81
False,8316024,Malterdingen,65 - 75 Jahre,245,119,126
False,8316024,Malterdingen,75 und mehr Jahre,213,81,132
False,8316024,Malterdingen,Insgesamt,3017,1535,1482
False,8316036,Reute,unter 3 Jahre,70,42,28
False,8316036,Reute,3 -  6 Jahre,58,27,31
False,8316036,Reute,6 - 10 Jahre,127,81,46
False,8316036,Reute,10 - 15 Jahre,205,113,92
False,8316036,Reute,15 - 18 Jahre,108,55,53
False,8316036,Reute,18 - 20 Jahre,76,35,41
False,8316036,Reute,20 - 25 Jahre,206,104,102
False,8316036,Reute,25 - 30 Jahre,180,98,82
False,8316036,Reute,30 - 35 Jahre,127,57,70
False,8316036,Reute,35 - 40 Jahre,193,90,103
False,8316036,Reute,40 - 45 Jahre,295,142,153
False,8316036,Reute,45 - 50 Jahre,320,156,164
False,8316036,Reute,50 - 55 Jahre,224,107,117
False,8316036,Reute,55 - 60 Jahre,219,101,118
False,8316036,Reute,60 - 65 Jahre,173,95,78
False,8316036,Reute,65 - 75 Jahre,297,149,148
False,8316036,Reute,75 und mehr Jahre,174,70,104
False,8316036,Reute,Insgesamt,3052,1522,1530
False,8316037,Riegel am Kaiserstuhl,unter 3 Jahre,94,47,47
False,8316037,Riegel am Kaiserstuhl,3 -  6 Jahre,100,58,42
False,8316037,Riegel am Kaiserstuhl,6 - 10 Jahre,101,49,52
False,8316037,Riegel am Kaiserstuhl,10 - 15 Jahre,208,104,104
False,8316037,Riegel am Kaiserstuhl,15 - 18 Jahre,119,59,60
False,8316037,Riegel am Kaiserstuhl,18 - 20 Jahre,102,53,49
False,8316037,Riegel am Kaiserstuhl,20 - 25 Jahre,244,119,125
False,8316037,Riegel am Kaiserstuhl,25 - 30 Jahre,227,125,102
False,8316037,Riegel am Kaiserstuhl,30 - 35 Jahre,222,116,106
False,8316037,Riegel am Kaiserstuhl,35 - 40 Jahre,212,89,123
False,8316037,Riegel am Kaiserstuhl,40 - 45 Jahre,335,177,158
False,8316037,Riegel am Kaiserstuhl,45 - 50 Jahre,376,186,190
False,8316037,Riegel am Kaiserstuhl,50 - 55 Jahre,311,162,149
False,8316037,Riegel am Kaiserstuhl,55 - 60 Jahre,255,134,121
False,8316037,Riegel am Kaiserstuhl,60 - 65 Jahre,192,84,108
False,8316037,Riegel am Kaiserstuhl,65 - 75 Jahre,333,157,176
False,8316037,Riegel am Kaiserstuhl,75 und mehr Jahre,214,87,127
False,8316037,Riegel am Kaiserstuhl,Insgesamt,3645,1806,1839
False,8316038,Sasbach am Kaiserstuhl,unter 3 Jahre,96,47,49
False,8316038,Sasbach am Kaiserstuhl,3 -  6 Jahre,93,45,48
False,8316038,Sasbach am Kaiserstuhl,6 - 10 Jahre,132,71,61
False,8316038,Sasbach am Kaiserstuhl,10 - 15 Jahre,203,99,104
False,8316038,Sasbach am Kaiserstuhl,15 - 18 Jahre,111,53,58
False,8316038,Sasbach am Kaiserstuhl,18 - 20 Jahre,91,48,43
False,8316038,Sasbach am Kaiserstuhl,20 - 25 Jahre,195,99,96
False,8316038,Sasbach am Kaiserstuhl,25 - 30 Jahre,168,92,76
False,8316038,Sasbach am Kaiserstuhl,30 - 35 Jahre,153,68,85
False,8316038,Sasbach am Kaiserstuhl,35 - 40 Jahre,191,87,104
False,8316038,Sasbach am Kaiserstuhl,40 - 45 Jahre,319,168,151
False,8316038,Sasbach am Kaiserstuhl,45 - 50 Jahre,327,177,150
False,8316038,Sasbach am Kaiserstuhl,50 - 55 Jahre,276,125,151
False,8316038,Sasbach am Kaiserstuhl,55 - 60 Jahre,229,118,111
False,8316038,Sasbach am Kaiserstuhl,60 - 65 Jahre,200,104,96
False,8316038,Sasbach am Kaiserstuhl,65 - 75 Jahre,327,160,167
False,8316038,Sasbach am Kaiserstuhl,75 und mehr Jahre,266,126,140
False,8316038,Sasbach am Kaiserstuhl,Insgesamt,3377,1687,1690
False,8316039,Sexau,unter 3 Jahre,89,45,44
False,8316039,Sexau,3 -  6 Jahre,76,40,36
False,8316039,Sexau,6 - 10 Jahre,112,53,59
False,8316039,Sexau,10 - 15 Jahre,182,80,102
False,8316039,Sexau,15 - 18 Jahre,119,53,66
False,8316039,Sexau,18 - 20 Jahre,72,40,32
False,8316039,Sexau,20 - 25 Jahre,175,83,92
False,8316039,Sexau,25 - 30 Jahre,150,73,77
False,8316039,Sexau,30 - 35 Jahre,156,73,83
False,8316039,Sexau,35 - 40 Jahre,165,82,83
False,8316039,Sexau,40 - 45 Jahre,300,141,159
False,8316039,Sexau,45 - 50 Jahre,312,153,159
False,8316039,Sexau,50 - 55 Jahre,269,134,135
False,8316039,Sexau,55 - 60 Jahre,223,125,98
False,8316039,Sexau,60 - 65 Jahre,205,100,105
False,8316039,Sexau,65 - 75 Jahre,366,176,190
False,8316039,Sexau,75 und mehr Jahre,274,120,154
False,8316039,Sexau,Insgesamt,3245,1571,1674
False,8316042,Simonswald,unter 3 Jahre,82,48,34
False,8316042,Simonswald,3 -  6 Jahre,63,34,29
False,8316042,Simonswald,6 - 10 Jahre,110,60,50
False,8316042,Simonswald,10 - 15 Jahre,180,94,86
False,8316042,Simonswald,15 - 18 Jahre,107,59,48
False,8316042,Simonswald,18 - 20 Jahre,68,32,36
False,8316042,Simonswald,20 - 25 Jahre,160,82,78
False,8316042,Simonswald,25 - 30 Jahre,151,81,70
False,8316042,Simonswald,30 - 35 Jahre,176,88,88
False,8316042,Simonswald,35 - 40 Jahre,189,95,94
False,8316042,Simonswald,40 - 45 Jahre,264,139,125
False,8316042,Simonswald,45 - 50 Jahre,290,148,142
False,8316042,Simonswald,50 - 55 Jahre,227,113,114
False,8316042,Simonswald,55 - 60 Jahre,209,114,95
False,8316042,Simonswald,60 - 65 Jahre,171,87,84
False,8316042,Simonswald,65 - 75 Jahre,318,155,163
False,8316042,Simonswald,75 und mehr Jahre,254,111,143
False,8316042,Simonswald,Insgesamt,3019,1540,1479
False,8316043,Teningen,unter 3 Jahre,242,136,106
False,8316043,Teningen,3 -  6 Jahre,297,168,129
False,8316043,Teningen,6 - 10 Jahre,421,218,203
False,8316043,Teningen,10 - 15 Jahre,645,328,317
False,8316043,Teningen,15 - 18 Jahre,432,240,192
False,8316043,Teningen,18 - 20 Jahre,259,136,123
False,8316043,Teningen,20 - 25 Jahre,609,331,278
False,8316043,Teningen,25 - 30 Jahre,522,263,259
False,8316043,Teningen,30 - 35 Jahre,619,304,315
False,8316043,Teningen,35 - 40 Jahre,705,338,367
False,8316043,Teningen,40 - 45 Jahre,1035,537,498
False,8316043,Teningen,45 - 50 Jahre,1043,514,529
False,8316043,Teningen,50 - 55 Jahre,917,459,458
False,8316043,Teningen,55 - 60 Jahre,836,412,424
False,8316043,Teningen,60 - 65 Jahre,677,349,328
False,8316043,Teningen,65 - 75 Jahre,1436,678,758
False,8316043,Teningen,75 und mehr Jahre,1038,414,624
False,8316043,Teningen,Insgesamt,11733,5825,5908
False,8316045,Vörstetten,unter 3 Jahre,70,36,34
False,8316045,Vörstetten,3 -  6 Jahre,107,45,62
False,8316045,Vörstetten,6 - 10 Jahre,119,55,64
False,8316045,Vörstetten,10 - 15 Jahre,149,69,80
False,8316045,Vörstetten,15 - 18 Jahre,90,51,39
False,8316045,Vörstetten,18 - 20 Jahre,85,50,35
False,8316045,Vörstetten,20 - 25 Jahre,149,79,70
False,8316045,Vörstetten,25 - 30 Jahre,146,65,81
False,8316045,Vörstetten,30 - 35 Jahre,169,82,87
False,8316045,Vörstetten,35 - 40 Jahre,191,91,100
False,8316045,Vörstetten,40 - 45 Jahre,271,123,148
False,8316045,Vörstetten,45 - 50 Jahre,299,172,127
False,8316045,Vörstetten,50 - 55 Jahre,250,121,129
False,8316045,Vörstetten,55 - 60 Jahre,207,97,110
False,8316045,Vörstetten,60 - 65 Jahre,143,77,66
False,8316045,Vörstetten,65 - 75 Jahre,314,155,159
False,8316045,Vörstetten,75 und mehr Jahre,196,82,114
False,8316045,Vörstetten,Insgesamt,2955,1450,1505
False,8316049,Weisweil,unter 3 Jahre,44,22,22
False,8316049,Weisweil,3 -  6 Jahre,51,23,28
False,8316049,Weisweil,6 - 10 Jahre,77,44,33
False,8316049,Weisweil,10 - 15 Jahre,122,68,54
False,8316049,Weisweil,15 - 18 Jahre,88,35,53
False,8316049,Weisweil,18 - 20 Jahre,65,27,38
False,8316049,Weisweil,20 - 25 Jahre,149,75,74
False,8316049,Weisweil,25 - 30 Jahre,109,72,37
False,8316049,Weisweil,30 - 35 Jahre,111,54,57
False,8316049,Weisweil,35 - 40 Jahre,119,56,63
False,8316049,Weisweil,40 - 45 Jahre,176,85,91
False,8316049,Weisweil,45 - 50 Jahre,220,107,113
False,8316049,Weisweil,50 - 55 Jahre,217,116,101
False,8316049,Weisweil,55 - 60 Jahre,122,67,55
False,8316049,Weisweil,60 - 65 Jahre,108,53,55
False,8316049,Weisweil,65 - 75 Jahre,201,90,111
False,8316049,Weisweil,75 und mehr Jahre,147,57,90
False,8316049,Weisweil,Insgesamt,2126,1051,1075
False,8316051,Wyhl am Kaiserstuhl,unter 3 Jahre,83,39,44
False,8316051,Wyhl am Kaiserstuhl,3 -  6 Jahre,75,39,36
False,8316051,Wyhl am Kaiserstuhl,6 - 10 Jahre,129,71,58
False,8316051,Wyhl am Kaiserstuhl,10 - 15 Jahre,216,103,113
False,8316051,Wyhl am Kaiserstuhl,15 - 18 Jahre,133,67,66
False,8316051,Wyhl am Kaiserstuhl,18 - 20 Jahre,90,50,40
False,8316051,Wyhl am Kaiserstuhl,20 - 25 Jahre,256,126,130
False,8316051,Wyhl am Kaiserstuhl,25 - 30 Jahre,246,135,111
False,8316051,Wyhl am Kaiserstuhl,30 - 35 Jahre,189,84,105
False,8316051,Wyhl am Kaiserstuhl,35 - 40 Jahre,207,115,92
False,8316051,Wyhl am Kaiserstuhl,40 - 45 Jahre,315,154,161
False,8316051,Wyhl am Kaiserstuhl,45 - 50 Jahre,367,185,182
False,8316051,Wyhl am Kaiserstuhl,50 - 55 Jahre,344,161,183
False,8316051,Wyhl am Kaiserstuhl,55 - 60 Jahre,247,148,99
False,8316051,Wyhl am Kaiserstuhl,60 - 65 Jahre,183,93,90
False,8316051,Wyhl am Kaiserstuhl,65 - 75 Jahre,298,144,154
False,8316051,Wyhl am Kaiserstuhl,75 und mehr Jahre,234,90,144
False,8316051,Wyhl am Kaiserstuhl,Insgesamt,3612,1804,1808
False,8316053,Rheinhausen,unter 3 Jahre,92,40,52
False,8316053,Rheinhausen,3 -  6 Jahre,124,66,58
False,8316053,Rheinhausen,6 - 10 Jahre,158,75,83
False,8316053,Rheinhausen,10 - 15 Jahre,226,125,101
False,8316053,Rheinhausen,15 - 18 Jahre,120,61,59
False,8316053,Rheinhausen,18 - 20 Jahre,71,39,32
False,8316053,Rheinhausen,20 - 25 Jahre,200,111,89
False,8316053,Rheinhausen,25 - 30 Jahre,149,71,78
False,8316053,Rheinhausen,30 - 35 Jahre,182,95,87
False,8316053,Rheinhausen,35 - 40 Jahre,217,113,104
False,8316053,Rheinhausen,40 - 45 Jahre,313,160,153
False,8316053,Rheinhausen,45 - 50 Jahre,321,174,147
False,8316053,Rheinhausen,50 - 55 Jahre,249,116,133
False,8316053,Rheinhausen,55 - 60 Jahre,207,105,102
False,8316053,Rheinhausen,60 - 65 Jahre,197,113,84
False,8316053,Rheinhausen,65 - 75 Jahre,347,146,201
False,8316053,Rheinhausen,75 und mehr Jahre,270,100,170
False,8316053,Rheinhausen,Insgesamt,3443,1710,1733
False,8316054,Freiamt,unter 3 Jahre,96,46,50
False,8316054,Freiamt,3 -  6 Jahre,112,54,58
False,8316054,Freiamt,6 - 10 Jahre,178,98,80
False,8316054,Freiamt,10 - 15 Jahre,249,126,123
False,8316054,Freiamt,15 - 18 Jahre,153,84,69
False,8316054,Freiamt,18 - 20 Jahre,103,51,52
False,8316054,Freiamt,20 - 25 Jahre,233,125,108
False,8316054,Freiamt,25 - 30 Jahre,196,99,97
False,8316054,Freiamt,30 - 35 Jahre,176,90,86
False,8316054,Freiamt,35 - 40 Jahre,253,118,135
False,8316054,Freiamt,40 - 45 Jahre,365,196,169
False,8316054,Freiamt,45 - 50 Jahre,398,207,191
False,8316054,Freiamt,50 - 55 Jahre,351,179,172
False,8316054,Freiamt,55 - 60 Jahre,296,153,143
False,8316054,Freiamt,60 - 65 Jahre,238,123,115
False,8316054,Freiamt,65 - 75 Jahre,414,200,214
False,8316054,Freiamt,75 und mehr Jahre,406,161,245
False,8316054,Freiamt,Insgesamt,4217,2110,2107
False,8316055,Winden im Elztal,unter 3 Jahre,67,34,33
False,8316055,Winden im Elztal,3 -  6 Jahre,78,39,39
False,8316055,Winden im Elztal,6 - 10 Jahre,94,56,38
False,8316055,Winden im Elztal,10 - 15 Jahre,170,94,76
False,8316055,Winden im Elztal,15 - 18 Jahre,108,49,59
False,8316055,Winden im Elztal,18 - 20 Jahre,65,35,30
False,8316055,Winden im Elztal,20 - 25 Jahre,155,86,69
False,8316055,Winden im Elztal,25 - 30 Jahre,168,92,76
False,8316055,Winden im Elztal,30 - 35 Jahre,154,82,72
False,8316055,Winden im Elztal,35 - 40 Jahre,187,93,94
False,8316055,Winden im Elztal,40 - 45 Jahre,260,142,118
False,8316055,Winden im Elztal,45 - 50 Jahre,256,128,128
False,8316055,Winden im Elztal,50 - 55 Jahre,246,128,118
False,8316055,Winden im Elztal,55 - 60 Jahre,195,105,90
False,8316055,Winden im Elztal,60 - 65 Jahre,149,75,74
False,8316055,Winden im Elztal,65 - 75 Jahre,246,117,129
False,8316055,Winden im Elztal,75 und mehr Jahre,230,91,139
False,8316055,Winden im Elztal,Insgesamt,2828,1446,1382
False,8316056,"Waldkirch, Stadt",unter 3 Jahre,525,264,261
False,8316056,"Waldkirch, Stadt",3 -  6 Jahre,533,269,264
False,8316056,"Waldkirch, Stadt",6 - 10 Jahre,846,439,407
False,8316056,"Waldkirch, Stadt",10 - 15 Jahre,1148,576,572
False,8316056,"Waldkirch, Stadt",15 - 18 Jahre,721,378,343
False,8316056,"Waldkirch, Stadt",18 - 20 Jahre,472,250,222
False,8316056,"Waldkirch, Stadt",20 - 25 Jahre,1106,565,541
False,8316056,"Waldkirch, Stadt",25 - 30 Jahre,1085,559,526
False,8316056,"Waldkirch, Stadt",30 - 35 Jahre,1065,507,558
False,8316056,"Waldkirch, Stadt",35 - 40 Jahre,1202,558,644
False,8316056,"Waldkirch, Stadt",40 - 45 Jahre,1710,838,872
False,8316056,"Waldkirch, Stadt",45 - 50 Jahre,1780,872,908
False,8316056,"Waldkirch, Stadt",50 - 55 Jahre,1555,786,769
False,8316056,"Waldkirch, Stadt",55 - 60 Jahre,1315,638,677
False,8316056,"Waldkirch, Stadt",60 - 65 Jahre,1124,552,572
False,8316056,"Waldkirch, Stadt",65 - 75 Jahre,2505,1142,1363
False,8316056,"Waldkirch, Stadt",75 und mehr Jahre,2165,824,1341
False,8316056,"Waldkirch, Stadt",Insgesamt,20857,10017,10840
False,8317,Landkreis Ortenaukreis,unter 3 Jahre,10681,5472,5209
False,8317,Landkreis Ortenaukreis,3 -  6 Jahre,11309,5728,5581
False,8317,Landkreis Ortenaukreis,6 - 10 Jahre,16085,8290,7795
False,8317,Landkreis Ortenaukreis,10 - 15 Jahre,23392,12104,11288
False,8317,Landkreis Ortenaukreis,15 - 18 Jahre,14725,7465,7260
False,8317,Landkreis Ortenaukreis,18 - 20 Jahre,10218,5270,4948
False,8317,Landkreis Ortenaukreis,20 - 25 Jahre,25054,13155,11899
False,8317,Landkreis Ortenaukreis,25 - 30 Jahre,23342,11995,11347
False,8317,Landkreis Ortenaukreis,30 - 35 Jahre,22519,11186,11333
False,8317,Landkreis Ortenaukreis,35 - 40 Jahre,24888,12448,12440
False,8317,Landkreis Ortenaukreis,40 - 45 Jahre,34226,17250,16976
False,8317,Landkreis Ortenaukreis,45 - 50 Jahre,36215,18389,17826
False,8317,Landkreis Ortenaukreis,50 - 55 Jahre,32225,16362,15863
False,8317,Landkreis Ortenaukreis,55 - 60 Jahre,28221,14142,14079
False,8317,Landkreis Ortenaukreis,60 - 65 Jahre,22511,11271,11240
False,8317,Landkreis Ortenaukreis,65 - 75 Jahre,43116,20448,22668
False,8317,Landkreis Ortenaukreis,75 und mehr Jahre,38786,14672,24114
False,8317,Landkreis Ortenaukreis,Insgesamt,417513,205647,211866
False,8317001,"Achern, Stadt",unter 3 Jahre,678,321,357
False,8317001,"Achern, Stadt",3 -  6 Jahre,721,357,364
False,8317001,"Achern, Stadt",6 - 10 Jahre,975,523,452
False,8317001,"Achern, Stadt",10 - 15 Jahre,1471,739,732
False,8317001,"Achern, Stadt",15 - 18 Jahre,918,464,454
False,8317001,"Achern, Stadt",18 - 20 Jahre,645,357,288
False,8317001,"Achern, Stadt",20 - 25 Jahre,1471,758,713
False,8317001,"Achern, Stadt",25 - 30 Jahre,1483,766,717
False,8317001,"Achern, Stadt",30 - 35 Jahre,1408,692,716
False,8317001,"Achern, Stadt",35 - 40 Jahre,1528,786,742
False,8317001,"Achern, Stadt",40 - 45 Jahre,2009,982,1027
False,8317001,"Achern, Stadt",45 - 50 Jahre,2141,1080,1061
False,8317001,"Achern, Stadt",50 - 55 Jahre,1843,886,957
False,8317001,"Achern, Stadt",55 - 60 Jahre,1676,861,815
False,8317001,"Achern, Stadt",60 - 65 Jahre,1308,647,661
False,8317001,"Achern, Stadt",65 - 75 Jahre,2490,1159,1331
False,8317001,"Achern, Stadt",75 und mehr Jahre,2249,829,1420
False,8317001,"Achern, Stadt",Insgesamt,25014,12207,12807
False,8317005,Appenweier,unter 3 Jahre,271,129,142
False,8317005,Appenweier,3 -  6 Jahre,259,139,120
False,8317005,Appenweier,6 - 10 Jahre,333,181,152
False,8317005,Appenweier,10 - 15 Jahre,532,285,247
False,8317005,Appenweier,15 - 18 Jahre,332,170,162
False,8317005,Appenweier,18 - 20 Jahre,244,131,113
False,8317005,Appenweier,20 - 25 Jahre,628,312,316
False,8317005,Appenweier,25 - 30 Jahre,543,293,250
False,8317005,Appenweier,30 - 35 Jahre,563,280,283
False,8317005,Appenweier,35 - 40 Jahre,582,292,290
False,8317005,Appenweier,40 - 45 Jahre,780,398,382
False,8317005,Appenweier,45 - 50 Jahre,852,408,444
False,8317005,Appenweier,50 - 55 Jahre,797,398,399
False,8317005,Appenweier,55 - 60 Jahre,697,328,369
False,8317005,Appenweier,60 - 65 Jahre,556,273,283
False,8317005,Appenweier,65 - 75 Jahre,984,486,498
False,8317005,Appenweier,75 und mehr Jahre,849,311,538
False,8317005,Appenweier,Insgesamt,9802,4814,4988
False,8317008,Bad Peterstal-Griesbach,unter 3 Jahre,62,30,32
False,8317008,Bad Peterstal-Griesbach,3 -  6 Jahre,75,38,37
False,8317008,Bad Peterstal-Griesbach,6 - 10 Jahre,75,45,30
False,8317008,Bad Peterstal-Griesbach,10 - 15 Jahre,137,70,67
False,8317008,Bad Peterstal-Griesbach,15 - 18 Jahre,84,44,40
False,8317008,Bad Peterstal-Griesbach,18 - 20 Jahre,83,51,32
False,8317008,Bad Peterstal-Griesbach,20 - 25 Jahre,180,100,80
False,8317008,Bad Peterstal-Griesbach,25 - 30 Jahre,124,54,70
False,8317008,Bad Peterstal-Griesbach,30 - 35 Jahre,134,66,68
False,8317008,Bad Peterstal-Griesbach,35 - 40 Jahre,144,76,68
False,8317008,Bad Peterstal-Griesbach,40 - 45 Jahre,217,119,98
False,8317008,Bad Peterstal-Griesbach,45 - 50 Jahre,193,86,107
False,8317008,Bad Peterstal-Griesbach,50 - 55 Jahre,195,100,95
False,8317008,Bad Peterstal-Griesbach,55 - 60 Jahre,174,102,72
False,8317008,Bad Peterstal-Griesbach,60 - 65 Jahre,156,70,86
False,8317008,Bad Peterstal-Griesbach,65 - 75 Jahre,333,164,169
False,8317008,Bad Peterstal-Griesbach,75 und mehr Jahre,332,128,204
False,8317008,Bad Peterstal-Griesbach,Insgesamt,2698,1343,1355
False,8317009,Berghaupten,unter 3 Jahre,72,38,34
False,8317009,Berghaupten,3 -  6 Jahre,70,38,32
False,8317009,Berghaupten,6 - 10 Jahre,98,57,41
False,8317009,Berghaupten,10 - 15 Jahre,130,65,65
False,8317009,Berghaupten,15 - 18 Jahre,79,42,37
False,8317009,Berghaupten,18 - 20 Jahre,63,32,31
False,8317009,Berghaupten,20 - 25 Jahre,147,73,74
False,8317009,Berghaupten,25 - 30 Jahre,104,57,47
False,8317009,Berghaupten,30 - 35 Jahre,123,56,67
False,8317009,Berghaupten,35 - 40 Jahre,129,70,59
False,8317009,Berghaupten,40 - 45 Jahre,241,122,119
False,8317009,Berghaupten,45 - 50 Jahre,211,112,99
False,8317009,Berghaupten,50 - 55 Jahre,194,103,91
False,8317009,Berghaupten,55 - 60 Jahre,151,75,76
False,8317009,Berghaupten,60 - 65 Jahre,160,81,79
False,8317009,Berghaupten,65 - 75 Jahre,244,116,128
False,8317009,Berghaupten,75 und mehr Jahre,199,81,118
False,8317009,Berghaupten,Insgesamt,2415,1218,1197
False,8317011,Biberach,unter 3 Jahre,101,54,47
False,8317011,Biberach,3 -  6 Jahre,92,46,46
False,8317011,Biberach,6 - 10 Jahre,138,68,70
False,8317011,Biberach,10 - 15 Jahre,167,91,76
False,8317011,Biberach,15 - 18 Jahre,136,65,71
False,8317011,Biberach,18 - 20 Jahre,83,41,42
False,8317011,Biberach,20 - 25 Jahre,201,97,104
False,8317011,Biberach,25 - 30 Jahre,186,98,88
False,8317011,Biberach,30 - 35 Jahre,168,89,79
False,8317011,Biberach,35 - 40 Jahre,207,95,112
False,8317011,Biberach,40 - 45 Jahre,292,167,125
False,8317011,Biberach,45 - 50 Jahre,282,134,148
False,8317011,Biberach,50 - 55 Jahre,263,131,132
False,8317011,Biberach,55 - 60 Jahre,238,130,108
False,8317011,Biberach,60 - 65 Jahre,173,90,83
False,8317011,Biberach,65 - 75 Jahre,313,143,170
False,8317011,Biberach,75 und mehr Jahre,325,122,203
False,8317011,Biberach,Insgesamt,3365,1661,1704
False,8317021,Durbach,unter 3 Jahre,92,47,45
False,8317021,Durbach,3 -  6 Jahre,91,48,43
False,8317021,Durbach,6 - 10 Jahre,142,70,72
False,8317021,Durbach,10 - 15 Jahre,201,102,99
False,8317021,Durbach,15 - 18 Jahre,114,61,53
False,8317021,Durbach,18 - 20 Jahre,78,38,40
False,8317021,Durbach,20 - 25 Jahre,217,122,95
False,8317021,Durbach,25 - 30 Jahre,200,83,117
False,8317021,Durbach,30 - 35 Jahre,176,90,86
False,8317021,Durbach,35 - 40 Jahre,194,94,100
False,8317021,Durbach,40 - 45 Jahre,316,163,153
False,8317021,Durbach,45 - 50 Jahre,336,176,160
False,8317021,Durbach,50 - 55 Jahre,316,170,146
False,8317021,Durbach,55 - 60 Jahre,298,137,161
False,8317021,Durbach,60 - 65 Jahre,261,143,118
False,8317021,Durbach,65 - 75 Jahre,439,205,234
False,8317021,Durbach,75 und mehr Jahre,343,141,202
False,8317021,Durbach,Insgesamt,3814,1890,1924
False,8317026,"Ettenheim, Stadt",unter 3 Jahre,297,156,141
False,8317026,"Ettenheim, Stadt",3 -  6 Jahre,319,170,149
False,8317026,"Ettenheim, Stadt",6 - 10 Jahre,435,203,232
False,8317026,"Ettenheim, Stadt",10 - 15 Jahre,703,342,361
False,8317026,"Ettenheim, Stadt",15 - 18 Jahre,444,215,229
False,8317026,"Ettenheim, Stadt",18 - 20 Jahre,327,139,188
False,8317026,"Ettenheim, Stadt",20 - 25 Jahre,737,359,378
False,8317026,"Ettenheim, Stadt",25 - 30 Jahre,614,301,313
False,8317026,"Ettenheim, Stadt",30 - 35 Jahre,621,317,304
False,8317026,"Ettenheim, Stadt",35 - 40 Jahre,823,432,391
False,8317026,"Ettenheim, Stadt",40 - 45 Jahre,1105,553,552
False,8317026,"Ettenheim, Stadt",45 - 50 Jahre,1126,538,588
False,8317026,"Ettenheim, Stadt",50 - 55 Jahre,986,501,485
False,8317026,"Ettenheim, Stadt",55 - 60 Jahre,810,412,398
False,8317026,"Ettenheim, Stadt",60 - 65 Jahre,632,326,306
False,8317026,"Ettenheim, Stadt",65 - 75 Jahre,1232,578,654
False,8317026,"Ettenheim, Stadt",75 und mehr Jahre,1033,381,652
False,8317026,"Ettenheim, Stadt",Insgesamt,12244,5923,6321
False,8317029,Fischerbach,unter 3 Jahre,47,30,17
False,8317029,Fischerbach,3 -  6 Jahre,49,29,20
False,8317029,Fischerbach,6 - 10 Jahre,69,42,27
False,8317029,Fischerbach,10 - 15 Jahre,127,72,55
False,8317029,Fischerbach,15 - 18 Jahre,64,34,30
False,8317029,Fischerbach,18 - 20 Jahre,49,27,22
False,8317029,Fischerbach,20 - 25 Jahre,114,68,46
False,8317029,Fischerbach,25 - 30 Jahre,79,39,40
False,8317029,Fischerbach,30 - 35 Jahre,94,58,36
False,8317029,Fischerbach,35 - 40 Jahre,94,43,51
False,8317029,Fischerbach,40 - 45 Jahre,152,71,81
False,8317029,Fischerbach,45 - 50 Jahre,161,77,84
False,8317029,Fischerbach,50 - 55 Jahre,144,81,63
False,8317029,Fischerbach,55 - 60 Jahre,86,42,44
False,8317029,Fischerbach,60 - 65 Jahre,73,33,40
False,8317029,Fischerbach,65 - 75 Jahre,203,97,106
False,8317029,Fischerbach,75 und mehr Jahre,136,57,79
False,8317029,Fischerbach,Insgesamt,1741,900,841
False,8317031,Friesenheim,unter 3 Jahre,340,189,151
False,8317031,Friesenheim,3 -  6 Jahre,323,163,160
False,8317031,Friesenheim,6 - 10 Jahre,497,241,256
False,8317031,Friesenheim,10 - 15 Jahre,696,389,307
False,8317031,Friesenheim,15 - 18 Jahre,463,240,223
False,8317031,Friesenheim,18 - 20 Jahre,287,151,136
False,8317031,Friesenheim,20 - 25 Jahre,762,417,345
False,8317031,Friesenheim,25 - 30 Jahre,767,404,363
False,8317031,Friesenheim,30 - 35 Jahre,690,355,335
False,8317031,Friesenheim,35 - 40 Jahre,717,362,355
False,8317031,Friesenheim,40 - 45 Jahre,1079,529,550
False,8317031,Friesenheim,45 - 50 Jahre,1139,571,568
False,8317031,Friesenheim,50 - 55 Jahre,1062,531,531
False,8317031,Friesenheim,55 - 60 Jahre,862,439,423
False,8317031,Friesenheim,60 - 65 Jahre,638,315,323
False,8317031,Friesenheim,65 - 75 Jahre,1238,581,657
False,8317031,Friesenheim,75 und mehr Jahre,1181,437,744
False,8317031,Friesenheim,Insgesamt,12741,6314,6427
False,8317034,"Gengenbach, Stadt",unter 3 Jahre,251,140,111
False,8317034,"Gengenbach, Stadt",3 -  6 Jahre,243,124,119
False,8317034,"Gengenbach, Stadt",6 - 10 Jahre,352,187,165
False,8317034,"Gengenbach, Stadt",10 - 15 Jahre,506,284,222
False,8317034,"Gengenbach, Stadt",15 - 18 Jahre,333,160,173
False,8317034,"Gengenbach, Stadt",18 - 20 Jahre,250,117,133
False,8317034,"Gengenbach, Stadt",20 - 25 Jahre,624,310,314
False,8317034,"Gengenbach, Stadt",25 - 30 Jahre,556,320,236
False,8317034,"Gengenbach, Stadt",30 - 35 Jahre,522,259,263
False,8317034,"Gengenbach, Stadt",35 - 40 Jahre,591,294,297
False,8317034,"Gengenbach, Stadt",40 - 45 Jahre,899,404,495
False,8317034,"Gengenbach, Stadt",45 - 50 Jahre,949,458,491
False,8317034,"Gengenbach, Stadt",50 - 55 Jahre,786,389,397
False,8317034,"Gengenbach, Stadt",55 - 60 Jahre,802,390,412
False,8317034,"Gengenbach, Stadt",60 - 65 Jahre,660,343,317
False,8317034,"Gengenbach, Stadt",65 - 75 Jahre,1324,645,679
False,8317034,"Gengenbach, Stadt",75 und mehr Jahre,1375,498,877
False,8317034,"Gengenbach, Stadt",Insgesamt,11023,5322,5701
False,8317039,Gutach (Schwarzwaldbahn),unter 3 Jahre,56,29,27
False,8317039,Gutach (Schwarzwaldbahn),3 -  6 Jahre,58,24,34
False,8317039,Gutach (Schwarzwaldbahn),6 - 10 Jahre,85,44,41
False,8317039,Gutach (Schwarzwaldbahn),10 - 15 Jahre,122,64,58
False,8317039,Gutach (Schwarzwaldbahn),15 - 18 Jahre,82,42,40
False,8317039,Gutach (Schwarzwaldbahn),18 - 20 Jahre,37,12,25
False,8317039,Gutach (Schwarzwaldbahn),20 - 25 Jahre,115,61,54
False,8317039,Gutach (Schwarzwaldbahn),25 - 30 Jahre,110,55,55
False,8317039,Gutach (Schwarzwaldbahn),30 - 35 Jahre,108,55,53
False,8317039,Gutach (Schwarzwaldbahn),35 - 40 Jahre,129,68,61
False,8317039,Gutach (Schwarzwaldbahn),40 - 45 Jahre,178,86,92
False,8317039,Gutach (Schwarzwaldbahn),45 - 50 Jahre,182,99,83
False,8317039,Gutach (Schwarzwaldbahn),50 - 55 Jahre,168,87,81
False,8317039,Gutach (Schwarzwaldbahn),55 - 60 Jahre,132,68,64
False,8317039,Gutach (Schwarzwaldbahn),60 - 65 Jahre,111,51,60
False,8317039,Gutach (Schwarzwaldbahn),65 - 75 Jahre,283,142,141
False,8317039,Gutach (Schwarzwaldbahn),75 und mehr Jahre,222,90,132
False,8317039,Gutach (Schwarzwaldbahn),Insgesamt,2178,1077,1101
False,8317040,"Haslach im Kinzigtal, Stadt",unter 3 Jahre,178,96,82
False,8317040,"Haslach im Kinzigtal, Stadt",3 -  6 Jahre,212,117,95
False,8317040,"Haslach im Kinzigtal, Stadt",6 - 10 Jahre,247,136,111
False,8317040,"Haslach im Kinzigtal, Stadt",10 - 15 Jahre,380,200,180
False,8317040,"Haslach im Kinzigtal, Stadt",15 - 18 Jahre,268,129,139
False,8317040,"Haslach im Kinzigtal, Stadt",18 - 20 Jahre,147,65,82
False,8317040,"Haslach im Kinzigtal, Stadt",20 - 25 Jahre,390,208,182
False,8317040,"Haslach im Kinzigtal, Stadt",25 - 30 Jahre,390,208,182
False,8317040,"Haslach im Kinzigtal, Stadt",30 - 35 Jahre,345,156,189
False,8317040,"Haslach im Kinzigtal, Stadt",35 - 40 Jahre,467,242,225
False,8317040,"Haslach im Kinzigtal, Stadt",40 - 45 Jahre,542,268,274
False,8317040,"Haslach im Kinzigtal, Stadt",45 - 50 Jahre,633,312,321
False,8317040,"Haslach im Kinzigtal, Stadt",50 - 55 Jahre,520,255,265
False,8317040,"Haslach im Kinzigtal, Stadt",55 - 60 Jahre,433,222,211
False,8317040,"Haslach im Kinzigtal, Stadt",60 - 65 Jahre,338,169,169
False,8317040,"Haslach im Kinzigtal, Stadt",65 - 75 Jahre,737,328,409
False,8317040,"Haslach im Kinzigtal, Stadt",75 und mehr Jahre,752,285,467
False,8317040,"Haslach im Kinzigtal, Stadt",Insgesamt,6979,3396,3583
False,8317041,"Hausach, Stadt",unter 3 Jahre,143,72,71
False,8317041,"Hausach, Stadt",3 -  6 Jahre,154,70,84
False,8317041,"Hausach, Stadt",6 - 10 Jahre,239,125,114
False,8317041,"Hausach, Stadt",10 - 15 Jahre,301,149,152
False,8317041,"Hausach, Stadt",15 - 18 Jahre,199,105,94
False,8317041,"Hausach, Stadt",18 - 20 Jahre,161,77,84
False,8317041,"Hausach, Stadt",20 - 25 Jahre,359,187,172
False,8317041,"Hausach, Stadt",25 - 30 Jahre,336,187,149
False,8317041,"Hausach, Stadt",30 - 35 Jahre,317,146,171
False,8317041,"Hausach, Stadt",35 - 40 Jahre,329,182,147
False,8317041,"Hausach, Stadt",40 - 45 Jahre,441,230,211
False,8317041,"Hausach, Stadt",45 - 50 Jahre,509,243,266
False,8317041,"Hausach, Stadt",50 - 55 Jahre,460,244,216
False,8317041,"Hausach, Stadt",55 - 60 Jahre,389,196,193
False,8317041,"Hausach, Stadt",60 - 65 Jahre,300,152,148
False,8317041,"Hausach, Stadt",65 - 75 Jahre,589,282,307
False,8317041,"Hausach, Stadt",75 und mehr Jahre,644,242,402
False,8317041,"Hausach, Stadt",Insgesamt,5870,2889,2981
False,8317046,Hofstetten,unter 3 Jahre,49,28,21
False,8317046,Hofstetten,3 -  6 Jahre,56,24,32
False,8317046,Hofstetten,6 - 10 Jahre,87,47,40
False,8317046,Hofstetten,10 - 15 Jahre,131,67,64
False,8317046,Hofstetten,15 - 18 Jahre,53,27,26
False,8317046,Hofstetten,18 - 20 Jahre,35,18,17
False,8317046,Hofstetten,20 - 25 Jahre,90,55,35
False,8317046,Hofstetten,25 - 30 Jahre,91,49,42
False,8317046,Hofstetten,30 - 35 Jahre,108,48,60
False,8317046,Hofstetten,35 - 40 Jahre,109,62,47
False,8317046,Hofstetten,40 - 45 Jahre,143,83,60
False,8317046,Hofstetten,45 - 50 Jahre,151,77,74
False,8317046,Hofstetten,50 - 55 Jahre,106,49,57
False,8317046,Hofstetten,55 - 60 Jahre,107,60,47
False,8317046,Hofstetten,60 - 65 Jahre,88,43,45
False,8317046,Hofstetten,65 - 75 Jahre,180,89,91
False,8317046,Hofstetten,75 und mehr Jahre,119,52,67
False,8317046,Hofstetten,Insgesamt,1703,878,825
False,8317047,Hohberg,unter 3 Jahre,186,100,86
False,8317047,Hohberg,3 -  6 Jahre,223,112,111
False,8317047,Hohberg,6 - 10 Jahre,319,163,156
False,8317047,Hohberg,10 - 15 Jahre,449,215,234
False,8317047,Hohberg,15 - 18 Jahre,299,159,140
False,8317047,Hohberg,18 - 20 Jahre,197,97,100
False,8317047,Hohberg,20 - 25 Jahre,479,254,225
False,8317047,Hohberg,25 - 30 Jahre,425,223,202
False,8317047,Hohberg,30 - 35 Jahre,380,178,202
False,8317047,Hohberg,35 - 40 Jahre,451,218,233
False,8317047,Hohberg,40 - 45 Jahre,677,329,348
False,8317047,Hohberg,45 - 50 Jahre,711,375,336
False,8317047,Hohberg,50 - 55 Jahre,642,338,304
False,8317047,Hohberg,55 - 60 Jahre,563,280,283
False,8317047,Hohberg,60 - 65 Jahre,421,219,202
False,8317047,Hohberg,65 - 75 Jahre,736,349,387
False,8317047,Hohberg,75 und mehr Jahre,677,253,424
False,8317047,Hohberg,Insgesamt,7835,3862,3973
False,8317051,"Hornberg, Stadt",unter 3 Jahre,114,68,46
False,8317051,"Hornberg, Stadt",3 -  6 Jahre,122,64,58
False,8317051,"Hornberg, Stadt",6 - 10 Jahre,181,90,91
False,8317051,"Hornberg, Stadt",10 - 15 Jahre,210,107,103
False,8317051,"Hornberg, Stadt",15 - 18 Jahre,132,67,65
False,8317051,"Hornberg, Stadt",18 - 20 Jahre,91,43,48
False,8317051,"Hornberg, Stadt",20 - 25 Jahre,216,113,103
False,8317051,"Hornberg, Stadt",25 - 30 Jahre,220,113,107
False,8317051,"Hornberg, Stadt",30 - 35 Jahre,231,107,124
False,8317051,"Hornberg, Stadt",35 - 40 Jahre,238,132,106
False,8317051,"Hornberg, Stadt",40 - 45 Jahre,327,171,156
False,8317051,"Hornberg, Stadt",45 - 50 Jahre,327,169,158
False,8317051,"Hornberg, Stadt",50 - 55 Jahre,350,180,170
False,8317051,"Hornberg, Stadt",55 - 60 Jahre,302,161,141
False,8317051,"Hornberg, Stadt",60 - 65 Jahre,265,148,117
False,8317051,"Hornberg, Stadt",65 - 75 Jahre,452,204,248
False,8317051,"Hornberg, Stadt",75 und mehr Jahre,516,185,331
False,8317051,"Hornberg, Stadt",Insgesamt,4294,2122,2172
False,8317056,Kappelrodeck,unter 3 Jahre,147,74,73
False,8317056,Kappelrodeck,3 -  6 Jahre,136,72,64
False,8317056,Kappelrodeck,6 - 10 Jahre,241,127,114
False,8317056,Kappelrodeck,10 - 15 Jahre,320,144,176
False,8317056,Kappelrodeck,15 - 18 Jahre,210,103,107
False,8317056,Kappelrodeck,18 - 20 Jahre,153,91,62
False,8317056,Kappelrodeck,20 - 25 Jahre,326,171,155
False,8317056,Kappelrodeck,25 - 30 Jahre,308,149,159
False,8317056,Kappelrodeck,30 - 35 Jahre,323,162,161
False,8317056,Kappelrodeck,35 - 40 Jahre,352,179,173
False,8317056,Kappelrodeck,40 - 45 Jahre,500,276,224
False,8317056,Kappelrodeck,45 - 50 Jahre,475,245,230
False,8317056,Kappelrodeck,50 - 55 Jahre,469,243,226
False,8317056,Kappelrodeck,55 - 60 Jahre,378,198,180
False,8317056,Kappelrodeck,60 - 65 Jahre,313,151,162
False,8317056,Kappelrodeck,65 - 75 Jahre,585,272,313
False,8317056,Kappelrodeck,75 und mehr Jahre,547,198,349
False,8317056,Kappelrodeck,Insgesamt,5783,2855,2928
False,8317057,"Kehl, Stadt",unter 3 Jahre,910,464,446
False,8317057,"Kehl, Stadt",3 -  6 Jahre,950,463,487
False,8317057,"Kehl, Stadt",6 - 10 Jahre,1386,709,677
False,8317057,"Kehl, Stadt",10 - 15 Jahre,1912,954,958
False,8317057,"Kehl, Stadt",15 - 18 Jahre,1099,539,560
False,8317057,"Kehl, Stadt",18 - 20 Jahre,818,431,387
False,8317057,"Kehl, Stadt",20 - 25 Jahre,2059,1067,992
False,8317057,"Kehl, Stadt",25 - 30 Jahre,1849,926,923
False,8317057,"Kehl, Stadt",30 - 35 Jahre,1981,950,1031
False,8317057,"Kehl, Stadt",35 - 40 Jahre,2161,1066,1095
False,8317057,"Kehl, Stadt",40 - 45 Jahre,2964,1468,1496
False,8317057,"Kehl, Stadt",45 - 50 Jahre,2782,1381,1401
False,8317057,"Kehl, Stadt",50 - 55 Jahre,2660,1349,1311
False,8317057,"Kehl, Stadt",55 - 60 Jahre,2416,1213,1203
False,8317057,"Kehl, Stadt",60 - 65 Jahre,2001,987,1014
False,8317057,"Kehl, Stadt",65 - 75 Jahre,3716,1780,1936
False,8317057,"Kehl, Stadt",75 und mehr Jahre,3125,1210,1915
False,8317057,"Kehl, Stadt",Insgesamt,34789,16957,17832
False,8317059,Kippenheim,unter 3 Jahre,146,65,81
False,8317059,Kippenheim,3 -  6 Jahre,151,75,76
False,8317059,Kippenheim,6 - 10 Jahre,188,107,81
False,8317059,Kippenheim,10 - 15 Jahre,279,146,133
False,8317059,Kippenheim,15 - 18 Jahre,169,78,91
False,8317059,Kippenheim,18 - 20 Jahre,115,60,55
False,8317059,Kippenheim,20 - 25 Jahre,311,161,150
False,8317059,Kippenheim,25 - 30 Jahre,286,150,136
False,8317059,Kippenheim,30 - 35 Jahre,301,149,152
False,8317059,Kippenheim,35 - 40 Jahre,263,129,134
False,8317059,Kippenheim,40 - 45 Jahre,401,215,186
False,8317059,Kippenheim,45 - 50 Jahre,477,233,244
False,8317059,Kippenheim,50 - 55 Jahre,389,204,185
False,8317059,Kippenheim,55 - 60 Jahre,383,199,184
False,8317059,Kippenheim,60 - 65 Jahre,283,147,136
False,8317059,Kippenheim,65 - 75 Jahre,527,257,270
False,8317059,Kippenheim,75 und mehr Jahre,498,193,305
False,8317059,Kippenheim,Insgesamt,5167,2568,2599
False,8317065,"Lahr/Schwarzwald, Stadt",unter 3 Jahre,1257,635,622
False,8317065,"Lahr/Schwarzwald, Stadt",3 -  6 Jahre,1317,667,650
False,8317065,"Lahr/Schwarzwald, Stadt",6 - 10 Jahre,1767,919,848
False,8317065,"Lahr/Schwarzwald, Stadt",10 - 15 Jahre,2406,1285,1121
False,8317065,"Lahr/Schwarzwald, Stadt",15 - 18 Jahre,1521,754,767
False,8317065,"Lahr/Schwarzwald, Stadt",18 - 20 Jahre,1085,556,529
False,8317065,"Lahr/Schwarzwald, Stadt",20 - 25 Jahre,2835,1448,1387
False,8317065,"Lahr/Schwarzwald, Stadt",25 - 30 Jahre,2676,1388,1288
False,8317065,"Lahr/Schwarzwald, Stadt",30 - 35 Jahre,2472,1243,1229
False,8317065,"Lahr/Schwarzwald, Stadt",35 - 40 Jahre,2662,1351,1311
False,8317065,"Lahr/Schwarzwald, Stadt",40 - 45 Jahre,3377,1691,1686
False,8317065,"Lahr/Schwarzwald, Stadt",45 - 50 Jahre,3551,1817,1734
False,8317065,"Lahr/Schwarzwald, Stadt",50 - 55 Jahre,3224,1615,1609
False,8317065,"Lahr/Schwarzwald, Stadt",55 - 60 Jahre,2923,1435,1488
False,8317065,"Lahr/Schwarzwald, Stadt",60 - 65 Jahre,2285,1139,1146
False,8317065,"Lahr/Schwarzwald, Stadt",65 - 75 Jahre,4408,2023,2385
False,8317065,"Lahr/Schwarzwald, Stadt",75 und mehr Jahre,4061,1496,2565
False,8317065,"Lahr/Schwarzwald, Stadt",Insgesamt,43827,21462,22365
False,8317067,Lautenbach,unter 3 Jahre,47,24,23
False,8317067,Lautenbach,3 -  6 Jahre,42,19,23
False,8317067,Lautenbach,6 - 10 Jahre,74,43,31
False,8317067,Lautenbach,10 - 15 Jahre,113,60,53
False,8317067,Lautenbach,15 - 18 Jahre,67,37,30
False,8317067,Lautenbach,18 - 20 Jahre,24,11,13
False,8317067,Lautenbach,20 - 25 Jahre,97,49,48
False,8317067,Lautenbach,25 - 30 Jahre,101,61,40
False,8317067,Lautenbach,30 - 35 Jahre,85,36,49
False,8317067,Lautenbach,35 - 40 Jahre,117,65,52
False,8317067,Lautenbach,40 - 45 Jahre,159,94,65
False,8317067,Lautenbach,45 - 50 Jahre,160,80,80
False,8317067,Lautenbach,50 - 55 Jahre,154,82,72
False,8317067,Lautenbach,55 - 60 Jahre,131,67,64
False,8317067,Lautenbach,60 - 65 Jahre,127,66,61
False,8317067,Lautenbach,65 - 75 Jahre,205,100,105
False,8317067,Lautenbach,75 und mehr Jahre,161,76,85
False,8317067,Lautenbach,Insgesamt,1864,970,894
False,8317068,Lauf,unter 3 Jahre,78,39,39
False,8317068,Lauf,3 -  6 Jahre,76,35,41
False,8317068,Lauf,6 - 10 Jahre,140,77,63
False,8317068,Lauf,10 - 15 Jahre,226,114,112
False,8317068,Lauf,15 - 18 Jahre,142,75,67
False,8317068,Lauf,18 - 20 Jahre,103,59,44
False,8317068,Lauf,20 - 25 Jahre,198,113,85
False,8317068,Lauf,25 - 30 Jahre,179,101,78
False,8317068,Lauf,30 - 35 Jahre,182,95,87
False,8317068,Lauf,35 - 40 Jahre,228,108,120
False,8317068,Lauf,40 - 45 Jahre,267,133,134
False,8317068,Lauf,45 - 50 Jahre,350,183,167
False,8317068,Lauf,50 - 55 Jahre,306,151,155
False,8317068,Lauf,55 - 60 Jahre,299,141,158
False,8317068,Lauf,60 - 65 Jahre,222,115,107
False,8317068,Lauf,65 - 75 Jahre,424,213,211
False,8317068,Lauf,75 und mehr Jahre,398,156,242
False,8317068,Lauf,Insgesamt,3818,1908,1910
False,8317073,"Mahlberg, Stadt",unter 3 Jahre,146,62,84
False,8317073,"Mahlberg, Stadt",3 -  6 Jahre,144,67,77
False,8317073,"Mahlberg, Stadt",6 - 10 Jahre,161,86,75
False,8317073,"Mahlberg, Stadt",10 - 15 Jahre,269,139,130
False,8317073,"Mahlberg, Stadt",15 - 18 Jahre,149,90,59
False,8317073,"Mahlberg, Stadt",18 - 20 Jahre,135,55,80
False,8317073,"Mahlberg, Stadt",20 - 25 Jahre,305,160,145
False,8317073,"Mahlberg, Stadt",25 - 30 Jahre,301,164,137
False,8317073,"Mahlberg, Stadt",30 - 35 Jahre,318,150,168
False,8317073,"Mahlberg, Stadt",35 - 40 Jahre,258,137,121
False,8317073,"Mahlberg, Stadt",40 - 45 Jahre,410,202,208
False,8317073,"Mahlberg, Stadt",45 - 50 Jahre,486,230,256
False,8317073,"Mahlberg, Stadt",50 - 55 Jahre,406,202,204
False,8317073,"Mahlberg, Stadt",55 - 60 Jahre,294,158,136
False,8317073,"Mahlberg, Stadt",60 - 65 Jahre,227,110,117
False,8317073,"Mahlberg, Stadt",65 - 75 Jahre,373,175,198
False,8317073,"Mahlberg, Stadt",75 und mehr Jahre,321,116,205
False,8317073,"Mahlberg, Stadt",Insgesamt,4703,2303,2400
False,8317075,Meißenheim,unter 3 Jahre,89,47,42
False,8317075,Meißenheim,3 -  6 Jahre,108,52,56
False,8317075,Meißenheim,6 - 10 Jahre,147,81,66
False,8317075,Meißenheim,10 - 15 Jahre,211,104,107
False,8317075,Meißenheim,15 - 18 Jahre,132,65,67
False,8317075,Meißenheim,18 - 20 Jahre,92,52,40
False,8317075,Meißenheim,20 - 25 Jahre,198,110,88
False,8317075,Meißenheim,25 - 30 Jahre,174,84,90
False,8317075,Meißenheim,30 - 35 Jahre,195,104,91
False,8317075,Meißenheim,35 - 40 Jahre,209,93,116
False,8317075,Meißenheim,40 - 45 Jahre,345,191,154
False,8317075,Meißenheim,45 - 50 Jahre,332,176,156
False,8317075,Meißenheim,50 - 55 Jahre,319,170,149
False,8317075,Meißenheim,55 - 60 Jahre,266,129,137
False,8317075,Meißenheim,60 - 65 Jahre,200,100,100
False,8317075,Meißenheim,65 - 75 Jahre,370,176,194
False,8317075,Meißenheim,75 und mehr Jahre,344,137,207
False,8317075,Meißenheim,Insgesamt,3731,1871,1860
False,8317078,Mühlenbach,unter 3 Jahre,50,27,23
False,8317078,Mühlenbach,3 -  6 Jahre,51,27,24
False,8317078,Mühlenbach,6 - 10 Jahre,72,47,25
False,8317078,Mühlenbach,10 - 15 Jahre,119,69,50
False,8317078,Mühlenbach,15 - 18 Jahre,65,26,39
False,8317078,Mühlenbach,18 - 20 Jahre,47,30,17
False,8317078,Mühlenbach,20 - 25 Jahre,111,51,60
False,8317078,Mühlenbach,25 - 30 Jahre,81,43,38
False,8317078,Mühlenbach,30 - 35 Jahre,88,35,53
False,8317078,Mühlenbach,35 - 40 Jahre,103,50,53
False,8317078,Mühlenbach,40 - 45 Jahre,151,75,76
False,8317078,Mühlenbach,45 - 50 Jahre,130,67,63
False,8317078,Mühlenbach,50 - 55 Jahre,123,73,50
False,8317078,Mühlenbach,55 - 60 Jahre,96,57,39
False,8317078,Mühlenbach,60 - 65 Jahre,68,30,38
False,8317078,Mühlenbach,65 - 75 Jahre,163,82,81
False,8317078,Mühlenbach,75 und mehr Jahre,150,70,80
False,8317078,Mühlenbach,Insgesamt,1668,859,809
False,8317085,Nordrach,unter 3 Jahre,46,21,25
False,8317085,Nordrach,3 -  6 Jahre,45,25,20
False,8317085,Nordrach,6 - 10 Jahre,74,32,42
False,8317085,Nordrach,10 - 15 Jahre,144,72,72
False,8317085,Nordrach,15 - 18 Jahre,78,39,39
False,8317085,Nordrach,18 - 20 Jahre,52,26,26
False,8317085,Nordrach,20 - 25 Jahre,79,43,36
False,8317085,Nordrach,25 - 30 Jahre,90,56,34
False,8317085,Nordrach,30 - 35 Jahre,83,33,50
False,8317085,Nordrach,35 - 40 Jahre,91,45,46
False,8317085,Nordrach,40 - 45 Jahre,207,113,94
False,8317085,Nordrach,45 - 50 Jahre,173,88,85
False,8317085,Nordrach,50 - 55 Jahre,165,96,69
False,8317085,Nordrach,55 - 60 Jahre,133,69,64
False,8317085,Nordrach,60 - 65 Jahre,118,63,55
False,8317085,Nordrach,65 - 75 Jahre,230,123,107
False,8317085,Nordrach,75 und mehr Jahre,166,73,93
False,8317085,Nordrach,Insgesamt,1974,1017,957
False,8317088,Oberharmersbach,unter 3 Jahre,59,31,28
False,8317088,Oberharmersbach,3 -  6 Jahre,65,34,31
False,8317088,Oberharmersbach,6 - 10 Jahre,103,53,50
False,8317088,Oberharmersbach,10 - 15 Jahre,182,98,84
False,8317088,Oberharmersbach,15 - 18 Jahre,105,54,51
False,8317088,Oberharmersbach,18 - 20 Jahre,85,43,42
False,8317088,Oberharmersbach,20 - 25 Jahre,179,103,76
False,8317088,Oberharmersbach,25 - 30 Jahre,142,76,66
False,8317088,Oberharmersbach,30 - 35 Jahre,100,65,35
False,8317088,Oberharmersbach,35 - 40 Jahre,134,61,73
False,8317088,Oberharmersbach,40 - 45 Jahre,203,108,95
False,8317088,Oberharmersbach,45 - 50 Jahre,234,123,111
False,8317088,Oberharmersbach,50 - 55 Jahre,199,105,94
False,8317088,Oberharmersbach,55 - 60 Jahre,150,85,65
False,8317088,Oberharmersbach,60 - 65 Jahre,107,51,56
False,8317088,Oberharmersbach,65 - 75 Jahre,236,109,127
False,8317088,Oberharmersbach,75 und mehr Jahre,218,92,126
False,8317088,Oberharmersbach,Insgesamt,2501,1291,1210
False,8317089,"Oberkirch, Stadt",unter 3 Jahre,511,253,258
False,8317089,"Oberkirch, Stadt",3 -  6 Jahre,534,250,284
False,8317089,"Oberkirch, Stadt",6 - 10 Jahre,795,411,384
False,8317089,"Oberkirch, Stadt",10 - 15 Jahre,1183,602,581
False,8317089,"Oberkirch, Stadt",15 - 18 Jahre,779,391,388
False,8317089,"Oberkirch, Stadt",18 - 20 Jahre,563,295,268
False,8317089,"Oberkirch, Stadt",20 - 25 Jahre,1271,688,583
False,8317089,"Oberkirch, Stadt",25 - 30 Jahre,1139,581,558
False,8317089,"Oberkirch, Stadt",30 - 35 Jahre,996,513,483
False,8317089,"Oberkirch, Stadt",35 - 40 Jahre,1127,540,587
False,8317089,"Oberkirch, Stadt",40 - 45 Jahre,1580,789,791
False,8317089,"Oberkirch, Stadt",45 - 50 Jahre,1760,901,859
False,8317089,"Oberkirch, Stadt",50 - 55 Jahre,1560,809,751
False,8317089,"Oberkirch, Stadt",55 - 60 Jahre,1318,657,661
False,8317089,"Oberkirch, Stadt",60 - 65 Jahre,1051,524,527
False,8317089,"Oberkirch, Stadt",65 - 75 Jahre,1997,975,1022
False,8317089,"Oberkirch, Stadt",75 und mehr Jahre,1797,701,1096
False,8317089,"Oberkirch, Stadt",Insgesamt,19961,9880,10081
False,8317093,Oberwolfach,unter 3 Jahre,67,32,35
False,8317093,Oberwolfach,3 -  6 Jahre,83,44,39
False,8317093,Oberwolfach,6 - 10 Jahre,130,60,70
False,8317093,Oberwolfach,10 - 15 Jahre,182,90,92
False,8317093,Oberwolfach,15 - 18 Jahre,122,64,58
False,8317093,Oberwolfach,18 - 20 Jahre,58,35,23
False,8317093,Oberwolfach,20 - 25 Jahre,124,57,67
False,8317093,Oberwolfach,25 - 30 Jahre,143,70,73
False,8317093,Oberwolfach,30 - 35 Jahre,149,65,84
False,8317093,Oberwolfach,35 - 40 Jahre,158,88,70
False,8317093,Oberwolfach,40 - 45 Jahre,232,118,114
False,8317093,Oberwolfach,45 - 50 Jahre,244,150,94
False,8317093,Oberwolfach,50 - 55 Jahre,187,82,105
False,8317093,Oberwolfach,55 - 60 Jahre,154,75,79
False,8317093,Oberwolfach,60 - 65 Jahre,124,67,57
False,8317093,Oberwolfach,65 - 75 Jahre,295,146,149
False,8317093,Oberwolfach,75 und mehr Jahre,277,118,159
False,8317093,Oberwolfach,Insgesamt,2729,1361,1368
False,8317096,"Offenburg, Stadt",unter 3 Jahre,1519,769,750
False,8317096,"Offenburg, Stadt",3 -  6 Jahre,1531,778,753
False,8317096,"Offenburg, Stadt",6 - 10 Jahre,2176,1078,1098
False,8317096,"Offenburg, Stadt",10 - 15 Jahre,3051,1568,1483
False,8317096,"Offenburg, Stadt",15 - 18 Jahre,1992,1041,951
False,8317096,"Offenburg, Stadt",18 - 20 Jahre,1314,691,623
False,8317096,"Offenburg, Stadt",20 - 25 Jahre,3568,1918,1650
False,8317096,"Offenburg, Stadt",25 - 30 Jahre,3787,1932,1855
False,8317096,"Offenburg, Stadt",30 - 35 Jahre,3537,1783,1754
False,8317096,"Offenburg, Stadt",35 - 40 Jahre,3633,1737,1896
False,8317096,"Offenburg, Stadt",40 - 45 Jahre,4657,2346,2311
False,8317096,"Offenburg, Stadt",45 - 50 Jahre,4803,2451,2352
False,8317096,"Offenburg, Stadt",50 - 55 Jahre,4473,2232,2241
False,8317096,"Offenburg, Stadt",55 - 60 Jahre,3959,1915,2044
False,8317096,"Offenburg, Stadt",60 - 65 Jahre,3221,1534,1687
False,8317096,"Offenburg, Stadt",65 - 75 Jahre,6409,2977,3432
False,8317096,"Offenburg, Stadt",75 und mehr Jahre,5585,2064,3521
False,8317096,"Offenburg, Stadt",Insgesamt,59215,28814,30401
False,8317097,Ohlsbach,unter 3 Jahre,70,29,41
False,8317097,Ohlsbach,3 -  6 Jahre,77,36,41
False,8317097,Ohlsbach,6 - 10 Jahre,142,85,57
False,8317097,Ohlsbach,10 - 15 Jahre,209,109,100
False,8317097,Ohlsbach,15 - 18 Jahre,105,52,53
False,8317097,Ohlsbach,18 - 20 Jahre,77,43,34
False,8317097,Ohlsbach,20 - 25 Jahre,183,97,86
False,8317097,Ohlsbach,25 - 30 Jahre,166,85,81
False,8317097,Ohlsbach,30 - 35 Jahre,136,69,67
False,8317097,Ohlsbach,35 - 40 Jahre,186,82,104
False,8317097,Ohlsbach,40 - 45 Jahre,311,144,167
False,8317097,Ohlsbach,45 - 50 Jahre,323,175,148
False,8317097,Ohlsbach,50 - 55 Jahre,259,140,119
False,8317097,Ohlsbach,55 - 60 Jahre,207,92,115
False,8317097,Ohlsbach,60 - 65 Jahre,188,88,100
False,8317097,Ohlsbach,65 - 75 Jahre,328,169,159
False,8317097,Ohlsbach,75 und mehr Jahre,264,117,147
False,8317097,Ohlsbach,Insgesamt,3231,1612,1619
False,8317098,"Oppenau, Stadt",unter 3 Jahre,115,53,62
False,8317098,"Oppenau, Stadt",3 -  6 Jahre,129,65,64
False,8317098,"Oppenau, Stadt",6 - 10 Jahre,195,110,85
False,8317098,"Oppenau, Stadt",10 - 15 Jahre,275,145,130
False,8317098,"Oppenau, Stadt",15 - 18 Jahre,161,80,81
False,8317098,"Oppenau, Stadt",18 - 20 Jahre,128,67,61
False,8317098,"Oppenau, Stadt",20 - 25 Jahre,304,163,141
False,8317098,"Oppenau, Stadt",25 - 30 Jahre,243,123,120
False,8317098,"Oppenau, Stadt",30 - 35 Jahre,217,108,109
False,8317098,"Oppenau, Stadt",35 - 40 Jahre,258,135,123
False,8317098,"Oppenau, Stadt",40 - 45 Jahre,392,217,175
False,8317098,"Oppenau, Stadt",45 - 50 Jahre,414,221,193
False,8317098,"Oppenau, Stadt",50 - 55 Jahre,336,164,172
False,8317098,"Oppenau, Stadt",55 - 60 Jahre,318,171,147
False,8317098,"Oppenau, Stadt",60 - 65 Jahre,242,124,118
False,8317098,"Oppenau, Stadt",65 - 75 Jahre,531,246,285
False,8317098,"Oppenau, Stadt",75 und mehr Jahre,592,217,375
False,8317098,"Oppenau, Stadt",Insgesamt,4850,2409,2441
False,8317100,Ortenberg,unter 3 Jahre,73,39,34
False,8317100,Ortenberg,3 -  6 Jahre,78,42,36
False,8317100,Ortenberg,6 - 10 Jahre,146,80,66
False,8317100,Ortenberg,10 - 15 Jahre,216,114,102
False,8317100,Ortenberg,15 - 18 Jahre,115,64,51
False,8317100,Ortenberg,18 - 20 Jahre,77,39,38
False,8317100,Ortenberg,20 - 25 Jahre,160,77,83
False,8317100,Ortenberg,25 - 30 Jahre,148,71,77
False,8317100,Ortenberg,30 - 35 Jahre,190,96,94
False,8317100,Ortenberg,35 - 40 Jahre,189,80,109
False,8317100,Ortenberg,40 - 45 Jahre,281,160,121
False,8317100,Ortenberg,45 - 50 Jahre,319,168,151
False,8317100,Ortenberg,50 - 55 Jahre,257,135,122
False,8317100,Ortenberg,55 - 60 Jahre,233,107,126
False,8317100,Ortenberg,60 - 65 Jahre,190,91,99
False,8317100,Ortenberg,65 - 75 Jahre,348,162,186
False,8317100,Ortenberg,75 und mehr Jahre,329,134,195
False,8317100,Ortenberg,Insgesamt,3349,1659,1690
False,8317102,Ottenhöfen im Schwarzwald,unter 3 Jahre,70,32,38
False,8317102,Ottenhöfen im Schwarzwald,3 -  6 Jahre,84,44,40
False,8317102,Ottenhöfen im Schwarzwald,6 - 10 Jahre,136,62,74
False,8317102,Ottenhöfen im Schwarzwald,10 - 15 Jahre,217,110,107
False,8317102,Ottenhöfen im Schwarzwald,15 - 18 Jahre,135,72,63
False,8317102,Ottenhöfen im Schwarzwald,18 - 20 Jahre,90,38,52
False,8317102,Ottenhöfen im Schwarzwald,20 - 25 Jahre,198,106,92
False,8317102,Ottenhöfen im Schwarzwald,25 - 30 Jahre,182,92,90
False,8317102,Ottenhöfen im Schwarzwald,30 - 35 Jahre,165,86,79
False,8317102,Ottenhöfen im Schwarzwald,35 - 40 Jahre,169,81,88
False,8317102,Ottenhöfen im Schwarzwald,40 - 45 Jahre,273,140,133
False,8317102,Ottenhöfen im Schwarzwald,45 - 50 Jahre,272,136,136
False,8317102,Ottenhöfen im Schwarzwald,50 - 55 Jahre,219,119,100
False,8317102,Ottenhöfen im Schwarzwald,55 - 60 Jahre,176,92,84
False,8317102,Ottenhöfen im Schwarzwald,60 - 65 Jahre,162,79,83
False,8317102,Ottenhöfen im Schwarzwald,65 - 75 Jahre,352,163,189
False,8317102,Ottenhöfen im Schwarzwald,75 und mehr Jahre,371,155,216
False,8317102,Ottenhöfen im Schwarzwald,Insgesamt,3271,1607,1664
False,8317110,"Renchen, Stadt",unter 3 Jahre,163,87,76
False,8317110,"Renchen, Stadt",3 -  6 Jahre,206,115,91
False,8317110,"Renchen, Stadt",6 - 10 Jahre,288,161,127
False,8317110,"Renchen, Stadt",10 - 15 Jahre,394,213,181
False,8317110,"Renchen, Stadt",15 - 18 Jahre,282,135,147
False,8317110,"Renchen, Stadt",18 - 20 Jahre,200,89,111
False,8317110,"Renchen, Stadt",20 - 25 Jahre,483,233,250
False,8317110,"Renchen, Stadt",25 - 30 Jahre,404,217,187
False,8317110,"Renchen, Stadt",30 - 35 Jahre,386,194,192
False,8317110,"Renchen, Stadt",35 - 40 Jahre,458,226,232
False,8317110,"Renchen, Stadt",40 - 45 Jahre,640,316,324
False,8317110,"Renchen, Stadt",45 - 50 Jahre,701,356,345
False,8317110,"Renchen, Stadt",50 - 55 Jahre,548,282,266
False,8317110,"Renchen, Stadt",55 - 60 Jahre,512,259,253
False,8317110,"Renchen, Stadt",60 - 65 Jahre,349,189,160
False,8317110,"Renchen, Stadt",65 - 75 Jahre,706,328,378
False,8317110,"Renchen, Stadt",75 und mehr Jahre,625,252,373
False,8317110,"Renchen, Stadt",Insgesamt,7345,3652,3693
False,8317113,Ringsheim,unter 3 Jahre,71,36,35
False,8317113,Ringsheim,3 -  6 Jahre,65,30,35
False,8317113,Ringsheim,6 - 10 Jahre,87,54,33
False,8317113,Ringsheim,10 - 15 Jahre,125,86,39
False,8317113,Ringsheim,15 - 18 Jahre,64,33,31
False,8317113,Ringsheim,18 - 20 Jahre,31,19,12
False,8317113,Ringsheim,20 - 25 Jahre,103,56,47
False,8317113,Ringsheim,25 - 30 Jahre,120,48,72
False,8317113,Ringsheim,30 - 35 Jahre,150,66,84
False,8317113,Ringsheim,35 - 40 Jahre,135,75,60
False,8317113,Ringsheim,40 - 45 Jahre,187,105,82
False,8317113,Ringsheim,45 - 50 Jahre,197,96,101
False,8317113,Ringsheim,50 - 55 Jahre,169,87,82
False,8317113,Ringsheim,55 - 60 Jahre,162,86,76
False,8317113,Ringsheim,60 - 65 Jahre,117,60,57
False,8317113,Ringsheim,65 - 75 Jahre,244,122,122
False,8317113,Ringsheim,75 und mehr Jahre,194,76,118
False,8317113,Ringsheim,Insgesamt,2221,1135,1086
False,8317114,Rust,unter 3 Jahre,112,57,55
False,8317114,Rust,3 -  6 Jahre,94,44,50
False,8317114,Rust,6 - 10 Jahre,128,68,60
False,8317114,Rust,10 - 15 Jahre,229,126,103
False,8317114,Rust,15 - 18 Jahre,132,63,69
False,8317114,Rust,18 - 20 Jahre,84,47,37
False,8317114,Rust,20 - 25 Jahre,273,141,132
False,8317114,Rust,25 - 30 Jahre,297,146,151
False,8317114,Rust,30 - 35 Jahre,264,131,133
False,8317114,Rust,35 - 40 Jahre,236,124,112
False,8317114,Rust,40 - 45 Jahre,334,150,184
False,8317114,Rust,45 - 50 Jahre,314,153,161
False,8317114,Rust,50 - 55 Jahre,285,151,134
False,8317114,Rust,55 - 60 Jahre,237,124,113
False,8317114,Rust,60 - 65 Jahre,205,116,89
False,8317114,Rust,65 - 75 Jahre,297,147,150
False,8317114,Rust,75 und mehr Jahre,215,77,138
False,8317114,Rust,Insgesamt,3736,1865,1871
False,8317116,Sasbach,unter 3 Jahre,111,65,46
False,8317116,Sasbach,3 -  6 Jahre,141,72,69
False,8317116,Sasbach,6 - 10 Jahre,195,96,99
False,8317116,Sasbach,10 - 15 Jahre,315,149,166
False,8317116,Sasbach,15 - 18 Jahre,184,100,84
False,8317116,Sasbach,18 - 20 Jahre,144,67,77
False,8317116,Sasbach,20 - 25 Jahre,325,186,139
False,8317116,Sasbach,25 - 30 Jahre,249,135,114
False,8317116,Sasbach,30 - 35 Jahre,264,137,127
False,8317116,Sasbach,35 - 40 Jahre,377,197,180
False,8317116,Sasbach,40 - 45 Jahre,496,282,214
False,8317116,Sasbach,45 - 50 Jahre,489,267,222
False,8317116,Sasbach,50 - 55 Jahre,388,200,188
False,8317116,Sasbach,55 - 60 Jahre,346,167,179
False,8317116,Sasbach,60 - 65 Jahre,307,158,149
False,8317116,Sasbach,65 - 75 Jahre,528,245,283
False,8317116,Sasbach,75 und mehr Jahre,587,177,410
False,8317116,Sasbach,Insgesamt,5446,2700,2746
False,8317118,Sasbachwalden,unter 3 Jahre,39,22,17
False,8317118,Sasbachwalden,3 -  6 Jahre,51,26,25
False,8317118,Sasbachwalden,6 - 10 Jahre,95,51,44
False,8317118,Sasbachwalden,10 - 15 Jahre,120,57,63
False,8317118,Sasbachwalden,15 - 18 Jahre,69,36,33
False,8317118,Sasbachwalden,18 - 20 Jahre,47,28,19
False,8317118,Sasbachwalden,20 - 25 Jahre,104,58,46
False,8317118,Sasbachwalden,25 - 30 Jahre,97,47,50
False,8317118,Sasbachwalden,30 - 35 Jahre,85,44,41
False,8317118,Sasbachwalden,35 - 40 Jahre,126,60,66
False,8317118,Sasbachwalden,40 - 45 Jahre,226,121,105
False,8317118,Sasbachwalden,45 - 50 Jahre,211,110,101
False,8317118,Sasbachwalden,50 - 55 Jahre,195,104,91
False,8317118,Sasbachwalden,55 - 60 Jahre,192,100,92
False,8317118,Sasbachwalden,60 - 65 Jahre,154,71,83
False,8317118,Sasbachwalden,65 - 75 Jahre,339,168,171
False,8317118,Sasbachwalden,75 und mehr Jahre,289,111,178
False,8317118,Sasbachwalden,Insgesamt,2439,1214,1225
False,8317121,Schuttertal,unter 3 Jahre,73,39,34
False,8317121,Schuttertal,3 -  6 Jahre,89,49,40
False,8317121,Schuttertal,6 - 10 Jahre,151,57,94
False,8317121,Schuttertal,10 - 15 Jahre,226,117,109
False,8317121,Schuttertal,15 - 18 Jahre,134,71,63
False,8317121,Schuttertal,18 - 20 Jahre,70,37,33
False,8317121,Schuttertal,20 - 25 Jahre,220,120,100
False,8317121,Schuttertal,25 - 30 Jahre,146,84,62
False,8317121,Schuttertal,30 - 35 Jahre,145,74,71
False,8317121,Schuttertal,35 - 40 Jahre,181,94,87
False,8317121,Schuttertal,40 - 45 Jahre,264,136,128
False,8317121,Schuttertal,45 - 50 Jahre,316,168,148
False,8317121,Schuttertal,50 - 55 Jahre,258,136,122
False,8317121,Schuttertal,55 - 60 Jahre,189,104,85
False,8317121,Schuttertal,60 - 65 Jahre,157,88,69
False,8317121,Schuttertal,65 - 75 Jahre,307,137,170
False,8317121,Schuttertal,75 und mehr Jahre,302,125,177
False,8317121,Schuttertal,Insgesamt,3228,1636,1592
False,8317122,Schutterwald,unter 3 Jahre,142,75,67
False,8317122,Schutterwald,3 -  6 Jahre,183,91,92
False,8317122,Schutterwald,6 - 10 Jahre,264,141,123
False,8317122,Schutterwald,10 - 15 Jahre,405,228,177
False,8317122,Schutterwald,15 - 18 Jahre,285,149,136
False,8317122,Schutterwald,18 - 20 Jahre,174,96,78
False,8317122,Schutterwald,20 - 25 Jahre,432,249,183
False,8317122,Schutterwald,25 - 30 Jahre,362,185,177
False,8317122,Schutterwald,30 - 35 Jahre,291,144,147
False,8317122,Schutterwald,35 - 40 Jahre,409,209,200
False,8317122,Schutterwald,40 - 45 Jahre,605,304,301
False,8317122,Schutterwald,45 - 50 Jahre,641,321,320
False,8317122,Schutterwald,50 - 55 Jahre,559,305,254
False,8317122,Schutterwald,55 - 60 Jahre,484,246,238
False,8317122,Schutterwald,60 - 65 Jahre,419,203,216
False,8317122,Schutterwald,65 - 75 Jahre,838,404,434
False,8317122,Schutterwald,75 und mehr Jahre,680,293,387
False,8317122,Schutterwald,Insgesamt,7173,3643,3530
False,8317126,Seebach,unter 3 Jahre,39,23,16
False,8317126,Seebach,3 -  6 Jahre,37,20,17
False,8317126,Seebach,6 - 10 Jahre,64,36,28
False,8317126,Seebach,10 - 15 Jahre,82,47,35
False,8317126,Seebach,15 - 18 Jahre,67,41,26
False,8317126,Seebach,18 - 20 Jahre,35,14,21
False,8317126,Seebach,20 - 25 Jahre,75,34,41
False,8317126,Seebach,25 - 30 Jahre,76,43,33
False,8317126,Seebach,30 - 35 Jahre,64,30,34
False,8317126,Seebach,35 - 40 Jahre,93,57,36
False,8317126,Seebach,40 - 45 Jahre,129,63,66
False,8317126,Seebach,45 - 50 Jahre,128,61,67
False,8317126,Seebach,50 - 55 Jahre,121,68,53
False,8317126,Seebach,55 - 60 Jahre,82,47,35
False,8317126,Seebach,60 - 65 Jahre,64,23,41
False,8317126,Seebach,65 - 75 Jahre,153,76,77
False,8317126,Seebach,75 und mehr Jahre,139,57,82
False,8317126,Seebach,Insgesamt,1448,740,708
False,8317127,Seelbach,unter 3 Jahre,129,68,61
False,8317127,Seelbach,3 -  6 Jahre,109,59,50
False,8317127,Seelbach,6 - 10 Jahre,162,76,86
False,8317127,Seelbach,10 - 15 Jahre,258,130,128
False,8317127,Seelbach,15 - 18 Jahre,180,80,100
False,8317127,Seelbach,18 - 20 Jahre,123,63,60
False,8317127,Seelbach,20 - 25 Jahre,300,171,129
False,8317127,Seelbach,25 - 30 Jahre,231,113,118
False,8317127,Seelbach,30 - 35 Jahre,253,130,123
False,8317127,Seelbach,35 - 40 Jahre,243,139,104
False,8317127,Seelbach,40 - 45 Jahre,356,169,187
False,8317127,Seelbach,45 - 50 Jahre,490,249,241
False,8317127,Seelbach,50 - 55 Jahre,412,210,202
False,8317127,Seelbach,55 - 60 Jahre,331,162,169
False,8317127,Seelbach,60 - 65 Jahre,319,164,155
False,8317127,Seelbach,65 - 75 Jahre,610,299,311
False,8317127,Seelbach,75 und mehr Jahre,520,193,327
False,8317127,Seelbach,Insgesamt,5026,2475,2551
False,8317129,Steinach,unter 3 Jahre,120,64,56
False,8317129,Steinach,3 -  6 Jahre,141,74,67
False,8317129,Steinach,6 - 10 Jahre,182,94,88
False,8317129,Steinach,10 - 15 Jahre,242,124,118
False,8317129,Steinach,15 - 18 Jahre,148,72,76
False,8317129,Steinach,18 - 20 Jahre,89,44,45
False,8317129,Steinach,20 - 25 Jahre,253,130,123
False,8317129,Steinach,25 - 30 Jahre,206,108,98
False,8317129,Steinach,30 - 35 Jahre,203,106,97
False,8317129,Steinach,35 - 40 Jahre,254,129,125
False,8317129,Steinach,40 - 45 Jahre,317,173,144
False,8317129,Steinach,45 - 50 Jahre,366,196,170
False,8317129,Steinach,50 - 55 Jahre,312,168,144
False,8317129,Steinach,55 - 60 Jahre,269,131,138
False,8317129,Steinach,60 - 65 Jahre,164,86,78
False,8317129,Steinach,65 - 75 Jahre,360,174,186
False,8317129,Steinach,75 und mehr Jahre,314,128,186
False,8317129,Steinach,Insgesamt,3940,2001,1939
False,8317141,Willstätt,unter 3 Jahre,234,125,109
False,8317141,Willstätt,3 -  6 Jahre,269,141,128
False,8317141,Willstätt,6 - 10 Jahre,318,158,160
False,8317141,Willstätt,10 - 15 Jahre,540,272,268
False,8317141,Willstätt,15 - 18 Jahre,329,173,156
False,8317141,Willstätt,18 - 20 Jahre,240,130,110
False,8317141,Willstätt,20 - 25 Jahre,543,296,247
False,8317141,Willstätt,25 - 30 Jahre,509,238,271
False,8317141,Willstätt,30 - 35 Jahre,479,243,236
False,8317141,Willstätt,35 - 40 Jahre,581,290,291
False,8317141,Willstätt,40 - 45 Jahre,766,383,383
False,8317141,Willstätt,45 - 50 Jahre,859,441,418
False,8317141,Willstätt,50 - 55 Jahre,765,386,379
False,8317141,Willstätt,55 - 60 Jahre,655,315,340
False,8317141,Willstätt,60 - 65 Jahre,494,254,240
False,8317141,Willstätt,65 - 75 Jahre,835,401,434
False,8317141,Willstätt,75 und mehr Jahre,680,274,406
False,8317141,Willstätt,Insgesamt,9096,4520,4576
False,8317145,"Wolfach, Stadt",unter 3 Jahre,157,76,81
False,8317145,"Wolfach, Stadt",3 -  6 Jahre,166,87,79
False,8317145,"Wolfach, Stadt",6 - 10 Jahre,204,108,96
False,8317145,"Wolfach, Stadt",10 - 15 Jahre,279,154,125
False,8317145,"Wolfach, Stadt",15 - 18 Jahre,187,100,87
False,8317145,"Wolfach, Stadt",18 - 20 Jahre,133,74,59
False,8317145,"Wolfach, Stadt",20 - 25 Jahre,292,157,135
False,8317145,"Wolfach, Stadt",25 - 30 Jahre,301,150,151
False,8317145,"Wolfach, Stadt",30 - 35 Jahre,320,147,173
False,8317145,"Wolfach, Stadt",35 - 40 Jahre,350,200,150
False,8317145,"Wolfach, Stadt",40 - 45 Jahre,436,219,217
False,8317145,"Wolfach, Stadt",45 - 50 Jahre,546,310,236
False,8317145,"Wolfach, Stadt",50 - 55 Jahre,398,202,196
False,8317145,"Wolfach, Stadt",55 - 60 Jahre,438,214,224
False,8317145,"Wolfach, Stadt",60 - 65 Jahre,321,177,144
False,8317145,"Wolfach, Stadt",65 - 75 Jahre,687,331,356
False,8317145,"Wolfach, Stadt",75 und mehr Jahre,610,227,383
False,8317145,"Wolfach, Stadt",Insgesamt,5825,2933,2892
False,8317146,"Zell am Harmersbach, Stadt",unter 3 Jahre,208,107,101
False,8317146,"Zell am Harmersbach, Stadt",3 -  6 Jahre,216,108,108
False,8317146,"Zell am Harmersbach, Stadt",6 - 10 Jahre,301,157,144
False,8317146,"Zell am Harmersbach, Stadt",10 - 15 Jahre,446,235,211
False,8317146,"Zell am Harmersbach, Stadt",15 - 18 Jahre,246,124,122
False,8317146,"Zell am Harmersbach, Stadt",18 - 20 Jahre,197,109,88
False,8317146,"Zell am Harmersbach, Stadt",20 - 25 Jahre,490,261,229
False,8317146,"Zell am Harmersbach, Stadt",25 - 30 Jahre,438,227,211
False,8317146,"Zell am Harmersbach, Stadt",30 - 35 Jahre,444,220,224
False,8317146,"Zell am Harmersbach, Stadt",35 - 40 Jahre,496,251,245
False,8317146,"Zell am Harmersbach, Stadt",40 - 45 Jahre,611,309,302
False,8317146,"Zell am Harmersbach, Stadt",45 - 50 Jahre,694,355,339
False,8317146,"Zell am Harmersbach, Stadt",50 - 55 Jahre,635,316,319
False,8317146,"Zell am Harmersbach, Stadt",55 - 60 Jahre,599,302,297
False,8317146,"Zell am Harmersbach, Stadt",60 - 65 Jahre,433,216,217
False,8317146,"Zell am Harmersbach, Stadt",65 - 75 Jahre,875,420,455
False,8317146,"Zell am Harmersbach, Stadt",75 und mehr Jahre,734,274,460
False,8317146,"Zell am Harmersbach, Stadt",Insgesamt,8063,3991,4072
False,8317150,Schwanau,unter 3 Jahre,169,95,74
False,8317150,Schwanau,3 -  6 Jahre,184,101,83
False,8317150,Schwanau,6 - 10 Jahre,284,154,130
False,8317150,Schwanau,10 - 15 Jahre,416,226,190
False,8317150,Schwanau,15 - 18 Jahre,239,117,122
False,8317150,Schwanau,18 - 20 Jahre,158,71,87
False,8317150,Schwanau,20 - 25 Jahre,394,190,204
False,8317150,Schwanau,25 - 30 Jahre,363,183,180
False,8317150,Schwanau,30 - 35 Jahre,335,174,161
False,8317150,Schwanau,35 - 40 Jahre,417,194,223
False,8317150,Schwanau,40 - 45 Jahre,594,302,292
False,8317150,Schwanau,45 - 50 Jahre,653,333,320
False,8317150,Schwanau,50 - 55 Jahre,490,242,248
False,8317150,Schwanau,55 - 60 Jahre,440,223,217
False,8317150,Schwanau,60 - 65 Jahre,356,188,168
False,8317150,Schwanau,65 - 75 Jahre,688,323,365
False,8317150,Schwanau,75 und mehr Jahre,666,194,472
False,8317150,Schwanau,Insgesamt,6846,3310,3536
False,8317151,Neuried,unter 3 Jahre,202,107,95
False,8317151,Neuried,3 -  6 Jahre,251,124,127
False,8317151,Neuried,6 - 10 Jahre,384,176,208
False,8317151,Neuried,10 - 15 Jahre,563,295,268
False,8317151,Neuried,15 - 18 Jahre,353,189,164
False,8317151,Neuried,18 - 20 Jahre,275,144,131
False,8317151,Neuried,20 - 25 Jahre,590,314,276
False,8317151,Neuried,25 - 30 Jahre,511,248,263
False,8317151,Neuried,30 - 35 Jahre,503,241,262
False,8317151,Neuried,35 - 40 Jahre,521,240,281
False,8317151,Neuried,40 - 45 Jahre,814,393,421
False,8317151,Neuried,45 - 50 Jahre,893,468,425
False,8317151,Neuried,50 - 55 Jahre,768,385,383
False,8317151,Neuried,55 - 60 Jahre,636,325,311
False,8317151,Neuried,60 - 65 Jahre,508,260,248
False,8317151,Neuried,65 - 75 Jahre,853,406,447
False,8317151,Neuried,75 und mehr Jahre,824,298,526
False,8317151,Neuried,Insgesamt,9449,4613,4836
False,8317152,Kappel-Grafenhausen,unter 3 Jahre,128,70,58
False,8317152,Kappel-Grafenhausen,3 -  6 Jahre,130,65,65
False,8317152,Kappel-Grafenhausen,6 - 10 Jahre,193,92,101
False,8317152,Kappel-Grafenhausen,10 - 15 Jahre,297,153,144
False,8317152,Kappel-Grafenhausen,15 - 18 Jahre,219,115,104
False,8317152,Kappel-Grafenhausen,18 - 20 Jahre,139,61,78
False,8317152,Kappel-Grafenhausen,20 - 25 Jahre,294,151,143
False,8317152,Kappel-Grafenhausen,25 - 30 Jahre,238,117,121
False,8317152,Kappel-Grafenhausen,30 - 35 Jahre,275,143,132
False,8317152,Kappel-Grafenhausen,35 - 40 Jahre,300,155,145
False,8317152,Kappel-Grafenhausen,40 - 45 Jahre,424,209,215
False,8317152,Kappel-Grafenhausen,45 - 50 Jahre,461,235,226
False,8317152,Kappel-Grafenhausen,50 - 55 Jahre,394,201,193
False,8317152,Kappel-Grafenhausen,55 - 60 Jahre,303,163,140
False,8317152,Kappel-Grafenhausen,60 - 65 Jahre,241,116,125
False,8317152,Kappel-Grafenhausen,65 - 75 Jahre,440,207,233
False,8317152,Kappel-Grafenhausen,75 und mehr Jahre,332,142,190
False,8317152,Kappel-Grafenhausen,Insgesamt,4808,2395,2413
False,8317153,"Rheinau, Stadt",unter 3 Jahre,247,133,114
False,8317153,"Rheinau, Stadt",3 -  6 Jahre,309,164,145
False,8317153,"Rheinau, Stadt",6 - 10 Jahre,440,222,218
False,8317153,"Rheinau, Stadt",10 - 15 Jahre,678,328,350
False,8317153,"Rheinau, Stadt",15 - 18 Jahre,461,219,242
False,8317153,"Rheinau, Stadt",18 - 20 Jahre,286,159,127
False,8317153,"Rheinau, Stadt",20 - 25 Jahre,647,332,315
False,8317153,"Rheinau, Stadt",25 - 30 Jahre,571,304,267
False,8317153,"Rheinau, Stadt",30 - 35 Jahre,552,268,284
False,8317153,"Rheinau, Stadt",35 - 40 Jahre,681,333,348
False,8317153,"Rheinau, Stadt",40 - 45 Jahre,919,461,458
False,8317153,"Rheinau, Stadt",45 - 50 Jahre,1068,530,538
False,8317153,"Rheinau, Stadt",50 - 55 Jahre,991,505,486
False,8317153,"Rheinau, Stadt",55 - 60 Jahre,792,411,381
False,8317153,"Rheinau, Stadt",60 - 65 Jahre,634,333,301
False,8317153,"Rheinau, Stadt",65 - 75 Jahre,1082,544,538
False,8317153,"Rheinau, Stadt",75 und mehr Jahre,919,359,560
False,8317153,"Rheinau, Stadt",Insgesamt,11277,5605,5672
False,8325,Landkreis Rottweil,unter 3 Jahre,3470,1799,1671
False,8325,Landkreis Rottweil,3 -  6 Jahre,3737,1897,1840
False,8325,Landkreis Rottweil,6 - 10 Jahre,5445,2746,2699
False,8325,Landkreis Rottweil,10 - 15 Jahre,8176,4131,4045
False,8325,Landkreis Rottweil,15 - 18 Jahre,5326,2716,2610
False,8325,Landkreis Rottweil,18 - 20 Jahre,3629,1878,1751
False,8325,Landkreis Rottweil,20 - 25 Jahre,8020,4162,3858
False,8325,Landkreis Rottweil,25 - 30 Jahre,7436,3805,3631
False,8325,Landkreis Rottweil,30 - 35 Jahre,7504,3780,3724
False,8325,Landkreis Rottweil,35 - 40 Jahre,8264,4159,4105
False,8325,Landkreis Rottweil,40 - 45 Jahre,11382,5852,5530
False,8325,Landkreis Rottweil,45 - 50 Jahre,12003,6136,5867
False,8325,Landkreis Rottweil,50 - 55 Jahre,10565,5385,5180
False,8325,Landkreis Rottweil,55 - 60 Jahre,8733,4366,4367
False,8325,Landkreis Rottweil,60 - 65 Jahre,7424,3690,3734
False,8325,Landkreis Rottweil,65 - 75 Jahre,15438,7397,8041
False,8325,Landkreis Rottweil,75 und mehr Jahre,12764,4802,7962
False,8325,Landkreis Rottweil,Insgesamt,139316,68701,70615
False,8325001,Aichhalden,unter 3 Jahre,97,44,53
False,8325001,Aichhalden,3 -  6 Jahre,113,53,60
False,8325001,Aichhalden,6 - 10 Jahre,161,82,79
False,8325001,Aichhalden,10 - 15 Jahre,259,134,125
False,8325001,Aichhalden,15 - 18 Jahre,156,87,69
False,8325001,Aichhalden,18 - 20 Jahre,126,64,62
False,8325001,Aichhalden,20 - 25 Jahre,218,117,101
False,8325001,Aichhalden,25 - 30 Jahre,219,123,96
False,8325001,Aichhalden,30 - 35 Jahre,222,112,110
False,8325001,Aichhalden,35 - 40 Jahre,222,124,98
False,8325001,Aichhalden,40 - 45 Jahre,330,174,156
False,8325001,Aichhalden,45 - 50 Jahre,364,174,190
False,8325001,Aichhalden,50 - 55 Jahre,344,178,166
False,8325001,Aichhalden,55 - 60 Jahre,229,111,118
False,8325001,Aichhalden,60 - 65 Jahre,230,116,114
False,8325001,Aichhalden,65 - 75 Jahre,479,241,238
False,8325001,Aichhalden,75 und mehr Jahre,314,113,201
False,8325001,Aichhalden,Insgesamt,4083,2047,2036
False,8325009,Bösingen,unter 3 Jahre,92,50,42
False,8325009,Bösingen,3 -  6 Jahre,124,63,61
False,8325009,Bösingen,6 - 10 Jahre,170,92,78
False,8325009,Bösingen,10 - 15 Jahre,250,112,138
False,8325009,Bösingen,15 - 18 Jahre,164,83,81
False,8325009,Bösingen,18 - 20 Jahre,96,46,50
False,8325009,Bösingen,20 - 25 Jahre,230,123,107
False,8325009,Bösingen,25 - 30 Jahre,184,93,91
False,8325009,Bösingen,30 - 35 Jahre,174,87,87
False,8325009,Bösingen,35 - 40 Jahre,234,111,123
False,8325009,Bösingen,40 - 45 Jahre,339,182,157
False,8325009,Bösingen,45 - 50 Jahre,296,156,140
False,8325009,Bösingen,50 - 55 Jahre,245,123,122
False,8325009,Bösingen,55 - 60 Jahre,195,103,92
False,8325009,Bösingen,60 - 65 Jahre,153,75,78
False,8325009,Bösingen,65 - 75 Jahre,322,158,164
False,8325009,Bösingen,75 und mehr Jahre,231,96,135
False,8325009,Bösingen,Insgesamt,3499,1753,1746
False,8325011,Dietingen,unter 3 Jahre,105,58,47
False,8325011,Dietingen,3 -  6 Jahre,112,61,51
False,8325011,Dietingen,6 - 10 Jahre,173,85,88
False,8325011,Dietingen,10 - 15 Jahre,258,118,140
False,8325011,Dietingen,15 - 18 Jahre,145,71,74
False,8325011,Dietingen,18 - 20 Jahre,112,54,58
False,8325011,Dietingen,20 - 25 Jahre,203,100,103
False,8325011,Dietingen,25 - 30 Jahre,176,83,93
False,8325011,Dietingen,30 - 35 Jahre,189,88,101
False,8325011,Dietingen,35 - 40 Jahre,229,106,123
False,8325011,Dietingen,40 - 45 Jahre,365,185,180
False,8325011,Dietingen,45 - 50 Jahre,364,201,163
False,8325011,Dietingen,50 - 55 Jahre,303,150,153
False,8325011,Dietingen,55 - 60 Jahre,237,129,108
False,8325011,Dietingen,60 - 65 Jahre,200,92,108
False,8325011,Dietingen,65 - 75 Jahre,414,202,212
False,8325011,Dietingen,75 und mehr Jahre,350,148,202
False,8325011,Dietingen,Insgesamt,3935,1931,2004
False,8325012,"Dornhan, Stadt",unter 3 Jahre,133,73,60
False,8325012,"Dornhan, Stadt",3 -  6 Jahre,180,75,105
False,8325012,"Dornhan, Stadt",6 - 10 Jahre,248,130,118
False,8325012,"Dornhan, Stadt",10 - 15 Jahre,370,187,183
False,8325012,"Dornhan, Stadt",15 - 18 Jahre,238,122,116
False,8325012,"Dornhan, Stadt",18 - 20 Jahre,137,66,71
False,8325012,"Dornhan, Stadt",20 - 25 Jahre,376,212,164
False,8325012,"Dornhan, Stadt",25 - 30 Jahre,279,152,127
False,8325012,"Dornhan, Stadt",30 - 35 Jahre,308,141,167
False,8325012,"Dornhan, Stadt",35 - 40 Jahre,393,212,181
False,8325012,"Dornhan, Stadt",40 - 45 Jahre,446,221,225
False,8325012,"Dornhan, Stadt",45 - 50 Jahre,575,303,272
False,8325012,"Dornhan, Stadt",50 - 55 Jahre,439,224,215
False,8325012,"Dornhan, Stadt",55 - 60 Jahre,372,190,182
False,8325012,"Dornhan, Stadt",60 - 65 Jahre,346,180,166
False,8325012,"Dornhan, Stadt",65 - 75 Jahre,707,346,361
False,8325012,"Dornhan, Stadt",75 und mehr Jahre,568,212,356
False,8325012,"Dornhan, Stadt",Insgesamt,6115,3046,3069
False,8325014,Dunningen,unter 3 Jahre,184,99,85
False,8325014,Dunningen,3 -  6 Jahre,168,78,90
False,8325014,Dunningen,6 - 10 Jahre,220,100,120
False,8325014,Dunningen,10 - 15 Jahre,343,179,164
False,8325014,Dunningen,15 - 18 Jahre,249,131,118
False,8325014,Dunningen,18 - 20 Jahre,147,65,82
False,8325014,Dunningen,20 - 25 Jahre,391,231,160
False,8325014,Dunningen,25 - 30 Jahre,376,177,199
False,8325014,Dunningen,30 - 35 Jahre,334,165,169
False,8325014,Dunningen,35 - 40 Jahre,368,189,179
False,8325014,Dunningen,40 - 45 Jahre,486,246,240
False,8325014,Dunningen,45 - 50 Jahre,527,267,260
False,8325014,Dunningen,50 - 55 Jahre,498,274,224
False,8325014,Dunningen,55 - 60 Jahre,420,218,202
False,8325014,Dunningen,60 - 65 Jahre,281,148,133
False,8325014,Dunningen,65 - 75 Jahre,559,290,269
False,8325014,Dunningen,75 und mehr Jahre,474,182,292
False,8325014,Dunningen,Insgesamt,6025,3039,2986
False,8325015,Epfendorf,unter 3 Jahre,87,46,41
False,8325015,Epfendorf,3 -  6 Jahre,74,42,32
False,8325015,Epfendorf,6 - 10 Jahre,134,73,61
False,8325015,Epfendorf,10 - 15 Jahre,217,93,124
False,8325015,Epfendorf,15 - 18 Jahre,124,78,46
False,8325015,Epfendorf,18 - 20 Jahre,84,44,40
False,8325015,Epfendorf,20 - 25 Jahre,201,98,103
False,8325015,Epfendorf,25 - 30 Jahre,167,88,79
False,8325015,Epfendorf,30 - 35 Jahre,150,71,79
False,8325015,Epfendorf,35 - 40 Jahre,158,72,86
False,8325015,Epfendorf,40 - 45 Jahre,288,155,133
False,8325015,Epfendorf,45 - 50 Jahre,308,138,170
False,8325015,Epfendorf,50 - 55 Jahre,299,167,132
False,8325015,Epfendorf,55 - 60 Jahre,193,97,96
False,8325015,Epfendorf,60 - 65 Jahre,188,102,86
False,8325015,Epfendorf,65 - 75 Jahre,375,180,195
False,8325015,Epfendorf,75 und mehr Jahre,306,105,201
False,8325015,Epfendorf,Insgesamt,3353,1649,1704
False,8325024,Hardt,unter 3 Jahre,50,23,27
False,8325024,Hardt,3 -  6 Jahre,73,36,37
False,8325024,Hardt,6 - 10 Jahre,124,64,60
False,8325024,Hardt,10 - 15 Jahre,148,73,75
False,8325024,Hardt,15 - 18 Jahre,105,52,53
False,8325024,Hardt,18 - 20 Jahre,73,39,34
False,8325024,Hardt,20 - 25 Jahre,130,71,59
False,8325024,Hardt,25 - 30 Jahre,130,68,62
False,8325024,Hardt,30 - 35 Jahre,155,78,77
False,8325024,Hardt,35 - 40 Jahre,166,80,86
False,8325024,Hardt,40 - 45 Jahre,214,110,104
False,8325024,Hardt,45 - 50 Jahre,210,106,104
False,8325024,Hardt,50 - 55 Jahre,165,73,92
False,8325024,Hardt,55 - 60 Jahre,185,98,87
False,8325024,Hardt,60 - 65 Jahre,125,58,67
False,8325024,Hardt,65 - 75 Jahre,305,147,158
False,8325024,Hardt,75 und mehr Jahre,189,88,101
False,8325024,Hardt,Insgesamt,2547,1264,1283
False,8325036,Lauterbach,unter 3 Jahre,62,40,22
False,8325036,Lauterbach,3 -  6 Jahre,88,37,51
False,8325036,Lauterbach,6 - 10 Jahre,107,52,55
False,8325036,Lauterbach,10 - 15 Jahre,172,94,78
False,8325036,Lauterbach,15 - 18 Jahre,125,59,66
False,8325036,Lauterbach,18 - 20 Jahre,95,48,47
False,8325036,Lauterbach,20 - 25 Jahre,145,80,65
False,8325036,Lauterbach,25 - 30 Jahre,115,61,54
False,8325036,Lauterbach,30 - 35 Jahre,117,59,58
False,8325036,Lauterbach,35 - 40 Jahre,189,87,102
False,8325036,Lauterbach,40 - 45 Jahre,249,140,109
False,8325036,Lauterbach,45 - 50 Jahre,244,120,124
False,8325036,Lauterbach,50 - 55 Jahre,207,108,99
False,8325036,Lauterbach,55 - 60 Jahre,155,70,85
False,8325036,Lauterbach,60 - 65 Jahre,153,73,80
False,8325036,Lauterbach,65 - 75 Jahre,420,193,227
False,8325036,Lauterbach,75 und mehr Jahre,363,135,228
False,8325036,Lauterbach,Insgesamt,3006,1456,1550
False,8325045,"Oberndorf am Neckar, Stadt",unter 3 Jahre,377,201,176
False,8325045,"Oberndorf am Neckar, Stadt",3 -  6 Jahre,381,189,192
False,8325045,"Oberndorf am Neckar, Stadt",6 - 10 Jahre,565,278,287
False,8325045,"Oberndorf am Neckar, Stadt",10 - 15 Jahre,847,444,403
False,8325045,"Oberndorf am Neckar, Stadt",15 - 18 Jahre,523,261,262
False,8325045,"Oberndorf am Neckar, Stadt",18 - 20 Jahre,325,156,169
False,8325045,"Oberndorf am Neckar, Stadt",20 - 25 Jahre,774,368,406
False,8325045,"Oberndorf am Neckar, Stadt",25 - 30 Jahre,777,403,374
False,8325045,"Oberndorf am Neckar, Stadt",30 - 35 Jahre,770,408,362
False,8325045,"Oberndorf am Neckar, Stadt",35 - 40 Jahre,852,416,436
False,8325045,"Oberndorf am Neckar, Stadt",40 - 45 Jahre,1175,610,565
False,8325045,"Oberndorf am Neckar, Stadt",45 - 50 Jahre,1224,662,562
False,8325045,"Oberndorf am Neckar, Stadt",50 - 55 Jahre,991,536,455
False,8325045,"Oberndorf am Neckar, Stadt",55 - 60 Jahre,851,412,439
False,8325045,"Oberndorf am Neckar, Stadt",60 - 65 Jahre,826,400,426
False,8325045,"Oberndorf am Neckar, Stadt",65 - 75 Jahre,1750,853,897
False,8325045,"Oberndorf am Neckar, Stadt",75 und mehr Jahre,1370,517,853
False,8325045,"Oberndorf am Neckar, Stadt",Insgesamt,14378,7114,7264
False,8325049,"Rottweil, Stadt",unter 3 Jahre,640,324,316
False,8325049,"Rottweil, Stadt",3 -  6 Jahre,686,368,318
False,8325049,"Rottweil, Stadt",6 - 10 Jahre,930,469,461
False,8325049,"Rottweil, Stadt",10 - 15 Jahre,1379,705,674
False,8325049,"Rottweil, Stadt",15 - 18 Jahre,874,413,461
False,8325049,"Rottweil, Stadt",18 - 20 Jahre,637,335,302
False,8325049,"Rottweil, Stadt",20 - 25 Jahre,1386,714,672
False,8325049,"Rottweil, Stadt",25 - 30 Jahre,1493,727,766
False,8325049,"Rottweil, Stadt",30 - 35 Jahre,1590,797,793
False,8325049,"Rottweil, Stadt",35 - 40 Jahre,1573,804,769
False,8325049,"Rottweil, Stadt",40 - 45 Jahre,2097,1078,1019
False,8325049,"Rottweil, Stadt",45 - 50 Jahre,2150,1072,1078
False,8325049,"Rottweil, Stadt",50 - 55 Jahre,1909,961,948
False,8325049,"Rottweil, Stadt",55 - 60 Jahre,1683,836,847
False,8325049,"Rottweil, Stadt",60 - 65 Jahre,1446,680,766
False,8325049,"Rottweil, Stadt",65 - 75 Jahre,2804,1322,1482
False,8325049,"Rottweil, Stadt",75 und mehr Jahre,2382,884,1498
False,8325049,"Rottweil, Stadt",Insgesamt,25659,12489,13170
False,8325050,Schenkenzell,unter 3 Jahre,44,16,28
False,8325050,Schenkenzell,3 -  6 Jahre,44,23,21
False,8325050,Schenkenzell,6 - 10 Jahre,71,40,31
False,8325050,Schenkenzell,10 - 15 Jahre,111,53,58
False,8325050,Schenkenzell,15 - 18 Jahre,78,41,37
False,8325050,Schenkenzell,18 - 20 Jahre,54,28,26
False,8325050,Schenkenzell,20 - 25 Jahre,103,60,43
False,8325050,Schenkenzell,25 - 30 Jahre,84,53,31
False,8325050,Schenkenzell,30 - 35 Jahre,78,38,40
False,8325050,Schenkenzell,35 - 40 Jahre,98,55,43
False,8325050,Schenkenzell,40 - 45 Jahre,136,60,76
False,8325050,Schenkenzell,45 - 50 Jahre,165,87,78
False,8325050,Schenkenzell,50 - 55 Jahre,143,82,61
False,8325050,Schenkenzell,55 - 60 Jahre,96,52,44
False,8325050,Schenkenzell,60 - 65 Jahre,73,37,36
False,8325050,Schenkenzell,65 - 75 Jahre,214,92,122
False,8325050,Schenkenzell,75 und mehr Jahre,186,79,107
False,8325050,Schenkenzell,Insgesamt,1778,896,882
False,8325051,"Schiltach, Stadt",unter 3 Jahre,78,43,35
False,8325051,"Schiltach, Stadt",3 -  6 Jahre,90,51,39
False,8325051,"Schiltach, Stadt",6 - 10 Jahre,136,65,71
False,8325051,"Schiltach, Stadt",10 - 15 Jahre,226,98,128
False,8325051,"Schiltach, Stadt",15 - 18 Jahre,150,83,67
False,8325051,"Schiltach, Stadt",18 - 20 Jahre,113,61,52
False,8325051,"Schiltach, Stadt",20 - 25 Jahre,209,107,102
False,8325051,"Schiltach, Stadt",25 - 30 Jahre,209,105,104
False,8325051,"Schiltach, Stadt",30 - 35 Jahre,168,87,81
False,8325051,"Schiltach, Stadt",35 - 40 Jahre,171,77,94
False,8325051,"Schiltach, Stadt",40 - 45 Jahre,288,144,144
False,8325051,"Schiltach, Stadt",45 - 50 Jahre,345,172,173
False,8325051,"Schiltach, Stadt",50 - 55 Jahre,313,157,156
False,8325051,"Schiltach, Stadt",55 - 60 Jahre,247,125,122
False,8325051,"Schiltach, Stadt",60 - 65 Jahre,183,103,80
False,8325051,"Schiltach, Stadt",65 - 75 Jahre,454,219,235
False,8325051,"Schiltach, Stadt",75 und mehr Jahre,495,171,324
False,8325051,"Schiltach, Stadt",Insgesamt,3875,1868,2007
False,8325053,"Schramberg, Stadt",unter 3 Jahre,499,257,242
False,8325053,"Schramberg, Stadt",3 -  6 Jahre,508,273,235
False,8325053,"Schramberg, Stadt",6 - 10 Jahre,764,393,371
False,8325053,"Schramberg, Stadt",10 - 15 Jahre,1184,610,574
False,8325053,"Schramberg, Stadt",15 - 18 Jahre,826,423,403
False,8325053,"Schramberg, Stadt",18 - 20 Jahre,571,307,264
False,8325053,"Schramberg, Stadt",20 - 25 Jahre,1265,669,596
False,8325053,"Schramberg, Stadt",25 - 30 Jahre,1183,622,561
False,8325053,"Schramberg, Stadt",30 - 35 Jahre,1098,581,517
False,8325053,"Schramberg, Stadt",35 - 40 Jahre,1215,634,581
False,8325053,"Schramberg, Stadt",40 - 45 Jahre,1674,840,834
False,8325053,"Schramberg, Stadt",45 - 50 Jahre,1708,877,831
False,8325053,"Schramberg, Stadt",50 - 55 Jahre,1559,779,780
False,8325053,"Schramberg, Stadt",55 - 60 Jahre,1354,671,683
False,8325053,"Schramberg, Stadt",60 - 65 Jahre,1181,573,608
False,8325053,"Schramberg, Stadt",65 - 75 Jahre,2508,1175,1333
False,8325053,"Schramberg, Stadt",75 und mehr Jahre,2145,764,1381
False,8325053,"Schramberg, Stadt",Insgesamt,21242,10448,10794
False,8325057,"Sulz am Neckar, Stadt",unter 3 Jahre,303,156,147
False,8325057,"Sulz am Neckar, Stadt",3 -  6 Jahre,309,161,148
False,8325057,"Sulz am Neckar, Stadt",6 - 10 Jahre,446,198,248
False,8325057,"Sulz am Neckar, Stadt",10 - 15 Jahre,779,389,390
False,8325057,"Sulz am Neckar, Stadt",15 - 18 Jahre,513,261,252
False,8325057,"Sulz am Neckar, Stadt",18 - 20 Jahre,329,172,157
False,8325057,"Sulz am Neckar, Stadt",20 - 25 Jahre,744,377,367
False,8325057,"Sulz am Neckar, Stadt",25 - 30 Jahre,613,326,287
False,8325057,"Sulz am Neckar, Stadt",30 - 35 Jahre,604,308,296
False,8325057,"Sulz am Neckar, Stadt",35 - 40 Jahre,680,340,340
False,8325057,"Sulz am Neckar, Stadt",40 - 45 Jahre,1000,524,476
False,8325057,"Sulz am Neckar, Stadt",45 - 50 Jahre,1124,556,568
False,8325057,"Sulz am Neckar, Stadt",50 - 55 Jahre,968,488,480
False,8325057,"Sulz am Neckar, Stadt",55 - 60 Jahre,759,390,369
False,8325057,"Sulz am Neckar, Stadt",60 - 65 Jahre,607,311,296
False,8325057,"Sulz am Neckar, Stadt",65 - 75 Jahre,1222,593,629
False,8325057,"Sulz am Neckar, Stadt",75 und mehr Jahre,1159,430,729
False,8325057,"Sulz am Neckar, Stadt",Insgesamt,12159,5980,6179
False,8325060,Villingendorf,unter 3 Jahre,109,51,58
False,8325060,Villingendorf,3 -  6 Jahre,88,38,50
False,8325060,Villingendorf,6 - 10 Jahre,134,71,63
False,8325060,Villingendorf,10 - 15 Jahre,223,108,115
False,8325060,Villingendorf,15 - 18 Jahre,141,71,70
False,8325060,Villingendorf,18 - 20 Jahre,92,45,47
False,8325060,Villingendorf,20 - 25 Jahre,216,109,107
False,8325060,Villingendorf,25 - 30 Jahre,181,89,92
False,8325060,Villingendorf,30 - 35 Jahre,182,106,76
False,8325060,Villingendorf,35 - 40 Jahre,204,96,108
False,8325060,Villingendorf,40 - 45 Jahre,281,143,138
False,8325060,Villingendorf,45 - 50 Jahre,289,136,153
False,8325060,Villingendorf,50 - 55 Jahre,249,121,128
False,8325060,Villingendorf,55 - 60 Jahre,212,102,110
False,8325060,Villingendorf,60 - 65 Jahre,163,88,75
False,8325060,Villingendorf,65 - 75 Jahre,295,138,157
False,8325060,Villingendorf,75 und mehr Jahre,251,99,152
False,8325060,Villingendorf,Insgesamt,3310,1611,1699
False,8325061,Vöhringen,unter 3 Jahre,111,55,56
False,8325061,Vöhringen,3 -  6 Jahre,128,70,58
False,8325061,Vöhringen,6 - 10 Jahre,194,100,94
False,8325061,Vöhringen,10 - 15 Jahre,268,148,120
False,8325061,Vöhringen,15 - 18 Jahre,174,91,83
False,8325061,Vöhringen,18 - 20 Jahre,111,61,50
False,8325061,Vöhringen,20 - 25 Jahre,239,128,111
False,8325061,Vöhringen,25 - 30 Jahre,188,94,94
False,8325061,Vöhringen,30 - 35 Jahre,233,118,115
False,8325061,Vöhringen,35 - 40 Jahre,276,133,143
False,8325061,Vöhringen,40 - 45 Jahre,323,175,148
False,8325061,Vöhringen,45 - 50 Jahre,376,196,180
False,8325061,Vöhringen,50 - 55 Jahre,295,148,147
False,8325061,Vöhringen,55 - 60 Jahre,213,100,113
False,8325061,Vöhringen,60 - 65 Jahre,210,114,96
False,8325061,Vöhringen,65 - 75 Jahre,424,190,234
False,8325061,Vöhringen,75 und mehr Jahre,341,120,221
False,8325061,Vöhringen,Insgesamt,4104,2041,2063
False,8325064,Wellendingen,unter 3 Jahre,99,48,51
False,8325064,Wellendingen,3 -  6 Jahre,108,54,54
False,8325064,Wellendingen,6 - 10 Jahre,143,68,75
False,8325064,Wellendingen,10 - 15 Jahre,189,98,91
False,8325064,Wellendingen,15 - 18 Jahre,116,50,66
False,8325064,Wellendingen,18 - 20 Jahre,82,47,35
False,8325064,Wellendingen,20 - 25 Jahre,171,96,75
False,8325064,Wellendingen,25 - 30 Jahre,186,79,107
False,8325064,Wellendingen,30 - 35 Jahre,172,92,80
False,8325064,Wellendingen,35 - 40 Jahre,193,95,98
False,8325064,Wellendingen,40 - 45 Jahre,248,137,111
False,8325064,Wellendingen,45 - 50 Jahre,280,144,136
False,8325064,Wellendingen,50 - 55 Jahre,262,133,129
False,8325064,Wellendingen,55 - 60 Jahre,215,116,99
False,8325064,Wellendingen,60 - 65 Jahre,141,82,59
False,8325064,Wellendingen,65 - 75 Jahre,297,146,151
False,8325064,Wellendingen,75 und mehr Jahre,201,79,122
False,8325064,Wellendingen,Insgesamt,3103,1564,1539
False,8325069,Zimmern ob Rottweil,unter 3 Jahre,121,71,50
False,8325069,Zimmern ob Rottweil,3 -  6 Jahre,140,61,79
False,8325069,Zimmern ob Rottweil,6 - 10 Jahre,235,132,103
False,8325069,Zimmern ob Rottweil,10 - 15 Jahre,327,168,159
False,8325069,Zimmern ob Rottweil,15 - 18 Jahre,219,118,101
False,8325069,Zimmern ob Rottweil,18 - 20 Jahre,132,64,68
False,8325069,Zimmern ob Rottweil,20 - 25 Jahre,365,165,200
False,8325069,Zimmern ob Rottweil,25 - 30 Jahre,299,158,141
False,8325069,Zimmern ob Rottweil,30 - 35 Jahre,339,146,193
False,8325069,Zimmern ob Rottweil,35 - 40 Jahre,391,200,191
False,8325069,Zimmern ob Rottweil,40 - 45 Jahre,482,241,241
False,8325069,Zimmern ob Rottweil,45 - 50 Jahre,485,260,225
False,8325069,Zimmern ob Rottweil,50 - 55 Jahre,502,235,267
False,8325069,Zimmern ob Rottweil,55 - 60 Jahre,410,197,213
False,8325069,Zimmern ob Rottweil,60 - 65 Jahre,321,165,156
False,8325069,Zimmern ob Rottweil,65 - 75 Jahre,631,302,329
False,8325069,Zimmern ob Rottweil,75 und mehr Jahre,461,182,279
False,8325069,Zimmern ob Rottweil,Insgesamt,5860,2865,2995
False,8325070,Fluorn-Winzeln,unter 3 Jahre,81,43,38
False,8325070,Fluorn-Winzeln,3 -  6 Jahre,81,43,38
False,8325070,Fluorn-Winzeln,6 - 10 Jahre,129,64,65
False,8325070,Fluorn-Winzeln,10 - 15 Jahre,191,102,89
False,8325070,Fluorn-Winzeln,15 - 18 Jahre,134,76,58
False,8325070,Fluorn-Winzeln,18 - 20 Jahre,88,52,36
False,8325070,Fluorn-Winzeln,20 - 25 Jahre,183,105,78
False,8325070,Fluorn-Winzeln,25 - 30 Jahre,158,72,86
False,8325070,Fluorn-Winzeln,30 - 35 Jahre,168,92,76
False,8325070,Fluorn-Winzeln,35 - 40 Jahre,211,102,109
False,8325070,Fluorn-Winzeln,40 - 45 Jahre,296,152,144
False,8325070,Fluorn-Winzeln,45 - 50 Jahre,281,151,130
False,8325070,Fluorn-Winzeln,50 - 55 Jahre,231,128,103
False,8325070,Fluorn-Winzeln,55 - 60 Jahre,159,80,79
False,8325070,Fluorn-Winzeln,60 - 65 Jahre,176,81,95
False,8325070,Fluorn-Winzeln,65 - 75 Jahre,369,178,191
False,8325070,Fluorn-Winzeln,75 und mehr Jahre,255,111,144
False,8325070,Fluorn-Winzeln,Insgesamt,3191,1632,1559
False,8325071,Eschbronn,unter 3 Jahre,54,31,23
False,8325071,Eschbronn,3 -  6 Jahre,66,29,37
False,8325071,Eschbronn,6 - 10 Jahre,110,49,61
False,8325071,Eschbronn,10 - 15 Jahre,115,60,55
False,8325071,Eschbronn,15 - 18 Jahre,68,42,26
False,8325071,Eschbronn,18 - 20 Jahre,49,25,24
False,8325071,Eschbronn,20 - 25 Jahre,96,49,47
False,8325071,Eschbronn,25 - 30 Jahre,89,50,39
False,8325071,Eschbronn,30 - 35 Jahre,113,53,60
False,8325071,Eschbronn,35 - 40 Jahre,121,63,58
False,8325071,Eschbronn,40 - 45 Jahre,187,99,88
False,8325071,Eschbronn,45 - 50 Jahre,178,97,81
False,8325071,Eschbronn,50 - 55 Jahre,147,72,75
False,8325071,Eschbronn,55 - 60 Jahre,134,68,66
False,8325071,Eschbronn,60 - 65 Jahre,107,50,57
False,8325071,Eschbronn,65 - 75 Jahre,280,137,143
False,8325071,Eschbronn,75 und mehr Jahre,172,82,90
False,8325071,Eschbronn,Insgesamt,2086,1056,1030
False,8325072,Deißlingen,unter 3 Jahre,144,70,74
False,8325072,Deißlingen,3 -  6 Jahre,176,92,84
False,8325072,Deißlingen,6 - 10 Jahre,251,141,110
False,8325072,Deißlingen,10 - 15 Jahre,320,158,162
False,8325072,Deißlingen,15 - 18 Jahre,204,103,101
False,8325072,Deißlingen,18 - 20 Jahre,176,99,77
False,8325072,Deißlingen,20 - 25 Jahre,375,183,192
False,8325072,Deißlingen,25 - 30 Jahre,330,182,148
False,8325072,Deißlingen,30 - 35 Jahre,340,153,187
False,8325072,Deißlingen,35 - 40 Jahre,320,163,157
False,8325072,Deißlingen,40 - 45 Jahre,478,236,242
False,8325072,Deißlingen,45 - 50 Jahre,510,261,249
False,8325072,Deißlingen,50 - 55 Jahre,496,248,248
False,8325072,Deißlingen,55 - 60 Jahre,414,201,213
False,8325072,Deißlingen,60 - 65 Jahre,314,162,152
False,8325072,Deißlingen,65 - 75 Jahre,609,295,314
False,8325072,Deißlingen,75 und mehr Jahre,551,205,346
False,8325072,Deißlingen,Insgesamt,6008,2952,3056
False,8326,Landkreis Schwarzw.-Baar-Kreis,unter 3 Jahre,5116,2621,2495
False,8326,Landkreis Schwarzw.-Baar-Kreis,3 -  6 Jahre,5307,2659,2648
False,8326,Landkreis Schwarzw.-Baar-Kreis,6 - 10 Jahre,7506,3820,3686
False,8326,Landkreis Schwarzw.-Baar-Kreis,10 - 15 Jahre,11107,5830,5277
False,8326,Landkreis Schwarzw.-Baar-Kreis,15 - 18 Jahre,6975,3591,3384
False,8326,Landkreis Schwarzw.-Baar-Kreis,18 - 20 Jahre,4915,2568,2347
False,8326,Landkreis Schwarzw.-Baar-Kreis,20 - 25 Jahre,12527,6538,5989
False,8326,Landkreis Schwarzw.-Baar-Kreis,25 - 30 Jahre,11615,5957,5658
False,8326,Landkreis Schwarzw.-Baar-Kreis,30 - 35 Jahre,11170,5663,5507
False,8326,Landkreis Schwarzw.-Baar-Kreis,35 - 40 Jahre,11594,5796,5798
False,8326,Landkreis Schwarzw.-Baar-Kreis,40 - 45 Jahre,15855,7957,7898
False,8326,Landkreis Schwarzw.-Baar-Kreis,45 - 50 Jahre,16965,8623,8342
False,8326,Landkreis Schwarzw.-Baar-Kreis,50 - 55 Jahre,15718,7934,7784
False,8326,Landkreis Schwarzw.-Baar-Kreis,55 - 60 Jahre,13570,6574,6996
False,8326,Landkreis Schwarzw.-Baar-Kreis,60 - 65 Jahre,11694,5760,5934
False,8326,Landkreis Schwarzw.-Baar-Kreis,65 - 75 Jahre,23729,11124,12605
False,8326,Landkreis Schwarzw.-Baar-Kreis,75 und mehr Jahre,21172,8143,13029
False,8326,Landkreis Schwarzw.-Baar-Kreis,Insgesamt,206535,101158,105377
False,8326003,"Bad Dürrheim, Stadt",unter 3 Jahre,261,137,124
False,8326003,"Bad Dürrheim, Stadt",3 -  6 Jahre,280,134,146
False,8326003,"Bad Dürrheim, Stadt",6 - 10 Jahre,397,210,187
False,8326003,"Bad Dürrheim, Stadt",10 - 15 Jahre,596,292,304
False,8326003,"Bad Dürrheim, Stadt",15 - 18 Jahre,347,175,172
False,8326003,"Bad Dürrheim, Stadt",18 - 20 Jahre,243,121,122
False,8326003,"Bad Dürrheim, Stadt",20 - 25 Jahre,602,304,298
False,8326003,"Bad Dürrheim, Stadt",25 - 30 Jahre,653,343,310
False,8326003,"Bad Dürrheim, Stadt",30 - 35 Jahre,594,312,282
False,8326003,"Bad Dürrheim, Stadt",35 - 40 Jahre,637,302,335
False,8326003,"Bad Dürrheim, Stadt",40 - 45 Jahre,914,457,457
False,8326003,"Bad Dürrheim, Stadt",45 - 50 Jahre,1037,490,547
False,8326003,"Bad Dürrheim, Stadt",50 - 55 Jahre,976,490,486
False,8326003,"Bad Dürrheim, Stadt",55 - 60 Jahre,834,371,463
False,8326003,"Bad Dürrheim, Stadt",60 - 65 Jahre,784,373,411
False,8326003,"Bad Dürrheim, Stadt",65 - 75 Jahre,1768,784,984
False,8326003,"Bad Dürrheim, Stadt",75 und mehr Jahre,1989,699,1290
False,8326003,"Bad Dürrheim, Stadt",Insgesamt,12912,5994,6918
False,8326005,"Blumberg, Stadt",unter 3 Jahre,270,153,117
False,8326005,"Blumberg, Stadt",3 -  6 Jahre,262,142,120
False,8326005,"Blumberg, Stadt",6 - 10 Jahre,431,226,205
False,8326005,"Blumberg, Stadt",10 - 15 Jahre,572,302,270
False,8326005,"Blumberg, Stadt",15 - 18 Jahre,376,198,178
False,8326005,"Blumberg, Stadt",18 - 20 Jahre,256,124,132
False,8326005,"Blumberg, Stadt",20 - 25 Jahre,588,315,273
False,8326005,"Blumberg, Stadt",25 - 30 Jahre,554,268,286
False,8326005,"Blumberg, Stadt",30 - 35 Jahre,532,265,267
False,8326005,"Blumberg, Stadt",35 - 40 Jahre,603,295,308
False,8326005,"Blumberg, Stadt",40 - 45 Jahre,766,382,384
False,8326005,"Blumberg, Stadt",45 - 50 Jahre,851,433,418
False,8326005,"Blumberg, Stadt",50 - 55 Jahre,779,402,377
False,8326005,"Blumberg, Stadt",55 - 60 Jahre,642,304,338
False,8326005,"Blumberg, Stadt",60 - 65 Jahre,580,295,285
False,8326005,"Blumberg, Stadt",65 - 75 Jahre,1152,579,573
False,8326005,"Blumberg, Stadt",75 und mehr Jahre,924,361,563
False,8326005,"Blumberg, Stadt",Insgesamt,10138,5044,5094
False,8326006,"Bräunlingen, Stadt",unter 3 Jahre,163,82,81
False,8326006,"Bräunlingen, Stadt",3 -  6 Jahre,168,76,92
False,8326006,"Bräunlingen, Stadt",6 - 10 Jahre,234,124,110
False,8326006,"Bräunlingen, Stadt",10 - 15 Jahre,343,181,162
False,8326006,"Bräunlingen, Stadt",15 - 18 Jahre,239,115,124
False,8326006,"Bräunlingen, Stadt",18 - 20 Jahre,160,80,80
False,8326006,"Bräunlingen, Stadt",20 - 25 Jahre,388,185,203
False,8326006,"Bräunlingen, Stadt",25 - 30 Jahre,322,164,158
False,8326006,"Bräunlingen, Stadt",30 - 35 Jahre,329,150,179
False,8326006,"Bräunlingen, Stadt",35 - 40 Jahre,350,166,184
False,8326006,"Bräunlingen, Stadt",40 - 45 Jahre,482,242,240
False,8326006,"Bräunlingen, Stadt",45 - 50 Jahre,571,287,284
False,8326006,"Bräunlingen, Stadt",50 - 55 Jahre,495,260,235
False,8326006,"Bräunlingen, Stadt",55 - 60 Jahre,401,212,189
False,8326006,"Bräunlingen, Stadt",60 - 65 Jahre,305,152,153
False,8326006,"Bräunlingen, Stadt",65 - 75 Jahre,550,277,273
False,8326006,"Bräunlingen, Stadt",75 und mehr Jahre,469,170,299
False,8326006,"Bräunlingen, Stadt",Insgesamt,5969,2923,3046
False,8326010,Dauchingen,unter 3 Jahre,91,40,51
False,8326010,Dauchingen,3 -  6 Jahre,98,53,45
False,8326010,Dauchingen,6 - 10 Jahre,133,61,72
False,8326010,Dauchingen,10 - 15 Jahre,186,102,84
False,8326010,Dauchingen,15 - 18 Jahre,115,65,50
False,8326010,Dauchingen,18 - 20 Jahre,92,43,49
False,8326010,Dauchingen,20 - 25 Jahre,220,119,101
False,8326010,Dauchingen,25 - 30 Jahre,200,99,101
False,8326010,Dauchingen,30 - 35 Jahre,191,87,104
False,8326010,Dauchingen,35 - 40 Jahre,199,103,96
False,8326010,Dauchingen,40 - 45 Jahre,324,158,166
False,8326010,Dauchingen,45 - 50 Jahre,352,174,178
False,8326010,Dauchingen,50 - 55 Jahre,280,141,139
False,8326010,Dauchingen,55 - 60 Jahre,243,107,136
False,8326010,Dauchingen,60 - 65 Jahre,213,114,99
False,8326010,Dauchingen,65 - 75 Jahre,429,199,230
False,8326010,Dauchingen,75 und mehr Jahre,305,149,156
False,8326010,Dauchingen,Insgesamt,3671,1814,1857
False,8326012,"Donaueschingen, Stadt",unter 3 Jahre,567,297,270
False,8326012,"Donaueschingen, Stadt",3 -  6 Jahre,559,291,268
False,8326012,"Donaueschingen, Stadt",6 - 10 Jahre,840,432,408
False,8326012,"Donaueschingen, Stadt",10 - 15 Jahre,1220,615,605
False,8326012,"Donaueschingen, Stadt",15 - 18 Jahre,725,380,345
False,8326012,"Donaueschingen, Stadt",18 - 20 Jahre,515,284,231
False,8326012,"Donaueschingen, Stadt",20 - 25 Jahre,1314,694,620
False,8326012,"Donaueschingen, Stadt",25 - 30 Jahre,1245,651,594
False,8326012,"Donaueschingen, Stadt",30 - 35 Jahre,1214,602,612
False,8326012,"Donaueschingen, Stadt",35 - 40 Jahre,1200,589,611
False,8326012,"Donaueschingen, Stadt",40 - 45 Jahre,1659,860,799
False,8326012,"Donaueschingen, Stadt",45 - 50 Jahre,1656,804,852
False,8326012,"Donaueschingen, Stadt",50 - 55 Jahre,1659,840,819
False,8326012,"Donaueschingen, Stadt",55 - 60 Jahre,1467,721,746
False,8326012,"Donaueschingen, Stadt",60 - 65 Jahre,1150,585,565
False,8326012,"Donaueschingen, Stadt",65 - 75 Jahre,2211,1035,1176
False,8326012,"Donaueschingen, Stadt",75 und mehr Jahre,1927,756,1171
False,8326012,"Donaueschingen, Stadt",Insgesamt,21128,10436,10692
False,8326017,"Furtwangen im Schwarzwald, Stadt",unter 3 Jahre,203,94,109
False,8326017,"Furtwangen im Schwarzwald, Stadt",3 -  6 Jahre,209,95,114
False,8326017,"Furtwangen im Schwarzwald, Stadt",6 - 10 Jahre,322,159,163
False,8326017,"Furtwangen im Schwarzwald, Stadt",10 - 15 Jahre,524,270,254
False,8326017,"Furtwangen im Schwarzwald, Stadt",15 - 18 Jahre,339,171,168
False,8326017,"Furtwangen im Schwarzwald, Stadt",18 - 20 Jahre,251,134,117
False,8326017,"Furtwangen im Schwarzwald, Stadt",20 - 25 Jahre,748,438,310
False,8326017,"Furtwangen im Schwarzwald, Stadt",25 - 30 Jahre,552,327,225
False,8326017,"Furtwangen im Schwarzwald, Stadt",30 - 35 Jahre,463,247,216
False,8326017,"Furtwangen im Schwarzwald, Stadt",35 - 40 Jahre,455,239,216
False,8326017,"Furtwangen im Schwarzwald, Stadt",40 - 45 Jahre,713,379,334
False,8326017,"Furtwangen im Schwarzwald, Stadt",45 - 50 Jahre,905,537,368
False,8326017,"Furtwangen im Schwarzwald, Stadt",50 - 55 Jahre,721,374,347
False,8326017,"Furtwangen im Schwarzwald, Stadt",55 - 60 Jahre,538,288,250
False,8326017,"Furtwangen im Schwarzwald, Stadt",60 - 65 Jahre,465,240,225
False,8326017,"Furtwangen im Schwarzwald, Stadt",65 - 75 Jahre,939,445,494
False,8326017,"Furtwangen im Schwarzwald, Stadt",75 und mehr Jahre,902,352,550
False,8326017,"Furtwangen im Schwarzwald, Stadt",Insgesamt,9249,4789,4460
False,8326020,Gütenbach,unter 3 Jahre,16,9,7
False,8326020,Gütenbach,3 -  6 Jahre,19,10,9
False,8326020,Gütenbach,6 - 10 Jahre,44,22,22
False,8326020,Gütenbach,10 - 15 Jahre,50,21,29
False,8326020,Gütenbach,15 - 18 Jahre,54,24,30
False,8326020,Gütenbach,18 - 20 Jahre,17,13,4
False,8326020,Gütenbach,20 - 25 Jahre,82,51,31
False,8326020,Gütenbach,25 - 30 Jahre,72,38,34
False,8326020,Gütenbach,30 - 35 Jahre,48,27,21
False,8326020,Gütenbach,35 - 40 Jahre,47,22,25
False,8326020,Gütenbach,40 - 45 Jahre,81,34,47
False,8326020,Gütenbach,45 - 50 Jahre,113,57,56
False,8326020,Gütenbach,50 - 55 Jahre,127,67,60
False,8326020,Gütenbach,55 - 60 Jahre,87,43,44
False,8326020,Gütenbach,60 - 65 Jahre,60,34,26
False,8326020,Gütenbach,65 - 75 Jahre,134,65,69
False,8326020,Gütenbach,75 und mehr Jahre,142,62,80
False,8326020,Gütenbach,Insgesamt,1193,599,594
False,8326027,"Hüfingen, Stadt",unter 3 Jahre,226,112,114
False,8326027,"Hüfingen, Stadt",3 -  6 Jahre,243,124,119
False,8326027,"Hüfingen, Stadt",6 - 10 Jahre,335,173,162
False,8326027,"Hüfingen, Stadt",10 - 15 Jahre,447,261,186
False,8326027,"Hüfingen, Stadt",15 - 18 Jahre,316,171,145
False,8326027,"Hüfingen, Stadt",18 - 20 Jahre,208,112,96
False,8326027,"Hüfingen, Stadt",20 - 25 Jahre,453,250,203
False,8326027,"Hüfingen, Stadt",25 - 30 Jahre,471,230,241
False,8326027,"Hüfingen, Stadt",30 - 35 Jahre,480,238,242
False,8326027,"Hüfingen, Stadt",35 - 40 Jahre,442,228,214
False,8326027,"Hüfingen, Stadt",40 - 45 Jahre,683,320,363
False,8326027,"Hüfingen, Stadt",45 - 50 Jahre,676,357,319
False,8326027,"Hüfingen, Stadt",50 - 55 Jahre,613,313,300
False,8326027,"Hüfingen, Stadt",55 - 60 Jahre,469,231,238
False,8326027,"Hüfingen, Stadt",60 - 65 Jahre,348,176,172
False,8326027,"Hüfingen, Stadt",65 - 75 Jahre,663,320,343
False,8326027,"Hüfingen, Stadt",75 und mehr Jahre,649,247,402
False,8326027,"Hüfingen, Stadt",Insgesamt,7722,3863,3859
False,8326031,Königsfeld im Schwarzwald,unter 3 Jahre,116,62,54
False,8326031,Königsfeld im Schwarzwald,3 -  6 Jahre,144,75,69
False,8326031,Königsfeld im Schwarzwald,6 - 10 Jahre,213,115,98
False,8326031,Königsfeld im Schwarzwald,10 - 15 Jahre,341,178,163
False,8326031,Königsfeld im Schwarzwald,15 - 18 Jahre,214,110,104
False,8326031,Königsfeld im Schwarzwald,18 - 20 Jahre,162,78,84
False,8326031,Königsfeld im Schwarzwald,20 - 25 Jahre,324,181,143
False,8326031,Königsfeld im Schwarzwald,25 - 30 Jahre,262,138,124
False,8326031,Königsfeld im Schwarzwald,30 - 35 Jahre,269,128,141
False,8326031,Königsfeld im Schwarzwald,35 - 40 Jahre,320,144,176
False,8326031,Königsfeld im Schwarzwald,40 - 45 Jahre,524,264,260
False,8326031,Königsfeld im Schwarzwald,45 - 50 Jahre,480,234,246
False,8326031,Königsfeld im Schwarzwald,50 - 55 Jahre,456,221,235
False,8326031,Königsfeld im Schwarzwald,55 - 60 Jahre,434,203,231
False,8326031,Königsfeld im Schwarzwald,60 - 65 Jahre,338,173,165
False,8326031,Königsfeld im Schwarzwald,65 - 75 Jahre,643,283,360
False,8326031,Königsfeld im Schwarzwald,75 und mehr Jahre,755,254,501
False,8326031,Königsfeld im Schwarzwald,Insgesamt,5995,2841,3154
False,8326037,Mönchweiler,unter 3 Jahre,71,37,34
False,8326037,Mönchweiler,3 -  6 Jahre,81,38,43
False,8326037,Mönchweiler,6 - 10 Jahre,113,60,53
False,8326037,Mönchweiler,10 - 15 Jahre,169,90,79
False,8326037,Mönchweiler,15 - 18 Jahre,102,48,54
False,8326037,Mönchweiler,18 - 20 Jahre,70,36,34
False,8326037,Mönchweiler,20 - 25 Jahre,155,83,72
False,8326037,Mönchweiler,25 - 30 Jahre,158,79,79
False,8326037,Mönchweiler,30 - 35 Jahre,137,81,56
False,8326037,Mönchweiler,35 - 40 Jahre,157,74,83
False,8326037,Mönchweiler,40 - 45 Jahre,263,138,125
False,8326037,Mönchweiler,45 - 50 Jahre,241,112,129
False,8326037,Mönchweiler,50 - 55 Jahre,248,113,135
False,8326037,Mönchweiler,55 - 60 Jahre,237,119,118
False,8326037,Mönchweiler,60 - 65 Jahre,194,89,105
False,8326037,Mönchweiler,65 - 75 Jahre,399,202,197
False,8326037,Mönchweiler,75 und mehr Jahre,286,122,164
False,8326037,Mönchweiler,Insgesamt,3081,1521,1560
False,8326041,Niedereschach,unter 3 Jahre,144,69,75
False,8326041,Niedereschach,3 -  6 Jahre,154,87,67
False,8326041,Niedereschach,6 - 10 Jahre,246,120,126
False,8326041,Niedereschach,10 - 15 Jahre,359,197,162
False,8326041,Niedereschach,15 - 18 Jahre,227,115,112
False,8326041,Niedereschach,18 - 20 Jahre,131,65,66
False,8326041,Niedereschach,20 - 25 Jahre,340,189,151
False,8326041,Niedereschach,25 - 30 Jahre,284,133,151
False,8326041,Niedereschach,30 - 35 Jahre,286,132,154
False,8326041,Niedereschach,35 - 40 Jahre,328,172,156
False,8326041,Niedereschach,40 - 45 Jahre,500,248,252
False,8326041,Niedereschach,45 - 50 Jahre,590,303,287
False,8326041,Niedereschach,50 - 55 Jahre,505,266,239
False,8326041,Niedereschach,55 - 60 Jahre,413,213,200
False,8326041,Niedereschach,60 - 65 Jahre,348,188,160
False,8326041,Niedereschach,65 - 75 Jahre,575,281,294
False,8326041,Niedereschach,75 und mehr Jahre,458,172,286
False,8326041,Niedereschach,Insgesamt,5888,2950,2938
False,8326052,"St. Georgen im Schwarzwald, Stadt",unter 3 Jahre,301,162,139
False,8326052,"St. Georgen im Schwarzwald, Stadt",3 -  6 Jahre,333,169,164
False,8326052,"St. Georgen im Schwarzwald, Stadt",6 - 10 Jahre,446,224,222
False,8326052,"St. Georgen im Schwarzwald, Stadt",10 - 15 Jahre,688,360,328
False,8326052,"St. Georgen im Schwarzwald, Stadt",15 - 18 Jahre,492,248,244
False,8326052,"St. Georgen im Schwarzwald, Stadt",18 - 20 Jahre,311,174,137
False,8326052,"St. Georgen im Schwarzwald, Stadt",20 - 25 Jahre,720,394,326
False,8326052,"St. Georgen im Schwarzwald, Stadt",25 - 30 Jahre,640,326,314
False,8326052,"St. Georgen im Schwarzwald, Stadt",30 - 35 Jahre,643,320,323
False,8326052,"St. Georgen im Schwarzwald, Stadt",35 - 40 Jahre,756,387,369
False,8326052,"St. Georgen im Schwarzwald, Stadt",40 - 45 Jahre,967,474,493
False,8326052,"St. Georgen im Schwarzwald, Stadt",45 - 50 Jahre,1104,541,563
False,8326052,"St. Georgen im Schwarzwald, Stadt",50 - 55 Jahre,965,498,467
False,8326052,"St. Georgen im Schwarzwald, Stadt",55 - 60 Jahre,855,397,458
False,8326052,"St. Georgen im Schwarzwald, Stadt",60 - 65 Jahre,720,353,367
False,8326052,"St. Georgen im Schwarzwald, Stadt",65 - 75 Jahre,1624,768,856
False,8326052,"St. Georgen im Schwarzwald, Stadt",75 und mehr Jahre,1449,567,882
False,8326052,"St. Georgen im Schwarzwald, Stadt",Insgesamt,13014,6362,6652
False,8326054,Schönwald im Schwarzwald,unter 3 Jahre,49,25,24
False,8326054,Schönwald im Schwarzwald,3 -  6 Jahre,58,32,26
False,8326054,Schönwald im Schwarzwald,6 - 10 Jahre,78,43,35
False,8326054,Schönwald im Schwarzwald,10 - 15 Jahre,121,70,51
False,8326054,Schönwald im Schwarzwald,15 - 18 Jahre,77,39,38
False,8326054,Schönwald im Schwarzwald,18 - 20 Jahre,62,32,30
False,8326054,Schönwald im Schwarzwald,20 - 25 Jahre,139,76,63
False,8326054,Schönwald im Schwarzwald,25 - 30 Jahre,109,54,55
False,8326054,Schönwald im Schwarzwald,30 - 35 Jahre,99,50,49
False,8326054,Schönwald im Schwarzwald,35 - 40 Jahre,118,59,59
False,8326054,Schönwald im Schwarzwald,40 - 45 Jahre,176,77,99
False,8326054,Schönwald im Schwarzwald,45 - 50 Jahre,219,113,106
False,8326054,Schönwald im Schwarzwald,50 - 55 Jahre,181,82,99
False,8326054,Schönwald im Schwarzwald,55 - 60 Jahre,150,76,74
False,8326054,Schönwald im Schwarzwald,60 - 65 Jahre,162,81,81
False,8326054,Schönwald im Schwarzwald,65 - 75 Jahre,349,167,182
False,8326054,Schönwald im Schwarzwald,75 und mehr Jahre,242,113,129
False,8326054,Schönwald im Schwarzwald,Insgesamt,2389,1189,1200
False,8326055,Schonach im Schwarzwald,unter 3 Jahre,63,34,29
False,8326055,Schonach im Schwarzwald,3 -  6 Jahre,91,47,44
False,8326055,Schonach im Schwarzwald,6 - 10 Jahre,119,69,50
False,8326055,Schonach im Schwarzwald,10 - 15 Jahre,240,123,117
False,8326055,Schonach im Schwarzwald,15 - 18 Jahre,152,79,73
False,8326055,Schonach im Schwarzwald,18 - 20 Jahre,109,59,50
False,8326055,Schonach im Schwarzwald,20 - 25 Jahre,242,130,112
False,8326055,Schonach im Schwarzwald,25 - 30 Jahre,171,98,73
False,8326055,Schonach im Schwarzwald,30 - 35 Jahre,161,76,85
False,8326055,Schonach im Schwarzwald,35 - 40 Jahre,204,111,93
False,8326055,Schonach im Schwarzwald,40 - 45 Jahre,283,153,130
False,8326055,Schonach im Schwarzwald,45 - 50 Jahre,302,138,164
False,8326055,Schonach im Schwarzwald,50 - 55 Jahre,268,140,128
False,8326055,Schonach im Schwarzwald,55 - 60 Jahre,272,126,146
False,8326055,Schonach im Schwarzwald,60 - 65 Jahre,234,120,114
False,8326055,Schonach im Schwarzwald,65 - 75 Jahre,573,262,311
False,8326055,Schonach im Schwarzwald,75 und mehr Jahre,405,177,228
False,8326055,Schonach im Schwarzwald,Insgesamt,3889,1942,1947
False,8326060,"Triberg im Schwarzwald, Stadt",unter 3 Jahre,91,54,37
False,8326060,"Triberg im Schwarzwald, Stadt",3 -  6 Jahre,124,63,61
False,8326060,"Triberg im Schwarzwald, Stadt",6 - 10 Jahre,143,72,71
False,8326060,"Triberg im Schwarzwald, Stadt",10 - 15 Jahre,285,153,132
False,8326060,"Triberg im Schwarzwald, Stadt",15 - 18 Jahre,168,83,85
False,8326060,"Triberg im Schwarzwald, Stadt",18 - 20 Jahre,123,62,61
False,8326060,"Triberg im Schwarzwald, Stadt",20 - 25 Jahre,307,164,143
False,8326060,"Triberg im Schwarzwald, Stadt",25 - 30 Jahre,208,112,96
False,8326060,"Triberg im Schwarzwald, Stadt",30 - 35 Jahre,182,94,88
False,8326060,"Triberg im Schwarzwald, Stadt",35 - 40 Jahre,239,114,125
False,8326060,"Triberg im Schwarzwald, Stadt",40 - 45 Jahre,372,170,202
False,8326060,"Triberg im Schwarzwald, Stadt",45 - 50 Jahre,437,218,219
False,8326060,"Triberg im Schwarzwald, Stadt",50 - 55 Jahre,347,195,152
False,8326060,"Triberg im Schwarzwald, Stadt",55 - 60 Jahre,279,136,143
False,8326060,"Triberg im Schwarzwald, Stadt",60 - 65 Jahre,256,134,122
False,8326060,"Triberg im Schwarzwald, Stadt",65 - 75 Jahre,572,263,309
False,8326060,"Triberg im Schwarzwald, Stadt",75 und mehr Jahre,657,246,411
False,8326060,"Triberg im Schwarzwald, Stadt",Insgesamt,4790,2333,2457
False,8326061,Tuningen,unter 3 Jahre,83,45,38
False,8326061,Tuningen,3 -  6 Jahre,92,42,50
False,8326061,Tuningen,6 - 10 Jahre,118,55,63
False,8326061,Tuningen,10 - 15 Jahre,151,67,84
False,8326061,Tuningen,15 - 18 Jahre,115,58,57
False,8326061,Tuningen,18 - 20 Jahre,79,45,34
False,8326061,Tuningen,20 - 25 Jahre,179,96,83
False,8326061,Tuningen,25 - 30 Jahre,176,95,81
False,8326061,Tuningen,30 - 35 Jahre,166,83,83
False,8326061,Tuningen,35 - 40 Jahre,192,93,99
False,8326061,Tuningen,40 - 45 Jahre,235,112,123
False,8326061,Tuningen,45 - 50 Jahre,263,143,120
False,8326061,Tuningen,50 - 55 Jahre,224,111,113
False,8326061,Tuningen,55 - 60 Jahre,162,86,76
False,8326061,Tuningen,60 - 65 Jahre,134,75,59
False,8326061,Tuningen,65 - 75 Jahre,269,130,139
False,8326061,Tuningen,75 und mehr Jahre,225,81,144
False,8326061,Tuningen,Insgesamt,2863,1417,1446
False,8326065,Unterkirnach,unter 3 Jahre,69,39,30
False,8326065,Unterkirnach,3 -  6 Jahre,68,44,24
False,8326065,Unterkirnach,6 - 10 Jahre,91,44,47
False,8326065,Unterkirnach,10 - 15 Jahre,144,78,66
False,8326065,Unterkirnach,15 - 18 Jahre,77,40,37
False,8326065,Unterkirnach,18 - 20 Jahre,58,36,22
False,8326065,Unterkirnach,20 - 25 Jahre,178,104,74
False,8326065,Unterkirnach,25 - 30 Jahre,174,96,78
False,8326065,Unterkirnach,30 - 35 Jahre,136,79,57
False,8326065,Unterkirnach,35 - 40 Jahre,164,94,70
False,8326065,Unterkirnach,40 - 45 Jahre,227,115,112
False,8326065,Unterkirnach,45 - 50 Jahre,266,143,123
False,8326065,Unterkirnach,50 - 55 Jahre,230,116,114
False,8326065,Unterkirnach,55 - 60 Jahre,183,94,89
False,8326065,Unterkirnach,60 - 65 Jahre,165,92,73
False,8326065,Unterkirnach,65 - 75 Jahre,279,133,146
False,8326065,Unterkirnach,75 und mehr Jahre,213,98,115
False,8326065,Unterkirnach,Insgesamt,2722,1445,1277
False,8326068,"Vöhrenbach, Stadt",unter 3 Jahre,95,50,45
False,8326068,"Vöhrenbach, Stadt",3 -  6 Jahre,79,39,40
False,8326068,"Vöhrenbach, Stadt",6 - 10 Jahre,142,59,83
False,8326068,"Vöhrenbach, Stadt",10 - 15 Jahre,246,125,121
False,8326068,"Vöhrenbach, Stadt",15 - 18 Jahre,147,81,66
False,8326068,"Vöhrenbach, Stadt",18 - 20 Jahre,92,47,45
False,8326068,"Vöhrenbach, Stadt",20 - 25 Jahre,223,120,103
False,8326068,"Vöhrenbach, Stadt",25 - 30 Jahre,185,91,94
False,8326068,"Vöhrenbach, Stadt",30 - 35 Jahre,153,80,73
False,8326068,"Vöhrenbach, Stadt",35 - 40 Jahre,204,104,100
False,8326068,"Vöhrenbach, Stadt",40 - 45 Jahre,323,171,152
False,8326068,"Vöhrenbach, Stadt",45 - 50 Jahre,322,166,156
False,8326068,"Vöhrenbach, Stadt",50 - 55 Jahre,292,171,121
False,8326068,"Vöhrenbach, Stadt",55 - 60 Jahre,222,119,103
False,8326068,"Vöhrenbach, Stadt",60 - 65 Jahre,236,120,116
False,8326068,"Vöhrenbach, Stadt",65 - 75 Jahre,443,222,221
False,8326068,"Vöhrenbach, Stadt",75 und mehr Jahre,401,169,232
False,8326068,"Vöhrenbach, Stadt",Insgesamt,3805,1934,1871
False,8326074,"Villingen-Schwenningen, Stadt",unter 3 Jahre,2123,1068,1055
False,8326074,"Villingen-Schwenningen, Stadt",3 -  6 Jahre,2116,1042,1074
False,8326074,"Villingen-Schwenningen, Stadt",6 - 10 Jahre,2868,1454,1414
False,8326074,"Villingen-Schwenningen, Stadt",10 - 15 Jahre,4123,2187,1936
False,8326074,"Villingen-Schwenningen, Stadt",15 - 18 Jahre,2527,1306,1221
False,8326074,"Villingen-Schwenningen, Stadt",18 - 20 Jahre,1874,961,913
False,8326074,"Villingen-Schwenningen, Stadt",20 - 25 Jahre,5035,2500,2535
False,8326074,"Villingen-Schwenningen, Stadt",25 - 30 Jahre,4873,2465,2408
False,8326074,"Villingen-Schwenningen, Stadt",30 - 35 Jahre,4801,2466,2335
False,8326074,"Villingen-Schwenningen, Stadt",35 - 40 Jahre,4667,2347,2320
False,8326074,"Villingen-Schwenningen, Stadt",40 - 45 Jahre,5948,3007,2941
False,8326074,"Villingen-Schwenningen, Stadt",45 - 50 Jahre,6159,3154,3005
False,8326074,"Villingen-Schwenningen, Stadt",50 - 55 Jahre,5909,2917,2992
False,8326074,"Villingen-Schwenningen, Stadt",55 - 60 Jahre,5292,2542,2750
False,8326074,"Villingen-Schwenningen, Stadt",60 - 65 Jahre,4668,2199,2469
False,8326074,"Villingen-Schwenningen, Stadt",65 - 75 Jahre,9644,4451,5193
False,8326074,"Villingen-Schwenningen, Stadt",75 und mehr Jahre,8395,3200,5195
False,8326074,"Villingen-Schwenningen, Stadt",Insgesamt,81022,39266,41756
False,8326075,Brigachtal,unter 3 Jahre,114,52,62
False,8326075,Brigachtal,3 -  6 Jahre,129,56,73
False,8326075,Brigachtal,6 - 10 Jahre,193,98,95
False,8326075,Brigachtal,10 - 15 Jahre,302,158,144
False,8326075,Brigachtal,15 - 18 Jahre,166,85,81
False,8326075,Brigachtal,18 - 20 Jahre,102,62,40
False,8326075,Brigachtal,20 - 25 Jahre,290,145,145
False,8326075,Brigachtal,25 - 30 Jahre,306,150,156
False,8326075,Brigachtal,30 - 35 Jahre,286,146,140
False,8326075,Brigachtal,35 - 40 Jahre,312,153,159
False,8326075,Brigachtal,40 - 45 Jahre,415,196,219
False,8326075,Brigachtal,45 - 50 Jahre,421,219,202
False,8326075,Brigachtal,50 - 55 Jahre,443,217,226
False,8326075,Brigachtal,55 - 60 Jahre,390,186,204
False,8326075,Brigachtal,60 - 65 Jahre,334,167,167
False,8326075,Brigachtal,65 - 75 Jahre,513,258,255
False,8326075,Brigachtal,75 und mehr Jahre,379,148,231
False,8326075,Brigachtal,Insgesamt,5095,2496,2599
False,8327,Landkreis Tuttlingen,unter 3 Jahre,3697,1861,1836
False,8327,Landkreis Tuttlingen,3 -  6 Jahre,3910,2020,1890
False,8327,Landkreis Tuttlingen,6 - 10 Jahre,5541,2849,2692
False,8327,Landkreis Tuttlingen,10 - 15 Jahre,7918,4069,3849
False,8327,Landkreis Tuttlingen,15 - 18 Jahre,4774,2466,2308
False,8327,Landkreis Tuttlingen,18 - 20 Jahre,3354,1741,1613
False,8327,Landkreis Tuttlingen,20 - 25 Jahre,8169,4191,3978
False,8327,Landkreis Tuttlingen,25 - 30 Jahre,7900,4105,3795
False,8327,Landkreis Tuttlingen,30 - 35 Jahre,7762,3845,3917
False,8327,Landkreis Tuttlingen,35 - 40 Jahre,8239,4215,4024
False,8327,Landkreis Tuttlingen,40 - 45 Jahre,10356,5297,5059
False,8327,Landkreis Tuttlingen,45 - 50 Jahre,11054,5701,5353
False,8327,Landkreis Tuttlingen,50 - 55 Jahre,10014,5003,5011
False,8327,Landkreis Tuttlingen,55 - 60 Jahre,8571,4271,4300
False,8327,Landkreis Tuttlingen,60 - 65 Jahre,6897,3454,3443
False,8327,Landkreis Tuttlingen,65 - 75 Jahre,13927,6619,7308
False,8327,Landkreis Tuttlingen,75 und mehr Jahre,12106,4781,7325
False,8327,Landkreis Tuttlingen,Insgesamt,134189,66488,67701
False,8327002,Aldingen,unter 3 Jahre,200,92,108
False,8327002,Aldingen,3 -  6 Jahre,212,110,102
False,8327002,Aldingen,6 - 10 Jahre,334,173,161
False,8327002,Aldingen,10 - 15 Jahre,452,240,212
False,8327002,Aldingen,15 - 18 Jahre,299,165,134
False,8327002,Aldingen,18 - 20 Jahre,194,103,91
False,8327002,Aldingen,20 - 25 Jahre,468,246,222
False,8327002,Aldingen,25 - 30 Jahre,416,219,197
False,8327002,Aldingen,30 - 35 Jahre,440,220,220
False,8327002,Aldingen,35 - 40 Jahre,501,263,238
False,8327002,Aldingen,40 - 45 Jahre,618,293,325
False,8327002,Aldingen,45 - 50 Jahre,615,334,281
False,8327002,Aldingen,50 - 55 Jahre,546,283,263
False,8327002,Aldingen,55 - 60 Jahre,472,223,249
False,8327002,Aldingen,60 - 65 Jahre,361,190,171
False,8327002,Aldingen,65 - 75 Jahre,720,357,363
False,8327002,Aldingen,75 und mehr Jahre,726,291,435
False,8327002,Aldingen,Insgesamt,7574,3802,3772
False,8327004,Bärenthal,unter 3 Jahre,8,5,3
False,8327004,Bärenthal,3 -  6 Jahre,12,6,6
False,8327004,Bärenthal,6 - 10 Jahre,15,8,7
False,8327004,Bärenthal,10 - 15 Jahre,28,13,15
False,8327004,Bärenthal,15 - 18 Jahre,9,3,6
False,8327004,Bärenthal,18 - 20 Jahre,16,8,8
False,8327004,Bärenthal,20 - 25 Jahre,32,16,16
False,8327004,Bärenthal,25 - 30 Jahre,25,14,11
False,8327004,Bärenthal,30 - 35 Jahre,33,14,19
False,8327004,Bärenthal,35 - 40 Jahre,20,11,9
False,8327004,Bärenthal,40 - 45 Jahre,30,13,17
False,8327004,Bärenthal,45 - 50 Jahre,35,20,15
False,8327004,Bärenthal,50 - 55 Jahre,35,14,21
False,8327004,Bärenthal,55 - 60 Jahre,33,20,13
False,8327004,Bärenthal,60 - 65 Jahre,13,7,6
False,8327004,Bärenthal,65 - 75 Jahre,48,21,27
False,8327004,Bärenthal,75 und mehr Jahre,47,22,25
False,8327004,Bärenthal,Insgesamt,439,215,224
False,8327005,Balgheim,unter 3 Jahre,57,32,25
False,8327005,Balgheim,3 -  6 Jahre,40,24,16
False,8327005,Balgheim,6 - 10 Jahre,39,23,16
False,8327005,Balgheim,10 - 15 Jahre,72,32,40
False,8327005,Balgheim,15 - 18 Jahre,43,26,17
False,8327005,Balgheim,18 - 20 Jahre,36,21,15
False,8327005,Balgheim,20 - 25 Jahre,58,35,23
False,8327005,Balgheim,25 - 30 Jahre,69,30,39
False,8327005,Balgheim,30 - 35 Jahre,70,35,35
False,8327005,Balgheim,35 - 40 Jahre,80,41,39
False,8327005,Balgheim,40 - 45 Jahre,101,52,49
False,8327005,Balgheim,45 - 50 Jahre,86,41,45
False,8327005,Balgheim,50 - 55 Jahre,76,35,41
False,8327005,Balgheim,55 - 60 Jahre,72,37,35
False,8327005,Balgheim,60 - 65 Jahre,59,28,31
False,8327005,Balgheim,65 - 75 Jahre,109,54,55
False,8327005,Balgheim,75 und mehr Jahre,59,29,30
False,8327005,Balgheim,Insgesamt,1126,575,551
False,8327006,Böttingen,unter 3 Jahre,45,21,24
False,8327006,Böttingen,3 -  6 Jahre,52,28,24
False,8327006,Böttingen,6 - 10 Jahre,60,33,27
False,8327006,Böttingen,10 - 15 Jahre,101,53,48
False,8327006,Böttingen,15 - 18 Jahre,74,36,38
False,8327006,Böttingen,18 - 20 Jahre,41,20,21
False,8327006,Böttingen,20 - 25 Jahre,83,50,33
False,8327006,Böttingen,25 - 30 Jahre,76,35,41
False,8327006,Böttingen,30 - 35 Jahre,69,38,31
False,8327006,Böttingen,35 - 40 Jahre,97,46,51
False,8327006,Böttingen,40 - 45 Jahre,124,64,60
False,8327006,Böttingen,45 - 50 Jahre,150,74,76
False,8327006,Böttingen,50 - 55 Jahre,102,63,39
False,8327006,Böttingen,55 - 60 Jahre,99,48,51
False,8327006,Böttingen,60 - 65 Jahre,61,35,26
False,8327006,Böttingen,65 - 75 Jahre,137,67,70
False,8327006,Böttingen,75 und mehr Jahre,118,36,82
False,8327006,Böttingen,Insgesamt,1489,747,742
False,8327007,Bubsheim,unter 3 Jahre,30,14,16
False,8327007,Bubsheim,3 -  6 Jahre,41,20,21
False,8327007,Bubsheim,6 - 10 Jahre,64,30,34
False,8327007,Bubsheim,10 - 15 Jahre,73,45,28
False,8327007,Bubsheim,15 - 18 Jahre,34,14,20
False,8327007,Bubsheim,18 - 20 Jahre,32,16,16
False,8327007,Bubsheim,20 - 25 Jahre,87,65,22
False,8327007,Bubsheim,25 - 30 Jahre,95,60,35
False,8327007,Bubsheim,30 - 35 Jahre,84,41,43
False,8327007,Bubsheim,35 - 40 Jahre,86,44,42
False,8327007,Bubsheim,40 - 45 Jahre,69,44,25
False,8327007,Bubsheim,45 - 50 Jahre,85,46,39
False,8327007,Bubsheim,50 - 55 Jahre,95,41,54
False,8327007,Bubsheim,55 - 60 Jahre,86,44,42
False,8327007,Bubsheim,60 - 65 Jahre,59,27,32
False,8327007,Bubsheim,65 - 75 Jahre,80,36,44
False,8327007,Bubsheim,75 und mehr Jahre,72,31,41
False,8327007,Bubsheim,Insgesamt,1172,618,554
False,8327008,Buchheim,unter 3 Jahre,17,4,13
False,8327008,Buchheim,3 -  6 Jahre,24,11,13
False,8327008,Buchheim,6 - 10 Jahre,24,12,12
False,8327008,Buchheim,10 - 15 Jahre,38,17,21
False,8327008,Buchheim,15 - 18 Jahre,36,18,18
False,8327008,Buchheim,18 - 20 Jahre,18,10,8
False,8327008,Buchheim,20 - 25 Jahre,42,20,22
False,8327008,Buchheim,25 - 30 Jahre,38,24,14
False,8327008,Buchheim,30 - 35 Jahre,27,15,12
False,8327008,Buchheim,35 - 40 Jahre,34,15,19
False,8327008,Buchheim,40 - 45 Jahre,43,26,17
False,8327008,Buchheim,45 - 50 Jahre,51,30,21
False,8327008,Buchheim,50 - 55 Jahre,52,27,25
False,8327008,Buchheim,55 - 60 Jahre,51,29,22
False,8327008,Buchheim,60 - 65 Jahre,37,24,13
False,8327008,Buchheim,65 - 75 Jahre,31,13,18
False,8327008,Buchheim,75 und mehr Jahre,57,24,33
False,8327008,Buchheim,Insgesamt,620,319,301
False,8327009,Deilingen,unter 3 Jahre,54,29,25
False,8327009,Deilingen,3 -  6 Jahre,52,26,26
False,8327009,Deilingen,6 - 10 Jahre,61,36,25
False,8327009,Deilingen,10 - 15 Jahre,107,56,51
False,8327009,Deilingen,15 - 18 Jahre,68,42,26
False,8327009,Deilingen,18 - 20 Jahre,50,24,26
False,8327009,Deilingen,20 - 25 Jahre,96,35,61
False,8327009,Deilingen,25 - 30 Jahre,108,54,54
False,8327009,Deilingen,30 - 35 Jahre,101,51,50
False,8327009,Deilingen,35 - 40 Jahre,101,55,46
False,8327009,Deilingen,40 - 45 Jahre,136,67,69
False,8327009,Deilingen,45 - 50 Jahre,134,69,65
False,8327009,Deilingen,50 - 55 Jahre,132,65,67
False,8327009,Deilingen,55 - 60 Jahre,106,55,51
False,8327009,Deilingen,60 - 65 Jahre,88,52,36
False,8327009,Deilingen,65 - 75 Jahre,154,65,89
False,8327009,Deilingen,75 und mehr Jahre,129,44,85
False,8327009,Deilingen,Insgesamt,1677,825,852
False,8327010,Denkingen,unter 3 Jahre,74,37,37
False,8327010,Denkingen,3 -  6 Jahre,86,33,53
False,8327010,Denkingen,6 - 10 Jahre,109,54,55
False,8327010,Denkingen,10 - 15 Jahre,156,83,73
False,8327010,Denkingen,15 - 18 Jahre,101,54,47
False,8327010,Denkingen,18 - 20 Jahre,71,38,33
False,8327010,Denkingen,20 - 25 Jahre,150,82,68
False,8327010,Denkingen,25 - 30 Jahre,136,70,66
False,8327010,Denkingen,30 - 35 Jahre,129,63,66
False,8327010,Denkingen,35 - 40 Jahre,163,87,76
False,8327010,Denkingen,40 - 45 Jahre,204,115,89
False,8327010,Denkingen,45 - 50 Jahre,222,112,110
False,8327010,Denkingen,50 - 55 Jahre,168,77,91
False,8327010,Denkingen,55 - 60 Jahre,177,83,94
False,8327010,Denkingen,60 - 65 Jahre,132,69,63
False,8327010,Denkingen,65 - 75 Jahre,257,122,135
False,8327010,Denkingen,75 und mehr Jahre,190,88,102
False,8327010,Denkingen,Insgesamt,2525,1267,1258
False,8327011,Dürbheim,unter 3 Jahre,45,17,28
False,8327011,Dürbheim,3 -  6 Jahre,49,27,22
False,8327011,Dürbheim,6 - 10 Jahre,69,39,30
False,8327011,Dürbheim,10 - 15 Jahre,96,59,37
False,8327011,Dürbheim,15 - 18 Jahre,73,33,40
False,8327011,Dürbheim,18 - 20 Jahre,33,22,11
False,8327011,Dürbheim,20 - 25 Jahre,102,58,44
False,8327011,Dürbheim,25 - 30 Jahre,87,37,50
False,8327011,Dürbheim,30 - 35 Jahre,95,46,49
False,8327011,Dürbheim,35 - 40 Jahre,100,46,54
False,8327011,Dürbheim,40 - 45 Jahre,132,57,75
False,8327011,Dürbheim,45 - 50 Jahre,183,98,85
False,8327011,Dürbheim,50 - 55 Jahre,126,65,61
False,8327011,Dürbheim,55 - 60 Jahre,110,56,54
False,8327011,Dürbheim,60 - 65 Jahre,92,42,50
False,8327011,Dürbheim,65 - 75 Jahre,159,88,71
False,8327011,Dürbheim,75 und mehr Jahre,123,59,64
False,8327011,Dürbheim,Insgesamt,1674,849,825
False,8327012,Durchhausen,unter 3 Jahre,29,20,9
False,8327012,Durchhausen,3 -  6 Jahre,27,15,12
False,8327012,Durchhausen,6 - 10 Jahre,34,18,16
False,8327012,Durchhausen,10 - 15 Jahre,59,36,23
False,8327012,Durchhausen,15 - 18 Jahre,43,24,19
False,8327012,Durchhausen,18 - 20 Jahre,18,9,9
False,8327012,Durchhausen,20 - 25 Jahre,49,28,21
False,8327012,Durchhausen,25 - 30 Jahre,50,27,23
False,8327012,Durchhausen,30 - 35 Jahre,41,22,19
False,8327012,Durchhausen,35 - 40 Jahre,64,36,28
False,8327012,Durchhausen,40 - 45 Jahre,80,44,36
False,8327012,Durchhausen,45 - 50 Jahre,71,38,33
False,8327012,Durchhausen,50 - 55 Jahre,72,36,36
False,8327012,Durchhausen,55 - 60 Jahre,52,29,23
False,8327012,Durchhausen,60 - 65 Jahre,45,24,21
False,8327012,Durchhausen,65 - 75 Jahre,106,44,62
False,8327012,Durchhausen,75 und mehr Jahre,82,36,46
False,8327012,Durchhausen,Insgesamt,922,486,436
False,8327013,Egesheim,unter 3 Jahre,13,7,6
False,8327013,Egesheim,3 -  6 Jahre,20,11,9
False,8327013,Egesheim,6 - 10 Jahre,31,10,21
False,8327013,Egesheim,10 - 15 Jahre,45,23,22
False,8327013,Egesheim,15 - 18 Jahre,21,7,14
False,8327013,Egesheim,18 - 20 Jahre,23,14,9
False,8327013,Egesheim,20 - 25 Jahre,43,26,17
False,8327013,Egesheim,25 - 30 Jahre,45,24,21
False,8327013,Egesheim,30 - 35 Jahre,46,27,19
False,8327013,Egesheim,35 - 40 Jahre,47,21,26
False,8327013,Egesheim,40 - 45 Jahre,46,29,17
False,8327013,Egesheim,45 - 50 Jahre,51,26,25
False,8327013,Egesheim,50 - 55 Jahre,54,31,23
False,8327013,Egesheim,55 - 60 Jahre,19,11,8
False,8327013,Egesheim,60 - 65 Jahre,31,12,19
False,8327013,Egesheim,65 - 75 Jahre,60,31,29
False,8327013,Egesheim,75 und mehr Jahre,36,13,23
False,8327013,Egesheim,Insgesamt,631,323,308
False,8327016,"Fridingen an der Donau, Stadt",unter 3 Jahre,76,31,45
False,8327016,"Fridingen an der Donau, Stadt",3 -  6 Jahre,68,31,37
False,8327016,"Fridingen an der Donau, Stadt",6 - 10 Jahre,102,56,46
False,8327016,"Fridingen an der Donau, Stadt",10 - 15 Jahre,180,93,87
False,8327016,"Fridingen an der Donau, Stadt",15 - 18 Jahre,124,65,59
False,8327016,"Fridingen an der Donau, Stadt",18 - 20 Jahre,92,48,44
False,8327016,"Fridingen an der Donau, Stadt",20 - 25 Jahre,190,99,91
False,8327016,"Fridingen an der Donau, Stadt",25 - 30 Jahre,161,94,67
False,8327016,"Fridingen an der Donau, Stadt",30 - 35 Jahre,143,77,66
False,8327016,"Fridingen an der Donau, Stadt",35 - 40 Jahre,145,73,72
False,8327016,"Fridingen an der Donau, Stadt",40 - 45 Jahre,230,121,109
False,8327016,"Fridingen an der Donau, Stadt",45 - 50 Jahre,296,143,153
False,8327016,"Fridingen an der Donau, Stadt",50 - 55 Jahre,256,127,129
False,8327016,"Fridingen an der Donau, Stadt",55 - 60 Jahre,218,108,110
False,8327016,"Fridingen an der Donau, Stadt",60 - 65 Jahre,177,94,83
False,8327016,"Fridingen an der Donau, Stadt",65 - 75 Jahre,365,172,193
False,8327016,"Fridingen an der Donau, Stadt",75 und mehr Jahre,292,121,171
False,8327016,"Fridingen an der Donau, Stadt",Insgesamt,3115,1553,1562
False,8327017,Frittlingen,unter 3 Jahre,77,37,40
False,8327017,Frittlingen,3 -  6 Jahre,77,40,37
False,8327017,Frittlingen,6 - 10 Jahre,75,40,35
False,8327017,Frittlingen,10 - 15 Jahre,117,65,52
False,8327017,Frittlingen,15 - 18 Jahre,96,46,50
False,8327017,Frittlingen,18 - 20 Jahre,58,25,33
False,8327017,Frittlingen,20 - 25 Jahre,125,62,63
False,8327017,Frittlingen,25 - 30 Jahre,125,68,57
False,8327017,Frittlingen,30 - 35 Jahre,111,60,51
False,8327017,Frittlingen,35 - 40 Jahre,133,62,71
False,8327017,Frittlingen,40 - 45 Jahre,177,98,79
False,8327017,Frittlingen,45 - 50 Jahre,185,95,90
False,8327017,Frittlingen,50 - 55 Jahre,166,82,84
False,8327017,Frittlingen,55 - 60 Jahre,135,79,56
False,8327017,Frittlingen,60 - 65 Jahre,104,53,51
False,8327017,Frittlingen,65 - 75 Jahre,198,99,99
False,8327017,Frittlingen,75 und mehr Jahre,168,67,101
False,8327017,Frittlingen,Insgesamt,2127,1078,1049
False,8327018,"Geisingen, Stadt",unter 3 Jahre,172,86,86
False,8327018,"Geisingen, Stadt",3 -  6 Jahre,162,89,73
False,8327018,"Geisingen, Stadt",6 - 10 Jahre,250,135,115
False,8327018,"Geisingen, Stadt",10 - 15 Jahre,357,171,186
False,8327018,"Geisingen, Stadt",15 - 18 Jahre,223,112,111
False,8327018,"Geisingen, Stadt",18 - 20 Jahre,137,72,65
False,8327018,"Geisingen, Stadt",20 - 25 Jahre,344,190,154
False,8327018,"Geisingen, Stadt",25 - 30 Jahre,348,174,174
False,8327018,"Geisingen, Stadt",30 - 35 Jahre,337,159,178
False,8327018,"Geisingen, Stadt",35 - 40 Jahre,365,179,186
False,8327018,"Geisingen, Stadt",40 - 45 Jahre,426,217,209
False,8327018,"Geisingen, Stadt",45 - 50 Jahre,518,294,224
False,8327018,"Geisingen, Stadt",50 - 55 Jahre,455,233,222
False,8327018,"Geisingen, Stadt",55 - 60 Jahre,464,255,209
False,8327018,"Geisingen, Stadt",60 - 65 Jahre,321,163,158
False,8327018,"Geisingen, Stadt",65 - 75 Jahre,613,304,309
False,8327018,"Geisingen, Stadt",75 und mehr Jahre,517,199,318
False,8327018,"Geisingen, Stadt",Insgesamt,6009,3032,2977
False,8327019,Gosheim,unter 3 Jahre,117,66,51
False,8327019,Gosheim,3 -  6 Jahre,120,55,65
False,8327019,Gosheim,6 - 10 Jahre,188,101,87
False,8327019,Gosheim,10 - 15 Jahre,248,128,120
False,8327019,Gosheim,15 - 18 Jahre,137,71,66
False,8327019,Gosheim,18 - 20 Jahre,109,61,48
False,8327019,Gosheim,20 - 25 Jahre,246,131,115
False,8327019,Gosheim,25 - 30 Jahre,236,126,110
False,8327019,Gosheim,30 - 35 Jahre,232,114,118
False,8327019,Gosheim,35 - 40 Jahre,203,99,104
False,8327019,Gosheim,40 - 45 Jahre,258,132,126
False,8327019,Gosheim,45 - 50 Jahre,315,150,165
False,8327019,Gosheim,50 - 55 Jahre,307,160,147
False,8327019,Gosheim,55 - 60 Jahre,219,117,102
False,8327019,Gosheim,60 - 65 Jahre,172,87,85
False,8327019,Gosheim,65 - 75 Jahre,344,149,195
False,8327019,Gosheim,75 und mehr Jahre,349,125,224
False,8327019,Gosheim,Insgesamt,3800,1872,1928
False,8327020,Gunningen,unter 3 Jahre,18,12,6
False,8327020,Gunningen,3 -  6 Jahre,18,10,8
False,8327020,Gunningen,6 - 10 Jahre,21,10,11
False,8327020,Gunningen,10 - 15 Jahre,41,21,20
False,8327020,Gunningen,15 - 18 Jahre,33,15,18
False,8327020,Gunningen,18 - 20 Jahre,24,14,10
False,8327020,Gunningen,20 - 25 Jahre,42,22,20
False,8327020,Gunningen,25 - 30 Jahre,48,27,21
False,8327020,Gunningen,30 - 35 Jahre,42,19,23
False,8327020,Gunningen,35 - 40 Jahre,39,22,17
False,8327020,Gunningen,40 - 45 Jahre,63,29,34
False,8327020,Gunningen,45 - 50 Jahre,55,25,30
False,8327020,Gunningen,50 - 55 Jahre,59,30,29
False,8327020,Gunningen,55 - 60 Jahre,54,27,27
False,8327020,Gunningen,60 - 65 Jahre,33,14,19
False,8327020,Gunningen,65 - 75 Jahre,82,43,39
False,8327020,Gunningen,75 und mehr Jahre,38,15,23
False,8327020,Gunningen,Insgesamt,710,355,355
False,8327023,Hausen ob Verena,unter 3 Jahre,22,14,8
False,8327023,Hausen ob Verena,3 -  6 Jahre,21,12,9
False,8327023,Hausen ob Verena,6 - 10 Jahre,26,13,13
False,8327023,Hausen ob Verena,10 - 15 Jahre,34,15,19
False,8327023,Hausen ob Verena,15 - 18 Jahre,32,18,14
False,8327023,Hausen ob Verena,18 - 20 Jahre,22,12,10
False,8327023,Hausen ob Verena,20 - 25 Jahre,42,24,18
False,8327023,Hausen ob Verena,25 - 30 Jahre,29,12,17
False,8327023,Hausen ob Verena,30 - 35 Jahre,39,17,22
False,8327023,Hausen ob Verena,35 - 40 Jahre,45,19,26
False,8327023,Hausen ob Verena,40 - 45 Jahre,66,36,30
False,8327023,Hausen ob Verena,45 - 50 Jahre,74,36,38
False,8327023,Hausen ob Verena,50 - 55 Jahre,55,19,36
False,8327023,Hausen ob Verena,55 - 60 Jahre,45,23,22
False,8327023,Hausen ob Verena,60 - 65 Jahre,40,22,18
False,8327023,Hausen ob Verena,65 - 75 Jahre,94,52,42
False,8327023,Hausen ob Verena,75 und mehr Jahre,64,27,37
False,8327023,Hausen ob Verena,Insgesamt,750,371,379
False,8327025,Immendingen,unter 3 Jahre,189,98,91
False,8327025,Immendingen,3 -  6 Jahre,198,97,101
False,8327025,Immendingen,6 - 10 Jahre,260,131,129
False,8327025,Immendingen,10 - 15 Jahre,345,175,170
False,8327025,Immendingen,15 - 18 Jahre,174,81,93
False,8327025,Immendingen,18 - 20 Jahre,148,91,57
False,8327025,Immendingen,20 - 25 Jahre,381,214,167
False,8327025,Immendingen,25 - 30 Jahre,371,219,152
False,8327025,Immendingen,30 - 35 Jahre,341,171,170
False,8327025,Immendingen,35 - 40 Jahre,398,232,166
False,8327025,Immendingen,40 - 45 Jahre,560,345,215
False,8327025,Immendingen,45 - 50 Jahre,525,310,215
False,8327025,Immendingen,50 - 55 Jahre,405,205,200
False,8327025,Immendingen,55 - 60 Jahre,353,170,183
False,8327025,Immendingen,60 - 65 Jahre,299,160,139
False,8327025,Immendingen,65 - 75 Jahre,542,257,285
False,8327025,Immendingen,75 und mehr Jahre,414,178,236
False,8327025,Immendingen,Insgesamt,5903,3134,2769
False,8327027,Irndorf,unter 3 Jahre,18,12,6
False,8327027,Irndorf,3 -  6 Jahre,14,6,8
False,8327027,Irndorf,6 - 10 Jahre,41,18,23
False,8327027,Irndorf,10 - 15 Jahre,47,20,27
False,8327027,Irndorf,15 - 18 Jahre,31,15,16
False,8327027,Irndorf,18 - 20 Jahre,22,8,14
False,8327027,Irndorf,20 - 25 Jahre,30,13,17
False,8327027,Irndorf,25 - 30 Jahre,36,17,19
False,8327027,Irndorf,30 - 35 Jahre,43,24,19
False,8327027,Irndorf,35 - 40 Jahre,35,12,23
False,8327027,Irndorf,40 - 45 Jahre,64,37,27
False,8327027,Irndorf,45 - 50 Jahre,78,37,41
False,8327027,Irndorf,50 - 55 Jahre,63,28,35
False,8327027,Irndorf,55 - 60 Jahre,50,28,22
False,8327027,Irndorf,60 - 65 Jahre,23,14,9
False,8327027,Irndorf,65 - 75 Jahre,87,38,49
False,8327027,Irndorf,75 und mehr Jahre,90,35,55
False,8327027,Irndorf,Insgesamt,772,362,410
False,8327029,Königsheim,unter 3 Jahre,18,7,11
False,8327029,Königsheim,3 -  6 Jahre,15,10,5
False,8327029,Königsheim,6 - 10 Jahre,27,16,11
False,8327029,Königsheim,10 - 15 Jahre,35,19,16
False,8327029,Königsheim,15 - 18 Jahre,23,14,9
False,8327029,Königsheim,18 - 20 Jahre,13,7,6
False,8327029,Königsheim,20 - 25 Jahre,36,20,16
False,8327029,Königsheim,25 - 30 Jahre,25,15,10
False,8327029,Königsheim,30 - 35 Jahre,34,16,18
False,8327029,Königsheim,35 - 40 Jahre,33,18,15
False,8327029,Königsheim,40 - 45 Jahre,48,20,28
False,8327029,Königsheim,45 - 50 Jahre,55,31,24
False,8327029,Königsheim,50 - 55 Jahre,42,24,18
False,8327029,Königsheim,55 - 60 Jahre,32,16,16
False,8327029,Königsheim,60 - 65 Jahre,19,9,10
False,8327029,Königsheim,65 - 75 Jahre,45,23,22
False,8327029,Königsheim,75 und mehr Jahre,55,23,32
False,8327029,Königsheim,Insgesamt,555,288,267
False,8327030,Kolbingen,unter 3 Jahre,36,18,18
False,8327030,Kolbingen,3 -  6 Jahre,36,17,19
False,8327030,Kolbingen,6 - 10 Jahre,52,30,22
False,8327030,Kolbingen,10 - 15 Jahre,79,31,48
False,8327030,Kolbingen,15 - 18 Jahre,51,22,29
False,8327030,Kolbingen,18 - 20 Jahre,34,17,17
False,8327030,Kolbingen,20 - 25 Jahre,53,29,24
False,8327030,Kolbingen,25 - 30 Jahre,62,28,34
False,8327030,Kolbingen,30 - 35 Jahre,59,33,26
False,8327030,Kolbingen,35 - 40 Jahre,78,40,38
False,8327030,Kolbingen,40 - 45 Jahre,113,60,53
False,8327030,Kolbingen,45 - 50 Jahre,118,59,59
False,8327030,Kolbingen,50 - 55 Jahre,96,50,46
False,8327030,Kolbingen,55 - 60 Jahre,81,35,46
False,8327030,Kolbingen,60 - 65 Jahre,71,37,34
False,8327030,Kolbingen,65 - 75 Jahre,146,65,81
False,8327030,Kolbingen,75 und mehr Jahre,132,61,71
False,8327030,Kolbingen,Insgesamt,1297,632,665
False,8327033,Mahlstetten,unter 3 Jahre,12,5,7
False,8327033,Mahlstetten,3 -  6 Jahre,21,9,12
False,8327033,Mahlstetten,6 - 10 Jahre,23,13,10
False,8327033,Mahlstetten,10 - 15 Jahre,39,23,16
False,8327033,Mahlstetten,15 - 18 Jahre,22,16,6
False,8327033,Mahlstetten,18 - 20 Jahre,21,9,12
False,8327033,Mahlstetten,20 - 25 Jahre,48,26,22
False,8327033,Mahlstetten,25 - 30 Jahre,38,21,17
False,8327033,Mahlstetten,30 - 35 Jahre,32,17,15
False,8327033,Mahlstetten,35 - 40 Jahre,41,18,23
False,8327033,Mahlstetten,40 - 45 Jahre,52,30,22
False,8327033,Mahlstetten,45 - 50 Jahre,61,29,32
False,8327033,Mahlstetten,50 - 55 Jahre,89,47,42
False,8327033,Mahlstetten,55 - 60 Jahre,54,32,22
False,8327033,Mahlstetten,60 - 65 Jahre,30,16,14
False,8327033,Mahlstetten,65 - 75 Jahre,73,30,43
False,8327033,Mahlstetten,75 und mehr Jahre,75,35,40
False,8327033,Mahlstetten,Insgesamt,731,376,355
False,8327036,"Mühlheim an der Donau, Stadt",unter 3 Jahre,86,39,47
False,8327036,"Mühlheim an der Donau, Stadt",3 -  6 Jahre,72,42,30
False,8327036,"Mühlheim an der Donau, Stadt",6 - 10 Jahre,144,65,79
False,8327036,"Mühlheim an der Donau, Stadt",10 - 15 Jahre,204,116,88
False,8327036,"Mühlheim an der Donau, Stadt",15 - 18 Jahre,116,52,64
False,8327036,"Mühlheim an der Donau, Stadt",18 - 20 Jahre,68,27,41
False,8327036,"Mühlheim an der Donau, Stadt",20 - 25 Jahre,178,100,78
False,8327036,"Mühlheim an der Donau, Stadt",25 - 30 Jahre,182,88,94
False,8327036,"Mühlheim an der Donau, Stadt",30 - 35 Jahre,172,87,85
False,8327036,"Mühlheim an der Donau, Stadt",35 - 40 Jahre,209,104,105
False,8327036,"Mühlheim an der Donau, Stadt",40 - 45 Jahre,290,132,158
False,8327036,"Mühlheim an der Donau, Stadt",45 - 50 Jahre,288,152,136
False,8327036,"Mühlheim an der Donau, Stadt",50 - 55 Jahre,235,116,119
False,8327036,"Mühlheim an der Donau, Stadt",55 - 60 Jahre,239,109,130
False,8327036,"Mühlheim an der Donau, Stadt",60 - 65 Jahre,224,106,118
False,8327036,"Mühlheim an der Donau, Stadt",65 - 75 Jahre,426,226,200
False,8327036,"Mühlheim an der Donau, Stadt",75 und mehr Jahre,347,140,207
False,8327036,"Mühlheim an der Donau, Stadt",Insgesamt,3480,1701,1779
False,8327038,Neuhausen ob Eck,unter 3 Jahre,121,56,65
False,8327038,Neuhausen ob Eck,3 -  6 Jahre,117,58,59
False,8327038,Neuhausen ob Eck,6 - 10 Jahre,175,89,86
False,8327038,Neuhausen ob Eck,10 - 15 Jahre,269,122,147
False,8327038,Neuhausen ob Eck,15 - 18 Jahre,152,83,69
False,8327038,Neuhausen ob Eck,18 - 20 Jahre,107,60,47
False,8327038,Neuhausen ob Eck,20 - 25 Jahre,252,146,106
False,8327038,Neuhausen ob Eck,25 - 30 Jahre,245,137,108
False,8327038,Neuhausen ob Eck,30 - 35 Jahre,204,100,104
False,8327038,Neuhausen ob Eck,35 - 40 Jahre,207,104,103
False,8327038,Neuhausen ob Eck,40 - 45 Jahre,299,156,143
False,8327038,Neuhausen ob Eck,45 - 50 Jahre,380,189,191
False,8327038,Neuhausen ob Eck,50 - 55 Jahre,329,168,161
False,8327038,Neuhausen ob Eck,55 - 60 Jahre,234,123,111
False,8327038,Neuhausen ob Eck,60 - 65 Jahre,155,80,75
False,8327038,Neuhausen ob Eck,65 - 75 Jahre,342,153,189
False,8327038,Neuhausen ob Eck,75 und mehr Jahre,279,116,163
False,8327038,Neuhausen ob Eck,Insgesamt,3867,1940,1927
False,8327040,Reichenbach am Heuberg,unter 3 Jahre,7,1,6
False,8327040,Reichenbach am Heuberg,3 -  6 Jahre,18,11,7
False,8327040,Reichenbach am Heuberg,6 - 10 Jahre,23,7,16
False,8327040,Reichenbach am Heuberg,10 - 15 Jahre,33,16,17
False,8327040,Reichenbach am Heuberg,15 - 18 Jahre,25,6,19
False,8327040,Reichenbach am Heuberg,18 - 20 Jahre,16,11,5
False,8327040,Reichenbach am Heuberg,20 - 25 Jahre,45,23,22
False,8327040,Reichenbach am Heuberg,25 - 30 Jahre,23,11,12
False,8327040,Reichenbach am Heuberg,30 - 35 Jahre,25,12,13
False,8327040,Reichenbach am Heuberg,35 - 40 Jahre,29,14,15
False,8327040,Reichenbach am Heuberg,40 - 45 Jahre,36,19,17
False,8327040,Reichenbach am Heuberg,45 - 50 Jahre,43,20,23
False,8327040,Reichenbach am Heuberg,50 - 55 Jahre,42,23,19
False,8327040,Reichenbach am Heuberg,55 - 60 Jahre,29,20,9
False,8327040,Reichenbach am Heuberg,60 - 65 Jahre,14,6,8
False,8327040,Reichenbach am Heuberg,65 - 75 Jahre,52,19,33
False,8327040,Reichenbach am Heuberg,75 und mehr Jahre,28,11,17
False,8327040,Reichenbach am Heuberg,Insgesamt,488,230,258
False,8327041,Renquishausen,unter 3 Jahre,10,4,6
False,8327041,Renquishausen,3 -  6 Jahre,17,9,8
False,8327041,Renquishausen,6 - 10 Jahre,36,19,17
False,8327041,Renquishausen,10 - 15 Jahre,47,25,22
False,8327041,Renquishausen,15 - 18 Jahre,29,17,12
False,8327041,Renquishausen,18 - 20 Jahre,20,13,7
False,8327041,Renquishausen,20 - 25 Jahre,47,26,21
False,8327041,Renquishausen,25 - 30 Jahre,31,20,11
False,8327041,Renquishausen,30 - 35 Jahre,46,21,25
False,8327041,Renquishausen,35 - 40 Jahre,36,19,17
False,8327041,Renquishausen,40 - 45 Jahre,72,42,30
False,8327041,Renquishausen,45 - 50 Jahre,69,31,38
False,8327041,Renquishausen,50 - 55 Jahre,62,32,30
False,8327041,Renquishausen,55 - 60 Jahre,47,25,22
False,8327041,Renquishausen,60 - 65 Jahre,34,16,18
False,8327041,Renquishausen,65 - 75 Jahre,60,32,28
False,8327041,Renquishausen,75 und mehr Jahre,62,30,32
False,8327041,Renquishausen,Insgesamt,725,381,344
False,8327046,"Spaichingen, Stadt",unter 3 Jahre,323,153,170
False,8327046,"Spaichingen, Stadt",3 -  6 Jahre,356,187,169
False,8327046,"Spaichingen, Stadt",6 - 10 Jahre,490,243,247
False,8327046,"Spaichingen, Stadt",10 - 15 Jahre,711,386,325
False,8327046,"Spaichingen, Stadt",15 - 18 Jahre,439,235,204
False,8327046,"Spaichingen, Stadt",18 - 20 Jahre,318,162,156
False,8327046,"Spaichingen, Stadt",20 - 25 Jahre,694,338,356
False,8327046,"Spaichingen, Stadt",25 - 30 Jahre,717,385,332
False,8327046,"Spaichingen, Stadt",30 - 35 Jahre,706,353,353
False,8327046,"Spaichingen, Stadt",35 - 40 Jahre,782,361,421
False,8327046,"Spaichingen, Stadt",40 - 45 Jahre,835,437,398
False,8327046,"Spaichingen, Stadt",45 - 50 Jahre,930,462,468
False,8327046,"Spaichingen, Stadt",50 - 55 Jahre,896,461,435
False,8327046,"Spaichingen, Stadt",55 - 60 Jahre,862,400,462
False,8327046,"Spaichingen, Stadt",60 - 65 Jahre,658,330,328
False,8327046,"Spaichingen, Stadt",65 - 75 Jahre,1389,658,731
False,8327046,"Spaichingen, Stadt",75 und mehr Jahre,1201,458,743
False,8327046,"Spaichingen, Stadt",Insgesamt,12307,6009,6298
False,8327048,Talheim,unter 3 Jahre,24,20,4
False,8327048,Talheim,3 -  6 Jahre,29,14,15
False,8327048,Talheim,6 - 10 Jahre,60,27,33
False,8327048,Talheim,10 - 15 Jahre,77,35,42
False,8327048,Talheim,15 - 18 Jahre,49,31,18
False,8327048,Talheim,18 - 20 Jahre,40,22,18
False,8327048,Talheim,20 - 25 Jahre,62,29,33
False,8327048,Talheim,25 - 30 Jahre,49,27,22
False,8327048,Talheim,30 - 35 Jahre,81,45,36
False,8327048,Talheim,35 - 40 Jahre,68,35,33
False,8327048,Talheim,40 - 45 Jahre,105,48,57
False,8327048,Talheim,45 - 50 Jahre,112,57,55
False,8327048,Talheim,50 - 55 Jahre,93,45,48
False,8327048,Talheim,55 - 60 Jahre,79,44,35
False,8327048,Talheim,60 - 65 Jahre,60,25,35
False,8327048,Talheim,65 - 75 Jahre,125,61,64
False,8327048,Talheim,75 und mehr Jahre,93,38,55
False,8327048,Talheim,Insgesamt,1206,603,603
False,8327049,"Trossingen, Stadt",unter 3 Jahre,430,217,213
False,8327049,"Trossingen, Stadt",3 -  6 Jahre,453,232,221
False,8327049,"Trossingen, Stadt",6 - 10 Jahre,661,357,304
False,8327049,"Trossingen, Stadt",10 - 15 Jahre,904,478,426
False,8327049,"Trossingen, Stadt",15 - 18 Jahre,539,277,262
False,8327049,"Trossingen, Stadt",18 - 20 Jahre,362,175,187
False,8327049,"Trossingen, Stadt",20 - 25 Jahre,1061,486,575
False,8327049,"Trossingen, Stadt",25 - 30 Jahre,1005,502,503
False,8327049,"Trossingen, Stadt",30 - 35 Jahre,883,416,467
False,8327049,"Trossingen, Stadt",35 - 40 Jahre,876,482,394
False,8327049,"Trossingen, Stadt",40 - 45 Jahre,1090,529,561
False,8327049,"Trossingen, Stadt",45 - 50 Jahre,1176,616,560
False,8327049,"Trossingen, Stadt",50 - 55 Jahre,1092,511,581
False,8327049,"Trossingen, Stadt",55 - 60 Jahre,1013,509,504
False,8327049,"Trossingen, Stadt",60 - 65 Jahre,778,375,403
False,8327049,"Trossingen, Stadt",65 - 75 Jahre,1545,716,829
False,8327049,"Trossingen, Stadt",75 und mehr Jahre,1442,561,881
False,8327049,"Trossingen, Stadt",Insgesamt,15310,7439,7871
False,8327050,"Tuttlingen, Stadt",unter 3 Jahre,957,506,451
False,8327050,"Tuttlingen, Stadt",3 -  6 Jahre,982,523,459
False,8327050,"Tuttlingen, Stadt",6 - 10 Jahre,1365,704,661
False,8327050,"Tuttlingen, Stadt",10 - 15 Jahre,1872,959,913
False,8327050,"Tuttlingen, Stadt",15 - 18 Jahre,1084,570,514
False,8327050,"Tuttlingen, Stadt",18 - 20 Jahre,824,422,402
False,8327050,"Tuttlingen, Stadt",20 - 25 Jahre,2100,1038,1062
False,8327050,"Tuttlingen, Stadt",25 - 30 Jahre,2101,1081,1020
False,8327050,"Tuttlingen, Stadt",30 - 35 Jahre,2147,1081,1066
False,8327050,"Tuttlingen, Stadt",35 - 40 Jahre,2221,1163,1058
False,8327050,"Tuttlingen, Stadt",40 - 45 Jahre,2611,1317,1294
False,8327050,"Tuttlingen, Stadt",45 - 50 Jahre,2574,1302,1272
False,8327050,"Tuttlingen, Stadt",50 - 55 Jahre,2487,1218,1269
False,8327050,"Tuttlingen, Stadt",55 - 60 Jahre,2004,962,1042
False,8327050,"Tuttlingen, Stadt",60 - 65 Jahre,1814,876,938
False,8327050,"Tuttlingen, Stadt",65 - 75 Jahre,3742,1770,1972
False,8327050,"Tuttlingen, Stadt",75 und mehr Jahre,3397,1276,2121
False,8327050,"Tuttlingen, Stadt",Insgesamt,34282,16768,17514
False,8327051,Wehingen,unter 3 Jahre,81,39,42
False,8327051,Wehingen,3 -  6 Jahre,110,51,59
False,8327051,Wehingen,6 - 10 Jahre,169,89,80
False,8327051,Wehingen,10 - 15 Jahre,245,122,123
False,8327051,Wehingen,15 - 18 Jahre,125,62,63
False,8327051,Wehingen,18 - 20 Jahre,100,58,42
False,8327051,Wehingen,20 - 25 Jahre,218,118,100
False,8327051,Wehingen,25 - 30 Jahre,202,101,101
False,8327051,Wehingen,30 - 35 Jahre,218,115,103
False,8327051,Wehingen,35 - 40 Jahre,216,97,119
False,8327051,Wehingen,40 - 45 Jahre,282,141,141
False,8327051,Wehingen,45 - 50 Jahre,327,183,144
False,8327051,Wehingen,50 - 55 Jahre,254,125,129
False,8327051,Wehingen,55 - 60 Jahre,229,113,116
False,8327051,Wehingen,60 - 65 Jahre,192,97,95
False,8327051,Wehingen,65 - 75 Jahre,364,177,187
False,8327051,Wehingen,75 und mehr Jahre,300,106,194
False,8327051,Wehingen,Insgesamt,3632,1794,1838
False,8327054,Wurmlingen,unter 3 Jahre,94,51,43
False,8327054,Wurmlingen,3 -  6 Jahre,100,46,54
False,8327054,Wurmlingen,6 - 10 Jahre,127,67,60
False,8327054,Wurmlingen,10 - 15 Jahre,207,99,108
False,8327054,Wurmlingen,15 - 18 Jahre,138,63,75
False,8327054,Wurmlingen,18 - 20 Jahre,76,38,38
False,8327054,Wurmlingen,20 - 25 Jahre,202,113,89
False,8327054,Wurmlingen,25 - 30 Jahre,222,111,111
False,8327054,Wurmlingen,30 - 35 Jahre,171,78,93
False,8327054,Wurmlingen,35 - 40 Jahre,195,94,101
False,8327054,Wurmlingen,40 - 45 Jahre,286,126,160
False,8327054,Wurmlingen,45 - 50 Jahre,334,162,172
False,8327054,Wurmlingen,50 - 55 Jahre,297,157,140
False,8327054,Wurmlingen,55 - 60 Jahre,247,132,115
False,8327054,Wurmlingen,60 - 65 Jahre,212,119,93
False,8327054,Wurmlingen,65 - 75 Jahre,482,225,257
False,8327054,Wurmlingen,75 und mehr Jahre,390,161,229
False,8327054,Wurmlingen,Insgesamt,3780,1842,1938
False,8327055,Seitingen-Oberflacht,unter 3 Jahre,61,29,32
False,8327055,Seitingen-Oberflacht,3 -  6 Jahre,82,44,38
False,8327055,Seitingen-Oberflacht,6 - 10 Jahre,100,46,54
False,8327055,Seitingen-Oberflacht,10 - 15 Jahre,165,80,85
False,8327055,Seitingen-Oberflacht,15 - 18 Jahre,85,50,35
False,8327055,Seitingen-Oberflacht,18 - 20 Jahre,54,28,26
False,8327055,Seitingen-Oberflacht,20 - 25 Jahre,130,75,55
False,8327055,Seitingen-Oberflacht,25 - 30 Jahre,106,58,48
False,8327055,Seitingen-Oberflacht,30 - 35 Jahre,140,62,78
False,8327055,Seitingen-Oberflacht,35 - 40 Jahre,132,64,68
False,8327055,Seitingen-Oberflacht,40 - 45 Jahre,184,96,88
False,8327055,Seitingen-Oberflacht,45 - 50 Jahre,214,107,107
False,8327055,Seitingen-Oberflacht,50 - 55 Jahre,189,109,80
False,8327055,Seitingen-Oberflacht,55 - 60 Jahre,128,61,67
False,8327055,Seitingen-Oberflacht,60 - 65 Jahre,133,63,70
False,8327055,Seitingen-Oberflacht,65 - 75 Jahre,253,125,128
False,8327055,Seitingen-Oberflacht,75 und mehr Jahre,169,79,90
False,8327055,Seitingen-Oberflacht,Insgesamt,2325,1176,1149
False,8327056,Rietheim-Weilheim,unter 3 Jahre,74,37,37
False,8327056,Rietheim-Weilheim,3 -  6 Jahre,87,46,41
False,8327056,Rietheim-Weilheim,6 - 10 Jahre,96,51,45
False,8327056,Rietheim-Weilheim,10 - 15 Jahre,146,64,82
False,8327056,Rietheim-Weilheim,15 - 18 Jahre,85,44,41
False,8327056,Rietheim-Weilheim,18 - 20 Jahre,58,28,30
False,8327056,Rietheim-Weilheim,20 - 25 Jahre,154,83,71
False,8327056,Rietheim-Weilheim,25 - 30 Jahre,158,75,83
False,8327056,Rietheim-Weilheim,30 - 35 Jahre,162,79,83
False,8327056,Rietheim-Weilheim,35 - 40 Jahre,163,94,69
False,8327056,Rietheim-Weilheim,40 - 45 Jahre,227,120,107
False,8327056,Rietheim-Weilheim,45 - 50 Jahre,245,107,138
False,8327056,Rietheim-Weilheim,50 - 55 Jahre,202,95,107
False,8327056,Rietheim-Weilheim,55 - 60 Jahre,168,84,84
False,8327056,Rietheim-Weilheim,60 - 65 Jahre,137,66,71
False,8327056,Rietheim-Weilheim,65 - 75 Jahre,277,126,151
False,8327056,Rietheim-Weilheim,75 und mehr Jahre,251,112,139
False,8327056,Rietheim-Weilheim,Insgesamt,2690,1311,1379
False,8327057,Emmingen-Liptingen,unter 3 Jahre,102,45,57
False,8327057,Emmingen-Liptingen,3 -  6 Jahre,122,70,52
False,8327057,Emmingen-Liptingen,6 - 10 Jahre,190,86,104
False,8327057,Emmingen-Liptingen,10 - 15 Jahre,289,149,140
False,8327057,Emmingen-Liptingen,15 - 18 Jahre,161,79,82
False,8327057,Emmingen-Liptingen,18 - 20 Jahre,99,48,51
False,8327057,Emmingen-Liptingen,20 - 25 Jahre,279,125,154
False,8327057,Emmingen-Liptingen,25 - 30 Jahre,235,114,121
False,8327057,Emmingen-Liptingen,30 - 35 Jahre,259,117,142
False,8327057,Emmingen-Liptingen,35 - 40 Jahre,297,145,152
False,8327057,Emmingen-Liptingen,40 - 45 Jahre,399,205,194
False,8327057,Emmingen-Liptingen,45 - 50 Jahre,399,216,183
False,8327057,Emmingen-Liptingen,50 - 55 Jahre,385,201,184
False,8327057,Emmingen-Liptingen,55 - 60 Jahre,310,164,146
False,8327057,Emmingen-Liptingen,60 - 65 Jahre,219,116,103
False,8327057,Emmingen-Liptingen,65 - 75 Jahre,420,201,219
False,8327057,Emmingen-Liptingen,75 und mehr Jahre,314,134,180
False,8327057,Emmingen-Liptingen,Insgesamt,4479,2215,2264
False,8335,Landkreis Konstanz,unter 3 Jahre,6645,3354,3291
False,8335,Landkreis Konstanz,3 -  6 Jahre,6862,3501,3361
False,8335,Landkreis Konstanz,6 - 10 Jahre,9723,4933,4790
False,8335,Landkreis Konstanz,10 - 15 Jahre,14063,7111,6952
False,8335,Landkreis Konstanz,15 - 18 Jahre,8371,4291,4080
False,8335,Landkreis Konstanz,18 - 20 Jahre,6330,3210,3120
False,8335,Landkreis Konstanz,20 - 25 Jahre,19950,9822,10128
False,8335,Landkreis Konstanz,25 - 30 Jahre,17268,8568,8700
False,8335,Landkreis Konstanz,30 - 35 Jahre,15554,7652,7902
False,8335,Landkreis Konstanz,35 - 40 Jahre,16246,8077,8169
False,8335,Landkreis Konstanz,40 - 45 Jahre,23206,11473,11733
False,8335,Landkreis Konstanz,45 - 50 Jahre,25319,12904,12415
False,8335,Landkreis Konstanz,50 - 55 Jahre,20805,10550,10255
False,8335,Landkreis Konstanz,55 - 60 Jahre,17239,8468,8771
False,8335,Landkreis Konstanz,60 - 65 Jahre,14989,7347,7642
False,8335,Landkreis Konstanz,65 - 75 Jahre,30631,14491,16140
False,8335,Landkreis Konstanz,75 und mehr Jahre,25782,9876,15906
False,8335,Landkreis Konstanz,Insgesamt,278983,135628,143355
False,8335001,"Aach, Stadt",unter 3 Jahre,60,29,31
False,8335001,"Aach, Stadt",3 -  6 Jahre,64,34,30
False,8335001,"Aach, Stadt",6 - 10 Jahre,90,42,48
False,8335001,"Aach, Stadt",10 - 15 Jahre,132,74,58
False,8335001,"Aach, Stadt",15 - 18 Jahre,84,50,34
False,8335001,"Aach, Stadt",18 - 20 Jahre,64,42,22
False,8335001,"Aach, Stadt",20 - 25 Jahre,109,54,55
False,8335001,"Aach, Stadt",25 - 30 Jahre,122,59,63
False,8335001,"Aach, Stadt",30 - 35 Jahre,124,60,64
False,8335001,"Aach, Stadt",35 - 40 Jahre,140,76,64
False,8335001,"Aach, Stadt",40 - 45 Jahre,201,113,88
False,8335001,"Aach, Stadt",45 - 50 Jahre,227,113,114
False,8335001,"Aach, Stadt",50 - 55 Jahre,181,95,86
False,8335001,"Aach, Stadt",55 - 60 Jahre,145,74,71
False,8335001,"Aach, Stadt",60 - 65 Jahre,103,56,47
False,8335001,"Aach, Stadt",65 - 75 Jahre,160,75,85
False,8335001,"Aach, Stadt",75 und mehr Jahre,169,68,101
False,8335001,"Aach, Stadt",Insgesamt,2175,1114,1061
False,8335002,Allensbach,unter 3 Jahre,150,64,86
False,8335002,Allensbach,3 -  6 Jahre,153,88,65
False,8335002,Allensbach,6 - 10 Jahre,233,124,109
False,8335002,Allensbach,10 - 15 Jahre,360,178,182
False,8335002,Allensbach,15 - 18 Jahre,213,114,99
False,8335002,Allensbach,18 - 20 Jahre,166,80,86
False,8335002,Allensbach,20 - 25 Jahre,374,163,211
False,8335002,Allensbach,25 - 30 Jahre,305,146,159
False,8335002,Allensbach,30 - 35 Jahre,352,170,182
False,8335002,Allensbach,35 - 40 Jahre,424,197,227
False,8335002,Allensbach,40 - 45 Jahre,588,260,328
False,8335002,Allensbach,45 - 50 Jahre,669,312,357
False,8335002,Allensbach,50 - 55 Jahre,601,274,327
False,8335002,Allensbach,55 - 60 Jahre,496,249,247
False,8335002,Allensbach,60 - 65 Jahre,412,185,227
False,8335002,Allensbach,65 - 75 Jahre,910,417,493
False,8335002,Allensbach,75 und mehr Jahre,700,216,484
False,8335002,Allensbach,Insgesamt,7106,3237,3869
False,8335015,Büsingen am Hochrhein,unter 3 Jahre,22,12,10
False,8335015,Büsingen am Hochrhein,3 -  6 Jahre,26,10,16
False,8335015,Büsingen am Hochrhein,6 - 10 Jahre,32,20,12
False,8335015,Büsingen am Hochrhein,10 - 15 Jahre,63,33,30
False,8335015,Büsingen am Hochrhein,15 - 18 Jahre,39,27,12
False,8335015,Büsingen am Hochrhein,18 - 20 Jahre,19,5,14
False,8335015,Büsingen am Hochrhein,20 - 25 Jahre,63,31,32
False,8335015,Büsingen am Hochrhein,25 - 30 Jahre,60,32,28
False,8335015,Büsingen am Hochrhein,30 - 35 Jahre,47,20,27
False,8335015,Büsingen am Hochrhein,35 - 40 Jahre,49,31,18
False,8335015,Büsingen am Hochrhein,40 - 45 Jahre,79,36,43
False,8335015,Büsingen am Hochrhein,45 - 50 Jahre,108,60,48
False,8335015,Büsingen am Hochrhein,50 - 55 Jahre,104,46,58
False,8335015,Büsingen am Hochrhein,55 - 60 Jahre,116,63,53
False,8335015,Büsingen am Hochrhein,60 - 65 Jahre,101,43,58
False,8335015,Büsingen am Hochrhein,65 - 75 Jahre,273,139,134
False,8335015,Büsingen am Hochrhein,75 und mehr Jahre,195,93,102
False,8335015,Büsingen am Hochrhein,Insgesamt,1396,701,695
False,8335021,Eigeltingen,unter 3 Jahre,91,51,40
False,8335021,Eigeltingen,3 -  6 Jahre,92,52,40
False,8335021,Eigeltingen,6 - 10 Jahre,151,70,81
False,8335021,Eigeltingen,10 - 15 Jahre,246,129,117
False,8335021,Eigeltingen,15 - 18 Jahre,161,76,85
False,8335021,Eigeltingen,18 - 20 Jahre,86,37,49
False,8335021,Eigeltingen,20 - 25 Jahre,196,112,84
False,8335021,Eigeltingen,25 - 30 Jahre,184,103,81
False,8335021,Eigeltingen,30 - 35 Jahre,211,88,123
False,8335021,Eigeltingen,35 - 40 Jahre,196,88,108
False,8335021,Eigeltingen,40 - 45 Jahre,318,178,140
False,8335021,Eigeltingen,45 - 50 Jahre,313,156,157
False,8335021,Eigeltingen,50 - 55 Jahre,314,161,153
False,8335021,Eigeltingen,55 - 60 Jahre,223,107,116
False,8335021,Eigeltingen,60 - 65 Jahre,188,105,83
False,8335021,Eigeltingen,65 - 75 Jahre,333,162,171
False,8335021,Eigeltingen,75 und mehr Jahre,269,103,166
False,8335021,Eigeltingen,Insgesamt,3572,1778,1794
False,8335022,"Engen, Stadt",unter 3 Jahre,258,131,127
False,8335022,"Engen, Stadt",3 -  6 Jahre,288,149,139
False,8335022,"Engen, Stadt",6 - 10 Jahre,426,211,215
False,8335022,"Engen, Stadt",10 - 15 Jahre,621,324,297
False,8335022,"Engen, Stadt",15 - 18 Jahre,382,189,193
False,8335022,"Engen, Stadt",18 - 20 Jahre,234,132,102
False,8335022,"Engen, Stadt",20 - 25 Jahre,557,288,269
False,8335022,"Engen, Stadt",25 - 30 Jahre,512,252,260
False,8335022,"Engen, Stadt",30 - 35 Jahre,534,238,296
False,8335022,"Engen, Stadt",35 - 40 Jahre,639,308,331
False,8335022,"Engen, Stadt",40 - 45 Jahre,811,385,426
False,8335022,"Engen, Stadt",45 - 50 Jahre,924,484,440
False,8335022,"Engen, Stadt",50 - 55 Jahre,773,406,367
False,8335022,"Engen, Stadt",55 - 60 Jahre,634,320,314
False,8335022,"Engen, Stadt",60 - 65 Jahre,548,269,279
False,8335022,"Engen, Stadt",65 - 75 Jahre,1097,515,582
False,8335022,"Engen, Stadt",75 und mehr Jahre,962,350,612
False,8335022,"Engen, Stadt",Insgesamt,10200,4951,5249
False,8335025,Gaienhofen,unter 3 Jahre,56,28,28
False,8335025,Gaienhofen,3 -  6 Jahre,58,29,29
False,8335025,Gaienhofen,6 - 10 Jahre,86,41,45
False,8335025,Gaienhofen,10 - 15 Jahre,153,70,83
False,8335025,Gaienhofen,15 - 18 Jahre,99,59,40
False,8335025,Gaienhofen,18 - 20 Jahre,64,38,26
False,8335025,Gaienhofen,20 - 25 Jahre,164,74,90
False,8335025,Gaienhofen,25 - 30 Jahre,142,70,72
False,8335025,Gaienhofen,30 - 35 Jahre,152,81,71
False,8335025,Gaienhofen,35 - 40 Jahre,179,83,96
False,8335025,Gaienhofen,40 - 45 Jahre,239,107,132
False,8335025,Gaienhofen,45 - 50 Jahre,257,128,129
False,8335025,Gaienhofen,50 - 55 Jahre,252,111,141
False,8335025,Gaienhofen,55 - 60 Jahre,261,130,131
False,8335025,Gaienhofen,60 - 65 Jahre,234,115,119
False,8335025,Gaienhofen,65 - 75 Jahre,490,228,262
False,8335025,Gaienhofen,75 und mehr Jahre,352,148,204
False,8335025,Gaienhofen,Insgesamt,3238,1540,1698
False,8335026,Gailingen am Hochrhein,unter 3 Jahre,77,37,40
False,8335026,Gailingen am Hochrhein,3 -  6 Jahre,77,42,35
False,8335026,Gailingen am Hochrhein,6 - 10 Jahre,113,57,56
False,8335026,Gailingen am Hochrhein,10 - 15 Jahre,131,64,67
False,8335026,Gailingen am Hochrhein,15 - 18 Jahre,80,44,36
False,8335026,Gailingen am Hochrhein,18 - 20 Jahre,68,37,31
False,8335026,Gailingen am Hochrhein,20 - 25 Jahre,138,62,76
False,8335026,Gailingen am Hochrhein,25 - 30 Jahre,144,62,82
False,8335026,Gailingen am Hochrhein,30 - 35 Jahre,155,67,88
False,8335026,Gailingen am Hochrhein,35 - 40 Jahre,268,147,121
False,8335026,Gailingen am Hochrhein,40 - 45 Jahre,360,219,141
False,8335026,Gailingen am Hochrhein,45 - 50 Jahre,247,123,124
False,8335026,Gailingen am Hochrhein,50 - 55 Jahre,242,122,120
False,8335026,Gailingen am Hochrhein,55 - 60 Jahre,179,84,95
False,8335026,Gailingen am Hochrhein,60 - 65 Jahre,149,81,68
False,8335026,Gailingen am Hochrhein,65 - 75 Jahre,328,152,176
False,8335026,Gailingen am Hochrhein,75 und mehr Jahre,328,140,188
False,8335026,Gailingen am Hochrhein,Insgesamt,3084,1540,1544
False,8335028,Gottmadingen,unter 3 Jahre,241,120,121
False,8335028,Gottmadingen,3 -  6 Jahre,293,144,149
False,8335028,Gottmadingen,6 - 10 Jahre,442,223,219
False,8335028,Gottmadingen,10 - 15 Jahre,626,330,296
False,8335028,Gottmadingen,15 - 18 Jahre,350,196,154
False,8335028,Gottmadingen,18 - 20 Jahre,215,109,106
False,8335028,Gottmadingen,20 - 25 Jahre,506,256,250
False,8335028,Gottmadingen,25 - 30 Jahre,522,266,256
False,8335028,Gottmadingen,30 - 35 Jahre,537,263,274
False,8335028,Gottmadingen,35 - 40 Jahre,635,308,327
False,8335028,Gottmadingen,40 - 45 Jahre,905,431,474
False,8335028,Gottmadingen,45 - 50 Jahre,917,443,474
False,8335028,Gottmadingen,50 - 55 Jahre,736,389,347
False,8335028,Gottmadingen,55 - 60 Jahre,560,284,276
False,8335028,Gottmadingen,60 - 65 Jahre,547,273,274
False,8335028,Gottmadingen,65 - 75 Jahre,1152,534,618
False,8335028,Gottmadingen,75 und mehr Jahre,1069,409,660
False,8335028,Gottmadingen,Insgesamt,10253,4978,5275
False,8335035,Hilzingen,unter 3 Jahre,179,91,88
False,8335035,Hilzingen,3 -  6 Jahre,221,108,113
False,8335035,Hilzingen,6 - 10 Jahre,333,148,185
False,8335035,Hilzingen,10 - 15 Jahre,482,253,229
False,8335035,Hilzingen,15 - 18 Jahre,313,151,162
False,8335035,Hilzingen,18 - 20 Jahre,195,93,102
False,8335035,Hilzingen,20 - 25 Jahre,435,219,216
False,8335035,Hilzingen,25 - 30 Jahre,390,193,197
False,8335035,Hilzingen,30 - 35 Jahre,446,214,232
False,8335035,Hilzingen,35 - 40 Jahre,509,240,269
False,8335035,Hilzingen,40 - 45 Jahre,775,382,393
False,8335035,Hilzingen,45 - 50 Jahre,872,446,426
False,8335035,Hilzingen,50 - 55 Jahre,607,302,305
False,8335035,Hilzingen,55 - 60 Jahre,568,275,293
False,8335035,Hilzingen,60 - 65 Jahre,456,234,222
False,8335035,Hilzingen,65 - 75 Jahre,887,416,471
False,8335035,Hilzingen,75 und mehr Jahre,616,271,345
False,8335035,Hilzingen,Insgesamt,8284,4036,4248
False,8335043,"Konstanz, Universitätsstadt",unter 3 Jahre,1908,1003,905
False,8335043,"Konstanz, Universitätsstadt",3 -  6 Jahre,1830,940,890
False,8335043,"Konstanz, Universitätsstadt",6 - 10 Jahre,2374,1202,1172
False,8335043,"Konstanz, Universitätsstadt",10 - 15 Jahre,3348,1680,1668
False,8335043,"Konstanz, Universitätsstadt",15 - 18 Jahre,2010,1012,998
False,8335043,"Konstanz, Universitätsstadt",18 - 20 Jahre,1799,822,977
False,8335043,"Konstanz, Universitätsstadt",20 - 25 Jahre,9553,4614,4939
False,8335043,"Konstanz, Universitätsstadt",25 - 30 Jahre,7173,3606,3567
False,8335043,"Konstanz, Universitätsstadt",30 - 35 Jahre,5173,2578,2595
False,8335043,"Konstanz, Universitätsstadt",35 - 40 Jahre,4787,2482,2305
False,8335043,"Konstanz, Universitätsstadt",40 - 45 Jahre,6851,3380,3471
False,8335043,"Konstanz, Universitätsstadt",45 - 50 Jahre,7802,4082,3720
False,8335043,"Konstanz, Universitätsstadt",50 - 55 Jahre,5702,2890,2812
False,8335043,"Konstanz, Universitätsstadt",55 - 60 Jahre,4449,2106,2343
False,8335043,"Konstanz, Universitätsstadt",60 - 65 Jahre,3970,1891,2079
False,8335043,"Konstanz, Universitätsstadt",65 - 75 Jahre,8689,4029,4660
False,8335043,"Konstanz, Universitätsstadt",75 und mehr Jahre,7275,2717,4558
False,8335043,"Konstanz, Universitätsstadt",Insgesamt,84693,41034,43659
False,8335055,Moos,unter 3 Jahre,71,32,39
False,8335055,Moos,3 -  6 Jahre,67,29,38
False,8335055,Moos,6 - 10 Jahre,120,67,53
False,8335055,Moos,10 - 15 Jahre,197,102,95
False,8335055,Moos,15 - 18 Jahre,111,58,53
False,8335055,Moos,18 - 20 Jahre,89,47,42
False,8335055,Moos,20 - 25 Jahre,156,80,76
False,8335055,Moos,25 - 30 Jahre,109,59,50
False,8335055,Moos,30 - 35 Jahre,156,77,79
False,8335055,Moos,35 - 40 Jahre,169,76,93
False,8335055,Moos,40 - 45 Jahre,296,144,152
False,8335055,Moos,45 - 50 Jahre,372,189,183
False,8335055,Moos,50 - 55 Jahre,300,144,156
False,8335055,Moos,55 - 60 Jahre,237,131,106
False,8335055,Moos,60 - 65 Jahre,197,88,109
False,8335055,Moos,65 - 75 Jahre,356,179,177
False,8335055,Moos,75 und mehr Jahre,267,108,159
False,8335055,Moos,Insgesamt,3270,1610,1660
False,8335057,Mühlingen,unter 3 Jahre,80,38,42
False,8335057,Mühlingen,3 -  6 Jahre,78,44,34
False,8335057,Mühlingen,6 - 10 Jahre,87,52,35
False,8335057,Mühlingen,10 - 15 Jahre,168,83,85
False,8335057,Mühlingen,15 - 18 Jahre,82,47,35
False,8335057,Mühlingen,18 - 20 Jahre,47,23,24
False,8335057,Mühlingen,20 - 25 Jahre,129,69,60
False,8335057,Mühlingen,25 - 30 Jahre,129,76,53
False,8335057,Mühlingen,30 - 35 Jahre,140,68,72
False,8335057,Mühlingen,35 - 40 Jahre,139,59,80
False,8335057,Mühlingen,40 - 45 Jahre,203,109,94
False,8335057,Mühlingen,45 - 50 Jahre,207,109,98
False,8335057,Mühlingen,50 - 55 Jahre,185,98,87
False,8335057,Mühlingen,55 - 60 Jahre,155,79,76
False,8335057,Mühlingen,60 - 65 Jahre,103,56,47
False,8335057,Mühlingen,65 - 75 Jahre,189,92,97
False,8335057,Mühlingen,75 und mehr Jahre,191,81,110
False,8335057,Mühlingen,Insgesamt,2312,1183,1129
False,8335061,Öhningen,unter 3 Jahre,66,32,34
False,8335061,Öhningen,3 -  6 Jahre,88,40,48
False,8335061,Öhningen,6 - 10 Jahre,135,62,73
False,8335061,Öhningen,10 - 15 Jahre,185,89,96
False,8335061,Öhningen,15 - 18 Jahre,101,47,54
False,8335061,Öhningen,18 - 20 Jahre,86,57,29
False,8335061,Öhningen,20 - 25 Jahre,160,84,76
False,8335061,Öhningen,25 - 30 Jahre,114,61,53
False,8335061,Öhningen,30 - 35 Jahre,157,78,79
False,8335061,Öhningen,35 - 40 Jahre,173,71,102
False,8335061,Öhningen,40 - 45 Jahre,294,152,142
False,8335061,Öhningen,45 - 50 Jahre,383,205,178
False,8335061,Öhningen,50 - 55 Jahre,283,138,145
False,8335061,Öhningen,55 - 60 Jahre,235,125,110
False,8335061,Öhningen,60 - 65 Jahre,230,106,124
False,8335061,Öhningen,65 - 75 Jahre,521,270,251
False,8335061,Öhningen,75 und mehr Jahre,413,178,235
False,8335061,Öhningen,Insgesamt,3624,1795,1829
False,8335063,"Radolfzell am Bodensee, Stadt",unter 3 Jahre,780,397,383
False,8335063,"Radolfzell am Bodensee, Stadt",3 -  6 Jahre,789,385,404
False,8335063,"Radolfzell am Bodensee, Stadt",6 - 10 Jahre,1033,549,484
False,8335063,"Radolfzell am Bodensee, Stadt",10 - 15 Jahre,1536,773,763
False,8335063,"Radolfzell am Bodensee, Stadt",15 - 18 Jahre,907,467,440
False,8335063,"Radolfzell am Bodensee, Stadt",18 - 20 Jahre,711,372,339
False,8335063,"Radolfzell am Bodensee, Stadt",20 - 25 Jahre,1594,829,765
False,8335063,"Radolfzell am Bodensee, Stadt",25 - 30 Jahre,1663,784,879
False,8335063,"Radolfzell am Bodensee, Stadt",30 - 35 Jahre,1663,832,831
False,8335063,"Radolfzell am Bodensee, Stadt",35 - 40 Jahre,1829,875,954
False,8335063,"Radolfzell am Bodensee, Stadt",40 - 45 Jahre,2622,1281,1341
False,8335063,"Radolfzell am Bodensee, Stadt",45 - 50 Jahre,2832,1382,1450
False,8335063,"Radolfzell am Bodensee, Stadt",50 - 55 Jahre,2436,1235,1201
False,8335063,"Radolfzell am Bodensee, Stadt",55 - 60 Jahre,2151,1044,1107
False,8335063,"Radolfzell am Bodensee, Stadt",60 - 65 Jahre,1808,914,894
False,8335063,"Radolfzell am Bodensee, Stadt",65 - 75 Jahre,3628,1732,1896
False,8335063,"Radolfzell am Bodensee, Stadt",75 und mehr Jahre,2800,1032,1768
False,8335063,"Radolfzell am Bodensee, Stadt",Insgesamt,30782,14883,15899
False,8335066,Reichenau,unter 3 Jahre,119,55,64
False,8335066,Reichenau,3 -  6 Jahre,128,76,52
False,8335066,Reichenau,6 - 10 Jahre,176,94,82
False,8335066,Reichenau,10 - 15 Jahre,289,156,133
False,8335066,Reichenau,15 - 18 Jahre,167,84,83
False,8335066,Reichenau,18 - 20 Jahre,135,75,60
False,8335066,Reichenau,20 - 25 Jahre,335,164,171
False,8335066,Reichenau,25 - 30 Jahre,272,134,138
False,8335066,Reichenau,30 - 35 Jahre,270,132,138
False,8335066,Reichenau,35 - 40 Jahre,347,172,175
False,8335066,Reichenau,40 - 45 Jahre,504,251,253
False,8335066,Reichenau,45 - 50 Jahre,519,267,252
False,8335066,Reichenau,50 - 55 Jahre,438,226,212
False,8335066,Reichenau,55 - 60 Jahre,328,167,161
False,8335066,Reichenau,60 - 65 Jahre,285,145,140
False,8335066,Reichenau,65 - 75 Jahre,477,239,238
False,8335066,Reichenau,75 und mehr Jahre,396,157,239
False,8335066,Reichenau,Insgesamt,5185,2594,2591
False,8335075,"Singen (Hohentwiel), Stadt",unter 3 Jahre,1214,607,607
False,8335075,"Singen (Hohentwiel), Stadt",3 -  6 Jahre,1243,642,601
False,8335075,"Singen (Hohentwiel), Stadt",6 - 10 Jahre,1694,864,830
False,8335075,"Singen (Hohentwiel), Stadt",10 - 15 Jahre,2411,1229,1182
False,8335075,"Singen (Hohentwiel), Stadt",15 - 18 Jahre,1473,763,710
False,8335075,"Singen (Hohentwiel), Stadt",18 - 20 Jahre,1055,535,520
False,8335075,"Singen (Hohentwiel), Stadt",20 - 25 Jahre,2552,1223,1329
False,8335075,"Singen (Hohentwiel), Stadt",25 - 30 Jahre,2600,1281,1319
False,8335075,"Singen (Hohentwiel), Stadt",30 - 35 Jahre,2589,1252,1337
False,8335075,"Singen (Hohentwiel), Stadt",35 - 40 Jahre,2661,1385,1276
False,8335075,"Singen (Hohentwiel), Stadt",40 - 45 Jahre,3533,1762,1771
False,8335075,"Singen (Hohentwiel), Stadt",45 - 50 Jahre,3763,1895,1868
False,8335075,"Singen (Hohentwiel), Stadt",50 - 55 Jahre,3310,1727,1583
False,8335075,"Singen (Hohentwiel), Stadt",55 - 60 Jahre,2917,1432,1485
False,8335075,"Singen (Hohentwiel), Stadt",60 - 65 Jahre,2578,1267,1311
False,8335075,"Singen (Hohentwiel), Stadt",65 - 75 Jahre,5337,2502,2835
False,8335075,"Singen (Hohentwiel), Stadt",75 und mehr Jahre,4896,1847,3049
False,8335075,"Singen (Hohentwiel), Stadt",Insgesamt,45826,22213,23613
False,8335077,Steißlingen,unter 3 Jahre,98,52,46
False,8335077,Steißlingen,3 -  6 Jahre,126,66,60
False,8335077,Steißlingen,6 - 10 Jahre,205,103,102
False,8335077,Steißlingen,10 - 15 Jahre,301,156,145
False,8335077,Steißlingen,15 - 18 Jahre,152,72,80
False,8335077,Steißlingen,18 - 20 Jahre,110,63,47
False,8335077,Steißlingen,20 - 25 Jahre,245,126,119
False,8335077,Steißlingen,25 - 30 Jahre,221,100,121
False,8335077,Steißlingen,30 - 35 Jahre,239,111,128
False,8335077,Steißlingen,35 - 40 Jahre,289,131,158
False,8335077,Steißlingen,40 - 45 Jahre,406,197,209
False,8335077,Steißlingen,45 - 50 Jahre,422,213,209
False,8335077,Steißlingen,50 - 55 Jahre,394,204,190
False,8335077,Steißlingen,55 - 60 Jahre,257,142,115
False,8335077,Steißlingen,60 - 65 Jahre,239,112,127
False,8335077,Steißlingen,65 - 75 Jahre,484,229,255
False,8335077,Steißlingen,75 und mehr Jahre,420,161,259
False,8335077,Steißlingen,Insgesamt,4608,2238,2370
False,8335079,"Stockach, Stadt",unter 3 Jahre,385,193,192
False,8335079,"Stockach, Stadt",3 -  6 Jahre,405,196,209
False,8335079,"Stockach, Stadt",6 - 10 Jahre,690,364,326
False,8335079,"Stockach, Stadt",10 - 15 Jahre,977,476,501
False,8335079,"Stockach, Stadt",15 - 18 Jahre,598,310,288
False,8335079,"Stockach, Stadt",18 - 20 Jahre,435,228,207
False,8335079,"Stockach, Stadt",20 - 25 Jahre,1013,506,507
False,8335079,"Stockach, Stadt",25 - 30 Jahre,911,460,451
False,8335079,"Stockach, Stadt",30 - 35 Jahre,809,422,387
False,8335079,"Stockach, Stadt",35 - 40 Jahre,927,438,489
False,8335079,"Stockach, Stadt",40 - 45 Jahre,1316,622,694
False,8335079,"Stockach, Stadt",45 - 50 Jahre,1480,732,748
False,8335079,"Stockach, Stadt",50 - 55 Jahre,1378,681,697
False,8335079,"Stockach, Stadt",55 - 60 Jahre,1195,598,597
False,8335079,"Stockach, Stadt",60 - 65 Jahre,1006,516,490
False,8335079,"Stockach, Stadt",65 - 75 Jahre,1720,830,890
False,8335079,"Stockach, Stadt",75 und mehr Jahre,1434,554,880
False,8335079,"Stockach, Stadt",Insgesamt,16679,8126,8553
False,8335080,"Tengen, Stadt",unter 3 Jahre,108,37,71
False,8335080,"Tengen, Stadt",3 -  6 Jahre,127,61,66
False,8335080,"Tengen, Stadt",6 - 10 Jahre,182,83,99
False,8335080,"Tengen, Stadt",10 - 15 Jahre,256,120,136
False,8335080,"Tengen, Stadt",15 - 18 Jahre,151,72,79
False,8335080,"Tengen, Stadt",18 - 20 Jahre,133,79,54
False,8335080,"Tengen, Stadt",20 - 25 Jahre,255,127,128
False,8335080,"Tengen, Stadt",25 - 30 Jahre,218,104,114
False,8335080,"Tengen, Stadt",30 - 35 Jahre,206,111,95
False,8335080,"Tengen, Stadt",35 - 40 Jahre,211,105,106
False,8335080,"Tengen, Stadt",40 - 45 Jahre,416,220,196
False,8335080,"Tengen, Stadt",45 - 50 Jahre,453,236,217
False,8335080,"Tengen, Stadt",50 - 55 Jahre,374,183,191
False,8335080,"Tengen, Stadt",55 - 60 Jahre,321,157,164
False,8335080,"Tengen, Stadt",60 - 65 Jahre,234,124,110
False,8335080,"Tengen, Stadt",65 - 75 Jahre,466,229,237
False,8335080,"Tengen, Stadt",75 und mehr Jahre,491,198,293
False,8335080,"Tengen, Stadt",Insgesamt,4602,2246,2356
False,8335081,Volkertshausen,unter 3 Jahre,93,49,44
False,8335081,Volkertshausen,3 -  6 Jahre,88,45,43
False,8335081,Volkertshausen,6 - 10 Jahre,130,56,74
False,8335081,Volkertshausen,10 - 15 Jahre,172,98,74
False,8335081,Volkertshausen,15 - 18 Jahre,112,59,53
False,8335081,Volkertshausen,18 - 20 Jahre,69,42,27
False,8335081,Volkertshausen,20 - 25 Jahre,182,93,89
False,8335081,Volkertshausen,25 - 30 Jahre,144,80,64
False,8335081,Volkertshausen,30 - 35 Jahre,171,84,87
False,8335081,Volkertshausen,35 - 40 Jahre,181,85,96
False,8335081,Volkertshausen,40 - 45 Jahre,280,144,136
False,8335081,Volkertshausen,45 - 50 Jahre,279,151,128
False,8335081,Volkertshausen,50 - 55 Jahre,247,133,114
False,8335081,Volkertshausen,55 - 60 Jahre,176,83,93
False,8335081,Volkertshausen,60 - 65 Jahre,147,78,69
False,8335081,Volkertshausen,65 - 75 Jahre,249,113,136
False,8335081,Volkertshausen,75 und mehr Jahre,228,92,136
False,8335081,Volkertshausen,Insgesamt,2948,1485,1463
False,8335096,Hohenfels,unter 3 Jahre,62,31,31
False,8335096,Hohenfels,3 -  6 Jahre,59,24,35
False,8335096,Hohenfels,6 - 10 Jahre,93,41,52
False,8335096,Hohenfels,10 - 15 Jahre,143,70,73
False,8335096,Hohenfels,15 - 18 Jahre,70,40,30
False,8335096,Hohenfels,18 - 20 Jahre,54,28,26
False,8335096,Hohenfels,20 - 25 Jahre,89,49,40
False,8335096,Hohenfels,25 - 30 Jahre,111,45,66
False,8335096,Hohenfels,30 - 35 Jahre,118,72,46
False,8335096,Hohenfels,35 - 40 Jahre,134,58,76
False,8335096,Hohenfels,40 - 45 Jahre,170,96,74
False,8335096,Hohenfels,45 - 50 Jahre,177,86,91
False,8335096,Hohenfels,50 - 55 Jahre,136,72,64
False,8335096,Hohenfels,55 - 60 Jahre,106,47,59
False,8335096,Hohenfels,60 - 65 Jahre,127,67,60
False,8335096,Hohenfels,65 - 75 Jahre,217,124,93
False,8335096,Hohenfels,75 und mehr Jahre,142,53,89
False,8335096,Hohenfels,Insgesamt,2008,1003,1005
False,8335097,Mühlhausen-Ehingen,unter 3 Jahre,99,57,42
False,8335097,Mühlhausen-Ehingen,3 -  6 Jahre,88,50,38
False,8335097,Mühlhausen-Ehingen,6 - 10 Jahre,164,94,70
False,8335097,Mühlhausen-Ehingen,10 - 15 Jahre,214,108,106
False,8335097,Mühlhausen-Ehingen,15 - 18 Jahre,142,69,73
False,8335097,Mühlhausen-Ehingen,18 - 20 Jahre,92,49,43
False,8335097,Mühlhausen-Ehingen,20 - 25 Jahre,195,102,93
False,8335097,Mühlhausen-Ehingen,25 - 30 Jahre,200,98,102
False,8335097,Mühlhausen-Ehingen,30 - 35 Jahre,202,93,109
False,8335097,Mühlhausen-Ehingen,35 - 40 Jahre,206,107,99
False,8335097,Mühlhausen-Ehingen,40 - 45 Jahre,331,177,154
False,8335097,Mühlhausen-Ehingen,45 - 50 Jahre,319,169,150
False,8335097,Mühlhausen-Ehingen,50 - 55 Jahre,300,150,150
False,8335097,Mühlhausen-Ehingen,55 - 60 Jahre,251,121,130
False,8335097,Mühlhausen-Ehingen,60 - 65 Jahre,195,102,93
False,8335097,Mühlhausen-Ehingen,65 - 75 Jahre,396,192,204
False,8335097,Mühlhausen-Ehingen,75 und mehr Jahre,283,131,152
False,8335097,Mühlhausen-Ehingen,Insgesamt,3677,1869,1808
False,8335098,Bodman-Ludwigshafen,unter 3 Jahre,80,40,40
False,8335098,Bodman-Ludwigshafen,3 -  6 Jahre,99,44,55
False,8335098,Bodman-Ludwigshafen,6 - 10 Jahre,169,82,87
False,8335098,Bodman-Ludwigshafen,10 - 15 Jahre,198,93,105
False,8335098,Bodman-Ludwigshafen,15 - 18 Jahre,83,34,49
False,8335098,Bodman-Ludwigshafen,18 - 20 Jahre,71,39,32
False,8335098,Bodman-Ludwigshafen,20 - 25 Jahre,168,83,85
False,8335098,Bodman-Ludwigshafen,25 - 30 Jahre,242,108,134
False,8335098,Bodman-Ludwigshafen,30 - 35 Jahre,248,116,132
False,8335098,Bodman-Ludwigshafen,35 - 40 Jahre,265,134,131
False,8335098,Bodman-Ludwigshafen,40 - 45 Jahre,334,155,179
False,8335098,Bodman-Ludwigshafen,45 - 50 Jahre,383,196,187
False,8335098,Bodman-Ludwigshafen,50 - 55 Jahre,340,174,166
False,8335098,Bodman-Ludwigshafen,55 - 60 Jahre,311,160,151
False,8335098,Bodman-Ludwigshafen,60 - 65 Jahre,326,160,166
False,8335098,Bodman-Ludwigshafen,65 - 75 Jahre,584,285,299
False,8335098,Bodman-Ludwigshafen,75 und mehr Jahre,490,212,278
False,8335098,Bodman-Ludwigshafen,Insgesamt,4391,2115,2276
False,8335099,Orsingen-Nenzingen,unter 3 Jahre,96,48,48
False,8335099,Orsingen-Nenzingen,3 -  6 Jahre,99,48,51
False,8335099,Orsingen-Nenzingen,6 - 10 Jahre,145,70,75
False,8335099,Orsingen-Nenzingen,10 - 15 Jahre,225,117,108
False,8335099,Orsingen-Nenzingen,15 - 18 Jahre,114,61,53
False,8335099,Orsingen-Nenzingen,18 - 20 Jahre,87,47,40
False,8335099,Orsingen-Nenzingen,20 - 25 Jahre,161,93,68
False,8335099,Orsingen-Nenzingen,25 - 30 Jahre,143,60,83
False,8335099,Orsingen-Nenzingen,30 - 35 Jahre,185,91,94
False,8335099,Orsingen-Nenzingen,35 - 40 Jahre,198,92,106
False,8335099,Orsingen-Nenzingen,40 - 45 Jahre,345,181,164
False,8335099,Orsingen-Nenzingen,45 - 50 Jahre,299,144,155
False,8335099,Orsingen-Nenzingen,50 - 55 Jahre,237,123,114
False,8335099,Orsingen-Nenzingen,55 - 60 Jahre,184,96,88
False,8335099,Orsingen-Nenzingen,60 - 65 Jahre,151,81,70
False,8335099,Orsingen-Nenzingen,65 - 75 Jahre,282,133,149
False,8335099,Orsingen-Nenzingen,75 und mehr Jahre,238,96,142
False,8335099,Orsingen-Nenzingen,Insgesamt,3189,1581,1608
False,8335100,Rielasingen-Worblingen,unter 3 Jahre,252,120,132
False,8335100,Rielasingen-Worblingen,3 -  6 Jahre,276,155,121
False,8335100,Rielasingen-Worblingen,6 - 10 Jahre,420,214,206
False,8335100,Rielasingen-Worblingen,10 - 15 Jahre,629,306,323
False,8335100,Rielasingen-Worblingen,15 - 18 Jahre,377,190,187
False,8335100,Rielasingen-Worblingen,18 - 20 Jahre,246,131,115
False,8335100,Rielasingen-Worblingen,20 - 25 Jahre,621,321,300
False,8335100,Rielasingen-Worblingen,25 - 30 Jahre,637,329,308
False,8335100,Rielasingen-Worblingen,30 - 35 Jahre,670,334,336
False,8335100,Rielasingen-Worblingen,35 - 40 Jahre,691,329,362
False,8335100,Rielasingen-Worblingen,40 - 45 Jahre,1029,491,538
False,8335100,Rielasingen-Worblingen,45 - 50 Jahre,1095,583,512
False,8335100,Rielasingen-Worblingen,50 - 55 Jahre,935,466,469
False,8335100,Rielasingen-Worblingen,55 - 60 Jahre,784,394,390
False,8335100,Rielasingen-Worblingen,60 - 65 Jahre,655,279,376
False,8335100,Rielasingen-Worblingen,65 - 75 Jahre,1406,675,731
False,8335100,Rielasingen-Worblingen,75 und mehr Jahre,1158,461,697
False,8335100,Rielasingen-Worblingen,Insgesamt,11881,5778,6103
False,8336,Landkreis Lörrach,unter 3 Jahre,5638,2876,2762
False,8336,Landkreis Lörrach,3 -  6 Jahre,5784,3002,2782
False,8336,Landkreis Lörrach,6 - 10 Jahre,8322,4300,4022
False,8336,Landkreis Lörrach,10 - 15 Jahre,12521,6319,6202
False,8336,Landkreis Lörrach,15 - 18 Jahre,7733,4034,3699
False,8336,Landkreis Lörrach,18 - 20 Jahre,5437,2761,2676
False,8336,Landkreis Lörrach,20 - 25 Jahre,12688,6514,6174
False,8336,Landkreis Lörrach,25 - 30 Jahre,12278,6088,6190
False,8336,Landkreis Lörrach,30 - 35 Jahre,12155,5850,6305
False,8336,Landkreis Lörrach,35 - 40 Jahre,13447,6638,6809
False,8336,Landkreis Lörrach,40 - 45 Jahre,18783,9423,9360
False,8336,Landkreis Lörrach,45 - 50 Jahre,20234,10047,10187
False,8336,Landkreis Lörrach,50 - 55 Jahre,17560,8771,8789
False,8336,Landkreis Lörrach,55 - 60 Jahre,14413,7265,7148
False,8336,Landkreis Lörrach,60 - 65 Jahre,11878,5825,6053
False,8336,Landkreis Lörrach,65 - 75 Jahre,23702,11164,12538
False,8336,Landkreis Lörrach,75 und mehr Jahre,20077,7864,12213
False,8336,Landkreis Lörrach,Insgesamt,222650,108741,113909
False,8336004,Aitern,unter 3 Jahre,19,10,9
False,8336004,Aitern,3 -  6 Jahre,12,5,7
False,8336004,Aitern,6 - 10 Jahre,20,8,12
False,8336004,Aitern,10 - 15 Jahre,32,19,13
False,8336004,Aitern,15 - 18 Jahre,29,14,15
False,8336004,Aitern,18 - 20 Jahre,13,9,4
False,8336004,Aitern,20 - 25 Jahre,31,22,9
False,8336004,Aitern,25 - 30 Jahre,23,9,14
False,8336004,Aitern,30 - 35 Jahre,32,21,11
False,8336004,Aitern,35 - 40 Jahre,34,16,18
False,8336004,Aitern,40 - 45 Jahre,46,24,22
False,8336004,Aitern,45 - 50 Jahre,58,30,28
False,8336004,Aitern,50 - 55 Jahre,39,19,20
False,8336004,Aitern,55 - 60 Jahre,36,22,14
False,8336004,Aitern,60 - 65 Jahre,30,17,13
False,8336004,Aitern,65 - 75 Jahre,56,26,30
False,8336004,Aitern,75 und mehr Jahre,40,16,24
False,8336004,Aitern,Insgesamt,550,287,263
False,8336006,Bad Bellingen,unter 3 Jahre,82,49,33
False,8336006,Bad Bellingen,3 -  6 Jahre,65,33,32
False,8336006,Bad Bellingen,6 - 10 Jahre,111,47,64
False,8336006,Bad Bellingen,10 - 15 Jahre,182,93,89
False,8336006,Bad Bellingen,15 - 18 Jahre,103,60,43
False,8336006,Bad Bellingen,18 - 20 Jahre,69,35,34
False,8336006,Bad Bellingen,20 - 25 Jahre,218,107,111
False,8336006,Bad Bellingen,25 - 30 Jahre,244,115,129
False,8336006,Bad Bellingen,30 - 35 Jahre,212,112,100
False,8336006,Bad Bellingen,35 - 40 Jahre,185,97,88
False,8336006,Bad Bellingen,40 - 45 Jahre,305,166,139
False,8336006,Bad Bellingen,45 - 50 Jahre,340,170,170
False,8336006,Bad Bellingen,50 - 55 Jahre,314,158,156
False,8336006,Bad Bellingen,55 - 60 Jahre,320,168,152
False,8336006,Bad Bellingen,60 - 65 Jahre,248,133,115
False,8336006,Bad Bellingen,65 - 75 Jahre,463,229,234
False,8336006,Bad Bellingen,75 und mehr Jahre,433,163,270
False,8336006,Bad Bellingen,Insgesamt,3894,1935,1959
False,8336008,Binzen,unter 3 Jahre,82,44,38
False,8336008,Binzen,3 -  6 Jahre,82,43,39
False,8336008,Binzen,6 - 10 Jahre,149,80,69
False,8336008,Binzen,10 - 15 Jahre,190,103,87
False,8336008,Binzen,15 - 18 Jahre,82,44,38
False,8336008,Binzen,18 - 20 Jahre,61,32,29
False,8336008,Binzen,20 - 25 Jahre,164,73,91
False,8336008,Binzen,25 - 30 Jahre,119,59,60
False,8336008,Binzen,30 - 35 Jahre,132,59,73
False,8336008,Binzen,35 - 40 Jahre,184,88,96
False,8336008,Binzen,40 - 45 Jahre,315,139,176
False,8336008,Binzen,45 - 50 Jahre,283,146,137
False,8336008,Binzen,50 - 55 Jahre,203,108,95
False,8336008,Binzen,55 - 60 Jahre,172,82,90
False,8336008,Binzen,60 - 65 Jahre,156,77,79
False,8336008,Binzen,65 - 75 Jahre,291,137,154
False,8336008,Binzen,75 und mehr Jahre,221,98,123
False,8336008,Binzen,Insgesamt,2886,1412,1474
False,8336010,Böllen,unter 3 Jahre,3,2,1
False,8336010,Böllen,3 -  6 Jahre,2,1,1
False,8336010,Böllen,6 - 10 Jahre,3,1,2
False,8336010,Böllen,10 - 15 Jahre,6,3,3
False,8336010,Böllen,15 - 18 Jahre,8,2,6
False,8336010,Böllen,18 - 20 Jahre,1,1,0
False,8336010,Böllen,20 - 25 Jahre,2,2,0
False,8336010,Böllen,25 - 30 Jahre,1,1,0
False,8336010,Böllen,30 - 35 Jahre,3,1,2
False,8336010,Böllen,35 - 40 Jahre,9,5,4
False,8336010,Böllen,40 - 45 Jahre,8,4,4
False,8336010,Böllen,45 - 50 Jahre,9,5,4
False,8336010,Böllen,50 - 55 Jahre,12,7,5
False,8336010,Böllen,55 - 60 Jahre,5,1,4
False,8336010,Böllen,60 - 65 Jahre,3,2,1
False,8336010,Böllen,65 - 75 Jahre,4,2,2
False,8336010,Böllen,75 und mehr Jahre,15,7,8
False,8336010,Böllen,Insgesamt,94,47,47
False,8336014,Efringen-Kirchen,unter 3 Jahre,211,114,97
False,8336014,Efringen-Kirchen,3 -  6 Jahre,219,108,111
False,8336014,Efringen-Kirchen,6 - 10 Jahre,303,166,137
False,8336014,Efringen-Kirchen,10 - 15 Jahre,466,239,227
False,8336014,Efringen-Kirchen,15 - 18 Jahre,277,148,129
False,8336014,Efringen-Kirchen,18 - 20 Jahre,212,127,85
False,8336014,Efringen-Kirchen,20 - 25 Jahre,459,230,229
False,8336014,Efringen-Kirchen,25 - 30 Jahre,455,223,232
False,8336014,Efringen-Kirchen,30 - 35 Jahre,423,206,217
False,8336014,Efringen-Kirchen,35 - 40 Jahre,462,224,238
False,8336014,Efringen-Kirchen,40 - 45 Jahre,715,355,360
False,8336014,Efringen-Kirchen,45 - 50 Jahre,773,372,401
False,8336014,Efringen-Kirchen,50 - 55 Jahre,716,363,353
False,8336014,Efringen-Kirchen,55 - 60 Jahre,605,297,308
False,8336014,Efringen-Kirchen,60 - 65 Jahre,406,214,192
False,8336014,Efringen-Kirchen,65 - 75 Jahre,831,408,423
False,8336014,Efringen-Kirchen,75 und mehr Jahre,631,262,369
False,8336014,Efringen-Kirchen,Insgesamt,8164,4056,4108
False,8336019,Eimeldingen,unter 3 Jahre,68,35,33
False,8336019,Eimeldingen,3 -  6 Jahre,68,36,32
False,8336019,Eimeldingen,6 - 10 Jahre,113,59,54
False,8336019,Eimeldingen,10 - 15 Jahre,145,80,65
False,8336019,Eimeldingen,15 - 18 Jahre,88,42,46
False,8336019,Eimeldingen,18 - 20 Jahre,60,23,37
False,8336019,Eimeldingen,20 - 25 Jahre,145,76,69
False,8336019,Eimeldingen,25 - 30 Jahre,143,71,72
False,8336019,Eimeldingen,30 - 35 Jahre,145,80,65
False,8336019,Eimeldingen,35 - 40 Jahre,186,81,105
False,8336019,Eimeldingen,40 - 45 Jahre,239,120,119
False,8336019,Eimeldingen,45 - 50 Jahre,231,116,115
False,8336019,Eimeldingen,50 - 55 Jahre,210,113,97
False,8336019,Eimeldingen,55 - 60 Jahre,150,74,76
False,8336019,Eimeldingen,60 - 65 Jahre,116,55,61
False,8336019,Eimeldingen,65 - 75 Jahre,192,85,107
False,8336019,Eimeldingen,75 und mehr Jahre,140,63,77
False,8336019,Eimeldingen,Insgesamt,2439,1209,1230
False,8336024,Fischingen,unter 3 Jahre,10,5,5
False,8336024,Fischingen,3 -  6 Jahre,19,12,7
False,8336024,Fischingen,6 - 10 Jahre,36,14,22
False,8336024,Fischingen,10 - 15 Jahre,34,16,18
False,8336024,Fischingen,15 - 18 Jahre,19,11,8
False,8336024,Fischingen,18 - 20 Jahre,12,6,6
False,8336024,Fischingen,20 - 25 Jahre,36,20,16
False,8336024,Fischingen,25 - 30 Jahre,34,19,15
False,8336024,Fischingen,30 - 35 Jahre,43,20,23
False,8336024,Fischingen,35 - 40 Jahre,41,17,24
False,8336024,Fischingen,40 - 45 Jahre,69,39,30
False,8336024,Fischingen,45 - 50 Jahre,59,37,22
False,8336024,Fischingen,50 - 55 Jahre,67,34,33
False,8336024,Fischingen,55 - 60 Jahre,49,27,22
False,8336024,Fischingen,60 - 65 Jahre,38,19,19
False,8336024,Fischingen,65 - 75 Jahre,76,38,38
False,8336024,Fischingen,75 und mehr Jahre,59,22,37
False,8336024,Fischingen,Insgesamt,701,356,345
False,8336025,Fröhnd,unter 3 Jahre,13,8,5
False,8336025,Fröhnd,3 -  6 Jahre,10,4,6
False,8336025,Fröhnd,6 - 10 Jahre,26,7,19
False,8336025,Fröhnd,10 - 15 Jahre,22,10,12
False,8336025,Fröhnd,15 - 18 Jahre,20,11,9
False,8336025,Fröhnd,18 - 20 Jahre,10,7,3
False,8336025,Fröhnd,20 - 25 Jahre,31,20,11
False,8336025,Fröhnd,25 - 30 Jahre,30,16,14
False,8336025,Fröhnd,30 - 35 Jahre,25,10,15
False,8336025,Fröhnd,35 - 40 Jahre,22,12,10
False,8336025,Fröhnd,40 - 45 Jahre,44,26,18
False,8336025,Fröhnd,45 - 50 Jahre,44,20,24
False,8336025,Fröhnd,50 - 55 Jahre,46,25,21
False,8336025,Fröhnd,55 - 60 Jahre,35,22,13
False,8336025,Fröhnd,60 - 65 Jahre,17,11,6
False,8336025,Fröhnd,65 - 75 Jahre,37,18,19
False,8336025,Fröhnd,75 und mehr Jahre,53,24,29
False,8336025,Fröhnd,Insgesamt,485,251,234
False,8336034,Hasel,unter 3 Jahre,34,19,15
False,8336034,Hasel,3 -  6 Jahre,29,13,16
False,8336034,Hasel,6 - 10 Jahre,50,33,17
False,8336034,Hasel,10 - 15 Jahre,61,34,27
False,8336034,Hasel,15 - 18 Jahre,33,14,19
False,8336034,Hasel,18 - 20 Jahre,27,17,10
False,8336034,Hasel,20 - 25 Jahre,71,30,41
False,8336034,Hasel,25 - 30 Jahre,63,32,31
False,8336034,Hasel,30 - 35 Jahre,56,30,26
False,8336034,Hasel,35 - 40 Jahre,83,36,47
False,8336034,Hasel,40 - 45 Jahre,88,50,38
False,8336034,Hasel,45 - 50 Jahre,100,49,51
False,8336034,Hasel,50 - 55 Jahre,81,40,41
False,8336034,Hasel,55 - 60 Jahre,79,47,32
False,8336034,Hasel,60 - 65 Jahre,51,28,23
False,8336034,Hasel,65 - 75 Jahre,105,47,58
False,8336034,Hasel,75 und mehr Jahre,108,42,66
False,8336034,Hasel,Insgesamt,1119,561,558
False,8336036,Hausen im Wiesental,unter 3 Jahre,56,28,28
False,8336036,Hausen im Wiesental,3 -  6 Jahre,53,28,25
False,8336036,Hausen im Wiesental,6 - 10 Jahre,80,39,41
False,8336036,Hausen im Wiesental,10 - 15 Jahre,156,86,70
False,8336036,Hausen im Wiesental,15 - 18 Jahre,113,65,48
False,8336036,Hausen im Wiesental,18 - 20 Jahre,59,26,33
False,8336036,Hausen im Wiesental,20 - 25 Jahre,135,68,67
False,8336036,Hausen im Wiesental,25 - 30 Jahre,120,67,53
False,8336036,Hausen im Wiesental,30 - 35 Jahre,97,45,52
False,8336036,Hausen im Wiesental,35 - 40 Jahre,139,79,60
False,8336036,Hausen im Wiesental,40 - 45 Jahre,215,106,109
False,8336036,Hausen im Wiesental,45 - 50 Jahre,229,122,107
False,8336036,Hausen im Wiesental,50 - 55 Jahre,190,96,94
False,8336036,Hausen im Wiesental,55 - 60 Jahre,126,66,60
False,8336036,Hausen im Wiesental,60 - 65 Jahre,135,66,69
False,8336036,Hausen im Wiesental,65 - 75 Jahre,257,115,142
False,8336036,Hausen im Wiesental,75 und mehr Jahre,199,81,118
False,8336036,Hausen im Wiesental,Insgesamt,2359,1183,1176
False,8336043,Inzlingen,unter 3 Jahre,49,24,25
False,8336043,Inzlingen,3 -  6 Jahre,68,44,24
False,8336043,Inzlingen,6 - 10 Jahre,88,49,39
False,8336043,Inzlingen,10 - 15 Jahre,116,66,50
False,8336043,Inzlingen,15 - 18 Jahre,66,28,38
False,8336043,Inzlingen,18 - 20 Jahre,60,33,27
False,8336043,Inzlingen,20 - 25 Jahre,96,50,46
False,8336043,Inzlingen,25 - 30 Jahre,122,62,60
False,8336043,Inzlingen,30 - 35 Jahre,124,57,67
False,8336043,Inzlingen,35 - 40 Jahre,122,63,59
False,8336043,Inzlingen,40 - 45 Jahre,234,93,141
False,8336043,Inzlingen,45 - 50 Jahre,208,97,111
False,8336043,Inzlingen,50 - 55 Jahre,217,115,102
False,8336043,Inzlingen,55 - 60 Jahre,177,83,94
False,8336043,Inzlingen,60 - 65 Jahre,141,70,71
False,8336043,Inzlingen,65 - 75 Jahre,330,163,167
False,8336043,Inzlingen,75 und mehr Jahre,254,102,152
False,8336043,Inzlingen,Insgesamt,2472,1199,1273
False,8336045,"Kandern, Stadt",unter 3 Jahre,171,77,94
False,8336045,"Kandern, Stadt",3 -  6 Jahre,193,93,100
False,8336045,"Kandern, Stadt",6 - 10 Jahre,280,145,135
False,8336045,"Kandern, Stadt",10 - 15 Jahre,443,234,209
False,8336045,"Kandern, Stadt",15 - 18 Jahre,320,165,155
False,8336045,"Kandern, Stadt",18 - 20 Jahre,183,104,79
False,8336045,"Kandern, Stadt",20 - 25 Jahre,403,193,210
False,8336045,"Kandern, Stadt",25 - 30 Jahre,385,185,200
False,8336045,"Kandern, Stadt",30 - 35 Jahre,412,188,224
False,8336045,"Kandern, Stadt",35 - 40 Jahre,416,196,220
False,8336045,"Kandern, Stadt",40 - 45 Jahre,732,370,362
False,8336045,"Kandern, Stadt",45 - 50 Jahre,791,383,408
False,8336045,"Kandern, Stadt",50 - 55 Jahre,714,355,359
False,8336045,"Kandern, Stadt",55 - 60 Jahre,532,288,244
False,8336045,"Kandern, Stadt",60 - 65 Jahre,435,224,211
False,8336045,"Kandern, Stadt",65 - 75 Jahre,820,399,421
False,8336045,"Kandern, Stadt",75 und mehr Jahre,873,297,576
False,8336045,"Kandern, Stadt",Insgesamt,8103,3896,4207
False,8336050,"Lörrach, Stadt",unter 3 Jahre,1257,643,614
False,8336050,"Lörrach, Stadt",3 -  6 Jahre,1262,693,569
False,8336050,"Lörrach, Stadt",6 - 10 Jahre,1699,842,857
False,8336050,"Lörrach, Stadt",10 - 15 Jahre,2607,1305,1302
False,8336050,"Lörrach, Stadt",15 - 18 Jahre,1575,830,745
False,8336050,"Lörrach, Stadt",18 - 20 Jahre,1105,532,573
False,8336050,"Lörrach, Stadt",20 - 25 Jahre,2792,1405,1387
False,8336050,"Lörrach, Stadt",25 - 30 Jahre,3017,1492,1525
False,8336050,"Lörrach, Stadt",30 - 35 Jahre,2931,1422,1509
False,8336050,"Lörrach, Stadt",35 - 40 Jahre,3088,1548,1540
False,8336050,"Lörrach, Stadt",40 - 45 Jahre,3938,1985,1953
False,8336050,"Lörrach, Stadt",45 - 50 Jahre,4326,2070,2256
False,8336050,"Lörrach, Stadt",50 - 55 Jahre,3662,1853,1809
False,8336050,"Lörrach, Stadt",55 - 60 Jahre,3061,1545,1516
False,8336050,"Lörrach, Stadt",60 - 65 Jahre,2541,1206,1335
False,8336050,"Lörrach, Stadt",65 - 75 Jahre,4939,2289,2650
False,8336050,"Lörrach, Stadt",75 und mehr Jahre,4580,1711,2869
False,8336050,"Lörrach, Stadt",Insgesamt,48380,23371,25009
False,8336057,Maulburg,unter 3 Jahre,104,54,50
False,8336057,Maulburg,3 -  6 Jahre,80,38,42
False,8336057,Maulburg,6 - 10 Jahre,174,107,67
False,8336057,Maulburg,10 - 15 Jahre,221,108,113
False,8336057,Maulburg,15 - 18 Jahre,167,93,74
False,8336057,Maulburg,18 - 20 Jahre,130,68,62
False,8336057,Maulburg,20 - 25 Jahre,284,155,129
False,8336057,Maulburg,25 - 30 Jahre,222,116,106
False,8336057,Maulburg,30 - 35 Jahre,213,107,106
False,8336057,Maulburg,35 - 40 Jahre,239,117,122
False,8336057,Maulburg,40 - 45 Jahre,304,153,151
False,8336057,Maulburg,45 - 50 Jahre,358,189,169
False,8336057,Maulburg,50 - 55 Jahre,343,165,178
False,8336057,Maulburg,55 - 60 Jahre,257,131,126
False,8336057,Maulburg,60 - 65 Jahre,211,104,107
False,8336057,Maulburg,65 - 75 Jahre,409,196,213
False,8336057,Maulburg,75 und mehr Jahre,302,125,177
False,8336057,Maulburg,Insgesamt,4018,2026,1992
False,8336069,"Rheinfelden (Baden), Stadt",unter 3 Jahre,854,427,427
False,8336069,"Rheinfelden (Baden), Stadt",3 -  6 Jahre,872,487,385
False,8336069,"Rheinfelden (Baden), Stadt",6 - 10 Jahre,1224,639,585
False,8336069,"Rheinfelden (Baden), Stadt",10 - 15 Jahre,1863,930,933
False,8336069,"Rheinfelden (Baden), Stadt",15 - 18 Jahre,1080,562,518
False,8336069,"Rheinfelden (Baden), Stadt",18 - 20 Jahre,814,410,404
False,8336069,"Rheinfelden (Baden), Stadt",20 - 25 Jahre,1941,971,970
False,8336069,"Rheinfelden (Baden), Stadt",25 - 30 Jahre,1753,860,893
False,8336069,"Rheinfelden (Baden), Stadt",30 - 35 Jahre,1854,899,955
False,8336069,"Rheinfelden (Baden), Stadt",35 - 40 Jahre,1979,1006,973
False,8336069,"Rheinfelden (Baden), Stadt",40 - 45 Jahre,2787,1432,1355
False,8336069,"Rheinfelden (Baden), Stadt",45 - 50 Jahre,2838,1409,1429
False,8336069,"Rheinfelden (Baden), Stadt",50 - 55 Jahre,2569,1278,1291
False,8336069,"Rheinfelden (Baden), Stadt",55 - 60 Jahre,1979,966,1013
False,8336069,"Rheinfelden (Baden), Stadt",60 - 65 Jahre,1642,795,847
False,8336069,"Rheinfelden (Baden), Stadt",65 - 75 Jahre,3603,1628,1975
False,8336069,"Rheinfelden (Baden), Stadt",75 und mehr Jahre,2678,1083,1595
False,8336069,"Rheinfelden (Baden), Stadt",Insgesamt,32330,15782,16548
False,8336073,Rümmingen,unter 3 Jahre,43,24,19
False,8336073,Rümmingen,3 -  6 Jahre,51,20,31
False,8336073,Rümmingen,6 - 10 Jahre,68,36,32
False,8336073,Rümmingen,10 - 15 Jahre,85,50,35
False,8336073,Rümmingen,15 - 18 Jahre,44,19,25
False,8336073,Rümmingen,18 - 20 Jahre,44,23,21
False,8336073,Rümmingen,20 - 25 Jahre,90,49,41
False,8336073,Rümmingen,25 - 30 Jahre,82,42,40
False,8336073,Rümmingen,30 - 35 Jahre,83,33,50
False,8336073,Rümmingen,35 - 40 Jahre,131,75,56
False,8336073,Rümmingen,40 - 45 Jahre,138,62,76
False,8336073,Rümmingen,45 - 50 Jahre,145,79,66
False,8336073,Rümmingen,50 - 55 Jahre,136,70,66
False,8336073,Rümmingen,55 - 60 Jahre,105,44,61
False,8336073,Rümmingen,60 - 65 Jahre,121,67,54
False,8336073,Rümmingen,65 - 75 Jahre,180,91,89
False,8336073,Rümmingen,75 und mehr Jahre,90,42,48
False,8336073,Rümmingen,Insgesamt,1636,826,810
False,8336075,Schallbach,unter 3 Jahre,23,9,14
False,8336075,Schallbach,3 -  6 Jahre,23,12,11
False,8336075,Schallbach,6 - 10 Jahre,26,13,13
False,8336075,Schallbach,10 - 15 Jahre,59,34,25
False,8336075,Schallbach,15 - 18 Jahre,25,13,12
False,8336075,Schallbach,18 - 20 Jahre,12,6,6
False,8336075,Schallbach,20 - 25 Jahre,34,14,20
False,8336075,Schallbach,25 - 30 Jahre,35,13,22
False,8336075,Schallbach,30 - 35 Jahre,29,14,15
False,8336075,Schallbach,35 - 40 Jahre,43,20,23
False,8336075,Schallbach,40 - 45 Jahre,62,33,29
False,8336075,Schallbach,45 - 50 Jahre,75,30,45
False,8336075,Schallbach,50 - 55 Jahre,42,27,15
False,8336075,Schallbach,55 - 60 Jahre,67,36,31
False,8336075,Schallbach,60 - 65 Jahre,47,18,29
False,8336075,Schallbach,65 - 75 Jahre,64,36,28
False,8336075,Schallbach,75 und mehr Jahre,45,18,27
False,8336075,Schallbach,Insgesamt,711,346,365
False,8336078,Schliengen,unter 3 Jahre,145,66,79
False,8336078,Schliengen,3 -  6 Jahre,154,71,83
False,8336078,Schliengen,6 - 10 Jahre,235,121,114
False,8336078,Schliengen,10 - 15 Jahre,329,159,170
False,8336078,Schliengen,15 - 18 Jahre,207,99,108
False,8336078,Schliengen,18 - 20 Jahre,137,67,70
False,8336078,Schliengen,20 - 25 Jahre,291,166,125
False,8336078,Schliengen,25 - 30 Jahre,266,133,133
False,8336078,Schliengen,30 - 35 Jahre,268,127,141
False,8336078,Schliengen,35 - 40 Jahre,314,147,167
False,8336078,Schliengen,40 - 45 Jahre,497,240,257
False,8336078,Schliengen,45 - 50 Jahre,467,241,226
False,8336078,Schliengen,50 - 55 Jahre,456,235,221
False,8336078,Schliengen,55 - 60 Jahre,346,185,161
False,8336078,Schliengen,60 - 65 Jahre,290,151,139
False,8336078,Schliengen,65 - 75 Jahre,511,240,271
False,8336078,Schliengen,75 und mehr Jahre,409,169,240
False,8336078,Schliengen,Insgesamt,5322,2617,2705
False,8336079,"Schönau im Schwarzwald, Stadt",unter 3 Jahre,64,27,37
False,8336079,"Schönau im Schwarzwald, Stadt",3 -  6 Jahre,58,28,30
False,8336079,"Schönau im Schwarzwald, Stadt",6 - 10 Jahre,99,55,44
False,8336079,"Schönau im Schwarzwald, Stadt",10 - 15 Jahre,139,59,80
False,8336079,"Schönau im Schwarzwald, Stadt",15 - 18 Jahre,90,54,36
False,8336079,"Schönau im Schwarzwald, Stadt",18 - 20 Jahre,77,32,45
False,8336079,"Schönau im Schwarzwald, Stadt",20 - 25 Jahre,126,60,66
False,8336079,"Schönau im Schwarzwald, Stadt",25 - 30 Jahre,136,63,73
False,8336079,"Schönau im Schwarzwald, Stadt",30 - 35 Jahre,122,62,60
False,8336079,"Schönau im Schwarzwald, Stadt",35 - 40 Jahre,143,73,70
False,8336079,"Schönau im Schwarzwald, Stadt",40 - 45 Jahre,173,87,86
False,8336079,"Schönau im Schwarzwald, Stadt",45 - 50 Jahre,190,96,94
False,8336079,"Schönau im Schwarzwald, Stadt",50 - 55 Jahre,184,99,85
False,8336079,"Schönau im Schwarzwald, Stadt",55 - 60 Jahre,158,72,86
False,8336079,"Schönau im Schwarzwald, Stadt",60 - 65 Jahre,135,71,64
False,8336079,"Schönau im Schwarzwald, Stadt",65 - 75 Jahre,273,126,147
False,8336079,"Schönau im Schwarzwald, Stadt",75 und mehr Jahre,215,90,125
False,8336079,"Schönau im Schwarzwald, Stadt",Insgesamt,2382,1154,1228
False,8336080,Schönenberg,unter 3 Jahre,11,7,4
False,8336080,Schönenberg,3 -  6 Jahre,6,2,4
False,8336080,Schönenberg,6 - 10 Jahre,17,13,4
False,8336080,Schönenberg,10 - 15 Jahre,24,12,12
False,8336080,Schönenberg,15 - 18 Jahre,12,3,9
False,8336080,Schönenberg,18 - 20 Jahre,8,3,5
False,8336080,Schönenberg,20 - 25 Jahre,21,15,6
False,8336080,Schönenberg,25 - 30 Jahre,6,3,3
False,8336080,Schönenberg,30 - 35 Jahre,18,8,10
False,8336080,Schönenberg,35 - 40 Jahre,26,13,13
False,8336080,Schönenberg,40 - 45 Jahre,25,11,14
False,8336080,Schönenberg,45 - 50 Jahre,38,21,17
False,8336080,Schönenberg,50 - 55 Jahre,26,14,12
False,8336080,Schönenberg,55 - 60 Jahre,11,4,7
False,8336080,Schönenberg,60 - 65 Jahre,24,10,14
False,8336080,Schönenberg,65 - 75 Jahre,44,25,19
False,8336080,Schönenberg,75 und mehr Jahre,30,11,19
False,8336080,Schönenberg,Insgesamt,347,175,172
False,8336081,"Schopfheim, Stadt",unter 3 Jahre,437,225,212
False,8336081,"Schopfheim, Stadt",3 -  6 Jahre,487,236,251
False,8336081,"Schopfheim, Stadt",6 - 10 Jahre,706,375,331
False,8336081,"Schopfheim, Stadt",10 - 15 Jahre,1092,543,549
False,8336081,"Schopfheim, Stadt",15 - 18 Jahre,729,348,381
False,8336081,"Schopfheim, Stadt",18 - 20 Jahre,506,256,250
False,8336081,"Schopfheim, Stadt",20 - 25 Jahre,1074,549,525
False,8336081,"Schopfheim, Stadt",25 - 30 Jahre,988,522,466
False,8336081,"Schopfheim, Stadt",30 - 35 Jahre,947,467,480
False,8336081,"Schopfheim, Stadt",35 - 40 Jahre,1087,517,570
False,8336081,"Schopfheim, Stadt",40 - 45 Jahre,1528,763,765
False,8336081,"Schopfheim, Stadt",45 - 50 Jahre,1805,897,908
False,8336081,"Schopfheim, Stadt",50 - 55 Jahre,1548,767,781
False,8336081,"Schopfheim, Stadt",55 - 60 Jahre,1326,649,677
False,8336081,"Schopfheim, Stadt",60 - 65 Jahre,1026,520,506
False,8336081,"Schopfheim, Stadt",65 - 75 Jahre,1947,918,1029
False,8336081,"Schopfheim, Stadt",75 und mehr Jahre,1707,658,1049
False,8336081,"Schopfheim, Stadt",Insgesamt,18940,9210,9730
False,8336082,Schwörstadt,unter 3 Jahre,61,30,31
False,8336082,Schwörstadt,3 -  6 Jahre,60,29,31
False,8336082,Schwörstadt,6 - 10 Jahre,69,34,35
False,8336082,Schwörstadt,10 - 15 Jahre,126,59,67
False,8336082,Schwörstadt,15 - 18 Jahre,100,48,52
False,8336082,Schwörstadt,18 - 20 Jahre,63,33,30
False,8336082,Schwörstadt,20 - 25 Jahre,138,80,58
False,8336082,Schwörstadt,25 - 30 Jahre,155,90,65
False,8336082,Schwörstadt,30 - 35 Jahre,115,54,61
False,8336082,Schwörstadt,35 - 40 Jahre,159,79,80
False,8336082,Schwörstadt,40 - 45 Jahre,207,107,100
False,8336082,Schwörstadt,45 - 50 Jahre,216,105,111
False,8336082,Schwörstadt,50 - 55 Jahre,184,89,95
False,8336082,Schwörstadt,55 - 60 Jahre,160,80,80
False,8336082,Schwörstadt,60 - 65 Jahre,136,72,64
False,8336082,Schwörstadt,65 - 75 Jahre,251,121,130
False,8336082,Schwörstadt,75 und mehr Jahre,207,91,116
False,8336082,Schwörstadt,Insgesamt,2407,1201,1206
False,8336084,Steinen,unter 3 Jahre,263,138,125
False,8336084,Steinen,3 -  6 Jahre,271,129,142
False,8336084,Steinen,6 - 10 Jahre,379,205,174
False,8336084,Steinen,10 - 15 Jahre,592,301,291
False,8336084,Steinen,15 - 18 Jahre,357,189,168
False,8336084,Steinen,18 - 20 Jahre,257,123,134
False,8336084,Steinen,20 - 25 Jahre,553,303,250
False,8336084,Steinen,25 - 30 Jahre,518,249,269
False,8336084,Steinen,30 - 35 Jahre,480,245,235
False,8336084,Steinen,35 - 40 Jahre,529,247,282
False,8336084,Steinen,40 - 45 Jahre,906,424,482
False,8336084,Steinen,45 - 50 Jahre,1013,504,509
False,8336084,Steinen,50 - 55 Jahre,826,412,414
False,8336084,Steinen,55 - 60 Jahre,702,353,349
False,8336084,Steinen,60 - 65 Jahre,542,269,273
False,8336084,Steinen,65 - 75 Jahre,1071,513,558
False,8336084,Steinen,75 und mehr Jahre,884,348,536
False,8336084,Steinen,Insgesamt,10143,4952,5191
False,8336087,"Todtnau, Stadt",unter 3 Jahre,96,58,38
False,8336087,"Todtnau, Stadt",3 -  6 Jahre,114,55,59
False,8336087,"Todtnau, Stadt",6 - 10 Jahre,171,78,93
False,8336087,"Todtnau, Stadt",10 - 15 Jahre,312,160,152
False,8336087,"Todtnau, Stadt",15 - 18 Jahre,190,105,85
False,8336087,"Todtnau, Stadt",18 - 20 Jahre,126,61,65
False,8336087,"Todtnau, Stadt",20 - 25 Jahre,247,129,118
False,8336087,"Todtnau, Stadt",25 - 30 Jahre,196,93,103
False,8336087,"Todtnau, Stadt",30 - 35 Jahre,225,98,127
False,8336087,"Todtnau, Stadt",35 - 40 Jahre,268,131,137
False,8336087,"Todtnau, Stadt",40 - 45 Jahre,405,208,197
False,8336087,"Todtnau, Stadt",45 - 50 Jahre,497,270,227
False,8336087,"Todtnau, Stadt",50 - 55 Jahre,338,171,167
False,8336087,"Todtnau, Stadt",55 - 60 Jahre,293,156,137
False,8336087,"Todtnau, Stadt",60 - 65 Jahre,263,119,144
False,8336087,"Todtnau, Stadt",65 - 75 Jahre,554,268,286
False,8336087,"Todtnau, Stadt",75 und mehr Jahre,584,243,341
False,8336087,"Todtnau, Stadt",Insgesamt,4879,2403,2476
False,8336089,Tunau,unter 3 Jahre,5,2,3
False,8336089,Tunau,3 -  6 Jahre,9,7,2
False,8336089,Tunau,6 - 10 Jahre,8,4,4
False,8336089,Tunau,10 - 15 Jahre,6,4,2
False,8336089,Tunau,15 - 18 Jahre,4,2,2
False,8336089,Tunau,18 - 20 Jahre,5,4,1
False,8336089,Tunau,20 - 25 Jahre,11,7,4
False,8336089,Tunau,25 - 30 Jahre,5,1,4
False,8336089,Tunau,30 - 35 Jahre,6,3,3
False,8336089,Tunau,35 - 40 Jahre,21,11,10
False,8336089,Tunau,40 - 45 Jahre,15,6,9
False,8336089,Tunau,45 - 50 Jahre,17,8,9
False,8336089,Tunau,50 - 55 Jahre,15,8,7
False,8336089,Tunau,55 - 60 Jahre,16,11,5
False,8336089,Tunau,60 - 65 Jahre,10,8,2
False,8336089,Tunau,65 - 75 Jahre,24,9,15
False,8336089,Tunau,75 und mehr Jahre,14,5,9
False,8336089,Tunau,Insgesamt,191,100,91
False,8336090,Utzenfeld,unter 3 Jahre,11,6,5
False,8336090,Utzenfeld,3 -  6 Jahre,18,11,7
False,8336090,Utzenfeld,6 - 10 Jahre,18,5,13
False,8336090,Utzenfeld,10 - 15 Jahre,33,18,15
False,8336090,Utzenfeld,15 - 18 Jahre,27,13,14
False,8336090,Utzenfeld,18 - 20 Jahre,20,10,10
False,8336090,Utzenfeld,20 - 25 Jahre,35,19,16
False,8336090,Utzenfeld,25 - 30 Jahre,41,27,14
False,8336090,Utzenfeld,30 - 35 Jahre,33,14,19
False,8336090,Utzenfeld,35 - 40 Jahre,27,14,13
False,8336090,Utzenfeld,40 - 45 Jahre,33,22,11
False,8336090,Utzenfeld,45 - 50 Jahre,61,29,32
False,8336090,Utzenfeld,50 - 55 Jahre,67,38,29
False,8336090,Utzenfeld,55 - 60 Jahre,41,22,19
False,8336090,Utzenfeld,60 - 65 Jahre,24,15,9
False,8336090,Utzenfeld,65 - 75 Jahre,87,40,47
False,8336090,Utzenfeld,75 und mehr Jahre,61,26,35
False,8336090,Utzenfeld,Insgesamt,637,329,308
False,8336091,"Weil am Rhein, Stadt",unter 3 Jahre,792,419,373
False,8336091,"Weil am Rhein, Stadt",3 -  6 Jahre,806,416,390
False,8336091,"Weil am Rhein, Stadt",6 - 10 Jahre,1156,592,564
False,8336091,"Weil am Rhein, Stadt",10 - 15 Jahre,1669,846,823
False,8336091,"Weil am Rhein, Stadt",15 - 18 Jahre,942,501,441
False,8336091,"Weil am Rhein, Stadt",18 - 20 Jahre,682,352,330
False,8336091,"Weil am Rhein, Stadt",20 - 25 Jahre,1739,875,864
False,8336091,"Weil am Rhein, Stadt",25 - 30 Jahre,1737,830,907
False,8336091,"Weil am Rhein, Stadt",30 - 35 Jahre,1724,793,931
False,8336091,"Weil am Rhein, Stadt",35 - 40 Jahre,1913,957,956
False,8336091,"Weil am Rhein, Stadt",40 - 45 Jahre,2499,1275,1224
False,8336091,"Weil am Rhein, Stadt",45 - 50 Jahre,2533,1279,1254
False,8336091,"Weil am Rhein, Stadt",50 - 55 Jahre,2202,1057,1145
False,8336091,"Weil am Rhein, Stadt",55 - 60 Jahre,1813,883,930
False,8336091,"Weil am Rhein, Stadt",60 - 65 Jahre,1636,780,856
False,8336091,"Weil am Rhein, Stadt",65 - 75 Jahre,3351,1582,1769
False,8336091,"Weil am Rhein, Stadt",75 und mehr Jahre,2724,1055,1669
False,8336091,"Weil am Rhein, Stadt",Insgesamt,29918,14492,15426
False,8336094,Wembach,unter 3 Jahre,11,4,7
False,8336094,Wembach,3 -  6 Jahre,8,4,4
False,8336094,Wembach,6 - 10 Jahre,14,8,6
False,8336094,Wembach,10 - 15 Jahre,19,12,7
False,8336094,Wembach,15 - 18 Jahre,17,10,7
False,8336094,Wembach,18 - 20 Jahre,5,4,1
False,8336094,Wembach,20 - 25 Jahre,21,12,9
False,8336094,Wembach,25 - 30 Jahre,13,9,4
False,8336094,Wembach,30 - 35 Jahre,15,5,10
False,8336094,Wembach,35 - 40 Jahre,28,14,14
False,8336094,Wembach,40 - 45 Jahre,29,17,12
False,8336094,Wembach,45 - 50 Jahre,17,8,9
False,8336094,Wembach,50 - 55 Jahre,21,10,11
False,8336094,Wembach,55 - 60 Jahre,24,13,11
False,8336094,Wembach,60 - 65 Jahre,21,6,15
False,8336094,Wembach,65 - 75 Jahre,30,14,16
False,8336094,Wembach,75 und mehr Jahre,33,17,16
False,8336094,Wembach,Insgesamt,326,167,159
False,8336096,Wieden,unter 3 Jahre,18,9,9
False,8336096,Wieden,3 -  6 Jahre,15,9,6
False,8336096,Wieden,6 - 10 Jahre,27,13,14
False,8336096,Wieden,10 - 15 Jahre,39,23,16
False,8336096,Wieden,15 - 18 Jahre,22,6,16
False,8336096,Wieden,18 - 20 Jahre,21,9,12
False,8336096,Wieden,20 - 25 Jahre,43,24,19
False,8336096,Wieden,25 - 30 Jahre,37,25,12
False,8336096,Wieden,30 - 35 Jahre,19,13,6
False,8336096,Wieden,35 - 40 Jahre,41,19,22
False,8336096,Wieden,40 - 45 Jahre,39,17,22
False,8336096,Wieden,45 - 50 Jahre,42,20,22
False,8336096,Wieden,50 - 55 Jahre,40,17,23
False,8336096,Wieden,55 - 60 Jahre,41,23,18
False,8336096,Wieden,60 - 65 Jahre,31,12,19
False,8336096,Wieden,65 - 75 Jahre,57,35,22
False,8336096,Wieden,75 und mehr Jahre,32,14,18
False,8336096,Wieden,Insgesamt,564,288,276
False,8336100,Wittlingen,unter 3 Jahre,20,6,14
False,8336100,Wittlingen,3 -  6 Jahre,32,16,16
False,8336100,Wittlingen,6 - 10 Jahre,40,22,18
False,8336100,Wittlingen,10 - 15 Jahre,82,46,36
False,8336100,Wittlingen,15 - 18 Jahre,51,20,31
False,8336100,Wittlingen,18 - 20 Jahre,29,14,15
False,8336100,Wittlingen,20 - 25 Jahre,51,29,22
False,8336100,Wittlingen,25 - 30 Jahre,59,29,30
False,8336100,Wittlingen,30 - 35 Jahre,32,14,18
False,8336100,Wittlingen,35 - 40 Jahre,59,26,33
False,8336100,Wittlingen,40 - 45 Jahre,88,43,45
False,8336100,Wittlingen,45 - 50 Jahre,105,45,60
False,8336100,Wittlingen,50 - 55 Jahre,92,56,36
False,8336100,Wittlingen,55 - 60 Jahre,64,42,22
False,8336100,Wittlingen,60 - 65 Jahre,34,15,19
False,8336100,Wittlingen,65 - 75 Jahre,63,24,39
False,8336100,Wittlingen,75 und mehr Jahre,64,39,25
False,8336100,Wittlingen,Insgesamt,965,486,479
False,8336103,"Zell im Wiesental, Stadt",unter 3 Jahre,176,82,94
False,8336103,"Zell im Wiesental, Stadt",3 -  6 Jahre,166,83,83
False,8336103,"Zell im Wiesental, Stadt",6 - 10 Jahre,236,120,116
False,8336103,"Zell im Wiesental, Stadt",10 - 15 Jahre,340,162,178
False,8336103,"Zell im Wiesental, Stadt",15 - 18 Jahre,219,115,104
False,8336103,"Zell im Wiesental, Stadt",18 - 20 Jahre,185,102,83
False,8336103,"Zell im Wiesental, Stadt",20 - 25 Jahre,402,207,195
False,8336103,"Zell im Wiesental, Stadt",25 - 30 Jahre,312,167,145
False,8336103,"Zell im Wiesental, Stadt",30 - 35 Jahre,298,153,145
False,8336103,"Zell im Wiesental, Stadt",35 - 40 Jahre,334,149,185
False,8336103,"Zell im Wiesental, Stadt",40 - 45 Jahre,477,247,230
False,8336103,"Zell im Wiesental, Stadt",45 - 50 Jahre,549,277,272
False,8336103,"Zell im Wiesental, Stadt",50 - 55 Jahre,455,239,216
False,8336103,"Zell im Wiesental, Stadt",55 - 60 Jahre,361,192,169
False,8336103,"Zell im Wiesental, Stadt",60 - 65 Jahre,294,154,140
False,8336103,"Zell im Wiesental, Stadt",65 - 75 Jahre,586,287,299
False,8336103,"Zell im Wiesental, Stadt",75 und mehr Jahre,547,204,343
False,8336103,"Zell im Wiesental, Stadt",Insgesamt,5937,2940,2997
False,8336104,Malsburg-Marzell,unter 3 Jahre,28,12,16
False,8336104,Malsburg-Marzell,3 -  6 Jahre,26,14,12
False,8336104,Malsburg-Marzell,6 - 10 Jahre,59,37,22
False,8336104,Malsburg-Marzell,10 - 15 Jahre,89,41,48
False,8336104,Malsburg-Marzell,15 - 18 Jahre,79,47,32
False,8336104,Malsburg-Marzell,18 - 20 Jahre,30,20,10
False,8336104,Malsburg-Marzell,20 - 25 Jahre,88,52,36
False,8336104,Malsburg-Marzell,25 - 30 Jahre,66,36,30
False,8336104,Malsburg-Marzell,30 - 35 Jahre,65,24,41
False,8336104,Malsburg-Marzell,35 - 40 Jahre,70,37,33
False,8336104,Malsburg-Marzell,40 - 45 Jahre,113,52,61
False,8336104,Malsburg-Marzell,45 - 50 Jahre,160,78,82
False,8336104,Malsburg-Marzell,50 - 55 Jahre,129,68,61
False,8336104,Malsburg-Marzell,55 - 60 Jahre,116,60,56
False,8336104,Malsburg-Marzell,60 - 65 Jahre,76,38,38
False,8336104,Malsburg-Marzell,65 - 75 Jahre,171,88,83
False,8336104,Malsburg-Marzell,75 und mehr Jahre,142,59,83
False,8336104,Malsburg-Marzell,Insgesamt,1507,763,744
False,8336105,Grenzach-Wyhlen,unter 3 Jahre,341,177,164
False,8336105,Grenzach-Wyhlen,3 -  6 Jahre,345,175,170
False,8336105,Grenzach-Wyhlen,6 - 10 Jahre,493,250,243
False,8336105,Grenzach-Wyhlen,10 - 15 Jahre,729,358,371
False,8336105,Grenzach-Wyhlen,15 - 18 Jahre,463,247,216
False,8336105,Grenzach-Wyhlen,18 - 20 Jahre,323,161,162
False,8336105,Grenzach-Wyhlen,20 - 25 Jahre,724,392,332
False,8336105,Grenzach-Wyhlen,25 - 30 Jahre,717,331,386
False,8336105,Grenzach-Wyhlen,30 - 35 Jahre,794,380,414
False,8336105,Grenzach-Wyhlen,35 - 40 Jahre,846,416,430
False,8336105,Grenzach-Wyhlen,40 - 45 Jahre,1200,570,630
False,8336105,Grenzach-Wyhlen,45 - 50 Jahre,1269,646,623
False,8336105,Grenzach-Wyhlen,50 - 55 Jahre,1083,499,584
False,8336105,Grenzach-Wyhlen,55 - 60 Jahre,902,460,442
False,8336105,Grenzach-Wyhlen,60 - 65 Jahre,805,386,419
False,8336105,Grenzach-Wyhlen,65 - 75 Jahre,1657,799,858
False,8336105,Grenzach-Wyhlen,75 und mehr Jahre,1336,524,812
False,8336105,Grenzach-Wyhlen,Insgesamt,14027,6771,7256
False,8336106,Häg-Ehrsberg,unter 3 Jahre,25,9,16
False,8336106,Häg-Ehrsberg,3 -  6 Jahre,27,8,19
False,8336106,Häg-Ehrsberg,6 - 10 Jahre,35,20,15
False,8336106,Häg-Ehrsberg,10 - 15 Jahre,55,32,23
False,8336106,Häg-Ehrsberg,15 - 18 Jahre,41,25,16
False,8336106,Häg-Ehrsberg,18 - 20 Jahre,20,10,10
False,8336106,Häg-Ehrsberg,20 - 25 Jahre,50,23,27
False,8336106,Häg-Ehrsberg,25 - 30 Jahre,62,42,20
False,8336106,Häg-Ehrsberg,30 - 35 Jahre,54,32,22
False,8336106,Häg-Ehrsberg,35 - 40 Jahre,49,30,19
False,8336106,Häg-Ehrsberg,40 - 45 Jahre,74,41,33
False,8336106,Häg-Ehrsberg,45 - 50 Jahre,80,56,24
False,8336106,Häg-Ehrsberg,50 - 55 Jahre,71,28,43
False,8336106,Häg-Ehrsberg,55 - 60 Jahre,71,44,27
False,8336106,Häg-Ehrsberg,60 - 65 Jahre,33,15,18
False,8336106,Häg-Ehrsberg,65 - 75 Jahre,65,25,40
False,8336106,Häg-Ehrsberg,75 und mehr Jahre,77,35,42
False,8336106,Häg-Ehrsberg,Insgesamt,889,475,414
False,8336107,Kleines Wiesental,unter 3 Jahre,55,27,28
False,8336107,Kleines Wiesental,3 -  6 Jahre,74,39,35
False,8336107,Kleines Wiesental,6 - 10 Jahre,110,63,47
False,8336107,Kleines Wiesental,10 - 15 Jahre,158,74,84
False,8336107,Kleines Wiesental,15 - 18 Jahre,134,81,53
False,8336107,Kleines Wiesental,18 - 20 Jahre,71,41,30
False,8336107,Kleines Wiesental,20 - 25 Jahre,142,87,55
False,8336107,Kleines Wiesental,25 - 30 Jahre,116,56,60
False,8336107,Kleines Wiesental,30 - 35 Jahre,126,54,72
False,8336107,Kleines Wiesental,35 - 40 Jahre,170,78,92
False,8336107,Kleines Wiesental,40 - 45 Jahre,236,136,100
False,8336107,Kleines Wiesental,45 - 50 Jahre,308,143,165
False,8336107,Kleines Wiesental,50 - 55 Jahre,262,138,124
False,8336107,Kleines Wiesental,55 - 60 Jahre,213,117,96
False,8336107,Kleines Wiesental,60 - 65 Jahre,160,78,82
False,8336107,Kleines Wiesental,65 - 75 Jahre,303,143,160
False,8336107,Kleines Wiesental,75 und mehr Jahre,290,120,170
False,8336107,Kleines Wiesental,Insgesamt,2928,1475,1453
False,8337,Landkreis Waldshut,unter 3 Jahre,4310,2175,2135
False,8337,Landkreis Waldshut,3 -  6 Jahre,4492,2270,2222
False,8337,Landkreis Waldshut,6 - 10 Jahre,6605,3443,3162
False,8337,Landkreis Waldshut,10 - 15 Jahre,9434,4823,4611
False,8337,Landkreis Waldshut,15 - 18 Jahre,5953,3098,2855
False,8337,Landkreis Waldshut,18 - 20 Jahre,4183,2181,2002
False,8337,Landkreis Waldshut,20 - 25 Jahre,9599,4972,4627
False,8337,Landkreis Waldshut,25 - 30 Jahre,9175,4594,4581
False,8337,Landkreis Waldshut,30 - 35 Jahre,8763,4323,4440
False,8337,Landkreis Waldshut,35 - 40 Jahre,9662,4716,4946
False,8337,Landkreis Waldshut,40 - 45 Jahre,13302,6619,6683
False,8337,Landkreis Waldshut,45 - 50 Jahre,14335,7249,7086
False,8337,Landkreis Waldshut,50 - 55 Jahre,12700,6420,6280
False,8337,Landkreis Waldshut,55 - 60 Jahre,10973,5457,5516
False,8337,Landkreis Waldshut,60 - 65 Jahre,9051,4528,4523
False,8337,Landkreis Waldshut,65 - 75 Jahre,17855,8519,9336
False,8337,Landkreis Waldshut,75 und mehr Jahre,15748,6174,9574
False,8337,Landkreis Waldshut,Insgesamt,166140,81561,84579
False,8337002,Albbruck,unter 3 Jahre,218,116,102
False,8337002,Albbruck,3 -  6 Jahre,227,121,106
False,8337002,Albbruck,6 - 10 Jahre,309,160,149
False,8337002,Albbruck,10 - 15 Jahre,423,217,206
False,8337002,Albbruck,15 - 18 Jahre,274,140,134
False,8337002,Albbruck,18 - 20 Jahre,223,127,96
False,8337002,Albbruck,20 - 25 Jahre,501,273,228
False,8337002,Albbruck,25 - 30 Jahre,457,270,187
False,8337002,Albbruck,30 - 35 Jahre,381,182,199
False,8337002,Albbruck,35 - 40 Jahre,383,189,194
False,8337002,Albbruck,40 - 45 Jahre,546,257,289
False,8337002,Albbruck,45 - 50 Jahre,648,330,318
False,8337002,Albbruck,50 - 55 Jahre,590,301,289
False,8337002,Albbruck,55 - 60 Jahre,452,215,237
False,8337002,Albbruck,60 - 65 Jahre,345,186,159
False,8337002,Albbruck,65 - 75 Jahre,652,305,347
False,8337002,Albbruck,75 und mehr Jahre,647,258,389
False,8337002,Albbruck,Insgesamt,7276,3647,3629
False,8337013,Bernau im Schwarzwald,unter 3 Jahre,51,28,23
False,8337013,Bernau im Schwarzwald,3 -  6 Jahre,40,21,19
False,8337013,Bernau im Schwarzwald,6 - 10 Jahre,67,35,32
False,8337013,Bernau im Schwarzwald,10 - 15 Jahre,104,49,55
False,8337013,Bernau im Schwarzwald,15 - 18 Jahre,61,35,26
False,8337013,Bernau im Schwarzwald,18 - 20 Jahre,43,25,18
False,8337013,Bernau im Schwarzwald,20 - 25 Jahre,107,56,51
False,8337013,Bernau im Schwarzwald,25 - 30 Jahre,90,46,44
False,8337013,Bernau im Schwarzwald,30 - 35 Jahre,105,51,54
False,8337013,Bernau im Schwarzwald,35 - 40 Jahre,88,39,49
False,8337013,Bernau im Schwarzwald,40 - 45 Jahre,143,70,73
False,8337013,Bernau im Schwarzwald,45 - 50 Jahre,167,87,80
False,8337013,Bernau im Schwarzwald,50 - 55 Jahre,164,83,81
False,8337013,Bernau im Schwarzwald,55 - 60 Jahre,143,64,79
False,8337013,Bernau im Schwarzwald,60 - 65 Jahre,112,52,60
False,8337013,Bernau im Schwarzwald,65 - 75 Jahre,232,116,116
False,8337013,Bernau im Schwarzwald,75 und mehr Jahre,181,80,101
False,8337013,Bernau im Schwarzwald,Insgesamt,1898,937,961
False,8337022,"Bonndorf im Schwarzwald, Stadt",unter 3 Jahre,182,96,86
False,8337022,"Bonndorf im Schwarzwald, Stadt",3 -  6 Jahre,198,106,92
False,8337022,"Bonndorf im Schwarzwald, Stadt",6 - 10 Jahre,278,148,130
False,8337022,"Bonndorf im Schwarzwald, Stadt",10 - 15 Jahre,448,249,199
False,8337022,"Bonndorf im Schwarzwald, Stadt",15 - 18 Jahre,280,145,135
False,8337022,"Bonndorf im Schwarzwald, Stadt",18 - 20 Jahre,193,102,91
False,8337022,"Bonndorf im Schwarzwald, Stadt",20 - 25 Jahre,431,215,216
False,8337022,"Bonndorf im Schwarzwald, Stadt",25 - 30 Jahre,357,180,177
False,8337022,"Bonndorf im Schwarzwald, Stadt",30 - 35 Jahre,359,172,187
False,8337022,"Bonndorf im Schwarzwald, Stadt",35 - 40 Jahre,394,204,190
False,8337022,"Bonndorf im Schwarzwald, Stadt",40 - 45 Jahre,591,300,291
False,8337022,"Bonndorf im Schwarzwald, Stadt",45 - 50 Jahre,614,311,303
False,8337022,"Bonndorf im Schwarzwald, Stadt",50 - 55 Jahre,488,244,244
False,8337022,"Bonndorf im Schwarzwald, Stadt",55 - 60 Jahre,433,217,216
False,8337022,"Bonndorf im Schwarzwald, Stadt",60 - 65 Jahre,340,172,168
False,8337022,"Bonndorf im Schwarzwald, Stadt",65 - 75 Jahre,676,323,353
False,8337022,"Bonndorf im Schwarzwald, Stadt",75 und mehr Jahre,586,225,361
False,8337022,"Bonndorf im Schwarzwald, Stadt",Insgesamt,6848,3409,3439
False,8337027,Dachsberg (Südschwarzwald),unter 3 Jahre,44,18,26
False,8337027,Dachsberg (Südschwarzwald),3 -  6 Jahre,23,11,12
False,8337027,Dachsberg (Südschwarzwald),6 - 10 Jahre,69,41,28
False,8337027,Dachsberg (Südschwarzwald),10 - 15 Jahre,100,54,46
False,8337027,Dachsberg (Südschwarzwald),15 - 18 Jahre,61,29,32
False,8337027,Dachsberg (Südschwarzwald),18 - 20 Jahre,37,24,13
False,8337027,Dachsberg (Südschwarzwald),20 - 25 Jahre,80,47,33
False,8337027,Dachsberg (Südschwarzwald),25 - 30 Jahre,63,32,31
False,8337027,Dachsberg (Südschwarzwald),30 - 35 Jahre,69,45,24
False,8337027,Dachsberg (Südschwarzwald),35 - 40 Jahre,48,21,27
False,8337027,Dachsberg (Südschwarzwald),40 - 45 Jahre,96,45,51
False,8337027,Dachsberg (Südschwarzwald),45 - 50 Jahre,137,65,72
False,8337027,Dachsberg (Südschwarzwald),50 - 55 Jahre,110,58,52
False,8337027,Dachsberg (Südschwarzwald),55 - 60 Jahre,93,53,40
False,8337027,Dachsberg (Südschwarzwald),60 - 65 Jahre,66,30,36
False,8337027,Dachsberg (Südschwarzwald),65 - 75 Jahre,152,61,91
False,8337027,Dachsberg (Südschwarzwald),75 und mehr Jahre,155,64,91
False,8337027,Dachsberg (Südschwarzwald),Insgesamt,1403,698,705
False,8337030,Dettighofen,unter 3 Jahre,29,12,17
False,8337030,Dettighofen,3 -  6 Jahre,30,17,13
False,8337030,Dettighofen,6 - 10 Jahre,48,24,24
False,8337030,Dettighofen,10 - 15 Jahre,70,38,32
False,8337030,Dettighofen,15 - 18 Jahre,37,18,19
False,8337030,Dettighofen,18 - 20 Jahre,31,15,16
False,8337030,Dettighofen,20 - 25 Jahre,42,22,20
False,8337030,Dettighofen,25 - 30 Jahre,56,23,33
False,8337030,Dettighofen,30 - 35 Jahre,66,33,33
False,8337030,Dettighofen,35 - 40 Jahre,63,30,33
False,8337030,Dettighofen,40 - 45 Jahre,76,37,39
False,8337030,Dettighofen,45 - 50 Jahre,103,55,48
False,8337030,Dettighofen,50 - 55 Jahre,83,41,42
False,8337030,Dettighofen,55 - 60 Jahre,88,48,40
False,8337030,Dettighofen,60 - 65 Jahre,56,32,24
False,8337030,Dettighofen,65 - 75 Jahre,105,43,62
False,8337030,Dettighofen,75 und mehr Jahre,98,49,49
False,8337030,Dettighofen,Insgesamt,1081,537,544
False,8337032,Dogern,unter 3 Jahre,48,26,22
False,8337032,Dogern,3 -  6 Jahre,67,29,38
False,8337032,Dogern,6 - 10 Jahre,88,48,40
False,8337032,Dogern,10 - 15 Jahre,119,61,58
False,8337032,Dogern,15 - 18 Jahre,74,45,29
False,8337032,Dogern,18 - 20 Jahre,48,21,27
False,8337032,Dogern,20 - 25 Jahre,92,48,44
False,8337032,Dogern,25 - 30 Jahre,107,54,53
False,8337032,Dogern,30 - 35 Jahre,96,52,44
False,8337032,Dogern,35 - 40 Jahre,112,50,62
False,8337032,Dogern,40 - 45 Jahre,170,88,82
False,8337032,Dogern,45 - 50 Jahre,186,89,97
False,8337032,Dogern,50 - 55 Jahre,213,101,112
False,8337032,Dogern,55 - 60 Jahre,187,95,92
False,8337032,Dogern,60 - 65 Jahre,138,66,72
False,8337032,Dogern,65 - 75 Jahre,288,134,154
False,8337032,Dogern,75 und mehr Jahre,222,88,134
False,8337032,Dogern,Insgesamt,2255,1095,1160
False,8337038,Görwihl,unter 3 Jahre,121,58,63
False,8337038,Görwihl,3 -  6 Jahre,108,49,59
False,8337038,Görwihl,6 - 10 Jahre,187,91,96
False,8337038,Görwihl,10 - 15 Jahre,248,125,123
False,8337038,Görwihl,15 - 18 Jahre,172,90,82
False,8337038,Görwihl,18 - 20 Jahre,140,72,68
False,8337038,Görwihl,20 - 25 Jahre,288,142,146
False,8337038,Görwihl,25 - 30 Jahre,241,117,124
False,8337038,Görwihl,30 - 35 Jahre,225,124,101
False,8337038,Görwihl,35 - 40 Jahre,212,104,108
False,8337038,Görwihl,40 - 45 Jahre,378,185,193
False,8337038,Görwihl,45 - 50 Jahre,405,226,179
False,8337038,Görwihl,50 - 55 Jahre,347,174,173
False,8337038,Görwihl,55 - 60 Jahre,273,130,143
False,8337038,Görwihl,60 - 65 Jahre,238,120,118
False,8337038,Görwihl,65 - 75 Jahre,415,198,217
False,8337038,Görwihl,75 und mehr Jahre,345,120,225
False,8337038,Görwihl,Insgesamt,4343,2125,2218
False,8337039,Grafenhausen,unter 3 Jahre,53,22,31
False,8337039,Grafenhausen,3 -  6 Jahre,56,30,26
False,8337039,Grafenhausen,6 - 10 Jahre,99,50,49
False,8337039,Grafenhausen,10 - 15 Jahre,161,82,79
False,8337039,Grafenhausen,15 - 18 Jahre,88,42,46
False,8337039,Grafenhausen,18 - 20 Jahre,60,37,23
False,8337039,Grafenhausen,20 - 25 Jahre,105,61,44
False,8337039,Grafenhausen,25 - 30 Jahre,129,68,61
False,8337039,Grafenhausen,30 - 35 Jahre,108,47,61
False,8337039,Grafenhausen,35 - 40 Jahre,131,57,74
False,8337039,Grafenhausen,40 - 45 Jahre,170,93,77
False,8337039,Grafenhausen,45 - 50 Jahre,202,100,102
False,8337039,Grafenhausen,50 - 55 Jahre,156,74,82
False,8337039,Grafenhausen,55 - 60 Jahre,148,77,71
False,8337039,Grafenhausen,60 - 65 Jahre,120,64,56
False,8337039,Grafenhausen,65 - 75 Jahre,240,113,127
False,8337039,Grafenhausen,75 und mehr Jahre,208,82,126
False,8337039,Grafenhausen,Insgesamt,2234,1099,1135
False,8337045,Häusern,unter 3 Jahre,29,14,15
False,8337045,Häusern,3 -  6 Jahre,22,10,12
False,8337045,Häusern,6 - 10 Jahre,40,19,21
False,8337045,Häusern,10 - 15 Jahre,71,38,33
False,8337045,Häusern,15 - 18 Jahre,33,15,18
False,8337045,Häusern,18 - 20 Jahre,28,12,16
False,8337045,Häusern,20 - 25 Jahre,69,38,31
False,8337045,Häusern,25 - 30 Jahre,69,33,36
False,8337045,Häusern,30 - 35 Jahre,46,21,25
False,8337045,Häusern,35 - 40 Jahre,68,34,34
False,8337045,Häusern,40 - 45 Jahre,121,63,58
False,8337045,Häusern,45 - 50 Jahre,92,35,57
False,8337045,Häusern,50 - 55 Jahre,91,47,44
False,8337045,Häusern,55 - 60 Jahre,86,46,40
False,8337045,Häusern,60 - 65 Jahre,75,33,42
False,8337045,Häusern,65 - 75 Jahre,163,74,89
False,8337045,Häusern,75 und mehr Jahre,145,55,90
False,8337045,Häusern,Insgesamt,1248,587,661
False,8337049,Herrischried,unter 3 Jahre,54,23,31
False,8337049,Herrischried,3 -  6 Jahre,55,31,24
False,8337049,Herrischried,6 - 10 Jahre,86,54,32
False,8337049,Herrischried,10 - 15 Jahre,165,78,87
False,8337049,Herrischried,15 - 18 Jahre,103,61,42
False,8337049,Herrischried,18 - 20 Jahre,64,32,32
False,8337049,Herrischried,20 - 25 Jahre,143,81,62
False,8337049,Herrischried,25 - 30 Jahre,112,67,45
False,8337049,Herrischried,30 - 35 Jahre,103,55,48
False,8337049,Herrischried,35 - 40 Jahre,115,53,62
False,8337049,Herrischried,40 - 45 Jahre,205,105,100
False,8337049,Herrischried,45 - 50 Jahre,236,127,109
False,8337049,Herrischried,50 - 55 Jahre,225,117,108
False,8337049,Herrischried,55 - 60 Jahre,163,87,76
False,8337049,Herrischried,60 - 65 Jahre,142,66,76
False,8337049,Herrischried,65 - 75 Jahre,339,169,170
False,8337049,Herrischried,75 und mehr Jahre,433,179,254
False,8337049,Herrischried,Insgesamt,2743,1385,1358
False,8337051,Höchenschwand,unter 3 Jahre,49,25,24
False,8337051,Höchenschwand,3 -  6 Jahre,67,41,26
False,8337051,Höchenschwand,6 - 10 Jahre,89,47,42
False,8337051,Höchenschwand,10 - 15 Jahre,113,45,68
False,8337051,Höchenschwand,15 - 18 Jahre,87,57,30
False,8337051,Höchenschwand,18 - 20 Jahre,68,43,25
False,8337051,Höchenschwand,20 - 25 Jahre,125,69,56
False,8337051,Höchenschwand,25 - 30 Jahre,120,57,63
False,8337051,Höchenschwand,30 - 35 Jahre,99,52,47
False,8337051,Höchenschwand,35 - 40 Jahre,130,56,74
False,8337051,Höchenschwand,40 - 45 Jahre,220,102,118
False,8337051,Höchenschwand,45 - 50 Jahre,231,114,117
False,8337051,Höchenschwand,50 - 55 Jahre,195,99,96
False,8337051,Höchenschwand,55 - 60 Jahre,160,82,78
False,8337051,Höchenschwand,60 - 65 Jahre,140,63,77
False,8337051,Höchenschwand,65 - 75 Jahre,368,165,203
False,8337051,Höchenschwand,75 und mehr Jahre,305,121,184
False,8337051,Höchenschwand,Insgesamt,2566,1238,1328
False,8337053,Hohentengen am Hochrhein,unter 3 Jahre,93,56,37
False,8337053,Hohentengen am Hochrhein,3 -  6 Jahre,90,40,50
False,8337053,Hohentengen am Hochrhein,6 - 10 Jahre,172,98,74
False,8337053,Hohentengen am Hochrhein,10 - 15 Jahre,221,110,111
False,8337053,Hohentengen am Hochrhein,15 - 18 Jahre,124,66,58
False,8337053,Hohentengen am Hochrhein,18 - 20 Jahre,102,53,49
False,8337053,Hohentengen am Hochrhein,20 - 25 Jahre,179,98,81
False,8337053,Hohentengen am Hochrhein,25 - 30 Jahre,183,93,90
False,8337053,Hohentengen am Hochrhein,30 - 35 Jahre,245,121,124
False,8337053,Hohentengen am Hochrhein,35 - 40 Jahre,206,94,112
False,8337053,Hohentengen am Hochrhein,40 - 45 Jahre,326,144,182
False,8337053,Hohentengen am Hochrhein,45 - 50 Jahre,288,171,117
False,8337053,Hohentengen am Hochrhein,50 - 55 Jahre,331,174,157
False,8337053,Hohentengen am Hochrhein,55 - 60 Jahre,236,116,120
False,8337053,Hohentengen am Hochrhein,60 - 65 Jahre,199,96,103
False,8337053,Hohentengen am Hochrhein,65 - 75 Jahre,357,175,182
False,8337053,Hohentengen am Hochrhein,75 und mehr Jahre,292,130,162
False,8337053,Hohentengen am Hochrhein,Insgesamt,3644,1835,1809
False,8337059,Ibach,unter 3 Jahre,5,2,3
False,8337059,Ibach,3 -  6 Jahre,6,1,5
False,8337059,Ibach,6 - 10 Jahre,11,3,8
False,8337059,Ibach,10 - 15 Jahre,19,7,12
False,8337059,Ibach,15 - 18 Jahre,10,6,4
False,8337059,Ibach,18 - 20 Jahre,11,6,5
False,8337059,Ibach,20 - 25 Jahre,17,6,11
False,8337059,Ibach,25 - 30 Jahre,10,4,6
False,8337059,Ibach,30 - 35 Jahre,18,7,11
False,8337059,Ibach,35 - 40 Jahre,17,12,5
False,8337059,Ibach,40 - 45 Jahre,26,10,16
False,8337059,Ibach,45 - 50 Jahre,46,18,28
False,8337059,Ibach,50 - 55 Jahre,34,16,18
False,8337059,Ibach,55 - 60 Jahre,35,18,17
False,8337059,Ibach,60 - 65 Jahre,27,10,17
False,8337059,Ibach,65 - 75 Jahre,53,30,23
False,8337059,Ibach,75 und mehr Jahre,46,24,22
False,8337059,Ibach,Insgesamt,391,180,211
False,8337060,Jestetten,unter 3 Jahre,124,57,67
False,8337060,Jestetten,3 -  6 Jahre,159,89,70
False,8337060,Jestetten,6 - 10 Jahre,179,102,77
False,8337060,Jestetten,10 - 15 Jahre,298,160,138
False,8337060,Jestetten,15 - 18 Jahre,177,91,86
False,8337060,Jestetten,18 - 20 Jahre,132,67,65
False,8337060,Jestetten,20 - 25 Jahre,273,139,134
False,8337060,Jestetten,25 - 30 Jahre,274,140,134
False,8337060,Jestetten,30 - 35 Jahre,246,119,127
False,8337060,Jestetten,35 - 40 Jahre,316,156,160
False,8337060,Jestetten,40 - 45 Jahre,396,185,211
False,8337060,Jestetten,45 - 50 Jahre,477,249,228
False,8337060,Jestetten,50 - 55 Jahre,399,188,211
False,8337060,Jestetten,55 - 60 Jahre,307,148,159
False,8337060,Jestetten,60 - 65 Jahre,274,137,137
False,8337060,Jestetten,65 - 75 Jahre,590,292,298
False,8337060,Jestetten,75 und mehr Jahre,507,194,313
False,8337060,Jestetten,Insgesamt,5128,2513,2615
False,8337062,Klettgau,unter 3 Jahre,219,113,106
False,8337062,Klettgau,3 -  6 Jahre,215,95,120
False,8337062,Klettgau,6 - 10 Jahre,339,178,161
False,8337062,Klettgau,10 - 15 Jahre,495,241,254
False,8337062,Klettgau,15 - 18 Jahre,270,132,138
False,8337062,Klettgau,18 - 20 Jahre,184,98,86
False,8337062,Klettgau,20 - 25 Jahre,415,232,183
False,8337062,Klettgau,25 - 30 Jahre,374,191,183
False,8337062,Klettgau,30 - 35 Jahre,393,182,211
False,8337062,Klettgau,35 - 40 Jahre,436,208,228
False,8337062,Klettgau,40 - 45 Jahre,655,316,339
False,8337062,Klettgau,45 - 50 Jahre,650,332,318
False,8337062,Klettgau,50 - 55 Jahre,552,294,258
False,8337062,Klettgau,55 - 60 Jahre,465,251,214
False,8337062,Klettgau,60 - 65 Jahre,363,197,166
False,8337062,Klettgau,65 - 75 Jahre,735,354,381
False,8337062,Klettgau,75 und mehr Jahre,660,253,407
False,8337062,Klettgau,Insgesamt,7420,3667,3753
False,8337065,Lauchringen,unter 3 Jahre,194,101,93
False,8337065,Lauchringen,3 -  6 Jahre,216,112,104
False,8337065,Lauchringen,6 - 10 Jahre,314,160,154
False,8337065,Lauchringen,10 - 15 Jahre,420,203,217
False,8337065,Lauchringen,15 - 18 Jahre,281,140,141
False,8337065,Lauchringen,18 - 20 Jahre,190,95,95
False,8337065,Lauchringen,20 - 25 Jahre,427,208,219
False,8337065,Lauchringen,25 - 30 Jahre,452,235,217
False,8337065,Lauchringen,30 - 35 Jahre,442,226,216
False,8337065,Lauchringen,35 - 40 Jahre,477,243,234
False,8337065,Lauchringen,40 - 45 Jahre,599,284,315
False,8337065,Lauchringen,45 - 50 Jahre,605,297,308
False,8337065,Lauchringen,50 - 55 Jahre,577,302,275
False,8337065,Lauchringen,55 - 60 Jahre,526,243,283
False,8337065,Lauchringen,60 - 65 Jahre,433,215,218
False,8337065,Lauchringen,65 - 75 Jahre,807,392,415
False,8337065,Lauchringen,75 und mehr Jahre,592,239,353
False,8337065,Lauchringen,Insgesamt,7552,3695,3857
False,8337066,"Laufenburg (Baden), Stadt",unter 3 Jahre,237,129,108
False,8337066,"Laufenburg (Baden), Stadt",3 -  6 Jahre,241,127,114
False,8337066,"Laufenburg (Baden), Stadt",6 - 10 Jahre,357,179,178
False,8337066,"Laufenburg (Baden), Stadt",10 - 15 Jahre,440,225,215
False,8337066,"Laufenburg (Baden), Stadt",15 - 18 Jahre,318,163,155
False,8337066,"Laufenburg (Baden), Stadt",18 - 20 Jahre,223,104,119
False,8337066,"Laufenburg (Baden), Stadt",20 - 25 Jahre,537,266,271
False,8337066,"Laufenburg (Baden), Stadt",25 - 30 Jahre,453,218,235
False,8337066,"Laufenburg (Baden), Stadt",30 - 35 Jahre,449,218,231
False,8337066,"Laufenburg (Baden), Stadt",35 - 40 Jahre,530,248,282
False,8337066,"Laufenburg (Baden), Stadt",40 - 45 Jahre,725,347,378
False,8337066,"Laufenburg (Baden), Stadt",45 - 50 Jahre,793,388,405
False,8337066,"Laufenburg (Baden), Stadt",50 - 55 Jahre,703,342,361
False,8337066,"Laufenburg (Baden), Stadt",55 - 60 Jahre,569,288,281
False,8337066,"Laufenburg (Baden), Stadt",60 - 65 Jahre,442,216,226
False,8337066,"Laufenburg (Baden), Stadt",65 - 75 Jahre,875,436,439
False,8337066,"Laufenburg (Baden), Stadt",75 und mehr Jahre,762,299,463
False,8337066,"Laufenburg (Baden), Stadt",Insgesamt,8654,4193,4461
False,8337070,Lottstetten,unter 3 Jahre,57,27,30
False,8337070,Lottstetten,3 -  6 Jahre,67,25,42
False,8337070,Lottstetten,6 - 10 Jahre,102,51,51
False,8337070,Lottstetten,10 - 15 Jahre,111,65,46
False,8337070,Lottstetten,15 - 18 Jahre,90,39,51
False,8337070,Lottstetten,18 - 20 Jahre,56,35,21
False,8337070,Lottstetten,20 - 25 Jahre,80,49,31
False,8337070,Lottstetten,25 - 30 Jahre,118,62,56
False,8337070,Lottstetten,30 - 35 Jahre,109,67,42
False,8337070,Lottstetten,35 - 40 Jahre,134,51,83
False,8337070,Lottstetten,40 - 45 Jahre,195,117,78
False,8337070,Lottstetten,45 - 50 Jahre,197,99,98
False,8337070,Lottstetten,50 - 55 Jahre,170,95,75
False,8337070,Lottstetten,55 - 60 Jahre,135,75,60
False,8337070,Lottstetten,60 - 65 Jahre,104,50,54
False,8337070,Lottstetten,65 - 75 Jahre,283,137,146
False,8337070,Lottstetten,75 und mehr Jahre,153,55,98
False,8337070,Lottstetten,Insgesamt,2161,1099,1062
False,8337076,Murg,unter 3 Jahre,193,101,92
False,8337076,Murg,3 -  6 Jahre,210,116,94
False,8337076,Murg,6 - 10 Jahre,289,153,136
False,8337076,Murg,10 - 15 Jahre,394,200,194
False,8337076,Murg,15 - 18 Jahre,229,118,111
False,8337076,Murg,18 - 20 Jahre,163,75,88
False,8337076,Murg,20 - 25 Jahre,424,206,218
False,8337076,Murg,25 - 30 Jahre,384,195,189
False,8337076,Murg,30 - 35 Jahre,385,191,194
False,8337076,Murg,35 - 40 Jahre,402,188,214
False,8337076,Murg,40 - 45 Jahre,542,282,260
False,8337076,Murg,45 - 50 Jahre,560,267,293
False,8337076,Murg,50 - 55 Jahre,497,239,258
False,8337076,Murg,55 - 60 Jahre,468,244,224
False,8337076,Murg,60 - 65 Jahre,338,175,163
False,8337076,Murg,65 - 75 Jahre,685,332,353
False,8337076,Murg,75 und mehr Jahre,601,238,363
False,8337076,Murg,Insgesamt,6764,3320,3444
False,8337090,Rickenbach,unter 3 Jahre,86,49,37
False,8337090,Rickenbach,3 -  6 Jahre,121,68,53
False,8337090,Rickenbach,6 - 10 Jahre,151,84,67
False,8337090,Rickenbach,10 - 15 Jahre,242,116,126
False,8337090,Rickenbach,15 - 18 Jahre,138,73,65
False,8337090,Rickenbach,18 - 20 Jahre,95,48,47
False,8337090,Rickenbach,20 - 25 Jahre,225,124,101
False,8337090,Rickenbach,25 - 30 Jahre,222,107,115
False,8337090,Rickenbach,30 - 35 Jahre,213,107,106
False,8337090,Rickenbach,35 - 40 Jahre,246,129,117
False,8337090,Rickenbach,40 - 45 Jahre,291,147,144
False,8337090,Rickenbach,45 - 50 Jahre,357,173,184
False,8337090,Rickenbach,50 - 55 Jahre,288,143,145
False,8337090,Rickenbach,55 - 60 Jahre,240,122,118
False,8337090,Rickenbach,60 - 65 Jahre,208,114,94
False,8337090,Rickenbach,65 - 75 Jahre,411,199,212
False,8337090,Rickenbach,75 und mehr Jahre,334,139,195
False,8337090,Rickenbach,Insgesamt,3868,1942,1926
False,8337096,"Bad Säckingen, Stadt",unter 3 Jahre,441,212,229
False,8337096,"Bad Säckingen, Stadt",3 -  6 Jahre,403,194,209
False,8337096,"Bad Säckingen, Stadt",6 - 10 Jahre,589,285,304
False,8337096,"Bad Säckingen, Stadt",10 - 15 Jahre,893,498,395
False,8337096,"Bad Säckingen, Stadt",15 - 18 Jahre,534,288,246
False,8337096,"Bad Säckingen, Stadt",18 - 20 Jahre,394,213,181
False,8337096,"Bad Säckingen, Stadt",20 - 25 Jahre,911,444,467
False,8337096,"Bad Säckingen, Stadt",25 - 30 Jahre,997,488,509
False,8337096,"Bad Säckingen, Stadt",30 - 35 Jahre,882,411,471
False,8337096,"Bad Säckingen, Stadt",35 - 40 Jahre,970,483,487
False,8337096,"Bad Säckingen, Stadt",40 - 45 Jahre,1343,677,666
False,8337096,"Bad Säckingen, Stadt",45 - 50 Jahre,1253,616,637
False,8337096,"Bad Säckingen, Stadt",50 - 55 Jahre,1215,603,612
False,8337096,"Bad Säckingen, Stadt",55 - 60 Jahre,1119,555,564
False,8337096,"Bad Säckingen, Stadt",60 - 65 Jahre,977,459,518
False,8337096,"Bad Säckingen, Stadt",65 - 75 Jahre,1969,893,1076
False,8337096,"Bad Säckingen, Stadt",75 und mehr Jahre,1875,687,1188
False,8337096,"Bad Säckingen, Stadt",Insgesamt,16765,8006,8759
False,8337097,"St. Blasien, Stadt",unter 3 Jahre,68,41,27
False,8337097,"St. Blasien, Stadt",3 -  6 Jahre,80,38,42
False,8337097,"St. Blasien, Stadt",6 - 10 Jahre,125,53,72
False,8337097,"St. Blasien, Stadt",10 - 15 Jahre,214,114,100
False,8337097,"St. Blasien, Stadt",15 - 18 Jahre,150,80,70
False,8337097,"St. Blasien, Stadt",18 - 20 Jahre,78,38,40
False,8337097,"St. Blasien, Stadt",20 - 25 Jahre,194,108,86
False,8337097,"St. Blasien, Stadt",25 - 30 Jahre,203,106,97
False,8337097,"St. Blasien, Stadt",30 - 35 Jahre,228,116,112
False,8337097,"St. Blasien, Stadt",35 - 40 Jahre,259,162,97
False,8337097,"St. Blasien, Stadt",40 - 45 Jahre,374,264,110
False,8337097,"St. Blasien, Stadt",45 - 50 Jahre,257,106,151
False,8337097,"St. Blasien, Stadt",50 - 55 Jahre,300,140,160
False,8337097,"St. Blasien, Stadt",55 - 60 Jahre,248,118,130
False,8337097,"St. Blasien, Stadt",60 - 65 Jahre,237,113,124
False,8337097,"St. Blasien, Stadt",65 - 75 Jahre,450,202,248
False,8337097,"St. Blasien, Stadt",75 und mehr Jahre,458,180,278
False,8337097,"St. Blasien, Stadt",Insgesamt,3923,1979,1944
False,8337106,"Stühlingen, Stadt",unter 3 Jahre,152,78,74
False,8337106,"Stühlingen, Stadt",3 -  6 Jahre,136,72,64
False,8337106,"Stühlingen, Stadt",6 - 10 Jahre,217,120,97
False,8337106,"Stühlingen, Stadt",10 - 15 Jahre,323,159,164
False,8337106,"Stühlingen, Stadt",15 - 18 Jahre,200,96,104
False,8337106,"Stühlingen, Stadt",18 - 20 Jahre,111,61,50
False,8337106,"Stühlingen, Stadt",20 - 25 Jahre,333,181,152
False,8337106,"Stühlingen, Stadt",25 - 30 Jahre,261,129,132
False,8337106,"Stühlingen, Stadt",30 - 35 Jahre,281,134,147
False,8337106,"Stühlingen, Stadt",35 - 40 Jahre,292,156,136
False,8337106,"Stühlingen, Stadt",40 - 45 Jahre,425,210,215
False,8337106,"Stühlingen, Stadt",45 - 50 Jahre,465,233,232
False,8337106,"Stühlingen, Stadt",50 - 55 Jahre,415,213,202
False,8337106,"Stühlingen, Stadt",55 - 60 Jahre,327,185,142
False,8337106,"Stühlingen, Stadt",60 - 65 Jahre,276,137,139
False,8337106,"Stühlingen, Stadt",65 - 75 Jahre,501,250,251
False,8337106,"Stühlingen, Stadt",75 und mehr Jahre,465,181,284
False,8337106,"Stühlingen, Stadt",Insgesamt,5180,2595,2585
False,8337108,Todtmoos,unter 3 Jahre,53,27,26
False,8337108,Todtmoos,3 -  6 Jahre,47,17,30
False,8337108,Todtmoos,6 - 10 Jahre,56,27,29
False,8337108,Todtmoos,10 - 15 Jahre,86,48,38
False,8337108,Todtmoos,15 - 18 Jahre,48,25,23
False,8337108,Todtmoos,18 - 20 Jahre,53,30,23
False,8337108,Todtmoos,20 - 25 Jahre,137,72,65
False,8337108,Todtmoos,25 - 30 Jahre,94,46,48
False,8337108,Todtmoos,30 - 35 Jahre,88,41,47
False,8337108,Todtmoos,35 - 40 Jahre,106,50,56
False,8337108,Todtmoos,40 - 45 Jahre,136,65,71
False,8337108,Todtmoos,45 - 50 Jahre,216,101,115
False,8337108,Todtmoos,50 - 55 Jahre,164,90,74
False,8337108,Todtmoos,55 - 60 Jahre,163,67,96
False,8337108,Todtmoos,60 - 65 Jahre,150,88,62
False,8337108,Todtmoos,65 - 75 Jahre,233,116,117
False,8337108,Todtmoos,75 und mehr Jahre,184,68,116
False,8337108,Todtmoos,Insgesamt,2014,978,1036
False,8337116,"Wehr, Stadt",unter 3 Jahre,308,150,158
False,8337116,"Wehr, Stadt",3 -  6 Jahre,314,158,156
False,8337116,"Wehr, Stadt",6 - 10 Jahre,445,220,225
False,8337116,"Wehr, Stadt",10 - 15 Jahre,675,339,336
False,8337116,"Wehr, Stadt",15 - 18 Jahre,473,245,228
False,8337116,"Wehr, Stadt",18 - 20 Jahre,301,145,156
False,8337116,"Wehr, Stadt",20 - 25 Jahre,781,380,401
False,8337116,"Wehr, Stadt",25 - 30 Jahre,637,307,330
False,8337116,"Wehr, Stadt",30 - 35 Jahre,667,324,343
False,8337116,"Wehr, Stadt",35 - 40 Jahre,782,365,417
False,8337116,"Wehr, Stadt",40 - 45 Jahre,998,484,514
False,8337116,"Wehr, Stadt",45 - 50 Jahre,1161,589,572
False,8337116,"Wehr, Stadt",50 - 55 Jahre,965,466,499
False,8337116,"Wehr, Stadt",55 - 60 Jahre,845,415,430
False,8337116,"Wehr, Stadt",60 - 65 Jahre,695,343,352
False,8337116,"Wehr, Stadt",65 - 75 Jahre,1497,695,802
False,8337116,"Wehr, Stadt",75 und mehr Jahre,1227,506,721
False,8337116,"Wehr, Stadt",Insgesamt,12771,6131,6640
False,8337118,Weilheim,unter 3 Jahre,64,31,33
False,8337118,Weilheim,3 -  6 Jahre,76,35,41
False,8337118,Weilheim,6 - 10 Jahre,144,83,61
False,8337118,Weilheim,10 - 15 Jahre,185,88,97
False,8337118,Weilheim,15 - 18 Jahre,158,83,75
False,8337118,Weilheim,18 - 20 Jahre,84,37,47
False,8337118,Weilheim,20 - 25 Jahre,170,91,79
False,8337118,Weilheim,25 - 30 Jahre,160,85,75
False,8337118,Weilheim,30 - 35 Jahre,114,57,57
False,8337118,Weilheim,35 - 40 Jahre,150,57,93
False,8337118,Weilheim,40 - 45 Jahre,251,123,128
False,8337118,Weilheim,45 - 50 Jahre,366,178,188
False,8337118,Weilheim,50 - 55 Jahre,270,148,122
False,8337118,Weilheim,55 - 60 Jahre,200,113,87
False,8337118,Weilheim,60 - 65 Jahre,143,80,63
False,8337118,Weilheim,65 - 75 Jahre,292,136,156
False,8337118,Weilheim,75 und mehr Jahre,240,112,128
False,8337118,Weilheim,Insgesamt,3067,1537,1530
False,8337123,Wutöschingen,unter 3 Jahre,179,88,91
False,8337123,Wutöschingen,3 -  6 Jahre,186,86,100
False,8337123,Wutöschingen,6 - 10 Jahre,289,156,133
False,8337123,Wutöschingen,10 - 15 Jahre,416,211,205
False,8337123,Wutöschingen,15 - 18 Jahre,251,134,117
False,8337123,Wutöschingen,18 - 20 Jahre,187,106,81
False,8337123,Wutöschingen,20 - 25 Jahre,375,199,176
False,8337123,Wutöschingen,25 - 30 Jahre,353,184,169
False,8337123,Wutöschingen,30 - 35 Jahre,393,203,190
False,8337123,Wutöschingen,35 - 40 Jahre,433,212,221
False,8337123,Wutöschingen,40 - 45 Jahre,546,279,267
False,8337123,Wutöschingen,45 - 50 Jahre,587,314,273
False,8337123,Wutöschingen,50 - 55 Jahre,448,224,224
False,8337123,Wutöschingen,55 - 60 Jahre,421,204,217
False,8337123,Wutöschingen,60 - 65 Jahre,348,173,175
False,8337123,Wutöschingen,65 - 75 Jahre,677,348,329
False,8337123,Wutöschingen,75 und mehr Jahre,511,197,314
False,8337123,Wutöschingen,Insgesamt,6600,3318,3282
False,8337124,Eggingen,unter 3 Jahre,47,22,25
False,8337124,Eggingen,3 -  6 Jahre,53,29,24
False,8337124,Eggingen,6 - 10 Jahre,80,42,38
False,8337124,Eggingen,10 - 15 Jahre,97,52,45
False,8337124,Eggingen,15 - 18 Jahre,65,33,32
False,8337124,Eggingen,18 - 20 Jahre,49,24,25
False,8337124,Eggingen,20 - 25 Jahre,108,55,53
False,8337124,Eggingen,25 - 30 Jahre,107,46,61
False,8337124,Eggingen,30 - 35 Jahre,110,60,50
False,8337124,Eggingen,35 - 40 Jahre,88,38,50
False,8337124,Eggingen,40 - 45 Jahre,134,68,66
False,8337124,Eggingen,45 - 50 Jahre,131,69,62
False,8337124,Eggingen,50 - 55 Jahre,139,68,71
False,8337124,Eggingen,55 - 60 Jahre,104,59,45
False,8337124,Eggingen,60 - 65 Jahre,90,40,50
False,8337124,Eggingen,65 - 75 Jahre,142,74,68
False,8337124,Eggingen,75 und mehr Jahre,116,43,73
False,8337124,Eggingen,Insgesamt,1660,822,838
False,8337125,Küssaberg,unter 3 Jahre,146,69,77
False,8337125,Küssaberg,3 -  6 Jahre,143,79,64
False,8337125,Küssaberg,6 - 10 Jahre,206,103,103
False,8337125,Küssaberg,10 - 15 Jahre,320,160,160
False,8337125,Küssaberg,15 - 18 Jahre,172,91,81
False,8337125,Küssaberg,18 - 20 Jahre,119,56,63
False,8337125,Küssaberg,20 - 25 Jahre,276,150,126
False,8337125,Küssaberg,25 - 30 Jahre,281,126,155
False,8337125,Küssaberg,30 - 35 Jahre,296,143,153
False,8337125,Küssaberg,35 - 40 Jahre,328,162,166
False,8337125,Küssaberg,40 - 45 Jahre,508,249,259
False,8337125,Küssaberg,45 - 50 Jahre,507,275,232
False,8337125,Küssaberg,50 - 55 Jahre,439,230,209
False,8337125,Küssaberg,55 - 60 Jahre,349,165,184
False,8337125,Küssaberg,60 - 65 Jahre,310,138,172
False,8337125,Küssaberg,65 - 75 Jahre,593,297,296
False,8337125,Küssaberg,75 und mehr Jahre,475,191,284
False,8337125,Küssaberg,Insgesamt,5468,2684,2784
False,8337126,"Waldshut-Tiengen, Stadt",unter 3 Jahre,598,296,302
False,8337126,"Waldshut-Tiengen, Stadt",3 -  6 Jahre,668,341,327
False,8337126,"Waldshut-Tiengen, Stadt",6 - 10 Jahre,896,474,422
False,8337126,"Waldshut-Tiengen, Stadt",10 - 15 Jahre,1157,581,576
False,8337126,"Waldshut-Tiengen, Stadt",15 - 18 Jahre,745,389,356
False,8337126,"Waldshut-Tiengen, Stadt",18 - 20 Jahre,540,290,250
False,8337126,"Waldshut-Tiengen, Stadt",20 - 25 Jahre,1387,713,674
False,8337126,"Waldshut-Tiengen, Stadt",25 - 30 Jahre,1473,713,760
False,8337126,"Waldshut-Tiengen, Stadt",30 - 35 Jahre,1281,620,661
False,8337126,"Waldshut-Tiengen, Stadt",35 - 40 Jahre,1386,686,700
False,8337126,"Waldshut-Tiengen, Stadt",40 - 45 Jahre,1639,789,850
False,8337126,"Waldshut-Tiengen, Stadt",45 - 50 Jahre,1841,949,892
False,8337126,"Waldshut-Tiengen, Stadt",50 - 55 Jahre,1664,842,822
False,8337126,"Waldshut-Tiengen, Stadt",55 - 60 Jahre,1598,762,836
False,8337126,"Waldshut-Tiengen, Stadt",60 - 65 Jahre,1318,678,640
False,8337126,"Waldshut-Tiengen, Stadt",65 - 75 Jahre,2354,1107,1247
False,8337126,"Waldshut-Tiengen, Stadt",75 und mehr Jahre,2314,849,1465
False,8337126,"Waldshut-Tiengen, Stadt",Insgesamt,22859,11079,11780
False,8337127,Wutach,unter 3 Jahre,37,20,17
False,8337127,Wutach,3 -  6 Jahre,41,21,20
False,8337127,Wutach,6 - 10 Jahre,61,31,30
False,8337127,Wutach,10 - 15 Jahre,89,36,53
False,8337127,Wutach,15 - 18 Jahre,49,23,26
False,8337127,Wutach,18 - 20 Jahre,29,13,16
False,8337127,Wutach,20 - 25 Jahre,64,28,36
False,8337127,Wutach,25 - 30 Jahre,64,35,29
False,8337127,Wutach,30 - 35 Jahre,55,31,24
False,8337127,Wutach,35 - 40 Jahre,78,39,39
False,8337127,Wutach,40 - 45 Jahre,87,49,38
False,8337127,Wutach,45 - 50 Jahre,115,61,54
False,8337127,Wutach,50 - 55 Jahre,82,48,34
False,8337127,Wutach,55 - 60 Jahre,68,34,34
False,8337127,Wutach,60 - 65 Jahre,55,31,24
False,8337127,Wutach,65 - 75 Jahre,122,58,64
False,8337127,Wutach,75 und mehr Jahre,122,53,69
False,8337127,Wutach,Insgesamt,1218,611,607
False,8337128,Ühlingen-Birkendorf,unter 3 Jahre,131,68,63
False,8337128,Ühlingen-Birkendorf,3 -  6 Jahre,127,61,66
False,8337128,Ühlingen-Birkendorf,6 - 10 Jahre,223,124,99
False,8337128,Ühlingen-Birkendorf,10 - 15 Jahre,317,174,143
False,8337128,Ühlingen-Birkendorf,15 - 18 Jahre,201,106,95
False,8337128,Ühlingen-Birkendorf,18 - 20 Jahre,147,77,70
False,8337128,Ühlingen-Birkendorf,20 - 25 Jahre,303,171,132
False,8337128,Ühlingen-Birkendorf,25 - 30 Jahre,274,137,137
False,8337128,Ühlingen-Birkendorf,30 - 35 Jahre,211,111,100
False,8337128,Ühlingen-Birkendorf,35 - 40 Jahre,282,140,142
False,8337128,Ühlingen-Birkendorf,40 - 45 Jahre,390,185,205
False,8337128,Ühlingen-Birkendorf,45 - 50 Jahre,442,225,217
False,8337128,Ühlingen-Birkendorf,50 - 55 Jahre,386,216,170
False,8337128,Ühlingen-Birkendorf,55 - 60 Jahre,324,161,163
False,8337128,Ühlingen-Birkendorf,60 - 65 Jahre,292,154,138
False,8337128,Ühlingen-Birkendorf,65 - 75 Jahre,599,295,304
False,8337128,Ühlingen-Birkendorf,75 und mehr Jahre,489,215,274
False,8337128,Ühlingen-Birkendorf,Insgesamt,5138,2620,2518
False,84,Regierungsbezirk Tübingen,unter 3 Jahre,46680,23914,22766
False,84,Regierungsbezirk Tübingen,3 -  6 Jahre,48617,24810,23807
False,84,Regierungsbezirk Tübingen,6 - 10 Jahre,69931,36124,33807
False,84,Regierungsbezirk Tübingen,10 - 15 Jahre,101100,51778,49322
False,84,Regierungsbezirk Tübingen,15 - 18 Jahre,62829,32258,30571
False,84,Regierungsbezirk Tübingen,18 - 20 Jahre,45139,23058,22081
False,84,Regierungsbezirk Tübingen,20 - 25 Jahre,115661,58760,56901
False,84,Regierungsbezirk Tübingen,25 - 30 Jahre,109167,55275,53892
False,84,Regierungsbezirk Tübingen,30 - 35 Jahre,104435,52458,51977
False,84,Regierungsbezirk Tübingen,35 - 40 Jahre,112382,56314,56068
False,84,Regierungsbezirk Tübingen,40 - 45 Jahre,148535,75645,72890
False,84,Regierungsbezirk Tübingen,45 - 50 Jahre,157613,80755,76858
False,84,Regierungsbezirk Tübingen,50 - 55 Jahre,136929,69256,67673
False,84,Regierungsbezirk Tübingen,55 - 60 Jahre,113918,56667,57251
False,84,Regierungsbezirk Tübingen,60 - 65 Jahre,96539,48387,48152
False,84,Regierungsbezirk Tübingen,65 - 75 Jahre,185351,88802,96549
False,84,Regierungsbezirk Tübingen,75 und mehr Jahre,153132,58724,94408
False,84,Regierungsbezirk Tübingen,Insgesamt,1807958,892985,914973
False,8415,Landkreis Reutlingen,unter 3 Jahre,7157,3688,3469
False,8415,Landkreis Reutlingen,3 -  6 Jahre,7499,3825,3674
False,8415,Landkreis Reutlingen,6 - 10 Jahre,10773,5624,5149
False,8415,Landkreis Reutlingen,10 - 15 Jahre,15444,7912,7532
False,8415,Landkreis Reutlingen,15 - 18 Jahre,9533,4939,4594
False,8415,Landkreis Reutlingen,18 - 20 Jahre,6857,3438,3419
False,8415,Landkreis Reutlingen,20 - 25 Jahre,16981,8548,8433
False,8415,Landkreis Reutlingen,25 - 30 Jahre,15940,8035,7905
False,8415,Landkreis Reutlingen,30 - 35 Jahre,15752,7740,8012
False,8415,Landkreis Reutlingen,35 - 40 Jahre,17669,8828,8841
False,8415,Landkreis Reutlingen,40 - 45 Jahre,23308,11816,11492
False,8415,Landkreis Reutlingen,45 - 50 Jahre,24624,12508,12116
False,8415,Landkreis Reutlingen,50 - 55 Jahre,21397,10847,10550
False,8415,Landkreis Reutlingen,55 - 60 Jahre,17794,8785,9009
False,8415,Landkreis Reutlingen,60 - 65 Jahre,14930,7357,7573
False,8415,Landkreis Reutlingen,65 - 75 Jahre,30007,14108,15899
False,8415,Landkreis Reutlingen,75 und mehr Jahre,25266,9745,15521
False,8415,Landkreis Reutlingen,Insgesamt,280931,137743,143188
False,8415014,Dettingen an der Erms,unter 3 Jahre,258,147,111
False,8415014,Dettingen an der Erms,3 -  6 Jahre,268,154,114
False,8415014,Dettingen an der Erms,6 - 10 Jahre,383,185,198
False,8415014,Dettingen an der Erms,10 - 15 Jahre,515,278,237
False,8415014,Dettingen an der Erms,15 - 18 Jahre,316,157,159
False,8415014,Dettingen an der Erms,18 - 20 Jahre,205,98,107
False,8415014,Dettingen an der Erms,20 - 25 Jahre,518,283,235
False,8415014,Dettingen an der Erms,25 - 30 Jahre,488,253,235
False,8415014,Dettingen an der Erms,30 - 35 Jahre,533,264,269
False,8415014,Dettingen an der Erms,35 - 40 Jahre,572,287,285
False,8415014,Dettingen an der Erms,40 - 45 Jahre,800,386,414
False,8415014,Dettingen an der Erms,45 - 50 Jahre,845,441,404
False,8415014,Dettingen an der Erms,50 - 55 Jahre,698,366,332
False,8415014,Dettingen an der Erms,55 - 60 Jahre,549,294,255
False,8415014,Dettingen an der Erms,60 - 65 Jahre,473,238,235
False,8415014,Dettingen an der Erms,65 - 75 Jahre,1017,491,526
False,8415014,Dettingen an der Erms,75 und mehr Jahre,891,336,555
False,8415014,Dettingen an der Erms,Insgesamt,9329,4658,4671
False,8415019,Eningen unter Achalm,unter 3 Jahre,265,133,132
False,8415019,Eningen unter Achalm,3 -  6 Jahre,282,127,155
False,8415019,Eningen unter Achalm,6 - 10 Jahre,433,202,231
False,8415019,Eningen unter Achalm,10 - 15 Jahre,614,311,303
False,8415019,Eningen unter Achalm,15 - 18 Jahre,394,194,200
False,8415019,Eningen unter Achalm,18 - 20 Jahre,225,123,102
False,8415019,Eningen unter Achalm,20 - 25 Jahre,543,252,291
False,8415019,Eningen unter Achalm,25 - 30 Jahre,644,341,303
False,8415019,Eningen unter Achalm,30 - 35 Jahre,554,265,289
False,8415019,Eningen unter Achalm,35 - 40 Jahre,698,345,353
False,8415019,Eningen unter Achalm,40 - 45 Jahre,969,480,489
False,8415019,Eningen unter Achalm,45 - 50 Jahre,1002,525,477
False,8415019,Eningen unter Achalm,50 - 55 Jahre,838,441,397
False,8415019,Eningen unter Achalm,55 - 60 Jahre,703,346,357
False,8415019,Eningen unter Achalm,60 - 65 Jahre,628,295,333
False,8415019,Eningen unter Achalm,65 - 75 Jahre,1245,594,651
False,8415019,Eningen unter Achalm,75 und mehr Jahre,1032,408,624
False,8415019,Eningen unter Achalm,Insgesamt,11069,5382,5687
False,8415027,Gomadingen,unter 3 Jahre,55,27,28
False,8415027,Gomadingen,3 -  6 Jahre,54,21,33
False,8415027,Gomadingen,6 - 10 Jahre,81,46,35
False,8415027,Gomadingen,10 - 15 Jahre,126,68,58
False,8415027,Gomadingen,15 - 18 Jahre,96,50,46
False,8415027,Gomadingen,18 - 20 Jahre,59,24,35
False,8415027,Gomadingen,20 - 25 Jahre,119,56,63
False,8415027,Gomadingen,25 - 30 Jahre,109,64,45
False,8415027,Gomadingen,30 - 35 Jahre,102,35,67
False,8415027,Gomadingen,35 - 40 Jahre,130,71,59
False,8415027,Gomadingen,40 - 45 Jahre,192,94,98
False,8415027,Gomadingen,45 - 50 Jahre,207,104,103
False,8415027,Gomadingen,50 - 55 Jahre,191,109,82
False,8415027,Gomadingen,55 - 60 Jahre,156,86,70
False,8415027,Gomadingen,60 - 65 Jahre,111,62,49
False,8415027,Gomadingen,65 - 75 Jahre,223,114,109
False,8415027,Gomadingen,75 und mehr Jahre,182,75,107
False,8415027,Gomadingen,Insgesamt,2193,1106,1087
False,8415028,Grabenstetten,unter 3 Jahre,38,22,16
False,8415028,Grabenstetten,3 -  6 Jahre,47,28,19
False,8415028,Grabenstetten,6 - 10 Jahre,74,43,31
False,8415028,Grabenstetten,10 - 15 Jahre,96,49,47
False,8415028,Grabenstetten,15 - 18 Jahre,50,23,27
False,8415028,Grabenstetten,18 - 20 Jahre,38,17,21
False,8415028,Grabenstetten,20 - 25 Jahre,105,66,39
False,8415028,Grabenstetten,25 - 30 Jahre,73,42,31
False,8415028,Grabenstetten,30 - 35 Jahre,70,39,31
False,8415028,Grabenstetten,35 - 40 Jahre,99,56,43
False,8415028,Grabenstetten,40 - 45 Jahre,133,70,63
False,8415028,Grabenstetten,45 - 50 Jahre,132,60,72
False,8415028,Grabenstetten,50 - 55 Jahre,129,62,67
False,8415028,Grabenstetten,55 - 60 Jahre,117,55,62
False,8415028,Grabenstetten,60 - 65 Jahre,87,52,35
False,8415028,Grabenstetten,65 - 75 Jahre,118,51,67
False,8415028,Grabenstetten,75 und mehr Jahre,128,55,73
False,8415028,Grabenstetten,Insgesamt,1534,790,744
False,8415029,Grafenberg,unter 3 Jahre,63,37,26
False,8415029,Grafenberg,3 -  6 Jahre,66,35,31
False,8415029,Grafenberg,6 - 10 Jahre,104,51,53
False,8415029,Grafenberg,10 - 15 Jahre,189,107,82
False,8415029,Grafenberg,15 - 18 Jahre,83,45,38
False,8415029,Grafenberg,18 - 20 Jahre,64,30,34
False,8415029,Grafenberg,20 - 25 Jahre,156,90,66
False,8415029,Grafenberg,25 - 30 Jahre,129,68,61
False,8415029,Grafenberg,30 - 35 Jahre,143,65,78
False,8415029,Grafenberg,35 - 40 Jahre,152,85,67
False,8415029,Grafenberg,40 - 45 Jahre,263,131,132
False,8415029,Grafenberg,45 - 50 Jahre,217,121,96
False,8415029,Grafenberg,50 - 55 Jahre,209,106,103
False,8415029,Grafenberg,55 - 60 Jahre,180,88,92
False,8415029,Grafenberg,60 - 65 Jahre,152,76,76
False,8415029,Grafenberg,65 - 75 Jahre,267,132,135
False,8415029,Grafenberg,75 und mehr Jahre,177,79,98
False,8415029,Grafenberg,Insgesamt,2614,1346,1268
False,8415034,"Hayingen, Stadt",unter 3 Jahre,59,38,21
False,8415034,"Hayingen, Stadt",3 -  6 Jahre,61,31,30
False,8415034,"Hayingen, Stadt",6 - 10 Jahre,79,45,34
False,8415034,"Hayingen, Stadt",10 - 15 Jahre,128,68,60
False,8415034,"Hayingen, Stadt",15 - 18 Jahre,74,45,29
False,8415034,"Hayingen, Stadt",18 - 20 Jahre,46,26,20
False,8415034,"Hayingen, Stadt",20 - 25 Jahre,124,69,55
False,8415034,"Hayingen, Stadt",25 - 30 Jahre,100,44,56
False,8415034,"Hayingen, Stadt",30 - 35 Jahre,130,62,68
False,8415034,"Hayingen, Stadt",35 - 40 Jahre,146,81,65
False,8415034,"Hayingen, Stadt",40 - 45 Jahre,170,92,78
False,8415034,"Hayingen, Stadt",45 - 50 Jahre,187,98,89
False,8415034,"Hayingen, Stadt",50 - 55 Jahre,143,78,65
False,8415034,"Hayingen, Stadt",55 - 60 Jahre,119,54,65
False,8415034,"Hayingen, Stadt",60 - 65 Jahre,121,64,57
False,8415034,"Hayingen, Stadt",65 - 75 Jahre,248,128,120
False,8415034,"Hayingen, Stadt",75 und mehr Jahre,192,92,100
False,8415034,"Hayingen, Stadt",Insgesamt,2127,1115,1012
False,8415039,Hülben,unter 3 Jahre,85,40,45
False,8415039,Hülben,3 -  6 Jahre,66,39,27
False,8415039,Hülben,6 - 10 Jahre,116,63,53
False,8415039,Hülben,10 - 15 Jahre,175,88,87
False,8415039,Hülben,15 - 18 Jahre,105,55,50
False,8415039,Hülben,18 - 20 Jahre,78,38,40
False,8415039,Hülben,20 - 25 Jahre,158,72,86
False,8415039,Hülben,25 - 30 Jahre,135,66,69
False,8415039,Hülben,30 - 35 Jahre,124,69,55
False,8415039,Hülben,35 - 40 Jahre,170,81,89
False,8415039,Hülben,40 - 45 Jahre,229,119,110
False,8415039,Hülben,45 - 50 Jahre,271,141,130
False,8415039,Hülben,50 - 55 Jahre,205,95,110
False,8415039,Hülben,55 - 60 Jahre,152,79,73
False,8415039,Hülben,60 - 65 Jahre,158,79,79
False,8415039,Hülben,65 - 75 Jahre,285,134,151
False,8415039,Hülben,75 und mehr Jahre,314,106,208
False,8415039,Hülben,Insgesamt,2826,1364,1462
False,8415048,Mehrstetten,unter 3 Jahre,37,17,20
False,8415048,Mehrstetten,3 -  6 Jahre,27,15,12
False,8415048,Mehrstetten,6 - 10 Jahre,48,27,21
False,8415048,Mehrstetten,10 - 15 Jahre,83,46,37
False,8415048,Mehrstetten,15 - 18 Jahre,42,27,15
False,8415048,Mehrstetten,18 - 20 Jahre,37,21,16
False,8415048,Mehrstetten,20 - 25 Jahre,95,52,43
False,8415048,Mehrstetten,25 - 30 Jahre,81,42,39
False,8415048,Mehrstetten,30 - 35 Jahre,79,45,34
False,8415048,Mehrstetten,35 - 40 Jahre,70,42,28
False,8415048,Mehrstetten,40 - 45 Jahre,106,47,59
False,8415048,Mehrstetten,45 - 50 Jahre,146,79,67
False,8415048,Mehrstetten,50 - 55 Jahre,98,52,46
False,8415048,Mehrstetten,55 - 60 Jahre,101,47,54
False,8415048,Mehrstetten,60 - 65 Jahre,74,41,33
False,8415048,Mehrstetten,65 - 75 Jahre,115,51,64
False,8415048,Mehrstetten,75 und mehr Jahre,109,44,65
False,8415048,Mehrstetten,Insgesamt,1348,695,653
False,8415050,"Metzingen, Stadt",unter 3 Jahre,559,276,283
False,8415050,"Metzingen, Stadt",3 -  6 Jahre,599,282,317
False,8415050,"Metzingen, Stadt",6 - 10 Jahre,868,453,415
False,8415050,"Metzingen, Stadt",10 - 15 Jahre,1138,564,574
False,8415050,"Metzingen, Stadt",15 - 18 Jahre,737,362,375
False,8415050,"Metzingen, Stadt",18 - 20 Jahre,517,250,267
False,8415050,"Metzingen, Stadt",20 - 25 Jahre,1281,633,648
False,8415050,"Metzingen, Stadt",25 - 30 Jahre,1290,615,675
False,8415050,"Metzingen, Stadt",30 - 35 Jahre,1309,643,666
False,8415050,"Metzingen, Stadt",35 - 40 Jahre,1431,703,728
False,8415050,"Metzingen, Stadt",40 - 45 Jahre,1701,836,865
False,8415050,"Metzingen, Stadt",45 - 50 Jahre,1803,944,859
False,8415050,"Metzingen, Stadt",50 - 55 Jahre,1601,771,830
False,8415050,"Metzingen, Stadt",55 - 60 Jahre,1347,636,711
False,8415050,"Metzingen, Stadt",60 - 65 Jahre,1153,565,588
False,8415050,"Metzingen, Stadt",65 - 75 Jahre,2450,1128,1322
False,8415050,"Metzingen, Stadt",75 und mehr Jahre,2251,873,1378
False,8415050,"Metzingen, Stadt",Insgesamt,22035,10534,11501
False,8415053,"Münsingen, Stadt",unter 3 Jahre,370,177,193
False,8415053,"Münsingen, Stadt",3 -  6 Jahre,423,225,198
False,8415053,"Münsingen, Stadt",6 - 10 Jahre,648,358,290
False,8415053,"Münsingen, Stadt",10 - 15 Jahre,850,406,444
False,8415053,"Münsingen, Stadt",15 - 18 Jahre,548,271,277
False,8415053,"Münsingen, Stadt",18 - 20 Jahre,386,187,199
False,8415053,"Münsingen, Stadt",20 - 25 Jahre,875,456,419
False,8415053,"Münsingen, Stadt",25 - 30 Jahre,806,446,360
False,8415053,"Münsingen, Stadt",30 - 35 Jahre,733,386,347
False,8415053,"Münsingen, Stadt",35 - 40 Jahre,874,420,454
False,8415053,"Münsingen, Stadt",40 - 45 Jahre,1171,621,550
False,8415053,"Münsingen, Stadt",45 - 50 Jahre,1303,658,645
False,8415053,"Münsingen, Stadt",50 - 55 Jahre,1097,552,545
False,8415053,"Münsingen, Stadt",55 - 60 Jahre,916,458,458
False,8415053,"Münsingen, Stadt",60 - 65 Jahre,734,357,377
False,8415053,"Münsingen, Stadt",65 - 75 Jahre,1501,704,797
False,8415053,"Münsingen, Stadt",75 und mehr Jahre,1256,430,826
False,8415053,"Münsingen, Stadt",Insgesamt,14491,7112,7379
False,8415058,Pfronstetten,unter 3 Jahre,42,19,23
False,8415058,Pfronstetten,3 -  6 Jahre,55,26,29
False,8415058,Pfronstetten,6 - 10 Jahre,65,37,28
False,8415058,Pfronstetten,10 - 15 Jahre,95,55,40
False,8415058,Pfronstetten,15 - 18 Jahre,59,35,24
False,8415058,Pfronstetten,18 - 20 Jahre,51,31,20
False,8415058,Pfronstetten,20 - 25 Jahre,94,57,37
False,8415058,Pfronstetten,25 - 30 Jahre,78,45,33
False,8415058,Pfronstetten,30 - 35 Jahre,68,26,42
False,8415058,Pfronstetten,35 - 40 Jahre,103,53,50
False,8415058,Pfronstetten,40 - 45 Jahre,133,63,70
False,8415058,Pfronstetten,45 - 50 Jahre,135,76,59
False,8415058,Pfronstetten,50 - 55 Jahre,105,59,46
False,8415058,Pfronstetten,55 - 60 Jahre,106,59,47
False,8415058,Pfronstetten,60 - 65 Jahre,65,36,29
False,8415058,Pfronstetten,65 - 75 Jahre,138,69,69
False,8415058,Pfronstetten,75 und mehr Jahre,148,66,82
False,8415058,Pfronstetten,Insgesamt,1540,812,728
False,8415059,"Pfullingen, Stadt",unter 3 Jahre,486,229,257
False,8415059,"Pfullingen, Stadt",3 -  6 Jahre,536,269,267
False,8415059,"Pfullingen, Stadt",6 - 10 Jahre,739,393,346
False,8415059,"Pfullingen, Stadt",10 - 15 Jahre,1074,533,541
False,8415059,"Pfullingen, Stadt",15 - 18 Jahre,609,307,302
False,8415059,"Pfullingen, Stadt",18 - 20 Jahre,435,205,230
False,8415059,"Pfullingen, Stadt",20 - 25 Jahre,1087,529,558
False,8415059,"Pfullingen, Stadt",25 - 30 Jahre,1044,506,538
False,8415059,"Pfullingen, Stadt",30 - 35 Jahre,1039,491,548
False,8415059,"Pfullingen, Stadt",35 - 40 Jahre,1088,539,549
False,8415059,"Pfullingen, Stadt",40 - 45 Jahre,1509,772,737
False,8415059,"Pfullingen, Stadt",45 - 50 Jahre,1654,854,800
False,8415059,"Pfullingen, Stadt",50 - 55 Jahre,1454,725,729
False,8415059,"Pfullingen, Stadt",55 - 60 Jahre,1109,520,589
False,8415059,"Pfullingen, Stadt",60 - 65 Jahre,972,463,509
False,8415059,"Pfullingen, Stadt",65 - 75 Jahre,2111,985,1126
False,8415059,"Pfullingen, Stadt",75 und mehr Jahre,1729,681,1048
False,8415059,"Pfullingen, Stadt",Insgesamt,18675,9001,9674
False,8415060,Pliezhausen,unter 3 Jahre,245,129,116
False,8415060,Pliezhausen,3 -  6 Jahre,273,126,147
False,8415060,Pliezhausen,6 - 10 Jahre,347,190,157
False,8415060,Pliezhausen,10 - 15 Jahre,621,325,296
False,8415060,Pliezhausen,15 - 18 Jahre,330,176,154
False,8415060,Pliezhausen,18 - 20 Jahre,251,120,131
False,8415060,Pliezhausen,20 - 25 Jahre,491,265,226
False,8415060,Pliezhausen,25 - 30 Jahre,459,237,222
False,8415060,Pliezhausen,30 - 35 Jahre,472,236,236
False,8415060,Pliezhausen,35 - 40 Jahre,579,268,311
False,8415060,Pliezhausen,40 - 45 Jahre,853,410,443
False,8415060,Pliezhausen,45 - 50 Jahre,939,463,476
False,8415060,Pliezhausen,50 - 55 Jahre,728,372,356
False,8415060,Pliezhausen,55 - 60 Jahre,556,282,274
False,8415060,Pliezhausen,60 - 65 Jahre,536,265,271
False,8415060,Pliezhausen,65 - 75 Jahre,986,491,495
False,8415060,Pliezhausen,75 und mehr Jahre,663,262,401
False,8415060,Pliezhausen,Insgesamt,9329,4617,4712
False,8415061,"Reutlingen, Stadt",unter 3 Jahre,2872,1499,1373
False,8415061,"Reutlingen, Stadt",3 -  6 Jahre,2833,1456,1377
False,8415061,"Reutlingen, Stadt",6 - 10 Jahre,4040,2131,1909
False,8415061,"Reutlingen, Stadt",10 - 15 Jahre,5579,2859,2720
False,8415061,"Reutlingen, Stadt",15 - 18 Jahre,3466,1833,1633
False,8415061,"Reutlingen, Stadt",18 - 20 Jahre,2706,1348,1358
False,8415061,"Reutlingen, Stadt",20 - 25 Jahre,7205,3545,3660
False,8415061,"Reutlingen, Stadt",25 - 30 Jahre,6964,3494,3470
False,8415061,"Reutlingen, Stadt",30 - 35 Jahre,6850,3340,3510
False,8415061,"Reutlingen, Stadt",35 - 40 Jahre,7379,3724,3655
False,8415061,"Reutlingen, Stadt",40 - 45 Jahre,9295,4764,4531
False,8415061,"Reutlingen, Stadt",45 - 50 Jahre,9602,4792,4810
False,8415061,"Reutlingen, Stadt",50 - 55 Jahre,8427,4222,4205
False,8415061,"Reutlingen, Stadt",55 - 60 Jahre,7119,3484,3635
False,8415061,"Reutlingen, Stadt",60 - 65 Jahre,5924,2843,3081
False,8415061,"Reutlingen, Stadt",65 - 75 Jahre,12118,5636,6482
False,8415061,"Reutlingen, Stadt",75 und mehr Jahre,10105,3849,6256
False,8415061,"Reutlingen, Stadt",Insgesamt,112484,54819,57665
False,8415062,Riederich,unter 3 Jahre,99,51,48
False,8415062,Riederich,3 -  6 Jahre,122,65,57
False,8415062,Riederich,6 - 10 Jahre,154,73,81
False,8415062,Riederich,10 - 15 Jahre,231,117,114
False,8415062,Riederich,15 - 18 Jahre,132,63,69
False,8415062,Riederich,18 - 20 Jahre,76,36,40
False,8415062,Riederich,20 - 25 Jahre,257,130,127
False,8415062,Riederich,25 - 30 Jahre,254,127,127
False,8415062,Riederich,30 - 35 Jahre,247,121,126
False,8415062,Riederich,35 - 40 Jahre,259,130,129
False,8415062,Riederich,40 - 45 Jahre,374,202,172
False,8415062,Riederich,45 - 50 Jahre,351,172,179
False,8415062,Riederich,50 - 55 Jahre,343,177,166
False,8415062,Riederich,55 - 60 Jahre,280,125,155
False,8415062,Riederich,60 - 65 Jahre,258,135,123
False,8415062,Riederich,65 - 75 Jahre,485,227,258
False,8415062,Riederich,75 und mehr Jahre,321,138,183
False,8415062,Riederich,Insgesamt,4243,2089,2154
False,8415073,"Trochtelfingen, Stadt",unter 3 Jahre,161,86,75
False,8415073,"Trochtelfingen, Stadt",3 -  6 Jahre,151,78,73
False,8415073,"Trochtelfingen, Stadt",6 - 10 Jahre,241,118,123
False,8415073,"Trochtelfingen, Stadt",10 - 15 Jahre,404,216,188
False,8415073,"Trochtelfingen, Stadt",15 - 18 Jahre,287,154,133
False,8415073,"Trochtelfingen, Stadt",18 - 20 Jahre,175,92,83
False,8415073,"Trochtelfingen, Stadt",20 - 25 Jahre,407,213,194
False,8415073,"Trochtelfingen, Stadt",25 - 30 Jahre,274,125,149
False,8415073,"Trochtelfingen, Stadt",30 - 35 Jahre,359,185,174
False,8415073,"Trochtelfingen, Stadt",35 - 40 Jahre,368,186,182
False,8415073,"Trochtelfingen, Stadt",40 - 45 Jahre,560,299,261
False,8415073,"Trochtelfingen, Stadt",45 - 50 Jahre,561,289,272
False,8415073,"Trochtelfingen, Stadt",50 - 55 Jahre,533,282,251
False,8415073,"Trochtelfingen, Stadt",55 - 60 Jahre,426,218,208
False,8415073,"Trochtelfingen, Stadt",60 - 65 Jahre,354,171,183
False,8415073,"Trochtelfingen, Stadt",65 - 75 Jahre,638,324,314
False,8415073,"Trochtelfingen, Stadt",75 und mehr Jahre,547,194,353
False,8415073,"Trochtelfingen, Stadt",Insgesamt,6446,3230,3216
False,8415078,"Bad Urach, Stadt",unter 3 Jahre,293,152,141
False,8415078,"Bad Urach, Stadt",3 -  6 Jahre,291,138,153
False,8415078,"Bad Urach, Stadt",6 - 10 Jahre,436,234,202
False,8415078,"Bad Urach, Stadt",10 - 15 Jahre,650,344,306
False,8415078,"Bad Urach, Stadt",15 - 18 Jahre,422,224,198
False,8415078,"Bad Urach, Stadt",18 - 20 Jahre,303,153,150
False,8415078,"Bad Urach, Stadt",20 - 25 Jahre,775,400,375
False,8415078,"Bad Urach, Stadt",25 - 30 Jahre,660,336,324
False,8415078,"Bad Urach, Stadt",30 - 35 Jahre,621,308,313
False,8415078,"Bad Urach, Stadt",35 - 40 Jahre,695,336,359
False,8415078,"Bad Urach, Stadt",40 - 45 Jahre,976,518,458
False,8415078,"Bad Urach, Stadt",45 - 50 Jahre,1062,528,534
False,8415078,"Bad Urach, Stadt",50 - 55 Jahre,952,494,458
False,8415078,"Bad Urach, Stadt",55 - 60 Jahre,828,395,433
False,8415078,"Bad Urach, Stadt",60 - 65 Jahre,691,365,326
False,8415078,"Bad Urach, Stadt",65 - 75 Jahre,1431,659,772
False,8415078,"Bad Urach, Stadt",75 und mehr Jahre,1231,476,755
False,8415078,"Bad Urach, Stadt",Insgesamt,12317,6060,6257
False,8415080,Wannweil,unter 3 Jahre,108,58,50
False,8415080,Wannweil,3 -  6 Jahre,148,78,70
False,8415080,Wannweil,6 - 10 Jahre,199,104,95
False,8415080,Wannweil,10 - 15 Jahre,307,161,146
False,8415080,Wannweil,15 - 18 Jahre,183,103,80
False,8415080,Wannweil,18 - 20 Jahre,127,56,71
False,8415080,Wannweil,20 - 25 Jahre,258,120,138
False,8415080,Wannweil,25 - 30 Jahre,255,132,123
False,8415080,Wannweil,30 - 35 Jahre,243,105,138
False,8415080,Wannweil,35 - 40 Jahre,357,189,168
False,8415080,Wannweil,40 - 45 Jahre,441,233,208
False,8415080,Wannweil,45 - 50 Jahre,456,215,241
False,8415080,Wannweil,50 - 55 Jahre,422,216,206
False,8415080,Wannweil,55 - 60 Jahre,341,179,162
False,8415080,Wannweil,60 - 65 Jahre,272,134,138
False,8415080,Wannweil,65 - 75 Jahre,540,260,280
False,8415080,Wannweil,75 und mehr Jahre,492,185,307
False,8415080,Wannweil,Insgesamt,5149,2528,2621
False,8415085,Zwiefalten,unter 3 Jahre,51,21,30
False,8415085,Zwiefalten,3 -  6 Jahre,58,31,27
False,8415085,Zwiefalten,6 - 10 Jahre,84,48,36
False,8415085,Zwiefalten,10 - 15 Jahre,116,61,55
False,8415085,Zwiefalten,15 - 18 Jahre,70,39,31
False,8415085,Zwiefalten,18 - 20 Jahre,53,31,22
False,8415085,Zwiefalten,20 - 25 Jahre,115,60,55
False,8415085,Zwiefalten,25 - 30 Jahre,106,63,43
False,8415085,Zwiefalten,30 - 35 Jahre,110,65,45
False,8415085,Zwiefalten,35 - 40 Jahre,125,62,63
False,8415085,Zwiefalten,40 - 45 Jahre,151,76,75
False,8415085,Zwiefalten,45 - 50 Jahre,198,117,81
False,8415085,Zwiefalten,50 - 55 Jahre,156,84,72
False,8415085,Zwiefalten,55 - 60 Jahre,157,83,74
False,8415085,Zwiefalten,60 - 65 Jahre,116,72,44
False,8415085,Zwiefalten,65 - 75 Jahre,204,95,109
False,8415085,Zwiefalten,75 und mehr Jahre,197,73,124
False,8415085,Zwiefalten,Insgesamt,2067,1081,986
False,8415086,Gutsbezirk Münsingen,unter 3 Jahre,3,2,1
False,8415086,Gutsbezirk Münsingen,3 -  6 Jahre,2,1,1
False,8415086,Gutsbezirk Münsingen,6 - 10 Jahre,0,0,0
False,8415086,Gutsbezirk Münsingen,10 - 15 Jahre,0,0,0
False,8415086,Gutsbezirk Münsingen,15 - 18 Jahre,0,0,0
False,8415086,Gutsbezirk Münsingen,18 - 20 Jahre,0,0,0
False,8415086,Gutsbezirk Münsingen,20 - 25 Jahre,9,5,4
False,8415086,Gutsbezirk Münsingen,25 - 30 Jahre,9,4,5
False,8415086,Gutsbezirk Münsingen,30 - 35 Jahre,10,3,7
False,8415086,Gutsbezirk Münsingen,35 - 40 Jahre,13,6,7
False,8415086,Gutsbezirk Münsingen,40 - 45 Jahre,16,7,9
False,8415086,Gutsbezirk Münsingen,45 - 50 Jahre,23,15,8
False,8415086,Gutsbezirk Münsingen,50 - 55 Jahre,20,10,10
False,8415086,Gutsbezirk Münsingen,55 - 60 Jahre,6,3,3
False,8415086,Gutsbezirk Münsingen,60 - 65 Jahre,15,7,8
False,8415086,Gutsbezirk Münsingen,65 - 75 Jahre,16,7,9
False,8415086,Gutsbezirk Münsingen,75 und mehr Jahre,18,13,5
False,8415086,Gutsbezirk Münsingen,Insgesamt,160,83,77
False,8415087,Walddorfhäslach,unter 3 Jahre,133,68,65
False,8415087,Walddorfhäslach,3 -  6 Jahre,127,67,60
False,8415087,Walddorfhäslach,6 - 10 Jahre,182,95,87
False,8415087,Walddorfhäslach,10 - 15 Jahre,305,152,153
False,8415087,Walddorfhäslach,15 - 18 Jahre,204,104,100
False,8415087,Walddorfhäslach,18 - 20 Jahre,131,67,64
False,8415087,Walddorfhäslach,20 - 25 Jahre,312,163,149
False,8415087,Walddorfhäslach,25 - 30 Jahre,275,140,135
False,8415087,Walddorfhäslach,30 - 35 Jahre,294,137,157
False,8415087,Walddorfhäslach,35 - 40 Jahre,283,133,150
False,8415087,Walddorfhäslach,40 - 45 Jahre,431,203,228
False,8415087,Walddorfhäslach,45 - 50 Jahre,467,244,223
False,8415087,Walddorfhäslach,50 - 55 Jahre,389,198,191
False,8415087,Walddorfhäslach,55 - 60 Jahre,334,170,164
False,8415087,Walddorfhäslach,60 - 65 Jahre,255,130,125
False,8415087,Walddorfhäslach,65 - 75 Jahre,405,196,209
False,8415087,Walddorfhäslach,75 und mehr Jahre,322,137,185
False,8415087,Walddorfhäslach,Insgesamt,4849,2404,2445
False,8415088,Römerstein,unter 3 Jahre,102,59,43
False,8415088,Römerstein,3 -  6 Jahre,118,71,47
False,8415088,Römerstein,6 - 10 Jahre,174,71,103
False,8415088,Römerstein,10 - 15 Jahre,285,152,133
False,8415088,Römerstein,15 - 18 Jahre,171,77,94
False,8415088,Römerstein,18 - 20 Jahre,101,57,44
False,8415088,Römerstein,20 - 25 Jahre,215,103,112
False,8415088,Römerstein,25 - 30 Jahre,183,92,91
False,8415088,Römerstein,30 - 35 Jahre,186,95,91
False,8415088,Römerstein,35 - 40 Jahre,247,127,120
False,8415088,Römerstein,40 - 45 Jahre,346,168,178
False,8415088,Römerstein,45 - 50 Jahre,329,163,166
False,8415088,Römerstein,50 - 55 Jahre,272,152,120
False,8415088,Römerstein,55 - 60 Jahre,237,127,110
False,8415088,Römerstein,60 - 65 Jahre,223,114,109
False,8415088,Römerstein,65 - 75 Jahre,401,184,217
False,8415088,Römerstein,75 und mehr Jahre,321,131,190
False,8415088,Römerstein,Insgesamt,3911,1943,1968
False,8415089,Engstingen,unter 3 Jahre,117,60,57
False,8415089,Engstingen,3 -  6 Jahre,147,73,74
False,8415089,Engstingen,6 - 10 Jahre,255,136,119
False,8415089,Engstingen,10 - 15 Jahre,375,185,190
False,8415089,Engstingen,15 - 18 Jahre,214,103,111
False,8415089,Engstingen,18 - 20 Jahre,150,81,69
False,8415089,Engstingen,20 - 25 Jahre,345,174,171
False,8415089,Engstingen,25 - 30 Jahre,267,123,144
False,8415089,Engstingen,30 - 35 Jahre,224,110,114
False,8415089,Engstingen,35 - 40 Jahre,295,152,143
False,8415089,Engstingen,40 - 45 Jahre,440,230,210
False,8415089,Engstingen,45 - 50 Jahre,503,262,241
False,8415089,Engstingen,50 - 55 Jahre,430,214,216
False,8415089,Engstingen,55 - 60 Jahre,330,168,162
False,8415089,Engstingen,60 - 65 Jahre,262,136,126
False,8415089,Engstingen,65 - 75 Jahre,492,233,259
False,8415089,Engstingen,75 und mehr Jahre,460,182,278
False,8415089,Engstingen,Insgesamt,5306,2622,2684
False,8415090,Hohenstein,unter 3 Jahre,100,51,49
False,8415090,Hohenstein,3 -  6 Jahre,133,67,66
False,8415090,Hohenstein,6 - 10 Jahre,178,87,91
False,8415090,Hohenstein,10 - 15 Jahre,280,143,137
False,8415090,Hohenstein,15 - 18 Jahre,173,94,79
False,8415090,Hohenstein,18 - 20 Jahre,105,60,45
False,8415090,Hohenstein,20 - 25 Jahre,193,111,82
False,8415090,Hohenstein,25 - 30 Jahre,181,85,96
False,8415090,Hohenstein,30 - 35 Jahre,207,108,99
False,8415090,Hohenstein,35 - 40 Jahre,261,115,146
False,8415090,Hohenstein,40 - 45 Jahre,323,160,163
False,8415090,Hohenstein,45 - 50 Jahre,325,177,148
False,8415090,Hohenstein,50 - 55 Jahre,284,137,147
False,8415090,Hohenstein,55 - 60 Jahre,200,92,108
False,8415090,Hohenstein,60 - 65 Jahre,181,102,79
False,8415090,Hohenstein,65 - 75 Jahre,328,148,180
False,8415090,Hohenstein,75 und mehr Jahre,288,122,166
False,8415090,Hohenstein,Insgesamt,3740,1859,1881
False,8415091,Sonnenbühl,unter 3 Jahre,188,106,82
False,8415091,Sonnenbühl,3 -  6 Jahre,211,116,95
False,8415091,Sonnenbühl,6 - 10 Jahre,321,173,148
False,8415091,Sonnenbühl,10 - 15 Jahre,449,230,219
False,8415091,Sonnenbühl,15 - 18 Jahre,275,129,146
False,8415091,Sonnenbühl,18 - 20 Jahre,174,87,87
False,8415091,Sonnenbühl,20 - 25 Jahre,405,217,188
False,8415091,Sonnenbühl,25 - 30 Jahre,354,174,180
False,8415091,Sonnenbühl,30 - 35 Jahre,314,176,138
False,8415091,Sonnenbühl,35 - 40 Jahre,468,223,245
False,8415091,Sonnenbühl,40 - 45 Jahre,615,303,312
False,8415091,Sonnenbühl,45 - 50 Jahre,674,352,322
False,8415091,Sonnenbühl,50 - 55 Jahre,522,270,252
False,8415091,Sonnenbühl,55 - 60 Jahre,446,234,212
False,8415091,Sonnenbühl,60 - 65 Jahre,390,196,194
False,8415091,Sonnenbühl,65 - 75 Jahre,690,347,343
False,8415091,Sonnenbühl,75 und mehr Jahre,549,210,339
False,8415091,Sonnenbühl,Insgesamt,7045,3543,3502
False,8415092,Lichtenstein,unter 3 Jahre,244,122,122
False,8415092,Lichtenstein,3 -  6 Jahre,270,146,124
False,8415092,Lichtenstein,6 - 10 Jahre,313,159,154
False,8415092,Lichtenstein,10 - 15 Jahre,470,246,224
False,8415092,Lichtenstein,15 - 18 Jahre,307,170,137
False,8415092,Lichtenstein,18 - 20 Jahre,237,133,104
False,8415092,Lichtenstein,20 - 25 Jahre,534,255,279
False,8415092,Lichtenstein,25 - 30 Jahre,483,251,232
False,8415092,Lichtenstein,30 - 35 Jahre,485,236,249
False,8415092,Lichtenstein,35 - 40 Jahre,532,275,257
False,8415092,Lichtenstein,40 - 45 Jahre,671,311,360
False,8415092,Lichtenstein,45 - 50 Jahre,747,370,377
False,8415092,Lichtenstein,50 - 55 Jahre,719,386,333
False,8415092,Lichtenstein,55 - 60 Jahre,633,313,320
False,8415092,Lichtenstein,60 - 65 Jahre,455,229,226
False,8415092,Lichtenstein,65 - 75 Jahre,1007,465,542
False,8415092,Lichtenstein,75 und mehr Jahre,843,317,526
False,8415092,Lichtenstein,Insgesamt,8950,4384,4566
False,8415093,St. Johann,unter 3 Jahre,124,62,62
False,8415093,St. Johann,3 -  6 Jahre,131,60,71
False,8415093,St. Johann,6 - 10 Jahre,211,102,109
False,8415093,St. Johann,10 - 15 Jahre,289,148,141
False,8415093,St. Johann,15 - 18 Jahre,186,99,87
False,8415093,St. Johann,18 - 20 Jahre,127,67,60
False,8415093,St. Johann,20 - 25 Jahre,305,172,133
False,8415093,St. Johann,25 - 30 Jahre,239,120,119
False,8415093,St. Johann,30 - 35 Jahre,246,125,121
False,8415093,St. Johann,35 - 40 Jahre,275,139,136
False,8415093,St. Johann,40 - 45 Jahre,440,221,219
False,8415093,St. Johann,45 - 50 Jahre,485,248,237
False,8415093,St. Johann,50 - 55 Jahre,432,217,215
False,8415093,St. Johann,55 - 60 Jahre,346,190,156
False,8415093,St. Johann,60 - 65 Jahre,270,130,140
False,8415093,St. Johann,65 - 75 Jahre,548,255,293
False,8415093,St. Johann,75 und mehr Jahre,500,211,289
False,8415093,St. Johann,Insgesamt,5154,2566,2588
False,8416,Landkreis Tübingen,unter 3 Jahre,5669,2869,2800
False,8416,Landkreis Tübingen,3 -  6 Jahre,5814,2983,2831
False,8416,Landkreis Tübingen,6 - 10 Jahre,8215,4216,3999
False,8416,Landkreis Tübingen,10 - 15 Jahre,11481,5925,5556
False,8416,Landkreis Tübingen,15 - 18 Jahre,6997,3579,3418
False,8416,Landkreis Tübingen,18 - 20 Jahre,5282,2593,2689
False,8416,Landkreis Tübingen,20 - 25 Jahre,18382,8421,9961
False,8416,Landkreis Tübingen,25 - 30 Jahre,17052,8362,8690
False,8416,Landkreis Tübingen,30 - 35 Jahre,13496,6808,6688
False,8416,Landkreis Tübingen,35 - 40 Jahre,12908,6329,6579
False,8416,Landkreis Tübingen,40 - 45 Jahre,17711,8907,8804
False,8416,Landkreis Tübingen,45 - 50 Jahre,21108,10817,10291
False,8416,Landkreis Tübingen,50 - 55 Jahre,18138,9412,8726
False,8416,Landkreis Tübingen,55 - 60 Jahre,13797,6944,6853
False,8416,Landkreis Tübingen,60 - 65 Jahre,10657,5497,5160
False,8416,Landkreis Tübingen,65 - 75 Jahre,19117,9197,9920
False,8416,Landkreis Tübingen,75 und mehr Jahre,15480,5835,9645
False,8416,Landkreis Tübingen,Insgesamt,221304,108694,112610
False,8416006,Bodelshausen,unter 3 Jahre,137,71,66
False,8416006,Bodelshausen,3 -  6 Jahre,184,95,89
False,8416006,Bodelshausen,6 - 10 Jahre,245,129,116
False,8416006,Bodelshausen,10 - 15 Jahre,307,162,145
False,8416006,Bodelshausen,15 - 18 Jahre,200,107,93
False,8416006,Bodelshausen,18 - 20 Jahre,120,64,56
False,8416006,Bodelshausen,20 - 25 Jahre,343,184,159
False,8416006,Bodelshausen,25 - 30 Jahre,322,164,158
False,8416006,Bodelshausen,30 - 35 Jahre,364,176,188
False,8416006,Bodelshausen,35 - 40 Jahre,367,180,187
False,8416006,Bodelshausen,40 - 45 Jahre,471,230,241
False,8416006,Bodelshausen,45 - 50 Jahre,454,241,213
False,8416006,Bodelshausen,50 - 55 Jahre,430,225,205
False,8416006,Bodelshausen,55 - 60 Jahre,393,178,215
False,8416006,Bodelshausen,60 - 65 Jahre,324,171,153
False,8416006,Bodelshausen,65 - 75 Jahre,603,289,314
False,8416006,Bodelshausen,75 und mehr Jahre,471,191,280
False,8416006,Bodelshausen,Insgesamt,5735,2857,2878
False,8416009,Dettenhausen,unter 3 Jahre,141,69,72
False,8416009,Dettenhausen,3 -  6 Jahre,154,80,74
False,8416009,Dettenhausen,6 - 10 Jahre,230,122,108
False,8416009,Dettenhausen,10 - 15 Jahre,296,154,142
False,8416009,Dettenhausen,15 - 18 Jahre,182,99,83
False,8416009,Dettenhausen,18 - 20 Jahre,145,76,69
False,8416009,Dettenhausen,20 - 25 Jahre,303,161,142
False,8416009,Dettenhausen,25 - 30 Jahre,315,178,137
False,8416009,Dettenhausen,30 - 35 Jahre,292,138,154
False,8416009,Dettenhausen,35 - 40 Jahre,343,152,191
False,8416009,Dettenhausen,40 - 45 Jahre,455,248,207
False,8416009,Dettenhausen,45 - 50 Jahre,489,234,255
False,8416009,Dettenhausen,50 - 55 Jahre,452,232,220
False,8416009,Dettenhausen,55 - 60 Jahre,342,173,169
False,8416009,Dettenhausen,60 - 65 Jahre,308,150,158
False,8416009,Dettenhausen,65 - 75 Jahre,622,290,332
False,8416009,Dettenhausen,75 und mehr Jahre,377,149,228
False,8416009,Dettenhausen,Insgesamt,5446,2705,2741
False,8416011,Dußlingen,unter 3 Jahre,172,89,83
False,8416011,Dußlingen,3 -  6 Jahre,177,101,76
False,8416011,Dußlingen,6 - 10 Jahre,255,129,126
False,8416011,Dußlingen,10 - 15 Jahre,360,179,181
False,8416011,Dußlingen,15 - 18 Jahre,215,110,105
False,8416011,Dußlingen,18 - 20 Jahre,142,81,61
False,8416011,Dußlingen,20 - 25 Jahre,342,192,150
False,8416011,Dußlingen,25 - 30 Jahre,308,145,163
False,8416011,Dußlingen,30 - 35 Jahre,342,171,171
False,8416011,Dußlingen,35 - 40 Jahre,335,171,164
False,8416011,Dußlingen,40 - 45 Jahre,477,258,219
False,8416011,Dußlingen,45 - 50 Jahre,511,258,253
False,8416011,Dußlingen,50 - 55 Jahre,438,232,206
False,8416011,Dußlingen,55 - 60 Jahre,303,150,153
False,8416011,Dußlingen,60 - 65 Jahre,241,127,114
False,8416011,Dußlingen,65 - 75 Jahre,486,218,268
False,8416011,Dußlingen,75 und mehr Jahre,467,176,291
False,8416011,Dußlingen,Insgesamt,5571,2787,2784
False,8416015,Gomaringen,unter 3 Jahre,228,126,102
False,8416015,Gomaringen,3 -  6 Jahre,242,127,115
False,8416015,Gomaringen,6 - 10 Jahre,397,207,190
False,8416015,Gomaringen,10 - 15 Jahre,555,280,275
False,8416015,Gomaringen,15 - 18 Jahre,317,172,145
False,8416015,Gomaringen,18 - 20 Jahre,194,101,93
False,8416015,Gomaringen,20 - 25 Jahre,501,246,255
False,8416015,Gomaringen,25 - 30 Jahre,493,242,251
False,8416015,Gomaringen,30 - 35 Jahre,465,230,235
False,8416015,Gomaringen,35 - 40 Jahre,519,250,269
False,8416015,Gomaringen,40 - 45 Jahre,774,372,402
False,8416015,Gomaringen,45 - 50 Jahre,806,411,395
False,8416015,Gomaringen,50 - 55 Jahre,692,354,338
False,8416015,Gomaringen,55 - 60 Jahre,494,230,264
False,8416015,Gomaringen,60 - 65 Jahre,432,227,205
False,8416015,Gomaringen,65 - 75 Jahre,837,405,432
False,8416015,Gomaringen,75 und mehr Jahre,652,247,405
False,8416015,Gomaringen,Insgesamt,8598,4227,4371
False,8416018,Hirrlingen,unter 3 Jahre,68,39,29
False,8416018,Hirrlingen,3 -  6 Jahre,75,37,38
False,8416018,Hirrlingen,6 - 10 Jahre,99,48,51
False,8416018,Hirrlingen,10 - 15 Jahre,222,130,92
False,8416018,Hirrlingen,15 - 18 Jahre,133,65,68
False,8416018,Hirrlingen,18 - 20 Jahre,95,44,51
False,8416018,Hirrlingen,20 - 25 Jahre,199,105,94
False,8416018,Hirrlingen,25 - 30 Jahre,170,84,86
False,8416018,Hirrlingen,30 - 35 Jahre,150,78,72
False,8416018,Hirrlingen,35 - 40 Jahre,164,81,83
False,8416018,Hirrlingen,40 - 45 Jahre,229,109,120
False,8416018,Hirrlingen,45 - 50 Jahre,310,177,133
False,8416018,Hirrlingen,50 - 55 Jahre,243,124,119
False,8416018,Hirrlingen,55 - 60 Jahre,202,100,102
False,8416018,Hirrlingen,60 - 65 Jahre,139,77,62
False,8416018,Hirrlingen,65 - 75 Jahre,221,106,115
False,8416018,Hirrlingen,75 und mehr Jahre,223,88,135
False,8416018,Hirrlingen,Insgesamt,2942,1492,1450
False,8416022,Kirchentellinsfurt,unter 3 Jahre,162,91,71
False,8416022,Kirchentellinsfurt,3 -  6 Jahre,183,92,91
False,8416022,Kirchentellinsfurt,6 - 10 Jahre,235,105,130
False,8416022,Kirchentellinsfurt,10 - 15 Jahre,306,149,157
False,8416022,Kirchentellinsfurt,15 - 18 Jahre,158,78,80
False,8416022,Kirchentellinsfurt,18 - 20 Jahre,143,74,69
False,8416022,Kirchentellinsfurt,20 - 25 Jahre,311,159,152
False,8416022,Kirchentellinsfurt,25 - 30 Jahre,367,181,186
False,8416022,Kirchentellinsfurt,30 - 35 Jahre,341,181,160
False,8416022,Kirchentellinsfurt,35 - 40 Jahre,359,172,187
False,8416022,Kirchentellinsfurt,40 - 45 Jahre,482,251,231
False,8416022,Kirchentellinsfurt,45 - 50 Jahre,507,266,241
False,8416022,Kirchentellinsfurt,50 - 55 Jahre,451,212,239
False,8416022,Kirchentellinsfurt,55 - 60 Jahre,377,198,179
False,8416022,Kirchentellinsfurt,60 - 65 Jahre,292,147,145
False,8416022,Kirchentellinsfurt,65 - 75 Jahre,513,248,265
False,8416022,Kirchentellinsfurt,75 und mehr Jahre,405,153,252
False,8416022,Kirchentellinsfurt,Insgesamt,5592,2757,2835
False,8416023,Kusterdingen,unter 3 Jahre,228,116,112
False,8416023,Kusterdingen,3 -  6 Jahre,235,126,109
False,8416023,Kusterdingen,6 - 10 Jahre,359,185,174
False,8416023,Kusterdingen,10 - 15 Jahre,459,230,229
False,8416023,Kusterdingen,15 - 18 Jahre,335,175,160
False,8416023,Kusterdingen,18 - 20 Jahre,201,102,99
False,8416023,Kusterdingen,20 - 25 Jahre,462,222,240
False,8416023,Kusterdingen,25 - 30 Jahre,475,236,239
False,8416023,Kusterdingen,30 - 35 Jahre,470,224,246
False,8416023,Kusterdingen,35 - 40 Jahre,502,241,261
False,8416023,Kusterdingen,40 - 45 Jahre,757,383,374
False,8416023,Kusterdingen,45 - 50 Jahre,796,385,411
False,8416023,Kusterdingen,50 - 55 Jahre,656,354,302
False,8416023,Kusterdingen,55 - 60 Jahre,534,287,247
False,8416023,Kusterdingen,60 - 65 Jahre,405,204,201
False,8416023,Kusterdingen,65 - 75 Jahre,792,379,413
False,8416023,Kusterdingen,75 und mehr Jahre,579,235,344
False,8416023,Kusterdingen,Insgesamt,8245,4084,4161
False,8416025,"Mössingen, Stadt",unter 3 Jahre,535,269,266
False,8416025,"Mössingen, Stadt",3 -  6 Jahre,581,286,295
False,8416025,"Mössingen, Stadt",6 - 10 Jahre,810,423,387
False,8416025,"Mössingen, Stadt",10 - 15 Jahre,1244,653,591
False,8416025,"Mössingen, Stadt",15 - 18 Jahre,730,378,352
False,8416025,"Mössingen, Stadt",18 - 20 Jahre,526,276,250
False,8416025,"Mössingen, Stadt",20 - 25 Jahre,1246,633,613
False,8416025,"Mössingen, Stadt",25 - 30 Jahre,1105,558,547
False,8416025,"Mössingen, Stadt",30 - 35 Jahre,1071,518,553
False,8416025,"Mössingen, Stadt",35 - 40 Jahre,1250,584,666
False,8416025,"Mössingen, Stadt",40 - 45 Jahre,1596,782,814
False,8416025,"Mössingen, Stadt",45 - 50 Jahre,1732,873,859
False,8416025,"Mössingen, Stadt",50 - 55 Jahre,1567,805,762
False,8416025,"Mössingen, Stadt",55 - 60 Jahre,1327,629,698
False,8416025,"Mössingen, Stadt",60 - 65 Jahre,1066,539,527
False,8416025,"Mössingen, Stadt",65 - 75 Jahre,1997,969,1028
False,8416025,"Mössingen, Stadt",75 und mehr Jahre,1656,634,1022
False,8416025,"Mössingen, Stadt",Insgesamt,20039,9809,10230
False,8416026,Nehren,unter 3 Jahre,130,62,68
False,8416026,Nehren,3 -  6 Jahre,137,71,66
False,8416026,Nehren,6 - 10 Jahre,200,110,90
False,8416026,Nehren,10 - 15 Jahre,238,124,114
False,8416026,Nehren,15 - 18 Jahre,145,69,76
False,8416026,Nehren,18 - 20 Jahre,98,53,45
False,8416026,Nehren,20 - 25 Jahre,239,128,111
False,8416026,Nehren,25 - 30 Jahre,214,107,107
False,8416026,Nehren,30 - 35 Jahre,280,126,154
False,8416026,Nehren,35 - 40 Jahre,306,137,169
False,8416026,Nehren,40 - 45 Jahre,386,193,193
False,8416026,Nehren,45 - 50 Jahre,353,182,171
False,8416026,Nehren,50 - 55 Jahre,333,147,186
False,8416026,Nehren,55 - 60 Jahre,296,145,151
False,8416026,Nehren,60 - 65 Jahre,248,127,121
False,8416026,Nehren,65 - 75 Jahre,365,177,188
False,8416026,Nehren,75 und mehr Jahre,304,115,189
False,8416026,Nehren,Insgesamt,4272,2073,2199
False,8416031,Ofterdingen,unter 3 Jahre,129,62,67
False,8416031,Ofterdingen,3 -  6 Jahre,135,69,66
False,8416031,Ofterdingen,6 - 10 Jahre,208,104,104
False,8416031,Ofterdingen,10 - 15 Jahre,271,149,122
False,8416031,Ofterdingen,15 - 18 Jahre,152,73,79
False,8416031,Ofterdingen,18 - 20 Jahre,107,48,59
False,8416031,Ofterdingen,20 - 25 Jahre,229,110,119
False,8416031,Ofterdingen,25 - 30 Jahre,245,127,118
False,8416031,Ofterdingen,30 - 35 Jahre,284,142,142
False,8416031,Ofterdingen,35 - 40 Jahre,306,152,154
False,8416031,Ofterdingen,40 - 45 Jahre,392,189,203
False,8416031,Ofterdingen,45 - 50 Jahre,431,237,194
False,8416031,Ofterdingen,50 - 55 Jahre,325,162,163
False,8416031,Ofterdingen,55 - 60 Jahre,296,150,146
False,8416031,Ofterdingen,60 - 65 Jahre,260,133,127
False,8416031,Ofterdingen,65 - 75 Jahre,415,205,210
False,8416031,Ofterdingen,75 und mehr Jahre,370,156,214
False,8416031,Ofterdingen,Insgesamt,4555,2268,2287
False,8416036,"Rottenburg am Neckar, Stadt",unter 3 Jahre,1079,532,547
False,8416036,"Rottenburg am Neckar, Stadt",3 -  6 Jahre,1161,585,576
False,8416036,"Rottenburg am Neckar, Stadt",6 - 10 Jahre,1714,894,820
False,8416036,"Rottenburg am Neckar, Stadt",10 - 15 Jahre,2473,1262,1211
False,8416036,"Rottenburg am Neckar, Stadt",15 - 18 Jahre,1575,779,796
False,8416036,"Rottenburg am Neckar, Stadt",18 - 20 Jahre,1143,602,541
False,8416036,"Rottenburg am Neckar, Stadt",20 - 25 Jahre,2799,1445,1354
False,8416036,"Rottenburg am Neckar, Stadt",25 - 30 Jahre,2435,1294,1141
False,8416036,"Rottenburg am Neckar, Stadt",30 - 35 Jahre,2353,1181,1172
False,8416036,"Rottenburg am Neckar, Stadt",35 - 40 Jahre,2522,1272,1250
False,8416036,"Rottenburg am Neckar, Stadt",40 - 45 Jahre,3468,1720,1748
False,8416036,"Rottenburg am Neckar, Stadt",45 - 50 Jahre,4069,2180,1889
False,8416036,"Rottenburg am Neckar, Stadt",50 - 55 Jahre,3597,1896,1701
False,8416036,"Rottenburg am Neckar, Stadt",55 - 60 Jahre,2848,1454,1394
False,8416036,"Rottenburg am Neckar, Stadt",60 - 65 Jahre,2099,1080,1019
False,8416036,"Rottenburg am Neckar, Stadt",65 - 75 Jahre,4098,2056,2042
False,8416036,"Rottenburg am Neckar, Stadt",75 und mehr Jahre,3068,1171,1897
False,8416036,"Rottenburg am Neckar, Stadt",Insgesamt,42501,21403,21098
False,8416041,"Tübingen, Universitätsstadt",unter 3 Jahre,2124,1062,1062
False,8416041,"Tübingen, Universitätsstadt",3 -  6 Jahre,1972,1026,946
False,8416041,"Tübingen, Universitätsstadt",6 - 10 Jahre,2621,1322,1299
False,8416041,"Tübingen, Universitätsstadt",10 - 15 Jahre,3390,1756,1634
False,8416041,"Tübingen, Universitätsstadt",15 - 18 Jahre,2078,1059,1019
False,8416041,"Tübingen, Universitätsstadt",18 - 20 Jahre,1891,829,1062
False,8416041,"Tübingen, Universitätsstadt",20 - 25 Jahre,10179,4202,5977
False,8416041,"Tübingen, Universitätsstadt",25 - 30 Jahre,9541,4510,5031
False,8416041,"Tübingen, Universitätsstadt",30 - 35 Jahre,6047,3129,2918
False,8416041,"Tübingen, Universitätsstadt",35 - 40 Jahre,4724,2331,2393
False,8416041,"Tübingen, Universitätsstadt",40 - 45 Jahre,6500,3350,3150
False,8416041,"Tübingen, Universitätsstadt",45 - 50 Jahre,8777,4444,4333
False,8416041,"Tübingen, Universitätsstadt",50 - 55 Jahre,7357,3837,3520
False,8416041,"Tübingen, Universitätsstadt",55 - 60 Jahre,5159,2637,2522
False,8416041,"Tübingen, Universitätsstadt",60 - 65 Jahre,3939,2035,1904
False,8416041,"Tübingen, Universitätsstadt",65 - 75 Jahre,6521,3060,3461
False,8416041,"Tübingen, Universitätsstadt",75 und mehr Jahre,5538,2008,3530
False,8416041,"Tübingen, Universitätsstadt",Insgesamt,88358,42597,45761
False,8416048,Ammerbuch,unter 3 Jahre,326,180,146
False,8416048,Ammerbuch,3 -  6 Jahre,346,185,161
False,8416048,Ammerbuch,6 - 10 Jahre,477,257,220
False,8416048,Ammerbuch,10 - 15 Jahre,810,424,386
False,8416048,Ammerbuch,15 - 18 Jahre,446,248,198
False,8416048,Ammerbuch,18 - 20 Jahre,287,141,146
False,8416048,Ammerbuch,20 - 25 Jahre,716,363,353
False,8416048,Ammerbuch,25 - 30 Jahre,648,311,337
False,8416048,Ammerbuch,30 - 35 Jahre,648,328,320
False,8416048,Ammerbuch,35 - 40 Jahre,686,335,351
False,8416048,Ammerbuch,40 - 45 Jahre,986,463,523
False,8416048,Ammerbuch,45 - 50 Jahre,1076,549,527
False,8416048,Ammerbuch,50 - 55 Jahre,931,483,448
False,8416048,Ammerbuch,55 - 60 Jahre,719,337,382
False,8416048,Ammerbuch,60 - 65 Jahre,586,311,275
False,8416048,Ammerbuch,65 - 75 Jahre,1052,507,545
False,8416048,Ammerbuch,75 und mehr Jahre,793,307,486
False,8416048,Ammerbuch,Insgesamt,11533,5729,5804
False,8416049,Neustetten,unter 3 Jahre,96,45,51
False,8416049,Neustetten,3 -  6 Jahre,108,51,57
False,8416049,Neustetten,6 - 10 Jahre,174,89,85
False,8416049,Neustetten,10 - 15 Jahre,235,120,115
False,8416049,Neustetten,15 - 18 Jahre,154,77,77
False,8416049,Neustetten,18 - 20 Jahre,85,42,43
False,8416049,Neustetten,20 - 25 Jahre,232,123,109
False,8416049,Neustetten,25 - 30 Jahre,210,126,84
False,8416049,Neustetten,30 - 35 Jahre,194,89,105
False,8416049,Neustetten,35 - 40 Jahre,229,117,112
False,8416049,Neustetten,40 - 45 Jahre,319,161,158
False,8416049,Neustetten,45 - 50 Jahre,326,149,177
False,8416049,Neustetten,50 - 55 Jahre,288,149,139
False,8416049,Neustetten,55 - 60 Jahre,226,127,99
False,8416049,Neustetten,60 - 65 Jahre,160,77,83
False,8416049,Neustetten,65 - 75 Jahre,233,113,120
False,8416049,Neustetten,75 und mehr Jahre,209,74,135
False,8416049,Neustetten,Insgesamt,3478,1729,1749
False,8416050,Starzach,unter 3 Jahre,114,56,58
False,8416050,Starzach,3 -  6 Jahre,124,52,72
False,8416050,Starzach,6 - 10 Jahre,191,92,99
False,8416050,Starzach,10 - 15 Jahre,315,153,162
False,8416050,Starzach,15 - 18 Jahre,177,90,87
False,8416050,Starzach,18 - 20 Jahre,105,60,45
False,8416050,Starzach,20 - 25 Jahre,281,148,133
False,8416050,Starzach,25 - 30 Jahre,204,99,105
False,8416050,Starzach,30 - 35 Jahre,195,97,98
False,8416050,Starzach,35 - 40 Jahre,296,154,142
False,8416050,Starzach,40 - 45 Jahre,419,198,221
False,8416050,Starzach,45 - 50 Jahre,471,231,240
False,8416050,Starzach,50 - 55 Jahre,378,200,178
False,8416050,Starzach,55 - 60 Jahre,281,149,132
False,8416050,Starzach,60 - 65 Jahre,158,92,66
False,8416050,Starzach,65 - 75 Jahre,362,175,187
False,8416050,Starzach,75 und mehr Jahre,368,131,237
False,8416050,Starzach,Insgesamt,4439,2177,2262
False,8417,Landkreis Zollernalbkreis,unter 3 Jahre,4367,2253,2114
False,8417,Landkreis Zollernalbkreis,3 -  6 Jahre,4812,2431,2381
False,8417,Landkreis Zollernalbkreis,6 - 10 Jahre,6964,3631,3333
False,8417,Landkreis Zollernalbkreis,10 - 15 Jahre,10073,5232,4841
False,8417,Landkreis Zollernalbkreis,15 - 18 Jahre,6826,3474,3352
False,8417,Landkreis Zollernalbkreis,18 - 20 Jahre,4673,2396,2277
False,8417,Landkreis Zollernalbkreis,20 - 25 Jahre,11193,5980,5213
False,8417,Landkreis Zollernalbkreis,25 - 30 Jahre,10027,5195,4832
False,8417,Landkreis Zollernalbkreis,30 - 35 Jahre,9682,4889,4793
False,8417,Landkreis Zollernalbkreis,35 - 40 Jahre,11182,5610,5572
False,8417,Landkreis Zollernalbkreis,40 - 45 Jahre,14912,7570,7342
False,8417,Landkreis Zollernalbkreis,45 - 50 Jahre,16630,8491,8139
False,8417,Landkreis Zollernalbkreis,50 - 55 Jahre,14766,7495,7271
False,8417,Landkreis Zollernalbkreis,55 - 60 Jahre,12567,6215,6352
False,8417,Landkreis Zollernalbkreis,60 - 65 Jahre,10615,5311,5304
False,8417,Landkreis Zollernalbkreis,65 - 75 Jahre,20775,9764,11011
False,8417,Landkreis Zollernalbkreis,75 und mehr Jahre,18329,6893,11436
False,8417,Landkreis Zollernalbkreis,Insgesamt,188393,92830,95563
False,8417002,"Balingen, Stadt",unter 3 Jahre,770,398,372
False,8417002,"Balingen, Stadt",3 -  6 Jahre,871,427,444
False,8417002,"Balingen, Stadt",6 - 10 Jahre,1262,648,614
False,8417002,"Balingen, Stadt",10 - 15 Jahre,1746,925,821
False,8417002,"Balingen, Stadt",15 - 18 Jahre,1105,575,530
False,8417002,"Balingen, Stadt",18 - 20 Jahre,793,427,366
False,8417002,"Balingen, Stadt",20 - 25 Jahre,1913,1041,872
False,8417002,"Balingen, Stadt",25 - 30 Jahre,1824,901,923
False,8417002,"Balingen, Stadt",30 - 35 Jahre,1824,907,917
False,8417002,"Balingen, Stadt",35 - 40 Jahre,2009,1047,962
False,8417002,"Balingen, Stadt",40 - 45 Jahre,2615,1270,1345
False,8417002,"Balingen, Stadt",45 - 50 Jahre,2899,1468,1431
False,8417002,"Balingen, Stadt",50 - 55 Jahre,2635,1269,1366
False,8417002,"Balingen, Stadt",55 - 60 Jahre,2273,1115,1158
False,8417002,"Balingen, Stadt",60 - 65 Jahre,1957,951,1006
False,8417002,"Balingen, Stadt",65 - 75 Jahre,3984,1849,2135
False,8417002,"Balingen, Stadt",75 und mehr Jahre,3479,1345,2134
False,8417002,"Balingen, Stadt",Insgesamt,33959,16563,17396
False,8417008,Bisingen,unter 3 Jahre,247,118,129
False,8417008,Bisingen,3 -  6 Jahre,243,117,126
False,8417008,Bisingen,6 - 10 Jahre,333,185,148
False,8417008,Bisingen,10 - 15 Jahre,474,245,229
False,8417008,Bisingen,15 - 18 Jahre,351,176,175
False,8417008,Bisingen,18 - 20 Jahre,231,131,100
False,8417008,Bisingen,20 - 25 Jahre,536,283,253
False,8417008,Bisingen,25 - 30 Jahre,500,267,233
False,8417008,Bisingen,30 - 35 Jahre,524,249,275
False,8417008,Bisingen,35 - 40 Jahre,601,289,312
False,8417008,Bisingen,40 - 45 Jahre,750,389,361
False,8417008,Bisingen,45 - 50 Jahre,784,387,397
False,8417008,Bisingen,50 - 55 Jahre,757,388,369
False,8417008,Bisingen,55 - 60 Jahre,675,347,328
False,8417008,Bisingen,60 - 65 Jahre,517,252,265
False,8417008,Bisingen,65 - 75 Jahre,922,437,485
False,8417008,Bisingen,75 und mehr Jahre,804,300,504
False,8417008,Bisingen,Insgesamt,9249,4560,4689
False,8417010,Bitz,unter 3 Jahre,77,36,41
False,8417010,Bitz,3 -  6 Jahre,84,48,36
False,8417010,Bitz,6 - 10 Jahre,143,83,60
False,8417010,Bitz,10 - 15 Jahre,193,93,100
False,8417010,Bitz,15 - 18 Jahre,133,69,64
False,8417010,Bitz,18 - 20 Jahre,88,44,44
False,8417010,Bitz,20 - 25 Jahre,173,75,98
False,8417010,Bitz,25 - 30 Jahre,179,95,84
False,8417010,Bitz,30 - 35 Jahre,167,81,86
False,8417010,Bitz,35 - 40 Jahre,223,105,118
False,8417010,Bitz,40 - 45 Jahre,325,170,155
False,8417010,Bitz,45 - 50 Jahre,350,169,181
False,8417010,Bitz,50 - 55 Jahre,303,163,140
False,8417010,Bitz,55 - 60 Jahre,234,114,120
False,8417010,Bitz,60 - 65 Jahre,214,104,110
False,8417010,Bitz,65 - 75 Jahre,444,191,253
False,8417010,Bitz,75 und mehr Jahre,391,147,244
False,8417010,Bitz,Insgesamt,3721,1787,1934
False,8417013,"Burladingen, Stadt",unter 3 Jahre,266,139,127
False,8417013,"Burladingen, Stadt",3 -  6 Jahre,314,155,159
False,8417013,"Burladingen, Stadt",6 - 10 Jahre,455,237,218
False,8417013,"Burladingen, Stadt",10 - 15 Jahre,663,336,327
False,8417013,"Burladingen, Stadt",15 - 18 Jahre,473,242,231
False,8417013,"Burladingen, Stadt",18 - 20 Jahre,316,167,149
False,8417013,"Burladingen, Stadt",20 - 25 Jahre,754,405,349
False,8417013,"Burladingen, Stadt",25 - 30 Jahre,565,306,259
False,8417013,"Burladingen, Stadt",30 - 35 Jahre,609,304,305
False,8417013,"Burladingen, Stadt",35 - 40 Jahre,735,357,378
False,8417013,"Burladingen, Stadt",40 - 45 Jahre,1091,576,515
False,8417013,"Burladingen, Stadt",45 - 50 Jahre,1155,592,563
False,8417013,"Burladingen, Stadt",50 - 55 Jahre,976,502,474
False,8417013,"Burladingen, Stadt",55 - 60 Jahre,830,387,443
False,8417013,"Burladingen, Stadt",60 - 65 Jahre,688,369,319
False,8417013,"Burladingen, Stadt",65 - 75 Jahre,1287,587,700
False,8417013,"Burladingen, Stadt",75 und mehr Jahre,1209,409,800
False,8417013,"Burladingen, Stadt",Insgesamt,12386,6070,6316
False,8417014,Dautmergen,unter 3 Jahre,12,6,6
False,8417014,Dautmergen,3 -  6 Jahre,8,2,6
False,8417014,Dautmergen,6 - 10 Jahre,17,6,11
False,8417014,Dautmergen,10 - 15 Jahre,20,10,10
False,8417014,Dautmergen,15 - 18 Jahre,21,12,9
False,8417014,Dautmergen,18 - 20 Jahre,7,2,5
False,8417014,Dautmergen,20 - 25 Jahre,22,12,10
False,8417014,Dautmergen,25 - 30 Jahre,18,9,9
False,8417014,Dautmergen,30 - 35 Jahre,25,12,13
False,8417014,Dautmergen,35 - 40 Jahre,31,15,16
False,8417014,Dautmergen,40 - 45 Jahre,42,27,15
False,8417014,Dautmergen,45 - 50 Jahre,31,19,12
False,8417014,Dautmergen,50 - 55 Jahre,34,13,21
False,8417014,Dautmergen,55 - 60 Jahre,33,15,18
False,8417014,Dautmergen,60 - 65 Jahre,23,16,7
False,8417014,Dautmergen,65 - 75 Jahre,36,17,19
False,8417014,Dautmergen,75 und mehr Jahre,27,11,16
False,8417014,Dautmergen,Insgesamt,407,204,203
False,8417015,Dormettingen,unter 3 Jahre,20,8,12
False,8417015,Dormettingen,3 -  6 Jahre,33,19,14
False,8417015,Dormettingen,6 - 10 Jahre,49,25,24
False,8417015,Dormettingen,10 - 15 Jahre,63,28,35
False,8417015,Dormettingen,15 - 18 Jahre,56,34,22
False,8417015,Dormettingen,18 - 20 Jahre,32,15,17
False,8417015,Dormettingen,20 - 25 Jahre,54,28,26
False,8417015,Dormettingen,25 - 30 Jahre,70,37,33
False,8417015,Dormettingen,30 - 35 Jahre,38,19,19
False,8417015,Dormettingen,35 - 40 Jahre,55,29,26
False,8417015,Dormettingen,40 - 45 Jahre,81,40,41
False,8417015,Dormettingen,45 - 50 Jahre,103,55,48
False,8417015,Dormettingen,50 - 55 Jahre,105,48,57
False,8417015,Dormettingen,55 - 60 Jahre,66,35,31
False,8417015,Dormettingen,60 - 65 Jahre,35,20,15
False,8417015,Dormettingen,65 - 75 Jahre,100,54,46
False,8417015,Dormettingen,75 und mehr Jahre,73,30,43
False,8417015,Dormettingen,Insgesamt,1033,524,509
False,8417016,Dotternhausen,unter 3 Jahre,48,28,20
False,8417016,Dotternhausen,3 -  6 Jahre,57,29,28
False,8417016,Dotternhausen,6 - 10 Jahre,79,51,28
False,8417016,Dotternhausen,10 - 15 Jahre,121,57,64
False,8417016,Dotternhausen,15 - 18 Jahre,68,40,28
False,8417016,Dotternhausen,18 - 20 Jahre,52,28,24
False,8417016,Dotternhausen,20 - 25 Jahre,114,62,52
False,8417016,Dotternhausen,25 - 30 Jahre,95,55,40
False,8417016,Dotternhausen,30 - 35 Jahre,96,41,55
False,8417016,Dotternhausen,35 - 40 Jahre,122,57,65
False,8417016,Dotternhausen,40 - 45 Jahre,141,72,69
False,8417016,Dotternhausen,45 - 50 Jahre,166,82,84
False,8417016,Dotternhausen,50 - 55 Jahre,178,83,95
False,8417016,Dotternhausen,55 - 60 Jahre,148,76,72
False,8417016,Dotternhausen,60 - 65 Jahre,96,49,47
False,8417016,Dotternhausen,65 - 75 Jahre,155,71,84
False,8417016,Dotternhausen,75 und mehr Jahre,126,47,79
False,8417016,Dotternhausen,Insgesamt,1862,928,934
False,8417022,"Geislingen, Stadt",unter 3 Jahre,140,75,65
False,8417022,"Geislingen, Stadt",3 -  6 Jahre,148,83,65
False,8417022,"Geislingen, Stadt",6 - 10 Jahre,217,111,106
False,8417022,"Geislingen, Stadt",10 - 15 Jahre,385,209,176
False,8417022,"Geislingen, Stadt",15 - 18 Jahre,255,135,120
False,8417022,"Geislingen, Stadt",18 - 20 Jahre,166,81,85
False,8417022,"Geislingen, Stadt",20 - 25 Jahre,359,204,155
False,8417022,"Geislingen, Stadt",25 - 30 Jahre,279,142,137
False,8417022,"Geislingen, Stadt",30 - 35 Jahre,261,133,128
False,8417022,"Geislingen, Stadt",35 - 40 Jahre,330,156,174
False,8417022,"Geislingen, Stadt",40 - 45 Jahre,569,278,291
False,8417022,"Geislingen, Stadt",45 - 50 Jahre,587,321,266
False,8417022,"Geislingen, Stadt",50 - 55 Jahre,465,249,216
False,8417022,"Geislingen, Stadt",55 - 60 Jahre,366,190,176
False,8417022,"Geislingen, Stadt",60 - 65 Jahre,335,164,171
False,8417022,"Geislingen, Stadt",65 - 75 Jahre,628,300,328
False,8417022,"Geislingen, Stadt",75 und mehr Jahre,502,200,302
False,8417022,"Geislingen, Stadt",Insgesamt,5992,3031,2961
False,8417023,Grosselfingen,unter 3 Jahre,53,25,28
False,8417023,Grosselfingen,3 -  6 Jahre,60,40,20
False,8417023,Grosselfingen,6 - 10 Jahre,99,59,40
False,8417023,Grosselfingen,10 - 15 Jahre,129,63,66
False,8417023,Grosselfingen,15 - 18 Jahre,54,29,25
False,8417023,Grosselfingen,18 - 20 Jahre,60,29,31
False,8417023,Grosselfingen,20 - 25 Jahre,104,53,51
False,8417023,Grosselfingen,25 - 30 Jahre,96,53,43
False,8417023,Grosselfingen,30 - 35 Jahre,126,61,65
False,8417023,Grosselfingen,35 - 40 Jahre,134,70,64
False,8417023,Grosselfingen,40 - 45 Jahre,205,102,103
False,8417023,Grosselfingen,45 - 50 Jahre,182,92,90
False,8417023,Grosselfingen,50 - 55 Jahre,174,97,77
False,8417023,Grosselfingen,55 - 60 Jahre,127,62,65
False,8417023,Grosselfingen,60 - 65 Jahre,116,70,46
False,8417023,Grosselfingen,65 - 75 Jahre,183,81,102
False,8417023,Grosselfingen,75 und mehr Jahre,194,67,127
False,8417023,Grosselfingen,Insgesamt,2096,1053,1043
False,8417025,"Haigerloch, Stadt",unter 3 Jahre,247,138,109
False,8417025,"Haigerloch, Stadt",3 -  6 Jahre,271,141,130
False,8417025,"Haigerloch, Stadt",6 - 10 Jahre,427,223,204
False,8417025,"Haigerloch, Stadt",10 - 15 Jahre,679,350,329
False,8417025,"Haigerloch, Stadt",15 - 18 Jahre,427,211,216
False,8417025,"Haigerloch, Stadt",18 - 20 Jahre,299,142,157
False,8417025,"Haigerloch, Stadt",20 - 25 Jahre,640,347,293
False,8417025,"Haigerloch, Stadt",25 - 30 Jahre,484,248,236
False,8417025,"Haigerloch, Stadt",30 - 35 Jahre,569,290,279
False,8417025,"Haigerloch, Stadt",35 - 40 Jahre,665,322,343
False,8417025,"Haigerloch, Stadt",40 - 45 Jahre,954,486,468
False,8417025,"Haigerloch, Stadt",45 - 50 Jahre,1033,529,504
False,8417025,"Haigerloch, Stadt",50 - 55 Jahre,871,461,410
False,8417025,"Haigerloch, Stadt",55 - 60 Jahre,642,332,310
False,8417025,"Haigerloch, Stadt",60 - 65 Jahre,616,306,310
False,8417025,"Haigerloch, Stadt",65 - 75 Jahre,1083,500,583
False,8417025,"Haigerloch, Stadt",75 und mehr Jahre,850,342,508
False,8417025,"Haigerloch, Stadt",Insgesamt,10757,5368,5389
False,8417029,Hausen am Tann,unter 3 Jahre,13,5,8
False,8417029,Hausen am Tann,3 -  6 Jahre,14,9,5
False,8417029,Hausen am Tann,6 - 10 Jahre,15,6,9
False,8417029,Hausen am Tann,10 - 15 Jahre,25,9,16
False,8417029,Hausen am Tann,15 - 18 Jahre,19,9,10
False,8417029,Hausen am Tann,18 - 20 Jahre,13,5,8
False,8417029,Hausen am Tann,20 - 25 Jahre,28,15,13
False,8417029,Hausen am Tann,25 - 30 Jahre,29,16,13
False,8417029,Hausen am Tann,30 - 35 Jahre,35,14,21
False,8417029,Hausen am Tann,35 - 40 Jahre,29,17,12
False,8417029,Hausen am Tann,40 - 45 Jahre,24,15,9
False,8417029,Hausen am Tann,45 - 50 Jahre,51,26,25
False,8417029,Hausen am Tann,50 - 55 Jahre,53,27,26
False,8417029,Hausen am Tann,55 - 60 Jahre,32,15,17
False,8417029,Hausen am Tann,60 - 65 Jahre,28,16,12
False,8417029,Hausen am Tann,65 - 75 Jahre,38,24,14
False,8417029,Hausen am Tann,75 und mehr Jahre,46,17,29
False,8417029,Hausen am Tann,Insgesamt,492,245,247
False,8417031,"Hechingen, Stadt",unter 3 Jahre,477,228,249
False,8417031,"Hechingen, Stadt",3 -  6 Jahre,479,229,250
False,8417031,"Hechingen, Stadt",6 - 10 Jahre,749,392,357
False,8417031,"Hechingen, Stadt",10 - 15 Jahre,995,521,474
False,8417031,"Hechingen, Stadt",15 - 18 Jahre,698,340,358
False,8417031,"Hechingen, Stadt",18 - 20 Jahre,492,242,250
False,8417031,"Hechingen, Stadt",20 - 25 Jahre,1194,635,559
False,8417031,"Hechingen, Stadt",25 - 30 Jahre,1100,551,549
False,8417031,"Hechingen, Stadt",30 - 35 Jahre,1051,548,503
False,8417031,"Hechingen, Stadt",35 - 40 Jahre,1155,607,548
False,8417031,"Hechingen, Stadt",40 - 45 Jahre,1356,644,712
False,8417031,"Hechingen, Stadt",45 - 50 Jahre,1612,790,822
False,8417031,"Hechingen, Stadt",50 - 55 Jahre,1526,789,737
False,8417031,"Hechingen, Stadt",55 - 60 Jahre,1352,679,673
False,8417031,"Hechingen, Stadt",60 - 65 Jahre,1028,521,507
False,8417031,"Hechingen, Stadt",65 - 75 Jahre,2002,945,1057
False,8417031,"Hechingen, Stadt",75 und mehr Jahre,1823,663,1160
False,8417031,"Hechingen, Stadt",Insgesamt,19089,9324,9765
False,8417036,Jungingen,unter 3 Jahre,45,26,19
False,8417036,Jungingen,3 -  6 Jahre,28,16,12
False,8417036,Jungingen,6 - 10 Jahre,48,21,27
False,8417036,Jungingen,10 - 15 Jahre,72,44,28
False,8417036,Jungingen,15 - 18 Jahre,44,24,20
False,8417036,Jungingen,18 - 20 Jahre,30,17,13
False,8417036,Jungingen,20 - 25 Jahre,69,30,39
False,8417036,Jungingen,25 - 30 Jahre,55,32,23
False,8417036,Jungingen,30 - 35 Jahre,74,39,35
False,8417036,Jungingen,35 - 40 Jahre,80,35,45
False,8417036,Jungingen,40 - 45 Jahre,107,51,56
False,8417036,Jungingen,45 - 50 Jahre,118,60,58
False,8417036,Jungingen,50 - 55 Jahre,118,60,58
False,8417036,Jungingen,55 - 60 Jahre,98,42,56
False,8417036,Jungingen,60 - 65 Jahre,98,43,55
False,8417036,Jungingen,65 - 75 Jahre,167,86,81
False,8417036,Jungingen,75 und mehr Jahre,165,64,101
False,8417036,Jungingen,Insgesamt,1416,690,726
False,8417044,"Meßstetten, Stadt",unter 3 Jahre,242,128,114
False,8417044,"Meßstetten, Stadt",3 -  6 Jahre,270,146,124
False,8417044,"Meßstetten, Stadt",6 - 10 Jahre,355,173,182
False,8417044,"Meßstetten, Stadt",10 - 15 Jahre,562,303,259
False,8417044,"Meßstetten, Stadt",15 - 18 Jahre,405,203,202
False,8417044,"Meßstetten, Stadt",18 - 20 Jahre,276,132,144
False,8417044,"Meßstetten, Stadt",20 - 25 Jahre,632,340,292
False,8417044,"Meßstetten, Stadt",25 - 30 Jahre,584,312,272
False,8417044,"Meßstetten, Stadt",30 - 35 Jahre,594,305,289
False,8417044,"Meßstetten, Stadt",35 - 40 Jahre,605,288,317
False,8417044,"Meßstetten, Stadt",40 - 45 Jahre,782,412,370
False,8417044,"Meßstetten, Stadt",45 - 50 Jahre,1027,545,482
False,8417044,"Meßstetten, Stadt",50 - 55 Jahre,903,462,441
False,8417044,"Meßstetten, Stadt",55 - 60 Jahre,723,371,352
False,8417044,"Meßstetten, Stadt",60 - 65 Jahre,560,283,277
False,8417044,"Meßstetten, Stadt",65 - 75 Jahre,1081,510,571
False,8417044,"Meßstetten, Stadt",75 und mehr Jahre,871,349,522
False,8417044,"Meßstetten, Stadt",Insgesamt,10472,5262,5210
False,8417045,Nusplingen,unter 3 Jahre,51,28,23
False,8417045,Nusplingen,3 -  6 Jahre,52,27,25
False,8417045,Nusplingen,6 - 10 Jahre,84,45,39
False,8417045,Nusplingen,10 - 15 Jahre,91,46,45
False,8417045,Nusplingen,15 - 18 Jahre,62,34,28
False,8417045,Nusplingen,18 - 20 Jahre,46,27,19
False,8417045,Nusplingen,20 - 25 Jahre,116,56,60
False,8417045,Nusplingen,25 - 30 Jahre,82,47,35
False,8417045,Nusplingen,30 - 35 Jahre,83,40,43
False,8417045,Nusplingen,35 - 40 Jahre,116,57,59
False,8417045,Nusplingen,40 - 45 Jahre,126,62,64
False,8417045,Nusplingen,45 - 50 Jahre,163,84,79
False,8417045,Nusplingen,50 - 55 Jahre,161,86,75
False,8417045,Nusplingen,55 - 60 Jahre,106,56,50
False,8417045,Nusplingen,60 - 65 Jahre,91,43,48
False,8417045,Nusplingen,65 - 75 Jahre,211,98,113
False,8417045,Nusplingen,75 und mehr Jahre,169,63,106
False,8417045,Nusplingen,Insgesamt,1810,899,911
False,8417047,Obernheim,unter 3 Jahre,23,10,13
False,8417047,Obernheim,3 -  6 Jahre,37,17,20
False,8417047,Obernheim,6 - 10 Jahre,64,33,31
False,8417047,Obernheim,10 - 15 Jahre,111,51,60
False,8417047,Obernheim,15 - 18 Jahre,57,27,30
False,8417047,Obernheim,18 - 20 Jahre,40,22,18
False,8417047,Obernheim,20 - 25 Jahre,78,42,36
False,8417047,Obernheim,25 - 30 Jahre,46,20,26
False,8417047,Obernheim,30 - 35 Jahre,62,31,31
False,8417047,Obernheim,35 - 40 Jahre,87,48,39
False,8417047,Obernheim,40 - 45 Jahre,118,59,59
False,8417047,Obernheim,45 - 50 Jahre,128,63,65
False,8417047,Obernheim,50 - 55 Jahre,108,57,51
False,8417047,Obernheim,55 - 60 Jahre,100,53,47
False,8417047,Obernheim,60 - 65 Jahre,91,45,46
False,8417047,Obernheim,65 - 75 Jahre,143,68,75
False,8417047,Obernheim,75 und mehr Jahre,139,61,78
False,8417047,Obernheim,Insgesamt,1432,707,725
False,8417051,Rangendingen,unter 3 Jahre,124,59,65
False,8417051,Rangendingen,3 -  6 Jahre,149,77,72
False,8417051,Rangendingen,6 - 10 Jahre,210,112,98
False,8417051,Rangendingen,10 - 15 Jahre,299,160,139
False,8417051,Rangendingen,15 - 18 Jahre,189,88,101
False,8417051,Rangendingen,18 - 20 Jahre,123,55,68
False,8417051,Rangendingen,20 - 25 Jahre,300,154,146
False,8417051,Rangendingen,25 - 30 Jahre,320,161,159
False,8417051,Rangendingen,30 - 35 Jahre,308,151,157
False,8417051,Rangendingen,35 - 40 Jahre,352,174,178
False,8417051,Rangendingen,40 - 45 Jahre,409,212,197
False,8417051,Rangendingen,45 - 50 Jahre,454,227,227
False,8417051,Rangendingen,50 - 55 Jahre,391,181,210
False,8417051,Rangendingen,55 - 60 Jahre,363,169,194
False,8417051,Rangendingen,60 - 65 Jahre,321,161,160
False,8417051,Rangendingen,65 - 75 Jahre,533,277,256
False,8417051,Rangendingen,75 und mehr Jahre,358,132,226
False,8417051,Rangendingen,Insgesamt,5203,2550,2653
False,8417052,Ratshausen,unter 3 Jahre,16,9,7
False,8417052,Ratshausen,3 -  6 Jahre,20,10,10
False,8417052,Ratshausen,6 - 10 Jahre,28,11,17
False,8417052,Ratshausen,10 - 15 Jahre,33,12,21
False,8417052,Ratshausen,15 - 18 Jahre,38,19,19
False,8417052,Ratshausen,18 - 20 Jahre,26,13,13
False,8417052,Ratshausen,20 - 25 Jahre,30,15,15
False,8417052,Ratshausen,25 - 30 Jahre,35,16,19
False,8417052,Ratshausen,30 - 35 Jahre,33,19,14
False,8417052,Ratshausen,35 - 40 Jahre,41,17,24
False,8417052,Ratshausen,40 - 45 Jahre,67,42,25
False,8417052,Ratshausen,45 - 50 Jahre,62,30,32
False,8417052,Ratshausen,50 - 55 Jahre,56,33,23
False,8417052,Ratshausen,55 - 60 Jahre,41,21,20
False,8417052,Ratshausen,60 - 65 Jahre,58,26,32
False,8417052,Ratshausen,65 - 75 Jahre,88,44,44
False,8417052,Ratshausen,75 und mehr Jahre,96,24,72
False,8417052,Ratshausen,Insgesamt,768,361,407
False,8417054,"Rosenfeld, Stadt",unter 3 Jahre,162,95,67
False,8417054,"Rosenfeld, Stadt",3 -  6 Jahre,201,102,99
False,8417054,"Rosenfeld, Stadt",6 - 10 Jahre,309,166,143
False,8417054,"Rosenfeld, Stadt",10 - 15 Jahre,410,206,204
False,8417054,"Rosenfeld, Stadt",15 - 18 Jahre,281,137,144
False,8417054,"Rosenfeld, Stadt",18 - 20 Jahre,150,77,73
False,8417054,"Rosenfeld, Stadt",20 - 25 Jahre,401,213,188
False,8417054,"Rosenfeld, Stadt",25 - 30 Jahre,295,161,134
False,8417054,"Rosenfeld, Stadt",30 - 35 Jahre,321,163,158
False,8417054,"Rosenfeld, Stadt",35 - 40 Jahre,403,201,202
False,8417054,"Rosenfeld, Stadt",40 - 45 Jahre,550,271,279
False,8417054,"Rosenfeld, Stadt",45 - 50 Jahre,575,317,258
False,8417054,"Rosenfeld, Stadt",50 - 55 Jahre,483,244,239
False,8417054,"Rosenfeld, Stadt",55 - 60 Jahre,390,204,186
False,8417054,"Rosenfeld, Stadt",60 - 65 Jahre,323,156,167
False,8417054,"Rosenfeld, Stadt",65 - 75 Jahre,686,330,356
False,8417054,"Rosenfeld, Stadt",75 und mehr Jahre,519,206,313
False,8417054,"Rosenfeld, Stadt",Insgesamt,6459,3249,3210
False,8417057,"Schömberg, Stadt",unter 3 Jahre,134,70,64
False,8417057,"Schömberg, Stadt",3 -  6 Jahre,120,65,55
False,8417057,"Schömberg, Stadt",6 - 10 Jahre,178,101,77
False,8417057,"Schömberg, Stadt",10 - 15 Jahre,283,139,144
False,8417057,"Schömberg, Stadt",15 - 18 Jahre,214,108,106
False,8417057,"Schömberg, Stadt",18 - 20 Jahre,123,64,59
False,8417057,"Schömberg, Stadt",20 - 25 Jahre,278,151,127
False,8417057,"Schömberg, Stadt",25 - 30 Jahre,301,156,145
False,8417057,"Schömberg, Stadt",30 - 35 Jahre,233,133,100
False,8417057,"Schömberg, Stadt",35 - 40 Jahre,306,165,141
False,8417057,"Schömberg, Stadt",40 - 45 Jahre,378,212,166
False,8417057,"Schömberg, Stadt",45 - 50 Jahre,405,207,198
False,8417057,"Schömberg, Stadt",50 - 55 Jahre,350,179,171
False,8417057,"Schömberg, Stadt",55 - 60 Jahre,279,147,132
False,8417057,"Schömberg, Stadt",60 - 65 Jahre,263,133,130
False,8417057,"Schömberg, Stadt",65 - 75 Jahre,426,216,210
False,8417057,"Schömberg, Stadt",75 und mehr Jahre,371,147,224
False,8417057,"Schömberg, Stadt",Insgesamt,4642,2393,2249
False,8417063,Straßberg,unter 3 Jahre,54,29,25
False,8417063,Straßberg,3 -  6 Jahre,66,33,33
False,8417063,Straßberg,6 - 10 Jahre,93,50,43
False,8417063,Straßberg,10 - 15 Jahre,129,66,63
False,8417063,Straßberg,15 - 18 Jahre,96,50,46
False,8417063,Straßberg,18 - 20 Jahre,69,43,26
False,8417063,Straßberg,20 - 25 Jahre,171,107,64
False,8417063,Straßberg,25 - 30 Jahre,130,71,59
False,8417063,Straßberg,30 - 35 Jahre,106,48,58
False,8417063,Straßberg,35 - 40 Jahre,152,70,82
False,8417063,Straßberg,40 - 45 Jahre,196,83,113
False,8417063,Straßberg,45 - 50 Jahre,252,121,131
False,8417063,Straßberg,50 - 55 Jahre,196,106,90
False,8417063,Straßberg,55 - 60 Jahre,178,83,95
False,8417063,Straßberg,60 - 65 Jahre,165,88,77
False,8417063,Straßberg,65 - 75 Jahre,284,136,148
False,8417063,Straßberg,75 und mehr Jahre,261,96,165
False,8417063,Straßberg,Insgesamt,2598,1280,1318
False,8417071,Weilen unter den Rinnen,unter 3 Jahre,14,6,8
False,8417071,Weilen unter den Rinnen,3 -  6 Jahre,19,7,12
False,8417071,Weilen unter den Rinnen,6 - 10 Jahre,37,19,18
False,8417071,Weilen unter den Rinnen,10 - 15 Jahre,55,32,23
False,8417071,Weilen unter den Rinnen,15 - 18 Jahre,32,14,18
False,8417071,Weilen unter den Rinnen,18 - 20 Jahre,18,9,9
False,8417071,Weilen unter den Rinnen,20 - 25 Jahre,37,18,19
False,8417071,Weilen unter den Rinnen,25 - 30 Jahre,17,8,9
False,8417071,Weilen unter den Rinnen,30 - 35 Jahre,26,11,15
False,8417071,Weilen unter den Rinnen,35 - 40 Jahre,45,19,26
False,8417071,Weilen unter den Rinnen,40 - 45 Jahre,66,32,34
False,8417071,Weilen unter den Rinnen,45 - 50 Jahre,69,36,33
False,8417071,Weilen unter den Rinnen,50 - 55 Jahre,59,35,24
False,8417071,Weilen unter den Rinnen,55 - 60 Jahre,36,19,17
False,8417071,Weilen unter den Rinnen,60 - 65 Jahre,27,15,12
False,8417071,Weilen unter den Rinnen,65 - 75 Jahre,39,17,22
False,8417071,Weilen unter den Rinnen,75 und mehr Jahre,31,11,20
False,8417071,Weilen unter den Rinnen,Insgesamt,627,308,319
False,8417075,Winterlingen,unter 3 Jahre,151,77,74
False,8417075,Winterlingen,3 -  6 Jahre,182,91,91
False,8417075,Winterlingen,6 - 10 Jahre,240,125,115
False,8417075,Winterlingen,10 - 15 Jahre,353,187,166
False,8417075,Winterlingen,15 - 18 Jahre,237,135,102
False,8417075,Winterlingen,18 - 20 Jahre,174,90,84
False,8417075,Winterlingen,20 - 25 Jahre,392,211,181
False,8417075,Winterlingen,25 - 30 Jahre,340,164,176
False,8417075,Winterlingen,30 - 35 Jahre,288,144,144
False,8417075,Winterlingen,35 - 40 Jahre,340,193,147
False,8417075,Winterlingen,40 - 45 Jahre,530,275,255
False,8417075,Winterlingen,45 - 50 Jahre,565,289,276
False,8417075,Winterlingen,50 - 55 Jahre,509,268,241
False,8417075,Winterlingen,55 - 60 Jahre,428,207,221
False,8417075,Winterlingen,60 - 65 Jahre,361,184,177
False,8417075,Winterlingen,65 - 75 Jahre,690,329,361
False,8417075,Winterlingen,75 und mehr Jahre,693,263,430
False,8417075,Winterlingen,Insgesamt,6473,3232,3241
False,8417078,Zimmern unter der Burg,unter 3 Jahre,11,9,2
False,8417078,Zimmern unter der Burg,3 -  6 Jahre,11,5,6
False,8417078,Zimmern unter der Burg,6 - 10 Jahre,22,12,10
False,8417078,Zimmern unter der Burg,10 - 15 Jahre,36,12,24
False,8417078,Zimmern unter der Burg,15 - 18 Jahre,18,11,7
False,8417078,Zimmern unter der Burg,18 - 20 Jahre,25,17,8
False,8417078,Zimmern unter der Burg,20 - 25 Jahre,30,20,10
False,8417078,Zimmern unter der Burg,25 - 30 Jahre,14,6,8
False,8417078,Zimmern unter der Burg,30 - 35 Jahre,19,12,7
False,8417078,Zimmern unter der Burg,35 - 40 Jahre,27,15,12
False,8417078,Zimmern unter der Burg,40 - 45 Jahre,45,25,20
False,8417078,Zimmern unter der Burg,45 - 50 Jahre,31,13,18
False,8417078,Zimmern unter der Burg,50 - 55 Jahre,43,22,21
False,8417078,Zimmern unter der Burg,55 - 60 Jahre,24,11,13
False,8417078,Zimmern unter der Burg,60 - 65 Jahre,30,18,12
False,8417078,Zimmern unter der Burg,65 - 75 Jahre,45,23,22
False,8417078,Zimmern unter der Burg,75 und mehr Jahre,45,14,31
False,8417078,Zimmern unter der Burg,Insgesamt,476,245,231
False,8417079,"Albstadt, Stadt",unter 3 Jahre,970,503,467
False,8417079,"Albstadt, Stadt",3 -  6 Jahre,1075,536,539
False,8417079,"Albstadt, Stadt",6 - 10 Jahre,1451,737,714
False,8417079,"Albstadt, Stadt",10 - 15 Jahre,2146,1128,1018
False,8417079,"Albstadt, Stadt",15 - 18 Jahre,1493,752,741
False,8417079,"Albstadt, Stadt",18 - 20 Jahre,1024,517,507
False,8417079,"Albstadt, Stadt",20 - 25 Jahre,2768,1463,1305
False,8417079,"Albstadt, Stadt",25 - 30 Jahre,2569,1361,1208
False,8417079,"Albstadt, Stadt",30 - 35 Jahre,2210,1134,1076
False,8417079,"Albstadt, Stadt",35 - 40 Jahre,2539,1257,1282
False,8417079,"Albstadt, Stadt",40 - 45 Jahre,3385,1765,1620
False,8417079,"Albstadt, Stadt",45 - 50 Jahre,3828,1969,1859
False,8417079,"Albstadt, Stadt",50 - 55 Jahre,3312,1673,1639
False,8417079,"Albstadt, Stadt",55 - 60 Jahre,3023,1465,1558
False,8417079,"Albstadt, Stadt",60 - 65 Jahre,2574,1278,1296
False,8417079,"Albstadt, Stadt",65 - 75 Jahre,5520,2574,2946
False,8417079,"Albstadt, Stadt",75 und mehr Jahre,5087,1885,3202
False,8417079,"Albstadt, Stadt",Insgesamt,44974,21997,22977
False,8421,Stadtkreis Ulm,unter 3 Jahre,3354,1728,1626
False,8421,Stadtkreis Ulm,3 -  6 Jahre,3160,1551,1609
False,8421,Stadtkreis Ulm,6 - 10 Jahre,4113,2140,1973
False,8421,Stadtkreis Ulm,10 - 15 Jahre,5459,2797,2662
False,8421,Stadtkreis Ulm,15 - 18 Jahre,3315,1677,1638
False,8421,Stadtkreis Ulm,18 - 20 Jahre,2565,1280,1285
False,8421,Stadtkreis Ulm,20 - 25 Jahre,9119,4552,4567
False,8421,Stadtkreis Ulm,25 - 30 Jahre,10008,5029,4979
False,8421,Stadtkreis Ulm,30 - 35 Jahre,9287,4720,4567
False,8421,Stadtkreis Ulm,35 - 40 Jahre,8571,4504,4067
False,8421,Stadtkreis Ulm,40 - 45 Jahre,9535,5105,4430
False,8421,Stadtkreis Ulm,45 - 50 Jahre,9585,4956,4629
False,8421,Stadtkreis Ulm,50 - 55 Jahre,8321,4130,4191
False,8421,Stadtkreis Ulm,55 - 60 Jahre,7189,3433,3756
False,8421,Stadtkreis Ulm,60 - 65 Jahre,6605,3248,3357
False,8421,Stadtkreis Ulm,65 - 75 Jahre,12297,5854,6443
False,8421,Stadtkreis Ulm,75 und mehr Jahre,10318,3776,6542
False,8421,Stadtkreis Ulm,Insgesamt,122801,60480,62321
False,8421000,"Ulm, Universitätsstadt",unter 3 Jahre,3354,1728,1626
False,8421000,"Ulm, Universitätsstadt",3 -  6 Jahre,3160,1551,1609
False,8421000,"Ulm, Universitätsstadt",6 - 10 Jahre,4113,2140,1973
False,8421000,"Ulm, Universitätsstadt",10 - 15 Jahre,5459,2797,2662
False,8421000,"Ulm, Universitätsstadt",15 - 18 Jahre,3315,1677,1638
False,8421000,"Ulm, Universitätsstadt",18 - 20 Jahre,2565,1280,1285
False,8421000,"Ulm, Universitätsstadt",20 - 25 Jahre,9119,4552,4567
False,8421000,"Ulm, Universitätsstadt",25 - 30 Jahre,10008,5029,4979
False,8421000,"Ulm, Universitätsstadt",30 - 35 Jahre,9287,4720,4567
False,8421000,"Ulm, Universitätsstadt",35 - 40 Jahre,8571,4504,4067
False,8421000,"Ulm, Universitätsstadt",40 - 45 Jahre,9535,5105,4430
False,8421000,"Ulm, Universitätsstadt",45 - 50 Jahre,9585,4956,4629
False,8421000,"Ulm, Universitätsstadt",50 - 55 Jahre,8321,4130,4191
False,8421000,"Ulm, Universitätsstadt",55 - 60 Jahre,7189,3433,3756
False,8421000,"Ulm, Universitätsstadt",60 - 65 Jahre,6605,3248,3357
False,8421000,"Ulm, Universitätsstadt",65 - 75 Jahre,12297,5854,6443
False,8421000,"Ulm, Universitätsstadt",75 und mehr Jahre,10318,3776,6542
False,8421000,"Ulm, Universitätsstadt",Insgesamt,122801,60480,62321
False,8425,Landkreis Alb-Donau-Kreis,unter 3 Jahre,5066,2641,2425
False,8425,Landkreis Alb-Donau-Kreis,3 -  6 Jahre,5468,2809,2659
False,8425,Landkreis Alb-Donau-Kreis,6 - 10 Jahre,8000,4129,3871
False,8425,Landkreis Alb-Donau-Kreis,10 - 15 Jahre,11598,5864,5734
False,8425,Landkreis Alb-Donau-Kreis,15 - 18 Jahre,6954,3598,3356
False,8425,Landkreis Alb-Donau-Kreis,18 - 20 Jahre,4946,2595,2351
False,8425,Landkreis Alb-Donau-Kreis,20 - 25 Jahre,11490,5971,5519
False,8425,Landkreis Alb-Donau-Kreis,25 - 30 Jahre,10660,5546,5114
False,8425,Landkreis Alb-Donau-Kreis,30 - 35 Jahre,10854,5532,5322
False,8425,Landkreis Alb-Donau-Kreis,35 - 40 Jahre,11921,6003,5918
False,8425,Landkreis Alb-Donau-Kreis,40 - 45 Jahre,15614,7969,7645
False,8425,Landkreis Alb-Donau-Kreis,45 - 50 Jahre,16446,8582,7864
False,8425,Landkreis Alb-Donau-Kreis,50 - 55 Jahre,14304,7246,7058
False,8425,Landkreis Alb-Donau-Kreis,55 - 60 Jahre,12043,6203,5840
False,8425,Landkreis Alb-Donau-Kreis,60 - 65 Jahre,9914,5066,4848
False,8425,Landkreis Alb-Donau-Kreis,65 - 75 Jahre,18727,9050,9677
False,8425,Landkreis Alb-Donau-Kreis,75 und mehr Jahre,15665,6065,9600
False,8425,Landkreis Alb-Donau-Kreis,Insgesamt,189670,94869,94801
False,8425002,Allmendingen,unter 3 Jahre,101,47,54
False,8425002,Allmendingen,3 -  6 Jahre,85,41,44
False,8425002,Allmendingen,6 - 10 Jahre,233,126,107
False,8425002,Allmendingen,10 - 15 Jahre,297,138,159
False,8425002,Allmendingen,15 - 18 Jahre,161,81,80
False,8425002,Allmendingen,18 - 20 Jahre,128,66,62
False,8425002,Allmendingen,20 - 25 Jahre,311,169,142
False,8425002,Allmendingen,25 - 30 Jahre,221,117,104
False,8425002,Allmendingen,30 - 35 Jahre,220,104,116
False,8425002,Allmendingen,35 - 40 Jahre,261,128,133
False,8425002,Allmendingen,40 - 45 Jahre,345,172,173
False,8425002,Allmendingen,45 - 50 Jahre,384,215,169
False,8425002,Allmendingen,50 - 55 Jahre,343,173,170
False,8425002,Allmendingen,55 - 60 Jahre,286,161,125
False,8425002,Allmendingen,60 - 65 Jahre,230,109,121
False,8425002,Allmendingen,65 - 75 Jahre,471,236,235
False,8425002,Allmendingen,75 und mehr Jahre,364,138,226
False,8425002,Allmendingen,Insgesamt,4441,2221,2220
False,8425004,Altheim,unter 3 Jahre,23,17,6
False,8425004,Altheim,3 -  6 Jahre,15,8,7
False,8425004,Altheim,6 - 10 Jahre,21,8,13
False,8425004,Altheim,10 - 15 Jahre,61,35,26
False,8425004,Altheim,15 - 18 Jahre,26,14,12
False,8425004,Altheim,18 - 20 Jahre,16,12,4
False,8425004,Altheim,20 - 25 Jahre,44,20,24
False,8425004,Altheim,25 - 30 Jahre,29,11,18
False,8425004,Altheim,30 - 35 Jahre,40,23,17
False,8425004,Altheim,35 - 40 Jahre,40,22,18
False,8425004,Altheim,40 - 45 Jahre,41,21,20
False,8425004,Altheim,45 - 50 Jahre,46,30,16
False,8425004,Altheim,50 - 55 Jahre,25,12,13
False,8425004,Altheim,55 - 60 Jahre,40,19,21
False,8425004,Altheim,60 - 65 Jahre,35,14,21
False,8425004,Altheim,65 - 75 Jahre,55,25,30
False,8425004,Altheim,75 und mehr Jahre,25,10,15
False,8425004,Altheim,Insgesamt,582,301,281
False,8425005,Altheim (Alb),unter 3 Jahre,37,15,22
False,8425005,Altheim (Alb),3 -  6 Jahre,44,21,23
False,8425005,Altheim (Alb),6 - 10 Jahre,72,41,31
False,8425005,Altheim (Alb),10 - 15 Jahre,113,58,55
False,8425005,Altheim (Alb),15 - 18 Jahre,81,44,37
False,8425005,Altheim (Alb),18 - 20 Jahre,49,33,16
False,8425005,Altheim (Alb),20 - 25 Jahre,101,54,47
False,8425005,Altheim (Alb),25 - 30 Jahre,105,59,46
False,8425005,Altheim (Alb),30 - 35 Jahre,83,41,42
False,8425005,Altheim (Alb),35 - 40 Jahre,100,58,42
False,8425005,Altheim (Alb),40 - 45 Jahre,144,68,76
False,8425005,Altheim (Alb),45 - 50 Jahre,153,84,69
False,8425005,Altheim (Alb),50 - 55 Jahre,144,71,73
False,8425005,Altheim (Alb),55 - 60 Jahre,99,53,46
False,8425005,Altheim (Alb),60 - 65 Jahre,102,53,49
False,8425005,Altheim (Alb),65 - 75 Jahre,153,74,79
False,8425005,Altheim (Alb),75 und mehr Jahre,181,82,99
False,8425005,Altheim (Alb),Insgesamt,1761,909,852
False,8425008,Amstetten,unter 3 Jahre,111,68,43
False,8425008,Amstetten,3 -  6 Jahre,114,63,51
False,8425008,Amstetten,6 - 10 Jahre,180,103,77
False,8425008,Amstetten,10 - 15 Jahre,294,152,142
False,8425008,Amstetten,15 - 18 Jahre,151,72,79
False,8425008,Amstetten,18 - 20 Jahre,87,48,39
False,8425008,Amstetten,20 - 25 Jahre,236,127,109
False,8425008,Amstetten,25 - 30 Jahre,211,115,96
False,8425008,Amstetten,30 - 35 Jahre,206,103,103
False,8425008,Amstetten,35 - 40 Jahre,237,121,116
False,8425008,Amstetten,40 - 45 Jahre,334,155,179
False,8425008,Amstetten,45 - 50 Jahre,327,181,146
False,8425008,Amstetten,50 - 55 Jahre,259,130,129
False,8425008,Amstetten,55 - 60 Jahre,275,133,142
False,8425008,Amstetten,60 - 65 Jahre,190,107,83
False,8425008,Amstetten,65 - 75 Jahre,405,196,209
False,8425008,Amstetten,75 und mehr Jahre,323,136,187
False,8425008,Amstetten,Insgesamt,3940,2010,1930
False,8425011,Asselfingen,unter 3 Jahre,22,9,13
False,8425011,Asselfingen,3 -  6 Jahre,28,13,15
False,8425011,Asselfingen,6 - 10 Jahre,48,26,22
False,8425011,Asselfingen,10 - 15 Jahre,70,34,36
False,8425011,Asselfingen,15 - 18 Jahre,42,25,17
False,8425011,Asselfingen,18 - 20 Jahre,35,22,13
False,8425011,Asselfingen,20 - 25 Jahre,60,28,32
False,8425011,Asselfingen,25 - 30 Jahre,57,29,28
False,8425011,Asselfingen,30 - 35 Jahre,48,25,23
False,8425011,Asselfingen,35 - 40 Jahre,49,25,24
False,8425011,Asselfingen,40 - 45 Jahre,83,40,43
False,8425011,Asselfingen,45 - 50 Jahre,109,67,42
False,8425011,Asselfingen,50 - 55 Jahre,88,48,40
False,8425011,Asselfingen,55 - 60 Jahre,72,38,34
False,8425011,Asselfingen,60 - 65 Jahre,42,20,22
False,8425011,Asselfingen,65 - 75 Jahre,85,48,37
False,8425011,Asselfingen,75 und mehr Jahre,73,30,43
False,8425011,Asselfingen,Insgesamt,1011,527,484
False,8425013,Ballendorf,unter 3 Jahre,17,9,8
False,8425013,Ballendorf,3 -  6 Jahre,26,14,12
False,8425013,Ballendorf,6 - 10 Jahre,28,15,13
False,8425013,Ballendorf,10 - 15 Jahre,36,15,21
False,8425013,Ballendorf,15 - 18 Jahre,26,10,16
False,8425013,Ballendorf,18 - 20 Jahre,17,9,8
False,8425013,Ballendorf,20 - 25 Jahre,42,22,20
False,8425013,Ballendorf,25 - 30 Jahre,26,17,9
False,8425013,Ballendorf,30 - 35 Jahre,36,14,22
False,8425013,Ballendorf,35 - 40 Jahre,35,18,17
False,8425013,Ballendorf,40 - 45 Jahre,58,31,27
False,8425013,Ballendorf,45 - 50 Jahre,52,29,23
False,8425013,Ballendorf,50 - 55 Jahre,49,27,22
False,8425013,Ballendorf,55 - 60 Jahre,45,21,24
False,8425013,Ballendorf,60 - 65 Jahre,18,10,8
False,8425013,Ballendorf,65 - 75 Jahre,69,32,37
False,8425013,Ballendorf,75 und mehr Jahre,84,33,51
False,8425013,Ballendorf,Insgesamt,664,326,338
False,8425014,Beimerstetten,unter 3 Jahre,74,40,34
False,8425014,Beimerstetten,3 -  6 Jahre,78,31,47
False,8425014,Beimerstetten,6 - 10 Jahre,132,69,63
False,8425014,Beimerstetten,10 - 15 Jahre,140,77,63
False,8425014,Beimerstetten,15 - 18 Jahre,91,43,48
False,8425014,Beimerstetten,18 - 20 Jahre,63,35,28
False,8425014,Beimerstetten,20 - 25 Jahre,158,82,76
False,8425014,Beimerstetten,25 - 30 Jahre,132,67,65
False,8425014,Beimerstetten,30 - 35 Jahre,156,65,91
False,8425014,Beimerstetten,35 - 40 Jahre,171,84,87
False,8425014,Beimerstetten,40 - 45 Jahre,205,109,96
False,8425014,Beimerstetten,45 - 50 Jahre,226,129,97
False,8425014,Beimerstetten,50 - 55 Jahre,187,93,94
False,8425014,Beimerstetten,55 - 60 Jahre,157,80,77
False,8425014,Beimerstetten,60 - 65 Jahre,117,62,55
False,8425014,Beimerstetten,65 - 75 Jahre,268,129,139
False,8425014,Beimerstetten,75 und mehr Jahre,171,57,114
False,8425014,Beimerstetten,Insgesamt,2526,1252,1274
False,8425017,Berghülen,unter 3 Jahre,45,22,23
False,8425017,Berghülen,3 -  6 Jahre,63,28,35
False,8425017,Berghülen,6 - 10 Jahre,93,46,47
False,8425017,Berghülen,10 - 15 Jahre,118,57,61
False,8425017,Berghülen,15 - 18 Jahre,86,49,37
False,8425017,Berghülen,18 - 20 Jahre,53,28,25
False,8425017,Berghülen,20 - 25 Jahre,135,71,64
False,8425017,Berghülen,25 - 30 Jahre,91,57,34
False,8425017,Berghülen,30 - 35 Jahre,97,52,45
False,8425017,Berghülen,35 - 40 Jahre,98,50,48
False,8425017,Berghülen,40 - 45 Jahre,150,78,72
False,8425017,Berghülen,45 - 50 Jahre,163,86,77
False,8425017,Berghülen,50 - 55 Jahre,172,86,86
False,8425017,Berghülen,55 - 60 Jahre,143,77,66
False,8425017,Berghülen,60 - 65 Jahre,100,54,46
False,8425017,Berghülen,65 - 75 Jahre,164,80,84
False,8425017,Berghülen,75 und mehr Jahre,130,54,76
False,8425017,Berghülen,Insgesamt,1901,975,926
False,8425019,Bernstadt,unter 3 Jahre,65,39,26
False,8425019,Bernstadt,3 -  6 Jahre,68,38,30
False,8425019,Bernstadt,6 - 10 Jahre,103,53,50
False,8425019,Bernstadt,10 - 15 Jahre,104,58,46
False,8425019,Bernstadt,15 - 18 Jahre,77,31,46
False,8425019,Bernstadt,18 - 20 Jahre,59,32,27
False,8425019,Bernstadt,20 - 25 Jahre,112,55,57
False,8425019,Bernstadt,25 - 30 Jahre,108,53,55
False,8425019,Bernstadt,30 - 35 Jahre,139,66,73
False,8425019,Bernstadt,35 - 40 Jahre,146,68,78
False,8425019,Bernstadt,40 - 45 Jahre,174,97,77
False,8425019,Bernstadt,45 - 50 Jahre,189,99,90
False,8425019,Bernstadt,50 - 55 Jahre,165,85,80
False,8425019,Bernstadt,55 - 60 Jahre,119,60,59
False,8425019,Bernstadt,60 - 65 Jahre,125,66,59
False,8425019,Bernstadt,65 - 75 Jahre,187,100,87
False,8425019,Bernstadt,75 und mehr Jahre,142,55,87
False,8425019,Bernstadt,Insgesamt,2082,1055,1027
False,8425020,"Blaubeuren, Stadt",unter 3 Jahre,323,160,163
False,8425020,"Blaubeuren, Stadt",3 -  6 Jahre,332,178,154
False,8425020,"Blaubeuren, Stadt",6 - 10 Jahre,464,248,216
False,8425020,"Blaubeuren, Stadt",10 - 15 Jahre,775,390,385
False,8425020,"Blaubeuren, Stadt",15 - 18 Jahre,465,238,227
False,8425020,"Blaubeuren, Stadt",18 - 20 Jahre,313,156,157
False,8425020,"Blaubeuren, Stadt",20 - 25 Jahre,691,342,349
False,8425020,"Blaubeuren, Stadt",25 - 30 Jahre,599,312,287
False,8425020,"Blaubeuren, Stadt",30 - 35 Jahre,635,299,336
False,8425020,"Blaubeuren, Stadt",35 - 40 Jahre,717,382,335
False,8425020,"Blaubeuren, Stadt",40 - 45 Jahre,940,505,435
False,8425020,"Blaubeuren, Stadt",45 - 50 Jahre,967,523,444
False,8425020,"Blaubeuren, Stadt",50 - 55 Jahre,850,423,427
False,8425020,"Blaubeuren, Stadt",55 - 60 Jahre,716,375,341
False,8425020,"Blaubeuren, Stadt",60 - 65 Jahre,602,291,311
False,8425020,"Blaubeuren, Stadt",65 - 75 Jahre,1266,587,679
False,8425020,"Blaubeuren, Stadt",75 und mehr Jahre,1160,423,737
False,8425020,"Blaubeuren, Stadt",Insgesamt,11815,5832,5983
False,8425022,Börslingen,unter 3 Jahre,7,4,3
False,8425022,Börslingen,3 -  6 Jahre,4,2,2
False,8425022,Börslingen,6 - 10 Jahre,10,6,4
False,8425022,Börslingen,10 - 15 Jahre,10,2,8
False,8425022,Börslingen,15 - 18 Jahre,8,4,4
False,8425022,Börslingen,18 - 20 Jahre,5,2,3
False,8425022,Börslingen,20 - 25 Jahre,10,5,5
False,8425022,Börslingen,25 - 30 Jahre,9,7,2
False,8425022,Börslingen,30 - 35 Jahre,19,8,11
False,8425022,Börslingen,35 - 40 Jahre,11,7,4
False,8425022,Börslingen,40 - 45 Jahre,12,6,6
False,8425022,Börslingen,45 - 50 Jahre,13,6,7
False,8425022,Börslingen,50 - 55 Jahre,11,4,7
False,8425022,Börslingen,55 - 60 Jahre,11,7,4
False,8425022,Börslingen,60 - 65 Jahre,11,7,4
False,8425022,Börslingen,65 - 75 Jahre,14,8,6
False,8425022,Börslingen,75 und mehr Jahre,13,6,7
False,8425022,Börslingen,Insgesamt,178,91,87
False,8425024,Breitingen,unter 3 Jahre,8,6,2
False,8425024,Breitingen,3 -  6 Jahre,4,1,3
False,8425024,Breitingen,6 - 10 Jahre,12,5,7
False,8425024,Breitingen,10 - 15 Jahre,8,4,4
False,8425024,Breitingen,15 - 18 Jahre,8,4,4
False,8425024,Breitingen,18 - 20 Jahre,11,3,8
False,8425024,Breitingen,20 - 25 Jahre,20,7,13
False,8425024,Breitingen,25 - 30 Jahre,16,13,3
False,8425024,Breitingen,30 - 35 Jahre,15,6,9
False,8425024,Breitingen,35 - 40 Jahre,16,13,3
False,8425024,Breitingen,40 - 45 Jahre,17,9,8
False,8425024,Breitingen,45 - 50 Jahre,29,13,16
False,8425024,Breitingen,50 - 55 Jahre,26,14,12
False,8425024,Breitingen,55 - 60 Jahre,23,10,13
False,8425024,Breitingen,60 - 65 Jahre,15,8,7
False,8425024,Breitingen,65 - 75 Jahre,17,10,7
False,8425024,Breitingen,75 und mehr Jahre,17,8,9
False,8425024,Breitingen,Insgesamt,262,134,128
False,8425028,"Dietenheim, Stadt",unter 3 Jahre,181,94,87
False,8425028,"Dietenheim, Stadt",3 -  6 Jahre,176,89,87
False,8425028,"Dietenheim, Stadt",6 - 10 Jahre,252,120,132
False,8425028,"Dietenheim, Stadt",10 - 15 Jahre,360,182,178
False,8425028,"Dietenheim, Stadt",15 - 18 Jahre,257,141,116
False,8425028,"Dietenheim, Stadt",18 - 20 Jahre,167,83,84
False,8425028,"Dietenheim, Stadt",20 - 25 Jahre,455,246,209
False,8425028,"Dietenheim, Stadt",25 - 30 Jahre,398,209,189
False,8425028,"Dietenheim, Stadt",30 - 35 Jahre,355,183,172
False,8425028,"Dietenheim, Stadt",35 - 40 Jahre,389,200,189
False,8425028,"Dietenheim, Stadt",40 - 45 Jahre,477,252,225
False,8425028,"Dietenheim, Stadt",45 - 50 Jahre,551,267,284
False,8425028,"Dietenheim, Stadt",50 - 55 Jahre,549,276,273
False,8425028,"Dietenheim, Stadt",55 - 60 Jahre,393,205,188
False,8425028,"Dietenheim, Stadt",60 - 65 Jahre,328,164,164
False,8425028,"Dietenheim, Stadt",65 - 75 Jahre,625,288,337
False,8425028,"Dietenheim, Stadt",75 und mehr Jahre,675,239,436
False,8425028,"Dietenheim, Stadt",Insgesamt,6588,3238,3350
False,8425031,Dornstadt,unter 3 Jahre,230,122,108
False,8425031,Dornstadt,3 -  6 Jahre,220,101,119
False,8425031,Dornstadt,6 - 10 Jahre,332,169,163
False,8425031,Dornstadt,10 - 15 Jahre,474,254,220
False,8425031,Dornstadt,15 - 18 Jahre,289,145,144
False,8425031,Dornstadt,18 - 20 Jahre,199,113,86
False,8425031,Dornstadt,20 - 25 Jahre,521,276,245
False,8425031,Dornstadt,25 - 30 Jahre,515,256,259
False,8425031,Dornstadt,30 - 35 Jahre,502,259,243
False,8425031,Dornstadt,35 - 40 Jahre,510,248,262
False,8425031,Dornstadt,40 - 45 Jahre,615,318,297
False,8425031,Dornstadt,45 - 50 Jahre,709,365,344
False,8425031,Dornstadt,50 - 55 Jahre,625,303,322
False,8425031,Dornstadt,55 - 60 Jahre,577,303,274
False,8425031,Dornstadt,60 - 65 Jahre,474,247,227
False,8425031,Dornstadt,65 - 75 Jahre,966,460,506
False,8425031,Dornstadt,75 und mehr Jahre,650,258,392
False,8425031,Dornstadt,Insgesamt,8408,4197,4211
False,8425033,"Ehingen (Donau), Stadt",unter 3 Jahre,719,366,353
False,8425033,"Ehingen (Donau), Stadt",3 -  6 Jahre,738,388,350
False,8425033,"Ehingen (Donau), Stadt",6 - 10 Jahre,1016,522,494
False,8425033,"Ehingen (Donau), Stadt",10 - 15 Jahre,1516,746,770
False,8425033,"Ehingen (Donau), Stadt",15 - 18 Jahre,930,475,455
False,8425033,"Ehingen (Donau), Stadt",18 - 20 Jahre,656,311,345
False,8425033,"Ehingen (Donau), Stadt",20 - 25 Jahre,1610,808,802
False,8425033,"Ehingen (Donau), Stadt",25 - 30 Jahre,1486,769,717
False,8425033,"Ehingen (Donau), Stadt",30 - 35 Jahre,1563,792,771
False,8425033,"Ehingen (Donau), Stadt",35 - 40 Jahre,1752,881,871
False,8425033,"Ehingen (Donau), Stadt",40 - 45 Jahre,2078,1033,1045
False,8425033,"Ehingen (Donau), Stadt",45 - 50 Jahre,2173,1161,1012
False,8425033,"Ehingen (Donau), Stadt",50 - 55 Jahre,1872,927,945
False,8425033,"Ehingen (Donau), Stadt",55 - 60 Jahre,1658,816,842
False,8425033,"Ehingen (Donau), Stadt",60 - 65 Jahre,1483,754,729
False,8425033,"Ehingen (Donau), Stadt",65 - 75 Jahre,2461,1206,1255
False,8425033,"Ehingen (Donau), Stadt",75 und mehr Jahre,1959,735,1224
False,8425033,"Ehingen (Donau), Stadt",Insgesamt,25670,12690,12980
False,8425035,Emeringen,unter 3 Jahre,1,1,0
False,8425035,Emeringen,3 -  6 Jahre,2,1,1
False,8425035,Emeringen,6 - 10 Jahre,4,2,2
False,8425035,Emeringen,10 - 15 Jahre,8,4,4
False,8425035,Emeringen,15 - 18 Jahre,6,3,3
False,8425035,Emeringen,18 - 20 Jahre,7,3,4
False,8425035,Emeringen,20 - 25 Jahre,13,7,6
False,8425035,Emeringen,25 - 30 Jahre,3,3,0
False,8425035,Emeringen,30 - 35 Jahre,4,2,2
False,8425035,Emeringen,35 - 40 Jahre,8,3,5
False,8425035,Emeringen,40 - 45 Jahre,14,7,7
False,8425035,Emeringen,45 - 50 Jahre,14,5,9
False,8425035,Emeringen,50 - 55 Jahre,11,3,8
False,8425035,Emeringen,55 - 60 Jahre,7,4,3
False,8425035,Emeringen,60 - 65 Jahre,9,6,3
False,8425035,Emeringen,65 - 75 Jahre,10,5,5
False,8425035,Emeringen,75 und mehr Jahre,11,5,6
False,8425035,Emeringen,Insgesamt,132,64,68
False,8425036,Emerkingen,unter 3 Jahre,27,14,13
False,8425036,Emerkingen,3 -  6 Jahre,28,17,11
False,8425036,Emerkingen,6 - 10 Jahre,55,26,29
False,8425036,Emerkingen,10 - 15 Jahre,83,42,41
False,8425036,Emerkingen,15 - 18 Jahre,36,21,15
False,8425036,Emerkingen,18 - 20 Jahre,14,5,9
False,8425036,Emerkingen,20 - 25 Jahre,35,12,23
False,8425036,Emerkingen,25 - 30 Jahre,37,18,19
False,8425036,Emerkingen,30 - 35 Jahre,61,35,26
False,8425036,Emerkingen,35 - 40 Jahre,76,42,34
False,8425036,Emerkingen,40 - 45 Jahre,69,34,35
False,8425036,Emerkingen,45 - 50 Jahre,82,44,38
False,8425036,Emerkingen,50 - 55 Jahre,44,24,20
False,8425036,Emerkingen,55 - 60 Jahre,43,24,19
False,8425036,Emerkingen,60 - 65 Jahre,37,17,20
False,8425036,Emerkingen,65 - 75 Jahre,80,46,34
False,8425036,Emerkingen,75 und mehr Jahre,45,16,29
False,8425036,Emerkingen,Insgesamt,852,437,415
False,8425039,"Erbach, Stadt",unter 3 Jahre,342,181,161
False,8425039,"Erbach, Stadt",3 -  6 Jahre,386,199,187
False,8425039,"Erbach, Stadt",6 - 10 Jahre,567,280,287
False,8425039,"Erbach, Stadt",10 - 15 Jahre,772,406,366
False,8425039,"Erbach, Stadt",15 - 18 Jahre,484,260,224
False,8425039,"Erbach, Stadt",18 - 20 Jahre,336,182,154
False,8425039,"Erbach, Stadt",20 - 25 Jahre,817,414,403
False,8425039,"Erbach, Stadt",25 - 30 Jahre,780,383,397
False,8425039,"Erbach, Stadt",30 - 35 Jahre,798,406,392
False,8425039,"Erbach, Stadt",35 - 40 Jahre,829,416,413
False,8425039,"Erbach, Stadt",40 - 45 Jahre,1105,558,547
False,8425039,"Erbach, Stadt",45 - 50 Jahre,1179,650,529
False,8425039,"Erbach, Stadt",50 - 55 Jahre,943,490,453
False,8425039,"Erbach, Stadt",55 - 60 Jahre,901,452,449
False,8425039,"Erbach, Stadt",60 - 65 Jahre,665,350,315
False,8425039,"Erbach, Stadt",65 - 75 Jahre,1258,602,656
False,8425039,"Erbach, Stadt",75 und mehr Jahre,1056,412,644
False,8425039,"Erbach, Stadt",Insgesamt,13218,6641,6577
False,8425050,Griesingen,unter 3 Jahre,25,17,8
False,8425050,Griesingen,3 -  6 Jahre,32,15,17
False,8425050,Griesingen,6 - 10 Jahre,63,35,28
False,8425050,Griesingen,10 - 15 Jahre,68,34,34
False,8425050,Griesingen,15 - 18 Jahre,43,18,25
False,8425050,Griesingen,18 - 20 Jahre,32,14,18
False,8425050,Griesingen,20 - 25 Jahre,64,32,32
False,8425050,Griesingen,25 - 30 Jahre,71,29,42
False,8425050,Griesingen,30 - 35 Jahre,72,39,33
False,8425050,Griesingen,35 - 40 Jahre,75,39,36
False,8425050,Griesingen,40 - 45 Jahre,99,45,54
False,8425050,Griesingen,45 - 50 Jahre,86,44,42
False,8425050,Griesingen,50 - 55 Jahre,100,50,50
False,8425050,Griesingen,55 - 60 Jahre,63,39,24
False,8425050,Griesingen,60 - 65 Jahre,42,22,20
False,8425050,Griesingen,65 - 75 Jahre,64,29,35
False,8425050,Griesingen,75 und mehr Jahre,62,26,36
False,8425050,Griesingen,Insgesamt,1061,527,534
False,8425052,Grundsheim,unter 3 Jahre,4,0,4
False,8425052,Grundsheim,3 -  6 Jahre,6,2,4
False,8425052,Grundsheim,6 - 10 Jahre,10,4,6
False,8425052,Grundsheim,10 - 15 Jahre,13,6,7
False,8425052,Grundsheim,15 - 18 Jahre,5,1,4
False,8425052,Grundsheim,18 - 20 Jahre,4,2,2
False,8425052,Grundsheim,20 - 25 Jahre,7,1,6
False,8425052,Grundsheim,25 - 30 Jahre,10,6,4
False,8425052,Grundsheim,30 - 35 Jahre,10,6,4
False,8425052,Grundsheim,35 - 40 Jahre,15,7,8
False,8425052,Grundsheim,40 - 45 Jahre,16,7,9
False,8425052,Grundsheim,45 - 50 Jahre,12,9,3
False,8425052,Grundsheim,50 - 55 Jahre,15,7,8
False,8425052,Grundsheim,55 - 60 Jahre,11,8,3
False,8425052,Grundsheim,60 - 65 Jahre,11,7,4
False,8425052,Grundsheim,65 - 75 Jahre,18,8,10
False,8425052,Grundsheim,75 und mehr Jahre,19,6,13
False,8425052,Grundsheim,Insgesamt,186,87,99
False,8425055,Hausen am Bussen,unter 3 Jahre,7,4,3
False,8425055,Hausen am Bussen,3 -  6 Jahre,10,3,7
False,8425055,Hausen am Bussen,6 - 10 Jahre,12,3,9
False,8425055,Hausen am Bussen,10 - 15 Jahre,17,10,7
False,8425055,Hausen am Bussen,15 - 18 Jahre,8,8,0
False,8425055,Hausen am Bussen,18 - 20 Jahre,6,2,4
False,8425055,Hausen am Bussen,20 - 25 Jahre,17,9,8
False,8425055,Hausen am Bussen,25 - 30 Jahre,18,10,8
False,8425055,Hausen am Bussen,30 - 35 Jahre,19,12,7
False,8425055,Hausen am Bussen,35 - 40 Jahre,21,12,9
False,8425055,Hausen am Bussen,40 - 45 Jahre,16,9,7
False,8425055,Hausen am Bussen,45 - 50 Jahre,30,13,17
False,8425055,Hausen am Bussen,50 - 55 Jahre,18,14,4
False,8425055,Hausen am Bussen,55 - 60 Jahre,19,9,10
False,8425055,Hausen am Bussen,60 - 65 Jahre,17,9,8
False,8425055,Hausen am Bussen,65 - 75 Jahre,24,10,14
False,8425055,Hausen am Bussen,75 und mehr Jahre,16,7,9
False,8425055,Hausen am Bussen,Insgesamt,275,144,131
False,8425062,Holzkirch,unter 3 Jahre,7,4,3
False,8425062,Holzkirch,3 -  6 Jahre,7,1,6
False,8425062,Holzkirch,6 - 10 Jahre,7,2,5
False,8425062,Holzkirch,10 - 15 Jahre,13,7,6
False,8425062,Holzkirch,15 - 18 Jahre,19,9,10
False,8425062,Holzkirch,18 - 20 Jahre,8,6,2
False,8425062,Holzkirch,20 - 25 Jahre,14,7,7
False,8425062,Holzkirch,25 - 30 Jahre,10,4,6
False,8425062,Holzkirch,30 - 35 Jahre,9,3,6
False,8425062,Holzkirch,35 - 40 Jahre,17,9,8
False,8425062,Holzkirch,40 - 45 Jahre,31,15,16
False,8425062,Holzkirch,45 - 50 Jahre,34,20,14
False,8425062,Holzkirch,50 - 55 Jahre,10,4,6
False,8425062,Holzkirch,55 - 60 Jahre,12,8,4
False,8425062,Holzkirch,60 - 65 Jahre,12,9,3
False,8425062,Holzkirch,65 - 75 Jahre,23,9,14
False,8425062,Holzkirch,75 und mehr Jahre,36,15,21
False,8425062,Holzkirch,Insgesamt,269,132,137
False,8425064,Hüttisheim,unter 3 Jahre,33,16,17
False,8425064,Hüttisheim,3 -  6 Jahre,38,17,21
False,8425064,Hüttisheim,6 - 10 Jahre,44,20,24
False,8425064,Hüttisheim,10 - 15 Jahre,98,35,63
False,8425064,Hüttisheim,15 - 18 Jahre,51,26,25
False,8425064,Hüttisheim,18 - 20 Jahre,36,17,19
False,8425064,Hüttisheim,20 - 25 Jahre,93,51,42
False,8425064,Hüttisheim,25 - 30 Jahre,80,43,37
False,8425064,Hüttisheim,30 - 35 Jahre,61,29,32
False,8425064,Hüttisheim,35 - 40 Jahre,72,40,32
False,8425064,Hüttisheim,40 - 45 Jahre,136,67,69
False,8425064,Hüttisheim,45 - 50 Jahre,108,51,57
False,8425064,Hüttisheim,50 - 55 Jahre,127,62,65
False,8425064,Hüttisheim,55 - 60 Jahre,86,49,37
False,8425064,Hüttisheim,60 - 65 Jahre,60,33,27
False,8425064,Hüttisheim,65 - 75 Jahre,142,67,75
False,8425064,Hüttisheim,75 und mehr Jahre,103,40,63
False,8425064,Hüttisheim,Insgesamt,1368,663,705
False,8425066,Illerrieden,unter 3 Jahre,89,45,44
False,8425066,Illerrieden,3 -  6 Jahre,103,53,50
False,8425066,Illerrieden,6 - 10 Jahre,122,58,64
False,8425066,Illerrieden,10 - 15 Jahre,167,83,84
False,8425066,Illerrieden,15 - 18 Jahre,112,47,65
False,8425066,Illerrieden,18 - 20 Jahre,85,46,39
False,8425066,Illerrieden,20 - 25 Jahre,196,99,97
False,8425066,Illerrieden,25 - 30 Jahre,199,110,89
False,8425066,Illerrieden,30 - 35 Jahre,208,102,106
False,8425066,Illerrieden,35 - 40 Jahre,223,107,116
False,8425066,Illerrieden,40 - 45 Jahre,287,153,134
False,8425066,Illerrieden,45 - 50 Jahre,309,163,146
False,8425066,Illerrieden,50 - 55 Jahre,255,132,123
False,8425066,Illerrieden,55 - 60 Jahre,233,108,125
False,8425066,Illerrieden,60 - 65 Jahre,200,107,93
False,8425066,Illerrieden,65 - 75 Jahre,366,191,175
False,8425066,Illerrieden,75 und mehr Jahre,213,86,127
False,8425066,Illerrieden,Insgesamt,3367,1690,1677
False,8425071,"Laichingen, Stadt",unter 3 Jahre,285,151,134
False,8425071,"Laichingen, Stadt",3 -  6 Jahre,318,176,142
False,8425071,"Laichingen, Stadt",6 - 10 Jahre,482,243,239
False,8425071,"Laichingen, Stadt",10 - 15 Jahre,731,360,371
False,8425071,"Laichingen, Stadt",15 - 18 Jahre,421,227,194
False,8425071,"Laichingen, Stadt",18 - 20 Jahre,328,166,162
False,8425071,"Laichingen, Stadt",20 - 25 Jahre,708,353,355
False,8425071,"Laichingen, Stadt",25 - 30 Jahre,579,313,266
False,8425071,"Laichingen, Stadt",30 - 35 Jahre,569,284,285
False,8425071,"Laichingen, Stadt",35 - 40 Jahre,654,332,322
False,8425071,"Laichingen, Stadt",40 - 45 Jahre,913,456,457
False,8425071,"Laichingen, Stadt",45 - 50 Jahre,923,474,449
False,8425071,"Laichingen, Stadt",50 - 55 Jahre,783,419,364
False,8425071,"Laichingen, Stadt",55 - 60 Jahre,645,319,326
False,8425071,"Laichingen, Stadt",60 - 65 Jahre,548,276,272
False,8425071,"Laichingen, Stadt",65 - 75 Jahre,1045,497,548
False,8425071,"Laichingen, Stadt",75 und mehr Jahre,935,380,555
False,8425071,"Laichingen, Stadt",Insgesamt,10867,5426,5441
False,8425072,"Langenau, Stadt",unter 3 Jahre,407,212,195
False,8425072,"Langenau, Stadt",3 -  6 Jahre,434,215,219
False,8425072,"Langenau, Stadt",6 - 10 Jahre,615,321,294
False,8425072,"Langenau, Stadt",10 - 15 Jahre,886,444,442
False,8425072,"Langenau, Stadt",15 - 18 Jahre,519,283,236
False,8425072,"Langenau, Stadt",18 - 20 Jahre,364,193,171
False,8425072,"Langenau, Stadt",20 - 25 Jahre,847,452,395
False,8425072,"Langenau, Stadt",25 - 30 Jahre,829,434,395
False,8425072,"Langenau, Stadt",30 - 35 Jahre,878,466,412
False,8425072,"Langenau, Stadt",35 - 40 Jahre,934,467,467
False,8425072,"Langenau, Stadt",40 - 45 Jahre,1280,659,621
False,8425072,"Langenau, Stadt",45 - 50 Jahre,1274,653,621
False,8425072,"Langenau, Stadt",50 - 55 Jahre,1103,567,536
False,8425072,"Langenau, Stadt",55 - 60 Jahre,874,463,411
False,8425072,"Langenau, Stadt",60 - 65 Jahre,766,398,368
False,8425072,"Langenau, Stadt",65 - 75 Jahre,1331,644,687
False,8425072,"Langenau, Stadt",75 und mehr Jahre,1175,451,724
False,8425072,"Langenau, Stadt",Insgesamt,14516,7322,7194
False,8425073,Lauterach,unter 3 Jahre,16,9,7
False,8425073,Lauterach,3 -  6 Jahre,13,13,0
False,8425073,Lauterach,6 - 10 Jahre,32,19,13
False,8425073,Lauterach,10 - 15 Jahre,42,20,22
False,8425073,Lauterach,15 - 18 Jahre,21,9,12
False,8425073,Lauterach,18 - 20 Jahre,8,4,4
False,8425073,Lauterach,20 - 25 Jahre,37,22,15
False,8425073,Lauterach,25 - 30 Jahre,39,22,17
False,8425073,Lauterach,30 - 35 Jahre,32,18,14
False,8425073,Lauterach,35 - 40 Jahre,36,21,15
False,8425073,Lauterach,40 - 45 Jahre,52,34,18
False,8425073,Lauterach,45 - 50 Jahre,54,35,19
False,8425073,Lauterach,50 - 55 Jahre,52,32,20
False,8425073,Lauterach,55 - 60 Jahre,38,20,18
False,8425073,Lauterach,60 - 65 Jahre,36,20,16
False,8425073,Lauterach,65 - 75 Jahre,39,12,27
False,8425073,Lauterach,75 und mehr Jahre,44,17,27
False,8425073,Lauterach,Insgesamt,591,327,264
False,8425075,Lonsee,unter 3 Jahre,127,57,70
False,8425075,Lonsee,3 -  6 Jahre,137,71,66
False,8425075,Lonsee,6 - 10 Jahre,195,114,81
False,8425075,Lonsee,10 - 15 Jahre,322,166,156
False,8425075,Lonsee,15 - 18 Jahre,184,91,93
False,8425075,Lonsee,18 - 20 Jahre,136,70,66
False,8425075,Lonsee,20 - 25 Jahre,287,162,125
False,8425075,Lonsee,25 - 30 Jahre,287,137,150
False,8425075,Lonsee,30 - 35 Jahre,242,124,118
False,8425075,Lonsee,35 - 40 Jahre,279,139,140
False,8425075,Lonsee,40 - 45 Jahre,354,182,172
False,8425075,Lonsee,45 - 50 Jahre,456,233,223
False,8425075,Lonsee,50 - 55 Jahre,384,205,179
False,8425075,Lonsee,55 - 60 Jahre,284,143,141
False,8425075,Lonsee,60 - 65 Jahre,244,129,115
False,8425075,Lonsee,65 - 75 Jahre,417,208,209
False,8425075,Lonsee,75 und mehr Jahre,367,140,227
False,8425075,Lonsee,Insgesamt,4702,2371,2331
False,8425079,Merklingen,unter 3 Jahre,53,25,28
False,8425079,Merklingen,3 -  6 Jahre,50,22,28
False,8425079,Merklingen,6 - 10 Jahre,88,51,37
False,8425079,Merklingen,10 - 15 Jahre,118,57,61
False,8425079,Merklingen,15 - 18 Jahre,80,39,41
False,8425079,Merklingen,18 - 20 Jahre,57,29,28
False,8425079,Merklingen,20 - 25 Jahre,105,53,52
False,8425079,Merklingen,25 - 30 Jahre,72,37,35
False,8425079,Merklingen,30 - 35 Jahre,83,36,47
False,8425079,Merklingen,35 - 40 Jahre,108,52,56
False,8425079,Merklingen,40 - 45 Jahre,178,85,93
False,8425079,Merklingen,45 - 50 Jahre,180,97,83
False,8425079,Merklingen,50 - 55 Jahre,120,60,60
False,8425079,Merklingen,55 - 60 Jahre,105,55,50
False,8425079,Merklingen,60 - 65 Jahre,89,44,45
False,8425079,Merklingen,65 - 75 Jahre,203,101,102
False,8425079,Merklingen,75 und mehr Jahre,182,73,109
False,8425079,Merklingen,Insgesamt,1871,916,955
False,8425081,"Munderkingen, Stadt",unter 3 Jahre,126,62,64
False,8425081,"Munderkingen, Stadt",3 -  6 Jahre,121,75,46
False,8425081,"Munderkingen, Stadt",6 - 10 Jahre,186,102,84
False,8425081,"Munderkingen, Stadt",10 - 15 Jahre,274,142,132
False,8425081,"Munderkingen, Stadt",15 - 18 Jahre,186,90,96
False,8425081,"Munderkingen, Stadt",18 - 20 Jahre,144,75,69
False,8425081,"Munderkingen, Stadt",20 - 25 Jahre,340,178,162
False,8425081,"Munderkingen, Stadt",25 - 30 Jahre,279,152,127
False,8425081,"Munderkingen, Stadt",30 - 35 Jahre,243,129,114
False,8425081,"Munderkingen, Stadt",35 - 40 Jahre,270,136,134
False,8425081,"Munderkingen, Stadt",40 - 45 Jahre,316,160,156
False,8425081,"Munderkingen, Stadt",45 - 50 Jahre,394,168,226
False,8425081,"Munderkingen, Stadt",50 - 55 Jahre,431,215,216
False,8425081,"Munderkingen, Stadt",55 - 60 Jahre,324,158,166
False,8425081,"Munderkingen, Stadt",60 - 65 Jahre,260,129,131
False,8425081,"Munderkingen, Stadt",65 - 75 Jahre,556,250,306
False,8425081,"Munderkingen, Stadt",75 und mehr Jahre,462,179,283
False,8425081,"Munderkingen, Stadt",Insgesamt,4912,2400,2512
False,8425083,Neenstetten,unter 3 Jahre,28,13,15
False,8425083,Neenstetten,3 -  6 Jahre,27,16,11
False,8425083,Neenstetten,6 - 10 Jahre,46,21,25
False,8425083,Neenstetten,10 - 15 Jahre,61,28,33
False,8425083,Neenstetten,15 - 18 Jahre,26,10,16
False,8425083,Neenstetten,18 - 20 Jahre,24,13,11
False,8425083,Neenstetten,20 - 25 Jahre,46,27,19
False,8425083,Neenstetten,25 - 30 Jahre,42,18,24
False,8425083,Neenstetten,30 - 35 Jahre,39,19,20
False,8425083,Neenstetten,35 - 40 Jahre,65,30,35
False,8425083,Neenstetten,40 - 45 Jahre,77,39,38
False,8425083,Neenstetten,45 - 50 Jahre,71,36,35
False,8425083,Neenstetten,50 - 55 Jahre,64,29,35
False,8425083,Neenstetten,55 - 60 Jahre,40,24,16
False,8425083,Neenstetten,60 - 65 Jahre,38,16,22
False,8425083,Neenstetten,65 - 75 Jahre,80,44,36
False,8425083,Neenstetten,75 und mehr Jahre,53,23,30
False,8425083,Neenstetten,Insgesamt,827,406,421
False,8425084,Nellingen,unter 3 Jahre,49,22,27
False,8425084,Nellingen,3 -  6 Jahre,64,32,32
False,8425084,Nellingen,6 - 10 Jahre,100,56,44
False,8425084,Nellingen,10 - 15 Jahre,123,65,58
False,8425084,Nellingen,15 - 18 Jahre,69,37,32
False,8425084,Nellingen,18 - 20 Jahre,56,38,18
False,8425084,Nellingen,20 - 25 Jahre,101,52,49
False,8425084,Nellingen,25 - 30 Jahre,94,50,44
False,8425084,Nellingen,30 - 35 Jahre,82,43,39
False,8425084,Nellingen,35 - 40 Jahre,122,60,62
False,8425084,Nellingen,40 - 45 Jahre,188,89,99
False,8425084,Nellingen,45 - 50 Jahre,173,90,83
False,8425084,Nellingen,50 - 55 Jahre,151,82,69
False,8425084,Nellingen,55 - 60 Jahre,123,67,56
False,8425084,Nellingen,60 - 65 Jahre,95,54,41
False,8425084,Nellingen,65 - 75 Jahre,163,78,85
False,8425084,Nellingen,75 und mehr Jahre,136,53,83
False,8425084,Nellingen,Insgesamt,1889,968,921
False,8425085,Nerenstetten,unter 3 Jahre,8,5,3
False,8425085,Nerenstetten,3 -  6 Jahre,10,5,5
False,8425085,Nerenstetten,6 - 10 Jahre,10,3,7
False,8425085,Nerenstetten,10 - 15 Jahre,24,13,11
False,8425085,Nerenstetten,15 - 18 Jahre,13,6,7
False,8425085,Nerenstetten,18 - 20 Jahre,9,4,5
False,8425085,Nerenstetten,20 - 25 Jahre,26,13,13
False,8425085,Nerenstetten,25 - 30 Jahre,29,13,16
False,8425085,Nerenstetten,30 - 35 Jahre,13,9,4
False,8425085,Nerenstetten,35 - 40 Jahre,17,6,11
False,8425085,Nerenstetten,40 - 45 Jahre,33,14,19
False,8425085,Nerenstetten,45 - 50 Jahre,34,19,15
False,8425085,Nerenstetten,50 - 55 Jahre,18,7,11
False,8425085,Nerenstetten,55 - 60 Jahre,30,20,10
False,8425085,Nerenstetten,60 - 65 Jahre,14,7,7
False,8425085,Nerenstetten,65 - 75 Jahre,28,13,15
False,8425085,Nerenstetten,75 und mehr Jahre,26,11,15
False,8425085,Nerenstetten,Insgesamt,342,168,174
False,8425088,Oberdischingen,unter 3 Jahre,55,30,25
False,8425088,Oberdischingen,3 -  6 Jahre,60,33,27
False,8425088,Oberdischingen,6 - 10 Jahre,94,46,48
False,8425088,Oberdischingen,10 - 15 Jahre,142,60,82
False,8425088,Oberdischingen,15 - 18 Jahre,68,34,34
False,8425088,Oberdischingen,18 - 20 Jahre,62,34,28
False,8425088,Oberdischingen,20 - 25 Jahre,128,75,53
False,8425088,Oberdischingen,25 - 30 Jahre,123,66,57
False,8425088,Oberdischingen,30 - 35 Jahre,124,65,59
False,8425088,Oberdischingen,35 - 40 Jahre,108,51,57
False,8425088,Oberdischingen,40 - 45 Jahre,165,87,78
False,8425088,Oberdischingen,45 - 50 Jahre,133,53,80
False,8425088,Oberdischingen,50 - 55 Jahre,176,92,84
False,8425088,Oberdischingen,55 - 60 Jahre,127,65,62
False,8425088,Oberdischingen,60 - 65 Jahre,95,48,47
False,8425088,Oberdischingen,65 - 75 Jahre,168,87,81
False,8425088,Oberdischingen,75 und mehr Jahre,186,73,113
False,8425088,Oberdischingen,Insgesamt,2014,999,1015
False,8425090,Obermarchtal,unter 3 Jahre,33,13,20
False,8425090,Obermarchtal,3 -  6 Jahre,35,19,16
False,8425090,Obermarchtal,6 - 10 Jahre,56,34,22
False,8425090,Obermarchtal,10 - 15 Jahre,109,54,55
False,8425090,Obermarchtal,15 - 18 Jahre,55,26,29
False,8425090,Obermarchtal,18 - 20 Jahre,30,19,11
False,8425090,Obermarchtal,20 - 25 Jahre,81,42,39
False,8425090,Obermarchtal,25 - 30 Jahre,67,32,35
False,8425090,Obermarchtal,30 - 35 Jahre,85,45,40
False,8425090,Obermarchtal,35 - 40 Jahre,82,39,43
False,8425090,Obermarchtal,40 - 45 Jahre,100,55,45
False,8425090,Obermarchtal,45 - 50 Jahre,101,43,58
False,8425090,Obermarchtal,50 - 55 Jahre,83,46,37
False,8425090,Obermarchtal,55 - 60 Jahre,72,42,30
False,8425090,Obermarchtal,60 - 65 Jahre,64,28,36
False,8425090,Obermarchtal,65 - 75 Jahre,106,56,50
False,8425090,Obermarchtal,75 und mehr Jahre,85,35,50
False,8425090,Obermarchtal,Insgesamt,1244,628,616
False,8425091,Oberstadion,unter 3 Jahre,39,22,17
False,8425091,Oberstadion,3 -  6 Jahre,53,29,24
False,8425091,Oberstadion,6 - 10 Jahre,68,38,30
False,8425091,Oberstadion,10 - 15 Jahre,109,63,46
False,8425091,Oberstadion,15 - 18 Jahre,68,44,24
False,8425091,Oberstadion,18 - 20 Jahre,39,24,15
False,8425091,Oberstadion,20 - 25 Jahre,121,62,59
False,8425091,Oberstadion,25 - 30 Jahre,111,62,49
False,8425091,Oberstadion,30 - 35 Jahre,84,47,37
False,8425091,Oberstadion,35 - 40 Jahre,110,52,58
False,8425091,Oberstadion,40 - 45 Jahre,128,67,61
False,8425091,Oberstadion,45 - 50 Jahre,145,90,55
False,8425091,Oberstadion,50 - 55 Jahre,133,61,72
False,8425091,Oberstadion,55 - 60 Jahre,106,59,47
False,8425091,Oberstadion,60 - 65 Jahre,54,33,21
False,8425091,Oberstadion,65 - 75 Jahre,103,48,55
False,8425091,Oberstadion,75 und mehr Jahre,106,43,63
False,8425091,Oberstadion,Insgesamt,1577,844,733
False,8425092,Öllingen,unter 3 Jahre,11,6,5
False,8425092,Öllingen,3 -  6 Jahre,18,12,6
False,8425092,Öllingen,6 - 10 Jahre,37,21,16
False,8425092,Öllingen,10 - 15 Jahre,36,19,17
False,8425092,Öllingen,15 - 18 Jahre,23,13,10
False,8425092,Öllingen,18 - 20 Jahre,16,10,6
False,8425092,Öllingen,20 - 25 Jahre,34,16,18
False,8425092,Öllingen,25 - 30 Jahre,17,7,10
False,8425092,Öllingen,30 - 35 Jahre,33,16,17
False,8425092,Öllingen,35 - 40 Jahre,36,19,17
False,8425092,Öllingen,40 - 45 Jahre,46,24,22
False,8425092,Öllingen,45 - 50 Jahre,43,24,19
False,8425092,Öllingen,50 - 55 Jahre,42,24,18
False,8425092,Öllingen,55 - 60 Jahre,18,8,10
False,8425092,Öllingen,60 - 65 Jahre,15,8,7
False,8425092,Öllingen,65 - 75 Jahre,51,26,25
False,8425092,Öllingen,75 und mehr Jahre,41,20,21
False,8425092,Öllingen,Insgesamt,517,273,244
False,8425093,Öpfingen,unter 3 Jahre,62,33,29
False,8425093,Öpfingen,3 -  6 Jahre,74,37,37
False,8425093,Öpfingen,6 - 10 Jahre,105,48,57
False,8425093,Öpfingen,10 - 15 Jahre,131,80,51
False,8425093,Öpfingen,15 - 18 Jahre,87,42,45
False,8425093,Öpfingen,18 - 20 Jahre,45,28,17
False,8425093,Öpfingen,20 - 25 Jahre,120,56,64
False,8425093,Öpfingen,25 - 30 Jahre,131,64,67
False,8425093,Öpfingen,30 - 35 Jahre,151,78,73
False,8425093,Öpfingen,35 - 40 Jahre,148,76,72
False,8425093,Öpfingen,40 - 45 Jahre,193,108,85
False,8425093,Öpfingen,45 - 50 Jahre,191,94,97
False,8425093,Öpfingen,50 - 55 Jahre,173,89,84
False,8425093,Öpfingen,55 - 60 Jahre,149,67,82
False,8425093,Öpfingen,60 - 65 Jahre,114,64,50
False,8425093,Öpfingen,65 - 75 Jahre,253,127,126
False,8425093,Öpfingen,75 und mehr Jahre,166,65,101
False,8425093,Öpfingen,Insgesamt,2293,1156,1137
False,8425097,Rammingen,unter 3 Jahre,27,17,10
False,8425097,Rammingen,3 -  6 Jahre,37,21,16
False,8425097,Rammingen,6 - 10 Jahre,52,26,26
False,8425097,Rammingen,10 - 15 Jahre,72,38,34
False,8425097,Rammingen,15 - 18 Jahre,43,25,18
False,8425097,Rammingen,18 - 20 Jahre,39,23,16
False,8425097,Rammingen,20 - 25 Jahre,72,41,31
False,8425097,Rammingen,25 - 30 Jahre,64,38,26
False,8425097,Rammingen,30 - 35 Jahre,62,26,36
False,8425097,Rammingen,35 - 40 Jahre,82,31,51
False,8425097,Rammingen,40 - 45 Jahre,105,52,53
False,8425097,Rammingen,45 - 50 Jahre,134,77,57
False,8425097,Rammingen,50 - 55 Jahre,100,54,46
False,8425097,Rammingen,55 - 60 Jahre,90,48,42
False,8425097,Rammingen,60 - 65 Jahre,72,39,33
False,8425097,Rammingen,65 - 75 Jahre,127,67,60
False,8425097,Rammingen,75 und mehr Jahre,85,43,42
False,8425097,Rammingen,Insgesamt,1263,666,597
False,8425098,Rechtenstein,unter 3 Jahre,5,2,3
False,8425098,Rechtenstein,3 -  6 Jahre,4,2,2
False,8425098,Rechtenstein,6 - 10 Jahre,7,2,5
False,8425098,Rechtenstein,10 - 15 Jahre,9,5,4
False,8425098,Rechtenstein,15 - 18 Jahre,6,4,2
False,8425098,Rechtenstein,18 - 20 Jahre,7,4,3
False,8425098,Rechtenstein,20 - 25 Jahre,11,7,4
False,8425098,Rechtenstein,25 - 30 Jahre,21,13,8
False,8425098,Rechtenstein,30 - 35 Jahre,13,6,7
False,8425098,Rechtenstein,35 - 40 Jahre,14,5,9
False,8425098,Rechtenstein,40 - 45 Jahre,21,14,7
False,8425098,Rechtenstein,45 - 50 Jahre,30,11,19
False,8425098,Rechtenstein,50 - 55 Jahre,31,19,12
False,8425098,Rechtenstein,55 - 60 Jahre,20,11,9
False,8425098,Rechtenstein,60 - 65 Jahre,18,12,6
False,8425098,Rechtenstein,65 - 75 Jahre,36,18,18
False,8425098,Rechtenstein,75 und mehr Jahre,10,4,6
False,8425098,Rechtenstein,Insgesamt,263,139,124
False,8425104,Rottenacker,unter 3 Jahre,46,30,16
False,8425104,Rottenacker,3 -  6 Jahre,58,27,31
False,8425104,Rottenacker,6 - 10 Jahre,93,52,41
False,8425104,Rottenacker,10 - 15 Jahre,124,69,55
False,8425104,Rottenacker,15 - 18 Jahre,94,48,46
False,8425104,Rottenacker,18 - 20 Jahre,56,35,21
False,8425104,Rottenacker,20 - 25 Jahre,134,82,52
False,8425104,Rottenacker,25 - 30 Jahre,121,65,56
False,8425104,Rottenacker,30 - 35 Jahre,92,48,44
False,8425104,Rottenacker,35 - 40 Jahre,108,44,64
False,8425104,Rottenacker,40 - 45 Jahre,173,89,84
False,8425104,Rottenacker,45 - 50 Jahre,205,113,92
False,8425104,Rottenacker,50 - 55 Jahre,176,88,88
False,8425104,Rottenacker,55 - 60 Jahre,150,72,78
False,8425104,Rottenacker,60 - 65 Jahre,104,55,49
False,8425104,Rottenacker,65 - 75 Jahre,206,100,106
False,8425104,Rottenacker,75 und mehr Jahre,190,75,115
False,8425104,Rottenacker,Insgesamt,2130,1092,1038
False,8425108,"Schelklingen, Stadt",unter 3 Jahre,180,88,92
False,8425108,"Schelklingen, Stadt",3 -  6 Jahre,195,99,96
False,8425108,"Schelklingen, Stadt",6 - 10 Jahre,263,132,131
False,8425108,"Schelklingen, Stadt",10 - 15 Jahre,420,213,207
False,8425108,"Schelklingen, Stadt",15 - 18 Jahre,235,120,115
False,8425108,"Schelklingen, Stadt",18 - 20 Jahre,222,119,103
False,8425108,"Schelklingen, Stadt",20 - 25 Jahre,446,246,200
False,8425108,"Schelklingen, Stadt",25 - 30 Jahre,400,213,187
False,8425108,"Schelklingen, Stadt",30 - 35 Jahre,421,253,168
False,8425108,"Schelklingen, Stadt",35 - 40 Jahre,518,280,238
False,8425108,"Schelklingen, Stadt",40 - 45 Jahre,581,305,276
False,8425108,"Schelklingen, Stadt",45 - 50 Jahre,585,295,290
False,8425108,"Schelklingen, Stadt",50 - 55 Jahre,530,278,252
False,8425108,"Schelklingen, Stadt",55 - 60 Jahre,428,219,209
False,8425108,"Schelklingen, Stadt",60 - 65 Jahre,353,171,182
False,8425108,"Schelklingen, Stadt",65 - 75 Jahre,677,314,363
False,8425108,"Schelklingen, Stadt",75 und mehr Jahre,618,250,368
False,8425108,"Schelklingen, Stadt",Insgesamt,7072,3595,3477
False,8425110,Schnürpflingen,unter 3 Jahre,38,18,20
False,8425110,Schnürpflingen,3 -  6 Jahre,40,21,19
False,8425110,Schnürpflingen,6 - 10 Jahre,51,27,24
False,8425110,Schnürpflingen,10 - 15 Jahre,88,45,43
False,8425110,Schnürpflingen,15 - 18 Jahre,48,21,27
False,8425110,Schnürpflingen,18 - 20 Jahre,36,14,22
False,8425110,Schnürpflingen,20 - 25 Jahre,91,49,42
False,8425110,Schnürpflingen,25 - 30 Jahre,95,50,45
False,8425110,Schnürpflingen,30 - 35 Jahre,80,42,38
False,8425110,Schnürpflingen,35 - 40 Jahre,68,34,34
False,8425110,Schnürpflingen,40 - 45 Jahre,107,53,54
False,8425110,Schnürpflingen,45 - 50 Jahre,98,48,50
False,8425110,Schnürpflingen,50 - 55 Jahre,119,59,60
False,8425110,Schnürpflingen,55 - 60 Jahre,94,46,48
False,8425110,Schnürpflingen,60 - 65 Jahre,80,47,33
False,8425110,Schnürpflingen,65 - 75 Jahre,111,57,54
False,8425110,Schnürpflingen,75 und mehr Jahre,86,33,53
False,8425110,Schnürpflingen,Insgesamt,1330,664,666
False,8425112,Setzingen,unter 3 Jahre,22,13,9
False,8425112,Setzingen,3 -  6 Jahre,18,10,8
False,8425112,Setzingen,6 - 10 Jahre,28,20,8
False,8425112,Setzingen,10 - 15 Jahre,38,25,13
False,8425112,Setzingen,15 - 18 Jahre,19,12,7
False,8425112,Setzingen,18 - 20 Jahre,15,6,9
False,8425112,Setzingen,20 - 25 Jahre,35,18,17
False,8425112,Setzingen,25 - 30 Jahre,41,21,20
False,8425112,Setzingen,30 - 35 Jahre,30,13,17
False,8425112,Setzingen,35 - 40 Jahre,44,20,24
False,8425112,Setzingen,40 - 45 Jahre,47,22,25
False,8425112,Setzingen,45 - 50 Jahre,57,31,26
False,8425112,Setzingen,50 - 55 Jahre,48,22,26
False,8425112,Setzingen,55 - 60 Jahre,39,19,20
False,8425112,Setzingen,60 - 65 Jahre,39,19,20
False,8425112,Setzingen,65 - 75 Jahre,65,34,31
False,8425112,Setzingen,75 und mehr Jahre,41,14,27
False,8425112,Setzingen,Insgesamt,626,319,307
False,8425123,Untermarchtal,unter 3 Jahre,17,7,10
False,8425123,Untermarchtal,3 -  6 Jahre,19,9,10
False,8425123,Untermarchtal,6 - 10 Jahre,43,26,17
False,8425123,Untermarchtal,10 - 15 Jahre,53,23,30
False,8425123,Untermarchtal,15 - 18 Jahre,18,11,7
False,8425123,Untermarchtal,18 - 20 Jahre,27,10,17
False,8425123,Untermarchtal,20 - 25 Jahre,36,23,13
False,8425123,Untermarchtal,25 - 30 Jahre,20,9,11
False,8425123,Untermarchtal,30 - 35 Jahre,43,19,24
False,8425123,Untermarchtal,35 - 40 Jahre,40,21,19
False,8425123,Untermarchtal,40 - 45 Jahre,78,36,42
False,8425123,Untermarchtal,45 - 50 Jahre,57,26,31
False,8425123,Untermarchtal,50 - 55 Jahre,52,24,28
False,8425123,Untermarchtal,55 - 60 Jahre,50,24,26
False,8425123,Untermarchtal,60 - 65 Jahre,36,16,20
False,8425123,Untermarchtal,65 - 75 Jahre,109,29,80
False,8425123,Untermarchtal,75 und mehr Jahre,235,27,208
False,8425123,Untermarchtal,Insgesamt,933,340,593
False,8425124,Unterstadion,unter 3 Jahre,16,9,7
False,8425124,Unterstadion,3 -  6 Jahre,25,9,16
False,8425124,Unterstadion,6 - 10 Jahre,41,17,24
False,8425124,Unterstadion,10 - 15 Jahre,50,27,23
False,8425124,Unterstadion,15 - 18 Jahre,27,18,9
False,8425124,Unterstadion,18 - 20 Jahre,25,15,10
False,8425124,Unterstadion,20 - 25 Jahre,46,18,28
False,8425124,Unterstadion,25 - 30 Jahre,48,24,24
False,8425124,Unterstadion,30 - 35 Jahre,40,19,21
False,8425124,Unterstadion,35 - 40 Jahre,56,24,32
False,8425124,Unterstadion,40 - 45 Jahre,65,36,29
False,8425124,Unterstadion,45 - 50 Jahre,49,25,24
False,8425124,Unterstadion,50 - 55 Jahre,54,28,26
False,8425124,Unterstadion,55 - 60 Jahre,54,29,25
False,8425124,Unterstadion,60 - 65 Jahre,48,29,19
False,8425124,Unterstadion,65 - 75 Jahre,49,20,29
False,8425124,Unterstadion,75 und mehr Jahre,35,15,20
False,8425124,Unterstadion,Insgesamt,728,362,366
False,8425125,Unterwachingen,unter 3 Jahre,11,7,4
False,8425125,Unterwachingen,3 -  6 Jahre,14,8,6
False,8425125,Unterwachingen,6 - 10 Jahre,8,5,3
False,8425125,Unterwachingen,10 - 15 Jahre,15,9,6
False,8425125,Unterwachingen,15 - 18 Jahre,6,3,3
False,8425125,Unterwachingen,18 - 20 Jahre,4,3,1
False,8425125,Unterwachingen,20 - 25 Jahre,10,6,4
False,8425125,Unterwachingen,25 - 30 Jahre,10,5,5
False,8425125,Unterwachingen,30 - 35 Jahre,16,5,11
False,8425125,Unterwachingen,35 - 40 Jahre,12,7,5
False,8425125,Unterwachingen,40 - 45 Jahre,15,7,8
False,8425125,Unterwachingen,45 - 50 Jahre,15,10,5
False,8425125,Unterwachingen,50 - 55 Jahre,7,3,4
False,8425125,Unterwachingen,55 - 60 Jahre,14,8,6
False,8425125,Unterwachingen,60 - 65 Jahre,13,7,6
False,8425125,Unterwachingen,65 - 75 Jahre,20,10,10
False,8425125,Unterwachingen,75 und mehr Jahre,13,2,11
False,8425125,Unterwachingen,Insgesamt,203,105,98
False,8425130,Weidenstetten,unter 3 Jahre,37,18,19
False,8425130,Weidenstetten,3 -  6 Jahre,37,21,16
False,8425130,Weidenstetten,6 - 10 Jahre,57,27,30
False,8425130,Weidenstetten,10 - 15 Jahre,85,42,43
False,8425130,Weidenstetten,15 - 18 Jahre,59,30,29
False,8425130,Weidenstetten,18 - 20 Jahre,29,16,13
False,8425130,Weidenstetten,20 - 25 Jahre,55,27,28
False,8425130,Weidenstetten,25 - 30 Jahre,63,30,33
False,8425130,Weidenstetten,30 - 35 Jahre,82,43,39
False,8425130,Weidenstetten,35 - 40 Jahre,67,42,25
False,8425130,Weidenstetten,40 - 45 Jahre,109,57,52
False,8425130,Weidenstetten,45 - 50 Jahre,99,60,39
False,8425130,Weidenstetten,50 - 55 Jahre,102,51,51
False,8425130,Weidenstetten,55 - 60 Jahre,67,35,32
False,8425130,Weidenstetten,60 - 65 Jahre,57,27,30
False,8425130,Weidenstetten,65 - 75 Jahre,154,73,81
False,8425130,Weidenstetten,75 und mehr Jahre,109,51,58
False,8425130,Weidenstetten,Insgesamt,1268,650,618
False,8425134,Westerheim,unter 3 Jahre,77,39,38
False,8425134,Westerheim,3 -  6 Jahre,97,48,49
False,8425134,Westerheim,6 - 10 Jahre,147,81,66
False,8425134,Westerheim,10 - 15 Jahre,173,86,87
False,8425134,Westerheim,15 - 18 Jahre,93,54,39
False,8425134,Westerheim,18 - 20 Jahre,70,39,31
False,8425134,Westerheim,20 - 25 Jahre,148,84,64
False,8425134,Westerheim,25 - 30 Jahre,159,84,75
False,8425134,Westerheim,30 - 35 Jahre,155,68,87
False,8425134,Westerheim,35 - 40 Jahre,180,86,94
False,8425134,Westerheim,40 - 45 Jahre,243,127,116
False,8425134,Westerheim,45 - 50 Jahre,250,130,120
False,8425134,Westerheim,50 - 55 Jahre,196,90,106
False,8425134,Westerheim,55 - 60 Jahre,195,101,94
False,8425134,Westerheim,60 - 65 Jahre,132,61,71
False,8425134,Westerheim,65 - 75 Jahre,337,173,164
False,8425134,Westerheim,75 und mehr Jahre,212,76,136
False,8425134,Westerheim,Insgesamt,2864,1427,1437
False,8425135,Westerstetten,unter 3 Jahre,59,33,26
False,8425135,Westerstetten,3 -  6 Jahre,72,33,39
False,8425135,Westerstetten,6 - 10 Jahre,93,40,53
False,8425135,Westerstetten,10 - 15 Jahre,137,68,69
False,8425135,Westerstetten,15 - 18 Jahre,80,36,44
False,8425135,Westerstetten,18 - 20 Jahre,67,36,31
False,8425135,Westerstetten,20 - 25 Jahre,132,76,56
False,8425135,Westerstetten,25 - 30 Jahre,134,77,57
False,8425135,Westerstetten,30 - 35 Jahre,128,56,72
False,8425135,Westerstetten,35 - 40 Jahre,154,77,77
False,8425135,Westerstetten,40 - 45 Jahre,163,77,86
False,8425135,Westerstetten,45 - 50 Jahre,201,97,104
False,8425135,Westerstetten,50 - 55 Jahre,196,95,101
False,8425135,Westerstetten,55 - 60 Jahre,145,84,61
False,8425135,Westerstetten,60 - 65 Jahre,101,48,53
False,8425135,Westerstetten,65 - 75 Jahre,183,95,88
False,8425135,Westerstetten,75 und mehr Jahre,158,54,104
False,8425135,Westerstetten,Insgesamt,2203,1082,1121
False,8425137,Illerkirchberg,unter 3 Jahre,138,67,71
False,8425137,Illerkirchberg,3 -  6 Jahre,134,67,67
False,8425137,Illerkirchberg,6 - 10 Jahre,194,106,88
False,8425137,Illerkirchberg,10 - 15 Jahre,294,141,153
False,8425137,Illerkirchberg,15 - 18 Jahre,166,78,88
False,8425137,Illerkirchberg,18 - 20 Jahre,105,62,43
False,8425137,Illerkirchberg,20 - 25 Jahre,232,110,122
False,8425137,Illerkirchberg,25 - 30 Jahre,253,130,123
False,8425137,Illerkirchberg,30 - 35 Jahre,276,153,123
False,8425137,Illerkirchberg,35 - 40 Jahre,301,146,155
False,8425137,Illerkirchberg,40 - 45 Jahre,414,213,201
False,8425137,Illerkirchberg,45 - 50 Jahre,418,225,193
False,8425137,Illerkirchberg,50 - 55 Jahre,353,176,177
False,8425137,Illerkirchberg,55 - 60 Jahre,341,187,154
False,8425137,Illerkirchberg,60 - 65 Jahre,287,144,143
False,8425137,Illerkirchberg,65 - 75 Jahre,475,238,237
False,8425137,Illerkirchberg,75 und mehr Jahre,397,167,230
False,8425137,Illerkirchberg,Insgesamt,4778,2410,2368
False,8425138,Staig,unter 3 Jahre,69,43,26
False,8425138,Staig,3 -  6 Jahre,82,45,37
False,8425138,Staig,6 - 10 Jahre,120,63,57
False,8425138,Staig,10 - 15 Jahre,175,95,80
False,8425138,Staig,15 - 18 Jahre,122,65,57
False,8425138,Staig,18 - 20 Jahre,65,32,33
False,8425138,Staig,20 - 25 Jahre,171,80,91
False,8425138,Staig,25 - 30 Jahre,138,78,60
False,8425138,Staig,30 - 35 Jahre,154,69,85
False,8425138,Staig,35 - 40 Jahre,187,86,101
False,8425138,Staig,40 - 45 Jahre,258,131,127
False,8425138,Staig,45 - 50 Jahre,310,143,167
False,8425138,Staig,50 - 55 Jahre,250,128,122
False,8425138,Staig,55 - 60 Jahre,219,115,104
False,8425138,Staig,60 - 65 Jahre,187,99,88
False,8425138,Staig,65 - 75 Jahre,377,200,177
False,8425138,Staig,75 und mehr Jahre,252,106,146
False,8425138,Staig,Insgesamt,3136,1578,1558
False,8425139,Heroldstatt,unter 3 Jahre,63,38,25
False,8425139,Heroldstatt,3 -  6 Jahre,83,38,45
False,8425139,Heroldstatt,6 - 10 Jahre,106,42,64
False,8425139,Heroldstatt,10 - 15 Jahre,184,98,86
False,8425139,Heroldstatt,15 - 18 Jahre,107,58,49
False,8425139,Heroldstatt,18 - 20 Jahre,83,40,43
False,8425139,Heroldstatt,20 - 25 Jahre,140,89,51
False,8425139,Heroldstatt,25 - 30 Jahre,127,69,58
False,8425139,Heroldstatt,30 - 35 Jahre,164,83,81
False,8425139,Heroldstatt,35 - 40 Jahre,148,70,78
False,8425139,Heroldstatt,40 - 45 Jahre,229,126,103
False,8425139,Heroldstatt,45 - 50 Jahre,266,137,129
False,8425139,Heroldstatt,50 - 55 Jahre,199,104,95
False,8425139,Heroldstatt,55 - 60 Jahre,146,76,70
False,8425139,Heroldstatt,60 - 65 Jahre,132,67,65
False,8425139,Heroldstatt,65 - 75 Jahre,247,112,135
False,8425139,Heroldstatt,75 und mehr Jahre,248,88,160
False,8425139,Heroldstatt,Insgesamt,2672,1335,1337
False,8425140,Balzheim,unter 3 Jahre,53,36,17
False,8425140,Balzheim,3 -  6 Jahre,72,36,36
False,8425140,Balzheim,6 - 10 Jahre,76,45,31
False,8425140,Balzheim,10 - 15 Jahre,142,66,76
False,8425140,Balzheim,15 - 18 Jahre,82,41,41
False,8425140,Balzheim,18 - 20 Jahre,52,28,24
False,8425140,Balzheim,20 - 25 Jahre,138,89,49
False,8425140,Balzheim,25 - 30 Jahre,100,52,48
False,8425140,Balzheim,30 - 35 Jahre,112,58,54
False,8425140,Balzheim,35 - 40 Jahre,83,48,35
False,8425140,Balzheim,40 - 45 Jahre,195,90,105
False,8425140,Balzheim,45 - 50 Jahre,193,99,94
False,8425140,Balzheim,50 - 55 Jahre,181,88,93
False,8425140,Balzheim,55 - 60 Jahre,141,85,56
False,8425140,Balzheim,60 - 65 Jahre,103,58,45
False,8425140,Balzheim,65 - 75 Jahre,160,74,86
False,8425140,Balzheim,75 und mehr Jahre,110,55,55
False,8425140,Balzheim,Insgesamt,1993,1048,945
False,8425141,Blaustein,unter 3 Jahre,411,216,195
False,8425141,Blaustein,3 -  6 Jahre,460,236,224
False,8425141,Blaustein,6 - 10 Jahre,627,314,313
False,8425141,Blaustein,10 - 15 Jahre,816,414,402
False,8425141,Blaustein,15 - 18 Jahre,467,254,213
False,8425141,Blaustein,18 - 20 Jahre,340,176,164
False,8425141,Blaustein,20 - 25 Jahre,850,419,431
False,8425141,Blaustein,25 - 30 Jahre,956,484,472
False,8425141,Blaustein,30 - 35 Jahre,972,518,454
False,8425141,Blaustein,35 - 40 Jahre,1022,522,500
False,8425141,Blaustein,40 - 45 Jahre,1342,686,656
False,8425141,Blaustein,45 - 50 Jahre,1362,692,670
False,8425141,Blaustein,50 - 55 Jahre,1109,553,556
False,8425141,Blaustein,55 - 60 Jahre,926,475,451
False,8425141,Blaustein,60 - 65 Jahre,795,387,408
False,8425141,Blaustein,65 - 75 Jahre,1660,799,861
False,8425141,Blaustein,75 und mehr Jahre,1374,565,809
False,8425141,Blaustein,Insgesamt,15489,7710,7779
False,8426,Landkreis Biberach,unter 3 Jahre,5252,2654,2598
False,8426,Landkreis Biberach,3 -  6 Jahre,5491,2848,2643
False,8426,Landkreis Biberach,6 - 10 Jahre,8002,4083,3919
False,8426,Landkreis Biberach,10 - 15 Jahre,11550,5872,5678
False,8426,Landkreis Biberach,15 - 18 Jahre,7121,3632,3489
False,8426,Landkreis Biberach,18 - 20 Jahre,5093,2602,2491
False,8426,Landkreis Biberach,20 - 25 Jahre,11725,6193,5532
False,8426,Landkreis Biberach,25 - 30 Jahre,11120,5720,5400
False,8426,Landkreis Biberach,30 - 35 Jahre,10777,5450,5327
False,8426,Landkreis Biberach,35 - 40 Jahre,12105,6035,6070
False,8426,Landkreis Biberach,40 - 45 Jahre,15654,7989,7665
False,8426,Landkreis Biberach,45 - 50 Jahre,15984,8309,7675
False,8426,Landkreis Biberach,50 - 55 Jahre,14341,7209,7132
False,8426,Landkreis Biberach,55 - 60 Jahre,11944,6129,5815
False,8426,Landkreis Biberach,60 - 65 Jahre,9790,5006,4784
False,8426,Landkreis Biberach,65 - 75 Jahre,17944,8672,9272
False,8426,Landkreis Biberach,75 und mehr Jahre,15419,5932,9487
False,8426,Landkreis Biberach,Insgesamt,189312,94335,94977
False,8426001,Achstetten,unter 3 Jahre,147,69,78
False,8426001,Achstetten,3 -  6 Jahre,133,65,68
False,8426001,Achstetten,6 - 10 Jahre,220,116,104
False,8426001,Achstetten,10 - 15 Jahre,245,127,118
False,8426001,Achstetten,15 - 18 Jahre,162,77,85
False,8426001,Achstetten,18 - 20 Jahre,117,57,60
False,8426001,Achstetten,20 - 25 Jahre,260,124,136
False,8426001,Achstetten,25 - 30 Jahre,265,139,126
False,8426001,Achstetten,30 - 35 Jahre,273,150,123
False,8426001,Achstetten,35 - 40 Jahre,323,168,155
False,8426001,Achstetten,40 - 45 Jahre,360,186,174
False,8426001,Achstetten,45 - 50 Jahre,342,166,176
False,8426001,Achstetten,50 - 55 Jahre,280,138,142
False,8426001,Achstetten,55 - 60 Jahre,245,113,132
False,8426001,Achstetten,60 - 65 Jahre,230,122,108
False,8426001,Achstetten,65 - 75 Jahre,316,161,155
False,8426001,Achstetten,75 und mehr Jahre,257,100,157
False,8426001,Achstetten,Insgesamt,4175,2078,2097
False,8426005,Alleshausen,unter 3 Jahre,8,4,4
False,8426005,Alleshausen,3 -  6 Jahre,15,9,6
False,8426005,Alleshausen,6 - 10 Jahre,25,10,15
False,8426005,Alleshausen,10 - 15 Jahre,32,21,11
False,8426005,Alleshausen,15 - 18 Jahre,23,12,11
False,8426005,Alleshausen,18 - 20 Jahre,13,8,5
False,8426005,Alleshausen,20 - 25 Jahre,40,22,18
False,8426005,Alleshausen,25 - 30 Jahre,32,22,10
False,8426005,Alleshausen,30 - 35 Jahre,21,8,13
False,8426005,Alleshausen,35 - 40 Jahre,15,11,4
False,8426005,Alleshausen,40 - 45 Jahre,44,21,23
False,8426005,Alleshausen,45 - 50 Jahre,40,23,17
False,8426005,Alleshausen,50 - 55 Jahre,39,18,21
False,8426005,Alleshausen,55 - 60 Jahre,25,13,12
False,8426005,Alleshausen,60 - 65 Jahre,28,16,12
False,8426005,Alleshausen,65 - 75 Jahre,33,16,17
False,8426005,Alleshausen,75 und mehr Jahre,57,21,36
False,8426005,Alleshausen,Insgesamt,490,255,235
False,8426006,Allmannsweiler,unter 3 Jahre,4,3,1
False,8426006,Allmannsweiler,3 -  6 Jahre,7,4,3
False,8426006,Allmannsweiler,6 - 10 Jahre,15,6,9
False,8426006,Allmannsweiler,10 - 15 Jahre,24,10,14
False,8426006,Allmannsweiler,15 - 18 Jahre,17,8,9
False,8426006,Allmannsweiler,18 - 20 Jahre,10,2,8
False,8426006,Allmannsweiler,20 - 25 Jahre,21,11,10
False,8426006,Allmannsweiler,25 - 30 Jahre,17,10,7
False,8426006,Allmannsweiler,30 - 35 Jahre,8,2,6
False,8426006,Allmannsweiler,35 - 40 Jahre,12,5,7
False,8426006,Allmannsweiler,40 - 45 Jahre,30,13,17
False,8426006,Allmannsweiler,45 - 50 Jahre,41,22,19
False,8426006,Allmannsweiler,50 - 55 Jahre,25,14,11
False,8426006,Allmannsweiler,55 - 60 Jahre,21,14,7
False,8426006,Allmannsweiler,60 - 65 Jahre,7,3,4
False,8426006,Allmannsweiler,65 - 75 Jahre,23,15,8
False,8426006,Allmannsweiler,75 und mehr Jahre,22,12,10
False,8426006,Allmannsweiler,Insgesamt,304,154,150
False,8426008,Altheim,unter 3 Jahre,57,29,28
False,8426008,Altheim,3 -  6 Jahre,65,30,35
False,8426008,Altheim,6 - 10 Jahre,103,58,45
False,8426008,Altheim,10 - 15 Jahre,137,61,76
False,8426008,Altheim,15 - 18 Jahre,80,33,47
False,8426008,Altheim,18 - 20 Jahre,69,27,42
False,8426008,Altheim,20 - 25 Jahre,139,78,61
False,8426008,Altheim,25 - 30 Jahre,119,71,48
False,8426008,Altheim,30 - 35 Jahre,114,61,53
False,8426008,Altheim,35 - 40 Jahre,138,62,76
False,8426008,Altheim,40 - 45 Jahre,208,108,100
False,8426008,Altheim,45 - 50 Jahre,187,97,90
False,8426008,Altheim,50 - 55 Jahre,202,96,106
False,8426008,Altheim,55 - 60 Jahre,144,84,60
False,8426008,Altheim,60 - 65 Jahre,130,67,63
False,8426008,Altheim,65 - 75 Jahre,191,103,88
False,8426008,Altheim,75 und mehr Jahre,184,67,117
False,8426008,Altheim,Insgesamt,2267,1132,1135
False,8426011,Attenweiler,unter 3 Jahre,49,26,23
False,8426011,Attenweiler,3 -  6 Jahre,45,22,23
False,8426011,Attenweiler,6 - 10 Jahre,85,44,41
False,8426011,Attenweiler,10 - 15 Jahre,130,78,52
False,8426011,Attenweiler,15 - 18 Jahre,71,33,38
False,8426011,Attenweiler,18 - 20 Jahre,53,34,19
False,8426011,Attenweiler,20 - 25 Jahre,114,65,49
False,8426011,Attenweiler,25 - 30 Jahre,90,51,39
False,8426011,Attenweiler,30 - 35 Jahre,91,44,47
False,8426011,Attenweiler,35 - 40 Jahre,105,66,39
False,8426011,Attenweiler,40 - 45 Jahre,166,80,86
False,8426011,Attenweiler,45 - 50 Jahre,149,92,57
False,8426011,Attenweiler,50 - 55 Jahre,130,70,60
False,8426011,Attenweiler,55 - 60 Jahre,115,59,56
False,8426011,Attenweiler,60 - 65 Jahre,66,34,32
False,8426011,Attenweiler,65 - 75 Jahre,158,77,81
False,8426011,Attenweiler,75 und mehr Jahre,119,55,64
False,8426011,Attenweiler,Insgesamt,1736,930,806
False,8426013,"Bad Buchau, Stadt",unter 3 Jahre,105,53,52
False,8426013,"Bad Buchau, Stadt",3 -  6 Jahre,107,51,56
False,8426013,"Bad Buchau, Stadt",6 - 10 Jahre,121,57,64
False,8426013,"Bad Buchau, Stadt",10 - 15 Jahre,196,98,98
False,8426013,"Bad Buchau, Stadt",15 - 18 Jahre,134,63,71
False,8426013,"Bad Buchau, Stadt",18 - 20 Jahre,96,50,46
False,8426013,"Bad Buchau, Stadt",20 - 25 Jahre,231,133,98
False,8426013,"Bad Buchau, Stadt",25 - 30 Jahre,221,124,97
False,8426013,"Bad Buchau, Stadt",30 - 35 Jahre,219,108,111
False,8426013,"Bad Buchau, Stadt",35 - 40 Jahre,228,122,106
False,8426013,"Bad Buchau, Stadt",40 - 45 Jahre,287,145,142
False,8426013,"Bad Buchau, Stadt",45 - 50 Jahre,297,172,125
False,8426013,"Bad Buchau, Stadt",50 - 55 Jahre,327,154,173
False,8426013,"Bad Buchau, Stadt",55 - 60 Jahre,250,114,136
False,8426013,"Bad Buchau, Stadt",60 - 65 Jahre,244,113,131
False,8426013,"Bad Buchau, Stadt",65 - 75 Jahre,469,233,236
False,8426013,"Bad Buchau, Stadt",75 und mehr Jahre,459,176,283
False,8426013,"Bad Buchau, Stadt",Insgesamt,3991,1966,2025
False,8426014,"Bad Schussenried, Stadt",unter 3 Jahre,198,97,101
False,8426014,"Bad Schussenried, Stadt",3 -  6 Jahre,234,126,108
False,8426014,"Bad Schussenried, Stadt",6 - 10 Jahre,347,176,171
False,8426014,"Bad Schussenried, Stadt",10 - 15 Jahre,507,270,237
False,8426014,"Bad Schussenried, Stadt",15 - 18 Jahre,282,151,131
False,8426014,"Bad Schussenried, Stadt",18 - 20 Jahre,214,102,112
False,8426014,"Bad Schussenried, Stadt",20 - 25 Jahre,476,246,230
False,8426014,"Bad Schussenried, Stadt",25 - 30 Jahre,468,228,240
False,8426014,"Bad Schussenried, Stadt",30 - 35 Jahre,443,216,227
False,8426014,"Bad Schussenried, Stadt",35 - 40 Jahre,488,250,238
False,8426014,"Bad Schussenried, Stadt",40 - 45 Jahre,683,344,339
False,8426014,"Bad Schussenried, Stadt",45 - 50 Jahre,722,372,350
False,8426014,"Bad Schussenried, Stadt",50 - 55 Jahre,680,341,339
False,8426014,"Bad Schussenried, Stadt",55 - 60 Jahre,556,298,258
False,8426014,"Bad Schussenried, Stadt",60 - 65 Jahre,421,213,208
False,8426014,"Bad Schussenried, Stadt",65 - 75 Jahre,905,440,465
False,8426014,"Bad Schussenried, Stadt",75 und mehr Jahre,840,325,515
False,8426014,"Bad Schussenried, Stadt",Insgesamt,8464,4195,4269
False,8426019,Berkheim,unter 3 Jahre,80,37,43
False,8426019,Berkheim,3 -  6 Jahre,85,48,37
False,8426019,Berkheim,6 - 10 Jahre,121,64,57
False,8426019,Berkheim,10 - 15 Jahre,170,89,81
False,8426019,Berkheim,15 - 18 Jahre,106,59,47
False,8426019,Berkheim,18 - 20 Jahre,54,21,33
False,8426019,Berkheim,20 - 25 Jahre,146,85,61
False,8426019,Berkheim,25 - 30 Jahre,157,88,69
False,8426019,Berkheim,30 - 35 Jahre,194,89,105
False,8426019,Berkheim,35 - 40 Jahre,223,93,130
False,8426019,Berkheim,40 - 45 Jahre,209,114,95
False,8426019,Berkheim,45 - 50 Jahre,183,97,86
False,8426019,Berkheim,50 - 55 Jahre,173,85,88
False,8426019,Berkheim,55 - 60 Jahre,195,99,96
False,8426019,Berkheim,60 - 65 Jahre,157,83,74
False,8426019,Berkheim,65 - 75 Jahre,229,121,108
False,8426019,Berkheim,75 und mehr Jahre,186,66,120
False,8426019,Berkheim,Insgesamt,2668,1338,1330
False,8426020,Betzenweiler,unter 3 Jahre,17,10,7
False,8426020,Betzenweiler,3 -  6 Jahre,20,13,7
False,8426020,Betzenweiler,6 - 10 Jahre,37,16,21
False,8426020,Betzenweiler,10 - 15 Jahre,53,25,28
False,8426020,Betzenweiler,15 - 18 Jahre,28,15,13
False,8426020,Betzenweiler,18 - 20 Jahre,22,14,8
False,8426020,Betzenweiler,20 - 25 Jahre,53,32,21
False,8426020,Betzenweiler,25 - 30 Jahre,39,22,17
False,8426020,Betzenweiler,30 - 35 Jahre,38,18,20
False,8426020,Betzenweiler,35 - 40 Jahre,44,21,23
False,8426020,Betzenweiler,40 - 45 Jahre,59,25,34
False,8426020,Betzenweiler,45 - 50 Jahre,63,38,25
False,8426020,Betzenweiler,50 - 55 Jahre,45,19,26
False,8426020,Betzenweiler,55 - 60 Jahre,53,29,24
False,8426020,Betzenweiler,60 - 65 Jahre,39,22,17
False,8426020,Betzenweiler,65 - 75 Jahre,51,22,29
False,8426020,Betzenweiler,75 und mehr Jahre,37,15,22
False,8426020,Betzenweiler,Insgesamt,698,356,342
False,8426021,"Biberach an der Riß, Stadt",unter 3 Jahre,857,429,428
False,8426021,"Biberach an der Riß, Stadt",3 -  6 Jahre,836,423,413
False,8426021,"Biberach an der Riß, Stadt",6 - 10 Jahre,1162,595,567
False,8426021,"Biberach an der Riß, Stadt",10 - 15 Jahre,1700,838,862
False,8426021,"Biberach an der Riß, Stadt",15 - 18 Jahre,1041,535,506
False,8426021,"Biberach an der Riß, Stadt",18 - 20 Jahre,805,423,382
False,8426021,"Biberach an der Riß, Stadt",20 - 25 Jahre,1930,997,933
False,8426021,"Biberach an der Riß, Stadt",25 - 30 Jahre,2045,1051,994
False,8426021,"Biberach an der Riß, Stadt",30 - 35 Jahre,1975,1006,969
False,8426021,"Biberach an der Riß, Stadt",35 - 40 Jahre,1996,994,1002
False,8426021,"Biberach an der Riß, Stadt",40 - 45 Jahre,2546,1306,1240
False,8426021,"Biberach an der Riß, Stadt",45 - 50 Jahre,2577,1327,1250
False,8426021,"Biberach an der Riß, Stadt",50 - 55 Jahre,2382,1141,1241
False,8426021,"Biberach an der Riß, Stadt",55 - 60 Jahre,2030,993,1037
False,8426021,"Biberach an der Riß, Stadt",60 - 65 Jahre,1782,858,924
False,8426021,"Biberach an der Riß, Stadt",65 - 75 Jahre,3468,1595,1873
False,8426021,"Biberach an der Riß, Stadt",75 und mehr Jahre,3262,1230,2032
False,8426021,"Biberach an der Riß, Stadt",Insgesamt,32394,15741,16653
False,8426028,Burgrieden,unter 3 Jahre,99,51,48
False,8426028,Burgrieden,3 -  6 Jahre,114,57,57
False,8426028,Burgrieden,6 - 10 Jahre,167,90,77
False,8426028,Burgrieden,10 - 15 Jahre,257,126,131
False,8426028,Burgrieden,15 - 18 Jahre,155,79,76
False,8426028,Burgrieden,18 - 20 Jahre,102,53,49
False,8426028,Burgrieden,20 - 25 Jahre,214,122,92
False,8426028,Burgrieden,25 - 30 Jahre,194,98,96
False,8426028,Burgrieden,30 - 35 Jahre,188,93,95
False,8426028,Burgrieden,35 - 40 Jahre,222,97,125
False,8426028,Burgrieden,40 - 45 Jahre,349,182,167
False,8426028,Burgrieden,45 - 50 Jahre,394,211,183
False,8426028,Burgrieden,50 - 55 Jahre,283,150,133
False,8426028,Burgrieden,55 - 60 Jahre,212,112,100
False,8426028,Burgrieden,60 - 65 Jahre,151,82,69
False,8426028,Burgrieden,65 - 75 Jahre,274,135,139
False,8426028,Burgrieden,75 und mehr Jahre,244,93,151
False,8426028,Burgrieden,Insgesamt,3619,1831,1788
False,8426031,Dettingen an der Iller,unter 3 Jahre,60,29,31
False,8426031,Dettingen an der Iller,3 -  6 Jahre,92,46,46
False,8426031,Dettingen an der Iller,6 - 10 Jahre,114,57,57
False,8426031,Dettingen an der Iller,10 - 15 Jahre,152,73,79
False,8426031,Dettingen an der Iller,15 - 18 Jahre,90,41,49
False,8426031,Dettingen an der Iller,18 - 20 Jahre,74,42,32
False,8426031,Dettingen an der Iller,20 - 25 Jahre,187,97,90
False,8426031,Dettingen an der Iller,25 - 30 Jahre,137,59,78
False,8426031,Dettingen an der Iller,30 - 35 Jahre,135,71,64
False,8426031,Dettingen an der Iller,35 - 40 Jahre,147,74,73
False,8426031,Dettingen an der Iller,40 - 45 Jahre,202,111,91
False,8426031,Dettingen an der Iller,45 - 50 Jahre,216,99,117
False,8426031,Dettingen an der Iller,50 - 55 Jahre,185,99,86
False,8426031,Dettingen an der Iller,55 - 60 Jahre,130,70,60
False,8426031,Dettingen an der Iller,60 - 65 Jahre,79,47,32
False,8426031,Dettingen an der Iller,65 - 75 Jahre,200,98,102
False,8426031,Dettingen an der Iller,75 und mehr Jahre,136,66,70
False,8426031,Dettingen an der Iller,Insgesamt,2336,1179,1157
False,8426035,Dürmentingen,unter 3 Jahre,73,33,40
False,8426035,Dürmentingen,3 -  6 Jahre,77,39,38
False,8426035,Dürmentingen,6 - 10 Jahre,121,65,56
False,8426035,Dürmentingen,10 - 15 Jahre,193,97,96
False,8426035,Dürmentingen,15 - 18 Jahre,103,51,52
False,8426035,Dürmentingen,18 - 20 Jahre,82,49,33
False,8426035,Dürmentingen,20 - 25 Jahre,170,83,87
False,8426035,Dürmentingen,25 - 30 Jahre,131,73,58
False,8426035,Dürmentingen,30 - 35 Jahre,144,64,80
False,8426035,Dürmentingen,35 - 40 Jahre,165,98,67
False,8426035,Dürmentingen,40 - 45 Jahre,205,110,95
False,8426035,Dürmentingen,45 - 50 Jahre,198,101,97
False,8426035,Dürmentingen,50 - 55 Jahre,198,104,94
False,8426035,Dürmentingen,55 - 60 Jahre,157,85,72
False,8426035,Dürmentingen,60 - 65 Jahre,130,62,68
False,8426035,Dürmentingen,65 - 75 Jahre,212,99,113
False,8426035,Dürmentingen,75 und mehr Jahre,228,88,140
False,8426035,Dürmentingen,Insgesamt,2587,1301,1286
False,8426036,Dürnau,unter 3 Jahre,7,3,4
False,8426036,Dürnau,3 -  6 Jahre,11,5,6
False,8426036,Dürnau,6 - 10 Jahre,21,12,9
False,8426036,Dürnau,10 - 15 Jahre,37,21,16
False,8426036,Dürnau,15 - 18 Jahre,9,5,4
False,8426036,Dürnau,18 - 20 Jahre,12,5,7
False,8426036,Dürnau,20 - 25 Jahre,30,16,14
False,8426036,Dürnau,25 - 30 Jahre,36,18,18
False,8426036,Dürnau,30 - 35 Jahre,27,17,10
False,8426036,Dürnau,35 - 40 Jahre,29,12,17
False,8426036,Dürnau,40 - 45 Jahre,40,20,20
False,8426036,Dürnau,45 - 50 Jahre,36,18,18
False,8426036,Dürnau,50 - 55 Jahre,23,15,8
False,8426036,Dürnau,55 - 60 Jahre,34,16,18
False,8426036,Dürnau,60 - 65 Jahre,28,12,16
False,8426036,Dürnau,65 - 75 Jahre,36,18,18
False,8426036,Dürnau,75 und mehr Jahre,38,18,20
False,8426036,Dürnau,Insgesamt,454,231,223
False,8426038,Eberhardzell,unter 3 Jahre,134,76,58
False,8426038,Eberhardzell,3 -  6 Jahre,134,79,55
False,8426038,Eberhardzell,6 - 10 Jahre,187,100,87
False,8426038,Eberhardzell,10 - 15 Jahre,281,142,139
False,8426038,Eberhardzell,15 - 18 Jahre,177,93,84
False,8426038,Eberhardzell,18 - 20 Jahre,122,74,48
False,8426038,Eberhardzell,20 - 25 Jahre,268,149,119
False,8426038,Eberhardzell,25 - 30 Jahre,239,125,114
False,8426038,Eberhardzell,30 - 35 Jahre,242,123,119
False,8426038,Eberhardzell,35 - 40 Jahre,232,104,128
False,8426038,Eberhardzell,40 - 45 Jahre,370,196,174
False,8426038,Eberhardzell,45 - 50 Jahre,365,191,174
False,8426038,Eberhardzell,50 - 55 Jahre,332,158,174
False,8426038,Eberhardzell,55 - 60 Jahre,282,160,122
False,8426038,Eberhardzell,60 - 65 Jahre,183,105,78
False,8426038,Eberhardzell,65 - 75 Jahre,321,161,160
False,8426038,Eberhardzell,75 und mehr Jahre,291,106,185
False,8426038,Eberhardzell,Insgesamt,4160,2142,2018
False,8426043,Erlenmoos,unter 3 Jahre,47,25,22
False,8426043,Erlenmoos,3 -  6 Jahre,52,27,25
False,8426043,Erlenmoos,6 - 10 Jahre,95,36,59
False,8426043,Erlenmoos,10 - 15 Jahre,126,70,56
False,8426043,Erlenmoos,15 - 18 Jahre,68,38,30
False,8426043,Erlenmoos,18 - 20 Jahre,48,20,28
False,8426043,Erlenmoos,20 - 25 Jahre,100,65,35
False,8426043,Erlenmoos,25 - 30 Jahre,84,43,41
False,8426043,Erlenmoos,30 - 35 Jahre,96,45,51
False,8426043,Erlenmoos,35 - 40 Jahre,101,47,54
False,8426043,Erlenmoos,40 - 45 Jahre,164,90,74
False,8426043,Erlenmoos,45 - 50 Jahre,114,63,51
False,8426043,Erlenmoos,50 - 55 Jahre,134,67,67
False,8426043,Erlenmoos,55 - 60 Jahre,94,53,41
False,8426043,Erlenmoos,60 - 65 Jahre,78,47,31
False,8426043,Erlenmoos,65 - 75 Jahre,141,64,77
False,8426043,Erlenmoos,75 und mehr Jahre,115,55,60
False,8426043,Erlenmoos,Insgesamt,1657,855,802
False,8426044,Erolzheim,unter 3 Jahre,92,45,47
False,8426044,Erolzheim,3 -  6 Jahre,87,44,43
False,8426044,Erolzheim,6 - 10 Jahre,134,75,59
False,8426044,Erolzheim,10 - 15 Jahre,178,91,87
False,8426044,Erolzheim,15 - 18 Jahre,130,66,64
False,8426044,Erolzheim,18 - 20 Jahre,84,43,41
False,8426044,Erolzheim,20 - 25 Jahre,215,108,107
False,8426044,Erolzheim,25 - 30 Jahre,212,110,102
False,8426044,Erolzheim,30 - 35 Jahre,155,75,80
False,8426044,Erolzheim,35 - 40 Jahre,184,95,89
False,8426044,Erolzheim,40 - 45 Jahre,252,106,146
False,8426044,Erolzheim,45 - 50 Jahre,304,149,155
False,8426044,Erolzheim,50 - 55 Jahre,247,118,129
False,8426044,Erolzheim,55 - 60 Jahre,208,108,100
False,8426044,Erolzheim,60 - 65 Jahre,169,88,81
False,8426044,Erolzheim,65 - 75 Jahre,272,133,139
False,8426044,Erolzheim,75 und mehr Jahre,262,97,165
False,8426044,Erolzheim,Insgesamt,3185,1551,1634
False,8426045,Ertingen,unter 3 Jahre,164,82,82
False,8426045,Ertingen,3 -  6 Jahre,162,82,80
False,8426045,Ertingen,6 - 10 Jahre,259,137,122
False,8426045,Ertingen,10 - 15 Jahre,347,196,151
False,8426045,Ertingen,15 - 18 Jahre,200,107,93
False,8426045,Ertingen,18 - 20 Jahre,159,81,78
False,8426045,Ertingen,20 - 25 Jahre,336,203,133
False,8426045,Ertingen,25 - 30 Jahre,297,149,148
False,8426045,Ertingen,30 - 35 Jahre,249,116,133
False,8426045,Ertingen,35 - 40 Jahre,365,172,193
False,8426045,Ertingen,40 - 45 Jahre,445,217,228
False,8426045,Ertingen,45 - 50 Jahre,434,221,213
False,8426045,Ertingen,50 - 55 Jahre,413,197,216
False,8426045,Ertingen,55 - 60 Jahre,346,187,159
False,8426045,Ertingen,60 - 65 Jahre,251,134,117
False,8426045,Ertingen,65 - 75 Jahre,497,252,245
False,8426045,Ertingen,75 und mehr Jahre,470,164,306
False,8426045,Ertingen,Insgesamt,5394,2697,2697
False,8426058,Hochdorf,unter 3 Jahre,76,35,41
False,8426058,Hochdorf,3 -  6 Jahre,70,28,42
False,8426058,Hochdorf,6 - 10 Jahre,92,46,46
False,8426058,Hochdorf,10 - 15 Jahre,124,67,57
False,8426058,Hochdorf,15 - 18 Jahre,76,32,44
False,8426058,Hochdorf,18 - 20 Jahre,59,27,32
False,8426058,Hochdorf,20 - 25 Jahre,105,50,55
False,8426058,Hochdorf,25 - 30 Jahre,121,51,70
False,8426058,Hochdorf,30 - 35 Jahre,137,68,69
False,8426058,Hochdorf,35 - 40 Jahre,155,79,76
False,8426058,Hochdorf,40 - 45 Jahre,165,85,80
False,8426058,Hochdorf,45 - 50 Jahre,193,101,92
False,8426058,Hochdorf,50 - 55 Jahre,149,65,84
False,8426058,Hochdorf,55 - 60 Jahre,143,78,65
False,8426058,Hochdorf,60 - 65 Jahre,134,68,66
False,8426058,Hochdorf,65 - 75 Jahre,205,105,100
False,8426058,Hochdorf,75 und mehr Jahre,135,60,75
False,8426058,Hochdorf,Insgesamt,2139,1045,1094
False,8426062,Ingoldingen,unter 3 Jahre,86,44,42
False,8426062,Ingoldingen,3 -  6 Jahre,73,40,33
False,8426062,Ingoldingen,6 - 10 Jahre,82,40,42
False,8426062,Ingoldingen,10 - 15 Jahre,154,82,72
False,8426062,Ingoldingen,15 - 18 Jahre,125,64,61
False,8426062,Ingoldingen,18 - 20 Jahre,79,44,35
False,8426062,Ingoldingen,20 - 25 Jahre,172,91,81
False,8426062,Ingoldingen,25 - 30 Jahre,159,73,86
False,8426062,Ingoldingen,30 - 35 Jahre,155,76,79
False,8426062,Ingoldingen,35 - 40 Jahre,143,83,60
False,8426062,Ingoldingen,40 - 45 Jahre,215,109,106
False,8426062,Ingoldingen,45 - 50 Jahre,185,95,90
False,8426062,Ingoldingen,50 - 55 Jahre,207,105,102
False,8426062,Ingoldingen,55 - 60 Jahre,204,101,103
False,8426062,Ingoldingen,60 - 65 Jahre,161,84,77
False,8426062,Ingoldingen,65 - 75 Jahre,239,128,111
False,8426062,Ingoldingen,75 und mehr Jahre,191,84,107
False,8426062,Ingoldingen,Insgesamt,2630,1343,1287
False,8426064,Kanzach,unter 3 Jahre,12,4,8
False,8426064,Kanzach,3 -  6 Jahre,15,6,9
False,8426064,Kanzach,6 - 10 Jahre,17,9,8
False,8426064,Kanzach,10 - 15 Jahre,21,12,9
False,8426064,Kanzach,15 - 18 Jahre,16,8,8
False,8426064,Kanzach,18 - 20 Jahre,20,8,12
False,8426064,Kanzach,20 - 25 Jahre,32,20,12
False,8426064,Kanzach,25 - 30 Jahre,25,11,14
False,8426064,Kanzach,30 - 35 Jahre,20,8,12
False,8426064,Kanzach,35 - 40 Jahre,21,10,11
False,8426064,Kanzach,40 - 45 Jahre,35,21,14
False,8426064,Kanzach,45 - 50 Jahre,48,24,24
False,8426064,Kanzach,50 - 55 Jahre,39,22,17
False,8426064,Kanzach,55 - 60 Jahre,40,22,18
False,8426064,Kanzach,60 - 65 Jahre,19,8,11
False,8426064,Kanzach,65 - 75 Jahre,40,22,18
False,8426064,Kanzach,75 und mehr Jahre,44,15,29
False,8426064,Kanzach,Insgesamt,464,230,234
False,8426065,Kirchberg an der Iller,unter 3 Jahre,57,25,32
False,8426065,Kirchberg an der Iller,3 -  6 Jahre,65,36,29
False,8426065,Kirchberg an der Iller,6 - 10 Jahre,84,46,38
False,8426065,Kirchberg an der Iller,10 - 15 Jahre,108,53,55
False,8426065,Kirchberg an der Iller,15 - 18 Jahre,60,33,27
False,8426065,Kirchberg an der Iller,18 - 20 Jahre,47,22,25
False,8426065,Kirchberg an der Iller,20 - 25 Jahre,128,66,62
False,8426065,Kirchberg an der Iller,25 - 30 Jahre,112,70,42
False,8426065,Kirchberg an der Iller,30 - 35 Jahre,112,52,60
False,8426065,Kirchberg an der Iller,35 - 40 Jahre,125,63,62
False,8426065,Kirchberg an der Iller,40 - 45 Jahre,152,74,78
False,8426065,Kirchberg an der Iller,45 - 50 Jahre,164,80,84
False,8426065,Kirchberg an der Iller,50 - 55 Jahre,127,69,58
False,8426065,Kirchberg an der Iller,55 - 60 Jahre,127,65,62
False,8426065,Kirchberg an der Iller,60 - 65 Jahre,117,56,61
False,8426065,Kirchberg an der Iller,65 - 75 Jahre,183,93,90
False,8426065,Kirchberg an der Iller,75 und mehr Jahre,142,60,82
False,8426065,Kirchberg an der Iller,Insgesamt,1910,963,947
False,8426066,Kirchdorf an der Iller,unter 3 Jahre,88,48,40
False,8426066,Kirchdorf an der Iller,3 -  6 Jahre,90,47,43
False,8426066,Kirchdorf an der Iller,6 - 10 Jahre,168,90,78
False,8426066,Kirchdorf an der Iller,10 - 15 Jahre,255,153,102
False,8426066,Kirchdorf an der Iller,15 - 18 Jahre,126,62,64
False,8426066,Kirchdorf an der Iller,18 - 20 Jahre,110,56,54
False,8426066,Kirchdorf an der Iller,20 - 25 Jahre,236,118,118
False,8426066,Kirchdorf an der Iller,25 - 30 Jahre,209,102,107
False,8426066,Kirchdorf an der Iller,30 - 35 Jahre,206,112,94
False,8426066,Kirchdorf an der Iller,35 - 40 Jahre,196,90,106
False,8426066,Kirchdorf an der Iller,40 - 45 Jahre,264,134,130
False,8426066,Kirchdorf an der Iller,45 - 50 Jahre,316,163,153
False,8426066,Kirchdorf an der Iller,50 - 55 Jahre,253,130,123
False,8426066,Kirchdorf an der Iller,55 - 60 Jahre,238,113,125
False,8426066,Kirchdorf an der Iller,60 - 65 Jahre,191,109,82
False,8426066,Kirchdorf an der Iller,65 - 75 Jahre,289,132,157
False,8426066,Kirchdorf an der Iller,75 und mehr Jahre,235,96,139
False,8426066,Kirchdorf an der Iller,Insgesamt,3470,1755,1715
False,8426067,Langenenslingen,unter 3 Jahre,89,42,47
False,8426067,Langenenslingen,3 -  6 Jahre,110,50,60
False,8426067,Langenenslingen,6 - 10 Jahre,180,94,86
False,8426067,Langenenslingen,10 - 15 Jahre,260,128,132
False,8426067,Langenenslingen,15 - 18 Jahre,155,85,70
False,8426067,Langenenslingen,18 - 20 Jahre,113,53,60
False,8426067,Langenenslingen,20 - 25 Jahre,221,114,107
False,8426067,Langenenslingen,25 - 30 Jahre,176,92,84
False,8426067,Langenenslingen,30 - 35 Jahre,167,90,77
False,8426067,Langenenslingen,35 - 40 Jahre,207,95,112
False,8426067,Langenenslingen,40 - 45 Jahre,291,147,144
False,8426067,Langenenslingen,45 - 50 Jahre,293,147,146
False,8426067,Langenenslingen,50 - 55 Jahre,287,158,129
False,8426067,Langenenslingen,55 - 60 Jahre,189,104,85
False,8426067,Langenenslingen,60 - 65 Jahre,151,76,75
False,8426067,Langenenslingen,65 - 75 Jahre,333,161,172
False,8426067,Langenenslingen,75 und mehr Jahre,338,134,204
False,8426067,Langenenslingen,Insgesamt,3560,1770,1790
False,8426070,"Laupheim, Stadt",unter 3 Jahre,577,292,285
False,8426070,"Laupheim, Stadt",3 -  6 Jahre,616,338,278
False,8426070,"Laupheim, Stadt",6 - 10 Jahre,813,403,410
False,8426070,"Laupheim, Stadt",10 - 15 Jahre,1018,533,485
False,8426070,"Laupheim, Stadt",15 - 18 Jahre,658,350,308
False,8426070,"Laupheim, Stadt",18 - 20 Jahre,489,242,247
False,8426070,"Laupheim, Stadt",20 - 25 Jahre,1212,601,611
False,8426070,"Laupheim, Stadt",25 - 30 Jahre,1362,688,674
False,8426070,"Laupheim, Stadt",30 - 35 Jahre,1269,674,595
False,8426070,"Laupheim, Stadt",35 - 40 Jahre,1366,710,656
False,8426070,"Laupheim, Stadt",40 - 45 Jahre,1608,842,766
False,8426070,"Laupheim, Stadt",45 - 50 Jahre,1655,870,785
False,8426070,"Laupheim, Stadt",50 - 55 Jahre,1468,719,749
False,8426070,"Laupheim, Stadt",55 - 60 Jahre,1244,636,608
False,8426070,"Laupheim, Stadt",60 - 65 Jahre,1075,551,524
False,8426070,"Laupheim, Stadt",65 - 75 Jahre,1917,903,1014
False,8426070,"Laupheim, Stadt",75 und mehr Jahre,1449,529,920
False,8426070,"Laupheim, Stadt",Insgesamt,19796,9881,9915
False,8426071,Maselheim,unter 3 Jahre,116,63,53
False,8426071,Maselheim,3 -  6 Jahre,109,49,60
False,8426071,Maselheim,6 - 10 Jahre,168,79,89
False,8426071,Maselheim,10 - 15 Jahre,262,123,139
False,8426071,Maselheim,15 - 18 Jahre,185,100,85
False,8426071,Maselheim,18 - 20 Jahre,129,73,56
False,8426071,Maselheim,20 - 25 Jahre,276,146,130
False,8426071,Maselheim,25 - 30 Jahre,205,110,95
False,8426071,Maselheim,30 - 35 Jahre,227,109,118
False,8426071,Maselheim,35 - 40 Jahre,264,142,122
False,8426071,Maselheim,40 - 45 Jahre,385,196,189
False,8426071,Maselheim,45 - 50 Jahre,429,212,217
False,8426071,Maselheim,50 - 55 Jahre,335,179,156
False,8426071,Maselheim,55 - 60 Jahre,297,159,138
False,8426071,Maselheim,60 - 65 Jahre,243,127,116
False,8426071,Maselheim,65 - 75 Jahre,426,203,223
False,8426071,Maselheim,75 und mehr Jahre,317,134,183
False,8426071,Maselheim,Insgesamt,4373,2204,2169
False,8426073,Mietingen,unter 3 Jahre,135,57,78
False,8426073,Mietingen,3 -  6 Jahre,125,68,57
False,8426073,Mietingen,6 - 10 Jahre,184,98,86
False,8426073,Mietingen,10 - 15 Jahre,279,132,147
False,8426073,Mietingen,15 - 18 Jahre,177,95,82
False,8426073,Mietingen,18 - 20 Jahre,117,64,53
False,8426073,Mietingen,20 - 25 Jahre,266,141,125
False,8426073,Mietingen,25 - 30 Jahre,268,130,138
False,8426073,Mietingen,30 - 35 Jahre,267,152,115
False,8426073,Mietingen,35 - 40 Jahre,308,170,138
False,8426073,Mietingen,40 - 45 Jahre,368,198,170
False,8426073,Mietingen,45 - 50 Jahre,362,207,155
False,8426073,Mietingen,50 - 55 Jahre,312,161,151
False,8426073,Mietingen,55 - 60 Jahre,232,119,113
False,8426073,Mietingen,60 - 65 Jahre,203,106,97
False,8426073,Mietingen,65 - 75 Jahre,290,147,143
False,8426073,Mietingen,75 und mehr Jahre,180,74,106
False,8426073,Mietingen,Insgesamt,4073,2119,1954
False,8426074,Mittelbiberach,unter 3 Jahre,111,49,62
False,8426074,Mittelbiberach,3 -  6 Jahre,130,67,63
False,8426074,Mittelbiberach,6 - 10 Jahre,216,120,96
False,8426074,Mittelbiberach,10 - 15 Jahre,272,136,136
False,8426074,Mittelbiberach,15 - 18 Jahre,186,91,95
False,8426074,Mittelbiberach,18 - 20 Jahre,110,60,50
False,8426074,Mittelbiberach,20 - 25 Jahre,245,134,111
False,8426074,Mittelbiberach,25 - 30 Jahre,202,93,109
False,8426074,Mittelbiberach,30 - 35 Jahre,233,109,124
False,8426074,Mittelbiberach,35 - 40 Jahre,233,112,121
False,8426074,Mittelbiberach,40 - 45 Jahre,335,155,180
False,8426074,Mittelbiberach,45 - 50 Jahre,374,195,179
False,8426074,Mittelbiberach,50 - 55 Jahre,335,169,166
False,8426074,Mittelbiberach,55 - 60 Jahre,258,129,129
False,8426074,Mittelbiberach,60 - 65 Jahre,243,124,119
False,8426074,Mittelbiberach,65 - 75 Jahre,334,162,172
False,8426074,Mittelbiberach,75 und mehr Jahre,213,80,133
False,8426074,Mittelbiberach,Insgesamt,4030,1985,2045
False,8426078,Moosburg,unter 3 Jahre,5,3,2
False,8426078,Moosburg,3 -  6 Jahre,9,3,6
False,8426078,Moosburg,6 - 10 Jahre,8,3,5
False,8426078,Moosburg,10 - 15 Jahre,11,7,4
False,8426078,Moosburg,15 - 18 Jahre,10,6,4
False,8426078,Moosburg,18 - 20 Jahre,5,3,2
False,8426078,Moosburg,20 - 25 Jahre,10,7,3
False,8426078,Moosburg,25 - 30 Jahre,2,1,1
False,8426078,Moosburg,30 - 35 Jahre,2,0,2
False,8426078,Moosburg,35 - 40 Jahre,7,0,7
False,8426078,Moosburg,40 - 45 Jahre,14,5,9
False,8426078,Moosburg,45 - 50 Jahre,13,7,6
False,8426078,Moosburg,50 - 55 Jahre,7,5,2
False,8426078,Moosburg,55 - 60 Jahre,17,11,6
False,8426078,Moosburg,60 - 65 Jahre,8,3,5
False,8426078,Moosburg,65 - 75 Jahre,31,14,17
False,8426078,Moosburg,75 und mehr Jahre,14,5,9
False,8426078,Moosburg,Insgesamt,173,83,90
False,8426087,"Ochsenhausen, Stadt",unter 3 Jahre,240,130,110
False,8426087,"Ochsenhausen, Stadt",3 -  6 Jahre,241,137,104
False,8426087,"Ochsenhausen, Stadt",6 - 10 Jahre,353,178,175
False,8426087,"Ochsenhausen, Stadt",10 - 15 Jahre,554,306,248
False,8426087,"Ochsenhausen, Stadt",15 - 18 Jahre,408,198,210
False,8426087,"Ochsenhausen, Stadt",18 - 20 Jahre,237,112,125
False,8426087,"Ochsenhausen, Stadt",20 - 25 Jahre,569,284,285
False,8426087,"Ochsenhausen, Stadt",25 - 30 Jahre,558,273,285
False,8426087,"Ochsenhausen, Stadt",30 - 35 Jahre,512,274,238
False,8426087,"Ochsenhausen, Stadt",35 - 40 Jahre,581,270,311
False,8426087,"Ochsenhausen, Stadt",40 - 45 Jahre,752,385,367
False,8426087,"Ochsenhausen, Stadt",45 - 50 Jahre,701,362,339
False,8426087,"Ochsenhausen, Stadt",50 - 55 Jahre,701,363,338
False,8426087,"Ochsenhausen, Stadt",55 - 60 Jahre,559,287,272
False,8426087,"Ochsenhausen, Stadt",60 - 65 Jahre,411,216,195
False,8426087,"Ochsenhausen, Stadt",65 - 75 Jahre,756,361,395
False,8426087,"Ochsenhausen, Stadt",75 und mehr Jahre,666,233,433
False,8426087,"Ochsenhausen, Stadt",Insgesamt,8799,4369,4430
False,8426090,Oggelshausen,unter 3 Jahre,20,10,10
False,8426090,Oggelshausen,3 -  6 Jahre,27,15,12
False,8426090,Oggelshausen,6 - 10 Jahre,38,17,21
False,8426090,Oggelshausen,10 - 15 Jahre,64,31,33
False,8426090,Oggelshausen,15 - 18 Jahre,32,8,24
False,8426090,Oggelshausen,18 - 20 Jahre,27,15,12
False,8426090,Oggelshausen,20 - 25 Jahre,51,28,23
False,8426090,Oggelshausen,25 - 30 Jahre,23,11,12
False,8426090,Oggelshausen,30 - 35 Jahre,41,19,22
False,8426090,Oggelshausen,35 - 40 Jahre,50,29,21
False,8426090,Oggelshausen,40 - 45 Jahre,74,38,36
False,8426090,Oggelshausen,45 - 50 Jahre,105,54,51
False,8426090,Oggelshausen,50 - 55 Jahre,79,47,32
False,8426090,Oggelshausen,55 - 60 Jahre,59,34,25
False,8426090,Oggelshausen,60 - 65 Jahre,24,11,13
False,8426090,Oggelshausen,65 - 75 Jahre,101,42,59
False,8426090,Oggelshausen,75 und mehr Jahre,80,36,44
False,8426090,Oggelshausen,Insgesamt,895,445,450
False,8426097,"Riedlingen, Stadt",unter 3 Jahre,271,137,134
False,8426097,"Riedlingen, Stadt",3 -  6 Jahre,281,134,147
False,8426097,"Riedlingen, Stadt",6 - 10 Jahre,397,204,193
False,8426097,"Riedlingen, Stadt",10 - 15 Jahre,618,303,315
False,8426097,"Riedlingen, Stadt",15 - 18 Jahre,376,200,176
False,8426097,"Riedlingen, Stadt",18 - 20 Jahre,264,132,132
False,8426097,"Riedlingen, Stadt",20 - 25 Jahre,626,333,293
False,8426097,"Riedlingen, Stadt",25 - 30 Jahre,574,286,288
False,8426097,"Riedlingen, Stadt",30 - 35 Jahre,593,301,292
False,8426097,"Riedlingen, Stadt",35 - 40 Jahre,655,311,344
False,8426097,"Riedlingen, Stadt",40 - 45 Jahre,761,378,383
False,8426097,"Riedlingen, Stadt",45 - 50 Jahre,768,387,381
False,8426097,"Riedlingen, Stadt",50 - 55 Jahre,801,385,416
False,8426097,"Riedlingen, Stadt",55 - 60 Jahre,653,332,321
False,8426097,"Riedlingen, Stadt",60 - 65 Jahre,526,258,268
False,8426097,"Riedlingen, Stadt",65 - 75 Jahre,1034,482,552
False,8426097,"Riedlingen, Stadt",75 und mehr Jahre,1043,389,654
False,8426097,"Riedlingen, Stadt",Insgesamt,10241,4952,5289
False,8426100,Rot an der Rot,unter 3 Jahre,133,79,54
False,8426100,Rot an der Rot,3 -  6 Jahre,142,73,69
False,8426100,Rot an der Rot,6 - 10 Jahre,195,99,96
False,8426100,Rot an der Rot,10 - 15 Jahre,285,146,139
False,8426100,Rot an der Rot,15 - 18 Jahre,194,104,90
False,8426100,Rot an der Rot,18 - 20 Jahre,120,55,65
False,8426100,Rot an der Rot,20 - 25 Jahre,242,135,107
False,8426100,Rot an der Rot,25 - 30 Jahre,237,119,118
False,8426100,Rot an der Rot,30 - 35 Jahre,195,106,89
False,8426100,Rot an der Rot,35 - 40 Jahre,327,171,156
False,8426100,Rot an der Rot,40 - 45 Jahre,377,179,198
False,8426100,Rot an der Rot,45 - 50 Jahre,377,209,168
False,8426100,Rot an der Rot,50 - 55 Jahre,328,181,147
False,8426100,Rot an der Rot,55 - 60 Jahre,262,139,123
False,8426100,Rot an der Rot,60 - 65 Jahre,223,114,109
False,8426100,Rot an der Rot,65 - 75 Jahre,457,230,227
False,8426100,Rot an der Rot,75 und mehr Jahre,329,138,191
False,8426100,Rot an der Rot,Insgesamt,4423,2277,2146
False,8426108,Schwendi,unter 3 Jahre,157,83,74
False,8426108,Schwendi,3 -  6 Jahre,146,75,71
False,8426108,Schwendi,6 - 10 Jahre,258,127,131
False,8426108,Schwendi,10 - 15 Jahre,409,192,217
False,8426108,Schwendi,15 - 18 Jahre,253,143,110
False,8426108,Schwendi,18 - 20 Jahre,171,91,80
False,8426108,Schwendi,20 - 25 Jahre,391,212,179
False,8426108,Schwendi,25 - 30 Jahre,356,201,155
False,8426108,Schwendi,30 - 35 Jahre,305,152,153
False,8426108,Schwendi,35 - 40 Jahre,402,204,198
False,8426108,Schwendi,40 - 45 Jahre,543,271,272
False,8426108,Schwendi,45 - 50 Jahre,573,296,277
False,8426108,Schwendi,50 - 55 Jahre,457,233,224
False,8426108,Schwendi,55 - 60 Jahre,381,188,193
False,8426108,Schwendi,60 - 65 Jahre,320,177,143
False,8426108,Schwendi,65 - 75 Jahre,583,289,294
False,8426108,Schwendi,75 und mehr Jahre,521,202,319
False,8426108,Schwendi,Insgesamt,6226,3136,3090
False,8426109,Seekirch,unter 3 Jahre,4,1,3
False,8426109,Seekirch,3 -  6 Jahre,4,2,2
False,8426109,Seekirch,6 - 10 Jahre,21,9,12
False,8426109,Seekirch,10 - 15 Jahre,33,14,19
False,8426109,Seekirch,15 - 18 Jahre,18,7,11
False,8426109,Seekirch,18 - 20 Jahre,7,2,5
False,8426109,Seekirch,20 - 25 Jahre,9,6,3
False,8426109,Seekirch,25 - 30 Jahre,5,2,3
False,8426109,Seekirch,30 - 35 Jahre,7,3,4
False,8426109,Seekirch,35 - 40 Jahre,18,7,11
False,8426109,Seekirch,40 - 45 Jahre,45,21,24
False,8426109,Seekirch,45 - 50 Jahre,30,18,12
False,8426109,Seekirch,50 - 55 Jahre,17,8,9
False,8426109,Seekirch,55 - 60 Jahre,16,9,7
False,8426109,Seekirch,60 - 65 Jahre,7,6,1
False,8426109,Seekirch,65 - 75 Jahre,28,13,15
False,8426109,Seekirch,75 und mehr Jahre,18,6,12
False,8426109,Seekirch,Insgesamt,287,134,153
False,8426113,Steinhausen an der Rottum,unter 3 Jahre,57,25,32
False,8426113,Steinhausen an der Rottum,3 -  6 Jahre,68,38,30
False,8426113,Steinhausen an der Rottum,6 - 10 Jahre,74,45,29
False,8426113,Steinhausen an der Rottum,10 - 15 Jahre,119,58,61
False,8426113,Steinhausen an der Rottum,15 - 18 Jahre,83,39,44
False,8426113,Steinhausen an der Rottum,18 - 20 Jahre,58,23,35
False,8426113,Steinhausen an der Rottum,20 - 25 Jahre,136,66,70
False,8426113,Steinhausen an der Rottum,25 - 30 Jahre,85,46,39
False,8426113,Steinhausen an der Rottum,30 - 35 Jahre,111,49,62
False,8426113,Steinhausen an der Rottum,35 - 40 Jahre,134,74,60
False,8426113,Steinhausen an der Rottum,40 - 45 Jahre,182,92,90
False,8426113,Steinhausen an der Rottum,45 - 50 Jahre,179,101,78
False,8426113,Steinhausen an der Rottum,50 - 55 Jahre,148,84,64
False,8426113,Steinhausen an der Rottum,55 - 60 Jahre,110,55,55
False,8426113,Steinhausen an der Rottum,60 - 65 Jahre,85,46,39
False,8426113,Steinhausen an der Rottum,65 - 75 Jahre,152,74,78
False,8426113,Steinhausen an der Rottum,75 und mehr Jahre,140,54,86
False,8426113,Steinhausen an der Rottum,Insgesamt,1921,969,952
False,8426117,Tannheim,unter 3 Jahre,59,31,28
False,8426117,Tannheim,3 -  6 Jahre,77,43,34
False,8426117,Tannheim,6 - 10 Jahre,108,58,50
False,8426117,Tannheim,10 - 15 Jahre,152,65,87
False,8426117,Tannheim,15 - 18 Jahre,81,39,42
False,8426117,Tannheim,18 - 20 Jahre,55,24,31
False,8426117,Tannheim,20 - 25 Jahre,125,68,57
False,8426117,Tannheim,25 - 30 Jahre,116,70,46
False,8426117,Tannheim,30 - 35 Jahre,108,52,56
False,8426117,Tannheim,35 - 40 Jahre,146,65,81
False,8426117,Tannheim,40 - 45 Jahre,199,99,100
False,8426117,Tannheim,45 - 50 Jahre,210,110,100
False,8426117,Tannheim,50 - 55 Jahre,199,108,91
False,8426117,Tannheim,55 - 60 Jahre,158,81,77
False,8426117,Tannheim,60 - 65 Jahre,111,64,47
False,8426117,Tannheim,65 - 75 Jahre,241,111,130
False,8426117,Tannheim,75 und mehr Jahre,186,80,106
False,8426117,Tannheim,Insgesamt,2331,1168,1163
False,8426118,Tiefenbach,unter 3 Jahre,26,15,11
False,8426118,Tiefenbach,3 -  6 Jahre,13,4,9
False,8426118,Tiefenbach,6 - 10 Jahre,35,16,19
False,8426118,Tiefenbach,10 - 15 Jahre,32,17,15
False,8426118,Tiefenbach,15 - 18 Jahre,19,8,11
False,8426118,Tiefenbach,18 - 20 Jahre,12,5,7
False,8426118,Tiefenbach,20 - 25 Jahre,21,9,12
False,8426118,Tiefenbach,25 - 30 Jahre,34,18,16
False,8426118,Tiefenbach,30 - 35 Jahre,31,17,14
False,8426118,Tiefenbach,35 - 40 Jahre,49,24,25
False,8426118,Tiefenbach,40 - 45 Jahre,56,31,25
False,8426118,Tiefenbach,45 - 50 Jahre,34,20,14
False,8426118,Tiefenbach,50 - 55 Jahre,23,11,12
False,8426118,Tiefenbach,55 - 60 Jahre,26,18,8
False,8426118,Tiefenbach,60 - 65 Jahre,15,8,7
False,8426118,Tiefenbach,65 - 75 Jahre,61,29,32
False,8426118,Tiefenbach,75 und mehr Jahre,38,16,22
False,8426118,Tiefenbach,Insgesamt,525,266,259
False,8426120,Ummendorf,unter 3 Jahre,127,68,59
False,8426120,Ummendorf,3 -  6 Jahre,133,65,68
False,8426120,Ummendorf,6 - 10 Jahre,175,94,81
False,8426120,Ummendorf,10 - 15 Jahre,277,139,138
False,8426120,Ummendorf,15 - 18 Jahre,153,79,74
False,8426120,Ummendorf,18 - 20 Jahre,110,62,48
False,8426120,Ummendorf,20 - 25 Jahre,259,132,127
False,8426120,Ummendorf,25 - 30 Jahre,256,137,119
False,8426120,Ummendorf,30 - 35 Jahre,240,127,113
False,8426120,Ummendorf,35 - 40 Jahre,302,149,153
False,8426120,Ummendorf,40 - 45 Jahre,386,197,189
False,8426120,Ummendorf,45 - 50 Jahre,382,203,179
False,8426120,Ummendorf,50 - 55 Jahre,304,159,145
False,8426120,Ummendorf,55 - 60 Jahre,252,120,132
False,8426120,Ummendorf,60 - 65 Jahre,245,114,131
False,8426120,Ummendorf,65 - 75 Jahre,448,214,234
False,8426120,Ummendorf,75 und mehr Jahre,304,122,182
False,8426120,Ummendorf,Insgesamt,4353,2181,2172
False,8426121,Unlingen,unter 3 Jahre,55,27,28
False,8426121,Unlingen,3 -  6 Jahre,75,37,38
False,8426121,Unlingen,6 - 10 Jahre,114,58,56
False,8426121,Unlingen,10 - 15 Jahre,186,80,106
False,8426121,Unlingen,15 - 18 Jahre,104,49,55
False,8426121,Unlingen,18 - 20 Jahre,67,34,33
False,8426121,Unlingen,20 - 25 Jahre,159,86,73
False,8426121,Unlingen,25 - 30 Jahre,122,71,51
False,8426121,Unlingen,30 - 35 Jahre,119,62,57
False,8426121,Unlingen,35 - 40 Jahre,163,77,86
False,8426121,Unlingen,40 - 45 Jahre,207,104,103
False,8426121,Unlingen,45 - 50 Jahre,218,111,107
False,8426121,Unlingen,50 - 55 Jahre,164,80,84
False,8426121,Unlingen,55 - 60 Jahre,147,76,71
False,8426121,Unlingen,60 - 65 Jahre,122,64,58
False,8426121,Unlingen,65 - 75 Jahre,233,126,107
False,8426121,Unlingen,75 und mehr Jahre,174,66,108
False,8426121,Unlingen,Insgesamt,2429,1208,1221
False,8426124,Uttenweiler,unter 3 Jahre,107,54,53
False,8426124,Uttenweiler,3 -  6 Jahre,118,58,60
False,8426124,Uttenweiler,6 - 10 Jahre,180,87,93
False,8426124,Uttenweiler,10 - 15 Jahre,242,132,110
False,8426124,Uttenweiler,15 - 18 Jahre,123,58,65
False,8426124,Uttenweiler,18 - 20 Jahre,93,51,42
False,8426124,Uttenweiler,20 - 25 Jahre,265,147,118
False,8426124,Uttenweiler,25 - 30 Jahre,222,124,98
False,8426124,Uttenweiler,30 - 35 Jahre,202,97,105
False,8426124,Uttenweiler,35 - 40 Jahre,223,96,127
False,8426124,Uttenweiler,40 - 45 Jahre,260,157,103
False,8426124,Uttenweiler,45 - 50 Jahre,301,161,140
False,8426124,Uttenweiler,50 - 55 Jahre,310,159,151
False,8426124,Uttenweiler,55 - 60 Jahre,239,133,106
False,8426124,Uttenweiler,60 - 65 Jahre,159,77,82
False,8426124,Uttenweiler,65 - 75 Jahre,261,138,123
False,8426124,Uttenweiler,75 und mehr Jahre,265,99,166
False,8426124,Uttenweiler,Insgesamt,3570,1828,1742
False,8426125,Wain,unter 3 Jahre,47,24,23
False,8426125,Wain,3 -  6 Jahre,54,27,27
False,8426125,Wain,6 - 10 Jahre,75,40,35
False,8426125,Wain,10 - 15 Jahre,95,53,42
False,8426125,Wain,15 - 18 Jahre,70,35,35
False,8426125,Wain,18 - 20 Jahre,38,19,19
False,8426125,Wain,20 - 25 Jahre,88,53,35
False,8426125,Wain,25 - 30 Jahre,105,57,48
False,8426125,Wain,30 - 35 Jahre,94,42,52
False,8426125,Wain,35 - 40 Jahre,79,44,35
False,8426125,Wain,40 - 45 Jahre,104,54,50
False,8426125,Wain,45 - 50 Jahre,130,74,56
False,8426125,Wain,50 - 55 Jahre,103,56,47
False,8426125,Wain,55 - 60 Jahre,112,54,58
False,8426125,Wain,60 - 65 Jahre,99,53,46
False,8426125,Wain,65 - 75 Jahre,137,70,67
False,8426125,Wain,75 und mehr Jahre,109,45,64
False,8426125,Wain,Insgesamt,1539,800,739
False,8426128,Warthausen,unter 3 Jahre,121,64,57
False,8426128,Warthausen,3 -  6 Jahre,135,73,62
False,8426128,Warthausen,6 - 10 Jahre,213,106,107
False,8426128,Warthausen,10 - 15 Jahre,306,155,151
False,8426128,Warthausen,15 - 18 Jahre,162,84,78
False,8426128,Warthausen,18 - 20 Jahre,117,69,48
False,8426128,Warthausen,20 - 25 Jahre,319,169,150
False,8426128,Warthausen,25 - 30 Jahre,272,133,139
False,8426128,Warthausen,30 - 35 Jahre,293,140,153
False,8426128,Warthausen,35 - 40 Jahre,280,153,127
False,8426128,Warthausen,40 - 45 Jahre,403,212,191
False,8426128,Warthausen,45 - 50 Jahre,442,216,226
False,8426128,Warthausen,50 - 55 Jahre,365,181,184
False,8426128,Warthausen,55 - 60 Jahre,307,151,156
False,8426128,Warthausen,60 - 65 Jahre,248,134,114
False,8426128,Warthausen,65 - 75 Jahre,556,267,289
False,8426128,Warthausen,75 und mehr Jahre,469,176,293
False,8426128,Warthausen,Insgesamt,5008,2483,2525
False,8426134,Schemmerhofen,unter 3 Jahre,217,114,103
False,8426134,Schemmerhofen,3 -  6 Jahre,233,140,93
False,8426134,Schemmerhofen,6 - 10 Jahre,330,159,171
False,8426134,Schemmerhofen,10 - 15 Jahre,517,256,261
False,8426134,Schemmerhofen,15 - 18 Jahre,316,150,166
False,8426134,Schemmerhofen,18 - 20 Jahre,233,113,120
False,8426134,Schemmerhofen,20 - 25 Jahre,517,279,238
False,8426134,Schemmerhofen,25 - 30 Jahre,427,209,218
False,8426134,Schemmerhofen,30 - 35 Jahre,431,201,230
False,8426134,Schemmerhofen,35 - 40 Jahre,542,266,276
False,8426134,Schemmerhofen,40 - 45 Jahre,702,347,355
False,8426134,Schemmerhofen,45 - 50 Jahre,667,342,325
False,8426134,Schemmerhofen,50 - 55 Jahre,591,315,276
False,8426134,Schemmerhofen,55 - 60 Jahre,445,237,208
False,8426134,Schemmerhofen,60 - 65 Jahre,384,195,189
False,8426134,Schemmerhofen,65 - 75 Jahre,675,337,338
False,8426134,Schemmerhofen,75 und mehr Jahre,514,205,309
False,8426134,Schemmerhofen,Insgesamt,7741,3865,3876
False,8426135,Gutenzell-Hürbel,unter 3 Jahre,61,29,32
False,8426135,Gutenzell-Hürbel,3 -  6 Jahre,56,25,31
False,8426135,Gutenzell-Hürbel,6 - 10 Jahre,90,44,46
False,8426135,Gutenzell-Hürbel,10 - 15 Jahre,132,66,66
False,8426135,Gutenzell-Hürbel,15 - 18 Jahre,79,39,40
False,8426135,Gutenzell-Hürbel,18 - 20 Jahre,70,38,32
False,8426135,Gutenzell-Hürbel,20 - 25 Jahre,115,62,53
False,8426135,Gutenzell-Hürbel,25 - 30 Jahre,104,61,43
False,8426135,Gutenzell-Hürbel,30 - 35 Jahre,88,52,36
False,8426135,Gutenzell-Hürbel,35 - 40 Jahre,112,50,62
False,8426135,Gutenzell-Hürbel,40 - 45 Jahre,152,84,68
False,8426135,Gutenzell-Hürbel,45 - 50 Jahre,173,85,88
False,8426135,Gutenzell-Hürbel,50 - 55 Jahre,134,73,61
False,8426135,Gutenzell-Hürbel,55 - 60 Jahre,132,71,61
False,8426135,Gutenzell-Hürbel,60 - 65 Jahre,93,49,44
False,8426135,Gutenzell-Hürbel,65 - 75 Jahre,138,76,62
False,8426135,Gutenzell-Hürbel,75 und mehr Jahre,98,40,58
False,8426135,Gutenzell-Hürbel,Insgesamt,1827,944,883
False,8435,Landkreis Bodenseekreis,unter 3 Jahre,5192,2694,2498
False,8435,Landkreis Bodenseekreis,3 -  6 Jahre,5318,2678,2640
False,8435,Landkreis Bodenseekreis,6 - 10 Jahre,7631,3960,3671
False,8435,Landkreis Bodenseekreis,10 - 15 Jahre,11229,5759,5470
False,8435,Landkreis Bodenseekreis,15 - 18 Jahre,7131,3655,3476
False,8435,Landkreis Bodenseekreis,18 - 20 Jahre,5038,2639,2399
False,8435,Landkreis Bodenseekreis,20 - 25 Jahre,11813,6036,5777
False,8435,Landkreis Bodenseekreis,25 - 30 Jahre,11554,5867,5687
False,8435,Landkreis Bodenseekreis,30 - 35 Jahre,11810,5944,5866
False,8435,Landkreis Bodenseekreis,35 - 40 Jahre,12761,6404,6357
False,8435,Landkreis Bodenseekreis,40 - 45 Jahre,17119,8572,8547
False,8435,Landkreis Bodenseekreis,45 - 50 Jahre,17477,8763,8714
False,8435,Landkreis Bodenseekreis,50 - 55 Jahre,15338,7726,7612
False,8435,Landkreis Bodenseekreis,55 - 60 Jahre,13213,6340,6873
False,8435,Landkreis Bodenseekreis,60 - 65 Jahre,12393,5960,6433
False,8435,Landkreis Bodenseekreis,65 - 75 Jahre,25177,12216,12961
False,8435,Landkreis Bodenseekreis,75 und mehr Jahre,18173,7180,10993
False,8435,Landkreis Bodenseekreis,Insgesamt,208367,102393,105974
False,8435005,Bermatingen,unter 3 Jahre,99,59,40
False,8435005,Bermatingen,3 -  6 Jahre,119,67,52
False,8435005,Bermatingen,6 - 10 Jahre,141,74,67
False,8435005,Bermatingen,10 - 15 Jahre,236,123,113
False,8435005,Bermatingen,15 - 18 Jahre,159,77,82
False,8435005,Bermatingen,18 - 20 Jahre,109,48,61
False,8435005,Bermatingen,20 - 25 Jahre,196,97,99
False,8435005,Bermatingen,25 - 30 Jahre,177,84,93
False,8435005,Bermatingen,30 - 35 Jahre,193,99,94
False,8435005,Bermatingen,35 - 40 Jahre,234,110,124
False,8435005,Bermatingen,40 - 45 Jahre,324,150,174
False,8435005,Bermatingen,45 - 50 Jahre,388,186,202
False,8435005,Bermatingen,50 - 55 Jahre,335,178,157
False,8435005,Bermatingen,55 - 60 Jahre,248,125,123
False,8435005,Bermatingen,60 - 65 Jahre,228,127,101
False,8435005,Bermatingen,65 - 75 Jahre,423,220,203
False,8435005,Bermatingen,75 und mehr Jahre,262,115,147
False,8435005,Bermatingen,Insgesamt,3871,1939,1932
False,8435010,Daisendorf,unter 3 Jahre,39,22,17
False,8435010,Daisendorf,3 -  6 Jahre,36,20,16
False,8435010,Daisendorf,6 - 10 Jahre,65,33,32
False,8435010,Daisendorf,10 - 15 Jahre,72,41,31
False,8435010,Daisendorf,15 - 18 Jahre,46,19,27
False,8435010,Daisendorf,18 - 20 Jahre,33,13,20
False,8435010,Daisendorf,20 - 25 Jahre,68,32,36
False,8435010,Daisendorf,25 - 30 Jahre,84,43,41
False,8435010,Daisendorf,30 - 35 Jahre,80,41,39
False,8435010,Daisendorf,35 - 40 Jahre,75,48,27
False,8435010,Daisendorf,40 - 45 Jahre,136,60,76
False,8435010,Daisendorf,45 - 50 Jahre,132,61,71
False,8435010,Daisendorf,50 - 55 Jahre,114,53,61
False,8435010,Daisendorf,55 - 60 Jahre,98,50,48
False,8435010,Daisendorf,60 - 65 Jahre,133,70,63
False,8435010,Daisendorf,65 - 75 Jahre,234,111,123
False,8435010,Daisendorf,75 und mehr Jahre,131,67,64
False,8435010,Daisendorf,Insgesamt,1576,784,792
False,8435013,Eriskirch,unter 3 Jahre,127,60,67
False,8435013,Eriskirch,3 -  6 Jahre,131,61,70
False,8435013,Eriskirch,6 - 10 Jahre,182,105,77
False,8435013,Eriskirch,10 - 15 Jahre,253,137,116
False,8435013,Eriskirch,15 - 18 Jahre,137,59,78
False,8435013,Eriskirch,18 - 20 Jahre,123,64,59
False,8435013,Eriskirch,20 - 25 Jahre,252,141,111
False,8435013,Eriskirch,25 - 30 Jahre,253,130,123
False,8435013,Eriskirch,30 - 35 Jahre,223,111,112
False,8435013,Eriskirch,35 - 40 Jahre,299,158,141
False,8435013,Eriskirch,40 - 45 Jahre,405,209,196
False,8435013,Eriskirch,45 - 50 Jahre,422,218,204
False,8435013,Eriskirch,50 - 55 Jahre,363,192,171
False,8435013,Eriskirch,55 - 60 Jahre,318,156,162
False,8435013,Eriskirch,60 - 65 Jahre,286,143,143
False,8435013,Eriskirch,65 - 75 Jahre,463,229,234
False,8435013,Eriskirch,75 und mehr Jahre,305,125,180
False,8435013,Eriskirch,Insgesamt,4542,2298,2244
False,8435015,Frickingen,unter 3 Jahre,68,38,30
False,8435015,Frickingen,3 -  6 Jahre,78,38,40
False,8435015,Frickingen,6 - 10 Jahre,114,62,52
False,8435015,Frickingen,10 - 15 Jahre,208,102,106
False,8435015,Frickingen,15 - 18 Jahre,135,78,57
False,8435015,Frickingen,18 - 20 Jahre,82,44,38
False,8435015,Frickingen,20 - 25 Jahre,170,90,80
False,8435015,Frickingen,25 - 30 Jahre,131,57,74
False,8435015,Frickingen,30 - 35 Jahre,131,68,63
False,8435015,Frickingen,35 - 40 Jahre,153,77,76
False,8435015,Frickingen,40 - 45 Jahre,220,100,120
False,8435015,Frickingen,45 - 50 Jahre,237,116,121
False,8435015,Frickingen,50 - 55 Jahre,201,112,89
False,8435015,Frickingen,55 - 60 Jahre,174,88,86
False,8435015,Frickingen,60 - 65 Jahre,164,83,81
False,8435015,Frickingen,65 - 75 Jahre,277,140,137
False,8435015,Frickingen,75 und mehr Jahre,202,81,121
False,8435015,Frickingen,Insgesamt,2745,1374,1371
False,8435016,"Friedrichshafen, Stadt",unter 3 Jahre,1442,739,703
False,8435016,"Friedrichshafen, Stadt",3 -  6 Jahre,1444,716,728
False,8435016,"Friedrichshafen, Stadt",6 - 10 Jahre,2001,1015,986
False,8435016,"Friedrichshafen, Stadt",10 - 15 Jahre,2933,1520,1413
False,8435016,"Friedrichshafen, Stadt",15 - 18 Jahre,1812,909,903
False,8435016,"Friedrichshafen, Stadt",18 - 20 Jahre,1443,733,710
False,8435016,"Friedrichshafen, Stadt",20 - 25 Jahre,3754,1883,1871
False,8435016,"Friedrichshafen, Stadt",25 - 30 Jahre,3778,1909,1869
False,8435016,"Friedrichshafen, Stadt",30 - 35 Jahre,3754,1936,1818
False,8435016,"Friedrichshafen, Stadt",35 - 40 Jahre,3644,1859,1785
False,8435016,"Friedrichshafen, Stadt",40 - 45 Jahre,4589,2338,2251
False,8435016,"Friedrichshafen, Stadt",45 - 50 Jahre,4617,2384,2233
False,8435016,"Friedrichshafen, Stadt",50 - 55 Jahre,4086,2057,2029
False,8435016,"Friedrichshafen, Stadt",55 - 60 Jahre,3600,1676,1924
False,8435016,"Friedrichshafen, Stadt",60 - 65 Jahre,3480,1719,1761
False,8435016,"Friedrichshafen, Stadt",65 - 75 Jahre,7220,3476,3744
False,8435016,"Friedrichshafen, Stadt",75 und mehr Jahre,5405,2119,3286
False,8435016,"Friedrichshafen, Stadt",Insgesamt,59002,28988,30014
False,8435018,Hagnau am Bodensee,unter 3 Jahre,33,15,18
False,8435018,Hagnau am Bodensee,3 -  6 Jahre,36,16,20
False,8435018,Hagnau am Bodensee,6 - 10 Jahre,47,23,24
False,8435018,Hagnau am Bodensee,10 - 15 Jahre,68,32,36
False,8435018,Hagnau am Bodensee,15 - 18 Jahre,48,25,23
False,8435018,Hagnau am Bodensee,18 - 20 Jahre,28,15,13
False,8435018,Hagnau am Bodensee,20 - 25 Jahre,67,29,38
False,8435018,Hagnau am Bodensee,25 - 30 Jahre,81,41,40
False,8435018,Hagnau am Bodensee,30 - 35 Jahre,74,37,37
False,8435018,Hagnau am Bodensee,35 - 40 Jahre,72,38,34
False,8435018,Hagnau am Bodensee,40 - 45 Jahre,106,49,57
False,8435018,Hagnau am Bodensee,45 - 50 Jahre,99,46,53
False,8435018,Hagnau am Bodensee,50 - 55 Jahre,110,52,58
False,8435018,Hagnau am Bodensee,55 - 60 Jahre,109,46,63
False,8435018,Hagnau am Bodensee,60 - 65 Jahre,111,51,60
False,8435018,Hagnau am Bodensee,65 - 75 Jahre,205,100,105
False,8435018,Hagnau am Bodensee,75 und mehr Jahre,156,68,88
False,8435018,Hagnau am Bodensee,Insgesamt,1450,683,767
False,8435020,Heiligenberg,unter 3 Jahre,63,41,22
False,8435020,Heiligenberg,3 -  6 Jahre,84,36,48
False,8435020,Heiligenberg,6 - 10 Jahre,81,44,37
False,8435020,Heiligenberg,10 - 15 Jahre,162,91,71
False,8435020,Heiligenberg,15 - 18 Jahre,126,68,58
False,8435020,Heiligenberg,18 - 20 Jahre,75,47,28
False,8435020,Heiligenberg,20 - 25 Jahre,180,86,94
False,8435020,Heiligenberg,25 - 30 Jahre,151,79,72
False,8435020,Heiligenberg,30 - 35 Jahre,145,61,84
False,8435020,Heiligenberg,35 - 40 Jahre,135,79,56
False,8435020,Heiligenberg,40 - 45 Jahre,206,106,100
False,8435020,Heiligenberg,45 - 50 Jahre,270,126,144
False,8435020,Heiligenberg,50 - 55 Jahre,238,126,112
False,8435020,Heiligenberg,55 - 60 Jahre,212,122,90
False,8435020,Heiligenberg,60 - 65 Jahre,135,61,74
False,8435020,Heiligenberg,65 - 75 Jahre,264,118,146
False,8435020,Heiligenberg,75 und mehr Jahre,292,109,183
False,8435020,Heiligenberg,Insgesamt,2819,1400,1419
False,8435024,Immenstaad am Bodensee,unter 3 Jahre,179,87,92
False,8435024,Immenstaad am Bodensee,3 -  6 Jahre,157,83,74
False,8435024,Immenstaad am Bodensee,6 - 10 Jahre,220,124,96
False,8435024,Immenstaad am Bodensee,10 - 15 Jahre,274,120,154
False,8435024,Immenstaad am Bodensee,15 - 18 Jahre,152,84,68
False,8435024,Immenstaad am Bodensee,18 - 20 Jahre,107,53,54
False,8435024,Immenstaad am Bodensee,20 - 25 Jahre,255,129,126
False,8435024,Immenstaad am Bodensee,25 - 30 Jahre,308,155,153
False,8435024,Immenstaad am Bodensee,30 - 35 Jahre,355,173,182
False,8435024,Immenstaad am Bodensee,35 - 40 Jahre,325,162,163
False,8435024,Immenstaad am Bodensee,40 - 45 Jahre,441,222,219
False,8435024,Immenstaad am Bodensee,45 - 50 Jahre,488,244,244
False,8435024,Immenstaad am Bodensee,50 - 55 Jahre,475,258,217
False,8435024,Immenstaad am Bodensee,55 - 60 Jahre,433,203,230
False,8435024,Immenstaad am Bodensee,60 - 65 Jahre,422,205,217
False,8435024,Immenstaad am Bodensee,65 - 75 Jahre,964,471,493
False,8435024,Immenstaad am Bodensee,75 und mehr Jahre,528,223,305
False,8435024,Immenstaad am Bodensee,Insgesamt,6083,2996,3087
False,8435029,Kressbronn am Bodensee,unter 3 Jahre,212,101,111
False,8435029,Kressbronn am Bodensee,3 -  6 Jahre,223,121,102
False,8435029,Kressbronn am Bodensee,6 - 10 Jahre,345,170,175
False,8435029,Kressbronn am Bodensee,10 - 15 Jahre,502,271,231
False,8435029,Kressbronn am Bodensee,15 - 18 Jahre,290,149,141
False,8435029,Kressbronn am Bodensee,18 - 20 Jahre,185,103,82
False,8435029,Kressbronn am Bodensee,20 - 25 Jahre,405,215,190
False,8435029,Kressbronn am Bodensee,25 - 30 Jahre,429,208,221
False,8435029,Kressbronn am Bodensee,30 - 35 Jahre,441,225,216
False,8435029,Kressbronn am Bodensee,35 - 40 Jahre,531,248,283
False,8435029,Kressbronn am Bodensee,40 - 45 Jahre,632,329,303
False,8435029,Kressbronn am Bodensee,45 - 50 Jahre,671,342,329
False,8435029,Kressbronn am Bodensee,50 - 55 Jahre,542,271,271
False,8435029,Kressbronn am Bodensee,55 - 60 Jahre,498,241,257
False,8435029,Kressbronn am Bodensee,60 - 65 Jahre,494,226,268
False,8435029,Kressbronn am Bodensee,65 - 75 Jahre,1055,501,554
False,8435029,Kressbronn am Bodensee,75 und mehr Jahre,704,280,424
False,8435029,Kressbronn am Bodensee,Insgesamt,8159,4001,4158
False,8435030,Langenargen,unter 3 Jahre,205,108,97
False,8435030,Langenargen,3 -  6 Jahre,202,105,97
False,8435030,Langenargen,6 - 10 Jahre,279,149,130
False,8435030,Langenargen,10 - 15 Jahre,404,214,190
False,8435030,Langenargen,15 - 18 Jahre,246,130,116
False,8435030,Langenargen,18 - 20 Jahre,112,56,56
False,8435030,Langenargen,20 - 25 Jahre,324,168,156
False,8435030,Langenargen,25 - 30 Jahre,357,193,164
False,8435030,Langenargen,30 - 35 Jahre,376,205,171
False,8435030,Langenargen,35 - 40 Jahre,470,231,239
False,8435030,Langenargen,40 - 45 Jahre,674,340,334
False,8435030,Langenargen,45 - 50 Jahre,678,319,359
False,8435030,Langenargen,50 - 55 Jahre,570,280,290
False,8435030,Langenargen,55 - 60 Jahre,504,243,261
False,8435030,Langenargen,60 - 65 Jahre,508,246,262
False,8435030,Langenargen,65 - 75 Jahre,1121,540,581
False,8435030,Langenargen,75 und mehr Jahre,773,307,466
False,8435030,Langenargen,Insgesamt,7803,3834,3969
False,8435034,"Markdorf, Stadt",unter 3 Jahre,388,205,183
False,8435034,"Markdorf, Stadt",3 -  6 Jahre,364,166,198
False,8435034,"Markdorf, Stadt",6 - 10 Jahre,504,239,265
False,8435034,"Markdorf, Stadt",10 - 15 Jahre,676,333,343
False,8435034,"Markdorf, Stadt",15 - 18 Jahre,455,232,223
False,8435034,"Markdorf, Stadt",18 - 20 Jahre,248,124,124
False,8435034,"Markdorf, Stadt",20 - 25 Jahre,697,319,378
False,8435034,"Markdorf, Stadt",25 - 30 Jahre,803,416,387
False,8435034,"Markdorf, Stadt",30 - 35 Jahre,834,414,420
False,8435034,"Markdorf, Stadt",35 - 40 Jahre,848,429,419
False,8435034,"Markdorf, Stadt",40 - 45 Jahre,1081,569,512
False,8435034,"Markdorf, Stadt",45 - 50 Jahre,983,478,505
False,8435034,"Markdorf, Stadt",50 - 55 Jahre,936,461,475
False,8435034,"Markdorf, Stadt",55 - 60 Jahre,755,331,424
False,8435034,"Markdorf, Stadt",60 - 65 Jahre,767,363,404
False,8435034,"Markdorf, Stadt",65 - 75 Jahre,1629,776,853
False,8435034,"Markdorf, Stadt",75 und mehr Jahre,995,398,597
False,8435034,"Markdorf, Stadt",Insgesamt,12963,6253,6710
False,8435035,Meckenbeuren,unter 3 Jahre,328,161,167
False,8435035,Meckenbeuren,3 -  6 Jahre,386,203,183
False,8435035,Meckenbeuren,6 - 10 Jahre,542,306,236
False,8435035,Meckenbeuren,10 - 15 Jahre,830,426,404
False,8435035,Meckenbeuren,15 - 18 Jahre,461,255,206
False,8435035,Meckenbeuren,18 - 20 Jahre,300,163,137
False,8435035,Meckenbeuren,20 - 25 Jahre,818,448,370
False,8435035,Meckenbeuren,25 - 30 Jahre,770,366,404
False,8435035,Meckenbeuren,30 - 35 Jahre,777,407,370
False,8435035,Meckenbeuren,35 - 40 Jahre,924,470,454
False,8435035,Meckenbeuren,40 - 45 Jahre,1269,675,594
False,8435035,Meckenbeuren,45 - 50 Jahre,1250,614,636
False,8435035,Meckenbeuren,50 - 55 Jahre,985,516,469
False,8435035,Meckenbeuren,55 - 60 Jahre,863,443,420
False,8435035,Meckenbeuren,60 - 65 Jahre,717,347,370
False,8435035,Meckenbeuren,65 - 75 Jahre,1341,660,681
False,8435035,Meckenbeuren,75 und mehr Jahre,883,349,534
False,8435035,Meckenbeuren,Insgesamt,13444,6809,6635
False,8435036,"Meersburg, Stadt",unter 3 Jahre,118,58,60
False,8435036,"Meersburg, Stadt",3 -  6 Jahre,114,57,57
False,8435036,"Meersburg, Stadt",6 - 10 Jahre,156,75,81
False,8435036,"Meersburg, Stadt",10 - 15 Jahre,246,122,124
False,8435036,"Meersburg, Stadt",15 - 18 Jahre,160,72,88
False,8435036,"Meersburg, Stadt",18 - 20 Jahre,106,49,57
False,8435036,"Meersburg, Stadt",20 - 25 Jahre,305,150,155
False,8435036,"Meersburg, Stadt",25 - 30 Jahre,359,169,190
False,8435036,"Meersburg, Stadt",30 - 35 Jahre,300,142,158
False,8435036,"Meersburg, Stadt",35 - 40 Jahre,351,182,169
False,8435036,"Meersburg, Stadt",40 - 45 Jahre,495,258,237
False,8435036,"Meersburg, Stadt",45 - 50 Jahre,472,247,225
False,8435036,"Meersburg, Stadt",50 - 55 Jahre,388,189,199
False,8435036,"Meersburg, Stadt",55 - 60 Jahre,328,162,166
False,8435036,"Meersburg, Stadt",60 - 65 Jahre,370,157,213
False,8435036,"Meersburg, Stadt",65 - 75 Jahre,805,390,415
False,8435036,"Meersburg, Stadt",75 und mehr Jahre,552,210,342
False,8435036,"Meersburg, Stadt",Insgesamt,5625,2689,2936
False,8435042,Neukirch,unter 3 Jahre,74,38,36
False,8435042,Neukirch,3 -  6 Jahre,72,39,33
False,8435042,Neukirch,6 - 10 Jahre,116,51,65
False,8435042,Neukirch,10 - 15 Jahre,189,107,82
False,8435042,Neukirch,15 - 18 Jahre,86,37,49
False,8435042,Neukirch,18 - 20 Jahre,71,45,26
False,8435042,Neukirch,20 - 25 Jahre,175,98,77
False,8435042,Neukirch,25 - 30 Jahre,156,69,87
False,8435042,Neukirch,30 - 35 Jahre,168,79,89
False,8435042,Neukirch,35 - 40 Jahre,187,98,89
False,8435042,Neukirch,40 - 45 Jahre,238,121,117
False,8435042,Neukirch,45 - 50 Jahre,263,147,116
False,8435042,Neukirch,50 - 55 Jahre,209,103,106
False,8435042,Neukirch,55 - 60 Jahre,171,95,76
False,8435042,Neukirch,60 - 65 Jahre,130,68,62
False,8435042,Neukirch,65 - 75 Jahre,213,120,93
False,8435042,Neukirch,75 und mehr Jahre,141,57,84
False,8435042,Neukirch,Insgesamt,2659,1372,1287
False,8435045,Oberteuringen,unter 3 Jahre,137,77,60
False,8435045,Oberteuringen,3 -  6 Jahre,128,57,71
False,8435045,Oberteuringen,6 - 10 Jahre,190,91,99
False,8435045,Oberteuringen,10 - 15 Jahre,285,145,140
False,8435045,Oberteuringen,15 - 18 Jahre,171,89,82
False,8435045,Oberteuringen,18 - 20 Jahre,113,59,54
False,8435045,Oberteuringen,20 - 25 Jahre,260,122,138
False,8435045,Oberteuringen,25 - 30 Jahre,232,128,104
False,8435045,Oberteuringen,30 - 35 Jahre,268,127,141
False,8435045,Oberteuringen,35 - 40 Jahre,308,149,159
False,8435045,Oberteuringen,40 - 45 Jahre,426,222,204
False,8435045,Oberteuringen,45 - 50 Jahre,409,210,199
False,8435045,Oberteuringen,50 - 55 Jahre,348,165,183
False,8435045,Oberteuringen,55 - 60 Jahre,295,159,136
False,8435045,Oberteuringen,60 - 65 Jahre,246,130,116
False,8435045,Oberteuringen,65 - 75 Jahre,421,211,210
False,8435045,Oberteuringen,75 und mehr Jahre,258,118,140
False,8435045,Oberteuringen,Insgesamt,4495,2259,2236
False,8435047,Owingen,unter 3 Jahre,119,62,57
False,8435047,Owingen,3 -  6 Jahre,154,87,67
False,8435047,Owingen,6 - 10 Jahre,175,102,73
False,8435047,Owingen,10 - 15 Jahre,251,129,122
False,8435047,Owingen,15 - 18 Jahre,157,84,73
False,8435047,Owingen,18 - 20 Jahre,109,68,41
False,8435047,Owingen,20 - 25 Jahre,262,136,126
False,8435047,Owingen,25 - 30 Jahre,185,87,98
False,8435047,Owingen,30 - 35 Jahre,194,91,103
False,8435047,Owingen,35 - 40 Jahre,260,106,154
False,8435047,Owingen,40 - 45 Jahre,373,184,189
False,8435047,Owingen,45 - 50 Jahre,389,194,195
False,8435047,Owingen,50 - 55 Jahre,339,188,151
False,8435047,Owingen,55 - 60 Jahre,295,137,158
False,8435047,Owingen,60 - 65 Jahre,250,134,116
False,8435047,Owingen,65 - 75 Jahre,416,211,205
False,8435047,Owingen,75 und mehr Jahre,298,143,155
False,8435047,Owingen,Insgesamt,4226,2143,2083
False,8435052,Salem,unter 3 Jahre,289,147,142
False,8435052,Salem,3 -  6 Jahre,296,146,150
False,8435052,Salem,6 - 10 Jahre,432,223,209
False,8435052,Salem,10 - 15 Jahre,691,341,350
False,8435052,Salem,15 - 18 Jahre,507,250,257
False,8435052,Salem,18 - 20 Jahre,331,185,146
False,8435052,Salem,20 - 25 Jahre,698,376,322
False,8435052,Salem,25 - 30 Jahre,637,355,282
False,8435052,Salem,30 - 35 Jahre,624,321,303
False,8435052,Salem,35 - 40 Jahre,704,384,320
False,8435052,Salem,40 - 45 Jahre,850,401,449
False,8435052,Salem,45 - 50 Jahre,948,450,498
False,8435052,Salem,50 - 55 Jahre,827,396,431
False,8435052,Salem,55 - 60 Jahre,755,364,391
False,8435052,Salem,60 - 65 Jahre,618,306,312
False,8435052,Salem,65 - 75 Jahre,1090,559,531
False,8435052,Salem,75 und mehr Jahre,867,344,523
False,8435052,Salem,Insgesamt,11164,5548,5616
False,8435053,Sipplingen,unter 3 Jahre,39,22,17
False,8435053,Sipplingen,3 -  6 Jahre,32,19,13
False,8435053,Sipplingen,6 - 10 Jahre,70,37,33
False,8435053,Sipplingen,10 - 15 Jahre,88,44,44
False,8435053,Sipplingen,15 - 18 Jahre,68,28,40
False,8435053,Sipplingen,18 - 20 Jahre,43,23,20
False,8435053,Sipplingen,20 - 25 Jahre,80,43,37
False,8435053,Sipplingen,25 - 30 Jahre,98,57,41
False,8435053,Sipplingen,30 - 35 Jahre,100,47,53
False,8435053,Sipplingen,35 - 40 Jahre,116,58,58
False,8435053,Sipplingen,40 - 45 Jahre,180,89,91
False,8435053,Sipplingen,45 - 50 Jahre,199,109,90
False,8435053,Sipplingen,50 - 55 Jahre,165,83,82
False,8435053,Sipplingen,55 - 60 Jahre,153,77,76
False,8435053,Sipplingen,60 - 65 Jahre,135,71,64
False,8435053,Sipplingen,65 - 75 Jahre,282,142,140
False,8435053,Sipplingen,75 und mehr Jahre,232,89,143
False,8435053,Sipplingen,Insgesamt,2080,1038,1042
False,8435054,Stetten,unter 3 Jahre,23,11,12
False,8435054,Stetten,3 -  6 Jahre,17,7,10
False,8435054,Stetten,6 - 10 Jahre,46,23,23
False,8435054,Stetten,10 - 15 Jahre,39,13,26
False,8435054,Stetten,15 - 18 Jahre,22,11,11
False,8435054,Stetten,18 - 20 Jahre,20,7,13
False,8435054,Stetten,20 - 25 Jahre,59,32,27
False,8435054,Stetten,25 - 30 Jahre,61,28,33
False,8435054,Stetten,30 - 35 Jahre,43,18,25
False,8435054,Stetten,35 - 40 Jahre,49,30,19
False,8435054,Stetten,40 - 45 Jahre,81,26,55
False,8435054,Stetten,45 - 50 Jahre,99,43,56
False,8435054,Stetten,50 - 55 Jahre,86,45,41
False,8435054,Stetten,55 - 60 Jahre,80,35,45
False,8435054,Stetten,60 - 65 Jahre,45,23,22
False,8435054,Stetten,65 - 75 Jahre,130,61,69
False,8435054,Stetten,75 und mehr Jahre,87,39,48
False,8435054,Stetten,Insgesamt,987,452,535
False,8435057,"Tettnang, Stadt",unter 3 Jahre,482,268,214
False,8435057,"Tettnang, Stadt",3 -  6 Jahre,483,252,231
False,8435057,"Tettnang, Stadt",6 - 10 Jahre,749,401,348
False,8435057,"Tettnang, Stadt",10 - 15 Jahre,1071,556,515
False,8435057,"Tettnang, Stadt",15 - 18 Jahre,721,374,347
False,8435057,"Tettnang, Stadt",18 - 20 Jahre,469,249,220
False,8435057,"Tettnang, Stadt",20 - 25 Jahre,998,499,499
False,8435057,"Tettnang, Stadt",25 - 30 Jahre,943,500,443
False,8435057,"Tettnang, Stadt",30 - 35 Jahre,1062,520,542
False,8435057,"Tettnang, Stadt",35 - 40 Jahre,1156,563,593
False,8435057,"Tettnang, Stadt",40 - 45 Jahre,1670,863,807
False,8435057,"Tettnang, Stadt",45 - 50 Jahre,1723,891,832
False,8435057,"Tettnang, Stadt",50 - 55 Jahre,1465,791,674
False,8435057,"Tettnang, Stadt",55 - 60 Jahre,1167,565,602
False,8435057,"Tettnang, Stadt",60 - 65 Jahre,1033,512,521
False,8435057,"Tettnang, Stadt",65 - 75 Jahre,2016,1019,997
False,8435057,"Tettnang, Stadt",75 und mehr Jahre,1440,576,864
False,8435057,"Tettnang, Stadt",Insgesamt,18648,9399,9249
False,8435059,"Überlingen, Stadt",unter 3 Jahre,458,245,213
False,8435059,"Überlingen, Stadt",3 -  6 Jahre,448,221,227
False,8435059,"Überlingen, Stadt",6 - 10 Jahre,693,367,326
False,8435059,"Überlingen, Stadt",10 - 15 Jahre,1049,539,510
False,8435059,"Überlingen, Stadt",15 - 18 Jahre,733,379,354
False,8435059,"Überlingen, Stadt",18 - 20 Jahre,612,323,289
False,8435059,"Überlingen, Stadt",20 - 25 Jahre,1139,600,539
False,8435059,"Überlingen, Stadt",25 - 30 Jahre,1001,489,512
False,8435059,"Überlingen, Stadt",30 - 35 Jahre,1028,517,511
False,8435059,"Überlingen, Stadt",35 - 40 Jahre,1165,552,613
False,8435059,"Überlingen, Stadt",40 - 45 Jahre,1639,737,902
False,8435059,"Überlingen, Stadt",45 - 50 Jahre,1588,730,858
False,8435059,"Überlingen, Stadt",50 - 55 Jahre,1549,717,832
False,8435059,"Überlingen, Stadt",55 - 60 Jahre,1412,640,772
False,8435059,"Überlingen, Stadt",60 - 65 Jahre,1384,579,805
False,8435059,"Überlingen, Stadt",65 - 75 Jahre,3215,1499,1716
False,8435059,"Überlingen, Stadt",75 und mehr Jahre,2705,973,1732
False,8435059,"Überlingen, Stadt",Insgesamt,21818,10107,11711
False,8435066,Uhldingen-Mühlhofen,unter 3 Jahre,167,75,92
False,8435066,Uhldingen-Mühlhofen,3 -  6 Jahre,184,92,92
False,8435066,Uhldingen-Mühlhofen,6 - 10 Jahre,295,153,142
False,8435066,Uhldingen-Mühlhofen,10 - 15 Jahre,445,231,214
False,8435066,Uhldingen-Mühlhofen,15 - 18 Jahre,267,154,113
False,8435066,Uhldingen-Mühlhofen,18 - 20 Jahre,203,109,94
False,8435066,Uhldingen-Mühlhofen,20 - 25 Jahre,404,213,191
False,8435066,Uhldingen-Mühlhofen,25 - 30 Jahre,361,192,169
False,8435066,Uhldingen-Mühlhofen,30 - 35 Jahre,395,196,199
False,8435066,Uhldingen-Mühlhofen,35 - 40 Jahre,446,229,217
False,8435066,Uhldingen-Mühlhofen,40 - 45 Jahre,673,316,357
False,8435066,Uhldingen-Mühlhofen,45 - 50 Jahre,714,376,338
False,8435066,Uhldingen-Mühlhofen,50 - 55 Jahre,643,300,343
False,8435066,Uhldingen-Mühlhofen,55 - 60 Jahre,502,267,235
False,8435066,Uhldingen-Mühlhofen,60 - 65 Jahre,542,240,302
False,8435066,Uhldingen-Mühlhofen,65 - 75 Jahre,1005,485,520
False,8435066,Uhldingen-Mühlhofen,75 und mehr Jahre,664,260,404
False,8435066,Uhldingen-Mühlhofen,Insgesamt,7910,3888,4022
False,8435067,Deggenhausertal,unter 3 Jahre,103,55,48
False,8435067,Deggenhausertal,3 -  6 Jahre,130,69,61
False,8435067,Deggenhausertal,6 - 10 Jahre,188,93,95
False,8435067,Deggenhausertal,10 - 15 Jahre,257,122,135
False,8435067,Deggenhausertal,15 - 18 Jahre,172,92,80
False,8435067,Deggenhausertal,18 - 20 Jahre,116,59,57
False,8435067,Deggenhausertal,20 - 25 Jahre,247,130,117
False,8435067,Deggenhausertal,25 - 30 Jahre,199,112,87
False,8435067,Deggenhausertal,30 - 35 Jahre,245,109,136
False,8435067,Deggenhausertal,35 - 40 Jahre,309,144,165
False,8435067,Deggenhausertal,40 - 45 Jahre,411,208,203
False,8435067,Deggenhausertal,45 - 50 Jahre,438,232,206
False,8435067,Deggenhausertal,50 - 55 Jahre,364,193,171
False,8435067,Deggenhausertal,55 - 60 Jahre,243,115,128
False,8435067,Deggenhausertal,60 - 65 Jahre,195,99,96
False,8435067,Deggenhausertal,65 - 75 Jahre,388,177,211
False,8435067,Deggenhausertal,75 und mehr Jahre,293,130,163
False,8435067,Deggenhausertal,Insgesamt,4298,2139,2159
False,8436,Landkreis Ravensburg,unter 3 Jahre,7361,3720,3641
False,8436,Landkreis Ravensburg,3 -  6 Jahre,7557,3908,3649
False,8436,Landkreis Ravensburg,6 - 10 Jahre,11101,5699,5402
False,8436,Landkreis Ravensburg,10 - 15 Jahre,16344,8385,7959
False,8436,Landkreis Ravensburg,15 - 18 Jahre,9969,5177,4792
False,8436,Landkreis Ravensburg,18 - 20 Jahre,7200,3734,3466
False,8436,Landkreis Ravensburg,20 - 25 Jahre,17001,8775,8226
False,8436,Landkreis Ravensburg,25 - 30 Jahre,15686,7854,7832
False,8436,Landkreis Ravensburg,30 - 35 Jahre,15838,7890,7948
False,8436,Landkreis Ravensburg,35 - 40 Jahre,17616,8812,8804
False,8436,Landkreis Ravensburg,40 - 45 Jahre,23666,11933,11733
False,8436,Landkreis Ravensburg,45 - 50 Jahre,23823,12101,11722
False,8436,Landkreis Ravensburg,50 - 55 Jahre,20437,10184,10253
False,8436,Landkreis Ravensburg,55 - 60 Jahre,17195,8567,8628
False,8436,Landkreis Ravensburg,60 - 65 Jahre,14892,7506,7386
False,8436,Landkreis Ravensburg,65 - 75 Jahre,28138,13741,14397
False,8436,Landkreis Ravensburg,75 und mehr Jahre,23141,8909,14232
False,8436,Landkreis Ravensburg,Insgesamt,276965,136895,140070
False,8436001,Achberg,unter 3 Jahre,62,32,30
False,8436001,Achberg,3 -  6 Jahre,64,32,32
False,8436001,Achberg,6 - 10 Jahre,90,46,44
False,8436001,Achberg,10 - 15 Jahre,119,59,60
False,8436001,Achberg,15 - 18 Jahre,88,52,36
False,8436001,Achberg,18 - 20 Jahre,43,22,21
False,8436001,Achberg,20 - 25 Jahre,89,41,48
False,8436001,Achberg,25 - 30 Jahre,69,28,41
False,8436001,Achberg,30 - 35 Jahre,92,42,50
False,8436001,Achberg,35 - 40 Jahre,98,45,53
False,8436001,Achberg,40 - 45 Jahre,172,94,78
False,8436001,Achberg,45 - 50 Jahre,136,67,69
False,8436001,Achberg,50 - 55 Jahre,104,59,45
False,8436001,Achberg,55 - 60 Jahre,91,40,51
False,8436001,Achberg,60 - 65 Jahre,72,38,34
False,8436001,Achberg,65 - 75 Jahre,122,61,61
False,8436001,Achberg,75 und mehr Jahre,146,54,92
False,8436001,Achberg,Insgesamt,1657,812,845
False,8436003,Aichstetten,unter 3 Jahre,75,41,34
False,8436003,Aichstetten,3 -  6 Jahre,76,42,34
False,8436003,Aichstetten,6 - 10 Jahre,137,74,63
False,8436003,Aichstetten,10 - 15 Jahre,194,97,97
False,8436003,Aichstetten,15 - 18 Jahre,92,44,48
False,8436003,Aichstetten,18 - 20 Jahre,77,41,36
False,8436003,Aichstetten,20 - 25 Jahre,181,100,81
False,8436003,Aichstetten,25 - 30 Jahre,132,63,69
False,8436003,Aichstetten,30 - 35 Jahre,152,74,78
False,8436003,Aichstetten,35 - 40 Jahre,216,112,104
False,8436003,Aichstetten,40 - 45 Jahre,238,134,104
False,8436003,Aichstetten,45 - 50 Jahre,213,111,102
False,8436003,Aichstetten,50 - 55 Jahre,213,114,99
False,8436003,Aichstetten,55 - 60 Jahre,145,77,68
False,8436003,Aichstetten,60 - 65 Jahre,142,71,71
False,8436003,Aichstetten,65 - 75 Jahre,275,147,128
False,8436003,Aichstetten,75 und mehr Jahre,187,76,111
False,8436003,Aichstetten,Insgesamt,2745,1418,1327
False,8436004,Aitrach,unter 3 Jahre,64,32,32
False,8436004,Aitrach,3 -  6 Jahre,63,28,35
False,8436004,Aitrach,6 - 10 Jahre,96,49,47
False,8436004,Aitrach,10 - 15 Jahre,162,95,67
False,8436004,Aitrach,15 - 18 Jahre,102,53,49
False,8436004,Aitrach,18 - 20 Jahre,49,29,20
False,8436004,Aitrach,20 - 25 Jahre,123,69,54
False,8436004,Aitrach,25 - 30 Jahre,128,61,67
False,8436004,Aitrach,30 - 35 Jahre,146,73,73
False,8436004,Aitrach,35 - 40 Jahre,144,82,62
False,8436004,Aitrach,40 - 45 Jahre,210,112,98
False,8436004,Aitrach,45 - 50 Jahre,205,109,96
False,8436004,Aitrach,50 - 55 Jahre,177,89,88
False,8436004,Aitrach,55 - 60 Jahre,136,64,72
False,8436004,Aitrach,60 - 65 Jahre,170,86,84
False,8436004,Aitrach,65 - 75 Jahre,319,159,160
False,8436004,Aitrach,75 und mehr Jahre,231,90,141
False,8436004,Aitrach,Insgesamt,2525,1280,1245
False,8436005,Altshausen,unter 3 Jahre,105,51,54
False,8436005,Altshausen,3 -  6 Jahre,98,47,51
False,8436005,Altshausen,6 - 10 Jahre,148,75,73
False,8436005,Altshausen,10 - 15 Jahre,211,108,103
False,8436005,Altshausen,15 - 18 Jahre,162,89,73
False,8436005,Altshausen,18 - 20 Jahre,97,51,46
False,8436005,Altshausen,20 - 25 Jahre,238,138,100
False,8436005,Altshausen,25 - 30 Jahre,230,102,128
False,8436005,Altshausen,30 - 35 Jahre,237,129,108
False,8436005,Altshausen,35 - 40 Jahre,315,169,146
False,8436005,Altshausen,40 - 45 Jahre,318,173,145
False,8436005,Altshausen,45 - 50 Jahre,345,203,142
False,8436005,Altshausen,50 - 55 Jahre,364,212,152
False,8436005,Altshausen,55 - 60 Jahre,367,232,135
False,8436005,Altshausen,60 - 65 Jahre,314,210,104
False,8436005,Altshausen,65 - 75 Jahre,563,349,214
False,8436005,Altshausen,75 und mehr Jahre,518,219,299
False,8436005,Altshausen,Insgesamt,4630,2557,2073
False,8436006,Amtzell,unter 3 Jahre,129,59,70
False,8436006,Amtzell,3 -  6 Jahre,121,62,59
False,8436006,Amtzell,6 - 10 Jahre,182,91,91
False,8436006,Amtzell,10 - 15 Jahre,269,128,141
False,8436006,Amtzell,15 - 18 Jahre,150,70,80
False,8436006,Amtzell,18 - 20 Jahre,106,59,47
False,8436006,Amtzell,20 - 25 Jahre,222,115,107
False,8436006,Amtzell,25 - 30 Jahre,191,95,96
False,8436006,Amtzell,30 - 35 Jahre,220,100,120
False,8436006,Amtzell,35 - 40 Jahre,264,115,149
False,8436006,Amtzell,40 - 45 Jahre,338,183,155
False,8436006,Amtzell,45 - 50 Jahre,343,167,176
False,8436006,Amtzell,50 - 55 Jahre,293,142,151
False,8436006,Amtzell,55 - 60 Jahre,249,126,123
False,8436006,Amtzell,60 - 65 Jahre,196,105,91
False,8436006,Amtzell,65 - 75 Jahre,299,149,150
False,8436006,Amtzell,75 und mehr Jahre,257,99,158
False,8436006,Amtzell,Insgesamt,3829,1865,1964
False,8436008,"Aulendorf, Stadt",unter 3 Jahre,257,128,129
False,8436008,"Aulendorf, Stadt",3 -  6 Jahre,261,128,133
False,8436008,"Aulendorf, Stadt",6 - 10 Jahre,410,218,192
False,8436008,"Aulendorf, Stadt",10 - 15 Jahre,623,318,305
False,8436008,"Aulendorf, Stadt",15 - 18 Jahre,348,181,167
False,8436008,"Aulendorf, Stadt",18 - 20 Jahre,277,127,150
False,8436008,"Aulendorf, Stadt",20 - 25 Jahre,630,340,290
False,8436008,"Aulendorf, Stadt",25 - 30 Jahre,588,314,274
False,8436008,"Aulendorf, Stadt",30 - 35 Jahre,526,272,254
False,8436008,"Aulendorf, Stadt",35 - 40 Jahre,632,328,304
False,8436008,"Aulendorf, Stadt",40 - 45 Jahre,742,375,367
False,8436008,"Aulendorf, Stadt",45 - 50 Jahre,837,383,454
False,8436008,"Aulendorf, Stadt",50 - 55 Jahre,787,385,402
False,8436008,"Aulendorf, Stadt",55 - 60 Jahre,630,329,301
False,8436008,"Aulendorf, Stadt",60 - 65 Jahre,569,286,283
False,8436008,"Aulendorf, Stadt",65 - 75 Jahre,854,410,444
False,8436008,"Aulendorf, Stadt",75 und mehr Jahre,808,290,518
False,8436008,"Aulendorf, Stadt",Insgesamt,9779,4812,4967
False,8436009,"Bad Waldsee, Stadt",unter 3 Jahre,560,272,288
False,8436009,"Bad Waldsee, Stadt",3 -  6 Jahre,610,311,299
False,8436009,"Bad Waldsee, Stadt",6 - 10 Jahre,849,435,414
False,8436009,"Bad Waldsee, Stadt",10 - 15 Jahre,1170,611,559
False,8436009,"Bad Waldsee, Stadt",15 - 18 Jahre,726,364,362
False,8436009,"Bad Waldsee, Stadt",18 - 20 Jahre,487,241,246
False,8436009,"Bad Waldsee, Stadt",20 - 25 Jahre,1208,645,563
False,8436009,"Bad Waldsee, Stadt",25 - 30 Jahre,1108,526,582
False,8436009,"Bad Waldsee, Stadt",30 - 35 Jahre,1106,534,572
False,8436009,"Bad Waldsee, Stadt",35 - 40 Jahre,1296,624,672
False,8436009,"Bad Waldsee, Stadt",40 - 45 Jahre,1599,779,820
False,8436009,"Bad Waldsee, Stadt",45 - 50 Jahre,1587,783,804
False,8436009,"Bad Waldsee, Stadt",50 - 55 Jahre,1517,742,775
False,8436009,"Bad Waldsee, Stadt",55 - 60 Jahre,1286,625,661
False,8436009,"Bad Waldsee, Stadt",60 - 65 Jahre,1098,504,594
False,8436009,"Bad Waldsee, Stadt",65 - 75 Jahre,2044,971,1073
False,8436009,"Bad Waldsee, Stadt",75 und mehr Jahre,1687,582,1105
False,8436009,"Bad Waldsee, Stadt",Insgesamt,19938,9549,10389
False,8436010,"Bad Wurzach, Stadt",unter 3 Jahre,422,213,209
False,8436010,"Bad Wurzach, Stadt",3 -  6 Jahre,450,233,217
False,8436010,"Bad Wurzach, Stadt",6 - 10 Jahre,611,325,286
False,8436010,"Bad Wurzach, Stadt",10 - 15 Jahre,947,484,463
False,8436010,"Bad Wurzach, Stadt",15 - 18 Jahre,566,295,271
False,8436010,"Bad Wurzach, Stadt",18 - 20 Jahre,409,225,184
False,8436010,"Bad Wurzach, Stadt",20 - 25 Jahre,874,454,420
False,8436010,"Bad Wurzach, Stadt",25 - 30 Jahre,780,397,383
False,8436010,"Bad Wurzach, Stadt",30 - 35 Jahre,842,443,399
False,8436010,"Bad Wurzach, Stadt",35 - 40 Jahre,939,474,465
False,8436010,"Bad Wurzach, Stadt",40 - 45 Jahre,1260,664,596
False,8436010,"Bad Wurzach, Stadt",45 - 50 Jahre,1230,644,586
False,8436010,"Bad Wurzach, Stadt",50 - 55 Jahre,1003,523,480
False,8436010,"Bad Wurzach, Stadt",55 - 60 Jahre,843,442,401
False,8436010,"Bad Wurzach, Stadt",60 - 65 Jahre,710,360,350
False,8436010,"Bad Wurzach, Stadt",65 - 75 Jahre,1367,696,671
False,8436010,"Bad Wurzach, Stadt",75 und mehr Jahre,1019,402,617
False,8436010,"Bad Wurzach, Stadt",Insgesamt,14272,7274,6998
False,8436011,Baienfurt,unter 3 Jahre,187,102,85
False,8436011,Baienfurt,3 -  6 Jahre,186,97,89
False,8436011,Baienfurt,6 - 10 Jahre,297,150,147
False,8436011,Baienfurt,10 - 15 Jahre,392,220,172
False,8436011,Baienfurt,15 - 18 Jahre,257,128,129
False,8436011,Baienfurt,18 - 20 Jahre,185,101,84
False,8436011,Baienfurt,20 - 25 Jahre,435,228,207
False,8436011,Baienfurt,25 - 30 Jahre,429,207,222
False,8436011,Baienfurt,30 - 35 Jahre,377,196,181
False,8436011,Baienfurt,35 - 40 Jahre,397,190,207
False,8436011,Baienfurt,40 - 45 Jahre,652,330,322
False,8436011,Baienfurt,45 - 50 Jahre,603,304,299
False,8436011,Baienfurt,50 - 55 Jahre,521,264,257
False,8436011,Baienfurt,55 - 60 Jahre,477,220,257
False,8436011,Baienfurt,60 - 65 Jahre,388,198,190
False,8436011,Baienfurt,65 - 75 Jahre,792,382,410
False,8436011,Baienfurt,75 und mehr Jahre,619,244,375
False,8436011,Baienfurt,Insgesamt,7194,3561,3633
False,8436012,Baindt,unter 3 Jahre,134,76,58
False,8436012,Baindt,3 -  6 Jahre,146,87,59
False,8436012,Baindt,6 - 10 Jahre,197,96,101
False,8436012,Baindt,10 - 15 Jahre,279,150,129
False,8436012,Baindt,15 - 18 Jahre,164,92,72
False,8436012,Baindt,18 - 20 Jahre,124,65,59
False,8436012,Baindt,20 - 25 Jahre,311,161,150
False,8436012,Baindt,25 - 30 Jahre,285,132,153
False,8436012,Baindt,30 - 35 Jahre,289,141,148
False,8436012,Baindt,35 - 40 Jahre,283,144,139
False,8436012,Baindt,40 - 45 Jahre,410,186,224
False,8436012,Baindt,45 - 50 Jahre,397,210,187
False,8436012,Baindt,50 - 55 Jahre,362,168,194
False,8436012,Baindt,55 - 60 Jahre,336,167,169
False,8436012,Baindt,60 - 65 Jahre,258,130,128
False,8436012,Baindt,65 - 75 Jahre,551,265,286
False,8436012,Baindt,75 und mehr Jahre,358,160,198
False,8436012,Baindt,Insgesamt,4884,2430,2454
False,8436013,Berg,unter 3 Jahre,125,57,68
False,8436013,Berg,3 -  6 Jahre,129,73,56
False,8436013,Berg,6 - 10 Jahre,149,76,73
False,8436013,Berg,10 - 15 Jahre,256,139,117
False,8436013,Berg,15 - 18 Jahre,123,70,53
False,8436013,Berg,18 - 20 Jahre,82,51,31
False,8436013,Berg,20 - 25 Jahre,224,118,106
False,8436013,Berg,25 - 30 Jahre,223,114,109
False,8436013,Berg,30 - 35 Jahre,228,112,116
False,8436013,Berg,35 - 40 Jahre,263,138,125
False,8436013,Berg,40 - 45 Jahre,355,202,153
False,8436013,Berg,45 - 50 Jahre,307,148,159
False,8436013,Berg,50 - 55 Jahre,294,136,158
False,8436013,Berg,55 - 60 Jahre,243,109,134
False,8436013,Berg,60 - 65 Jahre,231,119,112
False,8436013,Berg,65 - 75 Jahre,447,213,234
False,8436013,Berg,75 und mehr Jahre,281,113,168
False,8436013,Berg,Insgesamt,3960,1988,1972
False,8436014,Bergatreute,unter 3 Jahre,83,36,47
False,8436014,Bergatreute,3 -  6 Jahre,102,55,47
False,8436014,Bergatreute,6 - 10 Jahre,133,71,62
False,8436014,Bergatreute,10 - 15 Jahre,221,115,106
False,8436014,Bergatreute,15 - 18 Jahre,156,88,68
False,8436014,Bergatreute,18 - 20 Jahre,95,57,38
False,8436014,Bergatreute,20 - 25 Jahre,232,123,109
False,8436014,Bergatreute,25 - 30 Jahre,148,69,79
False,8436014,Bergatreute,30 - 35 Jahre,155,71,84
False,8436014,Bergatreute,35 - 40 Jahre,186,103,83
False,8436014,Bergatreute,40 - 45 Jahre,280,151,129
False,8436014,Bergatreute,45 - 50 Jahre,308,160,148
False,8436014,Bergatreute,50 - 55 Jahre,233,127,106
False,8436014,Bergatreute,55 - 60 Jahre,202,95,107
False,8436014,Bergatreute,60 - 65 Jahre,145,79,66
False,8436014,Bergatreute,65 - 75 Jahre,284,136,148
False,8436014,Bergatreute,75 und mehr Jahre,182,70,112
False,8436014,Bergatreute,Insgesamt,3145,1606,1539
False,8436018,Bodnegg,unter 3 Jahre,87,43,44
False,8436018,Bodnegg,3 -  6 Jahre,86,50,36
False,8436018,Bodnegg,6 - 10 Jahre,134,64,70
False,8436018,Bodnegg,10 - 15 Jahre,199,91,108
False,8436018,Bodnegg,15 - 18 Jahre,93,49,44
False,8436018,Bodnegg,18 - 20 Jahre,88,41,47
False,8436018,Bodnegg,20 - 25 Jahre,181,103,78
False,8436018,Bodnegg,25 - 30 Jahre,144,74,70
False,8436018,Bodnegg,30 - 35 Jahre,146,81,65
False,8436018,Bodnegg,35 - 40 Jahre,180,89,91
False,8436018,Bodnegg,40 - 45 Jahre,273,132,141
False,8436018,Bodnegg,45 - 50 Jahre,312,178,134
False,8436018,Bodnegg,50 - 55 Jahre,240,118,122
False,8436018,Bodnegg,55 - 60 Jahre,212,107,105
False,8436018,Bodnegg,60 - 65 Jahre,191,107,84
False,8436018,Bodnegg,65 - 75 Jahre,327,152,175
False,8436018,Bodnegg,75 und mehr Jahre,256,117,139
False,8436018,Bodnegg,Insgesamt,3149,1596,1553
False,8436019,Boms,unter 3 Jahre,13,5,8
False,8436019,Boms,3 -  6 Jahre,26,14,12
False,8436019,Boms,6 - 10 Jahre,41,19,22
False,8436019,Boms,10 - 15 Jahre,49,24,25
False,8436019,Boms,15 - 18 Jahre,24,17,7
False,8436019,Boms,18 - 20 Jahre,20,15,5
False,8436019,Boms,20 - 25 Jahre,37,24,13
False,8436019,Boms,25 - 30 Jahre,32,15,17
False,8436019,Boms,30 - 35 Jahre,35,19,16
False,8436019,Boms,35 - 40 Jahre,42,25,17
False,8436019,Boms,40 - 45 Jahre,69,32,37
False,8436019,Boms,45 - 50 Jahre,54,28,26
False,8436019,Boms,50 - 55 Jahre,52,28,24
False,8436019,Boms,55 - 60 Jahre,34,18,16
False,8436019,Boms,60 - 65 Jahre,24,15,9
False,8436019,Boms,65 - 75 Jahre,30,17,13
False,8436019,Boms,75 und mehr Jahre,37,10,27
False,8436019,Boms,Insgesamt,619,325,294
False,8436024,Ebenweiler,unter 3 Jahre,31,16,15
False,8436024,Ebenweiler,3 -  6 Jahre,48,29,19
False,8436024,Ebenweiler,6 - 10 Jahre,55,26,29
False,8436024,Ebenweiler,10 - 15 Jahre,86,45,41
False,8436024,Ebenweiler,15 - 18 Jahre,55,29,26
False,8436024,Ebenweiler,18 - 20 Jahre,48,28,20
False,8436024,Ebenweiler,20 - 25 Jahre,76,39,37
False,8436024,Ebenweiler,25 - 30 Jahre,51,29,22
False,8436024,Ebenweiler,30 - 35 Jahre,64,29,35
False,8436024,Ebenweiler,35 - 40 Jahre,86,43,43
False,8436024,Ebenweiler,40 - 45 Jahre,109,53,56
False,8436024,Ebenweiler,45 - 50 Jahre,108,53,55
False,8436024,Ebenweiler,50 - 55 Jahre,89,45,44
False,8436024,Ebenweiler,55 - 60 Jahre,69,38,31
False,8436024,Ebenweiler,60 - 65 Jahre,57,35,22
False,8436024,Ebenweiler,65 - 75 Jahre,90,45,45
False,8436024,Ebenweiler,75 und mehr Jahre,54,24,30
False,8436024,Ebenweiler,Insgesamt,1176,606,570
False,8436027,Eichstegen,unter 3 Jahre,14,7,7
False,8436027,Eichstegen,3 -  6 Jahre,17,9,8
False,8436027,Eichstegen,6 - 10 Jahre,19,12,7
False,8436027,Eichstegen,10 - 15 Jahre,31,12,19
False,8436027,Eichstegen,15 - 18 Jahre,15,9,6
False,8436027,Eichstegen,18 - 20 Jahre,16,7,9
False,8436027,Eichstegen,20 - 25 Jahre,40,17,23
False,8436027,Eichstegen,25 - 30 Jahre,25,14,11
False,8436027,Eichstegen,30 - 35 Jahre,34,18,16
False,8436027,Eichstegen,35 - 40 Jahre,38,18,20
False,8436027,Eichstegen,40 - 45 Jahre,37,17,20
False,8436027,Eichstegen,45 - 50 Jahre,62,32,30
False,8436027,Eichstegen,50 - 55 Jahre,40,17,23
False,8436027,Eichstegen,55 - 60 Jahre,27,16,11
False,8436027,Eichstegen,60 - 65 Jahre,16,6,10
False,8436027,Eichstegen,65 - 75 Jahre,37,20,17
False,8436027,Eichstegen,75 und mehr Jahre,40,18,22
False,8436027,Eichstegen,Insgesamt,508,249,259
False,8436032,Fleischwangen,unter 3 Jahre,18,12,6
False,8436032,Fleischwangen,3 -  6 Jahre,21,15,6
False,8436032,Fleischwangen,6 - 10 Jahre,34,24,10
False,8436032,Fleischwangen,10 - 15 Jahre,60,33,27
False,8436032,Fleischwangen,15 - 18 Jahre,39,21,18
False,8436032,Fleischwangen,18 - 20 Jahre,24,17,7
False,8436032,Fleischwangen,20 - 25 Jahre,49,25,24
False,8436032,Fleischwangen,25 - 30 Jahre,32,18,14
False,8436032,Fleischwangen,30 - 35 Jahre,40,20,20
False,8436032,Fleischwangen,35 - 40 Jahre,44,19,25
False,8436032,Fleischwangen,40 - 45 Jahre,55,27,28
False,8436032,Fleischwangen,45 - 50 Jahre,58,28,30
False,8436032,Fleischwangen,50 - 55 Jahre,52,26,26
False,8436032,Fleischwangen,55 - 60 Jahre,23,11,12
False,8436032,Fleischwangen,60 - 65 Jahre,25,13,12
False,8436032,Fleischwangen,65 - 75 Jahre,51,32,19
False,8436032,Fleischwangen,75 und mehr Jahre,33,15,18
False,8436032,Fleischwangen,Insgesamt,658,356,302
False,8436039,Grünkraut,unter 3 Jahre,99,48,51
False,8436039,Grünkraut,3 -  6 Jahre,93,40,53
False,8436039,Grünkraut,6 - 10 Jahre,120,67,53
False,8436039,Grünkraut,10 - 15 Jahre,194,111,83
False,8436039,Grünkraut,15 - 18 Jahre,108,50,58
False,8436039,Grünkraut,18 - 20 Jahre,79,38,41
False,8436039,Grünkraut,20 - 25 Jahre,191,114,77
False,8436039,Grünkraut,25 - 30 Jahre,161,82,79
False,8436039,Grünkraut,30 - 35 Jahre,196,85,111
False,8436039,Grünkraut,35 - 40 Jahre,223,108,115
False,8436039,Grünkraut,40 - 45 Jahre,285,153,132
False,8436039,Grünkraut,45 - 50 Jahre,271,143,128
False,8436039,Grünkraut,50 - 55 Jahre,253,131,122
False,8436039,Grünkraut,55 - 60 Jahre,187,98,89
False,8436039,Grünkraut,60 - 65 Jahre,166,80,86
False,8436039,Grünkraut,65 - 75 Jahre,285,145,140
False,8436039,Grünkraut,75 und mehr Jahre,202,84,118
False,8436039,Grünkraut,Insgesamt,3113,1577,1536
False,8436040,Guggenhausen,unter 3 Jahre,4,2,2
False,8436040,Guggenhausen,3 -  6 Jahre,2,1,1
False,8436040,Guggenhausen,6 - 10 Jahre,5,3,2
False,8436040,Guggenhausen,10 - 15 Jahre,13,6,7
False,8436040,Guggenhausen,15 - 18 Jahre,9,5,4
False,8436040,Guggenhausen,18 - 20 Jahre,5,3,2
False,8436040,Guggenhausen,20 - 25 Jahre,8,2,6
False,8436040,Guggenhausen,25 - 30 Jahre,9,5,4
False,8436040,Guggenhausen,30 - 35 Jahre,12,6,6
False,8436040,Guggenhausen,35 - 40 Jahre,17,12,5
False,8436040,Guggenhausen,40 - 45 Jahre,8,3,5
False,8436040,Guggenhausen,45 - 50 Jahre,15,8,7
False,8436040,Guggenhausen,50 - 55 Jahre,20,14,6
False,8436040,Guggenhausen,55 - 60 Jahre,12,7,5
False,8436040,Guggenhausen,60 - 65 Jahre,10,5,5
False,8436040,Guggenhausen,65 - 75 Jahre,18,9,9
False,8436040,Guggenhausen,75 und mehr Jahre,14,5,9
False,8436040,Guggenhausen,Insgesamt,181,96,85
False,8436047,Hoßkirch,unter 3 Jahre,20,11,9
False,8436047,Hoßkirch,3 -  6 Jahre,23,9,14
False,8436047,Hoßkirch,6 - 10 Jahre,29,12,17
False,8436047,Hoßkirch,10 - 15 Jahre,47,27,20
False,8436047,Hoßkirch,15 - 18 Jahre,39,24,15
False,8436047,Hoßkirch,18 - 20 Jahre,20,13,7
False,8436047,Hoßkirch,20 - 25 Jahre,44,26,18
False,8436047,Hoßkirch,25 - 30 Jahre,36,23,13
False,8436047,Hoßkirch,30 - 35 Jahre,38,13,25
False,8436047,Hoßkirch,35 - 40 Jahre,38,23,15
False,8436047,Hoßkirch,40 - 45 Jahre,52,26,26
False,8436047,Hoßkirch,45 - 50 Jahre,65,40,25
False,8436047,Hoßkirch,50 - 55 Jahre,68,30,38
False,8436047,Hoßkirch,55 - 60 Jahre,56,33,23
False,8436047,Hoßkirch,60 - 65 Jahre,50,27,23
False,8436047,Hoßkirch,65 - 75 Jahre,66,31,35
False,8436047,Hoßkirch,75 und mehr Jahre,42,16,26
False,8436047,Hoßkirch,Insgesamt,733,384,349
False,8436049,"Isny im Allgäu, Stadt",unter 3 Jahre,317,162,155
False,8436049,"Isny im Allgäu, Stadt",3 -  6 Jahre,338,182,156
False,8436049,"Isny im Allgäu, Stadt",6 - 10 Jahre,531,262,269
False,8436049,"Isny im Allgäu, Stadt",10 - 15 Jahre,783,428,355
False,8436049,"Isny im Allgäu, Stadt",15 - 18 Jahre,462,237,225
False,8436049,"Isny im Allgäu, Stadt",18 - 20 Jahre,362,191,171
False,8436049,"Isny im Allgäu, Stadt",20 - 25 Jahre,840,448,392
False,8436049,"Isny im Allgäu, Stadt",25 - 30 Jahre,845,435,410
False,8436049,"Isny im Allgäu, Stadt",30 - 35 Jahre,870,423,447
False,8436049,"Isny im Allgäu, Stadt",35 - 40 Jahre,975,475,500
False,8436049,"Isny im Allgäu, Stadt",40 - 45 Jahre,1436,607,829
False,8436049,"Isny im Allgäu, Stadt",45 - 50 Jahre,1369,658,711
False,8436049,"Isny im Allgäu, Stadt",50 - 55 Jahre,1017,498,519
False,8436049,"Isny im Allgäu, Stadt",55 - 60 Jahre,849,430,419
False,8436049,"Isny im Allgäu, Stadt",60 - 65 Jahre,775,372,403
False,8436049,"Isny im Allgäu, Stadt",65 - 75 Jahre,1390,677,713
False,8436049,"Isny im Allgäu, Stadt",75 und mehr Jahre,1233,443,790
False,8436049,"Isny im Allgäu, Stadt",Insgesamt,14392,6928,7464
False,8436052,Kißlegg,unter 3 Jahre,264,130,134
False,8436052,Kißlegg,3 -  6 Jahre,207,101,106
False,8436052,Kißlegg,6 - 10 Jahre,351,170,181
False,8436052,Kißlegg,10 - 15 Jahre,550,298,252
False,8436052,Kißlegg,15 - 18 Jahre,373,192,181
False,8436052,Kißlegg,18 - 20 Jahre,232,125,107
False,8436052,Kißlegg,20 - 25 Jahre,468,264,204
False,8436052,Kißlegg,25 - 30 Jahre,471,221,250
False,8436052,Kißlegg,30 - 35 Jahre,450,220,230
False,8436052,Kißlegg,35 - 40 Jahre,498,248,250
False,8436052,Kißlegg,40 - 45 Jahre,706,342,364
False,8436052,Kißlegg,45 - 50 Jahre,743,365,378
False,8436052,Kißlegg,50 - 55 Jahre,636,333,303
False,8436052,Kißlegg,55 - 60 Jahre,558,303,255
False,8436052,Kißlegg,60 - 65 Jahre,488,244,244
False,8436052,Kißlegg,65 - 75 Jahre,824,408,416
False,8436052,Kißlegg,75 und mehr Jahre,696,256,440
False,8436052,Kißlegg,Insgesamt,8515,4220,4295
False,8436053,Königseggwald,unter 3 Jahre,17,7,10
False,8436053,Königseggwald,3 -  6 Jahre,15,7,8
False,8436053,Königseggwald,6 - 10 Jahre,29,15,14
False,8436053,Königseggwald,10 - 15 Jahre,50,26,24
False,8436053,Königseggwald,15 - 18 Jahre,27,15,12
False,8436053,Königseggwald,18 - 20 Jahre,25,10,15
False,8436053,Königseggwald,20 - 25 Jahre,42,25,17
False,8436053,Königseggwald,25 - 30 Jahre,39,22,17
False,8436053,Königseggwald,30 - 35 Jahre,37,20,17
False,8436053,Königseggwald,35 - 40 Jahre,32,15,17
False,8436053,Königseggwald,40 - 45 Jahre,68,34,34
False,8436053,Königseggwald,45 - 50 Jahre,59,32,27
False,8436053,Königseggwald,50 - 55 Jahre,40,19,21
False,8436053,Königseggwald,55 - 60 Jahre,46,25,21
False,8436053,Königseggwald,60 - 65 Jahre,22,13,9
False,8436053,Königseggwald,65 - 75 Jahre,71,32,39
False,8436053,Königseggwald,75 und mehr Jahre,51,21,30
False,8436053,Königseggwald,Insgesamt,670,338,332
False,8436055,"Leutkirch im Allgäu, Stadt",unter 3 Jahre,541,286,255
False,8436055,"Leutkirch im Allgäu, Stadt",3 -  6 Jahre,585,282,303
False,8436055,"Leutkirch im Allgäu, Stadt",6 - 10 Jahre,916,476,440
False,8436055,"Leutkirch im Allgäu, Stadt",10 - 15 Jahre,1411,712,699
False,8436055,"Leutkirch im Allgäu, Stadt",15 - 18 Jahre,902,481,421
False,8436055,"Leutkirch im Allgäu, Stadt",18 - 20 Jahre,631,322,309
False,8436055,"Leutkirch im Allgäu, Stadt",20 - 25 Jahre,1359,710,649
False,8436055,"Leutkirch im Allgäu, Stadt",25 - 30 Jahre,1161,617,544
False,8436055,"Leutkirch im Allgäu, Stadt",30 - 35 Jahre,1104,576,528
False,8436055,"Leutkirch im Allgäu, Stadt",35 - 40 Jahre,1311,643,668
False,8436055,"Leutkirch im Allgäu, Stadt",40 - 45 Jahre,1739,891,848
False,8436055,"Leutkirch im Allgäu, Stadt",45 - 50 Jahre,1811,929,882
False,8436055,"Leutkirch im Allgäu, Stadt",50 - 55 Jahre,1624,810,814
False,8436055,"Leutkirch im Allgäu, Stadt",55 - 60 Jahre,1384,705,679
False,8436055,"Leutkirch im Allgäu, Stadt",60 - 65 Jahre,1241,616,625
False,8436055,"Leutkirch im Allgäu, Stadt",65 - 75 Jahre,2236,1113,1123
False,8436055,"Leutkirch im Allgäu, Stadt",75 und mehr Jahre,1946,732,1214
False,8436055,"Leutkirch im Allgäu, Stadt",Insgesamt,21902,10901,11001
False,8436064,"Ravensburg, Stadt",unter 3 Jahre,1293,657,636
False,8436064,"Ravensburg, Stadt",3 -  6 Jahre,1310,653,657
False,8436064,"Ravensburg, Stadt",6 - 10 Jahre,1803,947,856
False,8436064,"Ravensburg, Stadt",10 - 15 Jahre,2516,1259,1257
False,8436064,"Ravensburg, Stadt",15 - 18 Jahre,1456,758,698
False,8436064,"Ravensburg, Stadt",18 - 20 Jahre,1162,599,563
False,8436064,"Ravensburg, Stadt",20 - 25 Jahre,2970,1438,1532
False,8436064,"Ravensburg, Stadt",25 - 30 Jahre,3163,1539,1624
False,8436064,"Ravensburg, Stadt",30 - 35 Jahre,3280,1650,1630
False,8436064,"Ravensburg, Stadt",35 - 40 Jahre,3353,1638,1715
False,8436064,"Ravensburg, Stadt",40 - 45 Jahre,4280,2129,2151
False,8436064,"Ravensburg, Stadt",45 - 50 Jahre,4215,2167,2048
False,8436064,"Ravensburg, Stadt",50 - 55 Jahre,3642,1817,1825
False,8436064,"Ravensburg, Stadt",55 - 60 Jahre,2902,1366,1536
False,8436064,"Ravensburg, Stadt",60 - 65 Jahre,2570,1283,1287
False,8436064,"Ravensburg, Stadt",65 - 75 Jahre,5357,2513,2844
False,8436064,"Ravensburg, Stadt",75 und mehr Jahre,4502,1683,2819
False,8436064,"Ravensburg, Stadt",Insgesamt,49774,24096,25678
False,8436067,Riedhausen,unter 3 Jahre,17,6,11
False,8436067,Riedhausen,3 -  6 Jahre,18,10,8
False,8436067,Riedhausen,6 - 10 Jahre,39,22,17
False,8436067,Riedhausen,10 - 15 Jahre,49,19,30
False,8436067,Riedhausen,15 - 18 Jahre,43,21,22
False,8436067,Riedhausen,18 - 20 Jahre,21,14,7
False,8436067,Riedhausen,20 - 25 Jahre,49,27,22
False,8436067,Riedhausen,25 - 30 Jahre,41,16,25
False,8436067,Riedhausen,30 - 35 Jahre,35,17,18
False,8436067,Riedhausen,35 - 40 Jahre,49,26,23
False,8436067,Riedhausen,40 - 45 Jahre,53,24,29
False,8436067,Riedhausen,45 - 50 Jahre,53,27,26
False,8436067,Riedhausen,50 - 55 Jahre,48,25,23
False,8436067,Riedhausen,55 - 60 Jahre,25,15,10
False,8436067,Riedhausen,60 - 65 Jahre,23,13,10
False,8436067,Riedhausen,65 - 75 Jahre,39,18,21
False,8436067,Riedhausen,75 und mehr Jahre,35,16,19
False,8436067,Riedhausen,Insgesamt,637,316,321
False,8436069,Schlier,unter 3 Jahre,121,65,56
False,8436069,Schlier,3 -  6 Jahre,81,37,44
False,8436069,Schlier,6 - 10 Jahre,152,79,73
False,8436069,Schlier,10 - 15 Jahre,225,121,104
False,8436069,Schlier,15 - 18 Jahre,135,62,73
False,8436069,Schlier,18 - 20 Jahre,103,56,47
False,8436069,Schlier,20 - 25 Jahre,207,100,107
False,8436069,Schlier,25 - 30 Jahre,213,106,107
False,8436069,Schlier,30 - 35 Jahre,234,113,121
False,8436069,Schlier,35 - 40 Jahre,226,110,116
False,8436069,Schlier,40 - 45 Jahre,289,154,135
False,8436069,Schlier,45 - 50 Jahre,319,151,168
False,8436069,Schlier,50 - 55 Jahre,322,149,173
False,8436069,Schlier,55 - 60 Jahre,273,143,130
False,8436069,Schlier,60 - 65 Jahre,178,93,85
False,8436069,Schlier,65 - 75 Jahre,392,213,179
False,8436069,Schlier,75 und mehr Jahre,240,103,137
False,8436069,Schlier,Insgesamt,3710,1855,1855
False,8436077,Unterwaldhausen,unter 3 Jahre,4,3,1
False,8436077,Unterwaldhausen,3 -  6 Jahre,5,4,1
False,8436077,Unterwaldhausen,6 - 10 Jahre,9,5,4
False,8436077,Unterwaldhausen,10 - 15 Jahre,14,5,9
False,8436077,Unterwaldhausen,15 - 18 Jahre,16,8,8
False,8436077,Unterwaldhausen,18 - 20 Jahre,6,1,5
False,8436077,Unterwaldhausen,20 - 25 Jahre,28,10,18
False,8436077,Unterwaldhausen,25 - 30 Jahre,16,9,7
False,8436077,Unterwaldhausen,30 - 35 Jahre,19,10,9
False,8436077,Unterwaldhausen,35 - 40 Jahre,15,8,7
False,8436077,Unterwaldhausen,40 - 45 Jahre,31,15,16
False,8436077,Unterwaldhausen,45 - 50 Jahre,28,14,14
False,8436077,Unterwaldhausen,50 - 55 Jahre,16,7,9
False,8436077,Unterwaldhausen,55 - 60 Jahre,22,13,9
False,8436077,Unterwaldhausen,60 - 65 Jahre,15,9,6
False,8436077,Unterwaldhausen,65 - 75 Jahre,16,8,8
False,8436077,Unterwaldhausen,75 und mehr Jahre,19,10,9
False,8436077,Unterwaldhausen,Insgesamt,279,139,140
False,8436078,Vogt,unter 3 Jahre,100,60,40
False,8436078,Vogt,3 -  6 Jahre,118,73,45
False,8436078,Vogt,6 - 10 Jahre,177,105,72
False,8436078,Vogt,10 - 15 Jahre,306,159,147
False,8436078,Vogt,15 - 18 Jahre,191,94,97
False,8436078,Vogt,18 - 20 Jahre,128,72,56
False,8436078,Vogt,20 - 25 Jahre,269,135,134
False,8436078,Vogt,25 - 30 Jahre,241,130,111
False,8436078,Vogt,30 - 35 Jahre,201,98,103
False,8436078,Vogt,35 - 40 Jahre,277,132,145
False,8436078,Vogt,40 - 45 Jahre,401,217,184
False,8436078,Vogt,45 - 50 Jahre,374,193,181
False,8436078,Vogt,50 - 55 Jahre,398,184,214
False,8436078,Vogt,55 - 60 Jahre,302,151,151
False,8436078,Vogt,60 - 65 Jahre,245,137,108
False,8436078,Vogt,65 - 75 Jahre,453,219,234
False,8436078,Vogt,75 und mehr Jahre,356,146,210
False,8436078,Vogt,Insgesamt,4537,2305,2232
False,8436079,Waldburg,unter 3 Jahre,79,30,49
False,8436079,Waldburg,3 -  6 Jahre,88,40,48
False,8436079,Waldburg,6 - 10 Jahre,125,74,51
False,8436079,Waldburg,10 - 15 Jahre,246,118,128
False,8436079,Waldburg,15 - 18 Jahre,138,65,73
False,8436079,Waldburg,18 - 20 Jahre,81,37,44
False,8436079,Waldburg,20 - 25 Jahre,171,91,80
False,8436079,Waldburg,25 - 30 Jahre,134,72,62
False,8436079,Waldburg,30 - 35 Jahre,144,66,78
False,8436079,Waldburg,35 - 40 Jahre,182,103,79
False,8436079,Waldburg,40 - 45 Jahre,259,134,125
False,8436079,Waldburg,45 - 50 Jahre,311,139,172
False,8436079,Waldburg,50 - 55 Jahre,236,133,103
False,8436079,Waldburg,55 - 60 Jahre,195,98,97
False,8436079,Waldburg,60 - 65 Jahre,159,83,76
False,8436079,Waldburg,65 - 75 Jahre,276,133,143
False,8436079,Waldburg,75 und mehr Jahre,227,92,135
False,8436079,Waldburg,Insgesamt,3051,1508,1543
False,8436081,"Wangen im Allgäu, Stadt",unter 3 Jahre,703,337,366
False,8436081,"Wangen im Allgäu, Stadt",3 -  6 Jahre,726,382,344
False,8436081,"Wangen im Allgäu, Stadt",6 - 10 Jahre,1133,557,576
False,8436081,"Wangen im Allgäu, Stadt",10 - 15 Jahre,1666,801,865
False,8436081,"Wangen im Allgäu, Stadt",15 - 18 Jahre,1006,484,522
False,8436081,"Wangen im Allgäu, Stadt",18 - 20 Jahre,714,365,349
False,8436081,"Wangen im Allgäu, Stadt",20 - 25 Jahre,1563,803,760
False,8436081,"Wangen im Allgäu, Stadt",25 - 30 Jahre,1312,663,649
False,8436081,"Wangen im Allgäu, Stadt",30 - 35 Jahre,1429,655,774
False,8436081,"Wangen im Allgäu, Stadt",35 - 40 Jahre,1680,846,834
False,8436081,"Wangen im Allgäu, Stadt",40 - 45 Jahre,2415,1223,1192
False,8436081,"Wangen im Allgäu, Stadt",45 - 50 Jahre,2395,1204,1191
False,8436081,"Wangen im Allgäu, Stadt",50 - 55 Jahre,1912,945,967
False,8436081,"Wangen im Allgäu, Stadt",55 - 60 Jahre,1642,772,870
False,8436081,"Wangen im Allgäu, Stadt",60 - 65 Jahre,1583,806,777
False,8436081,"Wangen im Allgäu, Stadt",65 - 75 Jahre,2993,1430,1563
False,8436081,"Wangen im Allgäu, Stadt",75 und mehr Jahre,2589,1046,1543
False,8436081,"Wangen im Allgäu, Stadt",Insgesamt,27461,13319,14142
False,8436082,"Weingarten, Stadt",unter 3 Jahre,584,308,276
False,8436082,"Weingarten, Stadt",3 -  6 Jahre,575,304,271
False,8436082,"Weingarten, Stadt",6 - 10 Jahre,796,411,385
False,8436082,"Weingarten, Stadt",10 - 15 Jahre,1047,548,499
False,8436082,"Weingarten, Stadt",15 - 18 Jahre,682,370,312
False,8436082,"Weingarten, Stadt",18 - 20 Jahre,543,283,260
False,8436082,"Weingarten, Stadt",20 - 25 Jahre,1809,875,934
False,8436082,"Weingarten, Stadt",25 - 30 Jahre,1586,807,779
False,8436082,"Weingarten, Stadt",30 - 35 Jahre,1452,746,706
False,8436082,"Weingarten, Stadt",35 - 40 Jahre,1404,734,670
False,8436082,"Weingarten, Stadt",40 - 45 Jahre,1916,1008,908
False,8436082,"Weingarten, Stadt",45 - 50 Jahre,2061,1070,991
False,8436082,"Weingarten, Stadt",50 - 55 Jahre,1686,812,874
False,8436082,"Weingarten, Stadt",55 - 60 Jahre,1556,744,812
False,8436082,"Weingarten, Stadt",60 - 65 Jahre,1254,568,686
False,8436082,"Weingarten, Stadt",65 - 75 Jahre,2690,1280,1410
False,8436082,"Weingarten, Stadt",75 und mehr Jahre,2234,830,1404
False,8436082,"Weingarten, Stadt",Insgesamt,23875,11698,12177
False,8436083,Wilhelmsdorf,unter 3 Jahre,110,55,55
False,8436083,Wilhelmsdorf,3 -  6 Jahre,112,58,54
False,8436083,Wilhelmsdorf,6 - 10 Jahre,198,98,100
False,8436083,Wilhelmsdorf,10 - 15 Jahre,337,172,165
False,8436083,Wilhelmsdorf,15 - 18 Jahre,245,129,116
False,8436083,Wilhelmsdorf,18 - 20 Jahre,171,93,78
False,8436083,Wilhelmsdorf,20 - 25 Jahre,341,184,157
False,8436083,Wilhelmsdorf,25 - 30 Jahre,272,128,144
False,8436083,Wilhelmsdorf,30 - 35 Jahre,230,133,97
False,8436083,Wilhelmsdorf,35 - 40 Jahre,285,150,135
False,8436083,Wilhelmsdorf,40 - 45 Jahre,414,212,202
False,8436083,Wilhelmsdorf,45 - 50 Jahre,439,222,217
False,8436083,Wilhelmsdorf,50 - 55 Jahre,363,171,192
False,8436083,Wilhelmsdorf,55 - 60 Jahre,290,159,131
False,8436083,Wilhelmsdorf,60 - 65 Jahre,229,114,115
False,8436083,Wilhelmsdorf,65 - 75 Jahre,436,207,229
False,8436083,Wilhelmsdorf,75 und mehr Jahre,334,139,195
False,8436083,Wilhelmsdorf,Insgesamt,4806,2424,2382
False,8436085,Wolfegg,unter 3 Jahre,105,53,52
False,8436085,Wolfegg,3 -  6 Jahre,101,53,48
False,8436085,Wolfegg,6 - 10 Jahre,165,79,86
False,8436085,Wolfegg,10 - 15 Jahre,209,102,107
False,8436085,Wolfegg,15 - 18 Jahre,134,80,54
False,8436085,Wolfegg,18 - 20 Jahre,94,47,47
False,8436085,Wolfegg,20 - 25 Jahre,168,88,80
False,8436085,Wolfegg,25 - 30 Jahre,159,87,72
False,8436085,Wolfegg,30 - 35 Jahre,204,98,106
False,8436085,Wolfegg,35 - 40 Jahre,228,104,124
False,8436085,Wolfegg,40 - 45 Jahre,300,165,135
False,8436085,Wolfegg,45 - 50 Jahre,269,139,130
False,8436085,Wolfegg,50 - 55 Jahre,247,119,128
False,8436085,Wolfegg,55 - 60 Jahre,219,114,105
False,8436085,Wolfegg,60 - 65 Jahre,181,88,93
False,8436085,Wolfegg,65 - 75 Jahre,343,167,176
False,8436085,Wolfegg,75 und mehr Jahre,321,133,188
False,8436085,Wolfegg,Insgesamt,3447,1716,1731
False,8436087,Wolpertswende,unter 3 Jahre,111,51,60
False,8436087,Wolpertswende,3 -  6 Jahre,124,72,52
False,8436087,Wolpertswende,6 - 10 Jahre,183,107,76
False,8436087,Wolpertswende,10 - 15 Jahre,242,129,113
False,8436087,Wolpertswende,15 - 18 Jahre,162,80,82
False,8436087,Wolpertswende,18 - 20 Jahre,100,46,54
False,8436087,Wolpertswende,20 - 25 Jahre,249,139,110
False,8436087,Wolpertswende,25 - 30 Jahre,225,120,105
False,8436087,Wolpertswende,30 - 35 Jahre,229,112,117
False,8436087,Wolpertswende,35 - 40 Jahre,248,119,129
False,8436087,Wolpertswende,40 - 45 Jahre,334,164,170
False,8436087,Wolpertswende,45 - 50 Jahre,361,186,175
False,8436087,Wolpertswende,50 - 55 Jahre,314,153,161
False,8436087,Wolpertswende,55 - 60 Jahre,265,134,131
False,8436087,Wolpertswende,60 - 65 Jahre,219,123,96
False,8436087,Wolpertswende,65 - 75 Jahre,417,215,202
False,8436087,Wolpertswende,75 und mehr Jahre,274,110,164
False,8436087,Wolpertswende,Insgesamt,4057,2060,1997
False,8436093,Ebersbach-Musbach,unter 3 Jahre,47,31,16
False,8436093,Ebersbach-Musbach,3 -  6 Jahre,49,31,18
False,8436093,Ebersbach-Musbach,6 - 10 Jahre,73,33,40
False,8436093,Ebersbach-Musbach,10 - 15 Jahre,135,65,70
False,8436093,Ebersbach-Musbach,15 - 18 Jahre,78,46,32
False,8436093,Ebersbach-Musbach,18 - 20 Jahre,52,24,28
False,8436093,Ebersbach-Musbach,20 - 25 Jahre,99,49,50
False,8436093,Ebersbach-Musbach,25 - 30 Jahre,71,40,31
False,8436093,Ebersbach-Musbach,30 - 35 Jahre,97,50,47
False,8436093,Ebersbach-Musbach,35 - 40 Jahre,112,56,56
False,8436093,Ebersbach-Musbach,40 - 45 Jahre,140,78,62
False,8436093,Ebersbach-Musbach,45 - 50 Jahre,189,101,88
False,8436093,Ebersbach-Musbach,50 - 55 Jahre,162,89,73
False,8436093,Ebersbach-Musbach,55 - 60 Jahre,114,60,54
False,8436093,Ebersbach-Musbach,60 - 65 Jahre,70,36,34
False,8436093,Ebersbach-Musbach,65 - 75 Jahre,156,92,64
False,8436093,Ebersbach-Musbach,75 und mehr Jahre,115,42,73
False,8436093,Ebersbach-Musbach,Insgesamt,1759,923,836
False,8436094,Argenbühl,unter 3 Jahre,197,94,103
False,8436094,Argenbühl,3 -  6 Jahre,203,104,99
False,8436094,Argenbühl,6 - 10 Jahre,267,129,138
False,8436094,Argenbühl,10 - 15 Jahre,394,209,185
False,8436094,Argenbühl,15 - 18 Jahre,238,131,107
False,8436094,Argenbühl,18 - 20 Jahre,189,91,98
False,8436094,Argenbühl,20 - 25 Jahre,360,184,176
False,8436094,Argenbühl,25 - 30 Jahre,364,198,166
False,8436094,Argenbühl,30 - 35 Jahre,352,178,174
False,8436094,Argenbühl,35 - 40 Jahre,382,196,186
False,8436094,Argenbühl,40 - 45 Jahre,552,272,280
False,8436094,Argenbühl,45 - 50 Jahre,524,266,258
False,8436094,Argenbühl,50 - 55 Jahre,406,203,203
False,8436094,Argenbühl,55 - 60 Jahre,377,202,175
False,8436094,Argenbühl,60 - 65 Jahre,332,178,154
False,8436094,Argenbühl,65 - 75 Jahre,507,247,260
False,8436094,Argenbühl,75 und mehr Jahre,402,165,237
False,8436094,Argenbühl,Insgesamt,6046,3047,2999
False,8436095,Horgenzell,unter 3 Jahre,149,78,71
False,8436095,Horgenzell,3 -  6 Jahre,153,84,69
False,8436095,Horgenzell,6 - 10 Jahre,239,119,120
False,8436095,Horgenzell,10 - 15 Jahre,317,168,149
False,8436095,Horgenzell,15 - 18 Jahre,186,98,88
False,8436095,Horgenzell,18 - 20 Jahre,132,66,66
False,8436095,Horgenzell,20 - 25 Jahre,352,175,177
False,8436095,Horgenzell,25 - 30 Jahre,303,156,147
False,8436095,Horgenzell,30 - 35 Jahre,305,154,151
False,8436095,Horgenzell,35 - 40 Jahre,378,197,181
False,8436095,Horgenzell,40 - 45 Jahre,461,236,225
False,8436095,Horgenzell,45 - 50 Jahre,420,219,201
False,8436095,Horgenzell,50 - 55 Jahre,349,173,176
False,8436095,Horgenzell,55 - 60 Jahre,258,137,121
False,8436095,Horgenzell,60 - 65 Jahre,219,118,101
False,8436095,Horgenzell,65 - 75 Jahre,359,183,176
False,8436095,Horgenzell,75 und mehr Jahre,275,125,150
False,8436095,Horgenzell,Insgesamt,4855,2486,2369
False,8436096,Fronreute,unter 3 Jahre,113,64,49
False,8436096,Fronreute,3 -  6 Jahre,127,69,58
False,8436096,Fronreute,6 - 10 Jahre,179,78,101
False,8436096,Fronreute,10 - 15 Jahre,325,173,152
False,8436096,Fronreute,15 - 18 Jahre,179,96,83
False,8436096,Fronreute,18 - 20 Jahre,123,61,62
False,8436096,Fronreute,20 - 25 Jahre,264,148,116
False,8436096,Fronreute,25 - 30 Jahre,269,120,149
False,8436096,Fronreute,30 - 35 Jahre,231,113,118
False,8436096,Fronreute,35 - 40 Jahre,280,151,129
False,8436096,Fronreute,40 - 45 Jahre,410,202,208
False,8436096,Fronreute,45 - 50 Jahre,427,220,207
False,8436096,Fronreute,50 - 55 Jahre,337,174,163
False,8436096,Fronreute,55 - 60 Jahre,293,142,151
False,8436096,Fronreute,60 - 65 Jahre,257,138,119
False,8436096,Fronreute,65 - 75 Jahre,362,197,165
False,8436096,Fronreute,75 und mehr Jahre,321,129,192
False,8436096,Fronreute,Insgesamt,4497,2275,2222
False,8437,Landkreis Sigmaringen,unter 3 Jahre,3262,1667,1595
False,8437,Landkreis Sigmaringen,3 -  6 Jahre,3498,1777,1721
False,8437,Landkreis Sigmaringen,6 - 10 Jahre,5132,2642,2490
False,8437,Landkreis Sigmaringen,10 - 15 Jahre,7922,4032,3890
False,8437,Landkreis Sigmaringen,15 - 18 Jahre,4983,2527,2456
False,8437,Landkreis Sigmaringen,18 - 20 Jahre,3485,1781,1704
False,8437,Landkreis Sigmaringen,20 - 25 Jahre,7957,4284,3673
False,8437,Landkreis Sigmaringen,25 - 30 Jahre,7120,3667,3453
False,8437,Landkreis Sigmaringen,30 - 35 Jahre,6939,3485,3454
False,8437,Landkreis Sigmaringen,35 - 40 Jahre,7649,3789,3860
False,8437,Landkreis Sigmaringen,40 - 45 Jahre,11016,5784,5232
False,8437,Landkreis Sigmaringen,45 - 50 Jahre,11936,6228,5708
False,8437,Landkreis Sigmaringen,50 - 55 Jahre,9887,5007,4880
False,8437,Landkreis Sigmaringen,55 - 60 Jahre,8176,4051,4125
False,8437,Landkreis Sigmaringen,60 - 65 Jahre,6743,3436,3307
False,8437,Landkreis Sigmaringen,65 - 75 Jahre,13169,6200,6969
False,8437,Landkreis Sigmaringen,75 und mehr Jahre,11341,4389,6952
False,8437,Landkreis Sigmaringen,Insgesamt,130215,64746,65469
False,8437005,Beuron,unter 3 Jahre,12,8,4
False,8437005,Beuron,3 -  6 Jahre,24,12,12
False,8437005,Beuron,6 - 10 Jahre,24,14,10
False,8437005,Beuron,10 - 15 Jahre,39,20,19
False,8437005,Beuron,15 - 18 Jahre,22,16,6
False,8437005,Beuron,18 - 20 Jahre,14,7,7
False,8437005,Beuron,20 - 25 Jahre,24,13,11
False,8437005,Beuron,25 - 30 Jahre,17,9,8
False,8437005,Beuron,30 - 35 Jahre,24,10,14
False,8437005,Beuron,35 - 40 Jahre,32,16,16
False,8437005,Beuron,40 - 45 Jahre,36,21,15
False,8437005,Beuron,45 - 50 Jahre,54,36,18
False,8437005,Beuron,50 - 55 Jahre,66,39,27
False,8437005,Beuron,55 - 60 Jahre,49,30,19
False,8437005,Beuron,60 - 65 Jahre,49,20,29
False,8437005,Beuron,65 - 75 Jahre,103,59,44
False,8437005,Beuron,75 und mehr Jahre,99,52,47
False,8437005,Beuron,Insgesamt,688,382,306
False,8437008,Bingen,unter 3 Jahre,44,20,24
False,8437008,Bingen,3 -  6 Jahre,70,39,31
False,8437008,Bingen,6 - 10 Jahre,127,75,52
False,8437008,Bingen,10 - 15 Jahre,189,96,93
False,8437008,Bingen,15 - 18 Jahre,111,50,61
False,8437008,Bingen,18 - 20 Jahre,75,36,39
False,8437008,Bingen,20 - 25 Jahre,162,87,75
False,8437008,Bingen,25 - 30 Jahre,140,75,65
False,8437008,Bingen,30 - 35 Jahre,134,79,55
False,8437008,Bingen,35 - 40 Jahre,153,66,87
False,8437008,Bingen,40 - 45 Jahre,248,107,141
False,8437008,Bingen,45 - 50 Jahre,281,152,129
False,8437008,Bingen,50 - 55 Jahre,215,107,108
False,8437008,Bingen,55 - 60 Jahre,179,89,90
False,8437008,Bingen,60 - 65 Jahre,161,85,76
False,8437008,Bingen,65 - 75 Jahre,279,143,136
False,8437008,Bingen,75 und mehr Jahre,215,87,128
False,8437008,Bingen,Insgesamt,2783,1393,1390
False,8437031,"Gammertingen, Stadt",unter 3 Jahre,139,62,77
False,8437031,"Gammertingen, Stadt",3 -  6 Jahre,159,78,81
False,8437031,"Gammertingen, Stadt",6 - 10 Jahre,256,133,123
False,8437031,"Gammertingen, Stadt",10 - 15 Jahre,392,207,185
False,8437031,"Gammertingen, Stadt",15 - 18 Jahre,246,127,119
False,8437031,"Gammertingen, Stadt",18 - 20 Jahre,216,111,105
False,8437031,"Gammertingen, Stadt",20 - 25 Jahre,409,223,186
False,8437031,"Gammertingen, Stadt",25 - 30 Jahre,316,161,155
False,8437031,"Gammertingen, Stadt",30 - 35 Jahre,310,142,168
False,8437031,"Gammertingen, Stadt",35 - 40 Jahre,387,198,189
False,8437031,"Gammertingen, Stadt",40 - 45 Jahre,512,272,240
False,8437031,"Gammertingen, Stadt",45 - 50 Jahre,584,283,301
False,8437031,"Gammertingen, Stadt",50 - 55 Jahre,474,232,242
False,8437031,"Gammertingen, Stadt",55 - 60 Jahre,422,194,228
False,8437031,"Gammertingen, Stadt",60 - 65 Jahre,360,188,172
False,8437031,"Gammertingen, Stadt",65 - 75 Jahre,719,331,388
False,8437031,"Gammertingen, Stadt",75 und mehr Jahre,550,211,339
False,8437031,"Gammertingen, Stadt",Insgesamt,6451,3153,3298
False,8437044,Herbertingen,unter 3 Jahre,131,68,63
False,8437044,Herbertingen,3 -  6 Jahre,148,79,69
False,8437044,Herbertingen,6 - 10 Jahre,212,116,96
False,8437044,Herbertingen,10 - 15 Jahre,345,188,157
False,8437044,Herbertingen,15 - 18 Jahre,213,99,114
False,8437044,Herbertingen,18 - 20 Jahre,146,78,68
False,8437044,Herbertingen,20 - 25 Jahre,299,157,142
False,8437044,Herbertingen,25 - 30 Jahre,235,117,118
False,8437044,Herbertingen,30 - 35 Jahre,246,121,125
False,8437044,Herbertingen,35 - 40 Jahre,328,167,161
False,8437044,Herbertingen,40 - 45 Jahre,425,215,210
False,8437044,Herbertingen,45 - 50 Jahre,427,229,198
False,8437044,Herbertingen,50 - 55 Jahre,323,166,157
False,8437044,Herbertingen,55 - 60 Jahre,319,168,151
False,8437044,Herbertingen,60 - 65 Jahre,236,117,119
False,8437044,Herbertingen,65 - 75 Jahre,467,222,245
False,8437044,Herbertingen,75 und mehr Jahre,355,143,212
False,8437044,Herbertingen,Insgesamt,4855,2450,2405
False,8437047,"Hettingen, Stadt",unter 3 Jahre,42,18,24
False,8437047,"Hettingen, Stadt",3 -  6 Jahre,51,28,23
False,8437047,"Hettingen, Stadt",6 - 10 Jahre,72,32,40
False,8437047,"Hettingen, Stadt",10 - 15 Jahre,120,61,59
False,8437047,"Hettingen, Stadt",15 - 18 Jahre,78,31,47
False,8437047,"Hettingen, Stadt",18 - 20 Jahre,54,29,25
False,8437047,"Hettingen, Stadt",20 - 25 Jahre,112,66,46
False,8437047,"Hettingen, Stadt",25 - 30 Jahre,81,40,41
False,8437047,"Hettingen, Stadt",30 - 35 Jahre,85,54,31
False,8437047,"Hettingen, Stadt",35 - 40 Jahre,102,47,55
False,8437047,"Hettingen, Stadt",40 - 45 Jahre,156,83,73
False,8437047,"Hettingen, Stadt",45 - 50 Jahre,172,93,79
False,8437047,"Hettingen, Stadt",50 - 55 Jahre,160,80,80
False,8437047,"Hettingen, Stadt",55 - 60 Jahre,115,57,58
False,8437047,"Hettingen, Stadt",60 - 65 Jahre,100,53,47
False,8437047,"Hettingen, Stadt",65 - 75 Jahre,213,101,112
False,8437047,"Hettingen, Stadt",75 und mehr Jahre,152,62,90
False,8437047,"Hettingen, Stadt",Insgesamt,1865,935,930
False,8437053,Hohentengen,unter 3 Jahre,137,67,70
False,8437053,Hohentengen,3 -  6 Jahre,132,61,71
False,8437053,Hohentengen,6 - 10 Jahre,179,81,98
False,8437053,Hohentengen,10 - 15 Jahre,300,150,150
False,8437053,Hohentengen,15 - 18 Jahre,172,81,91
False,8437053,Hohentengen,18 - 20 Jahre,114,61,53
False,8437053,Hohentengen,20 - 25 Jahre,278,164,114
False,8437053,Hohentengen,25 - 30 Jahre,222,101,121
False,8437053,Hohentengen,30 - 35 Jahre,231,114,117
False,8437053,Hohentengen,35 - 40 Jahre,255,126,129
False,8437053,Hohentengen,40 - 45 Jahre,474,307,167
False,8437053,Hohentengen,45 - 50 Jahre,421,257,164
False,8437053,Hohentengen,50 - 55 Jahre,311,160,151
False,8437053,Hohentengen,55 - 60 Jahre,246,133,113
False,8437053,Hohentengen,60 - 65 Jahre,218,122,96
False,8437053,Hohentengen,65 - 75 Jahre,389,188,201
False,8437053,Hohentengen,75 und mehr Jahre,280,118,162
False,8437053,Hohentengen,Insgesamt,4359,2291,2068
False,8437056,Illmensee,unter 3 Jahre,49,25,24
False,8437056,Illmensee,3 -  6 Jahre,53,31,22
False,8437056,Illmensee,6 - 10 Jahre,85,44,41
False,8437056,Illmensee,10 - 15 Jahre,123,62,61
False,8437056,Illmensee,15 - 18 Jahre,106,61,45
False,8437056,Illmensee,18 - 20 Jahre,61,25,36
False,8437056,Illmensee,20 - 25 Jahre,129,72,57
False,8437056,Illmensee,25 - 30 Jahre,103,60,43
False,8437056,Illmensee,30 - 35 Jahre,115,46,69
False,8437056,Illmensee,35 - 40 Jahre,119,66,53
False,8437056,Illmensee,40 - 45 Jahre,151,85,66
False,8437056,Illmensee,45 - 50 Jahre,172,86,86
False,8437056,Illmensee,50 - 55 Jahre,180,88,92
False,8437056,Illmensee,55 - 60 Jahre,153,73,80
False,8437056,Illmensee,60 - 65 Jahre,122,64,58
False,8437056,Illmensee,65 - 75 Jahre,151,70,81
False,8437056,Illmensee,75 und mehr Jahre,125,49,76
False,8437056,Illmensee,Insgesamt,1997,1007,990
False,8437059,Inzigkofen,unter 3 Jahre,85,34,51
False,8437059,Inzigkofen,3 -  6 Jahre,76,37,39
False,8437059,Inzigkofen,6 - 10 Jahre,130,56,74
False,8437059,Inzigkofen,10 - 15 Jahre,178,95,83
False,8437059,Inzigkofen,15 - 18 Jahre,95,44,51
False,8437059,Inzigkofen,18 - 20 Jahre,66,31,35
False,8437059,Inzigkofen,20 - 25 Jahre,180,91,89
False,8437059,Inzigkofen,25 - 30 Jahre,148,68,80
False,8437059,Inzigkofen,30 - 35 Jahre,149,75,74
False,8437059,Inzigkofen,35 - 40 Jahre,183,82,101
False,8437059,Inzigkofen,40 - 45 Jahre,257,135,122
False,8437059,Inzigkofen,45 - 50 Jahre,272,139,133
False,8437059,Inzigkofen,50 - 55 Jahre,238,128,110
False,8437059,Inzigkofen,55 - 60 Jahre,177,82,95
False,8437059,Inzigkofen,60 - 65 Jahre,141,72,69
False,8437059,Inzigkofen,65 - 75 Jahre,274,146,128
False,8437059,Inzigkofen,75 und mehr Jahre,255,109,146
False,8437059,Inzigkofen,Insgesamt,2904,1424,1480
False,8437065,Krauchenwies,unter 3 Jahre,149,74,75
False,8437065,Krauchenwies,3 -  6 Jahre,140,71,69
False,8437065,Krauchenwies,6 - 10 Jahre,228,96,132
False,8437065,Krauchenwies,10 - 15 Jahre,296,156,140
False,8437065,Krauchenwies,15 - 18 Jahre,215,122,93
False,8437065,Krauchenwies,18 - 20 Jahre,130,71,59
False,8437065,Krauchenwies,20 - 25 Jahre,288,143,145
False,8437065,Krauchenwies,25 - 30 Jahre,290,141,149
False,8437065,Krauchenwies,30 - 35 Jahre,288,156,132
False,8437065,Krauchenwies,35 - 40 Jahre,311,160,151
False,8437065,Krauchenwies,40 - 45 Jahre,427,209,218
False,8437065,Krauchenwies,45 - 50 Jahre,419,207,212
False,8437065,Krauchenwies,50 - 55 Jahre,438,230,208
False,8437065,Krauchenwies,55 - 60 Jahre,351,174,177
False,8437065,Krauchenwies,60 - 65 Jahre,227,114,113
False,8437065,Krauchenwies,65 - 75 Jahre,437,213,224
False,8437065,Krauchenwies,75 und mehr Jahre,389,142,247
False,8437065,Krauchenwies,Insgesamt,5023,2479,2544
False,8437072,Leibertingen,unter 3 Jahre,52,28,24
False,8437072,Leibertingen,3 -  6 Jahre,66,29,37
False,8437072,Leibertingen,6 - 10 Jahre,104,55,49
False,8437072,Leibertingen,10 - 15 Jahre,143,75,68
False,8437072,Leibertingen,15 - 18 Jahre,74,36,38
False,8437072,Leibertingen,18 - 20 Jahre,54,30,24
False,8437072,Leibertingen,20 - 25 Jahre,138,73,65
False,8437072,Leibertingen,25 - 30 Jahre,131,73,58
False,8437072,Leibertingen,30 - 35 Jahre,110,64,46
False,8437072,Leibertingen,35 - 40 Jahre,118,54,64
False,8437072,Leibertingen,40 - 45 Jahre,215,112,103
False,8437072,Leibertingen,45 - 50 Jahre,221,118,103
False,8437072,Leibertingen,50 - 55 Jahre,179,98,81
False,8437072,Leibertingen,55 - 60 Jahre,136,67,69
False,8437072,Leibertingen,60 - 65 Jahre,91,47,44
False,8437072,Leibertingen,65 - 75 Jahre,202,107,95
False,8437072,Leibertingen,75 und mehr Jahre,197,78,119
False,8437072,Leibertingen,Insgesamt,2231,1144,1087
False,8437076,"Mengen, Stadt",unter 3 Jahre,265,139,126
False,8437076,"Mengen, Stadt",3 -  6 Jahre,253,131,122
False,8437076,"Mengen, Stadt",6 - 10 Jahre,383,194,189
False,8437076,"Mengen, Stadt",10 - 15 Jahre,604,300,304
False,8437076,"Mengen, Stadt",15 - 18 Jahre,380,184,196
False,8437076,"Mengen, Stadt",18 - 20 Jahre,262,130,132
False,8437076,"Mengen, Stadt",20 - 25 Jahre,592,321,271
False,8437076,"Mengen, Stadt",25 - 30 Jahre,536,279,257
False,8437076,"Mengen, Stadt",30 - 35 Jahre,512,274,238
False,8437076,"Mengen, Stadt",35 - 40 Jahre,588,283,305
False,8437076,"Mengen, Stadt",40 - 45 Jahre,788,381,407
False,8437076,"Mengen, Stadt",45 - 50 Jahre,891,446,445
False,8437076,"Mengen, Stadt",50 - 55 Jahre,698,360,338
False,8437076,"Mengen, Stadt",55 - 60 Jahre,661,333,328
False,8437076,"Mengen, Stadt",60 - 65 Jahre,542,290,252
False,8437076,"Mengen, Stadt",65 - 75 Jahre,1059,499,560
False,8437076,"Mengen, Stadt",75 und mehr Jahre,872,323,549
False,8437076,"Mengen, Stadt",Insgesamt,9886,4867,5019
False,8437078,"Meßkirch, Stadt",unter 3 Jahre,203,103,100
False,8437078,"Meßkirch, Stadt",3 -  6 Jahre,196,105,91
False,8437078,"Meßkirch, Stadt",6 - 10 Jahre,348,178,170
False,8437078,"Meßkirch, Stadt",10 - 15 Jahre,506,264,242
False,8437078,"Meßkirch, Stadt",15 - 18 Jahre,342,169,173
False,8437078,"Meßkirch, Stadt",18 - 20 Jahre,221,111,110
False,8437078,"Meßkirch, Stadt",20 - 25 Jahre,603,344,259
False,8437078,"Meßkirch, Stadt",25 - 30 Jahre,407,223,184
False,8437078,"Meßkirch, Stadt",30 - 35 Jahre,462,204,258
False,8437078,"Meßkirch, Stadt",35 - 40 Jahre,460,227,233
False,8437078,"Meßkirch, Stadt",40 - 45 Jahre,604,296,308
False,8437078,"Meßkirch, Stadt",45 - 50 Jahre,736,371,365
False,8437078,"Meßkirch, Stadt",50 - 55 Jahre,635,336,299
False,8437078,"Meßkirch, Stadt",55 - 60 Jahre,513,271,242
False,8437078,"Meßkirch, Stadt",60 - 65 Jahre,404,210,194
False,8437078,"Meßkirch, Stadt",65 - 75 Jahre,801,356,445
False,8437078,"Meßkirch, Stadt",75 und mehr Jahre,850,333,517
False,8437078,"Meßkirch, Stadt",Insgesamt,8291,4101,4190
False,8437082,Neufra,unter 3 Jahre,39,21,18
False,8437082,Neufra,3 -  6 Jahre,47,24,23
False,8437082,Neufra,6 - 10 Jahre,75,41,34
False,8437082,Neufra,10 - 15 Jahre,108,56,52
False,8437082,Neufra,15 - 18 Jahre,70,35,35
False,8437082,Neufra,18 - 20 Jahre,42,21,21
False,8437082,Neufra,20 - 25 Jahre,101,52,49
False,8437082,Neufra,25 - 30 Jahre,102,45,57
False,8437082,Neufra,30 - 35 Jahre,81,36,45
False,8437082,Neufra,35 - 40 Jahre,107,53,54
False,8437082,Neufra,40 - 45 Jahre,155,79,76
False,8437082,Neufra,45 - 50 Jahre,174,84,90
False,8437082,Neufra,50 - 55 Jahre,180,86,94
False,8437082,Neufra,55 - 60 Jahre,123,66,57
False,8437082,Neufra,60 - 65 Jahre,100,40,60
False,8437082,Neufra,65 - 75 Jahre,212,108,104
False,8437082,Neufra,75 und mehr Jahre,150,60,90
False,8437082,Neufra,Insgesamt,1866,907,959
False,8437086,Ostrach,unter 3 Jahre,179,94,85
False,8437086,Ostrach,3 -  6 Jahre,195,105,90
False,8437086,Ostrach,6 - 10 Jahre,273,147,126
False,8437086,Ostrach,10 - 15 Jahre,446,238,208
False,8437086,Ostrach,15 - 18 Jahre,269,135,134
False,8437086,Ostrach,18 - 20 Jahre,208,106,102
False,8437086,Ostrach,20 - 25 Jahre,460,248,212
False,8437086,Ostrach,25 - 30 Jahre,388,202,186
False,8437086,Ostrach,30 - 35 Jahre,343,179,164
False,8437086,Ostrach,35 - 40 Jahre,397,193,204
False,8437086,Ostrach,40 - 45 Jahre,548,282,266
False,8437086,Ostrach,45 - 50 Jahre,612,289,323
False,8437086,Ostrach,50 - 55 Jahre,560,268,292
False,8437086,Ostrach,55 - 60 Jahre,426,230,196
False,8437086,Ostrach,60 - 65 Jahre,293,153,140
False,8437086,Ostrach,65 - 75 Jahre,597,276,321
False,8437086,Ostrach,75 und mehr Jahre,520,189,331
False,8437086,Ostrach,Insgesamt,6714,3334,3380
False,8437088,"Pfullendorf, Stadt",unter 3 Jahre,338,184,154
False,8437088,"Pfullendorf, Stadt",3 -  6 Jahre,385,190,195
False,8437088,"Pfullendorf, Stadt",6 - 10 Jahre,563,298,265
False,8437088,"Pfullendorf, Stadt",10 - 15 Jahre,835,424,411
False,8437088,"Pfullendorf, Stadt",15 - 18 Jahre,508,267,241
False,8437088,"Pfullendorf, Stadt",18 - 20 Jahre,366,203,163
False,8437088,"Pfullendorf, Stadt",20 - 25 Jahre,781,425,356
False,8437088,"Pfullendorf, Stadt",25 - 30 Jahre,787,413,374
False,8437088,"Pfullendorf, Stadt",30 - 35 Jahre,770,407,363
False,8437088,"Pfullendorf, Stadt",35 - 40 Jahre,836,423,413
False,8437088,"Pfullendorf, Stadt",40 - 45 Jahre,1029,539,490
False,8437088,"Pfullendorf, Stadt",45 - 50 Jahre,1219,672,547
False,8437088,"Pfullendorf, Stadt",50 - 55 Jahre,1001,523,478
False,8437088,"Pfullendorf, Stadt",55 - 60 Jahre,755,371,384
False,8437088,"Pfullendorf, Stadt",60 - 65 Jahre,656,324,332
False,8437088,"Pfullendorf, Stadt",65 - 75 Jahre,1267,613,654
False,8437088,"Pfullendorf, Stadt",75 und mehr Jahre,969,397,572
False,8437088,"Pfullendorf, Stadt",Insgesamt,13065,6673,6392
False,8437100,"Bad Saulgau, Stadt",unter 3 Jahre,456,230,226
False,8437100,"Bad Saulgau, Stadt",3 -  6 Jahre,455,242,213
False,8437100,"Bad Saulgau, Stadt",6 - 10 Jahre,664,341,323
False,8437100,"Bad Saulgau, Stadt",10 - 15 Jahre,1058,504,554
False,8437100,"Bad Saulgau, Stadt",15 - 18 Jahre,654,340,314
False,8437100,"Bad Saulgau, Stadt",18 - 20 Jahre,415,222,193
False,8437100,"Bad Saulgau, Stadt",20 - 25 Jahre,1003,522,481
False,8437100,"Bad Saulgau, Stadt",25 - 30 Jahre,1002,504,498
False,8437100,"Bad Saulgau, Stadt",30 - 35 Jahre,969,457,512
False,8437100,"Bad Saulgau, Stadt",35 - 40 Jahre,1050,508,542
False,8437100,"Bad Saulgau, Stadt",40 - 45 Jahre,1407,682,725
False,8437100,"Bad Saulgau, Stadt",45 - 50 Jahre,1450,728,722
False,8437100,"Bad Saulgau, Stadt",50 - 55 Jahre,1244,578,666
False,8437100,"Bad Saulgau, Stadt",55 - 60 Jahre,1087,499,588
False,8437100,"Bad Saulgau, Stadt",60 - 65 Jahre,922,457,465
False,8437100,"Bad Saulgau, Stadt",65 - 75 Jahre,1876,849,1027
False,8437100,"Bad Saulgau, Stadt",75 und mehr Jahre,1730,630,1100
False,8437100,"Bad Saulgau, Stadt",Insgesamt,17442,8293,9149
False,8437101,"Scheer, Stadt",unter 3 Jahre,71,37,34
False,8437101,"Scheer, Stadt",3 -  6 Jahre,60,27,33
False,8437101,"Scheer, Stadt",6 - 10 Jahre,81,48,33
False,8437101,"Scheer, Stadt",10 - 15 Jahre,153,87,66
False,8437101,"Scheer, Stadt",15 - 18 Jahre,104,48,56
False,8437101,"Scheer, Stadt",18 - 20 Jahre,71,29,42
False,8437101,"Scheer, Stadt",20 - 25 Jahre,154,93,61
False,8437101,"Scheer, Stadt",25 - 30 Jahre,115,70,45
False,8437101,"Scheer, Stadt",30 - 35 Jahre,112,53,59
False,8437101,"Scheer, Stadt",35 - 40 Jahre,138,73,65
False,8437101,"Scheer, Stadt",40 - 45 Jahre,236,114,122
False,8437101,"Scheer, Stadt",45 - 50 Jahre,232,125,107
False,8437101,"Scheer, Stadt",50 - 55 Jahre,222,103,119
False,8437101,"Scheer, Stadt",55 - 60 Jahre,175,84,91
False,8437101,"Scheer, Stadt",60 - 65 Jahre,151,79,72
False,8437101,"Scheer, Stadt",65 - 75 Jahre,239,113,126
False,8437101,"Scheer, Stadt",75 und mehr Jahre,239,90,149
False,8437101,"Scheer, Stadt",Insgesamt,2553,1273,1280
False,8437102,Schwenningen,unter 3 Jahre,55,31,24
False,8437102,Schwenningen,3 -  6 Jahre,52,28,24
False,8437102,Schwenningen,6 - 10 Jahre,63,28,35
False,8437102,Schwenningen,10 - 15 Jahre,100,49,51
False,8437102,Schwenningen,15 - 18 Jahre,62,37,25
False,8437102,Schwenningen,18 - 20 Jahre,38,16,22
False,8437102,Schwenningen,20 - 25 Jahre,88,38,50
False,8437102,Schwenningen,25 - 30 Jahre,85,46,39
False,8437102,Schwenningen,30 - 35 Jahre,64,39,25
False,8437102,Schwenningen,35 - 40 Jahre,64,33,31
False,8437102,Schwenningen,40 - 45 Jahre,103,47,56
False,8437102,Schwenningen,45 - 50 Jahre,134,83,51
False,8437102,Schwenningen,50 - 55 Jahre,110,54,56
False,8437102,Schwenningen,55 - 60 Jahre,110,55,55
False,8437102,Schwenningen,60 - 65 Jahre,64,28,36
False,8437102,Schwenningen,65 - 75 Jahre,162,74,88
False,8437102,Schwenningen,75 und mehr Jahre,135,64,71
False,8437102,Schwenningen,Insgesamt,1489,750,739
False,8437104,"Sigmaringen, Stadt",unter 3 Jahre,362,196,166
False,8437104,"Sigmaringen, Stadt",3 -  6 Jahre,427,215,212
False,8437104,"Sigmaringen, Stadt",6 - 10 Jahre,524,274,250
False,8437104,"Sigmaringen, Stadt",10 - 15 Jahre,814,404,410
False,8437104,"Sigmaringen, Stadt",15 - 18 Jahre,533,277,256
False,8437104,"Sigmaringen, Stadt",18 - 20 Jahre,378,190,188
False,8437104,"Sigmaringen, Stadt",20 - 25 Jahre,1033,547,486
False,8437104,"Sigmaringen, Stadt",25 - 30 Jahre,1004,488,516
False,8437104,"Sigmaringen, Stadt",30 - 35 Jahre,940,496,444
False,8437104,"Sigmaringen, Stadt",35 - 40 Jahre,877,443,434
False,8437104,"Sigmaringen, Stadt",40 - 45 Jahre,1464,891,573
False,8437104,"Sigmaringen, Stadt",45 - 50 Jahre,1693,977,716
False,8437104,"Sigmaringen, Stadt",50 - 55 Jahre,1109,553,556
False,8437104,"Sigmaringen, Stadt",55 - 60 Jahre,965,469,496
False,8437104,"Sigmaringen, Stadt",60 - 65 Jahre,853,447,406
False,8437104,"Sigmaringen, Stadt",65 - 75 Jahre,1743,766,977
False,8437104,"Sigmaringen, Stadt",75 und mehr Jahre,1533,578,955
False,8437104,"Sigmaringen, Stadt",Insgesamt,16252,8211,8041
False,8437105,Sigmaringendorf,unter 3 Jahre,93,54,39
False,8437105,Sigmaringendorf,3 -  6 Jahre,104,47,57
False,8437105,Sigmaringendorf,6 - 10 Jahre,138,74,64
False,8437105,Sigmaringendorf,10 - 15 Jahre,202,109,93
False,8437105,Sigmaringendorf,15 - 18 Jahre,137,67,70
False,8437105,Sigmaringendorf,18 - 20 Jahre,89,45,44
False,8437105,Sigmaringendorf,20 - 25 Jahre,178,94,84
False,8437105,Sigmaringendorf,25 - 30 Jahre,166,94,72
False,8437105,Sigmaringendorf,30 - 35 Jahre,187,93,94
False,8437105,Sigmaringendorf,35 - 40 Jahre,201,102,99
False,8437105,Sigmaringendorf,40 - 45 Jahre,292,151,141
False,8437105,Sigmaringendorf,45 - 50 Jahre,317,163,154
False,8437105,Sigmaringendorf,50 - 55 Jahre,255,128,127
False,8437105,Sigmaringendorf,55 - 60 Jahre,229,114,115
False,8437105,Sigmaringendorf,60 - 65 Jahre,232,107,125
False,8437105,Sigmaringendorf,65 - 75 Jahre,464,231,233
False,8437105,Sigmaringendorf,75 und mehr Jahre,369,146,223
False,8437105,Sigmaringendorf,Insgesamt,3653,1819,1834
False,8437107,Stetten am kalten Markt,unter 3 Jahre,105,49,56
False,8437107,Stetten am kalten Markt,3 -  6 Jahre,124,62,62
False,8437107,Stetten am kalten Markt,6 - 10 Jahre,192,98,94
False,8437107,Stetten am kalten Markt,10 - 15 Jahre,314,151,163
False,8437107,Stetten am kalten Markt,15 - 18 Jahre,182,86,96
False,8437107,Stetten am kalten Markt,18 - 20 Jahre,128,62,66
False,8437107,Stetten am kalten Markt,20 - 25 Jahre,291,161,130
False,8437107,Stetten am kalten Markt,25 - 30 Jahre,285,169,116
False,8437107,Stetten am kalten Markt,30 - 35 Jahre,243,129,114
False,8437107,Stetten am kalten Markt,35 - 40 Jahre,292,164,128
False,8437107,Stetten am kalten Markt,40 - 45 Jahre,520,333,187
False,8437107,Stetten am kalten Markt,45 - 50 Jahre,424,195,229
False,8437107,Stetten am kalten Markt,50 - 55 Jahre,355,182,173
False,8437107,Stetten am kalten Markt,55 - 60 Jahre,329,167,162
False,8437107,Stetten am kalten Markt,60 - 65 Jahre,255,122,133
False,8437107,Stetten am kalten Markt,65 - 75 Jahre,538,261,277
False,8437107,Stetten am kalten Markt,75 und mehr Jahre,514,200,314
False,8437107,Stetten am kalten Markt,Insgesamt,5091,2591,2500
False,8437114,"Veringenstadt, Stadt",unter 3 Jahre,60,30,30
False,8437114,"Veringenstadt, Stadt",3 -  6 Jahre,63,31,32
False,8437114,"Veringenstadt, Stadt",6 - 10 Jahre,76,43,33
False,8437114,"Veringenstadt, Stadt",10 - 15 Jahre,131,71,60
False,8437114,"Veringenstadt, Stadt",15 - 18 Jahre,83,49,34
False,8437114,"Veringenstadt, Stadt",18 - 20 Jahre,73,42,31
False,8437114,"Veringenstadt, Stadt",20 - 25 Jahre,122,64,58
False,8437114,"Veringenstadt, Stadt",25 - 30 Jahre,119,71,48
False,8437114,"Veringenstadt, Stadt",30 - 35 Jahre,103,51,52
False,8437114,"Veringenstadt, Stadt",35 - 40 Jahre,128,63,65
False,8437114,"Veringenstadt, Stadt",40 - 45 Jahre,170,86,84
False,8437114,"Veringenstadt, Stadt",45 - 50 Jahre,163,77,86
False,8437114,"Veringenstadt, Stadt",50 - 55 Jahre,186,93,93
False,8437114,"Veringenstadt, Stadt",55 - 60 Jahre,152,74,78
False,8437114,"Veringenstadt, Stadt",60 - 65 Jahre,151,77,74
False,8437114,"Veringenstadt, Stadt",65 - 75 Jahre,240,121,119
False,8437114,"Veringenstadt, Stadt",75 und mehr Jahre,207,77,130
False,8437114,"Veringenstadt, Stadt",Insgesamt,2227,1120,1107
False,8437118,Wald,unter 3 Jahre,60,34,26
False,8437118,Wald,3 -  6 Jahre,64,32,32
False,8437118,Wald,6 - 10 Jahre,125,63,62
False,8437118,Wald,10 - 15 Jahre,160,70,90
False,8437118,Wald,15 - 18 Jahre,96,45,51
False,8437118,Wald,18 - 20 Jahre,92,38,54
False,8437118,Wald,20 - 25 Jahre,154,85,69
False,8437118,Wald,25 - 30 Jahre,126,56,70
False,8437118,Wald,30 - 35 Jahre,174,68,106
False,8437118,Wald,35 - 40 Jahre,182,71,111
False,8437118,Wald,40 - 45 Jahre,294,113,181
False,8437118,Wald,45 - 50 Jahre,240,122,118
False,8437118,Wald,50 - 55 Jahre,205,106,99
False,8437118,Wald,55 - 60 Jahre,169,86,83
False,8437118,Wald,60 - 65 Jahre,125,65,60
False,8437118,Wald,65 - 75 Jahre,235,109,126
False,8437118,Wald,75 und mehr Jahre,227,74,153
False,8437118,Wald,Insgesamt,2728,1237,1491
False,8437123,Sauldorf,unter 3 Jahre,51,20,31
False,8437123,Sauldorf,3 -  6 Jahre,64,29,35
False,8437123,Sauldorf,6 - 10 Jahre,108,56,52
False,8437123,Sauldorf,10 - 15 Jahre,172,88,84
False,8437123,Sauldorf,15 - 18 Jahre,105,56,49
False,8437123,Sauldorf,18 - 20 Jahre,76,39,37
False,8437123,Sauldorf,20 - 25 Jahre,165,88,77
False,8437123,Sauldorf,25 - 30 Jahre,123,58,65
False,8437123,Sauldorf,30 - 35 Jahre,113,54,59
False,8437123,Sauldorf,35 - 40 Jahre,143,71,72
False,8437123,Sauldorf,40 - 45 Jahre,229,117,112
False,8437123,Sauldorf,45 - 50 Jahre,251,119,132
False,8437123,Sauldorf,50 - 55 Jahre,223,129,94
False,8437123,Sauldorf,55 - 60 Jahre,122,63,59
False,8437123,Sauldorf,60 - 65 Jahre,105,55,50
False,8437123,Sauldorf,65 - 75 Jahre,212,100,112
False,8437123,Sauldorf,75 und mehr Jahre,213,92,121
False,8437123,Sauldorf,Insgesamt,2475,1234,1241
False,8437124,Herdwangen-Schönach,unter 3 Jahre,85,41,44
False,8437124,Herdwangen-Schönach,3 -  6 Jahre,90,44,46
False,8437124,Herdwangen-Schönach,6 - 10 Jahre,102,57,45
False,8437124,Herdwangen-Schönach,10 - 15 Jahre,194,107,87
False,8437124,Herdwangen-Schönach,15 - 18 Jahre,126,65,61
False,8437124,Herdwangen-Schönach,18 - 20 Jahre,96,48,48
False,8437124,Herdwangen-Schönach,20 - 25 Jahre,213,113,100
False,8437124,Herdwangen-Schönach,25 - 30 Jahre,192,104,88
False,8437124,Herdwangen-Schönach,30 - 35 Jahre,174,84,90
False,8437124,Herdwangen-Schönach,35 - 40 Jahre,198,100,98
False,8437124,Herdwangen-Schönach,40 - 45 Jahre,276,127,149
False,8437124,Herdwangen-Schönach,45 - 50 Jahre,377,177,200
False,8437124,Herdwangen-Schönach,50 - 55 Jahre,320,180,140
False,8437124,Herdwangen-Schönach,55 - 60 Jahre,213,102,111
False,8437124,Herdwangen-Schönach,60 - 65 Jahre,185,100,85
False,8437124,Herdwangen-Schönach,65 - 75 Jahre,290,144,146
False,8437124,Herdwangen-Schönach,75 und mehr Jahre,196,85,111
False,8437124,Herdwangen-Schönach,Insgesamt,3327,1678,1649
