Anlagen,AGS,Ort,Alter von bis unter,Bevölkerung insgesamt,Bevölkerung männlich,Bevölkerung weiblich
False,8,Land Baden-Württemberg,unter 3 Jahre,290502,149450,141052
False,8,Land Baden-Württemberg,3 -  6 Jahre,312528,160139,152389
False,8,Land Baden-Württemberg,6 - 10 Jahre,458206,235498,222708
False,8,Land Baden-Württemberg,10 - 15 Jahre,595897,306068,289829
False,8,Land Baden-Württemberg,15 - 18 Jahre,382013,195473,186540
False,8,Land Baden-Württemberg,18 - 20 Jahre,248826,126785,122041
False,8,Land Baden-Württemberg,20 - 25 Jahre,636488,318634,317854
False,8,Land Baden-Württemberg,25 - 30 Jahre,642323,321751,320572
False,8,Land Baden-Württemberg,30 - 35 Jahre,678188,341293,336895
False,8,Land Baden-Württemberg,35 - 40 Jahre,892513,455905,436608
False,8,Land Baden-Württemberg,40 - 45 Jahre,942314,484592,457722
False,8,Land Baden-Württemberg,45 - 50 Jahre,820486,418508,401978
False,8,Land Baden-Württemberg,50 - 55 Jahre,697989,347889,350100
False,8,Land Baden-Württemberg,55 - 60 Jahre,611495,305064,306431
False,8,Land Baden-Württemberg,60 - 65 Jahre,572019,282976,289043
False,8,Land Baden-Württemberg,65 - 75 Jahre,1115629,529311,586318
False,8,Land Baden-Württemberg,75 und mehr Jahre,838285,291570,546715
False,8,Land Baden-Württemberg,Insgesamt,10735701,5270906,5464795
False,81,Regierungsbezirk Stuttgart,unter 3 Jahre,110897,56989,53908
False,81,Regierungsbezirk Stuttgart,3 -  6 Jahre,118204,60695,57509
False,81,Regierungsbezirk Stuttgart,6 - 10 Jahre,170950,87819,83131
False,81,Regierungsbezirk Stuttgart,10 - 15 Jahre,220925,113386,107539
False,81,Regierungsbezirk Stuttgart,15 - 18 Jahre,140275,71952,68323
False,81,Regierungsbezirk Stuttgart,18 - 20 Jahre,90984,46458,44526
False,81,Regierungsbezirk Stuttgart,20 - 25 Jahre,229430,115299,114131
False,81,Regierungsbezirk Stuttgart,25 - 30 Jahre,244426,122480,121946
False,81,Regierungsbezirk Stuttgart,30 - 35 Jahre,263804,134024,129780
False,81,Regierungsbezirk Stuttgart,35 - 40 Jahre,336683,173542,163141
False,81,Regierungsbezirk Stuttgart,40 - 45 Jahre,347360,180643,166717
False,81,Regierungsbezirk Stuttgart,45 - 50 Jahre,301300,154514,146786
False,81,Regierungsbezirk Stuttgart,50 - 55 Jahre,256136,127110,129026
False,81,Regierungsbezirk Stuttgart,55 - 60 Jahre,229975,114493,115482
False,81,Regierungsbezirk Stuttgart,60 - 65 Jahre,221334,109874,111460
False,81,Regierungsbezirk Stuttgart,65 - 75 Jahre,417982,199481,218501
False,81,Regierungsbezirk Stuttgart,75 und mehr Jahre,306708,107686,199022
False,81,Regierungsbezirk Stuttgart,Insgesamt,4007373,1976445,2030928
False,8111,Stadtkreis Stuttgart,unter 3 Jahre,15533,7972,7561
False,8111,Stadtkreis Stuttgart,3 -  6 Jahre,14874,7598,7276
False,8111,Stadtkreis Stuttgart,6 - 10 Jahre,19856,10239,9617
False,8111,Stadtkreis Stuttgart,10 - 15 Jahre,24373,12643,11730
False,8111,Stadtkreis Stuttgart,15 - 18 Jahre,15719,8065,7654
False,8111,Stadtkreis Stuttgart,18 - 20 Jahre,10850,5343,5507
False,8111,Stadtkreis Stuttgart,20 - 25 Jahre,37158,17854,19304
False,8111,Stadtkreis Stuttgart,25 - 30 Jahre,46986,23219,23767
False,8111,Stadtkreis Stuttgart,30 - 35 Jahre,48387,25321,23066
False,8111,Stadtkreis Stuttgart,35 - 40 Jahre,53245,28321,24924
False,8111,Stadtkreis Stuttgart,40 - 45 Jahre,51212,27814,23398
False,8111,Stadtkreis Stuttgart,45 - 50 Jahre,42264,22171,20093
False,8111,Stadtkreis Stuttgart,50 - 55 Jahre,35656,17718,17938
False,8111,Stadtkreis Stuttgart,55 - 60 Jahre,34441,17217,17224
False,8111,Stadtkreis Stuttgart,60 - 65 Jahre,34046,16863,17183
False,8111,Stadtkreis Stuttgart,65 - 75 Jahre,60070,28359,31711
False,8111,Stadtkreis Stuttgart,75 und mehr Jahre,47899,15601,32298
False,8111,Stadtkreis Stuttgart,Insgesamt,592569,292318,300251
False,8111000,"Stuttgart, Landeshauptstadt",unter 3 Jahre,15533,7972,7561
False,8111000,"Stuttgart, Landeshauptstadt",3 -  6 Jahre,14874,7598,7276
False,8111000,"Stuttgart, Landeshauptstadt",6 - 10 Jahre,19856,10239,9617
False,8111000,"Stuttgart, Landeshauptstadt",10 - 15 Jahre,24373,12643,11730
False,8111000,"Stuttgart, Landeshauptstadt",15 - 18 Jahre,15719,8065,7654
False,8111000,"Stuttgart, Landeshauptstadt",18 - 20 Jahre,10850,5343,5507
False,8111000,"Stuttgart, Landeshauptstadt",20 - 25 Jahre,37158,17854,19304
False,8111000,"Stuttgart, Landeshauptstadt",25 - 30 Jahre,46986,23219,23767
False,8111000,"Stuttgart, Landeshauptstadt",30 - 35 Jahre,48387,25321,23066
False,8111000,"Stuttgart, Landeshauptstadt",35 - 40 Jahre,53245,28321,24924
False,8111000,"Stuttgart, Landeshauptstadt",40 - 45 Jahre,51212,27814,23398
False,8111000,"Stuttgart, Landeshauptstadt",45 - 50 Jahre,42264,22171,20093
False,8111000,"Stuttgart, Landeshauptstadt",50 - 55 Jahre,35656,17718,17938
False,8111000,"Stuttgart, Landeshauptstadt",55 - 60 Jahre,34441,17217,17224
False,8111000,"Stuttgart, Landeshauptstadt",60 - 65 Jahre,34046,16863,17183
False,8111000,"Stuttgart, Landeshauptstadt",65 - 75 Jahre,60070,28359,31711
False,8111000,"Stuttgart, Landeshauptstadt",75 und mehr Jahre,47899,15601,32298
False,8111000,"Stuttgart, Landeshauptstadt",Insgesamt,592569,292318,300251
False,8115,Landkreis Böblingen,unter 3 Jahre,10674,5561,5113
False,8115,Landkreis Böblingen,3 -  6 Jahre,11514,5935,5579
False,8115,Landkreis Böblingen,6 - 10 Jahre,16617,8522,8095
False,8115,Landkreis Böblingen,10 - 15 Jahre,20968,10729,10239
False,8115,Landkreis Böblingen,15 - 18 Jahre,13067,6736,6331
False,8115,Landkreis Böblingen,18 - 20 Jahre,8330,4175,4155
False,8115,Landkreis Böblingen,20 - 25 Jahre,20716,10306,10410
False,8115,Landkreis Böblingen,25 - 30 Jahre,22454,11318,11136
False,8115,Landkreis Böblingen,30 - 35 Jahre,24370,12267,12103
False,8115,Landkreis Böblingen,35 - 40 Jahre,32160,16597,15563
False,8115,Landkreis Böblingen,40 - 45 Jahre,32599,16747,15852
False,8115,Landkreis Böblingen,45 - 50 Jahre,28351,14382,13969
False,8115,Landkreis Böblingen,50 - 55 Jahre,23790,11739,12051
False,8115,Landkreis Böblingen,55 - 60 Jahre,21147,10363,10784
False,8115,Landkreis Böblingen,60 - 65 Jahre,21829,10956,10873
False,8115,Landkreis Böblingen,65 - 75 Jahre,38661,18771,19890
False,8115,Landkreis Böblingen,75 und mehr Jahre,24908,9083,15825
False,8115,Landkreis Böblingen,Insgesamt,372155,184187,187968
False,8115001,Aidlingen,unter 3 Jahre,257,146,111
False,8115001,Aidlingen,3 -  6 Jahre,311,173,138
False,8115001,Aidlingen,6 - 10 Jahre,427,225,202
False,8115001,Aidlingen,10 - 15 Jahre,553,286,267
False,8115001,Aidlingen,15 - 18 Jahre,309,154,155
False,8115001,Aidlingen,18 - 20 Jahre,188,87,101
False,8115001,Aidlingen,20 - 25 Jahre,514,237,277
False,8115001,Aidlingen,25 - 30 Jahre,505,258,247
False,8115001,Aidlingen,30 - 35 Jahre,635,287,348
False,8115001,Aidlingen,35 - 40 Jahre,879,400,479
False,8115001,Aidlingen,40 - 45 Jahre,942,484,458
False,8115001,Aidlingen,45 - 50 Jahre,663,341,322
False,8115001,Aidlingen,50 - 55 Jahre,555,272,283
False,8115001,Aidlingen,55 - 60 Jahre,544,249,295
False,8115001,Aidlingen,60 - 65 Jahre,517,258,259
False,8115001,Aidlingen,65 - 75 Jahre,902,458,444
False,8115001,Aidlingen,75 und mehr Jahre,541,220,321
False,8115001,Aidlingen,Insgesamt,9242,4535,4707
False,8115002,Altdorf,unter 3 Jahre,162,96,66
False,8115002,Altdorf,3 -  6 Jahre,196,101,95
False,8115002,Altdorf,6 - 10 Jahre,297,146,151
False,8115002,Altdorf,10 - 15 Jahre,322,166,156
False,8115002,Altdorf,15 - 18 Jahre,171,82,89
False,8115002,Altdorf,18 - 20 Jahre,83,39,44
False,8115002,Altdorf,20 - 25 Jahre,228,111,117
False,8115002,Altdorf,25 - 30 Jahre,235,118,117
False,8115002,Altdorf,30 - 35 Jahre,286,125,161
False,8115002,Altdorf,35 - 40 Jahre,526,260,266
False,8115002,Altdorf,40 - 45 Jahre,435,231,204
False,8115002,Altdorf,45 - 50 Jahre,344,165,179
False,8115002,Altdorf,50 - 55 Jahre,249,130,119
False,8115002,Altdorf,55 - 60 Jahre,181,85,96
False,8115002,Altdorf,60 - 65 Jahre,207,98,109
False,8115002,Altdorf,65 - 75 Jahre,380,182,198
False,8115002,Altdorf,75 und mehr Jahre,181,70,111
False,8115002,Altdorf,Insgesamt,4483,2205,2278
False,8115003,"Böblingen, Stadt",unter 3 Jahre,1232,621,611
False,8115003,"Böblingen, Stadt",3 -  6 Jahre,1325,660,665
False,8115003,"Böblingen, Stadt",6 - 10 Jahre,1737,861,876
False,8115003,"Böblingen, Stadt",10 - 15 Jahre,2216,1166,1050
False,8115003,"Böblingen, Stadt",15 - 18 Jahre,1430,737,693
False,8115003,"Böblingen, Stadt",18 - 20 Jahre,926,452,474
False,8115003,"Böblingen, Stadt",20 - 25 Jahre,2582,1267,1315
False,8115003,"Böblingen, Stadt",25 - 30 Jahre,3223,1624,1599
False,8115003,"Böblingen, Stadt",30 - 35 Jahre,3238,1696,1542
False,8115003,"Böblingen, Stadt",35 - 40 Jahre,3707,2028,1679
False,8115003,"Böblingen, Stadt",40 - 45 Jahre,3636,1930,1706
False,8115003,"Böblingen, Stadt",45 - 50 Jahre,3363,1713,1650
False,8115003,"Böblingen, Stadt",50 - 55 Jahre,2946,1402,1544
False,8115003,"Böblingen, Stadt",55 - 60 Jahre,2855,1381,1474
False,8115003,"Böblingen, Stadt",60 - 65 Jahre,2942,1455,1487
False,8115003,"Böblingen, Stadt",65 - 75 Jahre,5390,2519,2871
False,8115003,"Böblingen, Stadt",75 und mehr Jahre,3633,1320,2313
False,8115003,"Böblingen, Stadt",Insgesamt,46381,22832,23549
False,8115004,Bondorf,unter 3 Jahre,192,107,85
False,8115004,Bondorf,3 -  6 Jahre,269,137,132
False,8115004,Bondorf,6 - 10 Jahre,337,177,160
False,8115004,Bondorf,10 - 15 Jahre,434,207,227
False,8115004,Bondorf,15 - 18 Jahre,232,127,105
False,8115004,Bondorf,18 - 20 Jahre,128,67,61
False,8115004,Bondorf,20 - 25 Jahre,312,159,153
False,8115004,Bondorf,25 - 30 Jahre,328,165,163
False,8115004,Bondorf,30 - 35 Jahre,412,206,206
False,8115004,Bondorf,35 - 40 Jahre,546,267,279
False,8115004,Bondorf,40 - 45 Jahre,579,283,296
False,8115004,Bondorf,45 - 50 Jahre,464,246,218
False,8115004,Bondorf,50 - 55 Jahre,372,198,174
False,8115004,Bondorf,55 - 60 Jahre,255,123,132
False,8115004,Bondorf,60 - 65 Jahre,241,127,114
False,8115004,Bondorf,65 - 75 Jahre,419,198,221
False,8115004,Bondorf,75 und mehr Jahre,325,109,216
False,8115004,Bondorf,Insgesamt,5845,2903,2942
False,8115010,Deckenpfronn,unter 3 Jahre,63,24,39
False,8115010,Deckenpfronn,3 -  6 Jahre,104,57,47
False,8115010,Deckenpfronn,6 - 10 Jahre,168,71,97
False,8115010,Deckenpfronn,10 - 15 Jahre,203,95,108
False,8115010,Deckenpfronn,15 - 18 Jahre,116,59,57
False,8115010,Deckenpfronn,18 - 20 Jahre,62,30,32
False,8115010,Deckenpfronn,20 - 25 Jahre,176,78,98
False,8115010,Deckenpfronn,25 - 30 Jahre,162,81,81
False,8115010,Deckenpfronn,30 - 35 Jahre,204,111,93
False,8115010,Deckenpfronn,35 - 40 Jahre,289,156,133
False,8115010,Deckenpfronn,40 - 45 Jahre,325,167,158
False,8115010,Deckenpfronn,45 - 50 Jahre,216,108,108
False,8115010,Deckenpfronn,50 - 55 Jahre,175,92,83
False,8115010,Deckenpfronn,55 - 60 Jahre,151,77,74
False,8115010,Deckenpfronn,60 - 65 Jahre,128,69,59
False,8115010,Deckenpfronn,65 - 75 Jahre,232,106,126
False,8115010,Deckenpfronn,75 und mehr Jahre,155,59,96
False,8115010,Deckenpfronn,Insgesamt,2929,1440,1489
False,8115013,Ehningen,unter 3 Jahre,234,128,106
False,8115013,Ehningen,3 -  6 Jahre,226,112,114
False,8115013,Ehningen,6 - 10 Jahre,363,186,177
False,8115013,Ehningen,10 - 15 Jahre,424,220,204
False,8115013,Ehningen,15 - 18 Jahre,252,140,112
False,8115013,Ehningen,18 - 20 Jahre,184,97,87
False,8115013,Ehningen,20 - 25 Jahre,459,242,217
False,8115013,Ehningen,25 - 30 Jahre,462,242,220
False,8115013,Ehningen,30 - 35 Jahre,502,259,243
False,8115013,Ehningen,35 - 40 Jahre,697,352,345
False,8115013,Ehningen,40 - 45 Jahre,713,354,359
False,8115013,Ehningen,45 - 50 Jahre,572,295,277
False,8115013,Ehningen,50 - 55 Jahre,482,242,240
False,8115013,Ehningen,55 - 60 Jahre,423,207,216
False,8115013,Ehningen,60 - 65 Jahre,464,219,245
False,8115013,Ehningen,65 - 75 Jahre,749,360,389
False,8115013,Ehningen,75 und mehr Jahre,431,169,262
False,8115013,Ehningen,Insgesamt,7637,3824,3813
False,8115015,Gärtringen,unter 3 Jahre,413,207,206
False,8115015,Gärtringen,3 -  6 Jahre,386,196,190
False,8115015,Gärtringen,6 - 10 Jahre,498,244,254
False,8115015,Gärtringen,10 - 15 Jahre,645,317,328
False,8115015,Gärtringen,15 - 18 Jahre,408,214,194
False,8115015,Gärtringen,18 - 20 Jahre,283,142,141
False,8115015,Gärtringen,20 - 25 Jahre,669,344,325
False,8115015,Gärtringen,25 - 30 Jahre,708,346,362
False,8115015,Gärtringen,30 - 35 Jahre,841,392,449
False,8115015,Gärtringen,35 - 40 Jahre,1149,578,571
False,8115015,Gärtringen,40 - 45 Jahre,1077,547,530
False,8115015,Gärtringen,45 - 50 Jahre,880,437,443
False,8115015,Gärtringen,50 - 55 Jahre,784,403,381
False,8115015,Gärtringen,55 - 60 Jahre,650,314,336
False,8115015,Gärtringen,60 - 65 Jahre,733,369,364
False,8115015,Gärtringen,65 - 75 Jahre,1131,583,548
False,8115015,Gärtringen,75 und mehr Jahre,694,235,459
False,8115015,Gärtringen,Insgesamt,11949,5868,6081
False,8115016,Gäufelden,unter 3 Jahre,303,172,131
False,8115016,Gäufelden,3 -  6 Jahre,302,149,153
False,8115016,Gäufelden,6 - 10 Jahre,522,256,266
False,8115016,Gäufelden,10 - 15 Jahre,645,317,328
False,8115016,Gäufelden,15 - 18 Jahre,406,192,214
False,8115016,Gäufelden,18 - 20 Jahre,267,151,116
False,8115016,Gäufelden,20 - 25 Jahre,573,291,282
False,8115016,Gäufelden,25 - 30 Jahre,561,269,292
False,8115016,Gäufelden,30 - 35 Jahre,633,310,323
False,8115016,Gäufelden,35 - 40 Jahre,859,472,387
False,8115016,Gäufelden,40 - 45 Jahre,889,453,436
False,8115016,Gäufelden,45 - 50 Jahre,787,408,379
False,8115016,Gäufelden,50 - 55 Jahre,585,298,287
False,8115016,Gäufelden,55 - 60 Jahre,477,234,243
False,8115016,Gäufelden,60 - 65 Jahre,444,231,213
False,8115016,Gäufelden,65 - 75 Jahre,736,366,370
False,8115016,Gäufelden,75 und mehr Jahre,370,144,226
False,8115016,Gäufelden,Insgesamt,9359,4713,4646
False,8115021,"Herrenberg, Stadt",unter 3 Jahre,938,495,443
False,8115021,"Herrenberg, Stadt",3 -  6 Jahre,965,522,443
False,8115021,"Herrenberg, Stadt",6 - 10 Jahre,1443,758,685
False,8115021,"Herrenberg, Stadt",10 - 15 Jahre,1831,945,886
False,8115021,"Herrenberg, Stadt",15 - 18 Jahre,1120,606,514
False,8115021,"Herrenberg, Stadt",18 - 20 Jahre,671,316,355
False,8115021,"Herrenberg, Stadt",20 - 25 Jahre,1860,973,887
False,8115021,"Herrenberg, Stadt",25 - 30 Jahre,1964,953,1011
False,8115021,"Herrenberg, Stadt",30 - 35 Jahre,2085,1067,1018
False,8115021,"Herrenberg, Stadt",35 - 40 Jahre,2680,1385,1295
False,8115021,"Herrenberg, Stadt",40 - 45 Jahre,2651,1362,1289
False,8115021,"Herrenberg, Stadt",45 - 50 Jahre,2357,1140,1217
False,8115021,"Herrenberg, Stadt",50 - 55 Jahre,1960,1001,959
False,8115021,"Herrenberg, Stadt",55 - 60 Jahre,1633,795,838
False,8115021,"Herrenberg, Stadt",60 - 65 Jahre,1751,861,890
False,8115021,"Herrenberg, Stadt",65 - 75 Jahre,3268,1577,1691
False,8115021,"Herrenberg, Stadt",75 und mehr Jahre,2078,743,1335
False,8115021,"Herrenberg, Stadt",Insgesamt,31255,15499,15756
False,8115022,Hildrizhausen,unter 3 Jahre,125,71,54
False,8115022,Hildrizhausen,3 -  6 Jahre,131,73,58
False,8115022,Hildrizhausen,6 - 10 Jahre,187,93,94
False,8115022,Hildrizhausen,10 - 15 Jahre,227,131,96
False,8115022,Hildrizhausen,15 - 18 Jahre,135,78,57
False,8115022,Hildrizhausen,18 - 20 Jahre,69,34,35
False,8115022,Hildrizhausen,20 - 25 Jahre,169,92,77
False,8115022,Hildrizhausen,25 - 30 Jahre,217,92,125
False,8115022,Hildrizhausen,30 - 35 Jahre,271,134,137
False,8115022,Hildrizhausen,35 - 40 Jahre,355,187,168
False,8115022,Hildrizhausen,40 - 45 Jahre,363,181,182
False,8115022,Hildrizhausen,45 - 50 Jahre,280,155,125
False,8115022,Hildrizhausen,50 - 55 Jahre,229,112,117
False,8115022,Hildrizhausen,55 - 60 Jahre,189,93,96
False,8115022,Hildrizhausen,60 - 65 Jahre,212,112,100
False,8115022,Hildrizhausen,65 - 75 Jahre,311,161,150
False,8115022,Hildrizhausen,75 und mehr Jahre,157,68,89
False,8115022,Hildrizhausen,Insgesamt,3627,1867,1760
False,8115024,"Holzgerlingen, Stadt",unter 3 Jahre,371,206,165
False,8115024,"Holzgerlingen, Stadt",3 -  6 Jahre,382,199,183
False,8115024,"Holzgerlingen, Stadt",6 - 10 Jahre,560,282,278
False,8115024,"Holzgerlingen, Stadt",10 - 15 Jahre,693,388,305
False,8115024,"Holzgerlingen, Stadt",15 - 18 Jahre,440,228,212
False,8115024,"Holzgerlingen, Stadt",18 - 20 Jahre,264,132,132
False,8115024,"Holzgerlingen, Stadt",20 - 25 Jahre,614,300,314
False,8115024,"Holzgerlingen, Stadt",25 - 30 Jahre,627,304,323
False,8115024,"Holzgerlingen, Stadt",30 - 35 Jahre,876,432,444
False,8115024,"Holzgerlingen, Stadt",35 - 40 Jahre,1117,558,559
False,8115024,"Holzgerlingen, Stadt",40 - 45 Jahre,1123,554,569
False,8115024,"Holzgerlingen, Stadt",45 - 50 Jahre,938,503,435
False,8115024,"Holzgerlingen, Stadt",50 - 55 Jahre,683,338,345
False,8115024,"Holzgerlingen, Stadt",55 - 60 Jahre,640,297,343
False,8115024,"Holzgerlingen, Stadt",60 - 65 Jahre,681,344,337
False,8115024,"Holzgerlingen, Stadt",65 - 75 Jahre,1174,584,590
False,8115024,"Holzgerlingen, Stadt",75 und mehr Jahre,723,290,433
False,8115024,"Holzgerlingen, Stadt",Insgesamt,11906,5939,5967
False,8115028,"Leonberg, Stadt",unter 3 Jahre,1224,615,609
False,8115028,"Leonberg, Stadt",3 -  6 Jahre,1310,664,646
False,8115028,"Leonberg, Stadt",6 - 10 Jahre,1795,925,870
False,8115028,"Leonberg, Stadt",10 - 15 Jahre,2281,1163,1118
False,8115028,"Leonberg, Stadt",15 - 18 Jahre,1336,690,646
False,8115028,"Leonberg, Stadt",18 - 20 Jahre,952,496,456
False,8115028,"Leonberg, Stadt",20 - 25 Jahre,2396,1186,1210
False,8115028,"Leonberg, Stadt",25 - 30 Jahre,2862,1477,1385
False,8115028,"Leonberg, Stadt",30 - 35 Jahre,2923,1512,1411
False,8115028,"Leonberg, Stadt",35 - 40 Jahre,3925,2067,1858
False,8115028,"Leonberg, Stadt",40 - 45 Jahre,3762,1957,1805
False,8115028,"Leonberg, Stadt",45 - 50 Jahre,3344,1667,1677
False,8115028,"Leonberg, Stadt",50 - 55 Jahre,2923,1428,1495
False,8115028,"Leonberg, Stadt",55 - 60 Jahre,2825,1371,1454
False,8115028,"Leonberg, Stadt",60 - 65 Jahre,3034,1462,1572
False,8115028,"Leonberg, Stadt",65 - 75 Jahre,5007,2421,2586
False,8115028,"Leonberg, Stadt",75 und mehr Jahre,3725,1279,2446
False,8115028,"Leonberg, Stadt",Insgesamt,45624,22380,23244
False,8115029,Magstadt,unter 3 Jahre,283,156,127
False,8115029,Magstadt,3 -  6 Jahre,266,154,112
False,8115029,Magstadt,6 - 10 Jahre,335,156,179
False,8115029,Magstadt,10 - 15 Jahre,473,233,240
False,8115029,Magstadt,15 - 18 Jahre,321,168,153
False,8115029,Magstadt,18 - 20 Jahre,185,80,105
False,8115029,Magstadt,20 - 25 Jahre,527,256,271
False,8115029,Magstadt,25 - 30 Jahre,601,324,277
False,8115029,Magstadt,30 - 35 Jahre,625,341,284
False,8115029,Magstadt,35 - 40 Jahre,810,438,372
False,8115029,Magstadt,40 - 45 Jahre,816,441,375
False,8115029,Magstadt,45 - 50 Jahre,664,348,316
False,8115029,Magstadt,50 - 55 Jahre,604,290,314
False,8115029,Magstadt,55 - 60 Jahre,505,265,240
False,8115029,Magstadt,60 - 65 Jahre,518,265,253
False,8115029,Magstadt,65 - 75 Jahre,844,408,436
False,8115029,Magstadt,75 und mehr Jahre,553,194,359
False,8115029,Magstadt,Insgesamt,8930,4517,4413
False,8115034,Mötzingen,unter 3 Jahre,96,44,52
False,8115034,Mötzingen,3 -  6 Jahre,147,72,75
False,8115034,Mötzingen,6 - 10 Jahre,192,102,90
False,8115034,Mötzingen,10 - 15 Jahre,271,138,133
False,8115034,Mötzingen,15 - 18 Jahre,165,78,87
False,8115034,Mötzingen,18 - 20 Jahre,99,46,53
False,8115034,Mötzingen,20 - 25 Jahre,240,122,118
False,8115034,Mötzingen,25 - 30 Jahre,161,101,60
False,8115034,Mötzingen,30 - 35 Jahre,192,82,110
False,8115034,Mötzingen,35 - 40 Jahre,321,157,164
False,8115034,Mötzingen,40 - 45 Jahre,345,174,171
False,8115034,Mötzingen,45 - 50 Jahre,316,156,160
False,8115034,Mötzingen,50 - 55 Jahre,219,117,102
False,8115034,Mötzingen,55 - 60 Jahre,190,91,99
False,8115034,Mötzingen,60 - 65 Jahre,142,78,64
False,8115034,Mötzingen,65 - 75 Jahre,309,146,163
False,8115034,Mötzingen,75 und mehr Jahre,159,57,102
False,8115034,Mötzingen,Insgesamt,3564,1761,1803
False,8115037,Nufringen,unter 3 Jahre,216,115,101
False,8115037,Nufringen,3 -  6 Jahre,183,91,92
False,8115037,Nufringen,6 - 10 Jahre,269,145,124
False,8115037,Nufringen,10 - 15 Jahre,302,142,160
False,8115037,Nufringen,15 - 18 Jahre,198,115,83
False,8115037,Nufringen,18 - 20 Jahre,104,55,49
False,8115037,Nufringen,20 - 25 Jahre,324,172,152
False,8115037,Nufringen,25 - 30 Jahre,320,155,165
False,8115037,Nufringen,30 - 35 Jahre,378,186,192
False,8115037,Nufringen,35 - 40 Jahre,486,240,246
False,8115037,Nufringen,40 - 45 Jahre,518,268,250
False,8115037,Nufringen,45 - 50 Jahre,391,193,198
False,8115037,Nufringen,50 - 55 Jahre,329,158,171
False,8115037,Nufringen,55 - 60 Jahre,262,135,127
False,8115037,Nufringen,60 - 65 Jahre,256,142,114
False,8115037,Nufringen,65 - 75 Jahre,492,236,256
False,8115037,Nufringen,75 und mehr Jahre,297,127,170
False,8115037,Nufringen,Insgesamt,5325,2675,2650
False,8115041,"Renningen, Stadt",unter 3 Jahre,477,238,239
False,8115041,"Renningen, Stadt",3 -  6 Jahre,533,271,262
False,8115041,"Renningen, Stadt",6 - 10 Jahre,823,453,370
False,8115041,"Renningen, Stadt",10 - 15 Jahre,1016,518,498
False,8115041,"Renningen, Stadt",15 - 18 Jahre,623,315,308
False,8115041,"Renningen, Stadt",18 - 20 Jahre,434,205,229
False,8115041,"Renningen, Stadt",20 - 25 Jahre,957,471,486
False,8115041,"Renningen, Stadt",25 - 30 Jahre,959,456,503
False,8115041,"Renningen, Stadt",30 - 35 Jahre,1130,578,552
False,8115041,"Renningen, Stadt",35 - 40 Jahre,1578,802,776
False,8115041,"Renningen, Stadt",40 - 45 Jahre,1585,797,788
False,8115041,"Renningen, Stadt",45 - 50 Jahre,1410,663,747
False,8115041,"Renningen, Stadt",50 - 55 Jahre,1118,541,577
False,8115041,"Renningen, Stadt",55 - 60 Jahre,932,470,462
False,8115041,"Renningen, Stadt",60 - 65 Jahre,950,483,467
False,8115041,"Renningen, Stadt",65 - 75 Jahre,1703,826,877
False,8115041,"Renningen, Stadt",75 und mehr Jahre,1007,370,637
False,8115041,"Renningen, Stadt",Insgesamt,17235,8457,8778
False,8115042,"Rutesheim, Stadt",unter 3 Jahre,265,143,122
False,8115042,"Rutesheim, Stadt",3 -  6 Jahre,314,173,141
False,8115042,"Rutesheim, Stadt",6 - 10 Jahre,489,248,241
False,8115042,"Rutesheim, Stadt",10 - 15 Jahre,604,303,301
False,8115042,"Rutesheim, Stadt",15 - 18 Jahre,389,191,198
False,8115042,"Rutesheim, Stadt",18 - 20 Jahre,237,121,116
False,8115042,"Rutesheim, Stadt",20 - 25 Jahre,529,259,270
False,8115042,"Rutesheim, Stadt",25 - 30 Jahre,544,291,253
False,8115042,"Rutesheim, Stadt",30 - 35 Jahre,594,317,277
False,8115042,"Rutesheim, Stadt",35 - 40 Jahre,909,435,474
False,8115042,"Rutesheim, Stadt",40 - 45 Jahre,969,483,486
False,8115042,"Rutesheim, Stadt",45 - 50 Jahre,820,422,398
False,8115042,"Rutesheim, Stadt",50 - 55 Jahre,632,309,323
False,8115042,"Rutesheim, Stadt",55 - 60 Jahre,605,312,293
False,8115042,"Rutesheim, Stadt",60 - 65 Jahre,533,265,268
False,8115042,"Rutesheim, Stadt",65 - 75 Jahre,1057,498,559
False,8115042,"Rutesheim, Stadt",75 und mehr Jahre,655,266,389
False,8115042,"Rutesheim, Stadt",Insgesamt,10145,5036,5109
False,8115044,Schönaich,unter 3 Jahre,263,142,121
False,8115044,Schönaich,3 -  6 Jahre,291,153,138
False,8115044,Schönaich,6 - 10 Jahre,466,241,225
False,8115044,Schönaich,10 - 15 Jahre,514,255,259
False,8115044,Schönaich,15 - 18 Jahre,338,191,147
False,8115044,Schönaich,18 - 20 Jahre,240,122,118
False,8115044,Schönaich,20 - 25 Jahre,543,267,276
False,8115044,Schönaich,25 - 30 Jahre,564,269,295
False,8115044,Schönaich,30 - 35 Jahre,572,301,271
False,8115044,Schönaich,35 - 40 Jahre,857,404,453
False,8115044,Schönaich,40 - 45 Jahre,899,471,428
False,8115044,Schönaich,45 - 50 Jahre,736,400,336
False,8115044,Schönaich,50 - 55 Jahre,674,322,352
False,8115044,Schönaich,55 - 60 Jahre,587,285,302
False,8115044,Schönaich,60 - 65 Jahre,648,307,341
False,8115044,Schönaich,65 - 75 Jahre,1157,574,583
False,8115044,Schönaich,75 und mehr Jahre,644,250,394
False,8115044,Schönaich,Insgesamt,9993,4954,5039
False,8115045,"Sindelfingen, Stadt",unter 3 Jahre,1694,866,828
False,8115045,"Sindelfingen, Stadt",3 -  6 Jahre,1794,927,867
False,8115045,"Sindelfingen, Stadt",6 - 10 Jahre,2471,1271,1200
False,8115045,"Sindelfingen, Stadt",10 - 15 Jahre,3186,1599,1587
False,8115045,"Sindelfingen, Stadt",15 - 18 Jahre,2090,1041,1049
False,8115045,"Sindelfingen, Stadt",18 - 20 Jahre,1364,677,687
False,8115045,"Sindelfingen, Stadt",20 - 25 Jahre,3590,1797,1793
False,8115045,"Sindelfingen, Stadt",25 - 30 Jahre,3809,1971,1838
False,8115045,"Sindelfingen, Stadt",30 - 35 Jahre,4040,2045,1995
False,8115045,"Sindelfingen, Stadt",35 - 40 Jahre,4774,2497,2277
False,8115045,"Sindelfingen, Stadt",40 - 45 Jahre,4862,2529,2333
False,8115045,"Sindelfingen, Stadt",45 - 50 Jahre,4487,2238,2249
False,8115045,"Sindelfingen, Stadt",50 - 55 Jahre,3791,1894,1897
False,8115045,"Sindelfingen, Stadt",55 - 60 Jahre,3617,1749,1868
False,8115045,"Sindelfingen, Stadt",60 - 65 Jahre,3737,1892,1845
False,8115045,"Sindelfingen, Stadt",65 - 75 Jahre,6978,3451,3527
False,8115045,"Sindelfingen, Stadt",75 und mehr Jahre,4559,1648,2911
False,8115045,"Sindelfingen, Stadt",Insgesamt,60843,30092,30751
False,8115046,Steinenbronn,unter 3 Jahre,173,93,80
False,8115046,Steinenbronn,3 -  6 Jahre,194,115,79
False,8115046,Steinenbronn,6 - 10 Jahre,282,146,136
False,8115046,Steinenbronn,10 - 15 Jahre,399,213,186
False,8115046,Steinenbronn,15 - 18 Jahre,243,137,106
False,8115046,Steinenbronn,18 - 20 Jahre,156,79,77
False,8115046,Steinenbronn,20 - 25 Jahre,349,173,176
False,8115046,Steinenbronn,25 - 30 Jahre,386,186,200
False,8115046,Steinenbronn,30 - 35 Jahre,360,165,195
False,8115046,Steinenbronn,35 - 40 Jahre,485,241,244
False,8115046,Steinenbronn,40 - 45 Jahre,603,315,288
False,8115046,Steinenbronn,45 - 50 Jahre,522,281,241
False,8115046,Steinenbronn,50 - 55 Jahre,412,224,188
False,8115046,Steinenbronn,55 - 60 Jahre,311,149,162
False,8115046,Steinenbronn,60 - 65 Jahre,303,157,146
False,8115046,Steinenbronn,65 - 75 Jahre,582,272,310
False,8115046,Steinenbronn,75 und mehr Jahre,349,125,224
False,8115046,Steinenbronn,Insgesamt,6109,3071,3038
False,8115048,"Waldenbuch, Stadt",unter 3 Jahre,243,126,117
False,8115048,"Waldenbuch, Stadt",3 -  6 Jahre,275,131,144
False,8115048,"Waldenbuch, Stadt",6 - 10 Jahre,398,225,173
False,8115048,"Waldenbuch, Stadt",10 - 15 Jahre,506,266,240
False,8115048,"Waldenbuch, Stadt",15 - 18 Jahre,288,150,138
False,8115048,"Waldenbuch, Stadt",18 - 20 Jahre,198,100,98
False,8115048,"Waldenbuch, Stadt",20 - 25 Jahre,445,197,248
False,8115048,"Waldenbuch, Stadt",25 - 30 Jahre,503,238,265
False,8115048,"Waldenbuch, Stadt",30 - 35 Jahre,503,251,252
False,8115048,"Waldenbuch, Stadt",35 - 40 Jahre,720,367,353
False,8115048,"Waldenbuch, Stadt",40 - 45 Jahre,761,366,395
False,8115048,"Waldenbuch, Stadt",45 - 50 Jahre,724,382,342
False,8115048,"Waldenbuch, Stadt",50 - 55 Jahre,646,297,349
False,8115048,"Waldenbuch, Stadt",55 - 60 Jahre,537,279,258
False,8115048,"Waldenbuch, Stadt",60 - 65 Jahre,506,257,249
False,8115048,"Waldenbuch, Stadt",65 - 75 Jahre,826,388,438
False,8115048,"Waldenbuch, Stadt",75 und mehr Jahre,572,200,372
False,8115048,"Waldenbuch, Stadt",Insgesamt,8651,4220,4431
False,8115050,"Weil der Stadt, Stadt",unter 3 Jahre,517,277,240
False,8115050,"Weil der Stadt, Stadt",3 -  6 Jahre,536,269,267
False,8115050,"Weil der Stadt, Stadt",6 - 10 Jahre,838,435,403
False,8115050,"Weil der Stadt, Stadt",10 - 15 Jahre,1185,614,571
False,8115050,"Weil der Stadt, Stadt",15 - 18 Jahre,779,395,384
False,8115050,"Weil der Stadt, Stadt",18 - 20 Jahre,499,256,243
False,8115050,"Weil der Stadt, Stadt",20 - 25 Jahre,1034,507,527
False,8115050,"Weil der Stadt, Stadt",25 - 30 Jahre,1061,539,522
False,8115050,"Weil der Stadt, Stadt",30 - 35 Jahre,1111,550,561
False,8115050,"Weil der Stadt, Stadt",35 - 40 Jahre,1595,836,759
False,8115050,"Weil der Stadt, Stadt",40 - 45 Jahre,1666,863,803
False,8115050,"Weil der Stadt, Stadt",45 - 50 Jahre,1527,784,743
False,8115050,"Weil der Stadt, Stadt",50 - 55 Jahre,1321,637,684
False,8115050,"Weil der Stadt, Stadt",55 - 60 Jahre,1067,536,531
False,8115050,"Weil der Stadt, Stadt",60 - 65 Jahre,1085,573,512
False,8115050,"Weil der Stadt, Stadt",65 - 75 Jahre,2025,974,1051
False,8115050,"Weil der Stadt, Stadt",75 und mehr Jahre,1267,453,814
False,8115050,"Weil der Stadt, Stadt",Insgesamt,19113,9498,9615
False,8115051,Weil im Schönbuch,unter 3 Jahre,319,162,157
False,8115051,Weil im Schönbuch,3 -  6 Jahre,385,188,197
False,8115051,Weil im Schönbuch,6 - 10 Jahre,555,286,269
False,8115051,Weil im Schönbuch,10 - 15 Jahre,579,289,290
False,8115051,Weil im Schönbuch,15 - 18 Jahre,348,191,157
False,8115051,Weil im Schönbuch,18 - 20 Jahre,221,120,101
False,8115051,Weil im Schönbuch,20 - 25 Jahre,469,232,237
False,8115051,Weil im Schönbuch,25 - 30 Jahre,526,263,263
False,8115051,Weil im Schönbuch,30 - 35 Jahre,594,246,348
False,8115051,Weil im Schönbuch,35 - 40 Jahre,994,536,458
False,8115051,Weil im Schönbuch,40 - 45 Jahre,986,498,488
False,8115051,Weil im Schönbuch,45 - 50 Jahre,800,428,372
False,8115051,Weil im Schönbuch,50 - 55 Jahre,598,279,319
False,8115051,Weil im Schönbuch,55 - 60 Jahre,535,268,267
False,8115051,Weil im Schönbuch,60 - 65 Jahre,580,309,271
False,8115051,Weil im Schönbuch,65 - 75 Jahre,947,467,480
False,8115051,Weil im Schönbuch,75 und mehr Jahre,570,210,360
False,8115051,Weil im Schönbuch,Insgesamt,10006,4972,5034
False,8115052,Weissach,unter 3 Jahre,200,97,103
False,8115052,Weissach,3 -  6 Jahre,236,117,119
False,8115052,Weissach,6 - 10 Jahre,372,197,175
False,8115052,Weissach,10 - 15 Jahre,550,290,260
False,8115052,Weissach,15 - 18 Jahre,335,170,165
False,8115052,Weissach,18 - 20 Jahre,157,87,70
False,8115052,Weissach,20 - 25 Jahre,414,208,206
False,8115052,Weissach,25 - 30 Jahre,344,186,158
False,8115052,Weissach,30 - 35 Jahre,438,218,220
False,8115052,Weissach,35 - 40 Jahre,659,333,326
False,8115052,Weissach,40 - 45 Jahre,727,349,378
False,8115052,Weissach,45 - 50 Jahre,647,331,316
False,8115052,Weissach,50 - 55 Jahre,569,284,285
False,8115052,Weissach,55 - 60 Jahre,411,202,209
False,8115052,Weissach,60 - 65 Jahre,438,233,205
False,8115052,Weissach,65 - 75 Jahre,733,357,376
False,8115052,Weissach,75 und mehr Jahre,475,180,295
False,8115052,Weissach,Insgesamt,7705,3839,3866
False,8115053,Jettingen,unter 3 Jahre,230,119,111
False,8115053,Jettingen,3 -  6 Jahre,258,139,119
False,8115053,Jettingen,6 - 10 Jahre,447,213,234
False,8115053,Jettingen,10 - 15 Jahre,552,278,274
False,8115053,Jettingen,15 - 18 Jahre,378,179,199
False,8115053,Jettingen,18 - 20 Jahre,220,114,106
False,8115053,Jettingen,20 - 25 Jahre,440,229,211
False,8115053,Jettingen,25 - 30 Jahre,412,207,205
False,8115053,Jettingen,30 - 35 Jahre,482,228,254
False,8115053,Jettingen,35 - 40 Jahre,646,289,357
False,8115053,Jettingen,40 - 45 Jahre,741,361,380
False,8115053,Jettingen,45 - 50 Jahre,622,321,301
False,8115053,Jettingen,50 - 55 Jahre,489,248,241
False,8115053,Jettingen,55 - 60 Jahre,392,215,177
False,8115053,Jettingen,60 - 65 Jahre,356,177,179
False,8115053,Jettingen,65 - 75 Jahre,668,324,344
False,8115053,Jettingen,75 und mehr Jahre,389,136,253
False,8115053,Jettingen,Insgesamt,7722,3777,3945
False,8115054,Grafenau,unter 3 Jahre,184,95,89
False,8115054,Grafenau,3 -  6 Jahre,195,92,103
False,8115054,Grafenau,6 - 10 Jahre,346,180,166
False,8115054,Grafenau,10 - 15 Jahre,357,190,167
False,8115054,Grafenau,15 - 18 Jahre,217,108,109
False,8115054,Grafenau,18 - 20 Jahre,139,70,69
False,8115054,Grafenau,20 - 25 Jahre,303,136,167
False,8115054,Grafenau,25 - 30 Jahre,410,203,207
False,8115054,Grafenau,30 - 35 Jahre,445,228,217
False,8115054,Grafenau,35 - 40 Jahre,597,312,285
False,8115054,Grafenau,40 - 45 Jahre,626,329,297
False,8115054,Grafenau,45 - 50 Jahre,477,257,220
False,8115054,Grafenau,50 - 55 Jahre,445,223,222
False,8115054,Grafenau,55 - 60 Jahre,373,181,192
False,8115054,Grafenau,60 - 65 Jahre,423,213,210
False,8115054,Grafenau,65 - 75 Jahre,641,335,306
False,8115054,Grafenau,75 und mehr Jahre,399,161,238
False,8115054,Grafenau,Insgesamt,6577,3313,3264
False,8116,Landkreis Esslingen,unter 3 Jahre,14479,7570,6909
False,8116,Landkreis Esslingen,3 -  6 Jahre,15183,7765,7418
False,8116,Landkreis Esslingen,6 - 10 Jahre,21947,11197,10750
False,8116,Landkreis Esslingen,10 - 15 Jahre,27726,14180,13546
False,8116,Landkreis Esslingen,15 - 18 Jahre,17355,8894,8461
False,8116,Landkreis Esslingen,18 - 20 Jahre,11127,5774,5353
False,8116,Landkreis Esslingen,20 - 25 Jahre,28117,14117,14000
False,8116,Landkreis Esslingen,25 - 30 Jahre,30657,15177,15480
False,8116,Landkreis Esslingen,30 - 35 Jahre,33574,16976,16598
False,8116,Landkreis Esslingen,35 - 40 Jahre,43307,21928,21379
False,8116,Landkreis Esslingen,40 - 45 Jahre,45358,23444,21914
False,8116,Landkreis Esslingen,45 - 50 Jahre,38711,19739,18972
False,8116,Landkreis Esslingen,50 - 55 Jahre,32450,15941,16509
False,8116,Landkreis Esslingen,55 - 60 Jahre,30376,14844,15532
False,8116,Landkreis Esslingen,60 - 65 Jahre,30274,15101,15173
False,8116,Landkreis Esslingen,65 - 75 Jahre,55288,26517,28771
False,8116,Landkreis Esslingen,75 und mehr Jahre,38316,13863,24453
False,8116,Landkreis Esslingen,Insgesamt,514245,253027,261218
False,8116004,Altbach,unter 3 Jahre,178,94,84
False,8116004,Altbach,3 -  6 Jahre,171,91,80
False,8116004,Altbach,6 - 10 Jahre,209,112,97
False,8116004,Altbach,10 - 15 Jahre,243,124,119
False,8116004,Altbach,15 - 18 Jahre,155,80,75
False,8116004,Altbach,18 - 20 Jahre,102,51,51
False,8116004,Altbach,20 - 25 Jahre,291,156,135
False,8116004,Altbach,25 - 30 Jahre,363,173,190
False,8116004,Altbach,30 - 35 Jahre,373,182,191
False,8116004,Altbach,35 - 40 Jahre,538,273,265
False,8116004,Altbach,40 - 45 Jahre,475,248,227
False,8116004,Altbach,45 - 50 Jahre,394,215,179
False,8116004,Altbach,50 - 55 Jahre,317,143,174
False,8116004,Altbach,55 - 60 Jahre,367,177,190
False,8116004,Altbach,60 - 65 Jahre,380,193,187
False,8116004,Altbach,65 - 75 Jahre,695,326,369
False,8116004,Altbach,75 und mehr Jahre,489,190,299
False,8116004,Altbach,Insgesamt,5740,2828,2912
False,8116005,Altdorf,unter 3 Jahre,69,47,22
False,8116005,Altdorf,3 -  6 Jahre,55,24,31
False,8116005,Altdorf,6 - 10 Jahre,89,46,43
False,8116005,Altdorf,10 - 15 Jahre,102,56,46
False,8116005,Altdorf,15 - 18 Jahre,56,26,30
False,8116005,Altdorf,18 - 20 Jahre,33,17,16
False,8116005,Altdorf,20 - 25 Jahre,84,40,44
False,8116005,Altdorf,25 - 30 Jahre,83,33,50
False,8116005,Altdorf,30 - 35 Jahre,111,50,61
False,8116005,Altdorf,35 - 40 Jahre,155,80,75
False,8116005,Altdorf,40 - 45 Jahre,142,81,61
False,8116005,Altdorf,45 - 50 Jahre,111,58,53
False,8116005,Altdorf,50 - 55 Jahre,75,43,32
False,8116005,Altdorf,55 - 60 Jahre,84,44,40
False,8116005,Altdorf,60 - 65 Jahre,58,34,24
False,8116005,Altdorf,65 - 75 Jahre,106,51,55
False,8116005,Altdorf,75 und mehr Jahre,49,16,33
False,8116005,Altdorf,Insgesamt,1462,746,716
False,8116006,Altenriet,unter 3 Jahre,55,32,23
False,8116006,Altenriet,3 -  6 Jahre,67,38,29
False,8116006,Altenriet,6 - 10 Jahre,102,52,50
False,8116006,Altenriet,10 - 15 Jahre,114,63,51
False,8116006,Altenriet,15 - 18 Jahre,84,33,51
False,8116006,Altenriet,18 - 20 Jahre,42,23,19
False,8116006,Altenriet,20 - 25 Jahre,91,51,40
False,8116006,Altenriet,25 - 30 Jahre,89,44,45
False,8116006,Altenriet,30 - 35 Jahre,124,54,70
False,8116006,Altenriet,35 - 40 Jahre,159,67,92
False,8116006,Altenriet,40 - 45 Jahre,202,115,87
False,8116006,Altenriet,45 - 50 Jahre,154,71,83
False,8116006,Altenriet,50 - 55 Jahre,111,55,56
False,8116006,Altenriet,55 - 60 Jahre,115,56,59
False,8116006,Altenriet,60 - 65 Jahre,95,51,44
False,8116006,Altenriet,65 - 75 Jahre,175,83,92
False,8116006,Altenriet,75 und mehr Jahre,76,28,48
False,8116006,Altenriet,Insgesamt,1855,916,939
False,8116007,Baltmannsweiler,unter 3 Jahre,145,76,69
False,8116007,Baltmannsweiler,3 -  6 Jahre,197,99,98
False,8116007,Baltmannsweiler,6 - 10 Jahre,302,160,142
False,8116007,Baltmannsweiler,10 - 15 Jahre,347,176,171
False,8116007,Baltmannsweiler,15 - 18 Jahre,207,101,106
False,8116007,Baltmannsweiler,18 - 20 Jahre,138,95,43
False,8116007,Baltmannsweiler,20 - 25 Jahre,229,124,105
False,8116007,Baltmannsweiler,25 - 30 Jahre,253,123,130
False,8116007,Baltmannsweiler,30 - 35 Jahre,286,131,155
False,8116007,Baltmannsweiler,35 - 40 Jahre,465,233,232
False,8116007,Baltmannsweiler,40 - 45 Jahre,526,274,252
False,8116007,Baltmannsweiler,45 - 50 Jahre,386,208,178
False,8116007,Baltmannsweiler,50 - 55 Jahre,346,162,184
False,8116007,Baltmannsweiler,55 - 60 Jahre,327,163,164
False,8116007,Baltmannsweiler,60 - 65 Jahre,385,178,207
False,8116007,Baltmannsweiler,65 - 75 Jahre,630,316,314
False,8116007,Baltmannsweiler,75 und mehr Jahre,383,145,238
False,8116007,Baltmannsweiler,Insgesamt,5552,2764,2788
False,8116008,Bempflingen,unter 3 Jahre,98,56,42
False,8116008,Bempflingen,3 -  6 Jahre,124,65,59
False,8116008,Bempflingen,6 - 10 Jahre,178,87,91
False,8116008,Bempflingen,10 - 15 Jahre,181,95,86
False,8116008,Bempflingen,15 - 18 Jahre,124,59,65
False,8116008,Bempflingen,18 - 20 Jahre,71,35,36
False,8116008,Bempflingen,20 - 25 Jahre,174,86,88
False,8116008,Bempflingen,25 - 30 Jahre,170,74,96
False,8116008,Bempflingen,30 - 35 Jahre,242,126,116
False,8116008,Bempflingen,35 - 40 Jahre,279,124,155
False,8116008,Bempflingen,40 - 45 Jahre,302,160,142
False,8116008,Bempflingen,45 - 50 Jahre,249,121,128
False,8116008,Bempflingen,50 - 55 Jahre,208,109,99
False,8116008,Bempflingen,55 - 60 Jahre,177,84,93
False,8116008,Bempflingen,60 - 65 Jahre,212,111,101
False,8116008,Bempflingen,65 - 75 Jahre,364,176,188
False,8116008,Bempflingen,75 und mehr Jahre,210,80,130
False,8116008,Bempflingen,Insgesamt,3363,1648,1715
False,8116011,Beuren,unter 3 Jahre,82,37,45
False,8116011,Beuren,3 -  6 Jahre,92,45,47
False,8116011,Beuren,6 - 10 Jahre,118,59,59
False,8116011,Beuren,10 - 15 Jahre,185,88,97
False,8116011,Beuren,15 - 18 Jahre,156,94,62
False,8116011,Beuren,18 - 20 Jahre,90,56,34
False,8116011,Beuren,20 - 25 Jahre,178,91,87
False,8116011,Beuren,25 - 30 Jahre,178,94,84
False,8116011,Beuren,30 - 35 Jahre,164,93,71
False,8116011,Beuren,35 - 40 Jahre,245,140,105
False,8116011,Beuren,40 - 45 Jahre,267,135,132
False,8116011,Beuren,45 - 50 Jahre,285,145,140
False,8116011,Beuren,50 - 55 Jahre,218,116,102
False,8116011,Beuren,55 - 60 Jahre,161,85,76
False,8116011,Beuren,60 - 65 Jahre,195,87,108
False,8116011,Beuren,65 - 75 Jahre,422,190,232
False,8116011,Beuren,75 und mehr Jahre,365,128,237
False,8116011,Beuren,Insgesamt,3401,1683,1718
False,8116012,Bissingen an der Teck,unter 3 Jahre,91,37,54
False,8116012,Bissingen an der Teck,3 -  6 Jahre,120,56,64
False,8116012,Bissingen an der Teck,6 - 10 Jahre,189,106,83
False,8116012,Bissingen an der Teck,10 - 15 Jahre,240,130,110
False,8116012,Bissingen an der Teck,15 - 18 Jahre,127,63,64
False,8116012,Bissingen an der Teck,18 - 20 Jahre,88,49,39
False,8116012,Bissingen an der Teck,20 - 25 Jahre,207,117,90
False,8116012,Bissingen an der Teck,25 - 30 Jahre,193,101,92
False,8116012,Bissingen an der Teck,30 - 35 Jahre,241,114,127
False,8116012,Bissingen an der Teck,35 - 40 Jahre,291,130,161
False,8116012,Bissingen an der Teck,40 - 45 Jahre,354,181,173
False,8116012,Bissingen an der Teck,45 - 50 Jahre,293,149,144
False,8116012,Bissingen an der Teck,50 - 55 Jahre,233,125,108
False,8116012,Bissingen an der Teck,55 - 60 Jahre,202,94,108
False,8116012,Bissingen an der Teck,60 - 65 Jahre,172,90,82
False,8116012,Bissingen an der Teck,65 - 75 Jahre,389,187,202
False,8116012,Bissingen an der Teck,75 und mehr Jahre,229,85,144
False,8116012,Bissingen an der Teck,Insgesamt,3659,1814,1845
False,8116014,Deizisau,unter 3 Jahre,210,110,100
False,8116014,Deizisau,3 -  6 Jahre,215,120,95
False,8116014,Deizisau,6 - 10 Jahre,313,180,133
False,8116014,Deizisau,10 - 15 Jahre,373,202,171
False,8116014,Deizisau,15 - 18 Jahre,197,104,93
False,8116014,Deizisau,18 - 20 Jahre,124,59,65
False,8116014,Deizisau,20 - 25 Jahre,337,184,153
False,8116014,Deizisau,25 - 30 Jahre,353,199,154
False,8116014,Deizisau,30 - 35 Jahre,422,206,216
False,8116014,Deizisau,35 - 40 Jahre,590,296,294
False,8116014,Deizisau,40 - 45 Jahre,611,309,302
False,8116014,Deizisau,45 - 50 Jahre,414,212,202
False,8116014,Deizisau,50 - 55 Jahre,399,203,196
False,8116014,Deizisau,55 - 60 Jahre,379,168,211
False,8116014,Deizisau,60 - 65 Jahre,436,206,230
False,8116014,Deizisau,65 - 75 Jahre,751,367,384
False,8116014,Deizisau,75 und mehr Jahre,428,177,251
False,8116014,Deizisau,Insgesamt,6552,3302,3250
False,8116015,Denkendorf,unter 3 Jahre,309,142,167
False,8116015,Denkendorf,3 -  6 Jahre,331,165,166
False,8116015,Denkendorf,6 - 10 Jahre,491,253,238
False,8116015,Denkendorf,10 - 15 Jahre,577,305,272
False,8116015,Denkendorf,15 - 18 Jahre,386,195,191
False,8116015,Denkendorf,18 - 20 Jahre,231,116,115
False,8116015,Denkendorf,20 - 25 Jahre,587,291,296
False,8116015,Denkendorf,25 - 30 Jahre,645,307,338
False,8116015,Denkendorf,30 - 35 Jahre,705,363,342
False,8116015,Denkendorf,35 - 40 Jahre,897,456,441
False,8116015,Denkendorf,40 - 45 Jahre,896,480,416
False,8116015,Denkendorf,45 - 50 Jahre,776,379,397
False,8116015,Denkendorf,50 - 55 Jahre,651,312,339
False,8116015,Denkendorf,55 - 60 Jahre,615,318,297
False,8116015,Denkendorf,60 - 65 Jahre,613,301,312
False,8116015,Denkendorf,65 - 75 Jahre,1144,566,578
False,8116015,Denkendorf,75 und mehr Jahre,675,248,427
False,8116015,Denkendorf,Insgesamt,10529,5197,5332
False,8116016,Dettingen unter Teck,unter 3 Jahre,163,88,75
False,8116016,Dettingen unter Teck,3 -  6 Jahre,163,81,82
False,8116016,Dettingen unter Teck,6 - 10 Jahre,242,126,116
False,8116016,Dettingen unter Teck,10 - 15 Jahre,298,156,142
False,8116016,Dettingen unter Teck,15 - 18 Jahre,193,100,93
False,8116016,Dettingen unter Teck,18 - 20 Jahre,128,62,66
False,8116016,Dettingen unter Teck,20 - 25 Jahre,293,149,144
False,8116016,Dettingen unter Teck,25 - 30 Jahre,314,179,135
False,8116016,Dettingen unter Teck,30 - 35 Jahre,330,168,162
False,8116016,Dettingen unter Teck,35 - 40 Jahre,445,231,214
False,8116016,Dettingen unter Teck,40 - 45 Jahre,435,232,203
False,8116016,Dettingen unter Teck,45 - 50 Jahre,388,192,196
False,8116016,Dettingen unter Teck,50 - 55 Jahre,398,180,218
False,8116016,Dettingen unter Teck,55 - 60 Jahre,357,181,176
False,8116016,Dettingen unter Teck,60 - 65 Jahre,371,195,176
False,8116016,Dettingen unter Teck,65 - 75 Jahre,602,300,302
False,8116016,Dettingen unter Teck,75 und mehr Jahre,522,170,352
False,8116016,Dettingen unter Teck,Insgesamt,5642,2790,2852
False,8116018,Erkenbrechtsweiler,unter 3 Jahre,53,24,29
False,8116018,Erkenbrechtsweiler,3 -  6 Jahre,54,28,26
False,8116018,Erkenbrechtsweiler,6 - 10 Jahre,115,61,54
False,8116018,Erkenbrechtsweiler,10 - 15 Jahre,174,86,88
False,8116018,Erkenbrechtsweiler,15 - 18 Jahre,84,42,42
False,8116018,Erkenbrechtsweiler,18 - 20 Jahre,58,21,37
False,8116018,Erkenbrechtsweiler,20 - 25 Jahre,108,56,52
False,8116018,Erkenbrechtsweiler,25 - 30 Jahre,92,43,49
False,8116018,Erkenbrechtsweiler,30 - 35 Jahre,121,63,58
False,8116018,Erkenbrechtsweiler,35 - 40 Jahre,158,79,79
False,8116018,Erkenbrechtsweiler,40 - 45 Jahre,196,88,108
False,8116018,Erkenbrechtsweiler,45 - 50 Jahre,182,102,80
False,8116018,Erkenbrechtsweiler,50 - 55 Jahre,156,78,78
False,8116018,Erkenbrechtsweiler,55 - 60 Jahre,126,70,56
False,8116018,Erkenbrechtsweiler,60 - 65 Jahre,109,55,54
False,8116018,Erkenbrechtsweiler,65 - 75 Jahre,210,96,114
False,8116018,Erkenbrechtsweiler,75 und mehr Jahre,137,43,94
False,8116018,Erkenbrechtsweiler,Insgesamt,2133,1035,1098
False,8116019,"Esslingen am Neckar, Stadt",unter 3 Jahre,2591,1360,1231
False,8116019,"Esslingen am Neckar, Stadt",3 -  6 Jahre,2457,1242,1215
False,8116019,"Esslingen am Neckar, Stadt",6 - 10 Jahre,3487,1756,1731
False,8116019,"Esslingen am Neckar, Stadt",10 - 15 Jahre,4242,2177,2065
False,8116019,"Esslingen am Neckar, Stadt",15 - 18 Jahre,2624,1415,1209
False,8116019,"Esslingen am Neckar, Stadt",18 - 20 Jahre,1710,869,841
False,8116019,"Esslingen am Neckar, Stadt",20 - 25 Jahre,5182,2612,2570
False,8116019,"Esslingen am Neckar, Stadt",25 - 30 Jahre,6374,3165,3209
False,8116019,"Esslingen am Neckar, Stadt",30 - 35 Jahre,6469,3387,3082
False,8116019,"Esslingen am Neckar, Stadt",35 - 40 Jahre,7428,3896,3532
False,8116019,"Esslingen am Neckar, Stadt",40 - 45 Jahre,7798,4138,3660
False,8116019,"Esslingen am Neckar, Stadt",45 - 50 Jahre,6572,3329,3243
False,8116019,"Esslingen am Neckar, Stadt",50 - 55 Jahre,5493,2708,2785
False,8116019,"Esslingen am Neckar, Stadt",55 - 60 Jahre,5380,2583,2797
False,8116019,"Esslingen am Neckar, Stadt",60 - 65 Jahre,5713,2856,2857
False,8116019,"Esslingen am Neckar, Stadt",65 - 75 Jahre,10447,5007,5440
False,8116019,"Esslingen am Neckar, Stadt",75 und mehr Jahre,8124,2850,5274
False,8116019,"Esslingen am Neckar, Stadt",Insgesamt,92091,45350,46741
False,8116020,Frickenhausen,unter 3 Jahre,203,112,91
False,8116020,Frickenhausen,3 -  6 Jahre,259,143,116
False,8116020,Frickenhausen,6 - 10 Jahre,389,202,187
False,8116020,Frickenhausen,10 - 15 Jahre,556,286,270
False,8116020,Frickenhausen,15 - 18 Jahre,313,161,152
False,8116020,Frickenhausen,18 - 20 Jahre,201,102,99
False,8116020,Frickenhausen,20 - 25 Jahre,492,272,220
False,8116020,Frickenhausen,25 - 30 Jahre,462,233,229
False,8116020,Frickenhausen,30 - 35 Jahre,477,228,249
False,8116020,Frickenhausen,35 - 40 Jahre,700,352,348
False,8116020,Frickenhausen,40 - 45 Jahre,806,414,392
False,8116020,Frickenhausen,45 - 50 Jahre,661,360,301
False,8116020,Frickenhausen,50 - 55 Jahre,561,277,284
False,8116020,Frickenhausen,55 - 60 Jahre,548,271,277
False,8116020,Frickenhausen,60 - 65 Jahre,540,277,263
False,8116020,Frickenhausen,65 - 75 Jahre,1062,529,533
False,8116020,Frickenhausen,75 und mehr Jahre,617,243,374
False,8116020,Frickenhausen,Insgesamt,8847,4462,4385
False,8116022,Großbettlingen,unter 3 Jahre,131,75,56
False,8116022,Großbettlingen,3 -  6 Jahre,133,69,64
False,8116022,Großbettlingen,6 - 10 Jahre,180,96,84
False,8116022,Großbettlingen,10 - 15 Jahre,258,116,142
False,8116022,Großbettlingen,15 - 18 Jahre,139,65,74
False,8116022,Großbettlingen,18 - 20 Jahre,80,39,41
False,8116022,Großbettlingen,20 - 25 Jahre,210,97,113
False,8116022,Großbettlingen,25 - 30 Jahre,231,125,106
False,8116022,Großbettlingen,30 - 35 Jahre,264,135,129
False,8116022,Großbettlingen,35 - 40 Jahre,328,159,169
False,8116022,Großbettlingen,40 - 45 Jahre,392,202,190
False,8116022,Großbettlingen,45 - 50 Jahre,283,141,142
False,8116022,Großbettlingen,50 - 55 Jahre,275,130,145
False,8116022,Großbettlingen,55 - 60 Jahre,257,133,124
False,8116022,Großbettlingen,60 - 65 Jahre,230,104,126
False,8116022,Großbettlingen,65 - 75 Jahre,411,208,203
False,8116022,Großbettlingen,75 und mehr Jahre,301,85,216
False,8116022,Großbettlingen,Insgesamt,4103,1979,2124
False,8116027,Hochdorf,unter 3 Jahre,106,47,59
False,8116027,Hochdorf,3 -  6 Jahre,123,67,56
False,8116027,Hochdorf,6 - 10 Jahre,194,95,99
False,8116027,Hochdorf,10 - 15 Jahre,271,136,135
False,8116027,Hochdorf,15 - 18 Jahre,139,69,70
False,8116027,Hochdorf,18 - 20 Jahre,89,44,45
False,8116027,Hochdorf,20 - 25 Jahre,237,118,119
False,8116027,Hochdorf,25 - 30 Jahre,240,113,127
False,8116027,Hochdorf,30 - 35 Jahre,253,147,106
False,8116027,Hochdorf,35 - 40 Jahre,438,225,213
False,8116027,Hochdorf,40 - 45 Jahre,379,179,200
False,8116027,Hochdorf,45 - 50 Jahre,369,196,173
False,8116027,Hochdorf,50 - 55 Jahre,328,164,164
False,8116027,Hochdorf,55 - 60 Jahre,290,146,144
False,8116027,Hochdorf,60 - 65 Jahre,293,144,149
False,8116027,Hochdorf,65 - 75 Jahre,580,272,308
False,8116027,Hochdorf,75 und mehr Jahre,361,145,216
False,8116027,Hochdorf,Insgesamt,4690,2307,2383
False,8116029,Holzmaden,unter 3 Jahre,59,27,32
False,8116029,Holzmaden,3 -  6 Jahre,70,38,32
False,8116029,Holzmaden,6 - 10 Jahre,104,48,56
False,8116029,Holzmaden,10 - 15 Jahre,156,78,78
False,8116029,Holzmaden,15 - 18 Jahre,97,55,42
False,8116029,Holzmaden,18 - 20 Jahre,42,24,18
False,8116029,Holzmaden,20 - 25 Jahre,127,65,62
False,8116029,Holzmaden,25 - 30 Jahre,112,68,44
False,8116029,Holzmaden,30 - 35 Jahre,126,57,69
False,8116029,Holzmaden,35 - 40 Jahre,169,81,88
False,8116029,Holzmaden,40 - 45 Jahre,231,118,113
False,8116029,Holzmaden,45 - 50 Jahre,198,94,104
False,8116029,Holzmaden,50 - 55 Jahre,131,74,57
False,8116029,Holzmaden,55 - 60 Jahre,106,51,55
False,8116029,Holzmaden,60 - 65 Jahre,88,41,47
False,8116029,Holzmaden,65 - 75 Jahre,183,96,87
False,8116029,Holzmaden,75 und mehr Jahre,146,49,97
False,8116029,Holzmaden,Insgesamt,2145,1064,1081
False,8116033,"Kirchheim unter Teck, Stadt",unter 3 Jahre,1038,546,492
False,8116033,"Kirchheim unter Teck, Stadt",3 -  6 Jahre,1122,571,551
False,8116033,"Kirchheim unter Teck, Stadt",6 - 10 Jahre,1739,877,862
False,8116033,"Kirchheim unter Teck, Stadt",10 - 15 Jahre,2221,1138,1083
False,8116033,"Kirchheim unter Teck, Stadt",15 - 18 Jahre,1539,792,747
False,8116033,"Kirchheim unter Teck, Stadt",18 - 20 Jahre,980,494,486
False,8116033,"Kirchheim unter Teck, Stadt",20 - 25 Jahre,2276,1132,1144
False,8116033,"Kirchheim unter Teck, Stadt",25 - 30 Jahre,2239,1101,1138
False,8116033,"Kirchheim unter Teck, Stadt",30 - 35 Jahre,2525,1281,1244
False,8116033,"Kirchheim unter Teck, Stadt",35 - 40 Jahre,3231,1578,1653
False,8116033,"Kirchheim unter Teck, Stadt",40 - 45 Jahre,3308,1653,1655
False,8116033,"Kirchheim unter Teck, Stadt",45 - 50 Jahre,3182,1597,1585
False,8116033,"Kirchheim unter Teck, Stadt",50 - 55 Jahre,2752,1333,1419
False,8116033,"Kirchheim unter Teck, Stadt",55 - 60 Jahre,2215,1114,1101
False,8116033,"Kirchheim unter Teck, Stadt",60 - 65 Jahre,2108,1028,1080
False,8116033,"Kirchheim unter Teck, Stadt",65 - 75 Jahre,4125,1950,2175
False,8116033,"Kirchheim unter Teck, Stadt",75 und mehr Jahre,3370,1171,2199
False,8116033,"Kirchheim unter Teck, Stadt",Insgesamt,39970,19356,20614
False,8116035,Köngen,unter 3 Jahre,251,137,114
False,8116035,Köngen,3 -  6 Jahre,293,165,128
False,8116035,Köngen,6 - 10 Jahre,469,248,221
False,8116035,Köngen,10 - 15 Jahre,606,315,291
False,8116035,Köngen,15 - 18 Jahre,323,168,155
False,8116035,Köngen,18 - 20 Jahre,213,116,97
False,8116035,Köngen,20 - 25 Jahre,449,202,247
False,8116035,Köngen,25 - 30 Jahre,537,260,277
False,8116035,Köngen,30 - 35 Jahre,613,298,315
False,8116035,Köngen,35 - 40 Jahre,902,451,451
False,8116035,Köngen,40 - 45 Jahre,957,489,468
False,8116035,Köngen,45 - 50 Jahre,712,365,347
False,8116035,Köngen,50 - 55 Jahre,561,286,275
False,8116035,Köngen,55 - 60 Jahre,542,267,275
False,8116035,Köngen,60 - 65 Jahre,528,262,266
False,8116035,Köngen,65 - 75 Jahre,1000,474,526
False,8116035,Köngen,75 und mehr Jahre,725,240,485
False,8116035,Köngen,Insgesamt,9681,4743,4938
False,8116036,Kohlberg,unter 3 Jahre,67,32,35
False,8116036,Kohlberg,3 -  6 Jahre,74,33,41
False,8116036,Kohlberg,6 - 10 Jahre,104,50,54
False,8116036,Kohlberg,10 - 15 Jahre,138,77,61
False,8116036,Kohlberg,15 - 18 Jahre,83,43,40
False,8116036,Kohlberg,18 - 20 Jahre,53,25,28
False,8116036,Kohlberg,20 - 25 Jahre,145,76,69
False,8116036,Kohlberg,25 - 30 Jahre,130,69,61
False,8116036,Kohlberg,30 - 35 Jahre,152,76,76
False,8116036,Kohlberg,35 - 40 Jahre,188,89,99
False,8116036,Kohlberg,40 - 45 Jahre,209,111,98
False,8116036,Kohlberg,45 - 50 Jahre,162,82,80
False,8116036,Kohlberg,50 - 55 Jahre,141,69,72
False,8116036,Kohlberg,55 - 60 Jahre,145,68,77
False,8116036,Kohlberg,60 - 65 Jahre,133,69,64
False,8116036,Kohlberg,65 - 75 Jahre,234,106,128
False,8116036,Kohlberg,75 und mehr Jahre,163,53,110
False,8116036,Kohlberg,Insgesamt,2321,1128,1193
False,8116037,Lichtenwald,unter 3 Jahre,40,19,21
False,8116037,Lichtenwald,3 -  6 Jahre,68,33,35
False,8116037,Lichtenwald,6 - 10 Jahre,118,56,62
False,8116037,Lichtenwald,10 - 15 Jahre,160,66,94
False,8116037,Lichtenwald,15 - 18 Jahre,101,55,46
False,8116037,Lichtenwald,18 - 20 Jahre,54,27,27
False,8116037,Lichtenwald,20 - 25 Jahre,156,78,78
False,8116037,Lichtenwald,25 - 30 Jahre,103,56,47
False,8116037,Lichtenwald,30 - 35 Jahre,104,52,52
False,8116037,Lichtenwald,35 - 40 Jahre,170,86,84
False,8116037,Lichtenwald,40 - 45 Jahre,236,107,129
False,8116037,Lichtenwald,45 - 50 Jahre,194,101,93
False,8116037,Lichtenwald,50 - 55 Jahre,178,88,90
False,8116037,Lichtenwald,55 - 60 Jahre,185,91,94
False,8116037,Lichtenwald,60 - 65 Jahre,165,83,82
False,8116037,Lichtenwald,65 - 75 Jahre,326,157,169
False,8116037,Lichtenwald,75 und mehr Jahre,150,66,84
False,8116037,Lichtenwald,Insgesamt,2508,1221,1287
False,8116041,Neckartailfingen,unter 3 Jahre,123,67,56
False,8116041,Neckartailfingen,3 -  6 Jahre,119,69,50
False,8116041,Neckartailfingen,6 - 10 Jahre,181,94,87
False,8116041,Neckartailfingen,10 - 15 Jahre,244,118,126
False,8116041,Neckartailfingen,15 - 18 Jahre,164,86,78
False,8116041,Neckartailfingen,18 - 20 Jahre,80,43,37
False,8116041,Neckartailfingen,20 - 25 Jahre,199,109,90
False,8116041,Neckartailfingen,25 - 30 Jahre,241,109,132
False,8116041,Neckartailfingen,30 - 35 Jahre,270,132,138
False,8116041,Neckartailfingen,35 - 40 Jahre,362,192,170
False,8116041,Neckartailfingen,40 - 45 Jahre,343,170,173
False,8116041,Neckartailfingen,45 - 50 Jahre,333,167,166
False,8116041,Neckartailfingen,50 - 55 Jahre,222,104,118
False,8116041,Neckartailfingen,55 - 60 Jahre,208,108,100
False,8116041,Neckartailfingen,60 - 65 Jahre,207,106,101
False,8116041,Neckartailfingen,65 - 75 Jahre,372,176,196
False,8116041,Neckartailfingen,75 und mehr Jahre,221,96,125
False,8116041,Neckartailfingen,Insgesamt,3889,1946,1943
False,8116042,Neckartenzlingen,unter 3 Jahre,200,104,96
False,8116042,Neckartenzlingen,3 -  6 Jahre,160,87,73
False,8116042,Neckartenzlingen,6 - 10 Jahre,289,145,144
False,8116042,Neckartenzlingen,10 - 15 Jahre,358,168,190
False,8116042,Neckartenzlingen,15 - 18 Jahre,230,114,116
False,8116042,Neckartenzlingen,18 - 20 Jahre,178,103,75
False,8116042,Neckartenzlingen,20 - 25 Jahre,413,200,213
False,8116042,Neckartenzlingen,25 - 30 Jahre,400,194,206
False,8116042,Neckartenzlingen,30 - 35 Jahre,445,227,218
False,8116042,Neckartenzlingen,35 - 40 Jahre,531,283,248
False,8116042,Neckartenzlingen,40 - 45 Jahre,508,249,259
False,8116042,Neckartenzlingen,45 - 50 Jahre,497,254,243
False,8116042,Neckartenzlingen,50 - 55 Jahre,431,213,218
False,8116042,Neckartenzlingen,55 - 60 Jahre,419,204,215
False,8116042,Neckartenzlingen,60 - 65 Jahre,371,186,185
False,8116042,Neckartenzlingen,65 - 75 Jahre,596,301,295
False,8116042,Neckartenzlingen,75 und mehr Jahre,344,116,228
False,8116042,Neckartenzlingen,Insgesamt,6370,3148,3222
False,8116043,Neidlingen,unter 3 Jahre,51,29,22
False,8116043,Neidlingen,3 -  6 Jahre,70,34,36
False,8116043,Neidlingen,6 - 10 Jahre,95,57,38
False,8116043,Neidlingen,10 - 15 Jahre,121,58,63
False,8116043,Neidlingen,15 - 18 Jahre,57,28,29
False,8116043,Neidlingen,18 - 20 Jahre,35,19,16
False,8116043,Neidlingen,20 - 25 Jahre,112,56,56
False,8116043,Neidlingen,25 - 30 Jahre,104,41,63
False,8116043,Neidlingen,30 - 35 Jahre,120,69,51
False,8116043,Neidlingen,35 - 40 Jahre,159,79,80
False,8116043,Neidlingen,40 - 45 Jahre,191,104,87
False,8116043,Neidlingen,45 - 50 Jahre,153,80,73
False,8116043,Neidlingen,50 - 55 Jahre,111,60,51
False,8116043,Neidlingen,55 - 60 Jahre,112,53,59
False,8116043,Neidlingen,60 - 65 Jahre,79,43,36
False,8116043,Neidlingen,65 - 75 Jahre,198,92,106
False,8116043,Neidlingen,75 und mehr Jahre,140,59,81
False,8116043,Neidlingen,Insgesamt,1908,961,947
False,8116046,"Neuffen, Stadt",unter 3 Jahre,175,91,84
False,8116046,"Neuffen, Stadt",3 -  6 Jahre,199,105,94
False,8116046,"Neuffen, Stadt",6 - 10 Jahre,297,139,158
False,8116046,"Neuffen, Stadt",10 - 15 Jahre,365,192,173
False,8116046,"Neuffen, Stadt",15 - 18 Jahre,261,125,136
False,8116046,"Neuffen, Stadt",18 - 20 Jahre,140,70,70
False,8116046,"Neuffen, Stadt",20 - 25 Jahre,326,172,154
False,8116046,"Neuffen, Stadt",25 - 30 Jahre,326,156,170
False,8116046,"Neuffen, Stadt",30 - 35 Jahre,404,207,197
False,8116046,"Neuffen, Stadt",35 - 40 Jahre,523,266,257
False,8116046,"Neuffen, Stadt",40 - 45 Jahre,527,272,255
False,8116046,"Neuffen, Stadt",45 - 50 Jahre,491,259,232
False,8116046,"Neuffen, Stadt",50 - 55 Jahre,414,205,209
False,8116046,"Neuffen, Stadt",55 - 60 Jahre,341,156,185
False,8116046,"Neuffen, Stadt",60 - 65 Jahre,354,189,165
False,8116046,"Neuffen, Stadt",65 - 75 Jahre,595,286,309
False,8116046,"Neuffen, Stadt",75 und mehr Jahre,493,171,322
False,8116046,"Neuffen, Stadt",Insgesamt,6231,3061,3170
False,8116047,Neuhausen auf den Fildern,unter 3 Jahre,332,172,160
False,8116047,Neuhausen auf den Fildern,3 -  6 Jahre,395,184,211
False,8116047,Neuhausen auf den Fildern,6 - 10 Jahre,495,242,253
False,8116047,Neuhausen auf den Fildern,10 - 15 Jahre,635,324,311
False,8116047,Neuhausen auf den Fildern,15 - 18 Jahre,406,202,204
False,8116047,Neuhausen auf den Fildern,18 - 20 Jahre,250,128,122
False,8116047,Neuhausen auf den Fildern,20 - 25 Jahre,653,333,320
False,8116047,Neuhausen auf den Fildern,25 - 30 Jahre,684,329,355
False,8116047,Neuhausen auf den Fildern,30 - 35 Jahre,777,376,401
False,8116047,Neuhausen auf den Fildern,35 - 40 Jahre,948,462,486
False,8116047,Neuhausen auf den Fildern,40 - 45 Jahre,1025,536,489
False,8116047,Neuhausen auf den Fildern,45 - 50 Jahre,856,445,411
False,8116047,Neuhausen auf den Fildern,50 - 55 Jahre,658,303,355
False,8116047,Neuhausen auf den Fildern,55 - 60 Jahre,716,356,360
False,8116047,Neuhausen auf den Fildern,60 - 65 Jahre,649,319,330
False,8116047,Neuhausen auf den Fildern,65 - 75 Jahre,1207,568,639
False,8116047,Neuhausen auf den Fildern,75 und mehr Jahre,777,302,475
False,8116047,Neuhausen auf den Fildern,Insgesamt,11463,5581,5882
False,8116048,Notzingen,unter 3 Jahre,88,46,42
False,8116048,Notzingen,3 -  6 Jahre,92,43,49
False,8116048,Notzingen,6 - 10 Jahre,145,72,73
False,8116048,Notzingen,10 - 15 Jahre,219,127,92
False,8116048,Notzingen,15 - 18 Jahre,152,85,67
False,8116048,Notzingen,18 - 20 Jahre,100,53,47
False,8116048,Notzingen,20 - 25 Jahre,162,90,72
False,8116048,Notzingen,25 - 30 Jahre,158,81,77
False,8116048,Notzingen,30 - 35 Jahre,156,80,76
False,8116048,Notzingen,35 - 40 Jahre,266,139,127
False,8116048,Notzingen,40 - 45 Jahre,336,183,153
False,8116048,Notzingen,45 - 50 Jahre,313,146,167
False,8116048,Notzingen,50 - 55 Jahre,268,139,129
False,8116048,Notzingen,55 - 60 Jahre,220,106,114
False,8116048,Notzingen,60 - 65 Jahre,204,100,104
False,8116048,Notzingen,65 - 75 Jahre,401,191,210
False,8116048,Notzingen,75 und mehr Jahre,214,85,129
False,8116048,Notzingen,Insgesamt,3494,1766,1728
False,8116049,"Nürtingen, Stadt",unter 3 Jahre,1130,564,566
False,8116049,"Nürtingen, Stadt",3 -  6 Jahre,1210,641,569
False,8116049,"Nürtingen, Stadt",6 - 10 Jahre,1687,843,844
False,8116049,"Nürtingen, Stadt",10 - 15 Jahre,2133,1111,1022
False,8116049,"Nürtingen, Stadt",15 - 18 Jahre,1413,703,710
False,8116049,"Nürtingen, Stadt",18 - 20 Jahre,983,524,459
False,8116049,"Nürtingen, Stadt",20 - 25 Jahre,2412,1198,1214
False,8116049,"Nürtingen, Stadt",25 - 30 Jahre,2422,1191,1231
False,8116049,"Nürtingen, Stadt",30 - 35 Jahre,2517,1248,1269
False,8116049,"Nürtingen, Stadt",35 - 40 Jahre,3289,1695,1594
False,8116049,"Nürtingen, Stadt",40 - 45 Jahre,3393,1733,1660
False,8116049,"Nürtingen, Stadt",45 - 50 Jahre,2962,1461,1501
False,8116049,"Nürtingen, Stadt",50 - 55 Jahre,2580,1284,1296
False,8116049,"Nürtingen, Stadt",55 - 60 Jahre,2410,1197,1213
False,8116049,"Nürtingen, Stadt",60 - 65 Jahre,2375,1188,1187
False,8116049,"Nürtingen, Stadt",65 - 75 Jahre,4286,2048,2238
False,8116049,"Nürtingen, Stadt",75 und mehr Jahre,3284,1184,2100
False,8116049,"Nürtingen, Stadt",Insgesamt,40486,19813,20673
False,8116050,Oberboihingen,unter 3 Jahre,145,76,69
False,8116050,Oberboihingen,3 -  6 Jahre,158,83,75
False,8116050,Oberboihingen,6 - 10 Jahre,231,118,113
False,8116050,Oberboihingen,10 - 15 Jahre,280,137,143
False,8116050,Oberboihingen,15 - 18 Jahre,188,92,96
False,8116050,Oberboihingen,18 - 20 Jahre,113,59,54
False,8116050,Oberboihingen,20 - 25 Jahre,345,158,187
False,8116050,Oberboihingen,25 - 30 Jahre,336,173,163
False,8116050,Oberboihingen,30 - 35 Jahre,319,162,157
False,8116050,Oberboihingen,35 - 40 Jahre,446,228,218
False,8116050,Oberboihingen,40 - 45 Jahre,451,223,228
False,8116050,Oberboihingen,45 - 50 Jahre,481,252,229
False,8116050,Oberboihingen,50 - 55 Jahre,368,180,188
False,8116050,Oberboihingen,55 - 60 Jahre,336,151,185
False,8116050,Oberboihingen,60 - 65 Jahre,332,179,153
False,8116050,Oberboihingen,65 - 75 Jahre,556,288,268
False,8116050,Oberboihingen,75 und mehr Jahre,300,106,194
False,8116050,Oberboihingen,Insgesamt,5385,2665,2720
False,8116053,Ohmden,unter 3 Jahre,51,27,24
False,8116053,Ohmden,3 -  6 Jahre,53,30,23
False,8116053,Ohmden,6 - 10 Jahre,88,52,36
False,8116053,Ohmden,10 - 15 Jahre,79,37,42
False,8116053,Ohmden,15 - 18 Jahre,59,31,28
False,8116053,Ohmden,18 - 20 Jahre,44,24,20
False,8116053,Ohmden,20 - 25 Jahre,107,51,56
False,8116053,Ohmden,25 - 30 Jahre,82,40,42
False,8116053,Ohmden,30 - 35 Jahre,103,49,54
False,8116053,Ohmden,35 - 40 Jahre,158,83,75
False,8116053,Ohmden,40 - 45 Jahre,163,95,68
False,8116053,Ohmden,45 - 50 Jahre,108,61,47
False,8116053,Ohmden,50 - 55 Jahre,129,64,65
False,8116053,Ohmden,55 - 60 Jahre,94,51,43
False,8116053,Ohmden,60 - 65 Jahre,111,48,63
False,8116053,Ohmden,65 - 75 Jahre,178,92,86
False,8116053,Ohmden,75 und mehr Jahre,107,43,64
False,8116053,Ohmden,Insgesamt,1714,878,836
False,8116054,"Owen, Stadt",unter 3 Jahre,97,47,50
False,8116054,"Owen, Stadt",3 -  6 Jahre,115,65,50
False,8116054,"Owen, Stadt",6 - 10 Jahre,160,76,84
False,8116054,"Owen, Stadt",10 - 15 Jahre,233,135,98
False,8116054,"Owen, Stadt",15 - 18 Jahre,139,70,69
False,8116054,"Owen, Stadt",18 - 20 Jahre,98,65,33
False,8116054,"Owen, Stadt",20 - 25 Jahre,191,106,85
False,8116054,"Owen, Stadt",25 - 30 Jahre,198,92,106
False,8116054,"Owen, Stadt",30 - 35 Jahre,198,100,98
False,8116054,"Owen, Stadt",35 - 40 Jahre,290,143,147
False,8116054,"Owen, Stadt",40 - 45 Jahre,332,174,158
False,8116054,"Owen, Stadt",45 - 50 Jahre,264,128,136
False,8116054,"Owen, Stadt",50 - 55 Jahre,217,105,112
False,8116054,"Owen, Stadt",55 - 60 Jahre,205,113,92
False,8116054,"Owen, Stadt",60 - 65 Jahre,161,88,73
False,8116054,"Owen, Stadt",65 - 75 Jahre,370,183,187
False,8116054,"Owen, Stadt",75 und mehr Jahre,227,90,137
False,8116054,"Owen, Stadt",Insgesamt,3495,1780,1715
False,8116056,"Plochingen, Stadt",unter 3 Jahre,413,218,195
False,8116056,"Plochingen, Stadt",3 -  6 Jahre,423,228,195
False,8116056,"Plochingen, Stadt",6 - 10 Jahre,626,314,312
False,8116056,"Plochingen, Stadt",10 - 15 Jahre,779,385,394
False,8116056,"Plochingen, Stadt",15 - 18 Jahre,480,244,236
False,8116056,"Plochingen, Stadt",18 - 20 Jahre,304,159,145
False,8116056,"Plochingen, Stadt",20 - 25 Jahre,796,392,404
False,8116056,"Plochingen, Stadt",25 - 30 Jahre,877,430,447
False,8116056,"Plochingen, Stadt",30 - 35 Jahre,949,490,459
False,8116056,"Plochingen, Stadt",35 - 40 Jahre,1213,616,597
False,8116056,"Plochingen, Stadt",40 - 45 Jahre,1267,660,607
False,8116056,"Plochingen, Stadt",45 - 50 Jahre,1034,533,501
False,8116056,"Plochingen, Stadt",50 - 55 Jahre,893,454,439
False,8116056,"Plochingen, Stadt",55 - 60 Jahre,837,423,414
False,8116056,"Plochingen, Stadt",60 - 65 Jahre,822,416,406
False,8116056,"Plochingen, Stadt",65 - 75 Jahre,1564,736,828
False,8116056,"Plochingen, Stadt",75 und mehr Jahre,1042,351,691
False,8116056,"Plochingen, Stadt",Insgesamt,14319,7049,7270
False,8116058,Reichenbach an der Fils,unter 3 Jahre,221,116,105
False,8116058,Reichenbach an der Fils,3 -  6 Jahre,248,119,129
False,8116058,Reichenbach an der Fils,6 - 10 Jahre,387,205,182
False,8116058,Reichenbach an der Fils,10 - 15 Jahre,462,229,233
False,8116058,Reichenbach an der Fils,15 - 18 Jahre,286,142,144
False,8116058,Reichenbach an der Fils,18 - 20 Jahre,151,84,67
False,8116058,Reichenbach an der Fils,20 - 25 Jahre,388,203,185
False,8116058,Reichenbach an der Fils,25 - 30 Jahre,420,206,214
False,8116058,Reichenbach an der Fils,30 - 35 Jahre,520,246,274
False,8116058,Reichenbach an der Fils,35 - 40 Jahre,617,297,320
False,8116058,Reichenbach an der Fils,40 - 45 Jahre,756,399,357
False,8116058,Reichenbach an der Fils,45 - 50 Jahre,603,328,275
False,8116058,Reichenbach an der Fils,50 - 55 Jahre,496,254,242
False,8116058,Reichenbach an der Fils,55 - 60 Jahre,413,198,215
False,8116058,Reichenbach an der Fils,60 - 65 Jahre,499,226,273
False,8116058,Reichenbach an der Fils,65 - 75 Jahre,903,432,471
False,8116058,Reichenbach an der Fils,75 und mehr Jahre,659,245,414
False,8116058,Reichenbach an der Fils,Insgesamt,8029,3929,4100
False,8116063,Schlaitdorf,unter 3 Jahre,64,29,35
False,8116063,Schlaitdorf,3 -  6 Jahre,61,30,31
False,8116063,Schlaitdorf,6 - 10 Jahre,79,40,39
False,8116063,Schlaitdorf,10 - 15 Jahre,107,49,58
False,8116063,Schlaitdorf,15 - 18 Jahre,55,19,36
False,8116063,Schlaitdorf,18 - 20 Jahre,46,28,18
False,8116063,Schlaitdorf,20 - 25 Jahre,104,57,47
False,8116063,Schlaitdorf,25 - 30 Jahre,90,51,39
False,8116063,Schlaitdorf,30 - 35 Jahre,97,41,56
False,8116063,Schlaitdorf,35 - 40 Jahre,160,85,75
False,8116063,Schlaitdorf,40 - 45 Jahre,157,85,72
False,8116063,Schlaitdorf,45 - 50 Jahre,154,68,86
False,8116063,Schlaitdorf,50 - 55 Jahre,115,61,54
False,8116063,Schlaitdorf,55 - 60 Jahre,97,49,48
False,8116063,Schlaitdorf,60 - 65 Jahre,82,47,35
False,8116063,Schlaitdorf,65 - 75 Jahre,145,70,75
False,8116063,Schlaitdorf,75 und mehr Jahre,96,34,62
False,8116063,Schlaitdorf,Insgesamt,1709,843,866
False,8116068,Unterensingen,unter 3 Jahre,142,81,61
False,8116068,Unterensingen,3 -  6 Jahre,133,77,56
False,8116068,Unterensingen,6 - 10 Jahre,239,127,112
False,8116068,Unterensingen,10 - 15 Jahre,288,153,135
False,8116068,Unterensingen,15 - 18 Jahre,167,89,78
False,8116068,Unterensingen,18 - 20 Jahre,87,45,42
False,8116068,Unterensingen,20 - 25 Jahre,219,114,105
False,8116068,Unterensingen,25 - 30 Jahre,255,118,137
False,8116068,Unterensingen,30 - 35 Jahre,300,150,150
False,8116068,Unterensingen,35 - 40 Jahre,411,192,219
False,8116068,Unterensingen,40 - 45 Jahre,453,249,204
False,8116068,Unterensingen,45 - 50 Jahre,291,158,133
False,8116068,Unterensingen,50 - 55 Jahre,267,118,149
False,8116068,Unterensingen,55 - 60 Jahre,254,113,141
False,8116068,Unterensingen,60 - 65 Jahre,280,134,146
False,8116068,Unterensingen,65 - 75 Jahre,488,243,245
False,8116068,Unterensingen,75 und mehr Jahre,241,102,139
False,8116068,Unterensingen,Insgesamt,4515,2263,2252
False,8116070,"Weilheim an der Teck, Stadt",unter 3 Jahre,286,148,138
False,8116070,"Weilheim an der Teck, Stadt",3 -  6 Jahre,302,152,150
False,8116070,"Weilheim an der Teck, Stadt",6 - 10 Jahre,471,256,215
False,8116070,"Weilheim an der Teck, Stadt",10 - 15 Jahre,625,318,307
False,8116070,"Weilheim an der Teck, Stadt",15 - 18 Jahre,369,198,171
False,8116070,"Weilheim an der Teck, Stadt",18 - 20 Jahre,239,118,121
False,8116070,"Weilheim an der Teck, Stadt",20 - 25 Jahre,564,278,286
False,8116070,"Weilheim an der Teck, Stadt",25 - 30 Jahre,489,251,238
False,8116070,"Weilheim an der Teck, Stadt",30 - 35 Jahre,522,251,271
False,8116070,"Weilheim an der Teck, Stadt",35 - 40 Jahre,818,398,420
False,8116070,"Weilheim an der Teck, Stadt",40 - 45 Jahre,888,455,433
False,8116070,"Weilheim an der Teck, Stadt",45 - 50 Jahre,783,405,378
False,8116070,"Weilheim an der Teck, Stadt",50 - 55 Jahre,621,323,298
False,8116070,"Weilheim an der Teck, Stadt",55 - 60 Jahre,526,278,248
False,8116070,"Weilheim an der Teck, Stadt",60 - 65 Jahre,497,245,252
False,8116070,"Weilheim an der Teck, Stadt",65 - 75 Jahre,940,461,479
False,8116070,"Weilheim an der Teck, Stadt",75 und mehr Jahre,730,237,493
False,8116070,"Weilheim an der Teck, Stadt",Insgesamt,9670,4772,4898
False,8116071,"Wendlingen am Neckar, Stadt",unter 3 Jahre,420,196,224
False,8116071,"Wendlingen am Neckar, Stadt",3 -  6 Jahre,417,204,213
False,8116071,"Wendlingen am Neckar, Stadt",6 - 10 Jahre,666,319,347
False,8116071,"Wendlingen am Neckar, Stadt",10 - 15 Jahre,942,485,457
False,8116071,"Wendlingen am Neckar, Stadt",15 - 18 Jahre,585,285,300
False,8116071,"Wendlingen am Neckar, Stadt",18 - 20 Jahre,349,183,166
False,8116071,"Wendlingen am Neckar, Stadt",20 - 25 Jahre,828,394,434
False,8116071,"Wendlingen am Neckar, Stadt",25 - 30 Jahre,967,484,483
False,8116071,"Wendlingen am Neckar, Stadt",30 - 35 Jahre,968,495,473
False,8116071,"Wendlingen am Neckar, Stadt",35 - 40 Jahre,1323,668,655
False,8116071,"Wendlingen am Neckar, Stadt",40 - 45 Jahre,1391,738,653
False,8116071,"Wendlingen am Neckar, Stadt",45 - 50 Jahre,1219,613,606
False,8116071,"Wendlingen am Neckar, Stadt",50 - 55 Jahre,949,468,481
False,8116071,"Wendlingen am Neckar, Stadt",55 - 60 Jahre,955,444,511
False,8116071,"Wendlingen am Neckar, Stadt",60 - 65 Jahre,921,453,468
False,8116071,"Wendlingen am Neckar, Stadt",65 - 75 Jahre,1768,864,904
False,8116071,"Wendlingen am Neckar, Stadt",75 und mehr Jahre,1043,363,680
False,8116071,"Wendlingen am Neckar, Stadt",Insgesamt,15711,7656,8055
False,8116072,"Wernau (Neckar), Stadt",unter 3 Jahre,332,176,156
False,8116072,"Wernau (Neckar), Stadt",3 -  6 Jahre,366,180,186
False,8116072,"Wernau (Neckar), Stadt",6 - 10 Jahre,506,265,241
False,8116072,"Wernau (Neckar), Stadt",10 - 15 Jahre,604,305,299
False,8116072,"Wernau (Neckar), Stadt",15 - 18 Jahre,414,204,210
False,8116072,"Wernau (Neckar), Stadt",18 - 20 Jahre,251,130,121
False,8116072,"Wernau (Neckar), Stadt",20 - 25 Jahre,653,324,329
False,8116072,"Wernau (Neckar), Stadt",25 - 30 Jahre,717,377,340
False,8116072,"Wernau (Neckar), Stadt",30 - 35 Jahre,834,411,423
False,8116072,"Wernau (Neckar), Stadt",35 - 40 Jahre,1019,524,495
False,8116072,"Wernau (Neckar), Stadt",40 - 45 Jahre,1063,544,519
False,8116072,"Wernau (Neckar), Stadt",45 - 50 Jahre,844,475,369
False,8116072,"Wernau (Neckar), Stadt",50 - 55 Jahre,775,369,406
False,8116072,"Wernau (Neckar), Stadt",55 - 60 Jahre,718,374,344
False,8116072,"Wernau (Neckar), Stadt",60 - 65 Jahre,667,298,369
False,8116072,"Wernau (Neckar), Stadt",65 - 75 Jahre,1505,697,808
False,8116072,"Wernau (Neckar), Stadt",75 und mehr Jahre,1120,446,674
False,8116072,"Wernau (Neckar), Stadt",Insgesamt,12388,6099,6289
False,8116073,Wolfschlugen,unter 3 Jahre,177,95,82
False,8116073,Wolfschlugen,3 -  6 Jahre,212,106,106
False,8116073,Wolfschlugen,6 - 10 Jahre,249,119,130
False,8116073,Wolfschlugen,10 - 15 Jahre,338,178,160
False,8116073,Wolfschlugen,15 - 18 Jahre,221,100,121
False,8116073,Wolfschlugen,18 - 20 Jahre,146,76,70
False,8116073,Wolfschlugen,20 - 25 Jahre,316,157,159
False,8116073,Wolfschlugen,25 - 30 Jahre,402,200,202
False,8116073,Wolfschlugen,30 - 35 Jahre,403,196,207
False,8116073,Wolfschlugen,35 - 40 Jahre,550,286,264
False,8116073,Wolfschlugen,40 - 45 Jahre,558,288,270
False,8116073,Wolfschlugen,45 - 50 Jahre,533,272,261
False,8116073,Wolfschlugen,50 - 55 Jahre,431,204,227
False,8116073,Wolfschlugen,55 - 60 Jahre,366,182,184
False,8116073,Wolfschlugen,60 - 65 Jahre,392,197,195
False,8116073,Wolfschlugen,65 - 75 Jahre,596,299,297
False,8116073,Wolfschlugen,75 und mehr Jahre,374,152,222
False,8116073,Wolfschlugen,Insgesamt,6264,3107,3157
False,8116076,Aichwald,unter 3 Jahre,201,106,95
False,8116076,Aichwald,3 -  6 Jahre,233,116,117
False,8116076,Aichwald,6 - 10 Jahre,334,164,170
False,8116076,Aichwald,10 - 15 Jahre,407,203,204
False,8116076,Aichwald,15 - 18 Jahre,257,143,114
False,8116076,Aichwald,18 - 20 Jahre,154,85,69
False,8116076,Aichwald,20 - 25 Jahre,374,189,185
False,8116076,Aichwald,25 - 30 Jahre,374,175,199
False,8116076,Aichwald,30 - 35 Jahre,394,195,199
False,8116076,Aichwald,35 - 40 Jahre,630,307,323
False,8116076,Aichwald,40 - 45 Jahre,608,310,298
False,8116076,Aichwald,45 - 50 Jahre,566,276,290
False,8116076,Aichwald,50 - 55 Jahre,502,237,265
False,8116076,Aichwald,55 - 60 Jahre,541,246,295
False,8116076,Aichwald,60 - 65 Jahre,612,302,310
False,8116076,Aichwald,65 - 75 Jahre,1009,498,511
False,8116076,Aichwald,75 und mehr Jahre,548,229,319
False,8116076,Aichwald,Insgesamt,7744,3781,3963
False,8116077,"Filderstadt, Stadt",unter 3 Jahre,1336,724,612
False,8116077,"Filderstadt, Stadt",3 -  6 Jahre,1375,668,707
False,8116077,"Filderstadt, Stadt",6 - 10 Jahre,1935,975,960
False,8116077,"Filderstadt, Stadt",10 - 15 Jahre,2460,1246,1214
False,8116077,"Filderstadt, Stadt",15 - 18 Jahre,1430,747,683
False,8116077,"Filderstadt, Stadt",18 - 20 Jahre,918,486,432
False,8116077,"Filderstadt, Stadt",20 - 25 Jahre,2327,1099,1228
False,8116077,"Filderstadt, Stadt",25 - 30 Jahre,2777,1363,1414
False,8116077,"Filderstadt, Stadt",30 - 35 Jahre,3071,1510,1561
False,8116077,"Filderstadt, Stadt",35 - 40 Jahre,4096,2058,2038
False,8116077,"Filderstadt, Stadt",40 - 45 Jahre,4024,2060,1964
False,8116077,"Filderstadt, Stadt",45 - 50 Jahre,3469,1751,1718
False,8116077,"Filderstadt, Stadt",50 - 55 Jahre,2760,1350,1410
False,8116077,"Filderstadt, Stadt",55 - 60 Jahre,2651,1277,1374
False,8116077,"Filderstadt, Stadt",60 - 65 Jahre,2403,1231,1172
False,8116077,"Filderstadt, Stadt",65 - 75 Jahre,4134,1973,2161
False,8116077,"Filderstadt, Stadt",75 und mehr Jahre,2551,889,1662
False,8116077,"Filderstadt, Stadt",Insgesamt,43717,21407,22310
False,8116078,"Leinfelden-Echterdingen, Stadt",unter 3 Jahre,1044,545,499
False,8116078,"Leinfelden-Echterdingen, Stadt",3 -  6 Jahre,1019,547,472
False,8116078,"Leinfelden-Echterdingen, Stadt",6 - 10 Jahre,1391,703,688
False,8116078,"Leinfelden-Echterdingen, Stadt",10 - 15 Jahre,1719,881,838
False,8116078,"Leinfelden-Echterdingen, Stadt",15 - 18 Jahre,1109,565,544
False,8116078,"Leinfelden-Echterdingen, Stadt",18 - 20 Jahre,741,381,360
False,8116078,"Leinfelden-Echterdingen, Stadt",20 - 25 Jahre,1902,968,934
False,8116078,"Leinfelden-Echterdingen, Stadt",25 - 30 Jahre,2206,1088,1118
False,8116078,"Leinfelden-Echterdingen, Stadt",30 - 35 Jahre,2613,1363,1250
False,8116078,"Leinfelden-Echterdingen, Stadt",35 - 40 Jahre,3199,1605,1594
False,8116078,"Leinfelden-Echterdingen, Stadt",40 - 45 Jahre,3467,1809,1658
False,8116078,"Leinfelden-Echterdingen, Stadt",45 - 50 Jahre,2779,1445,1334
False,8116078,"Leinfelden-Echterdingen, Stadt",50 - 55 Jahre,2336,1159,1177
False,8116078,"Leinfelden-Echterdingen, Stadt",55 - 60 Jahre,2216,1052,1164
False,8116078,"Leinfelden-Echterdingen, Stadt",60 - 65 Jahre,2433,1190,1243
False,8116078,"Leinfelden-Echterdingen, Stadt",65 - 75 Jahre,4152,1936,2216
False,8116078,"Leinfelden-Echterdingen, Stadt",75 und mehr Jahre,2709,989,1720
False,8116078,"Leinfelden-Echterdingen, Stadt",Insgesamt,37035,18226,18809
False,8116079,Lenningen,unter 3 Jahre,203,105,98
False,8116079,Lenningen,3 -  6 Jahre,266,134,132
False,8116079,Lenningen,6 - 10 Jahre,382,207,175
False,8116079,Lenningen,10 - 15 Jahre,538,295,243
False,8116079,Lenningen,15 - 18 Jahre,360,191,169
False,8116079,Lenningen,18 - 20 Jahre,223,111,112
False,8116079,Lenningen,20 - 25 Jahre,489,249,240
False,8116079,Lenningen,25 - 30 Jahre,386,213,173
False,8116079,Lenningen,30 - 35 Jahre,457,229,228
False,8116079,Lenningen,35 - 40 Jahre,679,347,332
False,8116079,Lenningen,40 - 45 Jahre,797,423,374
False,8116079,Lenningen,45 - 50 Jahre,681,362,319
False,8116079,Lenningen,50 - 55 Jahre,529,258,271
False,8116079,Lenningen,55 - 60 Jahre,521,267,254
False,8116079,Lenningen,60 - 65 Jahre,463,239,224
False,8116079,Lenningen,65 - 75 Jahre,986,488,498
False,8116079,Lenningen,75 und mehr Jahre,612,238,374
False,8116079,Lenningen,Insgesamt,8572,4356,4216
False,8116080,"Ostfildern, Stadt",unter 3 Jahre,1028,563,465
False,8116080,"Ostfildern, Stadt",3 -  6 Jahre,1063,551,512
False,8116080,"Ostfildern, Stadt",6 - 10 Jahre,1460,769,691
False,8116080,"Ostfildern, Stadt",10 - 15 Jahre,1750,869,881
False,8116080,"Ostfildern, Stadt",15 - 18 Jahre,1076,545,531
False,8116080,"Ostfildern, Stadt",18 - 20 Jahre,726,348,378
False,8116080,"Ostfildern, Stadt",20 - 25 Jahre,1873,945,928
False,8116080,"Ostfildern, Stadt",25 - 30 Jahre,2077,986,1091
False,8116080,"Ostfildern, Stadt",30 - 35 Jahre,2471,1253,1218
False,8116080,"Ostfildern, Stadt",35 - 40 Jahre,2947,1499,1448
False,8116080,"Ostfildern, Stadt",40 - 45 Jahre,3016,1522,1494
False,8116080,"Ostfildern, Stadt",45 - 50 Jahre,2487,1237,1250
False,8116080,"Ostfildern, Stadt",50 - 55 Jahre,2167,1034,1133
False,8116080,"Ostfildern, Stadt",55 - 60 Jahre,2014,954,1060
False,8116080,"Ostfildern, Stadt",60 - 65 Jahre,1982,999,983
False,8116080,"Ostfildern, Stadt",65 - 75 Jahre,3588,1712,1876
False,8116080,"Ostfildern, Stadt",75 und mehr Jahre,2397,924,1473
False,8116080,"Ostfildern, Stadt",Insgesamt,34122,16710,17412
False,8116081,"Aichtal, Stadt",unter 3 Jahre,281,147,134
False,8116081,"Aichtal, Stadt",3 -  6 Jahre,306,139,167
False,8116081,"Aichtal, Stadt",6 - 10 Jahre,422,226,196
False,8116081,"Aichtal, Stadt",10 - 15 Jahre,598,307,291
False,8116081,"Aichtal, Stadt",15 - 18 Jahre,350,166,184
False,8116081,"Aichtal, Stadt",18 - 20 Jahre,244,128,116
False,8116081,"Aichtal, Stadt",20 - 25 Jahre,511,278,233
False,8116081,"Aichtal, Stadt",25 - 30 Jahre,508,269,239
False,8116081,"Aichtal, Stadt",30 - 35 Jahre,564,285,279
False,8116081,"Aichtal, Stadt",35 - 40 Jahre,897,450,447
False,8116081,"Aichtal, Stadt",40 - 45 Jahre,922,449,473
False,8116081,"Aichtal, Stadt",45 - 50 Jahre,845,446,399
False,8116081,"Aichtal, Stadt",50 - 55 Jahre,679,340,339
False,8116081,"Aichtal, Stadt",55 - 60 Jahre,628,328,300
False,8116081,"Aichtal, Stadt",60 - 65 Jahre,554,313,241
False,8116081,"Aichtal, Stadt",65 - 75 Jahre,895,426,469
False,8116081,"Aichtal, Stadt",75 und mehr Jahre,567,200,367
False,8116081,"Aichtal, Stadt",Insgesamt,9771,4897,4874
False,8117,Landkreis Göppingen,unter 3 Jahre,6739,3465,3274
False,8117,Landkreis Göppingen,3 -  6 Jahre,7504,3893,3611
False,8117,Landkreis Göppingen,6 - 10 Jahre,11232,5837,5395
False,8117,Landkreis Göppingen,10 - 15 Jahre,14983,7779,7204
False,8117,Landkreis Göppingen,15 - 18 Jahre,9473,4883,4590
False,8117,Landkreis Göppingen,18 - 20 Jahre,6142,3114,3028
False,8117,Landkreis Göppingen,20 - 25 Jahre,14641,7541,7100
False,8117,Landkreis Göppingen,25 - 30 Jahre,14196,7163,7033
False,8117,Landkreis Göppingen,30 - 35 Jahre,15560,7786,7774
False,8117,Landkreis Göppingen,35 - 40 Jahre,20818,10620,10198
False,8117,Landkreis Göppingen,40 - 45 Jahre,21675,11221,10454
False,8117,Landkreis Göppingen,45 - 50 Jahre,19241,9785,9456
False,8117,Landkreis Göppingen,50 - 55 Jahre,16695,8290,8405
False,8117,Landkreis Göppingen,55 - 60 Jahre,15105,7535,7570
False,8117,Landkreis Göppingen,60 - 65 Jahre,14455,7162,7293
False,8117,Landkreis Göppingen,65 - 75 Jahre,28023,13362,14661
False,8117,Landkreis Göppingen,75 und mehr Jahre,21301,7515,13786
False,8117,Landkreis Göppingen,Insgesamt,257783,126951,130832
False,8117001,Adelberg,unter 3 Jahre,56,31,25
False,8117001,Adelberg,3 -  6 Jahre,65,36,29
False,8117001,Adelberg,6 - 10 Jahre,89,45,44
False,8117001,Adelberg,10 - 15 Jahre,120,60,60
False,8117001,Adelberg,15 - 18 Jahre,66,34,32
False,8117001,Adelberg,18 - 20 Jahre,50,24,26
False,8117001,Adelberg,20 - 25 Jahre,116,73,43
False,8117001,Adelberg,25 - 30 Jahre,81,41,40
False,8117001,Adelberg,30 - 35 Jahre,109,45,64
False,8117001,Adelberg,35 - 40 Jahre,191,99,92
False,8117001,Adelberg,40 - 45 Jahre,194,101,93
False,8117001,Adelberg,45 - 50 Jahre,138,70,68
False,8117001,Adelberg,50 - 55 Jahre,157,69,88
False,8117001,Adelberg,55 - 60 Jahre,133,71,62
False,8117001,Adelberg,60 - 65 Jahre,117,55,62
False,8117001,Adelberg,65 - 75 Jahre,209,112,97
False,8117001,Adelberg,75 und mehr Jahre,151,55,96
False,8117001,Adelberg,Insgesamt,2042,1021,1021
False,8117002,Aichelberg,unter 3 Jahre,29,15,14
False,8117002,Aichelberg,3 -  6 Jahre,44,18,26
False,8117002,Aichelberg,6 - 10 Jahre,69,42,27
False,8117002,Aichelberg,10 - 15 Jahre,70,40,30
False,8117002,Aichelberg,15 - 18 Jahre,38,24,14
False,8117002,Aichelberg,18 - 20 Jahre,25,12,13
False,8117002,Aichelberg,20 - 25 Jahre,52,35,17
False,8117002,Aichelberg,25 - 30 Jahre,69,34,35
False,8117002,Aichelberg,30 - 35 Jahre,76,35,41
False,8117002,Aichelberg,35 - 40 Jahre,129,69,60
False,8117002,Aichelberg,40 - 45 Jahre,114,60,54
False,8117002,Aichelberg,45 - 50 Jahre,96,48,48
False,8117002,Aichelberg,50 - 55 Jahre,82,41,41
False,8117002,Aichelberg,55 - 60 Jahre,88,53,35
False,8117002,Aichelberg,60 - 65 Jahre,64,30,34
False,8117002,Aichelberg,65 - 75 Jahre,107,49,58
False,8117002,Aichelberg,75 und mehr Jahre,79,31,48
False,8117002,Aichelberg,Insgesamt,1231,636,595
False,8117003,Albershausen,unter 3 Jahre,104,59,45
False,8117003,Albershausen,3 -  6 Jahre,120,67,53
False,8117003,Albershausen,6 - 10 Jahre,217,110,107
False,8117003,Albershausen,10 - 15 Jahre,285,167,118
False,8117003,Albershausen,15 - 18 Jahre,141,71,70
False,8117003,Albershausen,18 - 20 Jahre,100,45,55
False,8117003,Albershausen,20 - 25 Jahre,238,130,108
False,8117003,Albershausen,25 - 30 Jahre,240,112,128
False,8117003,Albershausen,30 - 35 Jahre,261,125,136
False,8117003,Albershausen,35 - 40 Jahre,400,202,198
False,8117003,Albershausen,40 - 45 Jahre,404,208,196
False,8117003,Albershausen,45 - 50 Jahre,311,146,165
False,8117003,Albershausen,50 - 55 Jahre,267,132,135
False,8117003,Albershausen,55 - 60 Jahre,243,129,114
False,8117003,Albershausen,60 - 65 Jahre,248,124,124
False,8117003,Albershausen,65 - 75 Jahre,483,223,260
False,8117003,Albershausen,75 und mehr Jahre,277,124,153
False,8117003,Albershausen,Insgesamt,4339,2174,2165
False,8117006,Bad Ditzenbach,unter 3 Jahre,85,52,33
False,8117006,Bad Ditzenbach,3 -  6 Jahre,89,46,43
False,8117006,Bad Ditzenbach,6 - 10 Jahre,162,77,85
False,8117006,Bad Ditzenbach,10 - 15 Jahre,249,127,122
False,8117006,Bad Ditzenbach,15 - 18 Jahre,140,74,66
False,8117006,Bad Ditzenbach,18 - 20 Jahre,89,39,50
False,8117006,Bad Ditzenbach,20 - 25 Jahre,195,88,107
False,8117006,Bad Ditzenbach,25 - 30 Jahre,191,100,91
False,8117006,Bad Ditzenbach,30 - 35 Jahre,218,106,112
False,8117006,Bad Ditzenbach,35 - 40 Jahre,310,157,153
False,8117006,Bad Ditzenbach,40 - 45 Jahre,348,172,176
False,8117006,Bad Ditzenbach,45 - 50 Jahre,303,161,142
False,8117006,Bad Ditzenbach,50 - 55 Jahre,245,132,113
False,8117006,Bad Ditzenbach,55 - 60 Jahre,198,96,102
False,8117006,Bad Ditzenbach,60 - 65 Jahre,199,103,96
False,8117006,Bad Ditzenbach,65 - 75 Jahre,398,187,211
False,8117006,Bad Ditzenbach,75 und mehr Jahre,318,112,206
False,8117006,Bad Ditzenbach,Insgesamt,3737,1829,1908
False,8117007,Bad Überkingen,unter 3 Jahre,84,43,41
False,8117007,Bad Überkingen,3 -  6 Jahre,119,65,54
False,8117007,Bad Überkingen,6 - 10 Jahre,176,86,90
False,8117007,Bad Überkingen,10 - 15 Jahre,245,130,115
False,8117007,Bad Überkingen,15 - 18 Jahre,152,73,79
False,8117007,Bad Überkingen,18 - 20 Jahre,83,39,44
False,8117007,Bad Überkingen,20 - 25 Jahre,195,84,111
False,8117007,Bad Überkingen,25 - 30 Jahre,219,106,113
False,8117007,Bad Überkingen,30 - 35 Jahre,196,96,100
False,8117007,Bad Überkingen,35 - 40 Jahre,315,139,176
False,8117007,Bad Überkingen,40 - 45 Jahre,315,167,148
False,8117007,Bad Überkingen,45 - 50 Jahre,250,124,126
False,8117007,Bad Überkingen,50 - 55 Jahre,238,101,137
False,8117007,Bad Überkingen,55 - 60 Jahre,210,106,104
False,8117007,Bad Überkingen,60 - 65 Jahre,269,115,154
False,8117007,Bad Überkingen,65 - 75 Jahre,496,228,268
False,8117007,Bad Überkingen,75 und mehr Jahre,430,158,272
False,8117007,Bad Überkingen,Insgesamt,3992,1860,2132
False,8117009,Birenbach,unter 3 Jahre,53,25,28
False,8117009,Birenbach,3 -  6 Jahre,68,36,32
False,8117009,Birenbach,6 - 10 Jahre,81,42,39
False,8117009,Birenbach,10 - 15 Jahre,121,53,68
False,8117009,Birenbach,15 - 18 Jahre,81,42,39
False,8117009,Birenbach,18 - 20 Jahre,42,20,22
False,8117009,Birenbach,20 - 25 Jahre,83,48,35
False,8117009,Birenbach,25 - 30 Jahre,82,36,46
False,8117009,Birenbach,30 - 35 Jahre,90,43,47
False,8117009,Birenbach,35 - 40 Jahre,149,60,89
False,8117009,Birenbach,40 - 45 Jahre,163,98,65
False,8117009,Birenbach,45 - 50 Jahre,165,88,77
False,8117009,Birenbach,50 - 55 Jahre,138,67,71
False,8117009,Birenbach,55 - 60 Jahre,120,55,65
False,8117009,Birenbach,60 - 65 Jahre,126,57,69
False,8117009,Birenbach,65 - 75 Jahre,215,111,104
False,8117009,Birenbach,75 und mehr Jahre,120,45,75
False,8117009,Birenbach,Insgesamt,1897,926,971
False,8117010,Böhmenkirch,unter 3 Jahre,157,86,71
False,8117010,Böhmenkirch,3 -  6 Jahre,171,96,75
False,8117010,Böhmenkirch,6 - 10 Jahre,292,146,146
False,8117010,Böhmenkirch,10 - 15 Jahre,374,200,174
False,8117010,Böhmenkirch,15 - 18 Jahre,226,124,102
False,8117010,Böhmenkirch,18 - 20 Jahre,150,80,70
False,8117010,Böhmenkirch,20 - 25 Jahre,323,166,157
False,8117010,Böhmenkirch,25 - 30 Jahre,302,150,152
False,8117010,Böhmenkirch,30 - 35 Jahre,333,185,148
False,8117010,Böhmenkirch,35 - 40 Jahre,506,240,266
False,8117010,Böhmenkirch,40 - 45 Jahre,558,288,270
False,8117010,Böhmenkirch,45 - 50 Jahre,392,207,185
False,8117010,Böhmenkirch,50 - 55 Jahre,348,186,162
False,8117010,Böhmenkirch,55 - 60 Jahre,301,142,159
False,8117010,Böhmenkirch,60 - 65 Jahre,267,130,137
False,8117010,Böhmenkirch,65 - 75 Jahre,521,258,263
False,8117010,Böhmenkirch,75 und mehr Jahre,380,147,233
False,8117010,Böhmenkirch,Insgesamt,5601,2831,2770
False,8117011,Börtlingen,unter 3 Jahre,44,18,26
False,8117011,Börtlingen,3 -  6 Jahre,55,29,26
False,8117011,Börtlingen,6 - 10 Jahre,91,53,38
False,8117011,Börtlingen,10 - 15 Jahre,104,51,53
False,8117011,Börtlingen,15 - 18 Jahre,62,34,28
False,8117011,Börtlingen,18 - 20 Jahre,39,23,16
False,8117011,Börtlingen,20 - 25 Jahre,97,48,49
False,8117011,Börtlingen,25 - 30 Jahre,93,41,52
False,8117011,Börtlingen,30 - 35 Jahre,81,41,40
False,8117011,Börtlingen,35 - 40 Jahre,147,67,80
False,8117011,Börtlingen,40 - 45 Jahre,139,81,58
False,8117011,Börtlingen,45 - 50 Jahre,141,67,74
False,8117011,Börtlingen,50 - 55 Jahre,145,76,69
False,8117011,Börtlingen,55 - 60 Jahre,115,58,57
False,8117011,Börtlingen,60 - 65 Jahre,106,54,52
False,8117011,Börtlingen,65 - 75 Jahre,194,92,102
False,8117011,Börtlingen,75 und mehr Jahre,145,50,95
False,8117011,Börtlingen,Insgesamt,1798,883,915
False,8117012,Bad Boll,unter 3 Jahre,175,99,76
False,8117012,Bad Boll,3 -  6 Jahre,148,79,69
False,8117012,Bad Boll,6 - 10 Jahre,236,117,119
False,8117012,Bad Boll,10 - 15 Jahre,315,170,145
False,8117012,Bad Boll,15 - 18 Jahre,208,106,102
False,8117012,Bad Boll,18 - 20 Jahre,134,76,58
False,8117012,Bad Boll,20 - 25 Jahre,227,122,105
False,8117012,Bad Boll,25 - 30 Jahre,245,130,115
False,8117012,Bad Boll,30 - 35 Jahre,340,165,175
False,8117012,Bad Boll,35 - 40 Jahre,459,204,255
False,8117012,Bad Boll,40 - 45 Jahre,451,206,245
False,8117012,Bad Boll,45 - 50 Jahre,401,192,209
False,8117012,Bad Boll,50 - 55 Jahre,318,151,167
False,8117012,Bad Boll,55 - 60 Jahre,306,148,158
False,8117012,Bad Boll,60 - 65 Jahre,249,106,143
False,8117012,Bad Boll,65 - 75 Jahre,531,245,286
False,8117012,Bad Boll,75 und mehr Jahre,527,170,357
False,8117012,Bad Boll,Insgesamt,5270,2486,2784
False,8117014,Deggingen,unter 3 Jahre,140,78,62
False,8117014,Deggingen,3 -  6 Jahre,177,89,88
False,8117014,Deggingen,6 - 10 Jahre,223,109,114
False,8117014,Deggingen,10 - 15 Jahre,290,170,120
False,8117014,Deggingen,15 - 18 Jahre,217,105,112
False,8117014,Deggingen,18 - 20 Jahre,146,72,74
False,8117014,Deggingen,20 - 25 Jahre,319,167,152
False,8117014,Deggingen,25 - 30 Jahre,267,140,127
False,8117014,Deggingen,30 - 35 Jahre,321,157,164
False,8117014,Deggingen,35 - 40 Jahre,455,224,231
False,8117014,Deggingen,40 - 45 Jahre,500,262,238
False,8117014,Deggingen,45 - 50 Jahre,397,211,186
False,8117014,Deggingen,50 - 55 Jahre,389,185,204
False,8117014,Deggingen,55 - 60 Jahre,327,168,159
False,8117014,Deggingen,60 - 65 Jahre,340,160,180
False,8117014,Deggingen,65 - 75 Jahre,666,332,334
False,8117014,Deggingen,75 und mehr Jahre,490,173,317
False,8117014,Deggingen,Insgesamt,5664,2802,2862
False,8117015,"Donzdorf, Stadt",unter 3 Jahre,282,152,130
False,8117015,"Donzdorf, Stadt",3 -  6 Jahre,349,183,166
False,8117015,"Donzdorf, Stadt",6 - 10 Jahre,492,273,219
False,8117015,"Donzdorf, Stadt",10 - 15 Jahre,659,332,327
False,8117015,"Donzdorf, Stadt",15 - 18 Jahre,433,237,196
False,8117015,"Donzdorf, Stadt",18 - 20 Jahre,231,103,128
False,8117015,"Donzdorf, Stadt",20 - 25 Jahre,635,325,310
False,8117015,"Donzdorf, Stadt",25 - 30 Jahre,608,315,293
False,8117015,"Donzdorf, Stadt",30 - 35 Jahre,641,313,328
False,8117015,"Donzdorf, Stadt",35 - 40 Jahre,903,465,438
False,8117015,"Donzdorf, Stadt",40 - 45 Jahre,905,481,424
False,8117015,"Donzdorf, Stadt",45 - 50 Jahre,808,413,395
False,8117015,"Donzdorf, Stadt",50 - 55 Jahre,691,328,363
False,8117015,"Donzdorf, Stadt",55 - 60 Jahre,714,360,354
False,8117015,"Donzdorf, Stadt",60 - 65 Jahre,661,326,335
False,8117015,"Donzdorf, Stadt",65 - 75 Jahre,1256,630,626
False,8117015,"Donzdorf, Stadt",75 und mehr Jahre,805,298,507
False,8117015,"Donzdorf, Stadt",Insgesamt,11073,5534,5539
False,8117016,Drackenstein,unter 3 Jahre,8,4,4
False,8117016,Drackenstein,3 -  6 Jahre,13,2,11
False,8117016,Drackenstein,6 - 10 Jahre,25,10,15
False,8117016,Drackenstein,10 - 15 Jahre,27,13,14
False,8117016,Drackenstein,15 - 18 Jahre,13,9,4
False,8117016,Drackenstein,18 - 20 Jahre,11,7,4
False,8117016,Drackenstein,20 - 25 Jahre,25,15,10
False,8117016,Drackenstein,25 - 30 Jahre,33,17,16
False,8117016,Drackenstein,30 - 35 Jahre,29,15,14
False,8117016,Drackenstein,35 - 40 Jahre,31,12,19
False,8117016,Drackenstein,40 - 45 Jahre,45,24,21
False,8117016,Drackenstein,45 - 50 Jahre,32,16,16
False,8117016,Drackenstein,50 - 55 Jahre,31,17,14
False,8117016,Drackenstein,55 - 60 Jahre,30,17,13
False,8117016,Drackenstein,60 - 65 Jahre,16,10,6
False,8117016,Drackenstein,65 - 75 Jahre,40,22,18
False,8117016,Drackenstein,75 und mehr Jahre,22,7,15
False,8117016,Drackenstein,Insgesamt,431,217,214
False,8117017,Dürnau,unter 3 Jahre,65,32,33
False,8117017,Dürnau,3 -  6 Jahre,58,32,26
False,8117017,Dürnau,6 - 10 Jahre,119,60,59
False,8117017,Dürnau,10 - 15 Jahre,165,88,77
False,8117017,Dürnau,15 - 18 Jahre,73,30,43
False,8117017,Dürnau,18 - 20 Jahre,50,31,19
False,8117017,Dürnau,20 - 25 Jahre,99,52,47
False,8117017,Dürnau,25 - 30 Jahre,99,55,44
False,8117017,Dürnau,30 - 35 Jahre,93,41,52
False,8117017,Dürnau,35 - 40 Jahre,215,112,103
False,8117017,Dürnau,40 - 45 Jahre,215,116,99
False,8117017,Dürnau,45 - 50 Jahre,166,88,78
False,8117017,Dürnau,50 - 55 Jahre,134,69,65
False,8117017,Dürnau,55 - 60 Jahre,137,74,63
False,8117017,Dürnau,60 - 65 Jahre,91,42,49
False,8117017,Dürnau,65 - 75 Jahre,198,92,106
False,8117017,Dürnau,75 und mehr Jahre,115,47,68
False,8117017,Dürnau,Insgesamt,2092,1061,1031
False,8117018,"Ebersbach an der Fils, Stadt",unter 3 Jahre,367,185,182
False,8117018,"Ebersbach an der Fils, Stadt",3 -  6 Jahre,444,225,219
False,8117018,"Ebersbach an der Fils, Stadt",6 - 10 Jahre,676,341,335
False,8117018,"Ebersbach an der Fils, Stadt",10 - 15 Jahre,963,514,449
False,8117018,"Ebersbach an der Fils, Stadt",15 - 18 Jahre,592,279,313
False,8117018,"Ebersbach an der Fils, Stadt",18 - 20 Jahre,340,172,168
False,8117018,"Ebersbach an der Fils, Stadt",20 - 25 Jahre,896,466,430
False,8117018,"Ebersbach an der Fils, Stadt",25 - 30 Jahre,817,400,417
False,8117018,"Ebersbach an der Fils, Stadt",30 - 35 Jahre,950,443,507
False,8117018,"Ebersbach an der Fils, Stadt",35 - 40 Jahre,1243,625,618
False,8117018,"Ebersbach an der Fils, Stadt",40 - 45 Jahre,1375,721,654
False,8117018,"Ebersbach an der Fils, Stadt",45 - 50 Jahre,1224,633,591
False,8117018,"Ebersbach an der Fils, Stadt",50 - 55 Jahre,993,485,508
False,8117018,"Ebersbach an der Fils, Stadt",55 - 60 Jahre,911,482,429
False,8117018,"Ebersbach an der Fils, Stadt",60 - 65 Jahre,953,449,504
False,8117018,"Ebersbach an der Fils, Stadt",65 - 75 Jahre,1800,896,904
False,8117018,"Ebersbach an der Fils, Stadt",75 und mehr Jahre,1185,456,729
False,8117018,"Ebersbach an der Fils, Stadt",Insgesamt,15729,7772,7957
False,8117019,"Eislingen/Fils, Stadt",unter 3 Jahre,604,309,295
False,8117019,"Eislingen/Fils, Stadt",3 -  6 Jahre,676,346,330
False,8117019,"Eislingen/Fils, Stadt",6 - 10 Jahre,822,391,431
False,8117019,"Eislingen/Fils, Stadt",10 - 15 Jahre,1105,559,546
False,8117019,"Eislingen/Fils, Stadt",15 - 18 Jahre,706,383,323
False,8117019,"Eislingen/Fils, Stadt",18 - 20 Jahre,495,241,254
False,8117019,"Eislingen/Fils, Stadt",20 - 25 Jahre,1262,649,613
False,8117019,"Eislingen/Fils, Stadt",25 - 30 Jahre,1305,661,644
False,8117019,"Eislingen/Fils, Stadt",30 - 35 Jahre,1345,686,659
False,8117019,"Eislingen/Fils, Stadt",35 - 40 Jahre,1590,813,777
False,8117019,"Eislingen/Fils, Stadt",40 - 45 Jahre,1618,841,777
False,8117019,"Eislingen/Fils, Stadt",45 - 50 Jahre,1508,750,758
False,8117019,"Eislingen/Fils, Stadt",50 - 55 Jahre,1351,653,698
False,8117019,"Eislingen/Fils, Stadt",55 - 60 Jahre,1249,622,627
False,8117019,"Eislingen/Fils, Stadt",60 - 65 Jahre,1084,540,544
False,8117019,"Eislingen/Fils, Stadt",65 - 75 Jahre,2044,987,1057
False,8117019,"Eislingen/Fils, Stadt",75 und mehr Jahre,1682,568,1114
False,8117019,"Eislingen/Fils, Stadt",Insgesamt,20446,9999,10447
False,8117020,Eschenbach,unter 3 Jahre,59,26,33
False,8117020,Eschenbach,3 -  6 Jahre,67,38,29
False,8117020,Eschenbach,6 - 10 Jahre,93,51,42
False,8117020,Eschenbach,10 - 15 Jahre,110,60,50
False,8117020,Eschenbach,15 - 18 Jahre,71,38,33
False,8117020,Eschenbach,18 - 20 Jahre,46,21,25
False,8117020,Eschenbach,20 - 25 Jahre,137,76,61
False,8117020,Eschenbach,25 - 30 Jahre,138,76,62
False,8117020,Eschenbach,30 - 35 Jahre,152,78,74
False,8117020,Eschenbach,35 - 40 Jahre,182,85,97
False,8117020,Eschenbach,40 - 45 Jahre,185,98,87
False,8117020,Eschenbach,45 - 50 Jahre,173,87,86
False,8117020,Eschenbach,50 - 55 Jahre,181,82,99
False,8117020,Eschenbach,55 - 60 Jahre,139,71,68
False,8117020,Eschenbach,60 - 65 Jahre,115,61,54
False,8117020,Eschenbach,65 - 75 Jahre,223,100,123
False,8117020,Eschenbach,75 und mehr Jahre,161,71,90
False,8117020,Eschenbach,Insgesamt,2232,1119,1113
False,8117023,Gammelshausen,unter 3 Jahre,30,14,16
False,8117023,Gammelshausen,3 -  6 Jahre,26,17,9
False,8117023,Gammelshausen,6 - 10 Jahre,51,33,18
False,8117023,Gammelshausen,10 - 15 Jahre,89,47,42
False,8117023,Gammelshausen,15 - 18 Jahre,60,39,21
False,8117023,Gammelshausen,18 - 20 Jahre,31,14,17
False,8117023,Gammelshausen,20 - 25 Jahre,75,34,41
False,8117023,Gammelshausen,25 - 30 Jahre,64,32,32
False,8117023,Gammelshausen,30 - 35 Jahre,83,34,49
False,8117023,Gammelshausen,35 - 40 Jahre,120,72,48
False,8117023,Gammelshausen,40 - 45 Jahre,121,57,64
False,8117023,Gammelshausen,45 - 50 Jahre,107,56,51
False,8117023,Gammelshausen,50 - 55 Jahre,96,43,53
False,8117023,Gammelshausen,55 - 60 Jahre,98,52,46
False,8117023,Gammelshausen,60 - 65 Jahre,79,35,44
False,8117023,Gammelshausen,65 - 75 Jahre,181,88,93
False,8117023,Gammelshausen,75 und mehr Jahre,104,46,58
False,8117023,Gammelshausen,Insgesamt,1415,713,702
False,8117024,"Geislingen an der Steige, Stadt",unter 3 Jahre,776,391,385
False,8117024,"Geislingen an der Steige, Stadt",3 -  6 Jahre,792,403,389
False,8117024,"Geislingen an der Steige, Stadt",6 - 10 Jahre,1245,668,577
False,8117024,"Geislingen an der Steige, Stadt",10 - 15 Jahre,1643,848,795
False,8117024,"Geislingen an der Steige, Stadt",15 - 18 Jahre,1068,547,521
False,8117024,"Geislingen an der Steige, Stadt",18 - 20 Jahre,681,319,362
False,8117024,"Geislingen an der Steige, Stadt",20 - 25 Jahre,1713,876,837
False,8117024,"Geislingen an der Steige, Stadt",25 - 30 Jahre,1655,833,822
False,8117024,"Geislingen an der Steige, Stadt",30 - 35 Jahre,1638,801,837
False,8117024,"Geislingen an der Steige, Stadt",35 - 40 Jahre,2076,1080,996
False,8117024,"Geislingen an der Steige, Stadt",40 - 45 Jahre,2242,1162,1080
False,8117024,"Geislingen an der Steige, Stadt",45 - 50 Jahre,1987,1023,964
False,8117024,"Geislingen an der Steige, Stadt",50 - 55 Jahre,1687,838,849
False,8117024,"Geislingen an der Steige, Stadt",55 - 60 Jahre,1562,790,772
False,8117024,"Geislingen an der Steige, Stadt",60 - 65 Jahre,1464,720,744
False,8117024,"Geislingen an der Steige, Stadt",65 - 75 Jahre,3041,1411,1630
False,8117024,"Geislingen an der Steige, Stadt",75 und mehr Jahre,2467,841,1626
False,8117024,"Geislingen an der Steige, Stadt",Insgesamt,27737,13551,14186
False,8117025,Gingen an der Fils,unter 3 Jahre,130,58,72
False,8117025,Gingen an der Fils,3 -  6 Jahre,159,82,77
False,8117025,Gingen an der Fils,6 - 10 Jahre,202,95,107
False,8117025,Gingen an der Fils,10 - 15 Jahre,255,117,138
False,8117025,Gingen an der Fils,15 - 18 Jahre,175,85,90
False,8117025,Gingen an der Fils,18 - 20 Jahre,107,65,42
False,8117025,Gingen an der Fils,20 - 25 Jahre,190,95,95
False,8117025,Gingen an der Fils,25 - 30 Jahre,214,104,110
False,8117025,Gingen an der Fils,30 - 35 Jahre,279,134,145
False,8117025,Gingen an der Fils,35 - 40 Jahre,363,178,185
False,8117025,Gingen an der Fils,40 - 45 Jahre,390,210,180
False,8117025,Gingen an der Fils,45 - 50 Jahre,319,172,147
False,8117025,Gingen an der Fils,50 - 55 Jahre,250,125,125
False,8117025,Gingen an der Fils,55 - 60 Jahre,239,107,132
False,8117025,Gingen an der Fils,60 - 65 Jahre,255,128,127
False,8117025,Gingen an der Fils,65 - 75 Jahre,516,252,264
False,8117025,Gingen an der Fils,75 und mehr Jahre,369,131,238
False,8117025,Gingen an der Fils,Insgesamt,4412,2138,2274
False,8117026,"Göppingen, Stadt",unter 3 Jahre,1441,757,684
False,8117026,"Göppingen, Stadt",3 -  6 Jahre,1513,801,712
False,8117026,"Göppingen, Stadt",6 - 10 Jahre,2299,1210,1089
False,8117026,"Göppingen, Stadt",10 - 15 Jahre,3079,1577,1502
False,8117026,"Göppingen, Stadt",15 - 18 Jahre,1975,977,998
False,8117026,"Göppingen, Stadt",18 - 20 Jahre,1441,733,708
False,8117026,"Göppingen, Stadt",20 - 25 Jahre,3486,1756,1730
False,8117026,"Göppingen, Stadt",25 - 30 Jahre,3356,1708,1648
False,8117026,"Göppingen, Stadt",30 - 35 Jahre,3589,1897,1692
False,8117026,"Göppingen, Stadt",35 - 40 Jahre,4622,2404,2218
False,8117026,"Göppingen, Stadt",40 - 45 Jahre,4641,2390,2251
False,8117026,"Göppingen, Stadt",45 - 50 Jahre,4190,2089,2101
False,8117026,"Göppingen, Stadt",50 - 55 Jahre,3792,1908,1884
False,8117026,"Göppingen, Stadt",55 - 60 Jahre,3387,1646,1741
False,8117026,"Göppingen, Stadt",60 - 65 Jahre,3320,1662,1658
False,8117026,"Göppingen, Stadt",65 - 75 Jahre,6264,2908,3356
False,8117026,"Göppingen, Stadt",75 und mehr Jahre,5376,1820,3556
False,8117026,"Göppingen, Stadt",Insgesamt,57771,28243,29528
False,8117028,Gruibingen,unter 3 Jahre,53,25,28
False,8117028,Gruibingen,3 -  6 Jahre,53,26,27
False,8117028,Gruibingen,6 - 10 Jahre,111,59,52
False,8117028,Gruibingen,10 - 15 Jahre,120,70,50
False,8117028,Gruibingen,15 - 18 Jahre,106,60,46
False,8117028,Gruibingen,18 - 20 Jahre,62,35,27
False,8117028,Gruibingen,20 - 25 Jahre,129,73,56
False,8117028,Gruibingen,25 - 30 Jahre,123,66,57
False,8117028,Gruibingen,30 - 35 Jahre,115,56,59
False,8117028,Gruibingen,35 - 40 Jahre,196,100,96
False,8117028,Gruibingen,40 - 45 Jahre,167,94,73
False,8117028,Gruibingen,45 - 50 Jahre,205,104,101
False,8117028,Gruibingen,50 - 55 Jahre,175,82,93
False,8117028,Gruibingen,55 - 60 Jahre,144,76,68
False,8117028,Gruibingen,60 - 65 Jahre,93,52,41
False,8117028,Gruibingen,65 - 75 Jahre,191,96,95
False,8117028,Gruibingen,75 und mehr Jahre,161,65,96
False,8117028,Gruibingen,Insgesamt,2204,1139,1065
False,8117029,Hattenhofen,unter 3 Jahre,81,42,39
False,8117029,Hattenhofen,3 -  6 Jahre,90,40,50
False,8117029,Hattenhofen,6 - 10 Jahre,140,63,77
False,8117029,Hattenhofen,10 - 15 Jahre,183,84,99
False,8117029,Hattenhofen,15 - 18 Jahre,103,55,48
False,8117029,Hattenhofen,18 - 20 Jahre,62,36,26
False,8117029,Hattenhofen,20 - 25 Jahre,158,82,76
False,8117029,Hattenhofen,25 - 30 Jahre,168,87,81
False,8117029,Hattenhofen,30 - 35 Jahre,176,81,95
False,8117029,Hattenhofen,35 - 40 Jahre,238,120,118
False,8117029,Hattenhofen,40 - 45 Jahre,253,135,118
False,8117029,Hattenhofen,45 - 50 Jahre,236,114,122
False,8117029,Hattenhofen,50 - 55 Jahre,219,116,103
False,8117029,Hattenhofen,55 - 60 Jahre,206,95,111
False,8117029,Hattenhofen,60 - 65 Jahre,208,111,97
False,8117029,Hattenhofen,65 - 75 Jahre,273,137,136
False,8117029,Hattenhofen,75 und mehr Jahre,210,83,127
False,8117029,Hattenhofen,Insgesamt,3004,1481,1523
False,8117030,Heiningen,unter 3 Jahre,116,55,61
False,8117030,Heiningen,3 -  6 Jahre,145,72,73
False,8117030,Heiningen,6 - 10 Jahre,224,106,118
False,8117030,Heiningen,10 - 15 Jahre,310,161,149
False,8117030,Heiningen,15 - 18 Jahre,209,118,91
False,8117030,Heiningen,18 - 20 Jahre,118,55,63
False,8117030,Heiningen,20 - 25 Jahre,300,173,127
False,8117030,Heiningen,25 - 30 Jahre,277,132,145
False,8117030,Heiningen,30 - 35 Jahre,327,176,151
False,8117030,Heiningen,35 - 40 Jahre,418,224,194
False,8117030,Heiningen,40 - 45 Jahre,460,244,216
False,8117030,Heiningen,45 - 50 Jahre,464,231,233
False,8117030,Heiningen,50 - 55 Jahre,381,196,185
False,8117030,Heiningen,55 - 60 Jahre,365,188,177
False,8117030,Heiningen,60 - 65 Jahre,308,158,150
False,8117030,Heiningen,65 - 75 Jahre,660,321,339
False,8117030,Heiningen,75 und mehr Jahre,398,144,254
False,8117030,Heiningen,Insgesamt,5480,2754,2726
False,8117031,Hohenstadt,unter 3 Jahre,21,12,9
False,8117031,Hohenstadt,3 -  6 Jahre,34,16,18
False,8117031,Hohenstadt,6 - 10 Jahre,34,18,16
False,8117031,Hohenstadt,10 - 15 Jahre,53,23,30
False,8117031,Hohenstadt,15 - 18 Jahre,32,14,18
False,8117031,Hohenstadt,18 - 20 Jahre,20,6,14
False,8117031,Hohenstadt,20 - 25 Jahre,39,15,24
False,8117031,Hohenstadt,25 - 30 Jahre,39,19,20
False,8117031,Hohenstadt,30 - 35 Jahre,36,20,16
False,8117031,Hohenstadt,35 - 40 Jahre,55,30,25
False,8117031,Hohenstadt,40 - 45 Jahre,44,25,19
False,8117031,Hohenstadt,45 - 50 Jahre,63,27,36
False,8117031,Hohenstadt,50 - 55 Jahre,63,27,36
False,8117031,Hohenstadt,55 - 60 Jahre,47,30,17
False,8117031,Hohenstadt,60 - 65 Jahre,33,15,18
False,8117031,Hohenstadt,65 - 75 Jahre,80,35,45
False,8117031,Hohenstadt,75 und mehr Jahre,32,13,19
False,8117031,Hohenstadt,Insgesamt,725,345,380
False,8117033,Kuchen,unter 3 Jahre,143,71,72
False,8117033,Kuchen,3 -  6 Jahre,163,83,80
False,8117033,Kuchen,6 - 10 Jahre,255,139,116
False,8117033,Kuchen,10 - 15 Jahre,315,176,139
False,8117033,Kuchen,15 - 18 Jahre,216,122,94
False,8117033,Kuchen,18 - 20 Jahre,122,67,55
False,8117033,Kuchen,20 - 25 Jahre,298,161,137
False,8117033,Kuchen,25 - 30 Jahre,306,163,143
False,8117033,Kuchen,30 - 35 Jahre,301,165,136
False,8117033,Kuchen,35 - 40 Jahre,466,261,205
False,8117033,Kuchen,40 - 45 Jahre,456,209,247
False,8117033,Kuchen,45 - 50 Jahre,398,197,201
False,8117033,Kuchen,50 - 55 Jahre,360,181,179
False,8117033,Kuchen,55 - 60 Jahre,380,191,189
False,8117033,Kuchen,60 - 65 Jahre,370,180,190
False,8117033,Kuchen,65 - 75 Jahre,724,346,378
False,8117033,Kuchen,75 und mehr Jahre,450,178,272
False,8117033,Kuchen,Insgesamt,5723,2890,2833
False,8117035,Mühlhausen im Täle,unter 3 Jahre,27,16,11
False,8117035,Mühlhausen im Täle,3 -  6 Jahre,26,12,14
False,8117035,Mühlhausen im Täle,6 - 10 Jahre,38,17,21
False,8117035,Mühlhausen im Täle,10 - 15 Jahre,80,41,39
False,8117035,Mühlhausen im Täle,15 - 18 Jahre,48,23,25
False,8117035,Mühlhausen im Täle,18 - 20 Jahre,22,14,8
False,8117035,Mühlhausen im Täle,20 - 25 Jahre,61,33,28
False,8117035,Mühlhausen im Täle,25 - 30 Jahre,43,25,18
False,8117035,Mühlhausen im Täle,30 - 35 Jahre,54,23,31
False,8117035,Mühlhausen im Täle,35 - 40 Jahre,76,38,38
False,8117035,Mühlhausen im Täle,40 - 45 Jahre,99,51,48
False,8117035,Mühlhausen im Täle,45 - 50 Jahre,92,58,34
False,8117035,Mühlhausen im Täle,50 - 55 Jahre,89,35,54
False,8117035,Mühlhausen im Täle,55 - 60 Jahre,62,43,19
False,8117035,Mühlhausen im Täle,60 - 65 Jahre,40,21,19
False,8117035,Mühlhausen im Täle,65 - 75 Jahre,91,45,46
False,8117035,Mühlhausen im Täle,75 und mehr Jahre,74,27,47
False,8117035,Mühlhausen im Täle,Insgesamt,1022,522,500
False,8117037,Ottenbach,unter 3 Jahre,68,38,30
False,8117037,Ottenbach,3 -  6 Jahre,84,45,39
False,8117037,Ottenbach,6 - 10 Jahre,112,63,49
False,8117037,Ottenbach,10 - 15 Jahre,164,79,85
False,8117037,Ottenbach,15 - 18 Jahre,79,38,41
False,8117037,Ottenbach,18 - 20 Jahre,56,31,25
False,8117037,Ottenbach,20 - 25 Jahre,129,64,65
False,8117037,Ottenbach,25 - 30 Jahre,141,68,73
False,8117037,Ottenbach,30 - 35 Jahre,143,73,70
False,8117037,Ottenbach,35 - 40 Jahre,225,102,123
False,8117037,Ottenbach,40 - 45 Jahre,228,115,113
False,8117037,Ottenbach,45 - 50 Jahre,184,101,83
False,8117037,Ottenbach,50 - 55 Jahre,175,86,89
False,8117037,Ottenbach,55 - 60 Jahre,132,64,68
False,8117037,Ottenbach,60 - 65 Jahre,124,65,59
False,8117037,Ottenbach,65 - 75 Jahre,253,122,131
False,8117037,Ottenbach,75 und mehr Jahre,177,54,123
False,8117037,Ottenbach,Insgesamt,2474,1208,1266
False,8117038,Rechberghausen,unter 3 Jahre,123,64,59
False,8117038,Rechberghausen,3 -  6 Jahre,153,68,85
False,8117038,Rechberghausen,6 - 10 Jahre,235,114,121
False,8117038,Rechberghausen,10 - 15 Jahre,307,177,130
False,8117038,Rechberghausen,15 - 18 Jahre,176,95,81
False,8117038,Rechberghausen,18 - 20 Jahre,120,56,64
False,8117038,Rechberghausen,20 - 25 Jahre,280,132,148
False,8117038,Rechberghausen,25 - 30 Jahre,267,122,145
False,8117038,Rechberghausen,30 - 35 Jahre,376,166,210
False,8117038,Rechberghausen,35 - 40 Jahre,469,253,216
False,8117038,Rechberghausen,40 - 45 Jahre,442,220,222
False,8117038,Rechberghausen,45 - 50 Jahre,431,213,218
False,8117038,Rechberghausen,50 - 55 Jahre,335,158,177
False,8117038,Rechberghausen,55 - 60 Jahre,337,165,172
False,8117038,Rechberghausen,60 - 65 Jahre,347,158,189
False,8117038,Rechberghausen,65 - 75 Jahre,646,309,337
False,8117038,Rechberghausen,75 und mehr Jahre,488,202,286
False,8117038,Rechberghausen,Insgesamt,5532,2672,2860
False,8117042,Salach,unter 3 Jahre,203,93,110
False,8117042,Salach,3 -  6 Jahre,240,125,115
False,8117042,Salach,6 - 10 Jahre,343,174,169
False,8117042,Salach,10 - 15 Jahre,445,237,208
False,8117042,Salach,15 - 18 Jahre,318,161,157
False,8117042,Salach,18 - 20 Jahre,192,112,80
False,8117042,Salach,20 - 25 Jahre,453,223,230
False,8117042,Salach,25 - 30 Jahre,464,225,239
False,8117042,Salach,30 - 35 Jahre,487,240,247
False,8117042,Salach,35 - 40 Jahre,634,319,315
False,8117042,Salach,40 - 45 Jahre,664,349,315
False,8117042,Salach,45 - 50 Jahre,561,287,274
False,8117042,Salach,50 - 55 Jahre,517,267,250
False,8117042,Salach,55 - 60 Jahre,435,213,222
False,8117042,Salach,60 - 65 Jahre,437,224,213
False,8117042,Salach,65 - 75 Jahre,844,400,444
False,8117042,Salach,75 und mehr Jahre,630,178,452
False,8117042,Salach,Insgesamt,7867,3827,4040
False,8117043,Schlat,unter 3 Jahre,44,19,25
False,8117043,Schlat,3 -  6 Jahre,60,31,29
False,8117043,Schlat,6 - 10 Jahre,82,45,37
False,8117043,Schlat,10 - 15 Jahre,103,57,46
False,8117043,Schlat,15 - 18 Jahre,61,34,27
False,8117043,Schlat,18 - 20 Jahre,34,12,22
False,8117043,Schlat,20 - 25 Jahre,104,56,48
False,8117043,Schlat,25 - 30 Jahre,78,37,41
False,8117043,Schlat,30 - 35 Jahre,98,51,47
False,8117043,Schlat,35 - 40 Jahre,149,77,72
False,8117043,Schlat,40 - 45 Jahre,143,81,62
False,8117043,Schlat,45 - 50 Jahre,149,77,72
False,8117043,Schlat,50 - 55 Jahre,129,71,58
False,8117043,Schlat,55 - 60 Jahre,88,33,55
False,8117043,Schlat,60 - 65 Jahre,125,69,56
False,8117043,Schlat,65 - 75 Jahre,190,88,102
False,8117043,Schlat,75 und mehr Jahre,138,55,83
False,8117043,Schlat,Insgesamt,1775,893,882
False,8117044,Schlierbach,unter 3 Jahre,103,58,45
False,8117044,Schlierbach,3 -  6 Jahre,129,76,53
False,8117044,Schlierbach,6 - 10 Jahre,193,107,86
False,8117044,Schlierbach,10 - 15 Jahre,264,133,131
False,8117044,Schlierbach,15 - 18 Jahre,139,56,83
False,8117044,Schlierbach,18 - 20 Jahre,62,33,29
False,8117044,Schlierbach,20 - 25 Jahre,175,99,76
False,8117044,Schlierbach,25 - 30 Jahre,176,81,95
False,8117044,Schlierbach,30 - 35 Jahre,240,118,122
False,8117044,Schlierbach,35 - 40 Jahre,310,155,155
False,8117044,Schlierbach,40 - 45 Jahre,364,185,179
False,8117044,Schlierbach,45 - 50 Jahre,258,136,122
False,8117044,Schlierbach,50 - 55 Jahre,227,121,106
False,8117044,Schlierbach,55 - 60 Jahre,242,113,129
False,8117044,Schlierbach,60 - 65 Jahre,219,118,101
False,8117044,Schlierbach,65 - 75 Jahre,416,198,218
False,8117044,Schlierbach,75 und mehr Jahre,255,106,149
False,8117044,Schlierbach,Insgesamt,3772,1893,1879
False,8117049,"Süßen, Stadt",unter 3 Jahre,244,115,129
False,8117049,"Süßen, Stadt",3 -  6 Jahre,285,152,133
False,8117049,"Süßen, Stadt",6 - 10 Jahre,423,213,210
False,8117049,"Süßen, Stadt",10 - 15 Jahre,590,309,281
False,8117049,"Süßen, Stadt",15 - 18 Jahre,390,198,192
False,8117049,"Süßen, Stadt",18 - 20 Jahre,255,140,115
False,8117049,"Süßen, Stadt",20 - 25 Jahre,579,307,272
False,8117049,"Süßen, Stadt",25 - 30 Jahre,573,300,273
False,8117049,"Süßen, Stadt",30 - 35 Jahre,624,302,322
False,8117049,"Süßen, Stadt",35 - 40 Jahre,786,411,375
False,8117049,"Süßen, Stadt",40 - 45 Jahre,867,449,418
False,8117049,"Süßen, Stadt",45 - 50 Jahre,820,443,377
False,8117049,"Süßen, Stadt",50 - 55 Jahre,675,340,335
False,8117049,"Süßen, Stadt",55 - 60 Jahre,586,293,293
False,8117049,"Süßen, Stadt",60 - 65 Jahre,522,278,244
False,8117049,"Süßen, Stadt",65 - 75 Jahre,1074,507,567
False,8117049,"Süßen, Stadt",75 und mehr Jahre,847,272,575
False,8117049,"Süßen, Stadt",Insgesamt,10140,5029,5111
False,8117051,"Uhingen, Stadt",unter 3 Jahre,417,216,201
False,8117051,"Uhingen, Stadt",3 -  6 Jahre,433,228,205
False,8117051,"Uhingen, Stadt",6 - 10 Jahre,691,397,294
False,8117051,"Uhingen, Stadt",10 - 15 Jahre,867,450,417
False,8117051,"Uhingen, Stadt",15 - 18 Jahre,527,291,236
False,8117051,"Uhingen, Stadt",18 - 20 Jahre,323,157,166
False,8117051,"Uhingen, Stadt",20 - 25 Jahre,735,390,345
False,8117051,"Uhingen, Stadt",25 - 30 Jahre,718,368,350
False,8117051,"Uhingen, Stadt",30 - 35 Jahre,803,417,386
False,8117051,"Uhingen, Stadt",35 - 40 Jahre,1094,550,544
False,8117051,"Uhingen, Stadt",40 - 45 Jahre,1150,581,569
False,8117051,"Uhingen, Stadt",45 - 50 Jahre,1065,552,513
False,8117051,"Uhingen, Stadt",50 - 55 Jahre,842,419,423
False,8117051,"Uhingen, Stadt",55 - 60 Jahre,730,356,374
False,8117051,"Uhingen, Stadt",60 - 65 Jahre,774,375,399
False,8117051,"Uhingen, Stadt",65 - 75 Jahre,1554,767,787
False,8117051,"Uhingen, Stadt",75 und mehr Jahre,1172,393,779
False,8117051,"Uhingen, Stadt",Insgesamt,13895,6907,6988
False,8117053,Wäschenbeuren,unter 3 Jahre,128,64,64
False,8117053,Wäschenbeuren,3 -  6 Jahre,144,77,67
False,8117053,Wäschenbeuren,6 - 10 Jahre,205,112,93
False,8117053,Wäschenbeuren,10 - 15 Jahre,248,110,138
False,8117053,Wäschenbeuren,15 - 18 Jahre,176,90,86
False,8117053,Wäschenbeuren,18 - 20 Jahre,97,53,44
False,8117053,Wäschenbeuren,20 - 25 Jahre,202,104,98
False,8117053,Wäschenbeuren,25 - 30 Jahre,189,91,98
False,8117053,Wäschenbeuren,30 - 35 Jahre,250,119,131
False,8117053,Wäschenbeuren,35 - 40 Jahre,375,184,191
False,8117053,Wäschenbeuren,40 - 45 Jahre,410,213,197
False,8117053,Wäschenbeuren,45 - 50 Jahre,329,166,163
False,8117053,Wäschenbeuren,50 - 55 Jahre,209,104,105
False,8117053,Wäschenbeuren,55 - 60 Jahre,188,93,95
False,8117053,Wäschenbeuren,60 - 65 Jahre,207,104,103
False,8117053,Wäschenbeuren,65 - 75 Jahre,381,179,202
False,8117053,Wäschenbeuren,75 und mehr Jahre,214,86,128
False,8117053,Wäschenbeuren,Insgesamt,3952,1949,2003
False,8117055,Wangen,unter 3 Jahre,63,37,26
False,8117055,Wangen,3 -  6 Jahre,84,44,40
False,8117055,Wangen,6 - 10 Jahre,131,61,70
False,8117055,Wangen,10 - 15 Jahre,180,86,94
False,8117055,Wangen,15 - 18 Jahre,112,53,59
False,8117055,Wangen,18 - 20 Jahre,72,42,30
False,8117055,Wangen,20 - 25 Jahre,155,79,76
False,8117055,Wangen,25 - 30 Jahre,154,87,67
False,8117055,Wangen,30 - 35 Jahre,210,94,116
False,8117055,Wangen,35 - 40 Jahre,262,145,117
False,8117055,Wangen,40 - 45 Jahre,277,146,131
False,8117055,Wangen,45 - 50 Jahre,238,108,130
False,8117055,Wangen,50 - 55 Jahre,236,119,117
False,8117055,Wangen,55 - 60 Jahre,187,100,87
False,8117055,Wangen,60 - 65 Jahre,199,101,98
False,8117055,Wangen,65 - 75 Jahre,394,183,211
False,8117055,Wangen,75 und mehr Jahre,259,111,148
False,8117055,Wangen,Insgesamt,3213,1596,1617
False,8117058,"Wiesensteig, Stadt",unter 3 Jahre,56,26,30
False,8117058,"Wiesensteig, Stadt",3 -  6 Jahre,61,32,29
False,8117058,"Wiesensteig, Stadt",6 - 10 Jahre,86,47,39
False,8117058,"Wiesensteig, Stadt",10 - 15 Jahre,124,70,54
False,8117058,"Wiesensteig, Stadt",15 - 18 Jahre,107,62,45
False,8117058,"Wiesensteig, Stadt",18 - 20 Jahre,79,44,35
False,8117058,"Wiesensteig, Stadt",20 - 25 Jahre,161,87,74
False,8117058,"Wiesensteig, Stadt",25 - 30 Jahre,110,54,56
False,8117058,"Wiesensteig, Stadt",30 - 35 Jahre,136,66,70
False,8117058,"Wiesensteig, Stadt",35 - 40 Jahre,175,103,72
False,8117058,"Wiesensteig, Stadt",40 - 45 Jahre,196,105,91
False,8117058,"Wiesensteig, Stadt",45 - 50 Jahre,172,97,75
False,8117058,"Wiesensteig, Stadt",50 - 55 Jahre,137,78,59
False,8117058,"Wiesensteig, Stadt",55 - 60 Jahre,108,53,55
False,8117058,"Wiesensteig, Stadt",60 - 65 Jahre,103,52,51
False,8117058,"Wiesensteig, Stadt",65 - 75 Jahre,302,136,166
False,8117058,"Wiesensteig, Stadt",75 und mehr Jahre,199,71,128
False,8117058,"Wiesensteig, Stadt",Insgesamt,2312,1183,1129
False,8117060,Zell unter Aichelberg,unter 3 Jahre,85,42,43
False,8117060,Zell unter Aichelberg,3 -  6 Jahre,81,40,41
False,8117060,Zell unter Aichelberg,6 - 10 Jahre,137,78,59
False,8117060,Zell unter Aichelberg,10 - 15 Jahre,180,102,78
False,8117060,Zell unter Aichelberg,15 - 18 Jahre,85,47,38
False,8117060,Zell unter Aichelberg,18 - 20 Jahre,81,51,30
False,8117060,Zell unter Aichelberg,20 - 25 Jahre,152,77,75
False,8117060,Zell unter Aichelberg,25 - 30 Jahre,160,85,75
False,8117060,Zell unter Aichelberg,30 - 35 Jahre,190,95,95
False,8117060,Zell unter Aichelberg,35 - 40 Jahre,266,135,131
False,8117060,Zell unter Aichelberg,40 - 45 Jahre,260,133,127
False,8117060,Zell unter Aichelberg,45 - 50 Jahre,262,128,134
False,8117060,Zell unter Aichelberg,50 - 55 Jahre,208,106,102
False,8117060,Zell unter Aichelberg,55 - 60 Jahre,206,104,102
False,8117060,Zell unter Aichelberg,60 - 65 Jahre,185,93,92
False,8117060,Zell unter Aichelberg,65 - 75 Jahre,271,127,144
False,8117060,Zell unter Aichelberg,75 und mehr Jahre,164,54,110
False,8117060,Zell unter Aichelberg,Insgesamt,2973,1497,1476
False,8117061,"Lauterstein, Stadt",unter 3 Jahre,75,38,37
False,8117061,"Lauterstein, Stadt",3 -  6 Jahre,86,36,50
False,8117061,"Lauterstein, Stadt",6 - 10 Jahre,132,65,67
False,8117061,"Lauterstein, Stadt",10 - 15 Jahre,182,91,91
False,8117061,"Lauterstein, Stadt",15 - 18 Jahre,92,55,37
False,8117061,"Lauterstein, Stadt",18 - 20 Jahre,74,34,40
False,8117061,"Lauterstein, Stadt",20 - 25 Jahre,168,81,87
False,8117061,"Lauterstein, Stadt",25 - 30 Jahre,132,62,70
False,8117061,"Lauterstein, Stadt",30 - 35 Jahre,170,84,86
False,8117061,"Lauterstein, Stadt",35 - 40 Jahre,218,106,112
False,8117061,"Lauterstein, Stadt",40 - 45 Jahre,272,143,129
False,8117061,"Lauterstein, Stadt",45 - 50 Jahre,206,105,101
False,8117061,"Lauterstein, Stadt",50 - 55 Jahre,185,96,89
False,8117061,"Lauterstein, Stadt",55 - 60 Jahre,155,78,77
False,8117061,"Lauterstein, Stadt",60 - 65 Jahre,138,81,57
False,8117061,"Lauterstein, Stadt",65 - 75 Jahre,296,143,153
False,8117061,"Lauterstein, Stadt",75 und mehr Jahre,230,73,157
False,8117061,"Lauterstein, Stadt",Insgesamt,2811,1371,1440
False,8118,Landkreis Ludwigsburg,unter 3 Jahre,14603,7530,7073
False,8118,Landkreis Ludwigsburg,3 -  6 Jahre,15648,8081,7567
False,8118,Landkreis Ludwigsburg,6 - 10 Jahre,22239,11502,10737
False,8118,Landkreis Ludwigsburg,10 - 15 Jahre,28626,14689,13937
False,8118,Landkreis Ludwigsburg,15 - 18 Jahre,18052,9161,8891
False,8118,Landkreis Ludwigsburg,18 - 20 Jahre,11311,5872,5439
False,8118,Landkreis Ludwigsburg,20 - 25 Jahre,28048,13784,14264
False,8118,Landkreis Ludwigsburg,25 - 30 Jahre,30781,15433,15348
False,8118,Landkreis Ludwigsburg,30 - 35 Jahre,33533,16949,16584
False,8118,Landkreis Ludwigsburg,35 - 40 Jahre,44403,22834,21569
False,8118,Landkreis Ludwigsburg,40 - 45 Jahre,44831,23159,21672
False,8118,Landkreis Ludwigsburg,45 - 50 Jahre,38934,19901,19033
False,8118,Landkreis Ludwigsburg,50 - 55 Jahre,32675,16011,16664
False,8118,Landkreis Ludwigsburg,55 - 60 Jahre,29625,14715,14910
False,8118,Landkreis Ludwigsburg,60 - 65 Jahre,29649,14642,15007
False,8118,Landkreis Ludwigsburg,65 - 75 Jahre,53959,25882,28077
False,8118,Landkreis Ludwigsburg,75 und mehr Jahre,36400,13188,23212
False,8118,Landkreis Ludwigsburg,Insgesamt,513317,253333,259984
False,8118001,Affalterbach,unter 3 Jahre,106,63,43
False,8118001,Affalterbach,3 -  6 Jahre,117,56,61
False,8118001,Affalterbach,6 - 10 Jahre,224,106,118
False,8118001,Affalterbach,10 - 15 Jahre,293,163,130
False,8118001,Affalterbach,15 - 18 Jahre,195,114,81
False,8118001,Affalterbach,18 - 20 Jahre,125,72,53
False,8118001,Affalterbach,20 - 25 Jahre,218,117,101
False,8118001,Affalterbach,25 - 30 Jahre,214,128,86
False,8118001,Affalterbach,30 - 35 Jahre,231,114,117
False,8118001,Affalterbach,35 - 40 Jahre,389,183,206
False,8118001,Affalterbach,40 - 45 Jahre,418,202,216
False,8118001,Affalterbach,45 - 50 Jahre,333,154,179
False,8118001,Affalterbach,50 - 55 Jahre,328,153,175
False,8118001,Affalterbach,55 - 60 Jahre,328,173,155
False,8118001,Affalterbach,60 - 65 Jahre,283,137,146
False,8118001,Affalterbach,65 - 75 Jahre,520,267,253
False,8118001,Affalterbach,75 und mehr Jahre,303,113,190
False,8118001,Affalterbach,Insgesamt,4625,2315,2310
False,8118003,"Asperg, Stadt",unter 3 Jahre,408,226,182
False,8118003,"Asperg, Stadt",3 -  6 Jahre,396,215,181
False,8118003,"Asperg, Stadt",6 - 10 Jahre,532,258,274
False,8118003,"Asperg, Stadt",10 - 15 Jahre,632,340,292
False,8118003,"Asperg, Stadt",15 - 18 Jahre,405,197,208
False,8118003,"Asperg, Stadt",18 - 20 Jahre,285,153,132
False,8118003,"Asperg, Stadt",20 - 25 Jahre,683,332,351
False,8118003,"Asperg, Stadt",25 - 30 Jahre,788,387,401
False,8118003,"Asperg, Stadt",30 - 35 Jahre,846,419,427
False,8118003,"Asperg, Stadt",35 - 40 Jahre,1099,568,531
False,8118003,"Asperg, Stadt",40 - 45 Jahre,1108,576,532
False,8118003,"Asperg, Stadt",45 - 50 Jahre,995,489,506
False,8118003,"Asperg, Stadt",50 - 55 Jahre,839,440,399
False,8118003,"Asperg, Stadt",55 - 60 Jahre,739,375,364
False,8118003,"Asperg, Stadt",60 - 65 Jahre,800,384,416
False,8118003,"Asperg, Stadt",65 - 75 Jahre,1405,663,742
False,8118003,"Asperg, Stadt",75 und mehr Jahre,965,352,613
False,8118003,"Asperg, Stadt",Insgesamt,12925,6374,6551
False,8118006,Benningen am Neckar,unter 3 Jahre,140,73,67
False,8118006,Benningen am Neckar,3 -  6 Jahre,157,80,77
False,8118006,Benningen am Neckar,6 - 10 Jahre,241,132,109
False,8118006,Benningen am Neckar,10 - 15 Jahre,307,163,144
False,8118006,Benningen am Neckar,15 - 18 Jahre,223,117,106
False,8118006,Benningen am Neckar,18 - 20 Jahre,140,73,67
False,8118006,Benningen am Neckar,20 - 25 Jahre,294,139,155
False,8118006,Benningen am Neckar,25 - 30 Jahre,333,160,173
False,8118006,Benningen am Neckar,30 - 35 Jahre,319,182,137
False,8118006,Benningen am Neckar,35 - 40 Jahre,430,220,210
False,8118006,Benningen am Neckar,40 - 45 Jahre,453,220,233
False,8118006,Benningen am Neckar,45 - 50 Jahre,457,221,236
False,8118006,Benningen am Neckar,50 - 55 Jahre,414,210,204
False,8118006,Benningen am Neckar,55 - 60 Jahre,358,178,180
False,8118006,Benningen am Neckar,60 - 65 Jahre,295,153,142
False,8118006,Benningen am Neckar,65 - 75 Jahre,537,240,297
False,8118006,Benningen am Neckar,75 und mehr Jahre,330,136,194
False,8118006,Benningen am Neckar,Insgesamt,5428,2697,2731
False,8118007,"Besigheim, Stadt",unter 3 Jahre,337,182,155
False,8118007,"Besigheim, Stadt",3 -  6 Jahre,403,200,203
False,8118007,"Besigheim, Stadt",6 - 10 Jahre,524,279,245
False,8118007,"Besigheim, Stadt",10 - 15 Jahre,701,355,346
False,8118007,"Besigheim, Stadt",15 - 18 Jahre,410,202,208
False,8118007,"Besigheim, Stadt",18 - 20 Jahre,258,141,117
False,8118007,"Besigheim, Stadt",20 - 25 Jahre,608,293,315
False,8118007,"Besigheim, Stadt",25 - 30 Jahre,647,311,336
False,8118007,"Besigheim, Stadt",30 - 35 Jahre,781,393,388
False,8118007,"Besigheim, Stadt",35 - 40 Jahre,1060,547,513
False,8118007,"Besigheim, Stadt",40 - 45 Jahre,1071,539,532
False,8118007,"Besigheim, Stadt",45 - 50 Jahre,980,517,463
False,8118007,"Besigheim, Stadt",50 - 55 Jahre,729,373,356
False,8118007,"Besigheim, Stadt",55 - 60 Jahre,644,336,308
False,8118007,"Besigheim, Stadt",60 - 65 Jahre,594,300,294
False,8118007,"Besigheim, Stadt",65 - 75 Jahre,1169,558,611
False,8118007,"Besigheim, Stadt",75 und mehr Jahre,890,297,593
False,8118007,"Besigheim, Stadt",Insgesamt,11806,5823,5983
False,8118010,"Bönnigheim, Stadt",unter 3 Jahre,185,99,86
False,8118010,"Bönnigheim, Stadt",3 -  6 Jahre,226,118,108
False,8118010,"Bönnigheim, Stadt",6 - 10 Jahre,346,188,158
False,8118010,"Bönnigheim, Stadt",10 - 15 Jahre,502,255,247
False,8118010,"Bönnigheim, Stadt",15 - 18 Jahre,321,169,152
False,8118010,"Bönnigheim, Stadt",18 - 20 Jahre,199,106,93
False,8118010,"Bönnigheim, Stadt",20 - 25 Jahre,396,197,199
False,8118010,"Bönnigheim, Stadt",25 - 30 Jahre,376,190,186
False,8118010,"Bönnigheim, Stadt",30 - 35 Jahre,528,281,247
False,8118010,"Bönnigheim, Stadt",35 - 40 Jahre,718,368,350
False,8118010,"Bönnigheim, Stadt",40 - 45 Jahre,721,369,352
False,8118010,"Bönnigheim, Stadt",45 - 50 Jahre,570,283,287
False,8118010,"Bönnigheim, Stadt",50 - 55 Jahre,424,217,207
False,8118010,"Bönnigheim, Stadt",55 - 60 Jahre,425,212,213
False,8118010,"Bönnigheim, Stadt",60 - 65 Jahre,323,158,165
False,8118010,"Bönnigheim, Stadt",65 - 75 Jahre,771,371,400
False,8118010,"Bönnigheim, Stadt",75 und mehr Jahre,456,154,302
False,8118010,"Bönnigheim, Stadt",Insgesamt,7487,3735,3752
False,8118011,"Ditzingen, Stadt",unter 3 Jahre,699,357,342
False,8118011,"Ditzingen, Stadt",3 -  6 Jahre,777,387,390
False,8118011,"Ditzingen, Stadt",6 - 10 Jahre,1036,553,483
False,8118011,"Ditzingen, Stadt",10 - 15 Jahre,1324,687,637
False,8118011,"Ditzingen, Stadt",15 - 18 Jahre,785,384,401
False,8118011,"Ditzingen, Stadt",18 - 20 Jahre,512,257,255
False,8118011,"Ditzingen, Stadt",20 - 25 Jahre,1209,619,590
False,8118011,"Ditzingen, Stadt",25 - 30 Jahre,1512,774,738
False,8118011,"Ditzingen, Stadt",30 - 35 Jahre,1551,791,760
False,8118011,"Ditzingen, Stadt",35 - 40 Jahre,2060,1056,1004
False,8118011,"Ditzingen, Stadt",40 - 45 Jahre,2098,1067,1031
False,8118011,"Ditzingen, Stadt",45 - 50 Jahre,1874,979,895
False,8118011,"Ditzingen, Stadt",50 - 55 Jahre,1590,792,798
False,8118011,"Ditzingen, Stadt",55 - 60 Jahre,1477,725,752
False,8118011,"Ditzingen, Stadt",60 - 65 Jahre,1497,752,745
False,8118011,"Ditzingen, Stadt",65 - 75 Jahre,2587,1246,1341
False,8118011,"Ditzingen, Stadt",75 und mehr Jahre,1655,615,1040
False,8118011,"Ditzingen, Stadt",Insgesamt,24243,12041,12202
False,8118012,Eberdingen,unter 3 Jahre,173,92,81
False,8118012,Eberdingen,3 -  6 Jahre,188,96,92
False,8118012,Eberdingen,6 - 10 Jahre,299,163,136
False,8118012,Eberdingen,10 - 15 Jahre,460,252,208
False,8118012,Eberdingen,15 - 18 Jahre,247,111,136
False,8118012,Eberdingen,18 - 20 Jahre,135,54,81
False,8118012,Eberdingen,20 - 25 Jahre,346,175,171
False,8118012,Eberdingen,25 - 30 Jahre,348,167,181
False,8118012,Eberdingen,30 - 35 Jahre,379,179,200
False,8118012,Eberdingen,35 - 40 Jahre,538,274,264
False,8118012,Eberdingen,40 - 45 Jahre,558,293,265
False,8118012,Eberdingen,45 - 50 Jahre,494,266,228
False,8118012,Eberdingen,50 - 55 Jahre,469,247,222
False,8118012,Eberdingen,55 - 60 Jahre,419,208,211
False,8118012,Eberdingen,60 - 65 Jahre,426,203,223
False,8118012,Eberdingen,65 - 75 Jahre,626,309,317
False,8118012,Eberdingen,75 und mehr Jahre,386,165,221
False,8118012,Eberdingen,Insgesamt,6491,3254,3237
False,8118014,Erdmannhausen,unter 3 Jahre,127,68,59
False,8118014,Erdmannhausen,3 -  6 Jahre,144,85,59
False,8118014,Erdmannhausen,6 - 10 Jahre,221,120,101
False,8118014,Erdmannhausen,10 - 15 Jahre,307,161,146
False,8118014,Erdmannhausen,15 - 18 Jahre,177,80,97
False,8118014,Erdmannhausen,18 - 20 Jahre,132,62,70
False,8118014,Erdmannhausen,20 - 25 Jahre,255,132,123
False,8118014,Erdmannhausen,25 - 30 Jahre,248,124,124
False,8118014,Erdmannhausen,30 - 35 Jahre,242,115,127
False,8118014,Erdmannhausen,35 - 40 Jahre,402,202,200
False,8118014,Erdmannhausen,40 - 45 Jahre,424,214,210
False,8118014,Erdmannhausen,45 - 50 Jahre,427,213,214
False,8118014,Erdmannhausen,50 - 55 Jahre,370,171,199
False,8118014,Erdmannhausen,55 - 60 Jahre,285,161,124
False,8118014,Erdmannhausen,60 - 65 Jahre,255,128,127
False,8118014,Erdmannhausen,65 - 75 Jahre,491,245,246
False,8118014,Erdmannhausen,75 und mehr Jahre,335,116,219
False,8118014,Erdmannhausen,Insgesamt,4842,2397,2445
False,8118015,Erligheim,unter 3 Jahre,86,41,45
False,8118015,Erligheim,3 -  6 Jahre,94,46,48
False,8118015,Erligheim,6 - 10 Jahre,127,65,62
False,8118015,Erligheim,10 - 15 Jahre,172,100,72
False,8118015,Erligheim,15 - 18 Jahre,125,73,52
False,8118015,Erligheim,18 - 20 Jahre,80,41,39
False,8118015,Erligheim,20 - 25 Jahre,141,78,63
False,8118015,Erligheim,25 - 30 Jahre,160,80,80
False,8118015,Erligheim,30 - 35 Jahre,180,91,89
False,8118015,Erligheim,35 - 40 Jahre,237,129,108
False,8118015,Erligheim,40 - 45 Jahre,257,120,137
False,8118015,Erligheim,45 - 50 Jahre,238,128,110
False,8118015,Erligheim,50 - 55 Jahre,193,97,96
False,8118015,Erligheim,55 - 60 Jahre,133,66,67
False,8118015,Erligheim,60 - 65 Jahre,129,63,66
False,8118015,Erligheim,65 - 75 Jahre,244,117,127
False,8118015,Erligheim,75 und mehr Jahre,129,57,72
False,8118015,Erligheim,Insgesamt,2725,1392,1333
False,8118016,Freudental,unter 3 Jahre,81,39,42
False,8118016,Freudental,3 -  6 Jahre,71,45,26
False,8118016,Freudental,6 - 10 Jahre,110,57,53
False,8118016,Freudental,10 - 15 Jahre,156,84,72
False,8118016,Freudental,15 - 18 Jahre,99,49,50
False,8118016,Freudental,18 - 20 Jahre,43,24,19
False,8118016,Freudental,20 - 25 Jahre,105,48,57
False,8118016,Freudental,25 - 30 Jahre,122,60,62
False,8118016,Freudental,30 - 35 Jahre,147,77,70
False,8118016,Freudental,35 - 40 Jahre,211,110,101
False,8118016,Freudental,40 - 45 Jahre,231,123,108
False,8118016,Freudental,45 - 50 Jahre,180,92,88
False,8118016,Freudental,50 - 55 Jahre,143,75,68
False,8118016,Freudental,55 - 60 Jahre,127,60,67
False,8118016,Freudental,60 - 65 Jahre,147,72,75
False,8118016,Freudental,65 - 75 Jahre,253,129,124
False,8118016,Freudental,75 und mehr Jahre,173,68,105
False,8118016,Freudental,Insgesamt,2399,1212,1187
False,8118018,Gemmrigheim,unter 3 Jahre,123,69,54
False,8118018,Gemmrigheim,3 -  6 Jahre,150,71,79
False,8118018,Gemmrigheim,6 - 10 Jahre,208,106,102
False,8118018,Gemmrigheim,10 - 15 Jahre,236,124,112
False,8118018,Gemmrigheim,15 - 18 Jahre,168,77,91
False,8118018,Gemmrigheim,18 - 20 Jahre,93,47,46
False,8118018,Gemmrigheim,20 - 25 Jahre,212,107,105
False,8118018,Gemmrigheim,25 - 30 Jahre,242,120,122
False,8118018,Gemmrigheim,30 - 35 Jahre,274,127,147
False,8118018,Gemmrigheim,35 - 40 Jahre,381,196,185
False,8118018,Gemmrigheim,40 - 45 Jahre,339,197,142
False,8118018,Gemmrigheim,45 - 50 Jahre,280,141,139
False,8118018,Gemmrigheim,50 - 55 Jahre,235,111,124
False,8118018,Gemmrigheim,55 - 60 Jahre,212,110,102
False,8118018,Gemmrigheim,60 - 65 Jahre,212,115,97
False,8118018,Gemmrigheim,65 - 75 Jahre,394,183,211
False,8118018,Gemmrigheim,75 und mehr Jahre,260,90,170
False,8118018,Gemmrigheim,Insgesamt,4019,1991,2028
False,8118019,"Gerlingen, Stadt",unter 3 Jahre,510,272,238
False,8118019,"Gerlingen, Stadt",3 -  6 Jahre,582,312,270
False,8118019,"Gerlingen, Stadt",6 - 10 Jahre,734,364,370
False,8118019,"Gerlingen, Stadt",10 - 15 Jahre,851,443,408
False,8118019,"Gerlingen, Stadt",15 - 18 Jahre,507,270,237
False,8118019,"Gerlingen, Stadt",18 - 20 Jahre,331,166,165
False,8118019,"Gerlingen, Stadt",20 - 25 Jahre,901,449,452
False,8118019,"Gerlingen, Stadt",25 - 30 Jahre,1080,563,517
False,8118019,"Gerlingen, Stadt",30 - 35 Jahre,1255,657,598
False,8118019,"Gerlingen, Stadt",35 - 40 Jahre,1716,920,796
False,8118019,"Gerlingen, Stadt",40 - 45 Jahre,1664,868,796
False,8118019,"Gerlingen, Stadt",45 - 50 Jahre,1326,683,643
False,8118019,"Gerlingen, Stadt",50 - 55 Jahre,1102,541,561
False,8118019,"Gerlingen, Stadt",55 - 60 Jahre,1078,526,552
False,8118019,"Gerlingen, Stadt",60 - 65 Jahre,1230,590,640
False,8118019,"Gerlingen, Stadt",65 - 75 Jahre,2335,1099,1236
False,8118019,"Gerlingen, Stadt",75 und mehr Jahre,1687,652,1035
False,8118019,"Gerlingen, Stadt",Insgesamt,18889,9375,9514
False,8118021,"Großbottwar, Stadt",unter 3 Jahre,253,150,103
False,8118021,"Großbottwar, Stadt",3 -  6 Jahre,287,156,131
False,8118021,"Großbottwar, Stadt",6 - 10 Jahre,403,234,169
False,8118021,"Großbottwar, Stadt",10 - 15 Jahre,564,271,293
False,8118021,"Großbottwar, Stadt",15 - 18 Jahre,341,181,160
False,8118021,"Großbottwar, Stadt",18 - 20 Jahre,195,102,93
False,8118021,"Großbottwar, Stadt",20 - 25 Jahre,429,218,211
False,8118021,"Großbottwar, Stadt",25 - 30 Jahre,452,249,203
False,8118021,"Großbottwar, Stadt",30 - 35 Jahre,473,229,244
False,8118021,"Großbottwar, Stadt",35 - 40 Jahre,751,383,368
False,8118021,"Großbottwar, Stadt",40 - 45 Jahre,805,399,406
False,8118021,"Großbottwar, Stadt",45 - 50 Jahre,579,306,273
False,8118021,"Großbottwar, Stadt",50 - 55 Jahre,544,268,276
False,8118021,"Großbottwar, Stadt",55 - 60 Jahre,474,245,229
False,8118021,"Großbottwar, Stadt",60 - 65 Jahre,452,240,212
False,8118021,"Großbottwar, Stadt",65 - 75 Jahre,863,428,435
False,8118021,"Großbottwar, Stadt",75 und mehr Jahre,526,195,331
False,8118021,"Großbottwar, Stadt",Insgesamt,8391,4254,4137
False,8118027,Hemmingen,unter 3 Jahre,209,111,98
False,8118027,Hemmingen,3 -  6 Jahre,208,100,108
False,8118027,Hemmingen,6 - 10 Jahre,317,165,152
False,8118027,Hemmingen,10 - 15 Jahre,452,229,223
False,8118027,Hemmingen,15 - 18 Jahre,260,143,117
False,8118027,Hemmingen,18 - 20 Jahre,152,76,76
False,8118027,Hemmingen,20 - 25 Jahre,381,190,191
False,8118027,Hemmingen,25 - 30 Jahre,449,218,231
False,8118027,Hemmingen,30 - 35 Jahre,441,205,236
False,8118027,Hemmingen,35 - 40 Jahre,609,320,289
False,8118027,Hemmingen,40 - 45 Jahre,672,343,329
False,8118027,Hemmingen,45 - 50 Jahre,559,302,257
False,8118027,Hemmingen,50 - 55 Jahre,555,253,302
False,8118027,Hemmingen,55 - 60 Jahre,488,234,254
False,8118027,Hemmingen,60 - 65 Jahre,523,253,270
False,8118027,Hemmingen,65 - 75 Jahre,822,422,400
False,8118027,Hemmingen,75 und mehr Jahre,474,190,284
False,8118027,Hemmingen,Insgesamt,7571,3754,3817
False,8118028,Hessigheim,unter 3 Jahre,65,38,27
False,8118028,Hessigheim,3 -  6 Jahre,92,41,51
False,8118028,Hessigheim,6 - 10 Jahre,114,66,48
False,8118028,Hessigheim,10 - 15 Jahre,135,63,72
False,8118028,Hessigheim,15 - 18 Jahre,95,45,50
False,8118028,Hessigheim,18 - 20 Jahre,75,40,35
False,8118028,Hessigheim,20 - 25 Jahre,148,83,65
False,8118028,Hessigheim,25 - 30 Jahre,111,66,45
False,8118028,Hessigheim,30 - 35 Jahre,120,56,64
False,8118028,Hessigheim,35 - 40 Jahre,176,83,93
False,8118028,Hessigheim,40 - 45 Jahre,206,103,103
False,8118028,Hessigheim,45 - 50 Jahre,167,79,88
False,8118028,Hessigheim,50 - 55 Jahre,149,75,74
False,8118028,Hessigheim,55 - 60 Jahre,108,61,47
False,8118028,Hessigheim,60 - 65 Jahre,97,41,56
False,8118028,Hessigheim,65 - 75 Jahre,212,100,112
False,8118028,Hessigheim,75 und mehr Jahre,139,50,89
False,8118028,Hessigheim,Insgesamt,2209,1090,1119
False,8118040,Kirchheim am Neckar,unter 3 Jahre,161,96,65
False,8118040,Kirchheim am Neckar,3 -  6 Jahre,177,89,88
False,8118040,Kirchheim am Neckar,6 - 10 Jahre,240,117,123
False,8118040,Kirchheim am Neckar,10 - 15 Jahre,366,200,166
False,8118040,Kirchheim am Neckar,15 - 18 Jahre,231,111,120
False,8118040,Kirchheim am Neckar,18 - 20 Jahre,135,81,54
False,8118040,Kirchheim am Neckar,20 - 25 Jahre,327,152,175
False,8118040,Kirchheim am Neckar,25 - 30 Jahre,288,154,134
False,8118040,Kirchheim am Neckar,30 - 35 Jahre,343,152,191
False,8118040,Kirchheim am Neckar,35 - 40 Jahre,429,210,219
False,8118040,Kirchheim am Neckar,40 - 45 Jahre,457,246,211
False,8118040,Kirchheim am Neckar,45 - 50 Jahre,391,197,194
False,8118040,Kirchheim am Neckar,50 - 55 Jahre,311,167,144
False,8118040,Kirchheim am Neckar,55 - 60 Jahre,273,136,137
False,8118040,Kirchheim am Neckar,60 - 65 Jahre,219,111,108
False,8118040,Kirchheim am Neckar,65 - 75 Jahre,502,228,274
False,8118040,Kirchheim am Neckar,75 und mehr Jahre,338,120,218
False,8118040,Kirchheim am Neckar,Insgesamt,5188,2567,2621
False,8118046,"Kornwestheim, Stadt",unter 3 Jahre,909,443,466
False,8118046,"Kornwestheim, Stadt",3 -  6 Jahre,891,462,429
False,8118046,"Kornwestheim, Stadt",6 - 10 Jahre,1203,614,589
False,8118046,"Kornwestheim, Stadt",10 - 15 Jahre,1585,835,750
False,8118046,"Kornwestheim, Stadt",15 - 18 Jahre,1036,548,488
False,8118046,"Kornwestheim, Stadt",18 - 20 Jahre,604,305,299
False,8118046,"Kornwestheim, Stadt",20 - 25 Jahre,1807,882,925
False,8118046,"Kornwestheim, Stadt",25 - 30 Jahre,1982,976,1006
False,8118046,"Kornwestheim, Stadt",30 - 35 Jahre,2049,1036,1013
False,8118046,"Kornwestheim, Stadt",35 - 40 Jahre,2527,1309,1218
False,8118046,"Kornwestheim, Stadt",40 - 45 Jahre,2502,1312,1190
False,8118046,"Kornwestheim, Stadt",45 - 50 Jahre,2324,1178,1146
False,8118046,"Kornwestheim, Stadt",50 - 55 Jahre,1793,914,879
False,8118046,"Kornwestheim, Stadt",55 - 60 Jahre,1757,846,911
False,8118046,"Kornwestheim, Stadt",60 - 65 Jahre,1800,877,923
False,8118046,"Kornwestheim, Stadt",65 - 75 Jahre,3490,1682,1808
False,8118046,"Kornwestheim, Stadt",75 und mehr Jahre,2530,877,1653
False,8118046,"Kornwestheim, Stadt",Insgesamt,30789,15096,15693
False,8118047,Löchgau,unter 3 Jahre,139,69,70
False,8118047,Löchgau,3 -  6 Jahre,170,78,92
False,8118047,Löchgau,6 - 10 Jahre,246,117,129
False,8118047,Löchgau,10 - 15 Jahre,334,177,157
False,8118047,Löchgau,15 - 18 Jahre,233,129,104
False,8118047,Löchgau,18 - 20 Jahre,125,69,56
False,8118047,Löchgau,20 - 25 Jahre,269,132,137
False,8118047,Löchgau,25 - 30 Jahre,229,113,116
False,8118047,Löchgau,30 - 35 Jahre,272,121,151
False,8118047,Löchgau,35 - 40 Jahre,416,204,212
False,8118047,Löchgau,40 - 45 Jahre,489,267,222
False,8118047,Löchgau,45 - 50 Jahre,467,227,240
False,8118047,Löchgau,50 - 55 Jahre,368,188,180
False,8118047,Löchgau,55 - 60 Jahre,299,146,153
False,8118047,Löchgau,60 - 65 Jahre,316,161,155
False,8118047,Löchgau,65 - 75 Jahre,577,290,287
False,8118047,Löchgau,75 und mehr Jahre,377,140,237
False,8118047,Löchgau,Insgesamt,5326,2628,2698
False,8118048,"Ludwigsburg, Stadt",unter 3 Jahre,2472,1244,1228
False,8118048,"Ludwigsburg, Stadt",3 -  6 Jahre,2528,1299,1229
False,8118048,"Ludwigsburg, Stadt",6 - 10 Jahre,3385,1760,1625
False,8118048,"Ludwigsburg, Stadt",10 - 15 Jahre,4194,2113,2081
False,8118048,"Ludwigsburg, Stadt",15 - 18 Jahre,2791,1401,1390
False,8118048,"Ludwigsburg, Stadt",18 - 20 Jahre,1805,934,871
False,8118048,"Ludwigsburg, Stadt",20 - 25 Jahre,5274,2400,2874
False,8118048,"Ludwigsburg, Stadt",25 - 30 Jahre,6009,2990,3019
False,8118048,"Ludwigsburg, Stadt",30 - 35 Jahre,6536,3409,3127
False,8118048,"Ludwigsburg, Stadt",35 - 40 Jahre,7659,4037,3622
False,8118048,"Ludwigsburg, Stadt",40 - 45 Jahre,7251,3777,3474
False,8118048,"Ludwigsburg, Stadt",45 - 50 Jahre,6246,3206,3040
False,8118048,"Ludwigsburg, Stadt",50 - 55 Jahre,5258,2480,2778
False,8118048,"Ludwigsburg, Stadt",55 - 60 Jahre,5084,2460,2624
False,8118048,"Ludwigsburg, Stadt",60 - 65 Jahre,4976,2424,2552
False,8118048,"Ludwigsburg, Stadt",65 - 75 Jahre,9238,4305,4933
False,8118048,"Ludwigsburg, Stadt",75 und mehr Jahre,6967,2381,4586
False,8118048,"Ludwigsburg, Stadt",Insgesamt,87673,42620,45053
False,8118049,"Marbach am Neckar, Stadt",unter 3 Jahre,455,237,218
False,8118049,"Marbach am Neckar, Stadt",3 -  6 Jahre,486,243,243
False,8118049,"Marbach am Neckar, Stadt",6 - 10 Jahre,717,377,340
False,8118049,"Marbach am Neckar, Stadt",10 - 15 Jahre,931,490,441
False,8118049,"Marbach am Neckar, Stadt",15 - 18 Jahre,553,301,252
False,8118049,"Marbach am Neckar, Stadt",18 - 20 Jahre,341,193,148
False,8118049,"Marbach am Neckar, Stadt",20 - 25 Jahre,783,376,407
False,8118049,"Marbach am Neckar, Stadt",25 - 30 Jahre,1007,510,497
False,8118049,"Marbach am Neckar, Stadt",30 - 35 Jahre,1010,526,484
False,8118049,"Marbach am Neckar, Stadt",35 - 40 Jahre,1356,672,684
False,8118049,"Marbach am Neckar, Stadt",40 - 45 Jahre,1469,776,693
False,8118049,"Marbach am Neckar, Stadt",45 - 50 Jahre,1129,597,532
False,8118049,"Marbach am Neckar, Stadt",50 - 55 Jahre,958,444,514
False,8118049,"Marbach am Neckar, Stadt",55 - 60 Jahre,743,373,370
False,8118049,"Marbach am Neckar, Stadt",60 - 65 Jahre,856,417,439
False,8118049,"Marbach am Neckar, Stadt",65 - 75 Jahre,1575,728,847
False,8118049,"Marbach am Neckar, Stadt",75 und mehr Jahre,1148,416,732
False,8118049,"Marbach am Neckar, Stadt",Insgesamt,15517,7676,7841
False,8118050,"Markgröningen, Stadt",unter 3 Jahre,419,217,202
False,8118050,"Markgröningen, Stadt",3 -  6 Jahre,426,228,198
False,8118050,"Markgröningen, Stadt",6 - 10 Jahre,618,329,289
False,8118050,"Markgröningen, Stadt",10 - 15 Jahre,860,441,419
False,8118050,"Markgröningen, Stadt",15 - 18 Jahre,561,293,268
False,8118050,"Markgröningen, Stadt",18 - 20 Jahre,376,191,185
False,8118050,"Markgröningen, Stadt",20 - 25 Jahre,807,395,412
False,8118050,"Markgröningen, Stadt",25 - 30 Jahre,898,438,460
False,8118050,"Markgröningen, Stadt",30 - 35 Jahre,994,490,504
False,8118050,"Markgröningen, Stadt",35 - 40 Jahre,1262,648,614
False,8118050,"Markgröningen, Stadt",40 - 45 Jahre,1268,649,619
False,8118050,"Markgröningen, Stadt",45 - 50 Jahre,1174,582,592
False,8118050,"Markgröningen, Stadt",50 - 55 Jahre,987,507,480
False,8118050,"Markgröningen, Stadt",55 - 60 Jahre,846,457,389
False,8118050,"Markgröningen, Stadt",60 - 65 Jahre,781,409,372
False,8118050,"Markgröningen, Stadt",65 - 75 Jahre,1346,640,706
False,8118050,"Markgröningen, Stadt",75 und mehr Jahre,888,325,563
False,8118050,"Markgröningen, Stadt",Insgesamt,14511,7239,7272
False,8118051,Möglingen,unter 3 Jahre,283,132,151
False,8118051,Möglingen,3 -  6 Jahre,296,152,144
False,8118051,Möglingen,6 - 10 Jahre,440,218,222
False,8118051,Möglingen,10 - 15 Jahre,559,305,254
False,8118051,Möglingen,15 - 18 Jahre,375,184,191
False,8118051,Möglingen,18 - 20 Jahre,234,126,108
False,8118051,Möglingen,20 - 25 Jahre,537,249,288
False,8118051,Möglingen,25 - 30 Jahre,627,324,303
False,8118051,Möglingen,30 - 35 Jahre,691,348,343
False,8118051,Möglingen,35 - 40 Jahre,878,471,407
False,8118051,Möglingen,40 - 45 Jahre,903,479,424
False,8118051,Möglingen,45 - 50 Jahre,769,372,397
False,8118051,Möglingen,50 - 55 Jahre,623,313,310
False,8118051,Möglingen,55 - 60 Jahre,596,290,306
False,8118051,Möglingen,60 - 65 Jahre,679,324,355
False,8118051,Möglingen,65 - 75 Jahre,1228,605,623
False,8118051,Möglingen,75 und mehr Jahre,731,293,438
False,8118051,Möglingen,Insgesamt,10449,5185,5264
False,8118053,Mundelsheim,unter 3 Jahre,99,57,42
False,8118053,Mundelsheim,3 -  6 Jahre,100,58,42
False,8118053,Mundelsheim,6 - 10 Jahre,155,87,68
False,8118053,Mundelsheim,10 - 15 Jahre,207,110,97
False,8118053,Mundelsheim,15 - 18 Jahre,132,57,75
False,8118053,Mundelsheim,18 - 20 Jahre,71,36,35
False,8118053,Mundelsheim,20 - 25 Jahre,169,91,78
False,8118053,Mundelsheim,25 - 30 Jahre,148,68,80
False,8118053,Mundelsheim,30 - 35 Jahre,170,91,79
False,8118053,Mundelsheim,35 - 40 Jahre,253,116,137
False,8118053,Mundelsheim,40 - 45 Jahre,292,149,143
False,8118053,Mundelsheim,45 - 50 Jahre,281,152,129
False,8118053,Mundelsheim,50 - 55 Jahre,203,99,104
False,8118053,Mundelsheim,55 - 60 Jahre,179,90,89
False,8118053,Mundelsheim,60 - 65 Jahre,165,91,74
False,8118053,Mundelsheim,65 - 75 Jahre,359,174,185
False,8118053,Mundelsheim,75 und mehr Jahre,191,65,126
False,8118053,Mundelsheim,Insgesamt,3174,1591,1583
False,8118054,Murr,unter 3 Jahre,163,85,78
False,8118054,Murr,3 -  6 Jahre,202,96,106
False,8118054,Murr,6 - 10 Jahre,289,146,143
False,8118054,Murr,10 - 15 Jahre,356,163,193
False,8118054,Murr,15 - 18 Jahre,199,112,87
False,8118054,Murr,18 - 20 Jahre,133,72,61
False,8118054,Murr,20 - 25 Jahre,325,147,178
False,8118054,Murr,25 - 30 Jahre,341,162,179
False,8118054,Murr,30 - 35 Jahre,397,198,199
False,8118054,Murr,35 - 40 Jahre,603,316,287
False,8118054,Murr,40 - 45 Jahre,574,282,292
False,8118054,Murr,45 - 50 Jahre,442,227,215
False,8118054,Murr,50 - 55 Jahre,386,188,198
False,8118054,Murr,55 - 60 Jahre,346,165,181
False,8118054,Murr,60 - 65 Jahre,343,176,167
False,8118054,Murr,65 - 75 Jahre,590,285,305
False,8118054,Murr,75 und mehr Jahre,380,139,241
False,8118054,Murr,Insgesamt,6069,2959,3110
False,8118059,"Oberriexingen, Stadt",unter 3 Jahre,88,38,50
False,8118059,"Oberriexingen, Stadt",3 -  6 Jahre,94,52,42
False,8118059,"Oberriexingen, Stadt",6 - 10 Jahre,145,79,66
False,8118059,"Oberriexingen, Stadt",10 - 15 Jahre,217,124,93
False,8118059,"Oberriexingen, Stadt",15 - 18 Jahre,111,52,59
False,8118059,"Oberriexingen, Stadt",18 - 20 Jahre,65,31,34
False,8118059,"Oberriexingen, Stadt",20 - 25 Jahre,152,80,72
False,8118059,"Oberriexingen, Stadt",25 - 30 Jahre,171,90,81
False,8118059,"Oberriexingen, Stadt",30 - 35 Jahre,176,94,82
False,8118059,"Oberriexingen, Stadt",35 - 40 Jahre,289,142,147
False,8118059,"Oberriexingen, Stadt",40 - 45 Jahre,289,149,140
False,8118059,"Oberriexingen, Stadt",45 - 50 Jahre,262,142,120
False,8118059,"Oberriexingen, Stadt",50 - 55 Jahre,190,94,96
False,8118059,"Oberriexingen, Stadt",55 - 60 Jahre,169,85,84
False,8118059,"Oberriexingen, Stadt",60 - 65 Jahre,188,93,95
False,8118059,"Oberriexingen, Stadt",65 - 75 Jahre,256,130,126
False,8118059,"Oberriexingen, Stadt",75 und mehr Jahre,148,55,93
False,8118059,"Oberriexingen, Stadt",Insgesamt,3010,1530,1480
False,8118060,Oberstenfeld,unter 3 Jahre,213,105,108
False,8118060,Oberstenfeld,3 -  6 Jahre,251,132,119
False,8118060,Oberstenfeld,6 - 10 Jahre,353,185,168
False,8118060,Oberstenfeld,10 - 15 Jahre,518,275,243
False,8118060,Oberstenfeld,15 - 18 Jahre,324,169,155
False,8118060,Oberstenfeld,18 - 20 Jahre,206,116,90
False,8118060,Oberstenfeld,20 - 25 Jahre,478,271,207
False,8118060,Oberstenfeld,25 - 30 Jahre,411,221,190
False,8118060,Oberstenfeld,30 - 35 Jahre,444,216,228
False,8118060,Oberstenfeld,35 - 40 Jahre,634,304,330
False,8118060,Oberstenfeld,40 - 45 Jahre,687,332,355
False,8118060,Oberstenfeld,45 - 50 Jahre,636,325,311
False,8118060,Oberstenfeld,50 - 55 Jahre,470,236,234
False,8118060,Oberstenfeld,55 - 60 Jahre,513,245,268
False,8118060,Oberstenfeld,60 - 65 Jahre,527,256,271
False,8118060,Oberstenfeld,65 - 75 Jahre,873,442,431
False,8118060,Oberstenfeld,75 und mehr Jahre,511,190,321
False,8118060,Oberstenfeld,Insgesamt,8049,4020,4029
False,8118063,Pleidelsheim,unter 3 Jahre,179,103,76
False,8118063,Pleidelsheim,3 -  6 Jahre,189,97,92
False,8118063,Pleidelsheim,6 - 10 Jahre,357,188,169
False,8118063,Pleidelsheim,10 - 15 Jahre,400,227,173
False,8118063,Pleidelsheim,15 - 18 Jahre,244,115,129
False,8118063,Pleidelsheim,18 - 20 Jahre,132,58,74
False,8118063,Pleidelsheim,20 - 25 Jahre,322,146,176
False,8118063,Pleidelsheim,25 - 30 Jahre,365,162,203
False,8118063,Pleidelsheim,30 - 35 Jahre,392,193,199
False,8118063,Pleidelsheim,35 - 40 Jahre,582,287,295
False,8118063,Pleidelsheim,40 - 45 Jahre,632,333,299
False,8118063,Pleidelsheim,45 - 50 Jahre,483,235,248
False,8118063,Pleidelsheim,50 - 55 Jahre,414,193,221
False,8118063,Pleidelsheim,55 - 60 Jahre,316,171,145
False,8118063,Pleidelsheim,60 - 65 Jahre,324,157,167
False,8118063,Pleidelsheim,65 - 75 Jahre,578,277,301
False,8118063,Pleidelsheim,75 und mehr Jahre,415,138,277
False,8118063,Pleidelsheim,Insgesamt,6324,3080,3244
False,8118067,Schwieberdingen,unter 3 Jahre,369,187,182
False,8118067,Schwieberdingen,3 -  6 Jahre,347,173,174
False,8118067,Schwieberdingen,6 - 10 Jahre,424,226,198
False,8118067,Schwieberdingen,10 - 15 Jahre,544,271,273
False,8118067,Schwieberdingen,15 - 18 Jahre,333,170,163
False,8118067,Schwieberdingen,18 - 20 Jahre,188,80,108
False,8118067,Schwieberdingen,20 - 25 Jahre,551,253,298
False,8118067,Schwieberdingen,25 - 30 Jahre,754,393,361
False,8118067,Schwieberdingen,30 - 35 Jahre,837,463,374
False,8118067,Schwieberdingen,35 - 40 Jahre,971,502,469
False,8118067,Schwieberdingen,40 - 45 Jahre,863,482,381
False,8118067,Schwieberdingen,45 - 50 Jahre,810,436,374
False,8118067,Schwieberdingen,50 - 55 Jahre,655,305,350
False,8118067,Schwieberdingen,55 - 60 Jahre,630,318,312
False,8118067,Schwieberdingen,60 - 65 Jahre,707,361,346
False,8118067,Schwieberdingen,65 - 75 Jahre,1130,558,572
False,8118067,Schwieberdingen,75 und mehr Jahre,660,267,393
False,8118067,Schwieberdingen,Insgesamt,10773,5445,5328
False,8118068,Sersheim,unter 3 Jahre,146,71,75
False,8118068,Sersheim,3 -  6 Jahre,190,105,85
False,8118068,Sersheim,6 - 10 Jahre,296,135,161
False,8118068,Sersheim,10 - 15 Jahre,327,154,173
False,8118068,Sersheim,15 - 18 Jahre,200,104,96
False,8118068,Sersheim,18 - 20 Jahre,114,65,49
False,8118068,Sersheim,20 - 25 Jahre,275,143,132
False,8118068,Sersheim,25 - 30 Jahre,278,134,144
False,8118068,Sersheim,30 - 35 Jahre,295,138,157
False,8118068,Sersheim,35 - 40 Jahre,493,240,253
False,8118068,Sersheim,40 - 45 Jahre,463,245,218
False,8118068,Sersheim,45 - 50 Jahre,362,190,172
False,8118068,Sersheim,50 - 55 Jahre,334,173,161
False,8118068,Sersheim,55 - 60 Jahre,302,149,153
False,8118068,Sersheim,60 - 65 Jahre,250,122,128
False,8118068,Sersheim,65 - 75 Jahre,494,238,256
False,8118068,Sersheim,75 und mehr Jahre,314,119,195
False,8118068,Sersheim,Insgesamt,5133,2525,2608
False,8118070,"Steinheim an der Murr, Stadt",unter 3 Jahre,318,170,148
False,8118070,"Steinheim an der Murr, Stadt",3 -  6 Jahre,402,208,194
False,8118070,"Steinheim an der Murr, Stadt",6 - 10 Jahre,546,262,284
False,8118070,"Steinheim an der Murr, Stadt",10 - 15 Jahre,774,393,381
False,8118070,"Steinheim an der Murr, Stadt",15 - 18 Jahre,492,230,262
False,8118070,"Steinheim an der Murr, Stadt",18 - 20 Jahre,345,184,161
False,8118070,"Steinheim an der Murr, Stadt",20 - 25 Jahre,597,326,271
False,8118070,"Steinheim an der Murr, Stadt",25 - 30 Jahre,548,267,281
False,8118070,"Steinheim an der Murr, Stadt",30 - 35 Jahre,601,309,292
False,8118070,"Steinheim an der Murr, Stadt",35 - 40 Jahre,1023,519,504
False,8118070,"Steinheim an der Murr, Stadt",40 - 45 Jahre,1122,577,545
False,8118070,"Steinheim an der Murr, Stadt",45 - 50 Jahre,988,480,508
False,8118070,"Steinheim an der Murr, Stadt",50 - 55 Jahre,826,423,403
False,8118070,"Steinheim an der Murr, Stadt",55 - 60 Jahre,652,339,313
False,8118070,"Steinheim an der Murr, Stadt",60 - 65 Jahre,582,300,282
False,8118070,"Steinheim an der Murr, Stadt",65 - 75 Jahre,1118,541,577
False,8118070,"Steinheim an der Murr, Stadt",75 und mehr Jahre,702,247,455
False,8118070,"Steinheim an der Murr, Stadt",Insgesamt,11636,5775,5861
False,8118071,Tamm,unter 3 Jahre,295,159,136
False,8118071,Tamm,3 -  6 Jahre,300,140,160
False,8118071,Tamm,6 - 10 Jahre,476,257,219
False,8118071,Tamm,10 - 15 Jahre,675,347,328
False,8118071,Tamm,15 - 18 Jahre,400,208,192
False,8118071,Tamm,18 - 20 Jahre,286,153,133
False,8118071,Tamm,20 - 25 Jahre,710,369,341
False,8118071,Tamm,25 - 30 Jahre,714,349,365
False,8118071,Tamm,30 - 35 Jahre,792,418,374
False,8118071,Tamm,35 - 40 Jahre,947,491,456
False,8118071,Tamm,40 - 45 Jahre,1005,484,521
False,8118071,Tamm,45 - 50 Jahre,1028,488,540
False,8118071,Tamm,50 - 55 Jahre,976,442,534
False,8118071,Tamm,55 - 60 Jahre,885,456,429
False,8118071,Tamm,60 - 65 Jahre,788,405,383
False,8118071,Tamm,65 - 75 Jahre,1183,584,599
False,8118071,Tamm,75 und mehr Jahre,695,271,424
False,8118071,Tamm,Insgesamt,12155,6021,6134
False,8118073,"Vaihingen an der Enz, Stadt",unter 3 Jahre,863,421,442
False,8118073,"Vaihingen an der Enz, Stadt",3 -  6 Jahre,951,501,450
False,8118073,"Vaihingen an der Enz, Stadt",6 - 10 Jahre,1456,742,714
False,8118073,"Vaihingen an der Enz, Stadt",10 - 15 Jahre,1813,868,945
False,8118073,"Vaihingen an der Enz, Stadt",15 - 18 Jahre,1091,588,503
False,8118073,"Vaihingen an der Enz, Stadt",18 - 20 Jahre,689,383,306
False,8118073,"Vaihingen an der Enz, Stadt",20 - 25 Jahre,1615,841,774
False,8118073,"Vaihingen an der Enz, Stadt",25 - 30 Jahre,1712,902,810
False,8118073,"Vaihingen an der Enz, Stadt",30 - 35 Jahre,1722,872,850
False,8118073,"Vaihingen an der Enz, Stadt",35 - 40 Jahre,2480,1255,1225
False,8118073,"Vaihingen an der Enz, Stadt",40 - 45 Jahre,2599,1354,1245
False,8118073,"Vaihingen an der Enz, Stadt",45 - 50 Jahre,2212,1139,1073
False,8118073,"Vaihingen an der Enz, Stadt",50 - 55 Jahre,1771,913,858
False,8118073,"Vaihingen an der Enz, Stadt",55 - 60 Jahre,1587,792,795
False,8118073,"Vaihingen an der Enz, Stadt",60 - 65 Jahre,1597,801,796
False,8118073,"Vaihingen an der Enz, Stadt",65 - 75 Jahre,2882,1409,1473
False,8118073,"Vaihingen an der Enz, Stadt",75 und mehr Jahre,1881,641,1240
False,8118073,"Vaihingen an der Enz, Stadt",Insgesamt,28921,14422,14499
False,8118074,Walheim,unter 3 Jahre,82,37,45
False,8118074,Walheim,3 -  6 Jahre,107,54,53
False,8118074,Walheim,6 - 10 Jahre,140,76,64
False,8118074,Walheim,10 - 15 Jahre,193,101,92
False,8118074,Walheim,15 - 18 Jahre,123,60,63
False,8118074,Walheim,18 - 20 Jahre,66,28,38
False,8118074,Walheim,20 - 25 Jahre,182,99,83
False,8118074,Walheim,25 - 30 Jahre,157,77,80
False,8118074,Walheim,30 - 35 Jahre,169,91,78
False,8118074,Walheim,35 - 40 Jahre,251,117,134
False,8118074,Walheim,40 - 45 Jahre,265,145,120
False,8118074,Walheim,45 - 50 Jahre,203,102,101
False,8118074,Walheim,50 - 55 Jahre,216,106,110
False,8118074,Walheim,55 - 60 Jahre,156,84,72
False,8118074,Walheim,60 - 65 Jahre,173,88,85
False,8118074,Walheim,65 - 75 Jahre,336,152,184
False,8118074,Walheim,75 und mehr Jahre,229,88,141
False,8118074,Walheim,Insgesamt,3048,1505,1543
False,8118076,"Sachsenheim, Stadt",unter 3 Jahre,466,283,183
False,8118076,"Sachsenheim, Stadt",3 -  6 Jahre,521,287,234
False,8118076,"Sachsenheim, Stadt",6 - 10 Jahre,741,362,379
False,8118076,"Sachsenheim, Stadt",10 - 15 Jahre,989,495,494
False,8118076,"Sachsenheim, Stadt",15 - 18 Jahre,714,358,356
False,8118076,"Sachsenheim, Stadt",18 - 20 Jahre,461,228,233
False,8118076,"Sachsenheim, Stadt",20 - 25 Jahre,972,504,468
False,8118076,"Sachsenheim, Stadt",25 - 30 Jahre,862,429,433
False,8118076,"Sachsenheim, Stadt",30 - 35 Jahre,1013,483,530
False,8118076,"Sachsenheim, Stadt",35 - 40 Jahre,1377,715,662
False,8118076,"Sachsenheim, Stadt",40 - 45 Jahre,1495,782,713
False,8118076,"Sachsenheim, Stadt",45 - 50 Jahre,1391,719,672
False,8118076,"Sachsenheim, Stadt",50 - 55 Jahre,1159,587,572
False,8118076,"Sachsenheim, Stadt",55 - 60 Jahre,984,515,469
False,8118076,"Sachsenheim, Stadt",60 - 65 Jahre,985,475,510
False,8118076,"Sachsenheim, Stadt",65 - 75 Jahre,1819,901,918
False,8118076,"Sachsenheim, Stadt",75 und mehr Jahre,1273,463,810
False,8118076,"Sachsenheim, Stadt",Insgesamt,17222,8586,8636
False,8118077,Ingersheim,unter 3 Jahre,177,93,84
False,8118077,Ingersheim,3 -  6 Jahre,187,109,78
False,8118077,Ingersheim,6 - 10 Jahre,290,131,159
False,8118077,Ingersheim,10 - 15 Jahre,320,153,167
False,8118077,Ingersheim,15 - 18 Jahre,193,89,104
False,8118077,Ingersheim,18 - 20 Jahre,130,60,70
False,8118077,Ingersheim,20 - 25 Jahre,310,150,160
False,8118077,Ingersheim,25 - 30 Jahre,418,217,201
False,8118077,Ingersheim,30 - 35 Jahre,407,208,199
False,8118077,Ingersheim,35 - 40 Jahre,611,312,299
False,8118077,Ingersheim,40 - 45 Jahre,531,283,248
False,8118077,Ingersheim,45 - 50 Jahre,405,199,206
False,8118077,Ingersheim,50 - 55 Jahre,380,183,197
False,8118077,Ingersheim,55 - 60 Jahre,354,164,190
False,8118077,Ingersheim,60 - 65 Jahre,358,186,172
False,8118077,Ingersheim,65 - 75 Jahre,526,245,281
False,8118077,Ingersheim,75 und mehr Jahre,426,163,263
False,8118077,Ingersheim,Insgesamt,6023,2945,3078
False,8118078,"Freiberg am Neckar, Stadt",unter 3 Jahre,408,194,214
False,8118078,"Freiberg am Neckar, Stadt",3 -  6 Jahre,436,228,208
False,8118078,"Freiberg am Neckar, Stadt",6 - 10 Jahre,640,338,302
False,8118078,"Freiberg am Neckar, Stadt",10 - 15 Jahre,846,410,436
False,8118078,"Freiberg am Neckar, Stadt",15 - 18 Jahre,526,290,236
False,8118078,"Freiberg am Neckar, Stadt",18 - 20 Jahre,305,154,151
False,8118078,"Freiberg am Neckar, Stadt",20 - 25 Jahre,824,395,429
False,8118078,"Freiberg am Neckar, Stadt",25 - 30 Jahre,841,420,421
False,8118078,"Freiberg am Neckar, Stadt",30 - 35 Jahre,1007,510,497
False,8118078,"Freiberg am Neckar, Stadt",35 - 40 Jahre,1441,718,723
False,8118078,"Freiberg am Neckar, Stadt",40 - 45 Jahre,1444,715,729
False,8118078,"Freiberg am Neckar, Stadt",45 - 50 Jahre,1167,600,567
False,8118078,"Freiberg am Neckar, Stadt",50 - 55 Jahre,1006,494,512
False,8118078,"Freiberg am Neckar, Stadt",55 - 60 Jahre,935,457,478
False,8118078,"Freiberg am Neckar, Stadt",60 - 65 Jahre,909,447,462
False,8118078,"Freiberg am Neckar, Stadt",65 - 75 Jahre,1749,827,922
False,8118078,"Freiberg am Neckar, Stadt",75 und mehr Jahre,1026,409,617
False,8118078,"Freiberg am Neckar, Stadt",Insgesamt,15510,7606,7904
False,8118079,"Bietigheim-Bissingen, Stadt",unter 3 Jahre,1154,585,569
False,8118079,"Bietigheim-Bissingen, Stadt",3 -  6 Jahre,1237,635,602
False,8118079,"Bietigheim-Bissingen, Stadt",6 - 10 Jahre,1813,921,892
False,8118079,"Bietigheim-Bissingen, Stadt",10 - 15 Jahre,2194,1147,1047
False,8118079,"Bietigheim-Bissingen, Stadt",15 - 18 Jahre,1404,690,714
False,8118079,"Bietigheim-Bissingen, Stadt",18 - 20 Jahre,912,471,441
False,8118079,"Bietigheim-Bissingen, Stadt",20 - 25 Jahre,2377,1210,1167
False,8118079,"Bietigheim-Bissingen, Stadt",25 - 30 Jahre,2553,1275,1278
False,8118079,"Bietigheim-Bissingen, Stadt",30 - 35 Jahre,2707,1344,1363
False,8118079,"Bietigheim-Bissingen, Stadt",35 - 40 Jahre,3426,1753,1673
False,8118079,"Bietigheim-Bissingen, Stadt",40 - 45 Jahre,3444,1775,1669
False,8118079,"Bietigheim-Bissingen, Stadt",45 - 50 Jahre,3286,1666,1620
False,8118079,"Bietigheim-Bissingen, Stadt",50 - 55 Jahre,2739,1315,1424
False,8118079,"Bietigheim-Bissingen, Stadt",55 - 60 Jahre,2367,1146,1221
False,8118079,"Bietigheim-Bissingen, Stadt",60 - 65 Jahre,2526,1230,1296
False,8118079,"Bietigheim-Bissingen, Stadt",65 - 75 Jahre,4811,2293,2518
False,8118079,"Bietigheim-Bissingen, Stadt",75 und mehr Jahre,3206,1149,2057
False,8118079,"Bietigheim-Bissingen, Stadt",Insgesamt,42156,20605,21551
False,8118080,"Korntal-Münchingen, Stadt",unter 3 Jahre,538,287,251
False,8118080,"Korntal-Münchingen, Stadt",3 -  6 Jahre,527,269,258
False,8118080,"Korntal-Münchingen, Stadt",6 - 10 Jahre,767,420,347
False,8118080,"Korntal-Münchingen, Stadt",10 - 15 Jahre,971,522,449
False,8118080,"Korntal-Münchingen, Stadt",15 - 18 Jahre,624,295,329
False,8118080,"Korntal-Münchingen, Stadt",18 - 20 Jahre,351,187,164
False,8118080,"Korntal-Münchingen, Stadt",20 - 25 Jahre,923,437,486
False,8118080,"Korntal-Münchingen, Stadt",25 - 30 Jahre,1078,521,557
False,8118080,"Korntal-Münchingen, Stadt",30 - 35 Jahre,1253,610,643
False,8118080,"Korntal-Münchingen, Stadt",35 - 40 Jahre,1663,884,779
False,8118080,"Korntal-Münchingen, Stadt",40 - 45 Jahre,1631,865,766
False,8118080,"Korntal-Münchingen, Stadt",45 - 50 Jahre,1293,690,603
False,8118080,"Korntal-Münchingen, Stadt",50 - 55 Jahre,1110,528,582
False,8118080,"Korntal-Münchingen, Stadt",55 - 60 Jahre,1008,471,537
False,8118080,"Korntal-Münchingen, Stadt",60 - 65 Jahre,1100,544,556
False,8118080,"Korntal-Münchingen, Stadt",65 - 75 Jahre,1951,925,1026
False,8118080,"Korntal-Münchingen, Stadt",75 und mehr Jahre,1408,503,905
False,8118080,"Korntal-Münchingen, Stadt",Insgesamt,18196,8958,9238
False,8118081,"Remseck am Neckar, Stadt",unter 3 Jahre,705,337,368
False,8118081,"Remseck am Neckar, Stadt",3 -  6 Jahre,741,378,363
False,8118081,"Remseck am Neckar, Stadt",6 - 10 Jahre,1066,559,507
False,8118081,"Remseck am Neckar, Stadt",10 - 15 Jahre,1361,678,683
False,8118081,"Remseck am Neckar, Stadt",15 - 18 Jahre,804,395,409
False,8118081,"Remseck am Neckar, Stadt",18 - 20 Jahre,482,253,229
False,8118081,"Remseck am Neckar, Stadt",20 - 25 Jahre,1136,559,577
False,8118081,"Remseck am Neckar, Stadt",25 - 30 Jahre,1308,644,664
False,8118081,"Remseck am Neckar, Stadt",30 - 35 Jahre,1489,713,776
False,8118081,"Remseck am Neckar, Stadt",35 - 40 Jahre,2055,1053,1002
False,8118081,"Remseck am Neckar, Stadt",40 - 45 Jahre,2131,1068,1063
False,8118081,"Remseck am Neckar, Stadt",45 - 50 Jahre,1726,899,827
False,8118081,"Remseck am Neckar, Stadt",50 - 55 Jahre,1458,696,762
False,8118081,"Remseck am Neckar, Stadt",55 - 60 Jahre,1349,690,659
False,8118081,"Remseck am Neckar, Stadt",60 - 65 Jahre,1237,598,639
False,8118081,"Remseck am Neckar, Stadt",65 - 75 Jahre,2119,1046,1073
False,8118081,"Remseck am Neckar, Stadt",75 und mehr Jahre,1248,479,769
False,8118081,"Remseck am Neckar, Stadt",Insgesamt,22415,11045,11370
False,8119,Landkreis Rems-Murr-Kreis,unter 3 Jahre,11672,5993,5679
False,8119,Landkreis Rems-Murr-Kreis,3 -  6 Jahre,12431,6249,6182
False,8119,Landkreis Rems-Murr-Kreis,6 - 10 Jahre,18476,9417,9059
False,8119,Landkreis Rems-Murr-Kreis,10 - 15 Jahre,24012,12222,11790
False,8119,Landkreis Rems-Murr-Kreis,15 - 18 Jahre,14721,7619,7102
False,8119,Landkreis Rems-Murr-Kreis,18 - 20 Jahre,9416,4847,4569
False,8119,Landkreis Rems-Murr-Kreis,20 - 25 Jahre,22404,11386,11018
False,8119,Landkreis Rems-Murr-Kreis,25 - 30 Jahre,23092,11396,11696
False,8119,Landkreis Rems-Murr-Kreis,30 - 35 Jahre,25750,12866,12884
False,8119,Landkreis Rems-Murr-Kreis,35 - 40 Jahre,35308,17931,17377
False,8119,Landkreis Rems-Murr-Kreis,40 - 45 Jahre,37144,19209,17935
False,8119,Landkreis Rems-Murr-Kreis,45 - 50 Jahre,31643,16168,15475
False,8119,Landkreis Rems-Murr-Kreis,50 - 55 Jahre,26850,13227,13623
False,8119,Landkreis Rems-Murr-Kreis,55 - 60 Jahre,24194,12008,12186
False,8119,Landkreis Rems-Murr-Kreis,60 - 65 Jahre,23830,11784,12046
False,8119,Landkreis Rems-Murr-Kreis,65 - 75 Jahre,45531,21903,23628
False,8119,Landkreis Rems-Murr-Kreis,75 und mehr Jahre,31223,11043,20180
False,8119,Landkreis Rems-Murr-Kreis,Insgesamt,417697,205268,212429
False,8119001,Alfdorf,unter 3 Jahre,196,102,94
False,8119001,Alfdorf,3 -  6 Jahre,258,138,120
False,8119001,Alfdorf,6 - 10 Jahre,394,206,188
False,8119001,Alfdorf,10 - 15 Jahre,514,261,253
False,8119001,Alfdorf,15 - 18 Jahre,355,193,162
False,8119001,Alfdorf,18 - 20 Jahre,193,100,93
False,8119001,Alfdorf,20 - 25 Jahre,368,198,170
False,8119001,Alfdorf,25 - 30 Jahre,347,184,163
False,8119001,Alfdorf,30 - 35 Jahre,403,203,200
False,8119001,Alfdorf,35 - 40 Jahre,616,308,308
False,8119001,Alfdorf,40 - 45 Jahre,625,328,297
False,8119001,Alfdorf,45 - 50 Jahre,587,291,296
False,8119001,Alfdorf,50 - 55 Jahre,451,236,215
False,8119001,Alfdorf,55 - 60 Jahre,347,191,156
False,8119001,Alfdorf,60 - 65 Jahre,340,168,172
False,8119001,Alfdorf,65 - 75 Jahre,729,331,398
False,8119001,Alfdorf,75 und mehr Jahre,540,210,330
False,8119001,Alfdorf,Insgesamt,7263,3648,3615
False,8119003,Allmersbach im Tal,unter 3 Jahre,114,55,59
False,8119003,Allmersbach im Tal,3 -  6 Jahre,153,89,64
False,8119003,Allmersbach im Tal,6 - 10 Jahre,220,113,107
False,8119003,Allmersbach im Tal,10 - 15 Jahre,304,158,146
False,8119003,Allmersbach im Tal,15 - 18 Jahre,194,92,102
False,8119003,Allmersbach im Tal,18 - 20 Jahre,105,52,53
False,8119003,Allmersbach im Tal,20 - 25 Jahre,253,126,127
False,8119003,Allmersbach im Tal,25 - 30 Jahre,200,108,92
False,8119003,Allmersbach im Tal,30 - 35 Jahre,282,132,150
False,8119003,Allmersbach im Tal,35 - 40 Jahre,462,224,238
False,8119003,Allmersbach im Tal,40 - 45 Jahre,472,240,232
False,8119003,Allmersbach im Tal,45 - 50 Jahre,358,182,176
False,8119003,Allmersbach im Tal,50 - 55 Jahre,285,138,147
False,8119003,Allmersbach im Tal,55 - 60 Jahre,264,131,133
False,8119003,Allmersbach im Tal,60 - 65 Jahre,300,150,150
False,8119003,Allmersbach im Tal,65 - 75 Jahre,565,301,264
False,8119003,Allmersbach im Tal,75 und mehr Jahre,336,112,224
False,8119003,Allmersbach im Tal,Insgesamt,4867,2403,2464
False,8119004,Althütte,unter 3 Jahre,128,68,60
False,8119004,Althütte,3 -  6 Jahre,125,65,60
False,8119004,Althütte,6 - 10 Jahre,247,121,126
False,8119004,Althütte,10 - 15 Jahre,273,138,135
False,8119004,Althütte,15 - 18 Jahre,144,87,57
False,8119004,Althütte,18 - 20 Jahre,109,54,55
False,8119004,Althütte,20 - 25 Jahre,199,99,100
False,8119004,Althütte,25 - 30 Jahre,173,72,101
False,8119004,Althütte,30 - 35 Jahre,238,122,116
False,8119004,Althütte,35 - 40 Jahre,373,167,206
False,8119004,Althütte,40 - 45 Jahre,381,208,173
False,8119004,Althütte,45 - 50 Jahre,314,173,141
False,8119004,Althütte,50 - 55 Jahre,268,136,132
False,8119004,Althütte,55 - 60 Jahre,256,125,131
False,8119004,Althütte,60 - 65 Jahre,248,122,126
False,8119004,Althütte,65 - 75 Jahre,416,210,206
False,8119004,Althütte,75 und mehr Jahre,289,103,186
False,8119004,Althütte,Insgesamt,4181,2070,2111
False,8119006,Auenwald,unter 3 Jahre,213,113,100
False,8119006,Auenwald,3 -  6 Jahre,222,119,103
False,8119006,Auenwald,6 - 10 Jahre,332,155,177
False,8119006,Auenwald,10 - 15 Jahre,466,234,232
False,8119006,Auenwald,15 - 18 Jahre,259,136,123
False,8119006,Auenwald,18 - 20 Jahre,177,86,91
False,8119006,Auenwald,20 - 25 Jahre,351,171,180
False,8119006,Auenwald,25 - 30 Jahre,363,195,168
False,8119006,Auenwald,30 - 35 Jahre,466,221,245
False,8119006,Auenwald,35 - 40 Jahre,609,307,302
False,8119006,Auenwald,40 - 45 Jahre,657,330,327
False,8119006,Auenwald,45 - 50 Jahre,544,263,281
False,8119006,Auenwald,50 - 55 Jahre,459,224,235
False,8119006,Auenwald,55 - 60 Jahre,428,214,214
False,8119006,Auenwald,60 - 65 Jahre,402,199,203
False,8119006,Auenwald,65 - 75 Jahre,705,367,338
False,8119006,Auenwald,75 und mehr Jahre,373,125,248
False,8119006,Auenwald,Insgesamt,7026,3459,3567
False,8119008,"Backnang, Stadt",unter 3 Jahre,991,519,472
False,8119008,"Backnang, Stadt",3 -  6 Jahre,1048,514,534
False,8119008,"Backnang, Stadt",6 - 10 Jahre,1600,798,802
False,8119008,"Backnang, Stadt",10 - 15 Jahre,2094,1066,1028
False,8119008,"Backnang, Stadt",15 - 18 Jahre,1340,673,667
False,8119008,"Backnang, Stadt",18 - 20 Jahre,849,402,447
False,8119008,"Backnang, Stadt",20 - 25 Jahre,2046,1093,953
False,8119008,"Backnang, Stadt",25 - 30 Jahre,1927,974,953
False,8119008,"Backnang, Stadt",30 - 35 Jahre,2180,1136,1044
False,8119008,"Backnang, Stadt",35 - 40 Jahre,2769,1467,1302
False,8119008,"Backnang, Stadt",40 - 45 Jahre,3143,1660,1483
False,8119008,"Backnang, Stadt",45 - 50 Jahre,2825,1506,1319
False,8119008,"Backnang, Stadt",50 - 55 Jahre,2281,1119,1162
False,8119008,"Backnang, Stadt",55 - 60 Jahre,2039,1002,1037
False,8119008,"Backnang, Stadt",60 - 65 Jahre,1898,971,927
False,8119008,"Backnang, Stadt",65 - 75 Jahre,3817,1825,1992
False,8119008,"Backnang, Stadt",75 und mehr Jahre,2914,1062,1852
False,8119008,"Backnang, Stadt",Insgesamt,35761,17787,17974
False,8119018,Burgstetten,unter 3 Jahre,86,42,44
False,8119018,Burgstetten,3 -  6 Jahre,113,58,55
False,8119018,Burgstetten,6 - 10 Jahre,173,90,83
False,8119018,Burgstetten,10 - 15 Jahre,245,122,123
False,8119018,Burgstetten,15 - 18 Jahre,126,77,49
False,8119018,Burgstetten,18 - 20 Jahre,106,53,53
False,8119018,Burgstetten,20 - 25 Jahre,185,94,91
False,8119018,Burgstetten,25 - 30 Jahre,172,81,91
False,8119018,Burgstetten,30 - 35 Jahre,183,90,93
False,8119018,Burgstetten,35 - 40 Jahre,288,146,142
False,8119018,Burgstetten,40 - 45 Jahre,337,159,178
False,8119018,Burgstetten,45 - 50 Jahre,267,130,137
False,8119018,Burgstetten,50 - 55 Jahre,218,115,103
False,8119018,Burgstetten,55 - 60 Jahre,199,99,100
False,8119018,Burgstetten,60 - 65 Jahre,164,94,70
False,8119018,Burgstetten,65 - 75 Jahre,322,160,162
False,8119018,Burgstetten,75 und mehr Jahre,222,89,133
False,8119018,Burgstetten,Insgesamt,3406,1699,1707
False,8119020,"Fellbach, Stadt",unter 3 Jahre,1261,647,614
False,8119020,"Fellbach, Stadt",3 -  6 Jahre,1252,625,627
False,8119020,"Fellbach, Stadt",6 - 10 Jahre,1721,856,865
False,8119020,"Fellbach, Stadt",10 - 15 Jahre,2157,1111,1046
False,8119020,"Fellbach, Stadt",15 - 18 Jahre,1351,705,646
False,8119020,"Fellbach, Stadt",18 - 20 Jahre,954,510,444
False,8119020,"Fellbach, Stadt",20 - 25 Jahre,2327,1149,1178
False,8119020,"Fellbach, Stadt",25 - 30 Jahre,2885,1342,1543
False,8119020,"Fellbach, Stadt",30 - 35 Jahre,3091,1568,1523
False,8119020,"Fellbach, Stadt",35 - 40 Jahre,3975,2129,1846
False,8119020,"Fellbach, Stadt",40 - 45 Jahre,3870,2004,1866
False,8119020,"Fellbach, Stadt",45 - 50 Jahre,3209,1628,1581
False,8119020,"Fellbach, Stadt",50 - 55 Jahre,2703,1303,1400
False,8119020,"Fellbach, Stadt",55 - 60 Jahre,2519,1251,1268
False,8119020,"Fellbach, Stadt",60 - 65 Jahre,2525,1209,1316
False,8119020,"Fellbach, Stadt",65 - 75 Jahre,4845,2297,2548
False,8119020,"Fellbach, Stadt",75 und mehr Jahre,3409,1154,2255
False,8119020,"Fellbach, Stadt",Insgesamt,44054,21488,22566
False,8119024,Großerlach,unter 3 Jahre,46,26,20
False,8119024,Großerlach,3 -  6 Jahre,48,24,24
False,8119024,Großerlach,6 - 10 Jahre,106,57,49
False,8119024,Großerlach,10 - 15 Jahre,169,84,85
False,8119024,Großerlach,15 - 18 Jahre,99,45,54
False,8119024,Großerlach,18 - 20 Jahre,54,30,24
False,8119024,Großerlach,20 - 25 Jahre,107,58,49
False,8119024,Großerlach,25 - 30 Jahre,75,45,30
False,8119024,Großerlach,30 - 35 Jahre,108,61,47
False,8119024,Großerlach,35 - 40 Jahre,204,118,86
False,8119024,Großerlach,40 - 45 Jahre,247,140,107
False,8119024,Großerlach,45 - 50 Jahre,238,145,93
False,8119024,Großerlach,50 - 55 Jahre,201,133,68
False,8119024,Großerlach,55 - 60 Jahre,185,112,73
False,8119024,Großerlach,60 - 65 Jahre,153,95,58
False,8119024,Großerlach,65 - 75 Jahre,271,163,108
False,8119024,Großerlach,75 und mehr Jahre,313,84,229
False,8119024,Großerlach,Insgesamt,2624,1420,1204
False,8119037,Kaisersbach,unter 3 Jahre,66,43,23
False,8119037,Kaisersbach,3 -  6 Jahre,81,45,36
False,8119037,Kaisersbach,6 - 10 Jahre,126,66,60
False,8119037,Kaisersbach,10 - 15 Jahre,195,100,95
False,8119037,Kaisersbach,15 - 18 Jahre,118,69,49
False,8119037,Kaisersbach,18 - 20 Jahre,82,35,47
False,8119037,Kaisersbach,20 - 25 Jahre,166,96,70
False,8119037,Kaisersbach,25 - 30 Jahre,124,61,63
False,8119037,Kaisersbach,30 - 35 Jahre,113,63,50
False,8119037,Kaisersbach,35 - 40 Jahre,239,108,131
False,8119037,Kaisersbach,40 - 45 Jahre,259,135,124
False,8119037,Kaisersbach,45 - 50 Jahre,215,110,105
False,8119037,Kaisersbach,50 - 55 Jahre,199,101,98
False,8119037,Kaisersbach,55 - 60 Jahre,131,65,66
False,8119037,Kaisersbach,60 - 65 Jahre,117,64,53
False,8119037,Kaisersbach,65 - 75 Jahre,242,119,123
False,8119037,Kaisersbach,75 und mehr Jahre,228,81,147
False,8119037,Kaisersbach,Insgesamt,2701,1361,1340
False,8119038,Kirchberg an der Murr,unter 3 Jahre,114,53,61
False,8119038,Kirchberg an der Murr,3 -  6 Jahre,124,49,75
False,8119038,Kirchberg an der Murr,6 - 10 Jahre,171,94,77
False,8119038,Kirchberg an der Murr,10 - 15 Jahre,212,105,107
False,8119038,Kirchberg an der Murr,15 - 18 Jahre,131,72,59
False,8119038,Kirchberg an der Murr,18 - 20 Jahre,76,39,37
False,8119038,Kirchberg an der Murr,20 - 25 Jahre,193,111,82
False,8119038,Kirchberg an der Murr,25 - 30 Jahre,201,100,101
False,8119038,Kirchberg an der Murr,30 - 35 Jahre,247,123,124
False,8119038,Kirchberg an der Murr,35 - 40 Jahre,305,154,151
False,8119038,Kirchberg an der Murr,40 - 45 Jahre,325,169,156
False,8119038,Kirchberg an der Murr,45 - 50 Jahre,255,136,119
False,8119038,Kirchberg an der Murr,50 - 55 Jahre,238,119,119
False,8119038,Kirchberg an der Murr,55 - 60 Jahre,185,92,93
False,8119038,Kirchberg an der Murr,60 - 65 Jahre,226,126,100
False,8119038,Kirchberg an der Murr,65 - 75 Jahre,371,185,186
False,8119038,Kirchberg an der Murr,75 und mehr Jahre,261,111,150
False,8119038,Kirchberg an der Murr,Insgesamt,3635,1838,1797
False,8119041,Korb,unter 3 Jahre,272,131,141
False,8119041,Korb,3 -  6 Jahre,281,134,147
False,8119041,Korb,6 - 10 Jahre,450,231,219
False,8119041,Korb,10 - 15 Jahre,597,295,302
False,8119041,Korb,15 - 18 Jahre,355,177,178
False,8119041,Korb,18 - 20 Jahre,184,84,100
False,8119041,Korb,20 - 25 Jahre,491,254,237
False,8119041,Korb,25 - 30 Jahre,595,309,286
False,8119041,Korb,30 - 35 Jahre,643,330,313
False,8119041,Korb,35 - 40 Jahre,947,481,466
False,8119041,Korb,40 - 45 Jahre,1022,528,494
False,8119041,Korb,45 - 50 Jahre,771,415,356
False,8119041,Korb,50 - 55 Jahre,663,338,325
False,8119041,Korb,55 - 60 Jahre,593,274,319
False,8119041,Korb,60 - 65 Jahre,596,285,311
False,8119041,Korb,65 - 75 Jahre,1210,583,627
False,8119041,Korb,75 und mehr Jahre,715,284,431
False,8119041,Korb,Insgesamt,10385,5133,5252
False,8119042,Leutenbach,unter 3 Jahre,313,160,153
False,8119042,Leutenbach,3 -  6 Jahre,313,167,146
False,8119042,Leutenbach,6 - 10 Jahre,444,206,238
False,8119042,Leutenbach,10 - 15 Jahre,656,318,338
False,8119042,Leutenbach,15 - 18 Jahre,390,215,175
False,8119042,Leutenbach,18 - 20 Jahre,233,121,112
False,8119042,Leutenbach,20 - 25 Jahre,580,272,308
False,8119042,Leutenbach,25 - 30 Jahre,587,279,308
False,8119042,Leutenbach,30 - 35 Jahre,655,329,326
False,8119042,Leutenbach,35 - 40 Jahre,959,471,488
False,8119042,Leutenbach,40 - 45 Jahre,1015,502,513
False,8119042,Leutenbach,45 - 50 Jahre,866,441,425
False,8119042,Leutenbach,50 - 55 Jahre,683,323,360
False,8119042,Leutenbach,55 - 60 Jahre,672,334,338
False,8119042,Leutenbach,60 - 65 Jahre,672,321,351
False,8119042,Leutenbach,65 - 75 Jahre,1134,563,571
False,8119042,Leutenbach,75 und mehr Jahre,666,241,425
False,8119042,Leutenbach,Insgesamt,10838,5263,5575
False,8119044,"Murrhardt, Stadt",unter 3 Jahre,368,176,192
False,8119044,"Murrhardt, Stadt",3 -  6 Jahre,390,191,199
False,8119044,"Murrhardt, Stadt",6 - 10 Jahre,608,301,307
False,8119044,"Murrhardt, Stadt",10 - 15 Jahre,773,390,383
False,8119044,"Murrhardt, Stadt",15 - 18 Jahre,487,257,230
False,8119044,"Murrhardt, Stadt",18 - 20 Jahre,328,187,141
False,8119044,"Murrhardt, Stadt",20 - 25 Jahre,819,402,417
False,8119044,"Murrhardt, Stadt",25 - 30 Jahre,686,370,316
False,8119044,"Murrhardt, Stadt",30 - 35 Jahre,760,376,384
False,8119044,"Murrhardt, Stadt",35 - 40 Jahre,1017,533,484
False,8119044,"Murrhardt, Stadt",40 - 45 Jahre,1204,610,594
False,8119044,"Murrhardt, Stadt",45 - 50 Jahre,1105,572,533
False,8119044,"Murrhardt, Stadt",50 - 55 Jahre,1005,510,495
False,8119044,"Murrhardt, Stadt",55 - 60 Jahre,826,420,406
False,8119044,"Murrhardt, Stadt",60 - 65 Jahre,813,422,391
False,8119044,"Murrhardt, Stadt",65 - 75 Jahre,1693,798,895
False,8119044,"Murrhardt, Stadt",75 und mehr Jahre,1412,468,944
False,8119044,"Murrhardt, Stadt",Insgesamt,14294,6983,7311
False,8119053,Oppenweiler,unter 3 Jahre,133,74,59
False,8119053,Oppenweiler,3 -  6 Jahre,145,77,68
False,8119053,Oppenweiler,6 - 10 Jahre,185,90,95
False,8119053,Oppenweiler,10 - 15 Jahre,242,126,116
False,8119053,Oppenweiler,15 - 18 Jahre,161,84,77
False,8119053,Oppenweiler,18 - 20 Jahre,95,69,26
False,8119053,Oppenweiler,20 - 25 Jahre,253,130,123
False,8119053,Oppenweiler,25 - 30 Jahre,248,118,130
False,8119053,Oppenweiler,30 - 35 Jahre,229,118,111
False,8119053,Oppenweiler,35 - 40 Jahre,324,165,159
False,8119053,Oppenweiler,40 - 45 Jahre,370,183,187
False,8119053,Oppenweiler,45 - 50 Jahre,358,179,179
False,8119053,Oppenweiler,50 - 55 Jahre,277,134,143
False,8119053,Oppenweiler,55 - 60 Jahre,260,140,120
False,8119053,Oppenweiler,60 - 65 Jahre,232,119,113
False,8119053,Oppenweiler,65 - 75 Jahre,480,233,247
False,8119053,Oppenweiler,75 und mehr Jahre,318,118,200
False,8119053,Oppenweiler,Insgesamt,4310,2157,2153
False,8119055,Plüderhausen,unter 3 Jahre,270,136,134
False,8119055,Plüderhausen,3 -  6 Jahre,293,155,138
False,8119055,Plüderhausen,6 - 10 Jahre,439,230,209
False,8119055,Plüderhausen,10 - 15 Jahre,525,287,238
False,8119055,Plüderhausen,15 - 18 Jahre,341,168,173
False,8119055,Plüderhausen,18 - 20 Jahre,239,124,115
False,8119055,Plüderhausen,20 - 25 Jahre,527,291,236
False,8119055,Plüderhausen,25 - 30 Jahre,498,261,237
False,8119055,Plüderhausen,30 - 35 Jahre,590,294,296
False,8119055,Plüderhausen,35 - 40 Jahre,795,390,405
False,8119055,Plüderhausen,40 - 45 Jahre,823,408,415
False,8119055,Plüderhausen,45 - 50 Jahre,740,388,352
False,8119055,Plüderhausen,50 - 55 Jahre,615,315,300
False,8119055,Plüderhausen,55 - 60 Jahre,573,271,302
False,8119055,Plüderhausen,60 - 65 Jahre,561,275,286
False,8119055,Plüderhausen,65 - 75 Jahre,1063,517,546
False,8119055,Plüderhausen,75 und mehr Jahre,682,246,436
False,8119055,Plüderhausen,Insgesamt,9574,4756,4818
False,8119061,Rudersberg,unter 3 Jahre,314,157,157
False,8119061,Rudersberg,3 -  6 Jahre,385,186,199
False,8119061,Rudersberg,6 - 10 Jahre,576,305,271
False,8119061,Rudersberg,10 - 15 Jahre,717,357,360
False,8119061,Rudersberg,15 - 18 Jahre,489,257,232
False,8119061,Rudersberg,18 - 20 Jahre,311,159,152
False,8119061,Rudersberg,20 - 25 Jahre,675,363,312
False,8119061,Rudersberg,25 - 30 Jahre,550,276,274
False,8119061,Rudersberg,30 - 35 Jahre,621,328,293
False,8119061,Rudersberg,35 - 40 Jahre,930,450,480
False,8119061,Rudersberg,40 - 45 Jahre,1073,565,508
False,8119061,Rudersberg,45 - 50 Jahre,867,441,426
False,8119061,Rudersberg,50 - 55 Jahre,822,407,415
False,8119061,Rudersberg,55 - 60 Jahre,679,352,327
False,8119061,Rudersberg,60 - 65 Jahre,613,309,304
False,8119061,Rudersberg,65 - 75 Jahre,1241,626,615
False,8119061,Rudersberg,75 und mehr Jahre,842,306,536
False,8119061,Rudersberg,Insgesamt,11705,5844,5861
False,8119067,"Schorndorf, Stadt",unter 3 Jahre,1076,553,523
False,8119067,"Schorndorf, Stadt",3 -  6 Jahre,1150,560,590
False,8119067,"Schorndorf, Stadt",6 - 10 Jahre,1619,819,800
False,8119067,"Schorndorf, Stadt",10 - 15 Jahre,2164,1075,1089
False,8119067,"Schorndorf, Stadt",15 - 18 Jahre,1407,736,671
False,8119067,"Schorndorf, Stadt",18 - 20 Jahre,863,438,425
False,8119067,"Schorndorf, Stadt",20 - 25 Jahre,2079,1042,1037
False,8119067,"Schorndorf, Stadt",25 - 30 Jahre,2184,1075,1109
False,8119067,"Schorndorf, Stadt",30 - 35 Jahre,2320,1136,1184
False,8119067,"Schorndorf, Stadt",35 - 40 Jahre,3121,1538,1583
False,8119067,"Schorndorf, Stadt",40 - 45 Jahre,3277,1727,1550
False,8119067,"Schorndorf, Stadt",45 - 50 Jahre,2878,1437,1441
False,8119067,"Schorndorf, Stadt",50 - 55 Jahre,2631,1283,1348
False,8119067,"Schorndorf, Stadt",55 - 60 Jahre,2391,1178,1213
False,8119067,"Schorndorf, Stadt",60 - 65 Jahre,2329,1103,1226
False,8119067,"Schorndorf, Stadt",65 - 75 Jahre,4521,2200,2321
False,8119067,"Schorndorf, Stadt",75 und mehr Jahre,3295,1132,2163
False,8119067,"Schorndorf, Stadt",Insgesamt,39305,19032,20273
False,8119068,Schwaikheim,unter 3 Jahre,276,153,123
False,8119068,Schwaikheim,3 -  6 Jahre,299,142,157
False,8119068,Schwaikheim,6 - 10 Jahre,481,229,252
False,8119068,Schwaikheim,10 - 15 Jahre,544,287,257
False,8119068,Schwaikheim,15 - 18 Jahre,299,165,134
False,8119068,Schwaikheim,18 - 20 Jahre,178,87,91
False,8119068,Schwaikheim,20 - 25 Jahre,461,251,210
False,8119068,Schwaikheim,25 - 30 Jahre,518,244,274
False,8119068,Schwaikheim,30 - 35 Jahre,606,302,304
False,8119068,Schwaikheim,35 - 40 Jahre,815,410,405
False,8119068,Schwaikheim,40 - 45 Jahre,890,445,445
False,8119068,Schwaikheim,45 - 50 Jahre,683,364,319
False,8119068,Schwaikheim,50 - 55 Jahre,594,279,315
False,8119068,Schwaikheim,55 - 60 Jahre,573,301,272
False,8119068,Schwaikheim,60 - 65 Jahre,507,245,262
False,8119068,Schwaikheim,65 - 75 Jahre,1013,477,536
False,8119068,Schwaikheim,75 und mehr Jahre,579,233,346
False,8119068,Schwaikheim,Insgesamt,9316,4614,4702
False,8119069,Spiegelberg,unter 3 Jahre,54,29,25
False,8119069,Spiegelberg,3 -  6 Jahre,59,29,30
False,8119069,Spiegelberg,6 - 10 Jahre,101,59,42
False,8119069,Spiegelberg,10 - 15 Jahre,167,91,76
False,8119069,Spiegelberg,15 - 18 Jahre,95,55,40
False,8119069,Spiegelberg,18 - 20 Jahre,52,25,27
False,8119069,Spiegelberg,20 - 25 Jahre,126,69,57
False,8119069,Spiegelberg,25 - 30 Jahre,111,60,51
False,8119069,Spiegelberg,30 - 35 Jahre,101,50,51
False,8119069,Spiegelberg,35 - 40 Jahre,183,105,78
False,8119069,Spiegelberg,40 - 45 Jahre,216,108,108
False,8119069,Spiegelberg,45 - 50 Jahre,194,107,87
False,8119069,Spiegelberg,50 - 55 Jahre,164,91,73
False,8119069,Spiegelberg,55 - 60 Jahre,104,63,41
False,8119069,Spiegelberg,60 - 65 Jahre,73,37,36
False,8119069,Spiegelberg,65 - 75 Jahre,217,98,119
False,8119069,Spiegelberg,75 und mehr Jahre,150,45,105
False,8119069,Spiegelberg,Insgesamt,2167,1121,1046
False,8119075,Sulzbach an der Murr,unter 3 Jahre,149,70,79
False,8119075,Sulzbach an der Murr,3 -  6 Jahre,165,83,82
False,8119075,Sulzbach an der Murr,6 - 10 Jahre,246,130,116
False,8119075,Sulzbach an der Murr,10 - 15 Jahre,360,173,187
False,8119075,Sulzbach an der Murr,15 - 18 Jahre,246,128,118
False,8119075,Sulzbach an der Murr,18 - 20 Jahre,128,64,64
False,8119075,Sulzbach an der Murr,20 - 25 Jahre,273,143,130
False,8119075,Sulzbach an der Murr,25 - 30 Jahre,281,149,132
False,8119075,Sulzbach an der Murr,30 - 35 Jahre,325,157,168
False,8119075,Sulzbach an der Murr,35 - 40 Jahre,456,220,236
False,8119075,Sulzbach an der Murr,40 - 45 Jahre,466,225,241
False,8119075,Sulzbach an der Murr,45 - 50 Jahre,429,223,206
False,8119075,Sulzbach an der Murr,50 - 55 Jahre,333,174,159
False,8119075,Sulzbach an der Murr,55 - 60 Jahre,315,155,160
False,8119075,Sulzbach an der Murr,60 - 65 Jahre,287,147,140
False,8119075,Sulzbach an der Murr,65 - 75 Jahre,579,266,313
False,8119075,Sulzbach an der Murr,75 und mehr Jahre,415,135,280
False,8119075,Sulzbach an der Murr,Insgesamt,5453,2642,2811
False,8119076,Urbach,unter 3 Jahre,263,132,131
False,8119076,Urbach,3 -  6 Jahre,295,142,153
False,8119076,Urbach,6 - 10 Jahre,411,230,181
False,8119076,Urbach,10 - 15 Jahre,533,259,274
False,8119076,Urbach,15 - 18 Jahre,317,177,140
False,8119076,Urbach,18 - 20 Jahre,201,99,102
False,8119076,Urbach,20 - 25 Jahre,459,240,219
False,8119076,Urbach,25 - 30 Jahre,395,208,187
False,8119076,Urbach,30 - 35 Jahre,541,267,274
False,8119076,Urbach,35 - 40 Jahre,810,408,402
False,8119076,Urbach,40 - 45 Jahre,778,400,378
False,8119076,Urbach,45 - 50 Jahre,659,338,321
False,8119076,Urbach,50 - 55 Jahre,474,231,243
False,8119076,Urbach,55 - 60 Jahre,460,225,235
False,8119076,Urbach,60 - 65 Jahre,410,203,207
False,8119076,Urbach,65 - 75 Jahre,917,435,482
False,8119076,Urbach,75 und mehr Jahre,607,203,404
False,8119076,Urbach,Insgesamt,8530,4197,4333
False,8119079,"Waiblingen, Stadt",unter 3 Jahre,1485,743,742
False,8119079,"Waiblingen, Stadt",3 -  6 Jahre,1571,789,782
False,8119079,"Waiblingen, Stadt",6 - 10 Jahre,2237,1141,1096
False,8119079,"Waiblingen, Stadt",10 - 15 Jahre,2890,1482,1408
False,8119079,"Waiblingen, Stadt",15 - 18 Jahre,1663,857,806
False,8119079,"Waiblingen, Stadt",18 - 20 Jahre,1188,644,544
False,8119079,"Waiblingen, Stadt",20 - 25 Jahre,2833,1402,1431
False,8119079,"Waiblingen, Stadt",25 - 30 Jahre,3298,1597,1701
False,8119079,"Waiblingen, Stadt",30 - 35 Jahre,3570,1792,1778
False,8119079,"Waiblingen, Stadt",35 - 40 Jahre,4477,2308,2169
False,8119079,"Waiblingen, Stadt",40 - 45 Jahre,4600,2394,2206
False,8119079,"Waiblingen, Stadt",45 - 50 Jahre,3957,1984,1973
False,8119079,"Waiblingen, Stadt",50 - 55 Jahre,3384,1655,1729
False,8119079,"Waiblingen, Stadt",55 - 60 Jahre,3087,1482,1605
False,8119079,"Waiblingen, Stadt",60 - 65 Jahre,3154,1551,1603
False,8119079,"Waiblingen, Stadt",65 - 75 Jahre,5777,2711,3066
False,8119079,"Waiblingen, Stadt",75 und mehr Jahre,3685,1292,2393
False,8119079,"Waiblingen, Stadt",Insgesamt,52856,25824,27032
False,8119083,Weissach im Tal,unter 3 Jahre,176,85,91
False,8119083,Weissach im Tal,3 -  6 Jahre,200,105,95
False,8119083,Weissach im Tal,6 - 10 Jahre,339,179,160
False,8119083,Weissach im Tal,10 - 15 Jahre,461,256,205
False,8119083,Weissach im Tal,15 - 18 Jahre,270,127,143
False,8119083,Weissach im Tal,18 - 20 Jahre,179,91,88
False,8119083,Weissach im Tal,20 - 25 Jahre,447,219,228
False,8119083,Weissach im Tal,25 - 30 Jahre,354,189,165
False,8119083,Weissach im Tal,30 - 35 Jahre,386,194,192
False,8119083,Weissach im Tal,35 - 40 Jahre,550,282,268
False,8119083,Weissach im Tal,40 - 45 Jahre,648,339,309
False,8119083,Weissach im Tal,45 - 50 Jahre,575,290,285
False,8119083,Weissach im Tal,50 - 55 Jahre,505,248,257
False,8119083,Weissach im Tal,55 - 60 Jahre,438,228,210
False,8119083,Weissach im Tal,60 - 65 Jahre,414,209,205
False,8119083,Weissach im Tal,65 - 75 Jahre,754,374,380
False,8119083,Weissach im Tal,75 und mehr Jahre,509,178,331
False,8119083,Weissach im Tal,Insgesamt,7205,3593,3612
False,8119084,"Welzheim, Stadt",unter 3 Jahre,321,171,150
False,8119084,"Welzheim, Stadt",3 -  6 Jahre,342,197,145
False,8119084,"Welzheim, Stadt",6 - 10 Jahre,488,238,250
False,8119084,"Welzheim, Stadt",10 - 15 Jahre,699,381,318
False,8119084,"Welzheim, Stadt",15 - 18 Jahre,475,226,249
False,8119084,"Welzheim, Stadt",18 - 20 Jahre,309,156,153
False,8119084,"Welzheim, Stadt",20 - 25 Jahre,699,362,337
False,8119084,"Welzheim, Stadt",25 - 30 Jahre,654,335,319
False,8119084,"Welzheim, Stadt",30 - 35 Jahre,670,354,316
False,8119084,"Welzheim, Stadt",35 - 40 Jahre,836,405,431
False,8119084,"Welzheim, Stadt",40 - 45 Jahre,988,510,478
False,8119084,"Welzheim, Stadt",45 - 50 Jahre,860,447,413
False,8119084,"Welzheim, Stadt",50 - 55 Jahre,717,340,377
False,8119084,"Welzheim, Stadt",55 - 60 Jahre,609,318,291
False,8119084,"Welzheim, Stadt",60 - 65 Jahre,563,272,291
False,8119084,"Welzheim, Stadt",65 - 75 Jahre,1111,500,611
False,8119084,"Welzheim, Stadt",75 und mehr Jahre,898,299,599
False,8119084,"Welzheim, Stadt",Insgesamt,11239,5511,5728
False,8119085,"Winnenden, Stadt",unter 3 Jahre,832,451,381
False,8119085,"Winnenden, Stadt",3 -  6 Jahre,849,418,431
False,8119085,"Winnenden, Stadt",6 - 10 Jahre,1266,655,611
False,8119085,"Winnenden, Stadt",10 - 15 Jahre,1654,828,826
False,8119085,"Winnenden, Stadt",15 - 18 Jahre,947,478,469
False,8119085,"Winnenden, Stadt",18 - 20 Jahre,578,291,287
False,8119085,"Winnenden, Stadt",20 - 25 Jahre,1572,773,799
False,8119085,"Winnenden, Stadt",25 - 30 Jahre,1580,759,821
False,8119085,"Winnenden, Stadt",30 - 35 Jahre,1764,876,888
False,8119085,"Winnenden, Stadt",35 - 40 Jahre,2452,1233,1219
False,8119085,"Winnenden, Stadt",40 - 45 Jahre,2527,1305,1222
False,8119085,"Winnenden, Stadt",45 - 50 Jahre,2109,1089,1020
False,8119085,"Winnenden, Stadt",50 - 55 Jahre,1698,842,856
False,8119085,"Winnenden, Stadt",55 - 60 Jahre,1514,732,782
False,8119085,"Winnenden, Stadt",60 - 65 Jahre,1571,769,802
False,8119085,"Winnenden, Stadt",65 - 75 Jahre,2925,1446,1479
False,8119085,"Winnenden, Stadt",75 und mehr Jahre,1920,719,1201
False,8119085,"Winnenden, Stadt",Insgesamt,27758,13664,14094
False,8119086,Winterbach,unter 3 Jahre,216,121,95
False,8119086,Winterbach,3 -  6 Jahre,243,126,117
False,8119086,Winterbach,6 - 10 Jahre,360,193,167
False,8119086,Winterbach,10 - 15 Jahre,476,213,263
False,8119086,Winterbach,15 - 18 Jahre,303,159,144
False,8119086,Winterbach,18 - 20 Jahre,173,98,75
False,8119086,Winterbach,20 - 25 Jahre,426,216,210
False,8119086,Winterbach,25 - 30 Jahre,412,217,195
False,8119086,Winterbach,30 - 35 Jahre,495,238,257
False,8119086,Winterbach,35 - 40 Jahre,690,342,348
False,8119086,Winterbach,40 - 45 Jahre,690,358,332
False,8119086,Winterbach,45 - 50 Jahre,570,282,288
False,8119086,Winterbach,50 - 55 Jahre,537,244,293
False,8119086,Winterbach,55 - 60 Jahre,480,237,243
False,8119086,Winterbach,60 - 65 Jahre,428,214,214
False,8119086,Winterbach,65 - 75 Jahre,816,386,430
False,8119086,Winterbach,75 und mehr Jahre,586,184,402
False,8119086,Winterbach,Insgesamt,7901,3828,4073
False,8119087,Aspach,unter 3 Jahre,251,129,122
False,8119087,Aspach,3 -  6 Jahre,262,142,120
False,8119087,Aspach,6 - 10 Jahre,407,199,208
False,8119087,Aspach,10 - 15 Jahre,520,254,266
False,8119087,Aspach,15 - 18 Jahre,294,151,143
False,8119087,Aspach,18 - 20 Jahre,211,112,99
False,8119087,Aspach,20 - 25 Jahre,447,207,240
False,8119087,Aspach,25 - 30 Jahre,445,225,220
False,8119087,Aspach,30 - 35 Jahre,497,241,256
False,8119087,Aspach,35 - 40 Jahre,692,325,367
False,8119087,Aspach,40 - 45 Jahre,741,382,359
False,8119087,Aspach,45 - 50 Jahre,661,343,318
False,8119087,Aspach,50 - 55 Jahre,550,268,282
False,8119087,Aspach,55 - 60 Jahre,460,240,220
False,8119087,Aspach,60 - 65 Jahre,434,233,201
False,8119087,Aspach,65 - 75 Jahre,862,399,463
False,8119087,Aspach,75 und mehr Jahre,564,214,350
False,8119087,Aspach,Insgesamt,8298,4064,4234
False,8119089,Berglen,unter 3 Jahre,166,76,90
False,8119089,Berglen,3 -  6 Jahre,192,97,95
False,8119089,Berglen,6 - 10 Jahre,307,142,165
False,8119089,Berglen,10 - 15 Jahre,407,213,194
False,8119089,Berglen,15 - 18 Jahre,224,116,108
False,8119089,Berglen,18 - 20 Jahre,140,76,64
False,8119089,Berglen,20 - 25 Jahre,274,159,115
False,8119089,Berglen,25 - 30 Jahre,257,140,117
False,8119089,Berglen,30 - 35 Jahre,342,165,177
False,8119089,Berglen,35 - 40 Jahre,580,299,281
False,8119089,Berglen,40 - 45 Jahre,579,284,295
False,8119089,Berglen,45 - 50 Jahre,516,259,257
False,8119089,Berglen,50 - 55 Jahre,404,208,196
False,8119089,Berglen,55 - 60 Jahre,356,197,159
False,8119089,Berglen,60 - 65 Jahre,346,168,178
False,8119089,Berglen,65 - 75 Jahre,667,328,339
False,8119089,Berglen,75 und mehr Jahre,373,139,234
False,8119089,Berglen,Insgesamt,6130,3066,3064
False,8119090,Remshalden,unter 3 Jahre,364,194,170
False,8119090,Remshalden,3 -  6 Jahre,399,201,198
False,8119090,Remshalden,6 - 10 Jahre,583,291,292
False,8119090,Remshalden,10 - 15 Jahre,774,398,376
False,8119090,Remshalden,15 - 18 Jahre,505,258,247
False,8119090,Remshalden,18 - 20 Jahre,315,164,151
False,8119090,Remshalden,20 - 25 Jahre,701,363,338
False,8119090,Remshalden,25 - 30 Jahre,669,316,353
False,8119090,Remshalden,30 - 35 Jahre,803,394,409
False,8119090,Remshalden,35 - 40 Jahre,1118,561,557
False,8119090,Remshalden,40 - 45 Jahre,1231,631,600
False,8119090,Remshalden,45 - 50 Jahre,961,483,478
False,8119090,Remshalden,50 - 55 Jahre,847,411,436
False,8119090,Remshalden,55 - 60 Jahre,853,402,451
False,8119090,Remshalden,60 - 65 Jahre,846,420,426
False,8119090,Remshalden,65 - 75 Jahre,1554,757,797
False,8119090,Remshalden,75 und mehr Jahre,1024,405,619
False,8119090,Remshalden,Insgesamt,13547,6649,6898
False,8119091,"Weinstadt, Stadt",unter 3 Jahre,759,399,360
False,8119091,"Weinstadt, Stadt",3 -  6 Jahre,774,378,396
False,8119091,"Weinstadt, Stadt",6 - 10 Jahre,1192,634,558
False,8119091,"Weinstadt, Stadt",10 - 15 Jahre,1483,756,727
False,8119091,"Weinstadt, Stadt",15 - 18 Jahre,870,429,441
False,8119091,"Weinstadt, Stadt",18 - 20 Jahre,501,244,257
False,8119091,"Weinstadt, Stadt",20 - 25 Jahre,1256,622,634
False,8119091,"Weinstadt, Stadt",25 - 30 Jahre,1469,711,758
False,8119091,"Weinstadt, Stadt",30 - 35 Jahre,1660,802,858
False,8119091,"Weinstadt, Stadt",35 - 40 Jahre,2315,1156,1159
False,8119091,"Weinstadt, Stadt",40 - 45 Jahre,2276,1181,1095
False,8119091,"Weinstadt, Stadt",45 - 50 Jahre,1879,945,934
False,8119091,"Weinstadt, Stadt",50 - 55 Jahre,1690,822,868
False,8119091,"Weinstadt, Stadt",55 - 60 Jahre,1547,751,796
False,8119091,"Weinstadt, Stadt",60 - 65 Jahre,1698,847,851
False,8119091,"Weinstadt, Stadt",65 - 75 Jahre,2973,1435,1538
False,8119091,"Weinstadt, Stadt",75 und mehr Jahre,1903,654,1249
False,8119091,"Weinstadt, Stadt",Insgesamt,26245,12766,13479
False,8119093,Kernen im Remstal,unter 3 Jahre,399,185,214
False,8119093,Kernen im Remstal,3 -  6 Jahre,400,204,196
False,8119093,Kernen im Remstal,6 - 10 Jahre,647,359,288
False,8119093,Kernen im Remstal,10 - 15 Jahre,741,404,337
False,8119093,Kernen im Remstal,15 - 18 Jahre,466,250,216
False,8119093,Kernen im Remstal,18 - 20 Jahre,305,153,152
False,8119093,Kernen im Remstal,20 - 25 Jahre,811,411,400
False,8119093,Kernen im Remstal,25 - 30 Jahre,834,396,438
False,8119093,Kernen im Remstal,30 - 35 Jahre,861,404,457
False,8119093,Kernen im Remstal,35 - 40 Jahre,1401,721,680
False,8119093,Kernen im Remstal,40 - 45 Jahre,1414,751,663
False,8119093,Kernen im Remstal,45 - 50 Jahre,1193,577,616
False,8119093,Kernen im Remstal,50 - 55 Jahre,954,480,474
False,8119093,Kernen im Remstal,55 - 60 Jahre,851,426,425
False,8119093,Kernen im Remstal,60 - 65 Jahre,910,437,473
False,8119093,Kernen im Remstal,65 - 75 Jahre,1741,813,928
False,8119093,Kernen im Remstal,75 und mehr Jahre,1195,417,778
False,8119093,Kernen im Remstal,Insgesamt,15123,7388,7735
False,8121,Stadtkreis Heilbronn,unter 3 Jahre,3414,1815,1599
False,8121,Stadtkreis Heilbronn,3 -  6 Jahre,3406,1765,1641
False,8121,Stadtkreis Heilbronn,6 - 10 Jahre,4748,2408,2340
False,8121,Stadtkreis Heilbronn,10 - 15 Jahre,6002,3051,2951
False,8121,Stadtkreis Heilbronn,15 - 18 Jahre,3972,2016,1956
False,8121,Stadtkreis Heilbronn,18 - 20 Jahre,2725,1359,1366
False,8121,Stadtkreis Heilbronn,20 - 25 Jahre,7399,3659,3740
False,8121,Stadtkreis Heilbronn,25 - 30 Jahre,8021,4088,3933
False,8121,Stadtkreis Heilbronn,30 - 35 Jahre,8413,4399,4014
False,8121,Stadtkreis Heilbronn,35 - 40 Jahre,9622,5085,4537
False,8121,Stadtkreis Heilbronn,40 - 45 Jahre,9954,5272,4682
False,8121,Stadtkreis Heilbronn,45 - 50 Jahre,8790,4500,4290
False,8121,Stadtkreis Heilbronn,50 - 55 Jahre,7680,3749,3931
False,8121,Stadtkreis Heilbronn,55 - 60 Jahre,6869,3358,3511
False,8121,Stadtkreis Heilbronn,60 - 65 Jahre,6834,3327,3507
False,8121,Stadtkreis Heilbronn,65 - 75 Jahre,13314,6225,7089
False,8121,Stadtkreis Heilbronn,75 und mehr Jahre,10450,3512,6938
False,8121,Stadtkreis Heilbronn,Insgesamt,121613,59588,62025
False,8121000,"Heilbronn, Stadt",unter 3 Jahre,3414,1815,1599
False,8121000,"Heilbronn, Stadt",3 -  6 Jahre,3406,1765,1641
False,8121000,"Heilbronn, Stadt",6 - 10 Jahre,4748,2408,2340
False,8121000,"Heilbronn, Stadt",10 - 15 Jahre,6002,3051,2951
False,8121000,"Heilbronn, Stadt",15 - 18 Jahre,3972,2016,1956
False,8121000,"Heilbronn, Stadt",18 - 20 Jahre,2725,1359,1366
False,8121000,"Heilbronn, Stadt",20 - 25 Jahre,7399,3659,3740
False,8121000,"Heilbronn, Stadt",25 - 30 Jahre,8021,4088,3933
False,8121000,"Heilbronn, Stadt",30 - 35 Jahre,8413,4399,4014
False,8121000,"Heilbronn, Stadt",35 - 40 Jahre,9622,5085,4537
False,8121000,"Heilbronn, Stadt",40 - 45 Jahre,9954,5272,4682
False,8121000,"Heilbronn, Stadt",45 - 50 Jahre,8790,4500,4290
False,8121000,"Heilbronn, Stadt",50 - 55 Jahre,7680,3749,3931
False,8121000,"Heilbronn, Stadt",55 - 60 Jahre,6869,3358,3511
False,8121000,"Heilbronn, Stadt",60 - 65 Jahre,6834,3327,3507
False,8121000,"Heilbronn, Stadt",65 - 75 Jahre,13314,6225,7089
False,8121000,"Heilbronn, Stadt",75 und mehr Jahre,10450,3512,6938
False,8121000,"Heilbronn, Stadt",Insgesamt,121613,59588,62025
False,8125,Landkreis Heilbronn,unter 3 Jahre,9207,4581,4626
False,8125,Landkreis Heilbronn,3 -  6 Jahre,10587,5415,5172
False,8125,Landkreis Heilbronn,6 - 10 Jahre,15519,7966,7553
False,8125,Landkreis Heilbronn,10 - 15 Jahre,20403,10553,9850
False,8125,Landkreis Heilbronn,15 - 18 Jahre,13005,6730,6275
False,8125,Landkreis Heilbronn,18 - 20 Jahre,8301,4267,4034
False,8125,Landkreis Heilbronn,20 - 25 Jahre,18396,9382,9014
False,8125,Landkreis Heilbronn,25 - 30 Jahre,18644,9411,9233
False,8125,Landkreis Heilbronn,30 - 35 Jahre,20731,10392,10339
False,8125,Landkreis Heilbronn,35 - 40 Jahre,27734,14234,13500
False,8125,Landkreis Heilbronn,40 - 45 Jahre,29654,15157,14497
False,8125,Landkreis Heilbronn,45 - 50 Jahre,25437,13225,12212
False,8125,Landkreis Heilbronn,50 - 55 Jahre,21584,10833,10751
False,8125,Landkreis Heilbronn,55 - 60 Jahre,18441,9200,9241
False,8125,Landkreis Heilbronn,60 - 65 Jahre,16561,8296,8265
False,8125,Landkreis Heilbronn,65 - 75 Jahre,32237,15462,16775
False,8125,Landkreis Heilbronn,75 und mehr Jahre,23062,8246,14816
False,8125,Landkreis Heilbronn,Insgesamt,329503,163350,166153
False,8125001,Abstatt,unter 3 Jahre,152,76,76
False,8125001,Abstatt,3 -  6 Jahre,157,78,79
False,8125001,Abstatt,6 - 10 Jahre,205,121,84
False,8125001,Abstatt,10 - 15 Jahre,293,146,147
False,8125001,Abstatt,15 - 18 Jahre,162,82,80
False,8125001,Abstatt,18 - 20 Jahre,120,66,54
False,8125001,Abstatt,20 - 25 Jahre,237,135,102
False,8125001,Abstatt,25 - 30 Jahre,273,138,135
False,8125001,Abstatt,30 - 35 Jahre,296,151,145
False,8125001,Abstatt,35 - 40 Jahre,424,213,211
False,8125001,Abstatt,40 - 45 Jahre,415,208,207
False,8125001,Abstatt,45 - 50 Jahre,364,186,178
False,8125001,Abstatt,50 - 55 Jahre,325,157,168
False,8125001,Abstatt,55 - 60 Jahre,263,131,132
False,8125001,Abstatt,60 - 65 Jahre,242,132,110
False,8125001,Abstatt,65 - 75 Jahre,369,169,200
False,8125001,Abstatt,75 und mehr Jahre,246,90,156
False,8125001,Abstatt,Insgesamt,4543,2279,2264
False,8125005,"Bad Friedrichshall, Stadt",unter 3 Jahre,585,310,275
False,8125005,"Bad Friedrichshall, Stadt",3 -  6 Jahre,701,362,339
False,8125005,"Bad Friedrichshall, Stadt",6 - 10 Jahre,926,466,460
False,8125005,"Bad Friedrichshall, Stadt",10 - 15 Jahre,1176,593,583
False,8125005,"Bad Friedrichshall, Stadt",15 - 18 Jahre,780,443,337
False,8125005,"Bad Friedrichshall, Stadt",18 - 20 Jahre,452,237,215
False,8125005,"Bad Friedrichshall, Stadt",20 - 25 Jahre,1167,584,583
False,8125005,"Bad Friedrichshall, Stadt",25 - 30 Jahre,1208,576,632
False,8125005,"Bad Friedrichshall, Stadt",30 - 35 Jahre,1322,662,660
False,8125005,"Bad Friedrichshall, Stadt",35 - 40 Jahre,1617,851,766
False,8125005,"Bad Friedrichshall, Stadt",40 - 45 Jahre,1734,856,878
False,8125005,"Bad Friedrichshall, Stadt",45 - 50 Jahre,1433,757,676
False,8125005,"Bad Friedrichshall, Stadt",50 - 55 Jahre,1179,613,566
False,8125005,"Bad Friedrichshall, Stadt",55 - 60 Jahre,943,482,461
False,8125005,"Bad Friedrichshall, Stadt",60 - 65 Jahre,757,392,365
False,8125005,"Bad Friedrichshall, Stadt",65 - 75 Jahre,1589,732,857
False,8125005,"Bad Friedrichshall, Stadt",75 und mehr Jahre,1205,418,787
False,8125005,"Bad Friedrichshall, Stadt",Insgesamt,18774,9334,9440
False,8125006,"Bad Rappenau, Stadt",unter 3 Jahre,563,279,284
False,8125006,"Bad Rappenau, Stadt",3 -  6 Jahre,630,308,322
False,8125006,"Bad Rappenau, Stadt",6 - 10 Jahre,923,473,450
False,8125006,"Bad Rappenau, Stadt",10 - 15 Jahre,1090,570,520
False,8125006,"Bad Rappenau, Stadt",15 - 18 Jahre,686,367,319
False,8125006,"Bad Rappenau, Stadt",18 - 20 Jahre,511,249,262
False,8125006,"Bad Rappenau, Stadt",20 - 25 Jahre,1149,553,596
False,8125006,"Bad Rappenau, Stadt",25 - 30 Jahre,1156,582,574
False,8125006,"Bad Rappenau, Stadt",30 - 35 Jahre,1296,656,640
False,8125006,"Bad Rappenau, Stadt",35 - 40 Jahre,1634,844,790
False,8125006,"Bad Rappenau, Stadt",40 - 45 Jahre,1883,933,950
False,8125006,"Bad Rappenau, Stadt",45 - 50 Jahre,1652,860,792
False,8125006,"Bad Rappenau, Stadt",50 - 55 Jahre,1366,684,682
False,8125006,"Bad Rappenau, Stadt",55 - 60 Jahre,1160,553,607
False,8125006,"Bad Rappenau, Stadt",60 - 65 Jahre,1059,536,523
False,8125006,"Bad Rappenau, Stadt",65 - 75 Jahre,2069,958,1111
False,8125006,"Bad Rappenau, Stadt",75 und mehr Jahre,1773,597,1176
False,8125006,"Bad Rappenau, Stadt",Insgesamt,20600,10002,10598
False,8125007,"Bad Wimpfen, Stadt",unter 3 Jahre,176,82,94
False,8125007,"Bad Wimpfen, Stadt",3 -  6 Jahre,196,103,93
False,8125007,"Bad Wimpfen, Stadt",6 - 10 Jahre,266,134,132
False,8125007,"Bad Wimpfen, Stadt",10 - 15 Jahre,328,172,156
False,8125007,"Bad Wimpfen, Stadt",15 - 18 Jahre,243,128,115
False,8125007,"Bad Wimpfen, Stadt",18 - 20 Jahre,136,65,71
False,8125007,"Bad Wimpfen, Stadt",20 - 25 Jahre,377,184,193
False,8125007,"Bad Wimpfen, Stadt",25 - 30 Jahre,403,195,208
False,8125007,"Bad Wimpfen, Stadt",30 - 35 Jahre,438,229,209
False,8125007,"Bad Wimpfen, Stadt",35 - 40 Jahre,545,281,264
False,8125007,"Bad Wimpfen, Stadt",40 - 45 Jahre,532,282,250
False,8125007,"Bad Wimpfen, Stadt",45 - 50 Jahre,497,242,255
False,8125007,"Bad Wimpfen, Stadt",50 - 55 Jahre,494,242,252
False,8125007,"Bad Wimpfen, Stadt",55 - 60 Jahre,455,227,228
False,8125007,"Bad Wimpfen, Stadt",60 - 65 Jahre,421,205,216
False,8125007,"Bad Wimpfen, Stadt",65 - 75 Jahre,823,397,426
False,8125007,"Bad Wimpfen, Stadt",75 und mehr Jahre,609,215,394
False,8125007,"Bad Wimpfen, Stadt",Insgesamt,6939,3383,3556
False,8125008,"Beilstein, Stadt",unter 3 Jahre,144,69,75
False,8125008,"Beilstein, Stadt",3 -  6 Jahre,169,93,76
False,8125008,"Beilstein, Stadt",6 - 10 Jahre,250,143,107
False,8125008,"Beilstein, Stadt",10 - 15 Jahre,359,183,176
False,8125008,"Beilstein, Stadt",15 - 18 Jahre,258,125,133
False,8125008,"Beilstein, Stadt",18 - 20 Jahre,167,74,93
False,8125008,"Beilstein, Stadt",20 - 25 Jahre,335,172,163
False,8125008,"Beilstein, Stadt",25 - 30 Jahre,298,145,153
False,8125008,"Beilstein, Stadt",30 - 35 Jahre,316,140,176
False,8125008,"Beilstein, Stadt",35 - 40 Jahre,502,245,257
False,8125008,"Beilstein, Stadt",40 - 45 Jahre,466,242,224
False,8125008,"Beilstein, Stadt",45 - 50 Jahre,443,222,221
False,8125008,"Beilstein, Stadt",50 - 55 Jahre,386,173,213
False,8125008,"Beilstein, Stadt",55 - 60 Jahre,448,220,228
False,8125008,"Beilstein, Stadt",60 - 65 Jahre,443,216,227
False,8125008,"Beilstein, Stadt",65 - 75 Jahre,663,340,323
False,8125008,"Beilstein, Stadt",75 und mehr Jahre,491,161,330
False,8125008,"Beilstein, Stadt",Insgesamt,6138,2963,3175
False,8125013,"Brackenheim, Stadt",unter 3 Jahre,478,235,243
False,8125013,"Brackenheim, Stadt",3 -  6 Jahre,506,255,251
False,8125013,"Brackenheim, Stadt",6 - 10 Jahre,826,443,383
False,8125013,"Brackenheim, Stadt",10 - 15 Jahre,974,515,459
False,8125013,"Brackenheim, Stadt",15 - 18 Jahre,670,318,352
False,8125013,"Brackenheim, Stadt",18 - 20 Jahre,431,199,232
False,8125013,"Brackenheim, Stadt",20 - 25 Jahre,827,422,405
False,8125013,"Brackenheim, Stadt",25 - 30 Jahre,789,431,358
False,8125013,"Brackenheim, Stadt",30 - 35 Jahre,911,437,474
False,8125013,"Brackenheim, Stadt",35 - 40 Jahre,1320,646,674
False,8125013,"Brackenheim, Stadt",40 - 45 Jahre,1407,736,671
False,8125013,"Brackenheim, Stadt",45 - 50 Jahre,1162,594,568
False,8125013,"Brackenheim, Stadt",50 - 55 Jahre,1008,495,513
False,8125013,"Brackenheim, Stadt",55 - 60 Jahre,777,409,368
False,8125013,"Brackenheim, Stadt",60 - 65 Jahre,721,361,360
False,8125013,"Brackenheim, Stadt",65 - 75 Jahre,1344,645,699
False,8125013,"Brackenheim, Stadt",75 und mehr Jahre,953,337,616
False,8125013,"Brackenheim, Stadt",Insgesamt,15104,7478,7626
False,8125017,Cleebronn,unter 3 Jahre,94,44,50
False,8125017,Cleebronn,3 -  6 Jahre,78,45,33
False,8125017,Cleebronn,6 - 10 Jahre,133,63,70
False,8125017,Cleebronn,10 - 15 Jahre,198,110,88
False,8125017,Cleebronn,15 - 18 Jahre,108,63,45
False,8125017,Cleebronn,18 - 20 Jahre,74,36,38
False,8125017,Cleebronn,20 - 25 Jahre,182,97,85
False,8125017,Cleebronn,25 - 30 Jahre,152,90,62
False,8125017,Cleebronn,30 - 35 Jahre,169,76,93
False,8125017,Cleebronn,35 - 40 Jahre,259,140,119
False,8125017,Cleebronn,40 - 45 Jahre,257,139,118
False,8125017,Cleebronn,45 - 50 Jahre,222,107,115
False,8125017,Cleebronn,50 - 55 Jahre,178,87,91
False,8125017,Cleebronn,55 - 60 Jahre,137,71,66
False,8125017,Cleebronn,60 - 65 Jahre,142,76,66
False,8125017,Cleebronn,65 - 75 Jahre,239,114,125
False,8125017,Cleebronn,75 und mehr Jahre,148,52,96
False,8125017,Cleebronn,Insgesamt,2770,1410,1360
False,8125021,Eberstadt,unter 3 Jahre,83,41,42
False,8125021,Eberstadt,3 -  6 Jahre,104,49,55
False,8125021,Eberstadt,6 - 10 Jahre,161,74,87
False,8125021,Eberstadt,10 - 15 Jahre,187,91,96
False,8125021,Eberstadt,15 - 18 Jahre,112,67,45
False,8125021,Eberstadt,18 - 20 Jahre,88,40,48
False,8125021,Eberstadt,20 - 25 Jahre,180,90,90
False,8125021,Eberstadt,25 - 30 Jahre,166,92,74
False,8125021,Eberstadt,30 - 35 Jahre,220,100,120
False,8125021,Eberstadt,35 - 40 Jahre,255,134,121
False,8125021,Eberstadt,40 - 45 Jahre,272,129,143
False,8125021,Eberstadt,45 - 50 Jahre,240,130,110
False,8125021,Eberstadt,50 - 55 Jahre,206,96,110
False,8125021,Eberstadt,55 - 60 Jahre,172,90,82
False,8125021,Eberstadt,60 - 65 Jahre,162,74,88
False,8125021,Eberstadt,65 - 75 Jahre,333,170,163
False,8125021,Eberstadt,75 und mehr Jahre,261,85,176
False,8125021,Eberstadt,Insgesamt,3202,1552,1650
False,8125024,Ellhofen,unter 3 Jahre,94,44,50
False,8125024,Ellhofen,3 -  6 Jahre,106,58,48
False,8125024,Ellhofen,6 - 10 Jahre,149,85,64
False,8125024,Ellhofen,10 - 15 Jahre,226,113,113
False,8125024,Ellhofen,15 - 18 Jahre,135,70,65
False,8125024,Ellhofen,18 - 20 Jahre,97,51,46
False,8125024,Ellhofen,20 - 25 Jahre,179,88,91
False,8125024,Ellhofen,25 - 30 Jahre,160,78,82
False,8125024,Ellhofen,30 - 35 Jahre,203,102,101
False,8125024,Ellhofen,35 - 40 Jahre,277,133,144
False,8125024,Ellhofen,40 - 45 Jahre,300,155,145
False,8125024,Ellhofen,45 - 50 Jahre,285,143,142
False,8125024,Ellhofen,50 - 55 Jahre,255,138,117
False,8125024,Ellhofen,55 - 60 Jahre,185,100,85
False,8125024,Ellhofen,60 - 65 Jahre,177,85,92
False,8125024,Ellhofen,65 - 75 Jahre,333,158,175
False,8125024,Ellhofen,75 und mehr Jahre,191,71,120
False,8125024,Ellhofen,Insgesamt,3352,1672,1680
False,8125026,"Eppingen, Stadt",unter 3 Jahre,610,297,313
False,8125026,"Eppingen, Stadt",3 -  6 Jahre,726,376,350
False,8125026,"Eppingen, Stadt",6 - 10 Jahre,1084,548,536
False,8125026,"Eppingen, Stadt",10 - 15 Jahre,1422,753,669
False,8125026,"Eppingen, Stadt",15 - 18 Jahre,873,452,421
False,8125026,"Eppingen, Stadt",18 - 20 Jahre,558,275,283
False,8125026,"Eppingen, Stadt",20 - 25 Jahre,1325,675,650
False,8125026,"Eppingen, Stadt",25 - 30 Jahre,1223,622,601
False,8125026,"Eppingen, Stadt",30 - 35 Jahre,1298,675,623
False,8125026,"Eppingen, Stadt",35 - 40 Jahre,1750,845,905
False,8125026,"Eppingen, Stadt",40 - 45 Jahre,1894,953,941
False,8125026,"Eppingen, Stadt",45 - 50 Jahre,1672,849,823
False,8125026,"Eppingen, Stadt",50 - 55 Jahre,1331,662,669
False,8125026,"Eppingen, Stadt",55 - 60 Jahre,1130,585,545
False,8125026,"Eppingen, Stadt",60 - 65 Jahre,826,425,401
False,8125026,"Eppingen, Stadt",65 - 75 Jahre,2034,922,1112
False,8125026,"Eppingen, Stadt",75 und mehr Jahre,1506,494,1012
False,8125026,"Eppingen, Stadt",Insgesamt,21262,10408,10854
False,8125027,Erlenbach,unter 3 Jahre,124,64,60
False,8125027,Erlenbach,3 -  6 Jahre,161,82,79
False,8125027,Erlenbach,6 - 10 Jahre,195,102,93
False,8125027,Erlenbach,10 - 15 Jahre,275,149,126
False,8125027,Erlenbach,15 - 18 Jahre,192,110,82
False,8125027,Erlenbach,18 - 20 Jahre,113,58,55
False,8125027,Erlenbach,20 - 25 Jahre,258,123,135
False,8125027,Erlenbach,25 - 30 Jahre,303,161,142
False,8125027,Erlenbach,30 - 35 Jahre,318,159,159
False,8125027,Erlenbach,35 - 40 Jahre,432,235,197
False,8125027,Erlenbach,40 - 45 Jahre,439,198,241
False,8125027,Erlenbach,45 - 50 Jahre,390,208,182
False,8125027,Erlenbach,50 - 55 Jahre,302,151,151
False,8125027,Erlenbach,55 - 60 Jahre,273,127,146
False,8125027,Erlenbach,60 - 65 Jahre,283,138,145
False,8125027,Erlenbach,65 - 75 Jahre,494,249,245
False,8125027,Erlenbach,75 und mehr Jahre,294,119,175
False,8125027,Erlenbach,Insgesamt,4846,2433,2413
False,8125030,Flein,unter 3 Jahre,149,74,75
False,8125030,Flein,3 -  6 Jahre,191,98,93
False,8125030,Flein,6 - 10 Jahre,261,133,128
False,8125030,Flein,10 - 15 Jahre,312,152,160
False,8125030,Flein,15 - 18 Jahre,193,85,108
False,8125030,Flein,18 - 20 Jahre,130,70,60
False,8125030,Flein,20 - 25 Jahre,287,140,147
False,8125030,Flein,25 - 30 Jahre,311,132,179
False,8125030,Flein,30 - 35 Jahre,355,179,176
False,8125030,Flein,35 - 40 Jahre,557,259,298
False,8125030,Flein,40 - 45 Jahre,591,286,305
False,8125030,Flein,45 - 50 Jahre,473,237,236
False,8125030,Flein,50 - 55 Jahre,381,188,193
False,8125030,Flein,55 - 60 Jahre,435,189,246
False,8125030,Flein,60 - 65 Jahre,417,186,231
False,8125030,Flein,65 - 75 Jahre,894,467,427
False,8125030,Flein,75 und mehr Jahre,598,259,339
False,8125030,Flein,Insgesamt,6535,3134,3401
False,8125034,Gemmingen,unter 3 Jahre,130,77,53
False,8125034,Gemmingen,3 -  6 Jahre,155,92,63
False,8125034,Gemmingen,6 - 10 Jahre,248,130,118
False,8125034,Gemmingen,10 - 15 Jahre,360,193,167
False,8125034,Gemmingen,15 - 18 Jahre,210,113,97
False,8125034,Gemmingen,18 - 20 Jahre,139,67,72
False,8125034,Gemmingen,20 - 25 Jahre,272,134,138
False,8125034,Gemmingen,25 - 30 Jahre,261,135,126
False,8125034,Gemmingen,30 - 35 Jahre,267,140,127
False,8125034,Gemmingen,35 - 40 Jahre,430,212,218
False,8125034,Gemmingen,40 - 45 Jahre,427,217,210
False,8125034,Gemmingen,45 - 50 Jahre,354,175,179
False,8125034,Gemmingen,50 - 55 Jahre,331,171,160
False,8125034,Gemmingen,55 - 60 Jahre,291,153,138
False,8125034,Gemmingen,60 - 65 Jahre,250,131,119
False,8125034,Gemmingen,65 - 75 Jahre,512,244,268
False,8125034,Gemmingen,75 und mehr Jahre,311,135,176
False,8125034,Gemmingen,Insgesamt,4948,2519,2429
False,8125038,"Güglingen, Stadt",unter 3 Jahre,201,115,86
False,8125038,"Güglingen, Stadt",3 -  6 Jahre,205,107,98
False,8125038,"Güglingen, Stadt",6 - 10 Jahre,321,169,152
False,8125038,"Güglingen, Stadt",10 - 15 Jahre,420,212,208
False,8125038,"Güglingen, Stadt",15 - 18 Jahre,282,141,141
False,8125038,"Güglingen, Stadt",18 - 20 Jahre,163,82,81
False,8125038,"Güglingen, Stadt",20 - 25 Jahre,370,178,192
False,8125038,"Güglingen, Stadt",25 - 30 Jahre,374,201,173
False,8125038,"Güglingen, Stadt",30 - 35 Jahre,442,228,214
False,8125038,"Güglingen, Stadt",35 - 40 Jahre,535,299,236
False,8125038,"Güglingen, Stadt",40 - 45 Jahre,572,304,268
False,8125038,"Güglingen, Stadt",45 - 50 Jahre,431,228,203
False,8125038,"Güglingen, Stadt",50 - 55 Jahre,352,174,178
False,8125038,"Güglingen, Stadt",55 - 60 Jahre,333,167,166
False,8125038,"Güglingen, Stadt",60 - 65 Jahre,342,175,167
False,8125038,"Güglingen, Stadt",65 - 75 Jahre,525,250,275
False,8125038,"Güglingen, Stadt",75 und mehr Jahre,365,139,226
False,8125038,"Güglingen, Stadt",Insgesamt,6233,3169,3064
False,8125039,"Gundelsheim, Stadt",unter 3 Jahre,181,85,96
False,8125039,"Gundelsheim, Stadt",3 -  6 Jahre,242,141,101
False,8125039,"Gundelsheim, Stadt",6 - 10 Jahre,355,169,186
False,8125039,"Gundelsheim, Stadt",10 - 15 Jahre,442,216,226
False,8125039,"Gundelsheim, Stadt",15 - 18 Jahre,309,160,149
False,8125039,"Gundelsheim, Stadt",18 - 20 Jahre,194,111,83
False,8125039,"Gundelsheim, Stadt",20 - 25 Jahre,395,218,177
False,8125039,"Gundelsheim, Stadt",25 - 30 Jahre,396,201,195
False,8125039,"Gundelsheim, Stadt",30 - 35 Jahre,438,224,214
False,8125039,"Gundelsheim, Stadt",35 - 40 Jahre,594,305,289
False,8125039,"Gundelsheim, Stadt",40 - 45 Jahre,675,346,329
False,8125039,"Gundelsheim, Stadt",45 - 50 Jahre,538,282,256
False,8125039,"Gundelsheim, Stadt",50 - 55 Jahre,490,241,249
False,8125039,"Gundelsheim, Stadt",55 - 60 Jahre,421,210,211
False,8125039,"Gundelsheim, Stadt",60 - 65 Jahre,404,206,198
False,8125039,"Gundelsheim, Stadt",65 - 75 Jahre,765,380,385
False,8125039,"Gundelsheim, Stadt",75 und mehr Jahre,640,184,456
False,8125039,"Gundelsheim, Stadt",Insgesamt,7479,3679,3800
False,8125046,Ilsfeld,unter 3 Jahre,255,130,125
False,8125046,Ilsfeld,3 -  6 Jahre,246,114,132
False,8125046,Ilsfeld,6 - 10 Jahre,379,184,195
False,8125046,Ilsfeld,10 - 15 Jahre,494,238,256
False,8125046,Ilsfeld,15 - 18 Jahre,339,158,181
False,8125046,Ilsfeld,18 - 20 Jahre,184,93,91
False,8125046,Ilsfeld,20 - 25 Jahre,443,225,218
False,8125046,Ilsfeld,25 - 30 Jahre,523,262,261
False,8125046,Ilsfeld,30 - 35 Jahre,572,278,294
False,8125046,Ilsfeld,35 - 40 Jahre,723,386,337
False,8125046,Ilsfeld,40 - 45 Jahre,712,366,346
False,8125046,Ilsfeld,45 - 50 Jahre,607,333,274
False,8125046,Ilsfeld,50 - 55 Jahre,551,261,290
False,8125046,Ilsfeld,55 - 60 Jahre,525,267,258
False,8125046,Ilsfeld,60 - 65 Jahre,494,252,242
False,8125046,Ilsfeld,65 - 75 Jahre,785,402,383
False,8125046,Ilsfeld,75 und mehr Jahre,437,162,275
False,8125046,Ilsfeld,Insgesamt,8269,4111,4158
False,8125047,Ittlingen,unter 3 Jahre,77,41,36
False,8125047,Ittlingen,3 -  6 Jahre,81,45,36
False,8125047,Ittlingen,6 - 10 Jahre,150,81,69
False,8125047,Ittlingen,10 - 15 Jahre,191,99,92
False,8125047,Ittlingen,15 - 18 Jahre,94,44,50
False,8125047,Ittlingen,18 - 20 Jahre,68,35,33
False,8125047,Ittlingen,20 - 25 Jahre,131,70,61
False,8125047,Ittlingen,25 - 30 Jahre,115,65,50
False,8125047,Ittlingen,30 - 35 Jahre,152,79,73
False,8125047,Ittlingen,35 - 40 Jahre,225,116,109
False,8125047,Ittlingen,40 - 45 Jahre,217,107,110
False,8125047,Ittlingen,45 - 50 Jahre,201,111,90
False,8125047,Ittlingen,50 - 55 Jahre,150,84,66
False,8125047,Ittlingen,55 - 60 Jahre,119,54,65
False,8125047,Ittlingen,60 - 65 Jahre,93,46,47
False,8125047,Ittlingen,65 - 75 Jahre,208,113,95
False,8125047,Ittlingen,75 und mehr Jahre,125,40,85
False,8125047,Ittlingen,Insgesamt,2397,1230,1167
False,8125048,Jagsthausen,unter 3 Jahre,37,15,22
False,8125048,Jagsthausen,3 -  6 Jahre,58,27,31
False,8125048,Jagsthausen,6 - 10 Jahre,89,55,34
False,8125048,Jagsthausen,10 - 15 Jahre,91,52,39
False,8125048,Jagsthausen,15 - 18 Jahre,53,25,28
False,8125048,Jagsthausen,18 - 20 Jahre,29,17,12
False,8125048,Jagsthausen,20 - 25 Jahre,82,43,39
False,8125048,Jagsthausen,25 - 30 Jahre,79,46,33
False,8125048,Jagsthausen,30 - 35 Jahre,92,50,42
False,8125048,Jagsthausen,35 - 40 Jahre,96,58,38
False,8125048,Jagsthausen,40 - 45 Jahre,129,55,74
False,8125048,Jagsthausen,45 - 50 Jahre,119,63,56
False,8125048,Jagsthausen,50 - 55 Jahre,83,39,44
False,8125048,Jagsthausen,55 - 60 Jahre,92,38,54
False,8125048,Jagsthausen,60 - 65 Jahre,89,48,41
False,8125048,Jagsthausen,65 - 75 Jahre,190,97,93
False,8125048,Jagsthausen,75 und mehr Jahre,103,42,61
False,8125048,Jagsthausen,Insgesamt,1511,770,741
False,8125049,Kirchardt,unter 3 Jahre,171,87,84
False,8125049,Kirchardt,3 -  6 Jahre,207,96,111
False,8125049,Kirchardt,6 - 10 Jahre,318,159,159
False,8125049,Kirchardt,10 - 15 Jahre,410,222,188
False,8125049,Kirchardt,15 - 18 Jahre,272,159,113
False,8125049,Kirchardt,18 - 20 Jahre,165,90,75
False,8125049,Kirchardt,20 - 25 Jahre,331,190,141
False,8125049,Kirchardt,25 - 30 Jahre,348,161,187
False,8125049,Kirchardt,30 - 35 Jahre,382,206,176
False,8125049,Kirchardt,35 - 40 Jahre,450,240,210
False,8125049,Kirchardt,40 - 45 Jahre,452,229,223
False,8125049,Kirchardt,45 - 50 Jahre,392,215,177
False,8125049,Kirchardt,50 - 55 Jahre,344,175,169
False,8125049,Kirchardt,55 - 60 Jahre,272,129,143
False,8125049,Kirchardt,60 - 65 Jahre,250,122,128
False,8125049,Kirchardt,65 - 75 Jahre,511,257,254
False,8125049,Kirchardt,75 und mehr Jahre,267,98,169
False,8125049,Kirchardt,Insgesamt,5542,2835,2707
False,8125056,"Lauffen am Neckar, Stadt",unter 3 Jahre,285,146,139
False,8125056,"Lauffen am Neckar, Stadt",3 -  6 Jahre,351,174,177
False,8125056,"Lauffen am Neckar, Stadt",6 - 10 Jahre,476,246,230
False,8125056,"Lauffen am Neckar, Stadt",10 - 15 Jahre,686,360,326
False,8125056,"Lauffen am Neckar, Stadt",15 - 18 Jahre,450,221,229
False,8125056,"Lauffen am Neckar, Stadt",18 - 20 Jahre,291,144,147
False,8125056,"Lauffen am Neckar, Stadt",20 - 25 Jahre,631,320,311
False,8125056,"Lauffen am Neckar, Stadt",25 - 30 Jahre,643,328,315
False,8125056,"Lauffen am Neckar, Stadt",30 - 35 Jahre,662,310,352
False,8125056,"Lauffen am Neckar, Stadt",35 - 40 Jahre,860,411,449
False,8125056,"Lauffen am Neckar, Stadt",40 - 45 Jahre,1058,568,490
False,8125056,"Lauffen am Neckar, Stadt",45 - 50 Jahre,850,451,399
False,8125056,"Lauffen am Neckar, Stadt",50 - 55 Jahre,721,351,370
False,8125056,"Lauffen am Neckar, Stadt",55 - 60 Jahre,640,311,329
False,8125056,"Lauffen am Neckar, Stadt",60 - 65 Jahre,543,273,270
False,8125056,"Lauffen am Neckar, Stadt",65 - 75 Jahre,1078,503,575
False,8125056,"Lauffen am Neckar, Stadt",75 und mehr Jahre,909,308,601
False,8125056,"Lauffen am Neckar, Stadt",Insgesamt,11134,5425,5709
False,8125057,Lehrensteinsfeld,unter 3 Jahre,66,33,33
False,8125057,Lehrensteinsfeld,3 -  6 Jahre,84,42,42
False,8125057,Lehrensteinsfeld,6 - 10 Jahre,117,63,54
False,8125057,Lehrensteinsfeld,10 - 15 Jahre,152,84,68
False,8125057,Lehrensteinsfeld,15 - 18 Jahre,65,43,22
False,8125057,Lehrensteinsfeld,18 - 20 Jahre,47,23,24
False,8125057,Lehrensteinsfeld,20 - 25 Jahre,95,51,44
False,8125057,Lehrensteinsfeld,25 - 30 Jahre,84,38,46
False,8125057,Lehrensteinsfeld,30 - 35 Jahre,122,60,62
False,8125057,Lehrensteinsfeld,35 - 40 Jahre,201,104,97
False,8125057,Lehrensteinsfeld,40 - 45 Jahre,192,97,95
False,8125057,Lehrensteinsfeld,45 - 50 Jahre,141,80,61
False,8125057,Lehrensteinsfeld,50 - 55 Jahre,139,59,80
False,8125057,Lehrensteinsfeld,55 - 60 Jahre,146,71,75
False,8125057,Lehrensteinsfeld,60 - 65 Jahre,117,57,60
False,8125057,Lehrensteinsfeld,65 - 75 Jahre,200,107,93
False,8125057,Lehrensteinsfeld,75 und mehr Jahre,105,36,69
False,8125057,Lehrensteinsfeld,Insgesamt,2073,1048,1025
False,8125058,Leingarten,unter 3 Jahre,272,145,127
False,8125058,Leingarten,3 -  6 Jahre,348,186,162
False,8125058,Leingarten,6 - 10 Jahre,542,274,268
False,8125058,Leingarten,10 - 15 Jahre,621,319,302
False,8125058,Leingarten,15 - 18 Jahre,370,179,191
False,8125058,Leingarten,18 - 20 Jahre,262,144,118
False,8125058,Leingarten,20 - 25 Jahre,568,286,282
False,8125058,Leingarten,25 - 30 Jahre,595,291,304
False,8125058,Leingarten,30 - 35 Jahre,681,326,355
False,8125058,Leingarten,35 - 40 Jahre,925,500,425
False,8125058,Leingarten,40 - 45 Jahre,974,474,500
False,8125058,Leingarten,45 - 50 Jahre,788,390,398
False,8125058,Leingarten,50 - 55 Jahre,701,347,354
False,8125058,Leingarten,55 - 60 Jahre,600,288,312
False,8125058,Leingarten,60 - 65 Jahre,585,285,300
False,8125058,Leingarten,65 - 75 Jahre,982,473,509
False,8125058,Leingarten,75 und mehr Jahre,637,242,395
False,8125058,Leingarten,Insgesamt,10451,5149,5302
False,8125059,"Löwenstein, Stadt",unter 3 Jahre,84,48,36
False,8125059,"Löwenstein, Stadt",3 -  6 Jahre,85,43,42
False,8125059,"Löwenstein, Stadt",6 - 10 Jahre,106,56,50
False,8125059,"Löwenstein, Stadt",10 - 15 Jahre,189,103,86
False,8125059,"Löwenstein, Stadt",15 - 18 Jahre,105,55,50
False,8125059,"Löwenstein, Stadt",18 - 20 Jahre,72,35,37
False,8125059,"Löwenstein, Stadt",20 - 25 Jahre,168,74,94
False,8125059,"Löwenstein, Stadt",25 - 30 Jahre,156,73,83
False,8125059,"Löwenstein, Stadt",30 - 35 Jahre,174,85,89
False,8125059,"Löwenstein, Stadt",35 - 40 Jahre,268,143,125
False,8125059,"Löwenstein, Stadt",40 - 45 Jahre,319,165,154
False,8125059,"Löwenstein, Stadt",45 - 50 Jahre,279,137,142
False,8125059,"Löwenstein, Stadt",50 - 55 Jahre,251,124,127
False,8125059,"Löwenstein, Stadt",55 - 60 Jahre,203,113,90
False,8125059,"Löwenstein, Stadt",60 - 65 Jahre,129,64,65
False,8125059,"Löwenstein, Stadt",65 - 75 Jahre,283,128,155
False,8125059,"Löwenstein, Stadt",75 und mehr Jahre,194,72,122
False,8125059,"Löwenstein, Stadt",Insgesamt,3065,1518,1547
False,8125061,Massenbachhausen,unter 3 Jahre,89,42,47
False,8125061,Massenbachhausen,3 -  6 Jahre,92,49,43
False,8125061,Massenbachhausen,6 - 10 Jahre,152,76,76
False,8125061,Massenbachhausen,10 - 15 Jahre,238,123,115
False,8125061,Massenbachhausen,15 - 18 Jahre,175,100,75
False,8125061,Massenbachhausen,18 - 20 Jahre,96,55,41
False,8125061,Massenbachhausen,20 - 25 Jahre,210,108,102
False,8125061,Massenbachhausen,25 - 30 Jahre,201,104,97
False,8125061,Massenbachhausen,30 - 35 Jahre,225,115,110
False,8125061,Massenbachhausen,35 - 40 Jahre,306,155,151
False,8125061,Massenbachhausen,40 - 45 Jahre,378,206,172
False,8125061,Massenbachhausen,45 - 50 Jahre,295,144,151
False,8125061,Massenbachhausen,50 - 55 Jahre,265,129,136
False,8125061,Massenbachhausen,55 - 60 Jahre,186,98,88
False,8125061,Massenbachhausen,60 - 65 Jahre,176,90,86
False,8125061,Massenbachhausen,65 - 75 Jahre,345,164,181
False,8125061,Massenbachhausen,75 und mehr Jahre,209,83,126
False,8125061,Massenbachhausen,Insgesamt,3638,1841,1797
False,8125063,"Möckmühl, Stadt",unter 3 Jahre,215,115,100
False,8125063,"Möckmühl, Stadt",3 -  6 Jahre,250,119,131
False,8125063,"Möckmühl, Stadt",6 - 10 Jahre,374,199,175
False,8125063,"Möckmühl, Stadt",10 - 15 Jahre,558,275,283
False,8125063,"Möckmühl, Stadt",15 - 18 Jahre,345,167,178
False,8125063,"Möckmühl, Stadt",18 - 20 Jahre,224,127,97
False,8125063,"Möckmühl, Stadt",20 - 25 Jahre,480,256,224
False,8125063,"Möckmühl, Stadt",25 - 30 Jahre,444,222,222
False,8125063,"Möckmühl, Stadt",30 - 35 Jahre,531,290,241
False,8125063,"Möckmühl, Stadt",35 - 40 Jahre,672,373,299
False,8125063,"Möckmühl, Stadt",40 - 45 Jahre,727,405,322
False,8125063,"Möckmühl, Stadt",45 - 50 Jahre,667,358,309
False,8125063,"Möckmühl, Stadt",50 - 55 Jahre,594,319,275
False,8125063,"Möckmühl, Stadt",55 - 60 Jahre,433,210,223
False,8125063,"Möckmühl, Stadt",60 - 65 Jahre,353,173,180
False,8125063,"Möckmühl, Stadt",65 - 75 Jahre,794,377,417
False,8125063,"Möckmühl, Stadt",75 und mehr Jahre,619,219,400
False,8125063,"Möckmühl, Stadt",Insgesamt,8280,4204,4076
False,8125065,"Neckarsulm, Stadt",unter 3 Jahre,720,329,391
False,8125065,"Neckarsulm, Stadt",3 -  6 Jahre,851,426,425
False,8125065,"Neckarsulm, Stadt",6 - 10 Jahre,1205,601,604
False,8125065,"Neckarsulm, Stadt",10 - 15 Jahre,1611,840,771
False,8125065,"Neckarsulm, Stadt",15 - 18 Jahre,1049,565,484
False,8125065,"Neckarsulm, Stadt",18 - 20 Jahre,669,372,297
False,8125065,"Neckarsulm, Stadt",20 - 25 Jahre,1665,838,827
False,8125065,"Neckarsulm, Stadt",25 - 30 Jahre,1798,937,861
False,8125065,"Neckarsulm, Stadt",30 - 35 Jahre,1897,974,923
False,8125065,"Neckarsulm, Stadt",35 - 40 Jahre,2263,1221,1042
False,8125065,"Neckarsulm, Stadt",40 - 45 Jahre,2213,1124,1089
False,8125065,"Neckarsulm, Stadt",45 - 50 Jahre,2054,1089,965
False,8125065,"Neckarsulm, Stadt",50 - 55 Jahre,1819,925,894
False,8125065,"Neckarsulm, Stadt",55 - 60 Jahre,1534,773,761
False,8125065,"Neckarsulm, Stadt",60 - 65 Jahre,1372,686,686
False,8125065,"Neckarsulm, Stadt",65 - 75 Jahre,2666,1265,1401
False,8125065,"Neckarsulm, Stadt",75 und mehr Jahre,2015,730,1285
False,8125065,"Neckarsulm, Stadt",Insgesamt,27401,13695,13706
False,8125066,Neckarwestheim,unter 3 Jahre,84,37,47
False,8125066,Neckarwestheim,3 -  6 Jahre,122,73,49
False,8125066,Neckarwestheim,6 - 10 Jahre,162,71,91
False,8125066,Neckarwestheim,10 - 15 Jahre,220,108,112
False,8125066,Neckarwestheim,15 - 18 Jahre,133,72,61
False,8125066,Neckarwestheim,18 - 20 Jahre,93,47,46
False,8125066,Neckarwestheim,20 - 25 Jahre,191,97,94
False,8125066,Neckarwestheim,25 - 30 Jahre,186,87,99
False,8125066,Neckarwestheim,30 - 35 Jahre,231,107,124
False,8125066,Neckarwestheim,35 - 40 Jahre,354,187,167
False,8125066,Neckarwestheim,40 - 45 Jahre,343,178,165
False,8125066,Neckarwestheim,45 - 50 Jahre,285,152,133
False,8125066,Neckarwestheim,50 - 55 Jahre,228,127,101
False,8125066,Neckarwestheim,55 - 60 Jahre,211,103,108
False,8125066,Neckarwestheim,60 - 65 Jahre,202,101,101
False,8125066,Neckarwestheim,65 - 75 Jahre,323,165,158
False,8125066,Neckarwestheim,75 und mehr Jahre,156,56,100
False,8125066,Neckarwestheim,Insgesamt,3524,1768,1756
False,8125068,"Neudenau, Stadt",unter 3 Jahre,157,78,79
False,8125068,"Neudenau, Stadt",3 -  6 Jahre,187,92,95
False,8125068,"Neudenau, Stadt",6 - 10 Jahre,238,131,107
False,8125068,"Neudenau, Stadt",10 - 15 Jahre,328,167,161
False,8125068,"Neudenau, Stadt",15 - 18 Jahre,197,99,98
False,8125068,"Neudenau, Stadt",18 - 20 Jahre,116,55,61
False,8125068,"Neudenau, Stadt",20 - 25 Jahre,273,155,118
False,8125068,"Neudenau, Stadt",25 - 30 Jahre,269,146,123
False,8125068,"Neudenau, Stadt",30 - 35 Jahre,375,178,197
False,8125068,"Neudenau, Stadt",35 - 40 Jahre,456,239,217
False,8125068,"Neudenau, Stadt",40 - 45 Jahre,428,225,203
False,8125068,"Neudenau, Stadt",45 - 50 Jahre,409,219,190
False,8125068,"Neudenau, Stadt",50 - 55 Jahre,355,183,172
False,8125068,"Neudenau, Stadt",55 - 60 Jahre,289,160,129
False,8125068,"Neudenau, Stadt",60 - 65 Jahre,223,101,122
False,8125068,"Neudenau, Stadt",65 - 75 Jahre,506,240,266
False,8125068,"Neudenau, Stadt",75 und mehr Jahre,360,117,243
False,8125068,"Neudenau, Stadt",Insgesamt,5166,2585,2581
False,8125069,"Neuenstadt am Kocher, Stadt",unter 3 Jahre,276,148,128
False,8125069,"Neuenstadt am Kocher, Stadt",3 -  6 Jahre,294,152,142
False,8125069,"Neuenstadt am Kocher, Stadt",6 - 10 Jahre,454,242,212
False,8125069,"Neuenstadt am Kocher, Stadt",10 - 15 Jahre,595,313,282
False,8125069,"Neuenstadt am Kocher, Stadt",15 - 18 Jahre,370,183,187
False,8125069,"Neuenstadt am Kocher, Stadt",18 - 20 Jahre,249,130,119
False,8125069,"Neuenstadt am Kocher, Stadt",20 - 25 Jahre,587,319,268
False,8125069,"Neuenstadt am Kocher, Stadt",25 - 30 Jahre,604,299,305
False,8125069,"Neuenstadt am Kocher, Stadt",30 - 35 Jahre,609,302,307
False,8125069,"Neuenstadt am Kocher, Stadt",35 - 40 Jahre,815,423,392
False,8125069,"Neuenstadt am Kocher, Stadt",40 - 45 Jahre,841,448,393
False,8125069,"Neuenstadt am Kocher, Stadt",45 - 50 Jahre,731,404,327
False,8125069,"Neuenstadt am Kocher, Stadt",50 - 55 Jahre,677,329,348
False,8125069,"Neuenstadt am Kocher, Stadt",55 - 60 Jahre,528,263,265
False,8125069,"Neuenstadt am Kocher, Stadt",60 - 65 Jahre,440,238,202
False,8125069,"Neuenstadt am Kocher, Stadt",65 - 75 Jahre,853,397,456
False,8125069,"Neuenstadt am Kocher, Stadt",75 und mehr Jahre,635,224,411
False,8125069,"Neuenstadt am Kocher, Stadt",Insgesamt,9558,4814,4744
False,8125074,Nordheim,unter 3 Jahre,236,117,119
False,8125074,Nordheim,3 -  6 Jahre,267,123,144
False,8125074,Nordheim,6 - 10 Jahre,364,192,172
False,8125074,Nordheim,10 - 15 Jahre,464,241,223
False,8125074,Nordheim,15 - 18 Jahre,283,148,135
False,8125074,Nordheim,18 - 20 Jahre,181,94,87
False,8125074,Nordheim,20 - 25 Jahre,367,191,176
False,8125074,Nordheim,25 - 30 Jahre,437,210,227
False,8125074,Nordheim,30 - 35 Jahre,465,221,244
False,8125074,Nordheim,35 - 40 Jahre,643,324,319
False,8125074,Nordheim,40 - 45 Jahre,699,348,351
False,8125074,Nordheim,45 - 50 Jahre,517,260,257
False,8125074,Nordheim,50 - 55 Jahre,479,232,247
False,8125074,Nordheim,55 - 60 Jahre,435,212,223
False,8125074,Nordheim,60 - 65 Jahre,404,194,210
False,8125074,Nordheim,65 - 75 Jahre,708,344,364
False,8125074,Nordheim,75 und mehr Jahre,502,195,307
False,8125074,Nordheim,Insgesamt,7451,3646,3805
False,8125078,Oedheim,unter 3 Jahre,178,68,110
False,8125078,Oedheim,3 -  6 Jahre,170,81,89
False,8125078,Oedheim,6 - 10 Jahre,286,134,152
False,8125078,Oedheim,10 - 15 Jahre,402,214,188
False,8125078,Oedheim,15 - 18 Jahre,245,130,115
False,8125078,Oedheim,18 - 20 Jahre,152,80,72
False,8125078,Oedheim,20 - 25 Jahre,287,147,140
False,8125078,Oedheim,25 - 30 Jahre,325,160,165
False,8125078,Oedheim,30 - 35 Jahre,360,218,142
False,8125078,Oedheim,35 - 40 Jahre,545,266,279
False,8125078,Oedheim,40 - 45 Jahre,567,308,259
False,8125078,Oedheim,45 - 50 Jahre,471,238,233
False,8125078,Oedheim,50 - 55 Jahre,363,195,168
False,8125078,Oedheim,55 - 60 Jahre,309,149,160
False,8125078,Oedheim,60 - 65 Jahre,319,156,163
False,8125078,Oedheim,65 - 75 Jahre,592,286,306
False,8125078,Oedheim,75 und mehr Jahre,351,139,212
False,8125078,Oedheim,Insgesamt,5922,2969,2953
False,8125079,Offenau,unter 3 Jahre,76,33,43
False,8125079,Offenau,3 -  6 Jahre,89,43,46
False,8125079,Offenau,6 - 10 Jahre,134,61,73
False,8125079,Offenau,10 - 15 Jahre,176,87,89
False,8125079,Offenau,15 - 18 Jahre,99,52,47
False,8125079,Offenau,18 - 20 Jahre,58,28,30
False,8125079,Offenau,20 - 25 Jahre,149,86,63
False,8125079,Offenau,25 - 30 Jahre,151,81,70
False,8125079,Offenau,30 - 35 Jahre,169,85,84
False,8125079,Offenau,35 - 40 Jahre,224,121,103
False,8125079,Offenau,40 - 45 Jahre,256,119,137
False,8125079,Offenau,45 - 50 Jahre,225,124,101
False,8125079,Offenau,50 - 55 Jahre,173,95,78
False,8125079,Offenau,55 - 60 Jahre,141,72,69
False,8125079,Offenau,60 - 65 Jahre,133,67,66
False,8125079,Offenau,65 - 75 Jahre,288,148,140
False,8125079,Offenau,75 und mehr Jahre,173,55,118
False,8125079,Offenau,Insgesamt,2714,1357,1357
False,8125081,Pfaffenhofen,unter 3 Jahre,60,23,37
False,8125081,Pfaffenhofen,3 -  6 Jahre,73,35,38
False,8125081,Pfaffenhofen,6 - 10 Jahre,118,65,53
False,8125081,Pfaffenhofen,10 - 15 Jahre,168,97,71
False,8125081,Pfaffenhofen,15 - 18 Jahre,125,65,60
False,8125081,Pfaffenhofen,18 - 20 Jahre,87,42,45
False,8125081,Pfaffenhofen,20 - 25 Jahre,163,80,83
False,8125081,Pfaffenhofen,25 - 30 Jahre,104,51,53
False,8125081,Pfaffenhofen,30 - 35 Jahre,114,57,57
False,8125081,Pfaffenhofen,35 - 40 Jahre,174,81,93
False,8125081,Pfaffenhofen,40 - 45 Jahre,207,107,100
False,8125081,Pfaffenhofen,45 - 50 Jahre,234,117,117
False,8125081,Pfaffenhofen,50 - 55 Jahre,153,81,72
False,8125081,Pfaffenhofen,55 - 60 Jahre,135,63,72
False,8125081,Pfaffenhofen,60 - 65 Jahre,112,64,48
False,8125081,Pfaffenhofen,65 - 75 Jahre,211,108,103
False,8125081,Pfaffenhofen,75 und mehr Jahre,166,59,107
False,8125081,Pfaffenhofen,Insgesamt,2404,1195,1209
False,8125084,Roigheim,unter 3 Jahre,44,22,22
False,8125084,Roigheim,3 -  6 Jahre,52,29,23
False,8125084,Roigheim,6 - 10 Jahre,67,37,30
False,8125084,Roigheim,10 - 15 Jahre,107,53,54
False,8125084,Roigheim,15 - 18 Jahre,50,23,27
False,8125084,Roigheim,18 - 20 Jahre,32,14,18
False,8125084,Roigheim,20 - 25 Jahre,75,40,35
False,8125084,Roigheim,25 - 30 Jahre,73,35,38
False,8125084,Roigheim,30 - 35 Jahre,87,44,43
False,8125084,Roigheim,35 - 40 Jahre,106,57,49
False,8125084,Roigheim,40 - 45 Jahre,140,68,72
False,8125084,Roigheim,45 - 50 Jahre,121,54,67
False,8125084,Roigheim,50 - 55 Jahre,87,45,42
False,8125084,Roigheim,55 - 60 Jahre,80,44,36
False,8125084,Roigheim,60 - 65 Jahre,63,33,30
False,8125084,Roigheim,65 - 75 Jahre,169,81,88
False,8125084,Roigheim,75 und mehr Jahre,116,42,74
False,8125084,Roigheim,Insgesamt,1469,721,748
False,8125086,"Schwaigern, Stadt",unter 3 Jahre,306,156,150
False,8125086,"Schwaigern, Stadt",3 -  6 Jahre,362,186,176
False,8125086,"Schwaigern, Stadt",6 - 10 Jahre,520,262,258
False,8125086,"Schwaigern, Stadt",10 - 15 Jahre,782,421,361
False,8125086,"Schwaigern, Stadt",15 - 18 Jahre,501,270,231
False,8125086,"Schwaigern, Stadt",18 - 20 Jahre,308,172,136
False,8125086,"Schwaigern, Stadt",20 - 25 Jahre,630,326,304
False,8125086,"Schwaigern, Stadt",25 - 30 Jahre,560,255,305
False,8125086,"Schwaigern, Stadt",30 - 35 Jahre,677,355,322
False,8125086,"Schwaigern, Stadt",35 - 40 Jahre,932,454,478
False,8125086,"Schwaigern, Stadt",40 - 45 Jahre,995,500,495
False,8125086,"Schwaigern, Stadt",45 - 50 Jahre,890,466,424
False,8125086,"Schwaigern, Stadt",50 - 55 Jahre,692,376,316
False,8125086,"Schwaigern, Stadt",55 - 60 Jahre,555,272,283
False,8125086,"Schwaigern, Stadt",60 - 65 Jahre,540,264,276
False,8125086,"Schwaigern, Stadt",65 - 75 Jahre,1083,508,575
False,8125086,"Schwaigern, Stadt",75 und mehr Jahre,703,253,450
False,8125086,"Schwaigern, Stadt",Insgesamt,11036,5496,5540
False,8125087,Siegelsbach,unter 3 Jahre,51,26,25
False,8125087,Siegelsbach,3 -  6 Jahre,68,43,25
False,8125087,Siegelsbach,6 - 10 Jahre,89,53,36
False,8125087,Siegelsbach,10 - 15 Jahre,105,51,54
False,8125087,Siegelsbach,15 - 18 Jahre,77,40,37
False,8125087,Siegelsbach,18 - 20 Jahre,45,24,21
False,8125087,Siegelsbach,20 - 25 Jahre,80,43,37
False,8125087,Siegelsbach,25 - 30 Jahre,93,42,51
False,8125087,Siegelsbach,30 - 35 Jahre,104,55,49
False,8125087,Siegelsbach,35 - 40 Jahre,166,82,84
False,8125087,Siegelsbach,40 - 45 Jahre,170,83,87
False,8125087,Siegelsbach,45 - 50 Jahre,113,59,54
False,8125087,Siegelsbach,50 - 55 Jahre,97,50,47
False,8125087,Siegelsbach,55 - 60 Jahre,92,49,43
False,8125087,Siegelsbach,60 - 65 Jahre,66,31,35
False,8125087,Siegelsbach,65 - 75 Jahre,162,74,88
False,8125087,Siegelsbach,75 und mehr Jahre,92,33,59
False,8125087,Siegelsbach,Insgesamt,1670,838,832
False,8125094,Talheim,unter 3 Jahre,123,52,71
False,8125094,Talheim,3 -  6 Jahre,146,71,75
False,8125094,Talheim,6 - 10 Jahre,203,106,97
False,8125094,Talheim,10 - 15 Jahre,293,151,142
False,8125094,Talheim,15 - 18 Jahre,188,104,84
False,8125094,Talheim,18 - 20 Jahre,99,53,46
False,8125094,Talheim,20 - 25 Jahre,195,108,87
False,8125094,Talheim,25 - 30 Jahre,237,113,124
False,8125094,Talheim,30 - 35 Jahre,272,128,144
False,8125094,Talheim,35 - 40 Jahre,427,211,216
False,8125094,Talheim,40 - 45 Jahre,475,241,234
False,8125094,Talheim,45 - 50 Jahre,395,217,178
False,8125094,Talheim,50 - 55 Jahre,326,171,155
False,8125094,Talheim,55 - 60 Jahre,296,139,157
False,8125094,Talheim,60 - 65 Jahre,273,139,134
False,8125094,Talheim,65 - 75 Jahre,516,244,272
False,8125094,Talheim,75 und mehr Jahre,304,123,181
False,8125094,Talheim,Insgesamt,4768,2371,2397
False,8125096,Untereisesheim,unter 3 Jahre,136,67,69
False,8125096,Untereisesheim,3 -  6 Jahre,130,73,57
False,8125096,Untereisesheim,6 - 10 Jahre,190,109,81
False,8125096,Untereisesheim,10 - 15 Jahre,244,115,129
False,8125096,Untereisesheim,15 - 18 Jahre,145,78,67
False,8125096,Untereisesheim,18 - 20 Jahre,113,51,62
False,8125096,Untereisesheim,20 - 25 Jahre,239,114,125
False,8125096,Untereisesheim,25 - 30 Jahre,268,142,126
False,8125096,Untereisesheim,30 - 35 Jahre,266,122,144
False,8125096,Untereisesheim,35 - 40 Jahre,372,208,164
False,8125096,Untereisesheim,40 - 45 Jahre,326,156,170
False,8125096,Untereisesheim,45 - 50 Jahre,303,160,143
False,8125096,Untereisesheim,50 - 55 Jahre,294,131,163
False,8125096,Untereisesheim,55 - 60 Jahre,277,144,133
False,8125096,Untereisesheim,60 - 65 Jahre,209,102,107
False,8125096,Untereisesheim,65 - 75 Jahre,330,158,172
False,8125096,Untereisesheim,75 und mehr Jahre,192,73,119
False,8125096,Untereisesheim,Insgesamt,4034,2003,2031
False,8125098,Untergruppenbach,unter 3 Jahre,185,96,89
False,8125098,Untergruppenbach,3 -  6 Jahre,205,110,95
False,8125098,Untergruppenbach,6 - 10 Jahre,349,186,163
False,8125098,Untergruppenbach,10 - 15 Jahre,415,195,220
False,8125098,Untergruppenbach,15 - 18 Jahre,267,147,120
False,8125098,Untergruppenbach,18 - 20 Jahre,140,70,70
False,8125098,Untergruppenbach,20 - 25 Jahre,394,188,206
False,8125098,Untergruppenbach,25 - 30 Jahre,395,191,204
False,8125098,Untergruppenbach,30 - 35 Jahre,419,207,212
False,8125098,Untergruppenbach,35 - 40 Jahre,643,302,341
False,8125098,Untergruppenbach,40 - 45 Jahre,695,387,308
False,8125098,Untergruppenbach,45 - 50 Jahre,596,313,283
False,8125098,Untergruppenbach,50 - 55 Jahre,525,241,284
False,8125098,Untergruppenbach,55 - 60 Jahre,462,231,231
False,8125098,Untergruppenbach,60 - 65 Jahre,488,237,251
False,8125098,Untergruppenbach,65 - 75 Jahre,859,429,430
False,8125098,Untergruppenbach,75 und mehr Jahre,512,212,300
False,8125098,Untergruppenbach,Insgesamt,7549,3742,3807
False,8125102,"Weinsberg, Stadt",unter 3 Jahre,303,149,154
False,8125102,"Weinsberg, Stadt",3 -  6 Jahre,346,182,164
False,8125102,"Weinsberg, Stadt",6 - 10 Jahre,479,238,241
False,8125102,"Weinsberg, Stadt",10 - 15 Jahre,656,339,317
False,8125102,"Weinsberg, Stadt",15 - 18 Jahre,412,195,217
False,8125102,"Weinsberg, Stadt",18 - 20 Jahre,307,163,144
False,8125102,"Weinsberg, Stadt",20 - 25 Jahre,607,301,306
False,8125102,"Weinsberg, Stadt",25 - 30 Jahre,666,340,326
False,8125102,"Weinsberg, Stadt",30 - 35 Jahre,773,385,388
False,8125102,"Weinsberg, Stadt",35 - 40 Jahre,994,505,489
False,8125102,"Weinsberg, Stadt",40 - 45 Jahre,1060,561,499
False,8125102,"Weinsberg, Stadt",45 - 50 Jahre,890,467,423
False,8125102,"Weinsberg, Stadt",50 - 55 Jahre,796,372,424
False,8125102,"Weinsberg, Stadt",55 - 60 Jahre,654,316,338
False,8125102,"Weinsberg, Stadt",60 - 65 Jahre,612,308,304
False,8125102,"Weinsberg, Stadt",65 - 75 Jahre,1233,587,646
False,8125102,"Weinsberg, Stadt",75 und mehr Jahre,950,346,604
False,8125102,"Weinsberg, Stadt",Insgesamt,11738,5754,5984
False,8125103,"Widdern, Stadt",unter 3 Jahre,57,30,27
False,8125103,"Widdern, Stadt",3 -  6 Jahre,57,25,32
False,8125103,"Widdern, Stadt",6 - 10 Jahre,127,69,58
False,8125103,"Widdern, Stadt",10 - 15 Jahre,150,64,86
False,8125103,"Widdern, Stadt",15 - 18 Jahre,81,45,36
False,8125103,"Widdern, Stadt",18 - 20 Jahre,50,25,25
False,8125103,"Widdern, Stadt",20 - 25 Jahre,99,56,43
False,8125103,"Widdern, Stadt",25 - 30 Jahre,89,45,44
False,8125103,"Widdern, Stadt",30 - 35 Jahre,99,49,50
False,8125103,"Widdern, Stadt",35 - 40 Jahre,171,88,83
False,8125103,"Widdern, Stadt",40 - 45 Jahre,185,91,94
False,8125103,"Widdern, Stadt",45 - 50 Jahre,158,86,72
False,8125103,"Widdern, Stadt",50 - 55 Jahre,113,69,44
False,8125103,"Widdern, Stadt",55 - 60 Jahre,100,50,50
False,8125103,"Widdern, Stadt",60 - 65 Jahre,74,42,32
False,8125103,"Widdern, Stadt",65 - 75 Jahre,167,84,83
False,8125103,"Widdern, Stadt",75 und mehr Jahre,189,64,125
False,8125103,"Widdern, Stadt",Insgesamt,1966,982,984
False,8125107,Wüstenrot,unter 3 Jahre,179,93,86
False,8125107,Wüstenrot,3 -  6 Jahre,202,94,108
False,8125107,Wüstenrot,6 - 10 Jahre,325,167,158
False,8125107,Wüstenrot,10 - 15 Jahre,425,231,194
False,8125107,Wüstenrot,15 - 18 Jahre,272,134,138
False,8125107,Wüstenrot,18 - 20 Jahre,177,86,91
False,8125107,Wüstenrot,20 - 25 Jahre,333,165,168
False,8125107,Wüstenrot,25 - 30 Jahre,306,159,147
False,8125107,Wüstenrot,30 - 35 Jahre,337,162,175
False,8125107,Wüstenrot,35 - 40 Jahre,509,251,258
False,8125107,Wüstenrot,40 - 45 Jahre,614,289,325
False,8125107,Wüstenrot,45 - 50 Jahre,519,267,252
False,8125107,Wüstenrot,50 - 55 Jahre,438,226,212
False,8125107,Wüstenrot,55 - 60 Jahre,371,188,183
False,8125107,Wüstenrot,60 - 65 Jahre,296,157,139
False,8125107,Wüstenrot,65 - 75 Jahre,711,342,369
False,8125107,Wüstenrot,75 und mehr Jahre,789,247,542
False,8125107,Wüstenrot,Insgesamt,6803,3258,3545
False,8125108,Zaberfeld,unter 3 Jahre,108,50,58
False,8125108,Zaberfeld,3 -  6 Jahre,137,71,66
False,8125108,Zaberfeld,6 - 10 Jahre,203,87,116
False,8125108,Zaberfeld,10 - 15 Jahre,275,138,137
False,8125108,Zaberfeld,15 - 18 Jahre,176,99,77
False,8125108,Zaberfeld,18 - 20 Jahre,102,50,52
False,8125108,Zaberfeld,20 - 25 Jahre,201,104,97
False,8125108,Zaberfeld,25 - 30 Jahre,186,93,93
False,8125108,Zaberfeld,30 - 35 Jahre,210,100,110
False,8125108,Zaberfeld,35 - 40 Jahre,311,152,159
False,8125108,Zaberfeld,40 - 45 Jahre,395,200,195
False,8125108,Zaberfeld,45 - 50 Jahre,341,170,171
False,8125108,Zaberfeld,50 - 55 Jahre,272,149,123
False,8125108,Zaberfeld,55 - 60 Jahre,218,119,99
False,8125108,Zaberfeld,60 - 65 Jahre,177,91,86
False,8125108,Zaberfeld,65 - 75 Jahre,381,171,210
False,8125108,Zaberfeld,75 und mehr Jahre,267,96,171
False,8125108,Zaberfeld,Insgesamt,3960,1940,2020
False,8125110,Obersulm,unter 3 Jahre,377,191,186
False,8125110,Obersulm,3 -  6 Jahre,439,229,210
False,8125110,Obersulm,6 - 10 Jahre,619,307,312
False,8125110,Obersulm,10 - 15 Jahre,784,419,365
False,8125110,Obersulm,15 - 18 Jahre,520,242,278
False,8125110,Obersulm,18 - 20 Jahre,318,170,148
False,8125110,Obersulm,20 - 25 Jahre,752,384,368
False,8125110,Obersulm,25 - 30 Jahre,825,435,390
False,8125110,Obersulm,30 - 35 Jahre,874,441,433
False,8125110,Obersulm,35 - 40 Jahre,1099,588,511
False,8125110,Obersulm,40 - 45 Jahre,1268,669,599
False,8125110,Obersulm,45 - 50 Jahre,1089,562,527
False,8125110,Obersulm,50 - 55 Jahre,840,438,402
False,8125110,Obersulm,55 - 60 Jahre,755,365,390
False,8125110,Obersulm,60 - 65 Jahre,775,390,385
False,8125110,Obersulm,65 - 75 Jahre,1461,695,766
False,8125110,Obersulm,75 und mehr Jahre,979,359,620
False,8125110,Obersulm,Insgesamt,13774,6884,6890
False,8125111,Hardthausen am Kocher,unter 3 Jahre,123,53,70
False,8125111,Hardthausen am Kocher,3 -  6 Jahre,143,71,72
False,8125111,Hardthausen am Kocher,6 - 10 Jahre,206,102,104
False,8125111,Hardthausen am Kocher,10 - 15 Jahre,287,152,135
False,8125111,Hardthausen am Kocher,15 - 18 Jahre,173,88,85
False,8125111,Hardthausen am Kocher,18 - 20 Jahre,113,57,56
False,8125111,Hardthausen am Kocher,20 - 25 Jahre,212,108,104
False,8125111,Hardthausen am Kocher,25 - 30 Jahre,216,124,92
False,8125111,Hardthausen am Kocher,30 - 35 Jahre,245,112,133
False,8125111,Hardthausen am Kocher,35 - 40 Jahre,369,189,180
False,8125111,Hardthausen am Kocher,40 - 45 Jahre,417,227,190
False,8125111,Hardthausen am Kocher,45 - 50 Jahre,321,165,156
False,8125111,Hardthausen am Kocher,50 - 55 Jahre,248,131,117
False,8125111,Hardthausen am Kocher,55 - 60 Jahre,187,106,81
False,8125111,Hardthausen am Kocher,60 - 65 Jahre,152,68,84
False,8125111,Hardthausen am Kocher,65 - 75 Jahre,356,166,190
False,8125111,Hardthausen am Kocher,75 und mehr Jahre,226,91,135
False,8125111,Hardthausen am Kocher,Insgesamt,3994,2010,1984
False,8125113,Langenbrettach,unter 3 Jahre,113,69,44
False,8125113,Langenbrettach,3 -  6 Jahre,118,64,54
False,8125113,Langenbrettach,6 - 10 Jahre,175,100,75
False,8125113,Langenbrettach,10 - 15 Jahre,224,114,110
False,8125113,Langenbrettach,15 - 18 Jahre,161,76,85
False,8125113,Langenbrettach,18 - 20 Jahre,81,41,40
False,8125113,Langenbrettach,20 - 25 Jahre,218,116,102
False,8125113,Langenbrettach,25 - 30 Jahre,195,97,98
False,8125113,Langenbrettach,30 - 35 Jahre,266,133,133
False,8125113,Langenbrettach,35 - 40 Jahre,304,157,147
False,8125113,Langenbrettach,40 - 45 Jahre,338,172,166
False,8125113,Langenbrettach,45 - 50 Jahre,280,134,146
False,8125113,Langenbrettach,50 - 55 Jahre,226,107,119
False,8125113,Langenbrettach,55 - 60 Jahre,173,89,84
False,8125113,Langenbrettach,60 - 65 Jahre,156,79,77
False,8125113,Langenbrettach,65 - 75 Jahre,300,154,146
False,8125113,Langenbrettach,75 und mehr Jahre,189,74,115
False,8125113,Langenbrettach,Insgesamt,3517,1776,1741
False,8126,Landkreis Hohenlohekreis,unter 3 Jahre,3057,1548,1509
False,8126,Landkreis Hohenlohekreis,3 -  6 Jahre,3429,1783,1646
False,8126,Landkreis Hohenlohekreis,6 - 10 Jahre,5024,2639,2385
False,8126,Landkreis Hohenlohekreis,10 - 15 Jahre,6736,3361,3375
False,8126,Landkreis Hohenlohekreis,15 - 18 Jahre,4393,2214,2179
False,8126,Landkreis Hohenlohekreis,18 - 20 Jahre,2904,1493,1411
False,8126,Landkreis Hohenlohekreis,20 - 25 Jahre,6562,3464,3098
False,8126,Landkreis Hohenlohekreis,25 - 30 Jahre,6283,3150,3133
False,8126,Landkreis Hohenlohekreis,30 - 35 Jahre,6771,3453,3318
False,8126,Landkreis Hohenlohekreis,35 - 40 Jahre,8831,4495,4336
False,8126,Landkreis Hohenlohekreis,40 - 45 Jahre,9574,4976,4598
False,8126,Landkreis Hohenlohekreis,45 - 50 Jahre,8636,4464,4172
False,8126,Landkreis Hohenlohekreis,50 - 55 Jahre,7290,3737,3553
False,8126,Landkreis Hohenlohekreis,55 - 60 Jahre,5894,3079,2815
False,8126,Landkreis Hohenlohekreis,60 - 65 Jahre,5003,2473,2530
False,8126,Landkreis Hohenlohekreis,65 - 75 Jahre,10676,5086,5590
False,8126,Landkreis Hohenlohekreis,75 und mehr Jahre,8655,3118,5537
False,8126,Landkreis Hohenlohekreis,Insgesamt,109718,54533,55185
False,8126011,Bretzfeld,unter 3 Jahre,359,171,188
False,8126011,Bretzfeld,3 -  6 Jahre,412,219,193
False,8126011,Bretzfeld,6 - 10 Jahre,595,310,285
False,8126011,Bretzfeld,10 - 15 Jahre,814,413,401
False,8126011,Bretzfeld,15 - 18 Jahre,511,262,249
False,8126011,Bretzfeld,18 - 20 Jahre,302,162,140
False,8126011,Bretzfeld,20 - 25 Jahre,708,371,337
False,8126011,Bretzfeld,25 - 30 Jahre,697,341,356
False,8126011,Bretzfeld,30 - 35 Jahre,764,388,376
False,8126011,Bretzfeld,35 - 40 Jahre,1030,530,500
False,8126011,Bretzfeld,40 - 45 Jahre,1134,571,563
False,8126011,Bretzfeld,45 - 50 Jahre,986,503,483
False,8126011,Bretzfeld,50 - 55 Jahre,868,437,431
False,8126011,Bretzfeld,55 - 60 Jahre,683,365,318
False,8126011,Bretzfeld,60 - 65 Jahre,499,249,250
False,8126011,Bretzfeld,65 - 75 Jahre,1042,496,546
False,8126011,Bretzfeld,75 und mehr Jahre,801,300,501
False,8126011,Bretzfeld,Insgesamt,12205,6088,6117
False,8126020,Dörzbach,unter 3 Jahre,81,43,38
False,8126020,Dörzbach,3 -  6 Jahre,92,53,39
False,8126020,Dörzbach,6 - 10 Jahre,128,64,64
False,8126020,Dörzbach,10 - 15 Jahre,143,70,73
False,8126020,Dörzbach,15 - 18 Jahre,109,62,47
False,8126020,Dörzbach,18 - 20 Jahre,50,26,24
False,8126020,Dörzbach,20 - 25 Jahre,140,73,67
False,8126020,Dörzbach,25 - 30 Jahre,134,61,73
False,8126020,Dörzbach,30 - 35 Jahre,173,89,84
False,8126020,Dörzbach,35 - 40 Jahre,193,104,89
False,8126020,Dörzbach,40 - 45 Jahre,224,116,108
False,8126020,Dörzbach,45 - 50 Jahre,176,93,83
False,8126020,Dörzbach,50 - 55 Jahre,165,87,78
False,8126020,Dörzbach,55 - 60 Jahre,122,64,58
False,8126020,Dörzbach,60 - 65 Jahre,98,52,46
False,8126020,Dörzbach,65 - 75 Jahre,228,111,117
False,8126020,Dörzbach,75 und mehr Jahre,182,59,123
False,8126020,Dörzbach,Insgesamt,2438,1227,1211
False,8126028,"Forchtenberg, Stadt",unter 3 Jahre,142,75,67
False,8126028,"Forchtenberg, Stadt",3 -  6 Jahre,158,83,75
False,8126028,"Forchtenberg, Stadt",6 - 10 Jahre,226,129,97
False,8126028,"Forchtenberg, Stadt",10 - 15 Jahre,357,172,185
False,8126028,"Forchtenberg, Stadt",15 - 18 Jahre,216,114,102
False,8126028,"Forchtenberg, Stadt",18 - 20 Jahre,129,68,61
False,8126028,"Forchtenberg, Stadt",20 - 25 Jahre,296,164,132
False,8126028,"Forchtenberg, Stadt",25 - 30 Jahre,300,139,161
False,8126028,"Forchtenberg, Stadt",30 - 35 Jahre,305,167,138
False,8126028,"Forchtenberg, Stadt",35 - 40 Jahre,436,219,217
False,8126028,"Forchtenberg, Stadt",40 - 45 Jahre,444,237,207
False,8126028,"Forchtenberg, Stadt",45 - 50 Jahre,359,179,180
False,8126028,"Forchtenberg, Stadt",50 - 55 Jahre,331,173,158
False,8126028,"Forchtenberg, Stadt",55 - 60 Jahre,283,151,132
False,8126028,"Forchtenberg, Stadt",60 - 65 Jahre,219,111,108
False,8126028,"Forchtenberg, Stadt",65 - 75 Jahre,484,238,246
False,8126028,"Forchtenberg, Stadt",75 und mehr Jahre,389,138,251
False,8126028,"Forchtenberg, Stadt",Insgesamt,5074,2557,2517
False,8126039,"Ingelfingen, Stadt",unter 3 Jahre,189,94,95
False,8126039,"Ingelfingen, Stadt",3 -  6 Jahre,189,104,85
False,8126039,"Ingelfingen, Stadt",6 - 10 Jahre,261,134,127
False,8126039,"Ingelfingen, Stadt",10 - 15 Jahre,368,180,188
False,8126039,"Ingelfingen, Stadt",15 - 18 Jahre,227,111,116
False,8126039,"Ingelfingen, Stadt",18 - 20 Jahre,149,73,76
False,8126039,"Ingelfingen, Stadt",20 - 25 Jahre,318,170,148
False,8126039,"Ingelfingen, Stadt",25 - 30 Jahre,313,153,160
False,8126039,"Ingelfingen, Stadt",30 - 35 Jahre,341,167,174
False,8126039,"Ingelfingen, Stadt",35 - 40 Jahre,509,250,259
False,8126039,"Ingelfingen, Stadt",40 - 45 Jahre,488,269,219
False,8126039,"Ingelfingen, Stadt",45 - 50 Jahre,421,225,196
False,8126039,"Ingelfingen, Stadt",50 - 55 Jahre,377,193,184
False,8126039,"Ingelfingen, Stadt",55 - 60 Jahre,313,158,155
False,8126039,"Ingelfingen, Stadt",60 - 65 Jahre,283,145,138
False,8126039,"Ingelfingen, Stadt",65 - 75 Jahre,575,271,304
False,8126039,"Ingelfingen, Stadt",75 und mehr Jahre,554,195,359
False,8126039,"Ingelfingen, Stadt",Insgesamt,5875,2892,2983
False,8126045,"Krautheim, Stadt",unter 3 Jahre,131,72,59
False,8126045,"Krautheim, Stadt",3 -  6 Jahre,162,92,70
False,8126045,"Krautheim, Stadt",6 - 10 Jahre,224,139,85
False,8126045,"Krautheim, Stadt",10 - 15 Jahre,297,158,139
False,8126045,"Krautheim, Stadt",15 - 18 Jahre,190,85,105
False,8126045,"Krautheim, Stadt",18 - 20 Jahre,134,60,74
False,8126045,"Krautheim, Stadt",20 - 25 Jahre,255,140,115
False,8126045,"Krautheim, Stadt",25 - 30 Jahre,259,139,120
False,8126045,"Krautheim, Stadt",30 - 35 Jahre,301,148,153
False,8126045,"Krautheim, Stadt",35 - 40 Jahre,415,222,193
False,8126045,"Krautheim, Stadt",40 - 45 Jahre,481,256,225
False,8126045,"Krautheim, Stadt",45 - 50 Jahre,396,201,195
False,8126045,"Krautheim, Stadt",50 - 55 Jahre,298,166,132
False,8126045,"Krautheim, Stadt",55 - 60 Jahre,243,121,122
False,8126045,"Krautheim, Stadt",60 - 65 Jahre,184,96,88
False,8126045,"Krautheim, Stadt",65 - 75 Jahre,528,262,266
False,8126045,"Krautheim, Stadt",75 und mehr Jahre,367,136,231
False,8126045,"Krautheim, Stadt",Insgesamt,4865,2493,2372
False,8126046,"Künzelsau, Stadt",unter 3 Jahre,392,198,194
False,8126046,"Künzelsau, Stadt",3 -  6 Jahre,430,203,227
False,8126046,"Künzelsau, Stadt",6 - 10 Jahre,644,302,342
False,8126046,"Künzelsau, Stadt",10 - 15 Jahre,819,397,422
False,8126046,"Künzelsau, Stadt",15 - 18 Jahre,618,313,305
False,8126046,"Künzelsau, Stadt",18 - 20 Jahre,399,211,188
False,8126046,"Künzelsau, Stadt",20 - 25 Jahre,948,508,440
False,8126046,"Künzelsau, Stadt",25 - 30 Jahre,903,452,451
False,8126046,"Künzelsau, Stadt",30 - 35 Jahre,928,456,472
False,8126046,"Künzelsau, Stadt",35 - 40 Jahre,1100,558,542
False,8126046,"Künzelsau, Stadt",40 - 45 Jahre,1185,617,568
False,8126046,"Künzelsau, Stadt",45 - 50 Jahre,1194,609,585
False,8126046,"Künzelsau, Stadt",50 - 55 Jahre,1024,509,515
False,8126046,"Künzelsau, Stadt",55 - 60 Jahre,785,397,388
False,8126046,"Künzelsau, Stadt",60 - 65 Jahre,720,365,355
False,8126046,"Künzelsau, Stadt",65 - 75 Jahre,1504,672,832
False,8126046,"Künzelsau, Stadt",75 und mehr Jahre,1439,521,918
False,8126046,"Künzelsau, Stadt",Insgesamt,15032,7288,7744
False,8126047,Kupferzell,unter 3 Jahre,189,98,91
False,8126047,Kupferzell,3 -  6 Jahre,170,90,80
False,8126047,Kupferzell,6 - 10 Jahre,259,137,122
False,8126047,Kupferzell,10 - 15 Jahre,395,196,199
False,8126047,Kupferzell,15 - 18 Jahre,255,124,131
False,8126047,Kupferzell,18 - 20 Jahre,153,74,79
False,8126047,Kupferzell,20 - 25 Jahre,377,203,174
False,8126047,Kupferzell,25 - 30 Jahre,363,187,176
False,8126047,Kupferzell,30 - 35 Jahre,382,177,205
False,8126047,Kupferzell,35 - 40 Jahre,518,276,242
False,8126047,Kupferzell,40 - 45 Jahre,529,245,284
False,8126047,Kupferzell,45 - 50 Jahre,468,238,230
False,8126047,Kupferzell,50 - 55 Jahre,365,186,179
False,8126047,Kupferzell,55 - 60 Jahre,281,157,124
False,8126047,Kupferzell,60 - 65 Jahre,203,105,98
False,8126047,Kupferzell,65 - 75 Jahre,480,228,252
False,8126047,Kupferzell,75 und mehr Jahre,346,125,221
False,8126047,Kupferzell,Insgesamt,5733,2846,2887
False,8126056,Mulfingen,unter 3 Jahre,129,63,66
False,8126056,Mulfingen,3 -  6 Jahre,124,72,52
False,8126056,Mulfingen,6 - 10 Jahre,202,106,96
False,8126056,Mulfingen,10 - 15 Jahre,251,127,124
False,8126056,Mulfingen,15 - 18 Jahre,193,111,82
False,8126056,Mulfingen,18 - 20 Jahre,128,67,61
False,8126056,Mulfingen,20 - 25 Jahre,256,135,121
False,8126056,Mulfingen,25 - 30 Jahre,178,99,79
False,8126056,Mulfingen,30 - 35 Jahre,228,125,103
False,8126056,Mulfingen,35 - 40 Jahre,270,151,119
False,8126056,Mulfingen,40 - 45 Jahre,343,172,171
False,8126056,Mulfingen,45 - 50 Jahre,318,169,149
False,8126056,Mulfingen,50 - 55 Jahre,240,129,111
False,8126056,Mulfingen,55 - 60 Jahre,205,118,87
False,8126056,Mulfingen,60 - 65 Jahre,133,59,74
False,8126056,Mulfingen,65 - 75 Jahre,364,185,179
False,8126056,Mulfingen,75 und mehr Jahre,311,102,209
False,8126056,Mulfingen,Insgesamt,3873,1990,1883
False,8126058,"Neuenstein, Stadt",unter 3 Jahre,170,87,83
False,8126058,"Neuenstein, Stadt",3 -  6 Jahre,193,90,103
False,8126058,"Neuenstein, Stadt",6 - 10 Jahre,300,170,130
False,8126058,"Neuenstein, Stadt",10 - 15 Jahre,398,208,190
False,8126058,"Neuenstein, Stadt",15 - 18 Jahre,251,120,131
False,8126058,"Neuenstein, Stadt",18 - 20 Jahre,169,92,77
False,8126058,"Neuenstein, Stadt",20 - 25 Jahre,383,213,170
False,8126058,"Neuenstein, Stadt",25 - 30 Jahre,344,160,184
False,8126058,"Neuenstein, Stadt",30 - 35 Jahre,352,179,173
False,8126058,"Neuenstein, Stadt",35 - 40 Jahre,491,255,236
False,8126058,"Neuenstein, Stadt",40 - 45 Jahre,567,283,284
False,8126058,"Neuenstein, Stadt",45 - 50 Jahre,513,274,239
False,8126058,"Neuenstein, Stadt",50 - 55 Jahre,426,224,202
False,8126058,"Neuenstein, Stadt",55 - 60 Jahre,350,193,157
False,8126058,"Neuenstein, Stadt",60 - 65 Jahre,235,118,117
False,8126058,"Neuenstein, Stadt",65 - 75 Jahre,597,270,327
False,8126058,"Neuenstein, Stadt",75 und mehr Jahre,460,177,283
False,8126058,"Neuenstein, Stadt",Insgesamt,6199,3113,3086
False,8126060,"Niedernhall, Stadt",unter 3 Jahre,112,52,60
False,8126060,"Niedernhall, Stadt",3 -  6 Jahre,120,61,59
False,8126060,"Niedernhall, Stadt",6 - 10 Jahre,190,99,91
False,8126060,"Niedernhall, Stadt",10 - 15 Jahre,221,113,108
False,8126060,"Niedernhall, Stadt",15 - 18 Jahre,140,71,69
False,8126060,"Niedernhall, Stadt",18 - 20 Jahre,99,41,58
False,8126060,"Niedernhall, Stadt",20 - 25 Jahre,221,121,100
False,8126060,"Niedernhall, Stadt",25 - 30 Jahre,238,126,112
False,8126060,"Niedernhall, Stadt",30 - 35 Jahre,286,170,116
False,8126060,"Niedernhall, Stadt",35 - 40 Jahre,335,184,151
False,8126060,"Niedernhall, Stadt",40 - 45 Jahre,324,167,157
False,8126060,"Niedernhall, Stadt",45 - 50 Jahre,310,172,138
False,8126060,"Niedernhall, Stadt",50 - 55 Jahre,266,131,135
False,8126060,"Niedernhall, Stadt",55 - 60 Jahre,271,130,141
False,8126060,"Niedernhall, Stadt",60 - 65 Jahre,193,102,91
False,8126060,"Niedernhall, Stadt",65 - 75 Jahre,391,194,197
False,8126060,"Niedernhall, Stadt",75 und mehr Jahre,252,96,156
False,8126060,"Niedernhall, Stadt",Insgesamt,3969,2030,1939
False,8126066,"Öhringen, Stadt",unter 3 Jahre,622,311,311
False,8126066,"Öhringen, Stadt",3 -  6 Jahre,699,363,336
False,8126066,"Öhringen, Stadt",6 - 10 Jahre,948,511,437
False,8126066,"Öhringen, Stadt",10 - 15 Jahre,1295,658,637
False,8126066,"Öhringen, Stadt",15 - 18 Jahre,818,419,399
False,8126066,"Öhringen, Stadt",18 - 20 Jahre,585,306,279
False,8126066,"Öhringen, Stadt",20 - 25 Jahre,1359,731,628
False,8126066,"Öhringen, Stadt",25 - 30 Jahre,1359,682,677
False,8126066,"Öhringen, Stadt",30 - 35 Jahre,1367,694,673
False,8126066,"Öhringen, Stadt",35 - 40 Jahre,1667,828,839
False,8126066,"Öhringen, Stadt",40 - 45 Jahre,1941,1003,938
False,8126066,"Öhringen, Stadt",45 - 50 Jahre,1908,976,932
False,8126066,"Öhringen, Stadt",50 - 55 Jahre,1548,772,776
False,8126066,"Öhringen, Stadt",55 - 60 Jahre,1218,645,573
False,8126066,"Öhringen, Stadt",60 - 65 Jahre,1111,526,585
False,8126066,"Öhringen, Stadt",65 - 75 Jahre,2291,1072,1219
False,8126066,"Öhringen, Stadt",75 und mehr Jahre,1970,703,1267
False,8126066,"Öhringen, Stadt",Insgesamt,22706,11200,11506
False,8126069,Pfedelbach,unter 3 Jahre,267,134,133
False,8126069,Pfedelbach,3 -  6 Jahre,286,134,152
False,8126069,Pfedelbach,6 - 10 Jahre,446,230,216
False,8126069,Pfedelbach,10 - 15 Jahre,562,275,287
False,8126069,Pfedelbach,15 - 18 Jahre,322,151,171
False,8126069,Pfedelbach,18 - 20 Jahre,226,123,103
False,8126069,Pfedelbach,20 - 25 Jahre,440,215,225
False,8126069,Pfedelbach,25 - 30 Jahre,467,232,235
False,8126069,Pfedelbach,30 - 35 Jahre,594,304,290
False,8126069,Pfedelbach,35 - 40 Jahre,766,369,397
False,8126069,Pfedelbach,40 - 45 Jahre,778,420,358
False,8126069,Pfedelbach,45 - 50 Jahre,668,349,319
False,8126069,Pfedelbach,50 - 55 Jahre,566,290,276
False,8126069,Pfedelbach,55 - 60 Jahre,500,237,263
False,8126069,Pfedelbach,60 - 65 Jahre,493,240,253
False,8126069,Pfedelbach,65 - 75 Jahre,896,434,462
False,8126069,Pfedelbach,75 und mehr Jahre,618,228,390
False,8126069,Pfedelbach,Insgesamt,8895,4365,4530
False,8126072,Schöntal,unter 3 Jahre,147,74,73
False,8126072,Schöntal,3 -  6 Jahre,183,100,83
False,8126072,Schöntal,6 - 10 Jahre,296,166,130
False,8126072,Schöntal,10 - 15 Jahre,367,173,194
False,8126072,Schöntal,15 - 18 Jahre,264,137,127
False,8126072,Schöntal,18 - 20 Jahre,154,81,73
False,8126072,Schöntal,20 - 25 Jahre,277,160,117
False,8126072,Schöntal,25 - 30 Jahre,267,149,118
False,8126072,Schöntal,30 - 35 Jahre,355,183,172
False,8126072,Schöntal,35 - 40 Jahre,512,257,255
False,8126072,Schöntal,40 - 45 Jahre,535,301,234
False,8126072,Schöntal,45 - 50 Jahre,445,234,211
False,8126072,Schöntal,50 - 55 Jahre,368,193,175
False,8126072,Schöntal,55 - 60 Jahre,301,165,136
False,8126072,Schöntal,60 - 65 Jahre,269,126,143
False,8126072,Schöntal,65 - 75 Jahre,678,338,340
False,8126072,Schöntal,75 und mehr Jahre,471,159,312
False,8126072,Schöntal,Insgesamt,5889,2996,2893
False,8126085,"Waldenburg, Stadt",unter 3 Jahre,53,34,19
False,8126085,"Waldenburg, Stadt",3 -  6 Jahre,86,50,36
False,8126085,"Waldenburg, Stadt",6 - 10 Jahre,135,60,75
False,8126085,"Waldenburg, Stadt",10 - 15 Jahre,199,91,108
False,8126085,"Waldenburg, Stadt",15 - 18 Jahre,108,55,53
False,8126085,"Waldenburg, Stadt",18 - 20 Jahre,124,57,67
False,8126085,"Waldenburg, Stadt",20 - 25 Jahre,354,139,215
False,8126085,"Waldenburg, Stadt",25 - 30 Jahre,215,108,107
False,8126085,"Waldenburg, Stadt",30 - 35 Jahre,143,67,76
False,8126085,"Waldenburg, Stadt",35 - 40 Jahre,285,124,161
False,8126085,"Waldenburg, Stadt",40 - 45 Jahre,265,137,128
False,8126085,"Waldenburg, Stadt",45 - 50 Jahre,188,91,97
False,8126085,"Waldenburg, Stadt",50 - 55 Jahre,192,108,84
False,8126085,"Waldenburg, Stadt",55 - 60 Jahre,135,73,62
False,8126085,"Waldenburg, Stadt",60 - 65 Jahre,168,88,80
False,8126085,"Waldenburg, Stadt",65 - 75 Jahre,246,121,125
False,8126085,"Waldenburg, Stadt",75 und mehr Jahre,187,61,126
False,8126085,"Waldenburg, Stadt",Insgesamt,3083,1464,1619
False,8126086,Weißbach,unter 3 Jahre,51,27,24
False,8126086,Weißbach,3 -  6 Jahre,65,38,27
False,8126086,Weißbach,6 - 10 Jahre,86,45,41
False,8126086,Weißbach,10 - 15 Jahre,143,71,72
False,8126086,Weißbach,15 - 18 Jahre,107,49,58
False,8126086,Weißbach,18 - 20 Jahre,57,26,31
False,8126086,Weißbach,20 - 25 Jahre,129,69,60
False,8126086,Weißbach,25 - 30 Jahre,143,78,65
False,8126086,Weißbach,30 - 35 Jahre,146,82,64
False,8126086,Weißbach,35 - 40 Jahre,166,88,78
False,8126086,Weißbach,40 - 45 Jahre,171,83,88
False,8126086,Weißbach,45 - 50 Jahre,166,84,82
False,8126086,Weißbach,50 - 55 Jahre,142,78,64
False,8126086,Weißbach,55 - 60 Jahre,113,53,60
False,8126086,Weißbach,60 - 65 Jahre,116,52,64
False,8126086,Weißbach,65 - 75 Jahre,213,107,106
False,8126086,Weißbach,75 und mehr Jahre,145,60,85
False,8126086,Weißbach,Insgesamt,2159,1090,1069
False,8126094,Zweiflingen,unter 3 Jahre,23,15,8
False,8126094,Zweiflingen,3 -  6 Jahre,60,31,29
False,8126094,Zweiflingen,6 - 10 Jahre,84,37,47
False,8126094,Zweiflingen,10 - 15 Jahre,107,59,48
False,8126094,Zweiflingen,15 - 18 Jahre,64,30,34
False,8126094,Zweiflingen,18 - 20 Jahre,46,26,20
False,8126094,Zweiflingen,20 - 25 Jahre,101,52,49
False,8126094,Zweiflingen,25 - 30 Jahre,103,44,59
False,8126094,Zweiflingen,30 - 35 Jahre,106,57,49
False,8126094,Zweiflingen,35 - 40 Jahre,138,80,58
False,8126094,Zweiflingen,40 - 45 Jahre,165,99,66
False,8126094,Zweiflingen,45 - 50 Jahre,120,67,53
False,8126094,Zweiflingen,50 - 55 Jahre,114,61,53
False,8126094,Zweiflingen,55 - 60 Jahre,91,52,39
False,8126094,Zweiflingen,60 - 65 Jahre,79,39,40
False,8126094,Zweiflingen,65 - 75 Jahre,159,87,72
False,8126094,Zweiflingen,75 und mehr Jahre,163,58,105
False,8126094,Zweiflingen,Insgesamt,1723,894,829
False,8127,Landkreis Schwäbisch Hall,unter 3 Jahre,5455,2822,2633
False,8127,Landkreis Schwäbisch Hall,3 -  6 Jahre,5918,3033,2885
False,8127,Landkreis Schwäbisch Hall,6 - 10 Jahre,8931,4610,4321
False,8127,Landkreis Schwäbisch Hall,10 - 15 Jahre,11950,6103,5847
False,8127,Landkreis Schwäbisch Hall,15 - 18 Jahre,7715,3990,3725
False,8127,Landkreis Schwäbisch Hall,18 - 20 Jahre,5004,2558,2446
False,8127,Landkreis Schwäbisch Hall,20 - 25 Jahre,11523,6086,5437
False,8127,Landkreis Schwäbisch Hall,25 - 30 Jahre,10736,5481,5255
False,8127,Landkreis Schwäbisch Hall,30 - 35 Jahre,11192,5599,5593
False,8127,Landkreis Schwäbisch Hall,35 - 40 Jahre,15086,7747,7339
False,8127,Landkreis Schwäbisch Hall,40 - 45 Jahre,16132,8241,7891
False,8127,Landkreis Schwäbisch Hall,45 - 50 Jahre,14781,7566,7215
False,8127,Landkreis Schwäbisch Hall,50 - 55 Jahre,12891,6465,6426
False,8127,Landkreis Schwäbisch Hall,55 - 60 Jahre,10523,5378,5145
False,8127,Landkreis Schwäbisch Hall,60 - 65 Jahre,8786,4355,4431
False,8127,Landkreis Schwäbisch Hall,65 - 75 Jahre,18113,8520,9593
False,8127,Landkreis Schwäbisch Hall,75 und mehr Jahre,14844,5154,9690
False,8127,Landkreis Schwäbisch Hall,Insgesamt,189580,93708,95872
False,8127008,Blaufelden,unter 3 Jahre,170,84,86
False,8127008,Blaufelden,3 -  6 Jahre,173,88,85
False,8127008,Blaufelden,6 - 10 Jahre,280,153,127
False,8127008,Blaufelden,10 - 15 Jahre,362,176,186
False,8127008,Blaufelden,15 - 18 Jahre,209,96,113
False,8127008,Blaufelden,18 - 20 Jahre,131,71,60
False,8127008,Blaufelden,20 - 25 Jahre,335,207,128
False,8127008,Blaufelden,25 - 30 Jahre,328,170,158
False,8127008,Blaufelden,30 - 35 Jahre,290,149,141
False,8127008,Blaufelden,35 - 40 Jahre,401,216,185
False,8127008,Blaufelden,40 - 45 Jahre,439,243,196
False,8127008,Blaufelden,45 - 50 Jahre,392,204,188
False,8127008,Blaufelden,50 - 55 Jahre,339,187,152
False,8127008,Blaufelden,55 - 60 Jahre,296,149,147
False,8127008,Blaufelden,60 - 65 Jahre,217,118,99
False,8127008,Blaufelden,65 - 75 Jahre,536,253,283
False,8127008,Blaufelden,75 und mehr Jahre,436,158,278
False,8127008,Blaufelden,Insgesamt,5334,2722,2612
False,8127009,Braunsbach,unter 3 Jahre,59,29,30
False,8127009,Braunsbach,3 -  6 Jahre,68,32,36
False,8127009,Braunsbach,6 - 10 Jahre,118,56,62
False,8127009,Braunsbach,10 - 15 Jahre,167,82,85
False,8127009,Braunsbach,15 - 18 Jahre,126,72,54
False,8127009,Braunsbach,18 - 20 Jahre,68,35,33
False,8127009,Braunsbach,20 - 25 Jahre,128,80,48
False,8127009,Braunsbach,25 - 30 Jahre,111,58,53
False,8127009,Braunsbach,30 - 35 Jahre,107,57,50
False,8127009,Braunsbach,35 - 40 Jahre,160,77,83
False,8127009,Braunsbach,40 - 45 Jahre,217,101,116
False,8127009,Braunsbach,45 - 50 Jahre,222,128,94
False,8127009,Braunsbach,50 - 55 Jahre,154,75,79
False,8127009,Braunsbach,55 - 60 Jahre,126,70,56
False,8127009,Braunsbach,60 - 65 Jahre,130,61,69
False,8127009,Braunsbach,65 - 75 Jahre,249,114,135
False,8127009,Braunsbach,75 und mehr Jahre,205,74,131
False,8127009,Braunsbach,Insgesamt,2415,1201,1214
False,8127012,Bühlertann,unter 3 Jahre,83,46,37
False,8127012,Bühlertann,3 -  6 Jahre,97,49,48
False,8127012,Bühlertann,6 - 10 Jahre,186,83,103
False,8127012,Bühlertann,10 - 15 Jahre,257,119,138
False,8127012,Bühlertann,15 - 18 Jahre,133,71,62
False,8127012,Bühlertann,18 - 20 Jahre,82,40,42
False,8127012,Bühlertann,20 - 25 Jahre,194,112,82
False,8127012,Bühlertann,25 - 30 Jahre,170,100,70
False,8127012,Bühlertann,30 - 35 Jahre,195,99,96
False,8127012,Bühlertann,35 - 40 Jahre,293,160,133
False,8127012,Bühlertann,40 - 45 Jahre,297,159,138
False,8127012,Bühlertann,45 - 50 Jahre,219,113,106
False,8127012,Bühlertann,50 - 55 Jahre,192,104,88
False,8127012,Bühlertann,55 - 60 Jahre,155,82,73
False,8127012,Bühlertann,60 - 65 Jahre,122,54,68
False,8127012,Bühlertann,65 - 75 Jahre,288,137,151
False,8127012,Bühlertann,75 und mehr Jahre,177,69,108
False,8127012,Bühlertann,Insgesamt,3140,1597,1543
False,8127013,Bühlerzell,unter 3 Jahre,65,36,29
False,8127013,Bühlerzell,3 -  6 Jahre,68,35,33
False,8127013,Bühlerzell,6 - 10 Jahre,107,51,56
False,8127013,Bühlerzell,10 - 15 Jahre,141,60,81
False,8127013,Bühlerzell,15 - 18 Jahre,69,42,27
False,8127013,Bühlerzell,18 - 20 Jahre,45,26,19
False,8127013,Bühlerzell,20 - 25 Jahre,121,69,52
False,8127013,Bühlerzell,25 - 30 Jahre,111,57,54
False,8127013,Bühlerzell,30 - 35 Jahre,118,52,66
False,8127013,Bühlerzell,35 - 40 Jahre,152,72,80
False,8127013,Bühlerzell,40 - 45 Jahre,186,87,99
False,8127013,Bühlerzell,45 - 50 Jahre,160,93,67
False,8127013,Bühlerzell,50 - 55 Jahre,128,70,58
False,8127013,Bühlerzell,55 - 60 Jahre,90,52,38
False,8127013,Bühlerzell,60 - 65 Jahre,95,40,55
False,8127013,Bühlerzell,65 - 75 Jahre,208,105,103
False,8127013,Bühlerzell,75 und mehr Jahre,174,44,130
False,8127013,Bühlerzell,Insgesamt,2038,991,1047
False,8127014,"Crailsheim, Stadt",unter 3 Jahre,938,487,451
False,8127014,"Crailsheim, Stadt",3 -  6 Jahre,953,484,469
False,8127014,"Crailsheim, Stadt",6 - 10 Jahre,1339,676,663
False,8127014,"Crailsheim, Stadt",10 - 15 Jahre,1798,889,909
False,8127014,"Crailsheim, Stadt",15 - 18 Jahre,1258,667,591
False,8127014,"Crailsheim, Stadt",18 - 20 Jahre,792,421,371
False,8127014,"Crailsheim, Stadt",20 - 25 Jahre,2069,1078,991
False,8127014,"Crailsheim, Stadt",25 - 30 Jahre,2088,1071,1017
False,8127014,"Crailsheim, Stadt",30 - 35 Jahre,1994,1038,956
False,8127014,"Crailsheim, Stadt",35 - 40 Jahre,2424,1317,1107
False,8127014,"Crailsheim, Stadt",40 - 45 Jahre,2584,1326,1258
False,8127014,"Crailsheim, Stadt",45 - 50 Jahre,2589,1337,1252
False,8127014,"Crailsheim, Stadt",50 - 55 Jahre,2256,1100,1156
False,8127014,"Crailsheim, Stadt",55 - 60 Jahre,1815,915,900
False,8127014,"Crailsheim, Stadt",60 - 65 Jahre,1621,768,853
False,8127014,"Crailsheim, Stadt",65 - 75 Jahre,3335,1551,1784
False,8127014,"Crailsheim, Stadt",75 und mehr Jahre,2721,908,1813
False,8127014,"Crailsheim, Stadt",Insgesamt,32574,16033,16541
False,8127023,Fichtenberg,unter 3 Jahre,66,36,30
False,8127023,Fichtenberg,3 -  6 Jahre,97,45,52
False,8127023,Fichtenberg,6 - 10 Jahre,137,75,62
False,8127023,Fichtenberg,10 - 15 Jahre,183,98,85
False,8127023,Fichtenberg,15 - 18 Jahre,131,72,59
False,8127023,Fichtenberg,18 - 20 Jahre,71,40,31
False,8127023,Fichtenberg,20 - 25 Jahre,154,96,58
False,8127023,Fichtenberg,25 - 30 Jahre,138,68,70
False,8127023,Fichtenberg,30 - 35 Jahre,167,76,91
False,8127023,Fichtenberg,35 - 40 Jahre,246,120,126
False,8127023,Fichtenberg,40 - 45 Jahre,239,123,116
False,8127023,Fichtenberg,45 - 50 Jahre,251,136,115
False,8127023,Fichtenberg,50 - 55 Jahre,198,97,101
False,8127023,Fichtenberg,55 - 60 Jahre,181,102,79
False,8127023,Fichtenberg,60 - 65 Jahre,140,69,71
False,8127023,Fichtenberg,65 - 75 Jahre,290,149,141
False,8127023,Fichtenberg,75 und mehr Jahre,212,64,148
False,8127023,Fichtenberg,Insgesamt,2901,1466,1435
False,8127025,"Gaildorf, Stadt",unter 3 Jahre,377,192,185
False,8127025,"Gaildorf, Stadt",3 -  6 Jahre,410,207,203
False,8127025,"Gaildorf, Stadt",6 - 10 Jahre,597,315,282
False,8127025,"Gaildorf, Stadt",10 - 15 Jahre,759,396,363
False,8127025,"Gaildorf, Stadt",15 - 18 Jahre,474,235,239
False,8127025,"Gaildorf, Stadt",18 - 20 Jahre,314,171,143
False,8127025,"Gaildorf, Stadt",20 - 25 Jahre,774,386,388
False,8127025,"Gaildorf, Stadt",25 - 30 Jahre,773,405,368
False,8127025,"Gaildorf, Stadt",30 - 35 Jahre,754,375,379
False,8127025,"Gaildorf, Stadt",35 - 40 Jahre,941,488,453
False,8127025,"Gaildorf, Stadt",40 - 45 Jahre,1024,532,492
False,8127025,"Gaildorf, Stadt",45 - 50 Jahre,981,481,500
False,8127025,"Gaildorf, Stadt",50 - 55 Jahre,866,439,427
False,8127025,"Gaildorf, Stadt",55 - 60 Jahre,695,343,352
False,8127025,"Gaildorf, Stadt",60 - 65 Jahre,598,306,292
False,8127025,"Gaildorf, Stadt",65 - 75 Jahre,1266,606,660
False,8127025,"Gaildorf, Stadt",75 und mehr Jahre,973,351,622
False,8127025,"Gaildorf, Stadt",Insgesamt,12576,6228,6348
False,8127032,"Gerabronn, Stadt",unter 3 Jahre,123,61,62
False,8127032,"Gerabronn, Stadt",3 -  6 Jahre,111,65,46
False,8127032,"Gerabronn, Stadt",6 - 10 Jahre,201,105,96
False,8127032,"Gerabronn, Stadt",10 - 15 Jahre,294,148,146
False,8127032,"Gerabronn, Stadt",15 - 18 Jahre,169,83,86
False,8127032,"Gerabronn, Stadt",18 - 20 Jahre,107,56,51
False,8127032,"Gerabronn, Stadt",20 - 25 Jahre,294,162,132
False,8127032,"Gerabronn, Stadt",25 - 30 Jahre,225,114,111
False,8127032,"Gerabronn, Stadt",30 - 35 Jahre,247,129,118
False,8127032,"Gerabronn, Stadt",35 - 40 Jahre,330,182,148
False,8127032,"Gerabronn, Stadt",40 - 45 Jahre,373,199,174
False,8127032,"Gerabronn, Stadt",45 - 50 Jahre,362,185,177
False,8127032,"Gerabronn, Stadt",50 - 55 Jahre,327,184,143
False,8127032,"Gerabronn, Stadt",55 - 60 Jahre,240,134,106
False,8127032,"Gerabronn, Stadt",60 - 65 Jahre,228,118,110
False,8127032,"Gerabronn, Stadt",65 - 75 Jahre,434,196,238
False,8127032,"Gerabronn, Stadt",75 und mehr Jahre,484,174,310
False,8127032,"Gerabronn, Stadt",Insgesamt,4549,2295,2254
False,8127043,"Ilshofen, Stadt",unter 3 Jahre,185,98,87
False,8127043,"Ilshofen, Stadt",3 -  6 Jahre,255,133,122
False,8127043,"Ilshofen, Stadt",6 - 10 Jahre,360,187,173
False,8127043,"Ilshofen, Stadt",10 - 15 Jahre,420,219,201
False,8127043,"Ilshofen, Stadt",15 - 18 Jahre,279,136,143
False,8127043,"Ilshofen, Stadt",18 - 20 Jahre,172,81,91
False,8127043,"Ilshofen, Stadt",20 - 25 Jahre,354,190,164
False,8127043,"Ilshofen, Stadt",25 - 30 Jahre,328,166,162
False,8127043,"Ilshofen, Stadt",30 - 35 Jahre,414,198,216
False,8127043,"Ilshofen, Stadt",35 - 40 Jahre,540,273,267
False,8127043,"Ilshofen, Stadt",40 - 45 Jahre,592,323,269
False,8127043,"Ilshofen, Stadt",45 - 50 Jahre,416,228,188
False,8127043,"Ilshofen, Stadt",50 - 55 Jahre,345,173,172
False,8127043,"Ilshofen, Stadt",55 - 60 Jahre,259,134,125
False,8127043,"Ilshofen, Stadt",60 - 65 Jahre,249,114,135
False,8127043,"Ilshofen, Stadt",65 - 75 Jahre,546,260,286
False,8127043,"Ilshofen, Stadt",75 und mehr Jahre,368,125,243
False,8127043,"Ilshofen, Stadt",Insgesamt,6082,3038,3044
False,8127046,"Kirchberg an der Jagst, Stadt",unter 3 Jahre,109,55,54
False,8127046,"Kirchberg an der Jagst, Stadt",3 -  6 Jahre,129,65,64
False,8127046,"Kirchberg an der Jagst, Stadt",6 - 10 Jahre,162,88,74
False,8127046,"Kirchberg an der Jagst, Stadt",10 - 15 Jahre,270,129,141
False,8127046,"Kirchberg an der Jagst, Stadt",15 - 18 Jahre,177,98,79
False,8127046,"Kirchberg an der Jagst, Stadt",18 - 20 Jahre,122,58,64
False,8127046,"Kirchberg an der Jagst, Stadt",20 - 25 Jahre,331,206,125
False,8127046,"Kirchberg an der Jagst, Stadt",25 - 30 Jahre,266,142,124
False,8127046,"Kirchberg an der Jagst, Stadt",30 - 35 Jahre,289,165,124
False,8127046,"Kirchberg an der Jagst, Stadt",35 - 40 Jahre,409,231,178
False,8127046,"Kirchberg an der Jagst, Stadt",40 - 45 Jahre,351,175,176
False,8127046,"Kirchberg an der Jagst, Stadt",45 - 50 Jahre,348,174,174
False,8127046,"Kirchberg an der Jagst, Stadt",50 - 55 Jahre,313,172,141
False,8127046,"Kirchberg an der Jagst, Stadt",55 - 60 Jahre,213,119,94
False,8127046,"Kirchberg an der Jagst, Stadt",60 - 65 Jahre,165,86,79
False,8127046,"Kirchberg an der Jagst, Stadt",65 - 75 Jahre,378,185,193
False,8127046,"Kirchberg an der Jagst, Stadt",75 und mehr Jahre,390,147,243
False,8127046,"Kirchberg an der Jagst, Stadt",Insgesamt,4422,2295,2127
False,8127047,"Langenburg, Stadt",unter 3 Jahre,48,27,21
False,8127047,"Langenburg, Stadt",3 -  6 Jahre,48,23,25
False,8127047,"Langenburg, Stadt",6 - 10 Jahre,84,47,37
False,8127047,"Langenburg, Stadt",10 - 15 Jahre,116,65,51
False,8127047,"Langenburg, Stadt",15 - 18 Jahre,75,41,34
False,8127047,"Langenburg, Stadt",18 - 20 Jahre,47,20,27
False,8127047,"Langenburg, Stadt",20 - 25 Jahre,88,41,47
False,8127047,"Langenburg, Stadt",25 - 30 Jahre,74,41,33
False,8127047,"Langenburg, Stadt",30 - 35 Jahre,93,48,45
False,8127047,"Langenburg, Stadt",35 - 40 Jahre,122,59,63
False,8127047,"Langenburg, Stadt",40 - 45 Jahre,150,59,91
False,8127047,"Langenburg, Stadt",45 - 50 Jahre,138,75,63
False,8127047,"Langenburg, Stadt",50 - 55 Jahre,112,60,52
False,8127047,"Langenburg, Stadt",55 - 60 Jahre,131,67,64
False,8127047,"Langenburg, Stadt",60 - 65 Jahre,83,44,39
False,8127047,"Langenburg, Stadt",65 - 75 Jahre,252,128,124
False,8127047,"Langenburg, Stadt",75 und mehr Jahre,172,66,106
False,8127047,"Langenburg, Stadt",Insgesamt,1833,911,922
False,8127052,Mainhardt,unter 3 Jahre,179,90,89
False,8127052,Mainhardt,3 -  6 Jahre,204,113,91
False,8127052,Mainhardt,6 - 10 Jahre,311,148,163
False,8127052,Mainhardt,10 - 15 Jahre,390,180,210
False,8127052,Mainhardt,15 - 18 Jahre,209,108,101
False,8127052,Mainhardt,18 - 20 Jahre,147,70,77
False,8127052,Mainhardt,20 - 25 Jahre,346,182,164
False,8127052,Mainhardt,25 - 30 Jahre,285,152,133
False,8127052,Mainhardt,30 - 35 Jahre,313,165,148
False,8127052,Mainhardt,35 - 40 Jahre,447,228,219
False,8127052,Mainhardt,40 - 45 Jahre,518,263,255
False,8127052,Mainhardt,45 - 50 Jahre,422,212,210
False,8127052,Mainhardt,50 - 55 Jahre,366,193,173
False,8127052,Mainhardt,55 - 60 Jahre,296,148,148
False,8127052,Mainhardt,60 - 65 Jahre,289,146,143
False,8127052,Mainhardt,65 - 75 Jahre,498,241,257
False,8127052,Mainhardt,75 und mehr Jahre,455,176,279
False,8127052,Mainhardt,Insgesamt,5675,2815,2860
False,8127056,Michelbach an der Bilz,unter 3 Jahre,82,49,33
False,8127056,Michelbach an der Bilz,3 -  6 Jahre,108,55,53
False,8127056,Michelbach an der Bilz,6 - 10 Jahre,146,82,64
False,8127056,Michelbach an der Bilz,10 - 15 Jahre,209,111,98
False,8127056,Michelbach an der Bilz,15 - 18 Jahre,151,79,72
False,8127056,Michelbach an der Bilz,18 - 20 Jahre,147,60,87
False,8127056,Michelbach an der Bilz,20 - 25 Jahre,206,115,91
False,8127056,Michelbach an der Bilz,25 - 30 Jahre,146,70,76
False,8127056,Michelbach an der Bilz,30 - 35 Jahre,174,80,94
False,8127056,Michelbach an der Bilz,35 - 40 Jahre,311,160,151
False,8127056,Michelbach an der Bilz,40 - 45 Jahre,295,138,157
False,8127056,Michelbach an der Bilz,45 - 50 Jahre,272,140,132
False,8127056,Michelbach an der Bilz,50 - 55 Jahre,260,111,149
False,8127056,Michelbach an der Bilz,55 - 60 Jahre,203,107,96
False,8127056,Michelbach an der Bilz,60 - 65 Jahre,197,110,87
False,8127056,Michelbach an der Bilz,65 - 75 Jahre,322,167,155
False,8127056,Michelbach an der Bilz,75 und mehr Jahre,242,91,151
False,8127056,Michelbach an der Bilz,Insgesamt,3471,1725,1746
False,8127059,Michelfeld,unter 3 Jahre,112,68,44
False,8127059,Michelfeld,3 -  6 Jahre,109,50,59
False,8127059,Michelfeld,6 - 10 Jahre,145,78,67
False,8127059,Michelfeld,10 - 15 Jahre,224,116,108
False,8127059,Michelfeld,15 - 18 Jahre,136,68,68
False,8127059,Michelfeld,18 - 20 Jahre,91,42,49
False,8127059,Michelfeld,20 - 25 Jahre,215,111,104
False,8127059,Michelfeld,25 - 30 Jahre,210,99,111
False,8127059,Michelfeld,30 - 35 Jahre,236,121,115
False,8127059,Michelfeld,35 - 40 Jahre,328,154,174
False,8127059,Michelfeld,40 - 45 Jahre,307,155,152
False,8127059,Michelfeld,45 - 50 Jahre,302,150,152
False,8127059,Michelfeld,50 - 55 Jahre,290,143,147
False,8127059,Michelfeld,55 - 60 Jahre,200,106,94
False,8127059,Michelfeld,60 - 65 Jahre,134,75,59
False,8127059,Michelfeld,65 - 75 Jahre,323,150,173
False,8127059,Michelfeld,75 und mehr Jahre,238,76,162
False,8127059,Michelfeld,Insgesamt,3600,1762,1838
False,8127062,Oberrot,unter 3 Jahre,113,59,54
False,8127062,Oberrot,3 -  6 Jahre,109,50,59
False,8127062,Oberrot,6 - 10 Jahre,178,88,90
False,8127062,Oberrot,10 - 15 Jahre,277,155,122
False,8127062,Oberrot,15 - 18 Jahre,172,95,77
False,8127062,Oberrot,18 - 20 Jahre,96,37,59
False,8127062,Oberrot,20 - 25 Jahre,220,106,114
False,8127062,Oberrot,25 - 30 Jahre,191,95,96
False,8127062,Oberrot,30 - 35 Jahre,208,112,96
False,8127062,Oberrot,35 - 40 Jahre,287,144,143
False,8127062,Oberrot,40 - 45 Jahre,332,173,159
False,8127062,Oberrot,45 - 50 Jahre,295,148,147
False,8127062,Oberrot,50 - 55 Jahre,264,137,127
False,8127062,Oberrot,55 - 60 Jahre,209,118,91
False,8127062,Oberrot,60 - 65 Jahre,153,77,76
False,8127062,Oberrot,65 - 75 Jahre,335,156,179
False,8127062,Oberrot,75 und mehr Jahre,309,111,198
False,8127062,Oberrot,Insgesamt,3748,1861,1887
False,8127063,Obersontheim,unter 3 Jahre,121,58,63
False,8127063,Obersontheim,3 -  6 Jahre,161,78,83
False,8127063,Obersontheim,6 - 10 Jahre,208,124,84
False,8127063,Obersontheim,10 - 15 Jahre,348,162,186
False,8127063,Obersontheim,15 - 18 Jahre,250,134,116
False,8127063,Obersontheim,18 - 20 Jahre,140,65,75
False,8127063,Obersontheim,20 - 25 Jahre,260,132,128
False,8127063,Obersontheim,25 - 30 Jahre,235,110,125
False,8127063,Obersontheim,30 - 35 Jahre,285,142,143
False,8127063,Obersontheim,35 - 40 Jahre,403,197,206
False,8127063,Obersontheim,40 - 45 Jahre,422,226,196
False,8127063,Obersontheim,45 - 50 Jahre,431,220,211
False,8127063,Obersontheim,50 - 55 Jahre,312,159,153
False,8127063,Obersontheim,55 - 60 Jahre,228,117,111
False,8127063,Obersontheim,60 - 65 Jahre,166,83,83
False,8127063,Obersontheim,65 - 75 Jahre,463,208,255
False,8127063,Obersontheim,75 und mehr Jahre,365,137,228
False,8127063,Obersontheim,Insgesamt,4798,2352,2446
False,8127071,Rot am See,unter 3 Jahre,171,94,77
False,8127071,Rot am See,3 -  6 Jahre,149,72,77
False,8127071,Rot am See,6 - 10 Jahre,252,124,128
False,8127071,Rot am See,10 - 15 Jahre,333,174,159
False,8127071,Rot am See,15 - 18 Jahre,234,109,125
False,8127071,Rot am See,18 - 20 Jahre,157,90,67
False,8127071,Rot am See,20 - 25 Jahre,303,154,149
False,8127071,Rot am See,25 - 30 Jahre,299,157,142
False,8127071,Rot am See,30 - 35 Jahre,280,140,140
False,8127071,Rot am See,35 - 40 Jahre,405,207,198
False,8127071,Rot am See,40 - 45 Jahre,420,219,201
False,8127071,Rot am See,45 - 50 Jahre,404,210,194
False,8127071,Rot am See,50 - 55 Jahre,344,178,166
False,8127071,Rot am See,55 - 60 Jahre,285,153,132
False,8127071,Rot am See,60 - 65 Jahre,225,111,114
False,8127071,Rot am See,65 - 75 Jahre,480,232,248
False,8127071,Rot am See,75 und mehr Jahre,431,164,267
False,8127071,Rot am See,Insgesamt,5172,2588,2584
False,8127073,Satteldorf,unter 3 Jahre,166,84,82
False,8127073,Satteldorf,3 -  6 Jahre,210,117,93
False,8127073,Satteldorf,6 - 10 Jahre,253,130,123
False,8127073,Satteldorf,10 - 15 Jahre,348,187,161
False,8127073,Satteldorf,15 - 18 Jahre,231,119,112
False,8127073,Satteldorf,18 - 20 Jahre,148,71,77
False,8127073,Satteldorf,20 - 25 Jahre,339,176,163
False,8127073,Satteldorf,25 - 30 Jahre,307,147,160
False,8127073,Satteldorf,30 - 35 Jahre,310,146,164
False,8127073,Satteldorf,35 - 40 Jahre,418,226,192
False,8127073,Satteldorf,40 - 45 Jahre,466,224,242
False,8127073,Satteldorf,45 - 50 Jahre,423,222,201
False,8127073,Satteldorf,50 - 55 Jahre,374,196,178
False,8127073,Satteldorf,55 - 60 Jahre,300,146,154
False,8127073,Satteldorf,60 - 65 Jahre,219,120,99
False,8127073,Satteldorf,65 - 75 Jahre,406,188,218
False,8127073,Satteldorf,75 und mehr Jahre,351,111,240
False,8127073,Satteldorf,Insgesamt,5269,2610,2659
False,8127075,"Schrozberg, Stadt",unter 3 Jahre,158,81,77
False,8127075,"Schrozberg, Stadt",3 -  6 Jahre,162,81,81
False,8127075,"Schrozberg, Stadt",6 - 10 Jahre,272,147,125
False,8127075,"Schrozberg, Stadt",10 - 15 Jahre,398,203,195
False,8127075,"Schrozberg, Stadt",15 - 18 Jahre,276,141,135
False,8127075,"Schrozberg, Stadt",18 - 20 Jahre,144,79,65
False,8127075,"Schrozberg, Stadt",20 - 25 Jahre,349,183,166
False,8127075,"Schrozberg, Stadt",25 - 30 Jahre,329,181,148
False,8127075,"Schrozberg, Stadt",30 - 35 Jahre,317,173,144
False,8127075,"Schrozberg, Stadt",35 - 40 Jahre,424,217,207
False,8127075,"Schrozberg, Stadt",40 - 45 Jahre,484,237,247
False,8127075,"Schrozberg, Stadt",45 - 50 Jahre,430,232,198
False,8127075,"Schrozberg, Stadt",50 - 55 Jahre,396,207,189
False,8127075,"Schrozberg, Stadt",55 - 60 Jahre,361,185,176
False,8127075,"Schrozberg, Stadt",60 - 65 Jahre,290,149,141
False,8127075,"Schrozberg, Stadt",65 - 75 Jahre,678,318,360
False,8127075,"Schrozberg, Stadt",75 und mehr Jahre,583,211,372
False,8127075,"Schrozberg, Stadt",Insgesamt,6051,3025,3026
False,8127076,"Schwäbisch Hall, Stadt",unter 3 Jahre,1001,525,476
False,8127076,"Schwäbisch Hall, Stadt",3 -  6 Jahre,1029,545,484
False,8127076,"Schwäbisch Hall, Stadt",6 - 10 Jahre,1653,838,815
False,8127076,"Schwäbisch Hall, Stadt",10 - 15 Jahre,2002,1034,968
False,8127076,"Schwäbisch Hall, Stadt",15 - 18 Jahre,1332,676,656
False,8127076,"Schwäbisch Hall, Stadt",18 - 20 Jahre,962,471,491
False,8127076,"Schwäbisch Hall, Stadt",20 - 25 Jahre,2272,1144,1128
False,8127076,"Schwäbisch Hall, Stadt",25 - 30 Jahre,2089,1020,1069
False,8127076,"Schwäbisch Hall, Stadt",30 - 35 Jahre,2247,1074,1173
False,8127076,"Schwäbisch Hall, Stadt",35 - 40 Jahre,3090,1529,1561
False,8127076,"Schwäbisch Hall, Stadt",40 - 45 Jahre,3059,1536,1523
False,8127076,"Schwäbisch Hall, Stadt",45 - 50 Jahre,2765,1345,1420
False,8127076,"Schwäbisch Hall, Stadt",50 - 55 Jahre,2510,1166,1344
False,8127076,"Schwäbisch Hall, Stadt",55 - 60 Jahre,2205,1067,1138
False,8127076,"Schwäbisch Hall, Stadt",60 - 65 Jahre,1902,919,983
False,8127076,"Schwäbisch Hall, Stadt",65 - 75 Jahre,3558,1600,1958
False,8127076,"Schwäbisch Hall, Stadt",75 und mehr Jahre,3035,988,2047
False,8127076,"Schwäbisch Hall, Stadt",Insgesamt,36711,17477,19234
False,8127079,Sulzbach-Laufen,unter 3 Jahre,79,38,41
False,8127079,Sulzbach-Laufen,3 -  6 Jahre,92,54,38
False,8127079,Sulzbach-Laufen,6 - 10 Jahre,125,66,59
False,8127079,Sulzbach-Laufen,10 - 15 Jahre,166,89,77
False,8127079,Sulzbach-Laufen,15 - 18 Jahre,103,55,48
False,8127079,Sulzbach-Laufen,18 - 20 Jahre,78,44,34
False,8127079,Sulzbach-Laufen,20 - 25 Jahre,138,77,61
False,8127079,Sulzbach-Laufen,25 - 30 Jahre,154,82,72
False,8127079,Sulzbach-Laufen,30 - 35 Jahre,136,71,65
False,8127079,Sulzbach-Laufen,35 - 40 Jahre,196,105,91
False,8127079,Sulzbach-Laufen,40 - 45 Jahre,228,119,109
False,8127079,Sulzbach-Laufen,45 - 50 Jahre,210,102,108
False,8127079,Sulzbach-Laufen,50 - 55 Jahre,158,85,73
False,8127079,Sulzbach-Laufen,55 - 60 Jahre,140,72,68
False,8127079,Sulzbach-Laufen,60 - 65 Jahre,117,62,55
False,8127079,Sulzbach-Laufen,65 - 75 Jahre,263,127,136
False,8127079,Sulzbach-Laufen,75 und mehr Jahre,179,71,108
False,8127079,Sulzbach-Laufen,Insgesamt,2562,1319,1243
False,8127086,Untermünkheim,unter 3 Jahre,86,42,44
False,8127086,Untermünkheim,3 -  6 Jahre,115,57,58
False,8127086,Untermünkheim,6 - 10 Jahre,151,84,67
False,8127086,Untermünkheim,10 - 15 Jahre,222,123,99
False,8127086,Untermünkheim,15 - 18 Jahre,130,65,65
False,8127086,Untermünkheim,18 - 20 Jahre,81,46,35
False,8127086,Untermünkheim,20 - 25 Jahre,172,93,79
False,8127086,Untermünkheim,25 - 30 Jahre,158,78,80
False,8127086,Untermünkheim,30 - 35 Jahre,169,73,96
False,8127086,Untermünkheim,35 - 40 Jahre,252,133,119
False,8127086,Untermünkheim,40 - 45 Jahre,265,140,125
False,8127086,Untermünkheim,45 - 50 Jahre,247,122,125
False,8127086,Untermünkheim,50 - 55 Jahre,199,102,97
False,8127086,Untermünkheim,55 - 60 Jahre,196,106,90
False,8127086,Untermünkheim,60 - 65 Jahre,131,63,68
False,8127086,Untermünkheim,65 - 75 Jahre,264,133,131
False,8127086,Untermünkheim,75 und mehr Jahre,186,71,115
False,8127086,Untermünkheim,Insgesamt,3024,1531,1493
False,8127089,"Vellberg, Stadt",unter 3 Jahre,132,71,61
False,8127089,"Vellberg, Stadt",3 -  6 Jahre,142,80,62
False,8127089,"Vellberg, Stadt",6 - 10 Jahre,224,116,108
False,8127089,"Vellberg, Stadt",10 - 15 Jahre,285,139,146
False,8127089,"Vellberg, Stadt",15 - 18 Jahre,177,93,84
False,8127089,"Vellberg, Stadt",18 - 20 Jahre,113,60,53
False,8127089,"Vellberg, Stadt",20 - 25 Jahre,233,125,108
False,8127089,"Vellberg, Stadt",25 - 30 Jahre,214,126,88
False,8127089,"Vellberg, Stadt",30 - 35 Jahre,237,118,119
False,8127089,"Vellberg, Stadt",35 - 40 Jahre,331,152,179
False,8127089,"Vellberg, Stadt",40 - 45 Jahre,378,209,169
False,8127089,"Vellberg, Stadt",45 - 50 Jahre,359,173,186
False,8127089,"Vellberg, Stadt",50 - 55 Jahre,329,188,141
False,8127089,"Vellberg, Stadt",55 - 60 Jahre,273,119,154
False,8127089,"Vellberg, Stadt",60 - 65 Jahre,204,102,102
False,8127089,"Vellberg, Stadt",65 - 75 Jahre,354,185,169
False,8127089,"Vellberg, Stadt",75 und mehr Jahre,348,132,216
False,8127089,"Vellberg, Stadt",Insgesamt,4333,2188,2145
False,8127091,Wallhausen,unter 3 Jahre,119,60,59
False,8127091,Wallhausen,3 -  6 Jahre,133,64,69
False,8127091,Wallhausen,6 - 10 Jahre,231,120,111
False,8127091,Wallhausen,10 - 15 Jahre,255,135,120
False,8127091,Wallhausen,15 - 18 Jahre,155,79,76
False,8127091,Wallhausen,18 - 20 Jahre,104,57,47
False,8127091,Wallhausen,20 - 25 Jahre,225,119,106
False,8127091,Wallhausen,25 - 30 Jahre,194,96,98
False,8127091,Wallhausen,30 - 35 Jahre,241,118,123
False,8127091,Wallhausen,35 - 40 Jahre,301,150,151
False,8127091,Wallhausen,40 - 45 Jahre,358,164,194
False,8127091,Wallhausen,45 - 50 Jahre,300,164,136
False,8127091,Wallhausen,50 - 55 Jahre,230,132,98
False,8127091,Wallhausen,55 - 60 Jahre,147,76,71
False,8127091,Wallhausen,60 - 65 Jahre,129,57,72
False,8127091,Wallhausen,65 - 75 Jahre,287,149,138
False,8127091,Wallhausen,75 und mehr Jahre,193,70,123
False,8127091,Wallhausen,Insgesamt,3602,1810,1792
False,8127099,Wolpertshausen,unter 3 Jahre,68,27,41
False,8127099,Wolpertshausen,3 -  6 Jahre,76,36,40
False,8127099,Wolpertshausen,6 - 10 Jahre,125,60,65
False,8127099,Wolpertshausen,10 - 15 Jahre,170,93,77
False,8127099,Wolpertshausen,15 - 18 Jahre,95,50,45
False,8127099,Wolpertshausen,18 - 20 Jahre,70,40,30
False,8127099,Wolpertshausen,20 - 25 Jahre,124,67,57
False,8127099,Wolpertshausen,25 - 30 Jahre,109,65,44
False,8127099,Wolpertshausen,30 - 35 Jahre,118,61,57
False,8127099,Wolpertshausen,35 - 40 Jahre,185,100,85
False,8127099,Wolpertshausen,40 - 45 Jahre,181,86,95
False,8127099,Wolpertshausen,45 - 50 Jahre,155,83,72
False,8127099,Wolpertshausen,50 - 55 Jahre,127,67,60
False,8127099,Wolpertshausen,55 - 60 Jahre,97,48,49
False,8127099,Wolpertshausen,60 - 65 Jahre,56,33,23
False,8127099,Wolpertshausen,65 - 75 Jahre,134,63,71
False,8127099,Wolpertshausen,75 und mehr Jahre,119,45,74
False,8127099,Wolpertshausen,Insgesamt,2009,1024,985
False,8127100,Rosengarten,unter 3 Jahre,154,69,85
False,8127100,Rosengarten,3 -  6 Jahre,199,103,96
False,8127100,Rosengarten,6 - 10 Jahre,260,138,122
False,8127100,Rosengarten,10 - 15 Jahre,364,196,168
False,8127100,Rosengarten,15 - 18 Jahre,256,129,127
False,8127100,Rosengarten,18 - 20 Jahre,126,74,52
False,8127100,Rosengarten,20 - 25 Jahre,261,132,129
False,8127100,Rosengarten,25 - 30 Jahre,298,134,164
False,8127100,Rosengarten,30 - 35 Jahre,270,119,151
False,8127100,Rosengarten,35 - 40 Jahre,428,208,220
False,8127100,Rosengarten,40 - 45 Jahre,530,265,265
False,8127100,Rosengarten,45 - 50 Jahre,406,217,189
False,8127100,Rosengarten,50 - 55 Jahre,344,164,180
False,8127100,Rosengarten,55 - 60 Jahre,274,146,128
False,8127100,Rosengarten,60 - 65 Jahre,256,125,131
False,8127100,Rosengarten,65 - 75 Jahre,447,217,230
False,8127100,Rosengarten,75 und mehr Jahre,375,119,256
False,8127100,Rosengarten,Insgesamt,5248,2555,2693
False,8127101,Kreßberg,unter 3 Jahre,119,57,62
False,8127101,Kreßberg,3 -  6 Jahre,120,54,66
False,8127101,Kreßberg,6 - 10 Jahre,197,94,103
False,8127101,Kreßberg,10 - 15 Jahre,288,141,147
False,8127101,Kreßberg,15 - 18 Jahre,179,90,89
False,8127101,Kreßberg,18 - 20 Jahre,126,77,49
False,8127101,Kreßberg,20 - 25 Jahre,216,116,100
False,8127101,Kreßberg,25 - 30 Jahre,185,97,88
False,8127101,Kreßberg,30 - 35 Jahre,228,114,114
False,8127101,Kreßberg,35 - 40 Jahre,327,158,169
False,8127101,Kreßberg,40 - 45 Jahre,353,181,172
False,8127101,Kreßberg,45 - 50 Jahre,306,164,142
False,8127101,Kreßberg,50 - 55 Jahre,271,134,137
False,8127101,Kreßberg,55 - 60 Jahre,244,134,110
False,8127101,Kreßberg,60 - 65 Jahre,164,84,80
False,8127101,Kreßberg,65 - 75 Jahre,381,187,194
False,8127101,Kreßberg,75 und mehr Jahre,273,104,169
False,8127101,Kreßberg,Insgesamt,3977,1986,1991
False,8127102,Fichtenau,unter 3 Jahre,134,60,74
False,8127102,Fichtenau,3 -  6 Jahre,130,63,67
False,8127102,Fichtenau,6 - 10 Jahre,234,120,114
False,8127102,Fichtenau,10 - 15 Jahre,341,194,147
False,8127102,Fichtenau,15 - 18 Jahre,182,94,88
False,8127102,Fichtenau,18 - 20 Jahre,110,54,56
False,8127102,Fichtenau,20 - 25 Jahre,286,154,132
False,8127102,Fichtenau,25 - 30 Jahre,274,142,132
False,8127102,Fichtenau,30 - 35 Jahre,289,142,147
False,8127102,Fichtenau,35 - 40 Jahre,373,190,183
False,8127102,Fichtenau,40 - 45 Jahre,404,233,171
False,8127102,Fichtenau,45 - 50 Jahre,347,172,175
False,8127102,Fichtenau,50 - 55 Jahre,302,152,150
False,8127102,Fichtenau,55 - 60 Jahre,246,128,118
False,8127102,Fichtenau,60 - 65 Jahre,196,100,96
False,8127102,Fichtenau,65 - 75 Jahre,426,192,234
False,8127102,Fichtenau,75 und mehr Jahre,307,104,203
False,8127102,Fichtenau,Insgesamt,4581,2294,2287
False,8127103,Frankenhardt,unter 3 Jahre,155,87,68
False,8127103,Frankenhardt,3 -  6 Jahre,170,93,77
False,8127103,Frankenhardt,6 - 10 Jahre,245,144,101
False,8127103,Frankenhardt,10 - 15 Jahre,373,181,192
False,8127103,Frankenhardt,15 - 18 Jahre,205,118,87
False,8127103,Frankenhardt,18 - 20 Jahre,124,60,64
False,8127103,Frankenhardt,20 - 25 Jahre,279,159,120
False,8127103,Frankenhardt,25 - 30 Jahre,262,138,124
False,8127103,Frankenhardt,30 - 35 Jahre,278,149,129
False,8127103,Frankenhardt,35 - 40 Jahre,341,176,165
False,8127103,Frankenhardt,40 - 45 Jahre,413,210,203
False,8127103,Frankenhardt,45 - 50 Jahre,379,206,173
False,8127103,Frankenhardt,50 - 55 Jahre,363,181,182
False,8127103,Frankenhardt,55 - 60 Jahre,237,135,102
False,8127103,Frankenhardt,60 - 65 Jahre,191,95,96
False,8127103,Frankenhardt,65 - 75 Jahre,443,203,240
False,8127103,Frankenhardt,75 und mehr Jahre,339,122,217
False,8127103,Frankenhardt,Insgesamt,4797,2457,2340
False,8127104,Stimpfach,unter 3 Jahre,83,52,31
False,8127104,Stimpfach,3 -  6 Jahre,91,42,49
False,8127104,Stimpfach,6 - 10 Jahre,150,73,77
False,8127104,Stimpfach,10 - 15 Jahre,190,109,81
False,8127104,Stimpfach,15 - 18 Jahre,142,75,67
False,8127104,Stimpfach,18 - 20 Jahre,89,42,47
False,8127104,Stimpfach,20 - 25 Jahre,237,114,123
False,8127104,Stimpfach,25 - 30 Jahre,185,100,85
False,8127104,Stimpfach,30 - 35 Jahre,188,95,93
False,8127104,Stimpfach,35 - 40 Jahre,221,118,103
False,8127104,Stimpfach,40 - 45 Jahre,267,136,131
False,8127104,Stimpfach,45 - 50 Jahre,250,130,120
False,8127104,Stimpfach,50 - 55 Jahre,222,109,113
False,8127104,Stimpfach,55 - 60 Jahre,181,100,81
False,8127104,Stimpfach,60 - 65 Jahre,119,66,53
False,8127104,Stimpfach,65 - 75 Jahre,269,120,149
False,8127104,Stimpfach,75 und mehr Jahre,204,71,133
False,8127104,Stimpfach,Insgesamt,3088,1552,1536
False,8128,Landkreis Main-Tauber-Kreis,unter 3 Jahre,3648,1877,1771
False,8128,Landkreis Main-Tauber-Kreis,3 -  6 Jahre,3910,1998,1912
False,8128,Landkreis Main-Tauber-Kreis,6 - 10 Jahre,5821,2997,2824
False,8128,Landkreis Main-Tauber-Kreis,10 - 15 Jahre,7904,4130,3774
False,8128,Landkreis Main-Tauber-Kreis,15 - 18 Jahre,5294,2671,2623
False,8128,Landkreis Main-Tauber-Kreis,18 - 20 Jahre,3463,1773,1690
False,8128,Landkreis Main-Tauber-Kreis,20 - 25 Jahre,7901,4177,3724
False,8128,Landkreis Main-Tauber-Kreis,25 - 30 Jahre,7524,3826,3698
False,8128,Landkreis Main-Tauber-Kreis,30 - 35 Jahre,7914,3966,3948
False,8128,Landkreis Main-Tauber-Kreis,35 - 40 Jahre,10596,5539,5057
False,8128,Landkreis Main-Tauber-Kreis,40 - 45 Jahre,11554,5944,5610
False,8128,Landkreis Main-Tauber-Kreis,45 - 50 Jahre,10559,5355,5204
False,8128,Landkreis Main-Tauber-Kreis,50 - 55 Jahre,9417,4701,4716
False,8128,Landkreis Main-Tauber-Kreis,55 - 60 Jahre,8010,4051,3959
False,8128,Landkreis Main-Tauber-Kreis,60 - 65 Jahre,6661,3312,3349
False,8128,Landkreis Main-Tauber-Kreis,65 - 75 Jahre,14499,6959,7540
False,8128,Landkreis Main-Tauber-Kreis,75 und mehr Jahre,12584,4383,8201
False,8128,Landkreis Main-Tauber-Kreis,Insgesamt,137259,67659,69600
False,8128006,Assamstadt,unter 3 Jahre,59,31,28
False,8128006,Assamstadt,3 -  6 Jahre,74,35,39
False,8128006,Assamstadt,6 - 10 Jahre,118,55,63
False,8128006,Assamstadt,10 - 15 Jahre,156,92,64
False,8128006,Assamstadt,15 - 18 Jahre,89,50,39
False,8128006,Assamstadt,18 - 20 Jahre,55,20,35
False,8128006,Assamstadt,20 - 25 Jahre,149,80,69
False,8128006,Assamstadt,25 - 30 Jahre,129,62,67
False,8128006,Assamstadt,30 - 35 Jahre,137,67,70
False,8128006,Assamstadt,35 - 40 Jahre,150,80,70
False,8128006,Assamstadt,40 - 45 Jahre,185,84,101
False,8128006,Assamstadt,45 - 50 Jahre,176,98,78
False,8128006,Assamstadt,50 - 55 Jahre,127,69,58
False,8128006,Assamstadt,55 - 60 Jahre,105,53,52
False,8128006,Assamstadt,60 - 65 Jahre,74,36,38
False,8128006,Assamstadt,65 - 75 Jahre,163,81,82
False,8128006,Assamstadt,75 und mehr Jahre,146,53,93
False,8128006,Assamstadt,Insgesamt,2092,1046,1046
False,8128007,"Bad Mergentheim, Stadt",unter 3 Jahre,608,309,299
False,8128007,"Bad Mergentheim, Stadt",3 -  6 Jahre,610,307,303
False,8128007,"Bad Mergentheim, Stadt",6 - 10 Jahre,860,427,433
False,8128007,"Bad Mergentheim, Stadt",10 - 15 Jahre,1127,564,563
False,8128007,"Bad Mergentheim, Stadt",15 - 18 Jahre,804,407,397
False,8128007,"Bad Mergentheim, Stadt",18 - 20 Jahre,609,287,322
False,8128007,"Bad Mergentheim, Stadt",20 - 25 Jahre,1285,663,622
False,8128007,"Bad Mergentheim, Stadt",25 - 30 Jahre,1247,646,601
False,8128007,"Bad Mergentheim, Stadt",30 - 35 Jahre,1305,647,658
False,8128007,"Bad Mergentheim, Stadt",35 - 40 Jahre,1633,828,805
False,8128007,"Bad Mergentheim, Stadt",40 - 45 Jahre,1694,844,850
False,8128007,"Bad Mergentheim, Stadt",45 - 50 Jahre,1597,716,881
False,8128007,"Bad Mergentheim, Stadt",50 - 55 Jahre,1591,756,835
False,8128007,"Bad Mergentheim, Stadt",55 - 60 Jahre,1340,620,720
False,8128007,"Bad Mergentheim, Stadt",60 - 65 Jahre,1188,563,625
False,8128007,"Bad Mergentheim, Stadt",65 - 75 Jahre,2444,1104,1340
False,8128007,"Bad Mergentheim, Stadt",75 und mehr Jahre,2544,835,1709
False,8128007,"Bad Mergentheim, Stadt",Insgesamt,22486,10523,11963
False,8128014,"Boxberg, Stadt",unter 3 Jahre,189,97,92
False,8128014,"Boxberg, Stadt",3 -  6 Jahre,235,127,108
False,8128014,"Boxberg, Stadt",6 - 10 Jahre,302,156,146
False,8128014,"Boxberg, Stadt",10 - 15 Jahre,425,215,210
False,8128014,"Boxberg, Stadt",15 - 18 Jahre,310,150,160
False,8128014,"Boxberg, Stadt",18 - 20 Jahre,196,112,84
False,8128014,"Boxberg, Stadt",20 - 25 Jahre,421,223,198
False,8128014,"Boxberg, Stadt",25 - 30 Jahre,393,192,201
False,8128014,"Boxberg, Stadt",30 - 35 Jahre,425,209,216
False,8128014,"Boxberg, Stadt",35 - 40 Jahre,578,299,279
False,8128014,"Boxberg, Stadt",40 - 45 Jahre,609,308,301
False,8128014,"Boxberg, Stadt",45 - 50 Jahre,566,302,264
False,8128014,"Boxberg, Stadt",50 - 55 Jahre,532,249,283
False,8128014,"Boxberg, Stadt",55 - 60 Jahre,418,222,196
False,8128014,"Boxberg, Stadt",60 - 65 Jahre,317,169,148
False,8128014,"Boxberg, Stadt",65 - 75 Jahre,708,353,355
False,8128014,"Boxberg, Stadt",75 und mehr Jahre,625,212,413
False,8128014,"Boxberg, Stadt",Insgesamt,7249,3595,3654
False,8128020,"Creglingen, Stadt",unter 3 Jahre,137,66,71
False,8128020,"Creglingen, Stadt",3 -  6 Jahre,142,76,66
False,8128020,"Creglingen, Stadt",6 - 10 Jahre,256,137,119
False,8128020,"Creglingen, Stadt",10 - 15 Jahre,322,175,147
False,8128020,"Creglingen, Stadt",15 - 18 Jahre,180,87,93
False,8128020,"Creglingen, Stadt",18 - 20 Jahre,113,63,50
False,8128020,"Creglingen, Stadt",20 - 25 Jahre,241,136,105
False,8128020,"Creglingen, Stadt",25 - 30 Jahre,245,131,114
False,8128020,"Creglingen, Stadt",30 - 35 Jahre,274,130,144
False,8128020,"Creglingen, Stadt",35 - 40 Jahre,357,212,145
False,8128020,"Creglingen, Stadt",40 - 45 Jahre,353,184,169
False,8128020,"Creglingen, Stadt",45 - 50 Jahre,346,168,178
False,8128020,"Creglingen, Stadt",50 - 55 Jahre,299,163,136
False,8128020,"Creglingen, Stadt",55 - 60 Jahre,278,154,124
False,8128020,"Creglingen, Stadt",60 - 65 Jahre,216,99,117
False,8128020,"Creglingen, Stadt",65 - 75 Jahre,621,304,317
False,8128020,"Creglingen, Stadt",75 und mehr Jahre,477,174,303
False,8128020,"Creglingen, Stadt",Insgesamt,4857,2459,2398
False,8128039,"Freudenberg, Stadt",unter 3 Jahre,103,51,52
False,8128039,"Freudenberg, Stadt",3 -  6 Jahre,104,62,42
False,8128039,"Freudenberg, Stadt",6 - 10 Jahre,183,99,84
False,8128039,"Freudenberg, Stadt",10 - 15 Jahre,214,99,115
False,8128039,"Freudenberg, Stadt",15 - 18 Jahre,141,73,68
False,8128039,"Freudenberg, Stadt",18 - 20 Jahre,75,35,40
False,8128039,"Freudenberg, Stadt",20 - 25 Jahre,240,122,118
False,8128039,"Freudenberg, Stadt",25 - 30 Jahre,219,119,100
False,8128039,"Freudenberg, Stadt",30 - 35 Jahre,226,109,117
False,8128039,"Freudenberg, Stadt",35 - 40 Jahre,300,164,136
False,8128039,"Freudenberg, Stadt",40 - 45 Jahre,320,165,155
False,8128039,"Freudenberg, Stadt",45 - 50 Jahre,280,146,134
False,8128039,"Freudenberg, Stadt",50 - 55 Jahre,298,150,148
False,8128039,"Freudenberg, Stadt",55 - 60 Jahre,218,122,96
False,8128039,"Freudenberg, Stadt",60 - 65 Jahre,185,85,100
False,8128039,"Freudenberg, Stadt",65 - 75 Jahre,492,242,250
False,8128039,"Freudenberg, Stadt",75 und mehr Jahre,432,159,273
False,8128039,"Freudenberg, Stadt",Insgesamt,4030,2002,2028
False,8128045,Großrinderfeld,unter 3 Jahre,111,51,60
False,8128045,Großrinderfeld,3 -  6 Jahre,121,64,57
False,8128045,Großrinderfeld,6 - 10 Jahre,187,106,81
False,8128045,Großrinderfeld,10 - 15 Jahre,268,145,123
False,8128045,Großrinderfeld,15 - 18 Jahre,170,89,81
False,8128045,Großrinderfeld,18 - 20 Jahre,114,56,58
False,8128045,Großrinderfeld,20 - 25 Jahre,232,107,125
False,8128045,Großrinderfeld,25 - 30 Jahre,269,126,143
False,8128045,Großrinderfeld,30 - 35 Jahre,263,142,121
False,8128045,Großrinderfeld,35 - 40 Jahre,384,202,182
False,8128045,Großrinderfeld,40 - 45 Jahre,382,195,187
False,8128045,Großrinderfeld,45 - 50 Jahre,349,179,170
False,8128045,Großrinderfeld,50 - 55 Jahre,295,155,140
False,8128045,Großrinderfeld,55 - 60 Jahre,255,136,119
False,8128045,Großrinderfeld,60 - 65 Jahre,138,61,77
False,8128045,Großrinderfeld,65 - 75 Jahre,353,174,179
False,8128045,Großrinderfeld,75 und mehr Jahre,257,90,167
False,8128045,Großrinderfeld,Insgesamt,4148,2078,2070
False,8128047,"Grünsfeld, Stadt",unter 3 Jahre,96,48,48
False,8128047,"Grünsfeld, Stadt",3 -  6 Jahre,120,63,57
False,8128047,"Grünsfeld, Stadt",6 - 10 Jahre,173,91,82
False,8128047,"Grünsfeld, Stadt",10 - 15 Jahre,252,134,118
False,8128047,"Grünsfeld, Stadt",15 - 18 Jahre,141,82,59
False,8128047,"Grünsfeld, Stadt",18 - 20 Jahre,81,45,36
False,8128047,"Grünsfeld, Stadt",20 - 25 Jahre,208,118,90
False,8128047,"Grünsfeld, Stadt",25 - 30 Jahre,183,92,91
False,8128047,"Grünsfeld, Stadt",30 - 35 Jahre,234,115,119
False,8128047,"Grünsfeld, Stadt",35 - 40 Jahre,305,142,163
False,8128047,"Grünsfeld, Stadt",40 - 45 Jahre,399,220,179
False,8128047,"Grünsfeld, Stadt",45 - 50 Jahre,315,174,141
False,8128047,"Grünsfeld, Stadt",50 - 55 Jahre,246,129,117
False,8128047,"Grünsfeld, Stadt",55 - 60 Jahre,201,98,103
False,8128047,"Grünsfeld, Stadt",60 - 65 Jahre,159,85,74
False,8128047,"Grünsfeld, Stadt",65 - 75 Jahre,414,191,223
False,8128047,"Grünsfeld, Stadt",75 und mehr Jahre,320,125,195
False,8128047,"Grünsfeld, Stadt",Insgesamt,3847,1952,1895
False,8128058,Igersheim,unter 3 Jahre,159,90,69
False,8128058,Igersheim,3 -  6 Jahre,188,93,95
False,8128058,Igersheim,6 - 10 Jahre,242,130,112
False,8128058,Igersheim,10 - 15 Jahre,315,155,160
False,8128058,Igersheim,15 - 18 Jahre,215,109,106
False,8128058,Igersheim,18 - 20 Jahre,159,73,86
False,8128058,Igersheim,20 - 25 Jahre,363,182,181
False,8128058,Igersheim,25 - 30 Jahre,376,203,173
False,8128058,Igersheim,30 - 35 Jahre,349,173,176
False,8128058,Igersheim,35 - 40 Jahre,428,235,193
False,8128058,Igersheim,40 - 45 Jahre,468,223,245
False,8128058,Igersheim,45 - 50 Jahre,429,196,233
False,8128058,Igersheim,50 - 55 Jahre,442,218,224
False,8128058,Igersheim,55 - 60 Jahre,323,169,154
False,8128058,Igersheim,60 - 65 Jahre,267,141,126
False,8128058,Igersheim,65 - 75 Jahre,561,283,278
False,8128058,Igersheim,75 und mehr Jahre,425,161,264
False,8128058,Igersheim,Insgesamt,5709,2834,2875
False,8128061,Königheim,unter 3 Jahre,95,50,45
False,8128061,Königheim,3 -  6 Jahre,69,29,40
False,8128061,Königheim,6 - 10 Jahre,142,80,62
False,8128061,Königheim,10 - 15 Jahre,205,101,104
False,8128061,Königheim,15 - 18 Jahre,138,67,71
False,8128061,Königheim,18 - 20 Jahre,73,42,31
False,8128061,Königheim,20 - 25 Jahre,166,83,83
False,8128061,Königheim,25 - 30 Jahre,162,87,75
False,8128061,Königheim,30 - 35 Jahre,185,92,93
False,8128061,Königheim,35 - 40 Jahre,256,135,121
False,8128061,Königheim,40 - 45 Jahre,284,161,123
False,8128061,Königheim,45 - 50 Jahre,254,136,118
False,8128061,Königheim,50 - 55 Jahre,199,112,87
False,8128061,Königheim,55 - 60 Jahre,204,97,107
False,8128061,Königheim,60 - 65 Jahre,171,95,76
False,8128061,Königheim,65 - 75 Jahre,360,173,187
False,8128061,Königheim,75 und mehr Jahre,327,116,211
False,8128061,Königheim,Insgesamt,3290,1656,1634
False,8128064,"Külsheim, Stadt",unter 3 Jahre,146,86,60
False,8128064,"Külsheim, Stadt",3 -  6 Jahre,151,76,75
False,8128064,"Külsheim, Stadt",6 - 10 Jahre,272,146,126
False,8128064,"Külsheim, Stadt",10 - 15 Jahre,354,186,168
False,8128064,"Külsheim, Stadt",15 - 18 Jahre,249,145,104
False,8128064,"Külsheim, Stadt",18 - 20 Jahre,149,78,71
False,8128064,"Külsheim, Stadt",20 - 25 Jahre,321,172,149
False,8128064,"Külsheim, Stadt",25 - 30 Jahre,299,161,138
False,8128064,"Külsheim, Stadt",30 - 35 Jahre,304,155,149
False,8128064,"Külsheim, Stadt",35 - 40 Jahre,506,284,222
False,8128064,"Külsheim, Stadt",40 - 45 Jahre,547,311,236
False,8128064,"Külsheim, Stadt",45 - 50 Jahre,455,226,229
False,8128064,"Külsheim, Stadt",50 - 55 Jahre,387,199,188
False,8128064,"Külsheim, Stadt",55 - 60 Jahre,329,171,158
False,8128064,"Külsheim, Stadt",60 - 65 Jahre,258,138,120
False,8128064,"Külsheim, Stadt",65 - 75 Jahre,581,288,293
False,8128064,"Külsheim, Stadt",75 und mehr Jahre,435,162,273
False,8128064,"Külsheim, Stadt",Insgesamt,5743,2984,2759
False,8128082,"Niederstetten, Stadt",unter 3 Jahre,172,80,92
False,8128082,"Niederstetten, Stadt",3 -  6 Jahre,163,83,80
False,8128082,"Niederstetten, Stadt",6 - 10 Jahre,234,116,118
False,8128082,"Niederstetten, Stadt",10 - 15 Jahre,306,148,158
False,8128082,"Niederstetten, Stadt",15 - 18 Jahre,190,103,87
False,8128082,"Niederstetten, Stadt",18 - 20 Jahre,141,73,68
False,8128082,"Niederstetten, Stadt",20 - 25 Jahre,340,185,155
False,8128082,"Niederstetten, Stadt",25 - 30 Jahre,321,161,160
False,8128082,"Niederstetten, Stadt",30 - 35 Jahre,349,189,160
False,8128082,"Niederstetten, Stadt",35 - 40 Jahre,430,236,194
False,8128082,"Niederstetten, Stadt",40 - 45 Jahre,576,352,224
False,8128082,"Niederstetten, Stadt",45 - 50 Jahre,422,214,208
False,8128082,"Niederstetten, Stadt",50 - 55 Jahre,355,189,166
False,8128082,"Niederstetten, Stadt",55 - 60 Jahre,300,155,145
False,8128082,"Niederstetten, Stadt",60 - 65 Jahre,256,141,115
False,8128082,"Niederstetten, Stadt",65 - 75 Jahre,515,252,263
False,8128082,"Niederstetten, Stadt",75 und mehr Jahre,406,158,248
False,8128082,"Niederstetten, Stadt",Insgesamt,5476,2835,2641
False,8128115,"Tauberbischofsheim, Stadt",unter 3 Jahre,338,183,155
False,8128115,"Tauberbischofsheim, Stadt",3 -  6 Jahre,411,210,201
False,8128115,"Tauberbischofsheim, Stadt",6 - 10 Jahre,511,258,253
False,8128115,"Tauberbischofsheim, Stadt",10 - 15 Jahre,717,391,326
False,8128115,"Tauberbischofsheim, Stadt",15 - 18 Jahre,508,237,271
False,8128115,"Tauberbischofsheim, Stadt",18 - 20 Jahre,360,167,193
False,8128115,"Tauberbischofsheim, Stadt",20 - 25 Jahre,784,427,357
False,8128115,"Tauberbischofsheim, Stadt",25 - 30 Jahre,707,340,367
False,8128115,"Tauberbischofsheim, Stadt",30 - 35 Jahre,853,424,429
False,8128115,"Tauberbischofsheim, Stadt",35 - 40 Jahre,1050,559,491
False,8128115,"Tauberbischofsheim, Stadt",40 - 45 Jahre,1073,571,502
False,8128115,"Tauberbischofsheim, Stadt",45 - 50 Jahre,1012,519,493
False,8128115,"Tauberbischofsheim, Stadt",50 - 55 Jahre,949,484,465
False,8128115,"Tauberbischofsheim, Stadt",55 - 60 Jahre,814,400,414
False,8128115,"Tauberbischofsheim, Stadt",60 - 65 Jahre,693,342,351
False,8128115,"Tauberbischofsheim, Stadt",65 - 75 Jahre,1327,626,701
False,8128115,"Tauberbischofsheim, Stadt",75 und mehr Jahre,1227,410,817
False,8128115,"Tauberbischofsheim, Stadt",Insgesamt,13334,6548,6786
False,8128126,"Weikersheim, Stadt",unter 3 Jahre,215,93,122
False,8128126,"Weikersheim, Stadt",3 -  6 Jahre,262,133,129
False,8128126,"Weikersheim, Stadt",6 - 10 Jahre,340,167,173
False,8128126,"Weikersheim, Stadt",10 - 15 Jahre,420,233,187
False,8128126,"Weikersheim, Stadt",15 - 18 Jahre,308,165,143
False,8128126,"Weikersheim, Stadt",18 - 20 Jahre,176,84,92
False,8128126,"Weikersheim, Stadt",20 - 25 Jahre,417,207,210
False,8128126,"Weikersheim, Stadt",25 - 30 Jahre,385,192,193
False,8128126,"Weikersheim, Stadt",30 - 35 Jahre,409,207,202
False,8128126,"Weikersheim, Stadt",35 - 40 Jahre,650,317,333
False,8128126,"Weikersheim, Stadt",40 - 45 Jahre,599,315,284
False,8128126,"Weikersheim, Stadt",45 - 50 Jahre,571,299,272
False,8128126,"Weikersheim, Stadt",50 - 55 Jahre,474,243,231
False,8128126,"Weikersheim, Stadt",55 - 60 Jahre,423,220,203
False,8128126,"Weikersheim, Stadt",60 - 65 Jahre,432,217,215
False,8128126,"Weikersheim, Stadt",65 - 75 Jahre,850,421,429
False,8128126,"Weikersheim, Stadt",75 und mehr Jahre,646,237,409
False,8128126,"Weikersheim, Stadt",Insgesamt,7577,3750,3827
False,8128128,Werbach,unter 3 Jahre,89,49,40
False,8128128,Werbach,3 -  6 Jahre,98,52,46
False,8128128,Werbach,6 - 10 Jahre,161,86,75
False,8128128,Werbach,10 - 15 Jahre,245,127,118
False,8128128,Werbach,15 - 18 Jahre,146,79,67
False,8128128,Werbach,18 - 20 Jahre,99,53,46
False,8128128,Werbach,20 - 25 Jahre,215,107,108
False,8128128,Werbach,25 - 30 Jahre,167,90,77
False,8128128,Werbach,30 - 35 Jahre,173,78,95
False,8128128,Werbach,35 - 40 Jahre,316,169,147
False,8128128,Werbach,40 - 45 Jahre,332,168,164
False,8128128,Werbach,45 - 50 Jahre,320,176,144
False,8128128,Werbach,50 - 55 Jahre,242,123,119
False,8128128,Werbach,55 - 60 Jahre,194,108,86
False,8128128,Werbach,60 - 65 Jahre,162,91,71
False,8128128,Werbach,65 - 75 Jahre,357,171,186
False,8128128,Werbach,75 und mehr Jahre,300,98,202
False,8128128,Werbach,Insgesamt,3616,1825,1791
False,8128131,"Wertheim, Stadt",unter 3 Jahre,615,315,300
False,8128131,"Wertheim, Stadt",3 -  6 Jahre,637,298,339
False,8128131,"Wertheim, Stadt",6 - 10 Jahre,1033,542,491
False,8128131,"Wertheim, Stadt",10 - 15 Jahre,1395,731,664
False,8128131,"Wertheim, Stadt",15 - 18 Jahre,953,453,500
False,8128131,"Wertheim, Stadt",18 - 20 Jahre,595,326,269
False,8128131,"Wertheim, Stadt",20 - 25 Jahre,1410,757,653
False,8128131,"Wertheim, Stadt",25 - 30 Jahre,1400,713,687
False,8128131,"Wertheim, Stadt",30 - 35 Jahre,1350,690,660
False,8128131,"Wertheim, Stadt",35 - 40 Jahre,1817,906,911
False,8128131,"Wertheim, Stadt",40 - 45 Jahre,2110,1034,1076
False,8128131,"Wertheim, Stadt",45 - 50 Jahre,1920,1026,894
False,8128131,"Wertheim, Stadt",50 - 55 Jahre,1646,781,865
False,8128131,"Wertheim, Stadt",55 - 60 Jahre,1441,743,698
False,8128131,"Wertheim, Stadt",60 - 65 Jahre,1145,562,583
False,8128131,"Wertheim, Stadt",65 - 75 Jahre,2654,1247,1407
False,8128131,"Wertheim, Stadt",75 und mehr Jahre,2353,827,1526
False,8128131,"Wertheim, Stadt",Insgesamt,24474,11951,12523
False,8128137,Wittighausen,unter 3 Jahre,49,23,26
False,8128137,Wittighausen,3 -  6 Jahre,51,28,23
False,8128137,Wittighausen,6 - 10 Jahre,81,46,35
False,8128137,Wittighausen,10 - 15 Jahre,102,44,58
False,8128137,Wittighausen,15 - 18 Jahre,76,35,41
False,8128137,Wittighausen,18 - 20 Jahre,35,14,21
False,8128137,Wittighausen,20 - 25 Jahre,96,60,36
False,8128137,Wittighausen,25 - 30 Jahre,80,40,40
False,8128137,Wittighausen,30 - 35 Jahre,112,51,61
False,8128137,Wittighausen,35 - 40 Jahre,150,87,63
False,8128137,Wittighausen,40 - 45 Jahre,127,61,66
False,8128137,Wittighausen,45 - 50 Jahre,155,93,62
False,8128137,Wittighausen,50 - 55 Jahre,114,66,48
False,8128137,Wittighausen,55 - 60 Jahre,99,49,50
False,8128137,Wittighausen,60 - 65 Jahre,74,36,38
False,8128137,Wittighausen,65 - 75 Jahre,191,99,92
False,8128137,Wittighausen,75 und mehr Jahre,119,37,82
False,8128137,Wittighausen,Insgesamt,1711,869,842
False,8128138,Ahorn,unter 3 Jahre,63,34,29
False,8128138,Ahorn,3 -  6 Jahre,56,35,21
False,8128138,Ahorn,6 - 10 Jahre,114,55,59
False,8128138,Ahorn,10 - 15 Jahre,165,95,70
False,8128138,Ahorn,15 - 18 Jahre,93,45,48
False,8128138,Ahorn,18 - 20 Jahre,65,34,31
False,8128138,Ahorn,20 - 25 Jahre,109,68,41
False,8128138,Ahorn,25 - 30 Jahre,106,55,51
False,8128138,Ahorn,30 - 35 Jahre,108,50,58
False,8128138,Ahorn,35 - 40 Jahre,181,97,84
False,8128138,Ahorn,40 - 45 Jahre,246,126,120
False,8128138,Ahorn,45 - 50 Jahre,195,107,88
False,8128138,Ahorn,50 - 55 Jahre,147,79,68
False,8128138,Ahorn,55 - 60 Jahre,138,73,65
False,8128138,Ahorn,60 - 65 Jahre,85,44,41
False,8128138,Ahorn,65 - 75 Jahre,242,116,126
False,8128138,Ahorn,75 und mehr Jahre,229,76,153
False,8128138,Ahorn,Insgesamt,2342,1189,1153
False,8128139,"Lauda-Königshofen, Stadt",unter 3 Jahre,404,221,183
False,8128139,"Lauda-Königshofen, Stadt",3 -  6 Jahre,418,227,191
False,8128139,"Lauda-Königshofen, Stadt",6 - 10 Jahre,612,300,312
False,8128139,"Lauda-Königshofen, Stadt",10 - 15 Jahre,916,495,421
False,8128139,"Lauda-Königshofen, Stadt",15 - 18 Jahre,583,295,288
False,8128139,"Lauda-Königshofen, Stadt",18 - 20 Jahre,368,211,157
False,8128139,"Lauda-Königshofen, Stadt",20 - 25 Jahre,904,480,424
False,8128139,"Lauda-Königshofen, Stadt",25 - 30 Jahre,836,416,420
False,8128139,"Lauda-Königshofen, Stadt",30 - 35 Jahre,858,438,420
False,8128139,"Lauda-Königshofen, Stadt",35 - 40 Jahre,1105,587,518
False,8128139,"Lauda-Königshofen, Stadt",40 - 45 Jahre,1250,622,628
False,8128139,"Lauda-Königshofen, Stadt",45 - 50 Jahre,1197,580,617
False,8128139,"Lauda-Königshofen, Stadt",50 - 55 Jahre,1074,536,538
False,8128139,"Lauda-Königshofen, Stadt",55 - 60 Jahre,930,461,469
False,8128139,"Lauda-Königshofen, Stadt",60 - 65 Jahre,841,407,434
False,8128139,"Lauda-Königshofen, Stadt",65 - 75 Jahre,1666,834,832
False,8128139,"Lauda-Königshofen, Stadt",75 und mehr Jahre,1316,453,863
False,8128139,"Lauda-Königshofen, Stadt",Insgesamt,15278,7563,7715
False,8135,Landkreis Heidenheim,unter 3 Jahre,3498,1753,1745
False,8135,Landkreis Heidenheim,3 -  6 Jahre,3928,2100,1828
False,8135,Landkreis Heidenheim,6 - 10 Jahre,5863,3022,2841
False,8135,Landkreis Heidenheim,10 - 15 Jahre,7905,4014,3891
False,8135,Landkreis Heidenheim,15 - 18 Jahre,5137,2676,2461
False,8135,Landkreis Heidenheim,18 - 20 Jahre,3514,1852,1662
False,8135,Landkreis Heidenheim,20 - 25 Jahre,7729,3989,3740
False,8135,Landkreis Heidenheim,25 - 30 Jahre,7076,3629,3447
False,8135,Landkreis Heidenheim,30 - 35 Jahre,7866,3951,3915
False,8135,Landkreis Heidenheim,35 - 40 Jahre,10418,5296,5122
False,8135,Landkreis Heidenheim,40 - 45 Jahre,11096,5704,5392
False,8135,Landkreis Heidenheim,45 - 50 Jahre,10134,5113,5021
False,8135,Landkreis Heidenheim,50 - 55 Jahre,8730,4449,4281
False,8135,Landkreis Heidenheim,55 - 60 Jahre,7771,3891,3880
False,8135,Landkreis Heidenheim,60 - 65 Jahre,7140,3498,3642
False,8135,Landkreis Heidenheim,65 - 75 Jahre,15277,7082,8195
False,8135,Landkreis Heidenheim,75 und mehr Jahre,12092,4300,7792
False,8135,Landkreis Heidenheim,Insgesamt,135174,66319,68855
False,8135010,Dischingen,unter 3 Jahre,119,57,62
False,8135010,Dischingen,3 -  6 Jahre,140,72,68
False,8135010,Dischingen,6 - 10 Jahre,205,108,97
False,8135010,Dischingen,10 - 15 Jahre,308,175,133
False,8135010,Dischingen,15 - 18 Jahre,211,118,93
False,8135010,Dischingen,18 - 20 Jahre,130,61,69
False,8135010,Dischingen,20 - 25 Jahre,243,155,88
False,8135010,Dischingen,25 - 30 Jahre,233,118,115
False,8135010,Dischingen,30 - 35 Jahre,266,135,131
False,8135010,Dischingen,35 - 40 Jahre,364,192,172
False,8135010,Dischingen,40 - 45 Jahre,384,202,182
False,8135010,Dischingen,45 - 50 Jahre,377,209,168
False,8135010,Dischingen,50 - 55 Jahre,305,172,133
False,8135010,Dischingen,55 - 60 Jahre,256,132,124
False,8135010,Dischingen,60 - 65 Jahre,195,103,92
False,8135010,Dischingen,65 - 75 Jahre,476,219,257
False,8135010,Dischingen,75 und mehr Jahre,368,138,230
False,8135010,Dischingen,Insgesamt,4580,2366,2214
False,8135015,Gerstetten,unter 3 Jahre,333,163,170
False,8135015,Gerstetten,3 -  6 Jahre,351,172,179
False,8135015,Gerstetten,6 - 10 Jahre,635,312,323
False,8135015,Gerstetten,10 - 15 Jahre,793,409,384
False,8135015,Gerstetten,15 - 18 Jahre,509,258,251
False,8135015,Gerstetten,18 - 20 Jahre,357,172,185
False,8135015,Gerstetten,20 - 25 Jahre,633,320,313
False,8135015,Gerstetten,25 - 30 Jahre,561,274,287
False,8135015,Gerstetten,30 - 35 Jahre,733,368,365
False,8135015,Gerstetten,35 - 40 Jahre,989,492,497
False,8135015,Gerstetten,40 - 45 Jahre,1026,543,483
False,8135015,Gerstetten,45 - 50 Jahre,929,478,451
False,8135015,Gerstetten,50 - 55 Jahre,752,385,367
False,8135015,Gerstetten,55 - 60 Jahre,670,364,306
False,8135015,Gerstetten,60 - 65 Jahre,534,262,272
False,8135015,Gerstetten,65 - 75 Jahre,1310,616,694
False,8135015,Gerstetten,75 und mehr Jahre,970,343,627
False,8135015,Gerstetten,Insgesamt,12085,5931,6154
False,8135016,"Giengen an der Brenz, Stadt",unter 3 Jahre,553,277,276
False,8135016,"Giengen an der Brenz, Stadt",3 -  6 Jahre,596,324,272
False,8135016,"Giengen an der Brenz, Stadt",6 - 10 Jahre,842,460,382
False,8135016,"Giengen an der Brenz, Stadt",10 - 15 Jahre,1225,632,593
False,8135016,"Giengen an der Brenz, Stadt",15 - 18 Jahre,765,399,366
False,8135016,"Giengen an der Brenz, Stadt",18 - 20 Jahre,526,298,228
False,8135016,"Giengen an der Brenz, Stadt",20 - 25 Jahre,1107,572,535
False,8135016,"Giengen an der Brenz, Stadt",25 - 30 Jahre,1081,537,544
False,8135016,"Giengen an der Brenz, Stadt",30 - 35 Jahre,1196,590,606
False,8135016,"Giengen an der Brenz, Stadt",35 - 40 Jahre,1643,816,827
False,8135016,"Giengen an der Brenz, Stadt",40 - 45 Jahre,1619,857,762
False,8135016,"Giengen an der Brenz, Stadt",45 - 50 Jahre,1426,728,698
False,8135016,"Giengen an der Brenz, Stadt",50 - 55 Jahre,1305,675,630
False,8135016,"Giengen an der Brenz, Stadt",55 - 60 Jahre,1124,549,575
False,8135016,"Giengen an der Brenz, Stadt",60 - 65 Jahre,1061,512,549
False,8135016,"Giengen an der Brenz, Stadt",65 - 75 Jahre,2305,1080,1225
False,8135016,"Giengen an der Brenz, Stadt",75 und mehr Jahre,1777,633,1144
False,8135016,"Giengen an der Brenz, Stadt",Insgesamt,20151,9939,10212
False,8135019,"Heidenheim an der Brenz, Stadt",unter 3 Jahre,1222,586,636
False,8135019,"Heidenheim an der Brenz, Stadt",3 -  6 Jahre,1331,703,628
False,8135019,"Heidenheim an der Brenz, Stadt",6 - 10 Jahre,1969,1025,944
False,8135019,"Heidenheim an der Brenz, Stadt",10 - 15 Jahre,2635,1321,1314
False,8135019,"Heidenheim an der Brenz, Stadt",15 - 18 Jahre,1806,942,864
False,8135019,"Heidenheim an der Brenz, Stadt",18 - 20 Jahre,1215,617,598
False,8135019,"Heidenheim an der Brenz, Stadt",20 - 25 Jahre,3002,1552,1450
False,8135019,"Heidenheim an der Brenz, Stadt",25 - 30 Jahre,2775,1384,1391
False,8135019,"Heidenheim an der Brenz, Stadt",30 - 35 Jahre,2964,1503,1461
False,8135019,"Heidenheim an der Brenz, Stadt",35 - 40 Jahre,3548,1830,1718
False,8135019,"Heidenheim an der Brenz, Stadt",40 - 45 Jahre,3913,1950,1963
False,8135019,"Heidenheim an der Brenz, Stadt",45 - 50 Jahre,3590,1802,1788
False,8135019,"Heidenheim an der Brenz, Stadt",50 - 55 Jahre,3201,1605,1596
False,8135019,"Heidenheim an der Brenz, Stadt",55 - 60 Jahre,2917,1426,1491
False,8135019,"Heidenheim an der Brenz, Stadt",60 - 65 Jahre,2754,1335,1419
False,8135019,"Heidenheim an der Brenz, Stadt",65 - 75 Jahre,5781,2615,3166
False,8135019,"Heidenheim an der Brenz, Stadt",75 und mehr Jahre,5003,1727,3276
False,8135019,"Heidenheim an der Brenz, Stadt",Insgesamt,49626,23923,25703
False,8135020,"Herbrechtingen, Stadt",unter 3 Jahre,334,177,157
False,8135020,"Herbrechtingen, Stadt",3 -  6 Jahre,407,218,189
False,8135020,"Herbrechtingen, Stadt",6 - 10 Jahre,603,307,296
False,8135020,"Herbrechtingen, Stadt",10 - 15 Jahre,750,391,359
False,8135020,"Herbrechtingen, Stadt",15 - 18 Jahre,452,235,217
False,8135020,"Herbrechtingen, Stadt",18 - 20 Jahre,340,176,164
False,8135020,"Herbrechtingen, Stadt",20 - 25 Jahre,695,360,335
False,8135020,"Herbrechtingen, Stadt",25 - 30 Jahre,698,371,327
False,8135020,"Herbrechtingen, Stadt",30 - 35 Jahre,786,357,429
False,8135020,"Herbrechtingen, Stadt",35 - 40 Jahre,1042,534,508
False,8135020,"Herbrechtingen, Stadt",40 - 45 Jahre,1098,588,510
False,8135020,"Herbrechtingen, Stadt",45 - 50 Jahre,1023,516,507
False,8135020,"Herbrechtingen, Stadt",50 - 55 Jahre,844,424,420
False,8135020,"Herbrechtingen, Stadt",55 - 60 Jahre,749,372,377
False,8135020,"Herbrechtingen, Stadt",60 - 65 Jahre,689,342,347
False,8135020,"Herbrechtingen, Stadt",65 - 75 Jahre,1445,676,769
False,8135020,"Herbrechtingen, Stadt",75 und mehr Jahre,1213,444,769
False,8135020,"Herbrechtingen, Stadt",Insgesamt,13168,6488,6680
False,8135021,Hermaringen,unter 3 Jahre,60,38,22
False,8135021,Hermaringen,3 -  6 Jahre,69,44,25
False,8135021,Hermaringen,6 - 10 Jahre,103,51,52
False,8135021,Hermaringen,10 - 15 Jahre,169,78,91
False,8135021,Hermaringen,15 - 18 Jahre,106,55,51
False,8135021,Hermaringen,18 - 20 Jahre,62,35,27
False,8135021,Hermaringen,20 - 25 Jahre,112,59,53
False,8135021,Hermaringen,25 - 30 Jahre,99,61,38
False,8135021,Hermaringen,30 - 35 Jahre,111,57,54
False,8135021,Hermaringen,35 - 40 Jahre,187,95,92
False,8135021,Hermaringen,40 - 45 Jahre,208,114,94
False,8135021,Hermaringen,45 - 50 Jahre,183,95,88
False,8135021,Hermaringen,50 - 55 Jahre,133,69,64
False,8135021,Hermaringen,55 - 60 Jahre,123,67,56
False,8135021,Hermaringen,60 - 65 Jahre,111,47,64
False,8135021,Hermaringen,65 - 75 Jahre,279,138,141
False,8135021,Hermaringen,75 und mehr Jahre,182,65,117
False,8135021,Hermaringen,Insgesamt,2297,1168,1129
False,8135025,Königsbronn,unter 3 Jahre,161,83,78
False,8135025,Königsbronn,3 -  6 Jahre,213,109,104
False,8135025,Königsbronn,6 - 10 Jahre,327,171,156
False,8135025,Königsbronn,10 - 15 Jahre,481,241,240
False,8135025,Königsbronn,15 - 18 Jahre,280,143,137
False,8135025,Königsbronn,18 - 20 Jahre,192,106,86
False,8135025,Königsbronn,20 - 25 Jahre,381,177,204
False,8135025,Königsbronn,25 - 30 Jahre,286,161,125
False,8135025,Königsbronn,30 - 35 Jahre,387,208,179
False,8135025,Königsbronn,35 - 40 Jahre,549,278,271
False,8135025,Königsbronn,40 - 45 Jahre,617,323,294
False,8135025,Königsbronn,45 - 50 Jahre,561,270,291
False,8135025,Königsbronn,50 - 55 Jahre,530,270,260
False,8135025,Königsbronn,55 - 60 Jahre,449,217,232
False,8135025,Königsbronn,60 - 65 Jahre,481,233,248
False,8135025,Königsbronn,65 - 75 Jahre,885,418,467
False,8135025,Königsbronn,75 und mehr Jahre,636,239,397
False,8135025,Königsbronn,Insgesamt,7416,3647,3769
False,8135026,Nattheim,unter 3 Jahre,182,95,87
False,8135026,Nattheim,3 -  6 Jahre,210,108,102
False,8135026,Nattheim,6 - 10 Jahre,299,154,145
False,8135026,Nattheim,10 - 15 Jahre,370,184,186
False,8135026,Nattheim,15 - 18 Jahre,242,134,108
False,8135026,Nattheim,18 - 20 Jahre,148,89,59
False,8135026,Nattheim,20 - 25 Jahre,362,176,186
False,8135026,Nattheim,25 - 30 Jahre,319,165,154
False,8135026,Nattheim,30 - 35 Jahre,363,183,180
False,8135026,Nattheim,35 - 40 Jahre,577,293,284
False,8135026,Nattheim,40 - 45 Jahre,574,299,275
False,8135026,Nattheim,45 - 50 Jahre,469,225,244
False,8135026,Nattheim,50 - 55 Jahre,424,216,208
False,8135026,Nattheim,55 - 60 Jahre,351,174,177
False,8135026,Nattheim,60 - 65 Jahre,351,178,173
False,8135026,Nattheim,65 - 75 Jahre,737,360,377
False,8135026,Nattheim,75 und mehr Jahre,392,131,261
False,8135026,Nattheim,Insgesamt,6370,3164,3206
False,8135027,"Niederstotzingen, Stadt",unter 3 Jahre,135,63,72
False,8135027,"Niederstotzingen, Stadt",3 -  6 Jahre,154,91,63
False,8135027,"Niederstotzingen, Stadt",6 - 10 Jahre,214,98,116
False,8135027,"Niederstotzingen, Stadt",10 - 15 Jahre,287,143,144
False,8135027,"Niederstotzingen, Stadt",15 - 18 Jahre,194,86,108
False,8135027,"Niederstotzingen, Stadt",18 - 20 Jahre,157,89,68
False,8135027,"Niederstotzingen, Stadt",20 - 25 Jahre,306,149,157
False,8135027,"Niederstotzingen, Stadt",25 - 30 Jahre,251,148,103
False,8135027,"Niederstotzingen, Stadt",30 - 35 Jahre,293,158,135
False,8135027,"Niederstotzingen, Stadt",35 - 40 Jahre,414,202,212
False,8135027,"Niederstotzingen, Stadt",40 - 45 Jahre,423,210,213
False,8135027,"Niederstotzingen, Stadt",45 - 50 Jahre,426,226,200
False,8135027,"Niederstotzingen, Stadt",50 - 55 Jahre,308,155,153
False,8135027,"Niederstotzingen, Stadt",55 - 60 Jahre,289,156,133
False,8135027,"Niederstotzingen, Stadt",60 - 65 Jahre,237,123,114
False,8135027,"Niederstotzingen, Stadt",65 - 75 Jahre,457,213,244
False,8135027,"Niederstotzingen, Stadt",75 und mehr Jahre,360,121,239
False,8135027,"Niederstotzingen, Stadt",Insgesamt,4905,2431,2474
False,8135031,Sontheim an der Brenz,unter 3 Jahre,151,81,70
False,8135031,Sontheim an der Brenz,3 -  6 Jahre,181,106,75
False,8135031,Sontheim an der Brenz,6 - 10 Jahre,262,130,132
False,8135031,Sontheim an der Brenz,10 - 15 Jahre,329,166,163
False,8135031,Sontheim an der Brenz,15 - 18 Jahre,216,126,90
False,8135031,Sontheim an der Brenz,18 - 20 Jahre,131,74,57
False,8135031,Sontheim an der Brenz,20 - 25 Jahre,347,189,158
False,8135031,Sontheim an der Brenz,25 - 30 Jahre,314,161,153
False,8135031,Sontheim an der Brenz,30 - 35 Jahre,307,164,143
False,8135031,Sontheim an der Brenz,35 - 40 Jahre,460,239,221
False,8135031,Sontheim an der Brenz,40 - 45 Jahre,512,252,260
False,8135031,Sontheim an der Brenz,45 - 50 Jahre,459,239,220
False,8135031,Sontheim an der Brenz,50 - 55 Jahre,339,175,164
False,8135031,Sontheim an der Brenz,55 - 60 Jahre,334,176,158
False,8135031,Sontheim an der Brenz,60 - 65 Jahre,268,136,132
False,8135031,Sontheim an der Brenz,65 - 75 Jahre,573,273,300
False,8135031,Sontheim an der Brenz,75 und mehr Jahre,463,178,285
False,8135031,Sontheim an der Brenz,Insgesamt,5646,2865,2781
False,8135032,Steinheim am Albuch,unter 3 Jahre,248,133,115
False,8135032,Steinheim am Albuch,3 -  6 Jahre,276,153,123
False,8135032,Steinheim am Albuch,6 - 10 Jahre,404,206,198
False,8135032,Steinheim am Albuch,10 - 15 Jahre,558,274,284
False,8135032,Steinheim am Albuch,15 - 18 Jahre,356,180,176
False,8135032,Steinheim am Albuch,18 - 20 Jahre,256,135,121
False,8135032,Steinheim am Albuch,20 - 25 Jahre,541,280,261
False,8135032,Steinheim am Albuch,25 - 30 Jahre,459,249,210
False,8135032,Steinheim am Albuch,30 - 35 Jahre,460,228,232
False,8135032,Steinheim am Albuch,35 - 40 Jahre,645,325,320
False,8135032,Steinheim am Albuch,40 - 45 Jahre,722,366,356
False,8135032,Steinheim am Albuch,45 - 50 Jahre,691,325,366
False,8135032,Steinheim am Albuch,50 - 55 Jahre,589,303,286
False,8135032,Steinheim am Albuch,55 - 60 Jahre,509,258,251
False,8135032,Steinheim am Albuch,60 - 65 Jahre,459,227,232
False,8135032,Steinheim am Albuch,65 - 75 Jahre,1029,474,555
False,8135032,Steinheim am Albuch,75 und mehr Jahre,728,281,447
False,8135032,Steinheim am Albuch,Insgesamt,8930,4397,4533
False,8136,Landkreis Ostalbkreis,unter 3 Jahre,8918,4502,4416
False,8136,Landkreis Ostalbkreis,3 -  6 Jahre,9872,5080,4792
False,8136,Landkreis Ostalbkreis,6 - 10 Jahre,14677,7463,7214
False,8136,Landkreis Ostalbkreis,10 - 15 Jahre,19337,9932,9405
False,8136,Landkreis Ostalbkreis,15 - 18 Jahre,12372,6297,6075
False,8136,Landkreis Ostalbkreis,18 - 20 Jahre,7897,4031,3866
False,8136,Landkreis Ostalbkreis,20 - 25 Jahre,18836,9554,9282
False,8136,Landkreis Ostalbkreis,25 - 30 Jahre,17976,9189,8787
False,8136,Landkreis Ostalbkreis,30 - 35 Jahre,19743,10099,9644
False,8136,Landkreis Ostalbkreis,35 - 40 Jahre,25155,12915,12240
False,8136,Landkreis Ostalbkreis,40 - 45 Jahre,26577,13755,12822
False,8136,Landkreis Ostalbkreis,45 - 50 Jahre,23819,12145,11674
False,8136,Landkreis Ostalbkreis,50 - 55 Jahre,20428,10250,10178
False,8136,Landkreis Ostalbkreis,55 - 60 Jahre,17579,8854,8725
False,8136,Landkreis Ostalbkreis,60 - 65 Jahre,16266,8105,8161
False,8136,Landkreis Ostalbkreis,65 - 75 Jahre,32334,15353,16981
False,8136,Landkreis Ostalbkreis,75 und mehr Jahre,24974,8680,16294
False,8136,Landkreis Ostalbkreis,Insgesamt,316760,156204,160556
False,8136002,Abtsgmünd,unter 3 Jahre,219,102,117
False,8136002,Abtsgmünd,3 -  6 Jahre,219,120,99
False,8136002,Abtsgmünd,6 - 10 Jahre,371,189,182
False,8136002,Abtsgmünd,10 - 15 Jahre,485,256,229
False,8136002,Abtsgmünd,15 - 18 Jahre,307,133,174
False,8136002,Abtsgmünd,18 - 20 Jahre,199,94,105
False,8136002,Abtsgmünd,20 - 25 Jahre,418,225,193
False,8136002,Abtsgmünd,25 - 30 Jahre,401,201,200
False,8136002,Abtsgmünd,30 - 35 Jahre,442,236,206
False,8136002,Abtsgmünd,35 - 40 Jahre,655,333,322
False,8136002,Abtsgmünd,40 - 45 Jahre,649,330,319
False,8136002,Abtsgmünd,45 - 50 Jahre,607,308,299
False,8136002,Abtsgmünd,50 - 55 Jahre,470,238,232
False,8136002,Abtsgmünd,55 - 60 Jahre,344,194,150
False,8136002,Abtsgmünd,60 - 65 Jahre,333,156,177
False,8136002,Abtsgmünd,65 - 75 Jahre,715,331,384
False,8136002,Abtsgmünd,75 und mehr Jahre,590,211,379
False,8136002,Abtsgmünd,Insgesamt,7424,3657,3767
False,8136003,Adelmannsfelden,unter 3 Jahre,56,26,30
False,8136003,Adelmannsfelden,3 -  6 Jahre,67,36,31
False,8136003,Adelmannsfelden,6 - 10 Jahre,130,59,71
False,8136003,Adelmannsfelden,10 - 15 Jahre,146,75,71
False,8136003,Adelmannsfelden,15 - 18 Jahre,78,40,38
False,8136003,Adelmannsfelden,18 - 20 Jahre,45,25,20
False,8136003,Adelmannsfelden,20 - 25 Jahre,79,38,41
False,8136003,Adelmannsfelden,25 - 30 Jahre,89,42,47
False,8136003,Adelmannsfelden,30 - 35 Jahre,104,45,59
False,8136003,Adelmannsfelden,35 - 40 Jahre,159,90,69
False,8136003,Adelmannsfelden,40 - 45 Jahre,193,99,94
False,8136003,Adelmannsfelden,45 - 50 Jahre,156,86,70
False,8136003,Adelmannsfelden,50 - 55 Jahre,113,69,44
False,8136003,Adelmannsfelden,55 - 60 Jahre,84,42,42
False,8136003,Adelmannsfelden,60 - 65 Jahre,85,39,46
False,8136003,Adelmannsfelden,65 - 75 Jahre,168,83,85
False,8136003,Adelmannsfelden,75 und mehr Jahre,131,40,91
False,8136003,Adelmannsfelden,Insgesamt,1883,934,949
False,8136007,Bartholomä,unter 3 Jahre,46,15,31
False,8136007,Bartholomä,3 -  6 Jahre,61,37,24
False,8136007,Bartholomä,6 - 10 Jahre,94,47,47
False,8136007,Bartholomä,10 - 15 Jahre,161,76,85
False,8136007,Bartholomä,15 - 18 Jahre,104,54,50
False,8136007,Bartholomä,18 - 20 Jahre,62,28,34
False,8136007,Bartholomä,20 - 25 Jahre,143,74,69
False,8136007,Bartholomä,25 - 30 Jahre,100,50,50
False,8136007,Bartholomä,30 - 35 Jahre,116,51,65
False,8136007,Bartholomä,35 - 40 Jahre,171,79,92
False,8136007,Bartholomä,40 - 45 Jahre,204,104,100
False,8136007,Bartholomä,45 - 50 Jahre,172,89,83
False,8136007,Bartholomä,50 - 55 Jahre,152,80,72
False,8136007,Bartholomä,55 - 60 Jahre,137,71,66
False,8136007,Bartholomä,60 - 65 Jahre,101,56,45
False,8136007,Bartholomä,65 - 75 Jahre,229,104,125
False,8136007,Bartholomä,75 und mehr Jahre,144,52,92
False,8136007,Bartholomä,Insgesamt,2197,1067,1130
False,8136009,Böbingen an der Rems,unter 3 Jahre,146,65,81
False,8136009,Böbingen an der Rems,3 -  6 Jahre,164,89,75
False,8136009,Böbingen an der Rems,6 - 10 Jahre,233,130,103
False,8136009,Böbingen an der Rems,10 - 15 Jahre,311,160,151
False,8136009,Böbingen an der Rems,15 - 18 Jahre,202,97,105
False,8136009,Böbingen an der Rems,18 - 20 Jahre,102,53,49
False,8136009,Böbingen an der Rems,20 - 25 Jahre,285,138,147
False,8136009,Böbingen an der Rems,25 - 30 Jahre,259,142,117
False,8136009,Böbingen an der Rems,30 - 35 Jahre,276,135,141
False,8136009,Böbingen an der Rems,35 - 40 Jahre,445,222,223
False,8136009,Böbingen an der Rems,40 - 45 Jahre,388,199,189
False,8136009,Böbingen an der Rems,45 - 50 Jahre,333,179,154
False,8136009,Böbingen an der Rems,50 - 55 Jahre,281,141,140
False,8136009,Böbingen an der Rems,55 - 60 Jahre,255,117,138
False,8136009,Böbingen an der Rems,60 - 65 Jahre,243,113,130
False,8136009,Böbingen an der Rems,65 - 75 Jahre,484,232,252
False,8136009,Böbingen an der Rems,75 und mehr Jahre,293,104,189
False,8136009,Böbingen an der Rems,Insgesamt,4700,2316,2384
False,8136010,"Bopfingen, Stadt",unter 3 Jahre,411,198,213
False,8136010,"Bopfingen, Stadt",3 -  6 Jahre,421,197,224
False,8136010,"Bopfingen, Stadt",6 - 10 Jahre,600,300,300
False,8136010,"Bopfingen, Stadt",10 - 15 Jahre,730,373,357
False,8136010,"Bopfingen, Stadt",15 - 18 Jahre,538,266,272
False,8136010,"Bopfingen, Stadt",18 - 20 Jahre,341,173,168
False,8136010,"Bopfingen, Stadt",20 - 25 Jahre,771,400,371
False,8136010,"Bopfingen, Stadt",25 - 30 Jahre,732,369,363
False,8136010,"Bopfingen, Stadt",30 - 35 Jahre,769,409,360
False,8136010,"Bopfingen, Stadt",35 - 40 Jahre,885,472,413
False,8136010,"Bopfingen, Stadt",40 - 45 Jahre,1006,520,486
False,8136010,"Bopfingen, Stadt",45 - 50 Jahre,947,494,453
False,8136010,"Bopfingen, Stadt",50 - 55 Jahre,862,439,423
False,8136010,"Bopfingen, Stadt",55 - 60 Jahre,736,372,364
False,8136010,"Bopfingen, Stadt",60 - 65 Jahre,579,290,289
False,8136010,"Bopfingen, Stadt",65 - 75 Jahre,1283,587,696
False,8136010,"Bopfingen, Stadt",75 und mehr Jahre,1005,328,677
False,8136010,"Bopfingen, Stadt",Insgesamt,12616,6187,6429
False,8136015,Durlangen,unter 3 Jahre,87,43,44
False,8136015,Durlangen,3 -  6 Jahre,94,58,36
False,8136015,Durlangen,6 - 10 Jahre,146,80,66
False,8136015,Durlangen,10 - 15 Jahre,221,119,102
False,8136015,Durlangen,15 - 18 Jahre,119,63,56
False,8136015,Durlangen,18 - 20 Jahre,69,29,40
False,8136015,Durlangen,20 - 25 Jahre,179,84,95
False,8136015,Durlangen,25 - 30 Jahre,153,81,72
False,8136015,Durlangen,30 - 35 Jahre,173,81,92
False,8136015,Durlangen,35 - 40 Jahre,225,125,100
False,8136015,Durlangen,40 - 45 Jahre,248,117,131
False,8136015,Durlangen,45 - 50 Jahre,221,119,102
False,8136015,Durlangen,50 - 55 Jahre,216,110,106
False,8136015,Durlangen,55 - 60 Jahre,162,82,80
False,8136015,Durlangen,60 - 65 Jahre,147,72,75
False,8136015,Durlangen,65 - 75 Jahre,334,173,161
False,8136015,Durlangen,75 und mehr Jahre,166,58,108
False,8136015,Durlangen,Insgesamt,2960,1494,1466
False,8136018,Ellenberg,unter 3 Jahre,45,22,23
False,8136018,Ellenberg,3 -  6 Jahre,62,26,36
False,8136018,Ellenberg,6 - 10 Jahre,89,38,51
False,8136018,Ellenberg,10 - 15 Jahre,110,58,52
False,8136018,Ellenberg,15 - 18 Jahre,80,45,35
False,8136018,Ellenberg,18 - 20 Jahre,53,21,32
False,8136018,Ellenberg,20 - 25 Jahre,101,53,48
False,8136018,Ellenberg,25 - 30 Jahre,115,69,46
False,8136018,Ellenberg,30 - 35 Jahre,90,50,40
False,8136018,Ellenberg,35 - 40 Jahre,135,65,70
False,8136018,Ellenberg,40 - 45 Jahre,163,92,71
False,8136018,Ellenberg,45 - 50 Jahre,157,88,69
False,8136018,Ellenberg,50 - 55 Jahre,138,81,57
False,8136018,Ellenberg,55 - 60 Jahre,86,55,31
False,8136018,Ellenberg,60 - 65 Jahre,61,24,37
False,8136018,Ellenberg,65 - 75 Jahre,156,76,80
False,8136018,Ellenberg,75 und mehr Jahre,115,41,74
False,8136018,Ellenberg,Insgesamt,1756,904,852
False,8136019,"Ellwangen (Jagst), Stadt",unter 3 Jahre,723,361,362
False,8136019,"Ellwangen (Jagst), Stadt",3 -  6 Jahre,817,403,414
False,8136019,"Ellwangen (Jagst), Stadt",6 - 10 Jahre,1231,615,616
False,8136019,"Ellwangen (Jagst), Stadt",10 - 15 Jahre,1545,776,769
False,8136019,"Ellwangen (Jagst), Stadt",15 - 18 Jahre,1002,533,469
False,8136019,"Ellwangen (Jagst), Stadt",18 - 20 Jahre,676,352,324
False,8136019,"Ellwangen (Jagst), Stadt",20 - 25 Jahre,1502,751,751
False,8136019,"Ellwangen (Jagst), Stadt",25 - 30 Jahre,1430,722,708
False,8136019,"Ellwangen (Jagst), Stadt",30 - 35 Jahre,1629,824,805
False,8136019,"Ellwangen (Jagst), Stadt",35 - 40 Jahre,2026,1046,980
False,8136019,"Ellwangen (Jagst), Stadt",40 - 45 Jahre,2102,1105,997
False,8136019,"Ellwangen (Jagst), Stadt",45 - 50 Jahre,1900,1000,900
False,8136019,"Ellwangen (Jagst), Stadt",50 - 55 Jahre,1603,825,778
False,8136019,"Ellwangen (Jagst), Stadt",55 - 60 Jahre,1288,652,636
False,8136019,"Ellwangen (Jagst), Stadt",60 - 65 Jahre,1161,608,553
False,8136019,"Ellwangen (Jagst), Stadt",65 - 75 Jahre,2483,1110,1373
False,8136019,"Ellwangen (Jagst), Stadt",75 und mehr Jahre,2142,786,1356
False,8136019,"Ellwangen (Jagst), Stadt",Insgesamt,25260,12469,12791
False,8136020,Eschach,unter 3 Jahre,54,28,26
False,8136020,Eschach,3 -  6 Jahre,64,32,32
False,8136020,Eschach,6 - 10 Jahre,78,34,44
False,8136020,Eschach,10 - 15 Jahre,149,85,64
False,8136020,Eschach,15 - 18 Jahre,87,53,34
False,8136020,Eschach,18 - 20 Jahre,45,27,18
False,8136020,Eschach,20 - 25 Jahre,95,44,51
False,8136020,Eschach,25 - 30 Jahre,90,47,43
False,8136020,Eschach,30 - 35 Jahre,112,52,60
False,8136020,Eschach,35 - 40 Jahre,169,89,80
False,8136020,Eschach,40 - 45 Jahre,178,91,87
False,8136020,Eschach,45 - 50 Jahre,140,73,67
False,8136020,Eschach,50 - 55 Jahre,116,64,52
False,8136020,Eschach,55 - 60 Jahre,87,51,36
False,8136020,Eschach,60 - 65 Jahre,75,29,46
False,8136020,Eschach,65 - 75 Jahre,166,84,82
False,8136020,Eschach,75 und mehr Jahre,126,44,82
False,8136020,Eschach,Insgesamt,1831,927,904
False,8136021,Essingen,unter 3 Jahre,169,87,82
False,8136021,Essingen,3 -  6 Jahre,216,113,103
False,8136021,Essingen,6 - 10 Jahre,271,126,145
False,8136021,Essingen,10 - 15 Jahre,403,212,191
False,8136021,Essingen,15 - 18 Jahre,252,141,111
False,8136021,Essingen,18 - 20 Jahre,167,89,78
False,8136021,Essingen,20 - 25 Jahre,362,189,173
False,8136021,Essingen,25 - 30 Jahre,401,199,202
False,8136021,Essingen,30 - 35 Jahre,424,224,200
False,8136021,Essingen,35 - 40 Jahre,510,275,235
False,8136021,Essingen,40 - 45 Jahre,586,283,303
False,8136021,Essingen,45 - 50 Jahre,525,257,268
False,8136021,Essingen,50 - 55 Jahre,413,204,209
False,8136021,Essingen,55 - 60 Jahre,360,180,180
False,8136021,Essingen,60 - 65 Jahre,342,176,166
False,8136021,Essingen,65 - 75 Jahre,592,290,302
False,8136021,Essingen,75 und mehr Jahre,426,166,260
False,8136021,Essingen,Insgesamt,6419,3211,3208
False,8136024,Göggingen,unter 3 Jahre,56,28,28
False,8136024,Göggingen,3 -  6 Jahre,101,43,58
False,8136024,Göggingen,6 - 10 Jahre,138,81,57
False,8136024,Göggingen,10 - 15 Jahre,182,93,89
False,8136024,Göggingen,15 - 18 Jahre,119,74,45
False,8136024,Göggingen,18 - 20 Jahre,85,36,49
False,8136024,Göggingen,20 - 25 Jahre,151,72,79
False,8136024,Göggingen,25 - 30 Jahre,119,54,65
False,8136024,Göggingen,30 - 35 Jahre,166,73,93
False,8136024,Göggingen,35 - 40 Jahre,199,100,99
False,8136024,Göggingen,40 - 45 Jahre,263,121,142
False,8136024,Göggingen,45 - 50 Jahre,221,115,106
False,8136024,Göggingen,50 - 55 Jahre,156,79,77
False,8136024,Göggingen,55 - 60 Jahre,129,70,59
False,8136024,Göggingen,60 - 65 Jahre,100,48,52
False,8136024,Göggingen,65 - 75 Jahre,205,99,106
False,8136024,Göggingen,75 und mehr Jahre,114,45,69
False,8136024,Göggingen,Insgesamt,2504,1231,1273
False,8136027,Gschwend,unter 3 Jahre,141,83,58
False,8136027,Gschwend,3 -  6 Jahre,160,73,87
False,8136027,Gschwend,6 - 10 Jahre,221,114,107
False,8136027,Gschwend,10 - 15 Jahre,336,189,147
False,8136027,Gschwend,15 - 18 Jahre,218,107,111
False,8136027,Gschwend,18 - 20 Jahre,119,60,59
False,8136027,Gschwend,20 - 25 Jahre,248,124,124
False,8136027,Gschwend,25 - 30 Jahre,258,125,133
False,8136027,Gschwend,30 - 35 Jahre,281,136,145
False,8136027,Gschwend,35 - 40 Jahre,404,210,194
False,8136027,Gschwend,40 - 45 Jahre,438,212,226
False,8136027,Gschwend,45 - 50 Jahre,429,215,214
False,8136027,Gschwend,50 - 55 Jahre,331,175,156
False,8136027,Gschwend,55 - 60 Jahre,268,152,116
False,8136027,Gschwend,60 - 65 Jahre,228,114,114
False,8136027,Gschwend,65 - 75 Jahre,546,251,295
False,8136027,Gschwend,75 und mehr Jahre,385,140,245
False,8136027,Gschwend,Insgesamt,5011,2480,2531
False,8136028,"Heubach, Stadt",unter 3 Jahre,282,146,136
False,8136028,"Heubach, Stadt",3 -  6 Jahre,314,159,155
False,8136028,"Heubach, Stadt",6 - 10 Jahre,440,233,207
False,8136028,"Heubach, Stadt",10 - 15 Jahre,591,314,277
False,8136028,"Heubach, Stadt",15 - 18 Jahre,400,205,195
False,8136028,"Heubach, Stadt",18 - 20 Jahre,262,138,124
False,8136028,"Heubach, Stadt",20 - 25 Jahre,667,355,312
False,8136028,"Heubach, Stadt",25 - 30 Jahre,575,312,263
False,8136028,"Heubach, Stadt",30 - 35 Jahre,582,301,281
False,8136028,"Heubach, Stadt",35 - 40 Jahre,737,366,371
False,8136028,"Heubach, Stadt",40 - 45 Jahre,823,423,400
False,8136028,"Heubach, Stadt",45 - 50 Jahre,830,406,424
False,8136028,"Heubach, Stadt",50 - 55 Jahre,691,327,364
False,8136028,"Heubach, Stadt",55 - 60 Jahre,618,304,314
False,8136028,"Heubach, Stadt",60 - 65 Jahre,565,284,281
False,8136028,"Heubach, Stadt",65 - 75 Jahre,1067,526,541
False,8136028,"Heubach, Stadt",75 und mehr Jahre,714,226,488
False,8136028,"Heubach, Stadt",Insgesamt,10158,5025,5133
False,8136029,Heuchlingen,unter 3 Jahre,64,33,31
False,8136029,Heuchlingen,3 -  6 Jahre,62,31,31
False,8136029,Heuchlingen,6 - 10 Jahre,85,44,41
False,8136029,Heuchlingen,10 - 15 Jahre,118,62,56
False,8136029,Heuchlingen,15 - 18 Jahre,91,45,46
False,8136029,Heuchlingen,18 - 20 Jahre,55,26,29
False,8136029,Heuchlingen,20 - 25 Jahre,99,54,45
False,8136029,Heuchlingen,25 - 30 Jahre,106,40,66
False,8136029,Heuchlingen,30 - 35 Jahre,112,49,63
False,8136029,Heuchlingen,35 - 40 Jahre,168,97,71
False,8136029,Heuchlingen,40 - 45 Jahre,172,90,82
False,8136029,Heuchlingen,45 - 50 Jahre,134,69,65
False,8136029,Heuchlingen,50 - 55 Jahre,97,45,52
False,8136029,Heuchlingen,55 - 60 Jahre,82,49,33
False,8136029,Heuchlingen,60 - 65 Jahre,77,32,45
False,8136029,Heuchlingen,65 - 75 Jahre,216,102,114
False,8136029,Heuchlingen,75 und mehr Jahre,121,50,71
False,8136029,Heuchlingen,Insgesamt,1859,918,941
False,8136033,Hüttlingen,unter 3 Jahre,149,76,73
False,8136033,Hüttlingen,3 -  6 Jahre,183,100,83
False,8136033,Hüttlingen,6 - 10 Jahre,259,134,125
False,8136033,Hüttlingen,10 - 15 Jahre,361,190,171
False,8136033,Hüttlingen,15 - 18 Jahre,210,107,103
False,8136033,Hüttlingen,18 - 20 Jahre,149,75,74
False,8136033,Hüttlingen,20 - 25 Jahre,330,172,158
False,8136033,Hüttlingen,25 - 30 Jahre,332,174,158
False,8136033,Hüttlingen,30 - 35 Jahre,337,166,171
False,8136033,Hüttlingen,35 - 40 Jahre,488,259,229
False,8136033,Hüttlingen,40 - 45 Jahre,527,273,254
False,8136033,Hüttlingen,45 - 50 Jahre,459,239,220
False,8136033,Hüttlingen,50 - 55 Jahre,349,174,175
False,8136033,Hüttlingen,55 - 60 Jahre,294,153,141
False,8136033,Hüttlingen,60 - 65 Jahre,297,139,158
False,8136033,Hüttlingen,65 - 75 Jahre,599,288,311
False,8136033,Hüttlingen,75 und mehr Jahre,351,125,226
False,8136033,Hüttlingen,Insgesamt,5674,2844,2830
False,8136034,Iggingen,unter 3 Jahre,79,45,34
False,8136034,Iggingen,3 -  6 Jahre,81,43,38
False,8136034,Iggingen,6 - 10 Jahre,141,76,65
False,8136034,Iggingen,10 - 15 Jahre,182,101,81
False,8136034,Iggingen,15 - 18 Jahre,92,43,49
False,8136034,Iggingen,18 - 20 Jahre,70,40,30
False,8136034,Iggingen,20 - 25 Jahre,152,80,72
False,8136034,Iggingen,25 - 30 Jahre,129,75,54
False,8136034,Iggingen,30 - 35 Jahre,147,65,82
False,8136034,Iggingen,35 - 40 Jahre,255,143,112
False,8136034,Iggingen,40 - 45 Jahre,239,115,124
False,8136034,Iggingen,45 - 50 Jahre,198,102,96
False,8136034,Iggingen,50 - 55 Jahre,147,78,69
False,8136034,Iggingen,55 - 60 Jahre,140,61,79
False,8136034,Iggingen,60 - 65 Jahre,139,68,71
False,8136034,Iggingen,65 - 75 Jahre,244,124,120
False,8136034,Iggingen,75 und mehr Jahre,145,54,91
False,8136034,Iggingen,Insgesamt,2580,1313,1267
False,8136035,Jagstzell,unter 3 Jahre,76,33,43
False,8136035,Jagstzell,3 -  6 Jahre,82,50,32
False,8136035,Jagstzell,6 - 10 Jahre,121,66,55
False,8136035,Jagstzell,10 - 15 Jahre,176,87,89
False,8136035,Jagstzell,15 - 18 Jahre,125,65,60
False,8136035,Jagstzell,18 - 20 Jahre,70,33,37
False,8136035,Jagstzell,20 - 25 Jahre,159,76,83
False,8136035,Jagstzell,25 - 30 Jahre,148,84,64
False,8136035,Jagstzell,30 - 35 Jahre,149,77,72
False,8136035,Jagstzell,35 - 40 Jahre,200,106,94
False,8136035,Jagstzell,40 - 45 Jahre,211,106,105
False,8136035,Jagstzell,45 - 50 Jahre,191,106,85
False,8136035,Jagstzell,50 - 55 Jahre,161,84,77
False,8136035,Jagstzell,55 - 60 Jahre,105,52,53
False,8136035,Jagstzell,60 - 65 Jahre,80,35,45
False,8136035,Jagstzell,65 - 75 Jahre,218,108,110
False,8136035,Jagstzell,75 und mehr Jahre,167,72,95
False,8136035,Jagstzell,Insgesamt,2439,1240,1199
False,8136037,Kirchheim am Ries,unter 3 Jahre,66,36,30
False,8136037,Kirchheim am Ries,3 -  6 Jahre,76,41,35
False,8136037,Kirchheim am Ries,6 - 10 Jahre,115,53,62
False,8136037,Kirchheim am Ries,10 - 15 Jahre,146,74,72
False,8136037,Kirchheim am Ries,15 - 18 Jahre,70,33,37
False,8136037,Kirchheim am Ries,18 - 20 Jahre,61,26,35
False,8136037,Kirchheim am Ries,20 - 25 Jahre,129,76,53
False,8136037,Kirchheim am Ries,25 - 30 Jahre,102,53,49
False,8136037,Kirchheim am Ries,30 - 35 Jahre,136,70,66
False,8136037,Kirchheim am Ries,35 - 40 Jahre,168,100,68
False,8136037,Kirchheim am Ries,40 - 45 Jahre,162,86,76
False,8136037,Kirchheim am Ries,45 - 50 Jahre,146,74,72
False,8136037,Kirchheim am Ries,50 - 55 Jahre,118,61,57
False,8136037,Kirchheim am Ries,55 - 60 Jahre,110,56,54
False,8136037,Kirchheim am Ries,60 - 65 Jahre,93,46,47
False,8136037,Kirchheim am Ries,65 - 75 Jahre,200,98,102
False,8136037,Kirchheim am Ries,75 und mehr Jahre,163,52,111
False,8136037,Kirchheim am Ries,Insgesamt,2061,1035,1026
False,8136038,"Lauchheim, Stadt",unter 3 Jahre,162,88,74
False,8136038,"Lauchheim, Stadt",3 -  6 Jahre,148,82,66
False,8136038,"Lauchheim, Stadt",6 - 10 Jahre,212,116,96
False,8136038,"Lauchheim, Stadt",10 - 15 Jahre,339,173,166
False,8136038,"Lauchheim, Stadt",15 - 18 Jahre,213,96,117
False,8136038,"Lauchheim, Stadt",18 - 20 Jahre,120,55,65
False,8136038,"Lauchheim, Stadt",20 - 25 Jahre,282,143,139
False,8136038,"Lauchheim, Stadt",25 - 30 Jahre,263,125,138
False,8136038,"Lauchheim, Stadt",30 - 35 Jahre,289,138,151
False,8136038,"Lauchheim, Stadt",35 - 40 Jahre,375,194,181
False,8136038,"Lauchheim, Stadt",40 - 45 Jahre,412,207,205
False,8136038,"Lauchheim, Stadt",45 - 50 Jahre,409,212,197
False,8136038,"Lauchheim, Stadt",50 - 55 Jahre,336,175,161
False,8136038,"Lauchheim, Stadt",55 - 60 Jahre,248,136,112
False,8136038,"Lauchheim, Stadt",60 - 65 Jahre,209,103,106
False,8136038,"Lauchheim, Stadt",65 - 75 Jahre,373,186,187
False,8136038,"Lauchheim, Stadt",75 und mehr Jahre,267,88,179
False,8136038,"Lauchheim, Stadt",Insgesamt,4657,2317,2340
False,8136040,Leinzell,unter 3 Jahre,52,23,29
False,8136040,Leinzell,3 -  6 Jahre,52,28,24
False,8136040,Leinzell,6 - 10 Jahre,102,48,54
False,8136040,Leinzell,10 - 15 Jahre,119,58,61
False,8136040,Leinzell,15 - 18 Jahre,79,33,46
False,8136040,Leinzell,18 - 20 Jahre,62,33,29
False,8136040,Leinzell,20 - 25 Jahre,131,66,65
False,8136040,Leinzell,25 - 30 Jahre,124,69,55
False,8136040,Leinzell,30 - 35 Jahre,126,71,55
False,8136040,Leinzell,35 - 40 Jahre,162,81,81
False,8136040,Leinzell,40 - 45 Jahre,198,100,98
False,8136040,Leinzell,45 - 50 Jahre,181,82,99
False,8136040,Leinzell,50 - 55 Jahre,160,74,86
False,8136040,Leinzell,55 - 60 Jahre,142,73,69
False,8136040,Leinzell,60 - 65 Jahre,115,60,55
False,8136040,Leinzell,65 - 75 Jahre,236,106,130
False,8136040,Leinzell,75 und mehr Jahre,176,70,106
False,8136040,Leinzell,Insgesamt,2217,1075,1142
False,8136042,"Lorch, Stadt",unter 3 Jahre,279,153,126
False,8136042,"Lorch, Stadt",3 -  6 Jahre,313,154,159
False,8136042,"Lorch, Stadt",6 - 10 Jahre,511,253,258
False,8136042,"Lorch, Stadt",10 - 15 Jahre,698,345,353
False,8136042,"Lorch, Stadt",15 - 18 Jahre,402,190,212
False,8136042,"Lorch, Stadt",18 - 20 Jahre,307,150,157
False,8136042,"Lorch, Stadt",20 - 25 Jahre,611,310,301
False,8136042,"Lorch, Stadt",25 - 30 Jahre,609,346,263
False,8136042,"Lorch, Stadt",30 - 35 Jahre,677,343,334
False,8136042,"Lorch, Stadt",35 - 40 Jahre,912,460,452
False,8136042,"Lorch, Stadt",40 - 45 Jahre,1082,585,497
False,8136042,"Lorch, Stadt",45 - 50 Jahre,899,457,442
False,8136042,"Lorch, Stadt",50 - 55 Jahre,756,373,383
False,8136042,"Lorch, Stadt",55 - 60 Jahre,678,340,338
False,8136042,"Lorch, Stadt",60 - 65 Jahre,614,308,306
False,8136042,"Lorch, Stadt",65 - 75 Jahre,1184,585,599
False,8136042,"Lorch, Stadt",75 und mehr Jahre,794,289,505
False,8136042,"Lorch, Stadt",Insgesamt,11326,5641,5685
False,8136043,Mögglingen,unter 3 Jahre,130,55,75
False,8136043,Mögglingen,3 -  6 Jahre,145,71,74
False,8136043,Mögglingen,6 - 10 Jahre,218,107,111
False,8136043,Mögglingen,10 - 15 Jahre,278,152,126
False,8136043,Mögglingen,15 - 18 Jahre,160,81,79
False,8136043,Mögglingen,18 - 20 Jahre,96,54,42
False,8136043,Mögglingen,20 - 25 Jahre,237,120,117
False,8136043,Mögglingen,25 - 30 Jahre,242,121,121
False,8136043,Mögglingen,30 - 35 Jahre,284,143,141
False,8136043,Mögglingen,35 - 40 Jahre,339,185,154
False,8136043,Mögglingen,40 - 45 Jahre,347,168,179
False,8136043,Mögglingen,45 - 50 Jahre,326,174,152
False,8136043,Mögglingen,50 - 55 Jahre,241,112,129
False,8136043,Mögglingen,55 - 60 Jahre,245,125,120
False,8136043,Mögglingen,60 - 65 Jahre,227,120,107
False,8136043,Mögglingen,65 - 75 Jahre,400,190,210
False,8136043,Mögglingen,75 und mehr Jahre,252,92,160
False,8136043,Mögglingen,Insgesamt,4167,2070,2097
False,8136044,Mutlangen,unter 3 Jahre,194,98,96
False,8136044,Mutlangen,3 -  6 Jahre,219,108,111
False,8136044,Mutlangen,6 - 10 Jahre,351,200,151
False,8136044,Mutlangen,10 - 15 Jahre,412,213,199
False,8136044,Mutlangen,15 - 18 Jahre,267,127,140
False,8136044,Mutlangen,18 - 20 Jahre,162,77,85
False,8136044,Mutlangen,20 - 25 Jahre,351,169,182
False,8136044,Mutlangen,25 - 30 Jahre,317,142,175
False,8136044,Mutlangen,30 - 35 Jahre,357,196,161
False,8136044,Mutlangen,35 - 40 Jahre,534,245,289
False,8136044,Mutlangen,40 - 45 Jahre,537,234,303
False,8136044,Mutlangen,45 - 50 Jahre,536,285,251
False,8136044,Mutlangen,50 - 55 Jahre,423,212,211
False,8136044,Mutlangen,55 - 60 Jahre,339,171,168
False,8136044,Mutlangen,60 - 65 Jahre,333,150,183
False,8136044,Mutlangen,65 - 75 Jahre,571,260,311
False,8136044,Mutlangen,75 und mehr Jahre,489,164,325
False,8136044,Mutlangen,Insgesamt,6392,3051,3341
False,8136045,"Neresheim, Stadt",unter 3 Jahre,212,98,114
False,8136045,"Neresheim, Stadt",3 -  6 Jahre,266,137,129
False,8136045,"Neresheim, Stadt",6 - 10 Jahre,413,214,199
False,8136045,"Neresheim, Stadt",10 - 15 Jahre,560,287,273
False,8136045,"Neresheim, Stadt",15 - 18 Jahre,346,176,170
False,8136045,"Neresheim, Stadt",18 - 20 Jahre,194,105,89
False,8136045,"Neresheim, Stadt",20 - 25 Jahre,484,248,236
False,8136045,"Neresheim, Stadt",25 - 30 Jahre,530,274,256
False,8136045,"Neresheim, Stadt",30 - 35 Jahre,549,296,253
False,8136045,"Neresheim, Stadt",35 - 40 Jahre,632,338,294
False,8136045,"Neresheim, Stadt",40 - 45 Jahre,703,368,335
False,8136045,"Neresheim, Stadt",45 - 50 Jahre,672,362,310
False,8136045,"Neresheim, Stadt",50 - 55 Jahre,585,299,286
False,8136045,"Neresheim, Stadt",55 - 60 Jahre,452,252,200
False,8136045,"Neresheim, Stadt",60 - 65 Jahre,362,199,163
False,8136045,"Neresheim, Stadt",65 - 75 Jahre,743,349,394
False,8136045,"Neresheim, Stadt",75 und mehr Jahre,596,218,378
False,8136045,"Neresheim, Stadt",Insgesamt,8299,4220,4079
False,8136046,Neuler,unter 3 Jahre,108,50,58
False,8136046,Neuler,3 -  6 Jahre,93,53,40
False,8136046,Neuler,6 - 10 Jahre,150,74,76
False,8136046,Neuler,10 - 15 Jahre,216,107,109
False,8136046,Neuler,15 - 18 Jahre,147,82,65
False,8136046,Neuler,18 - 20 Jahre,77,44,33
False,8136046,Neuler,20 - 25 Jahre,196,115,81
False,8136046,Neuler,25 - 30 Jahre,193,108,85
False,8136046,Neuler,30 - 35 Jahre,226,110,116
False,8136046,Neuler,35 - 40 Jahre,235,115,120
False,8136046,Neuler,40 - 45 Jahre,290,148,142
False,8136046,Neuler,45 - 50 Jahre,239,127,112
False,8136046,Neuler,50 - 55 Jahre,196,100,96
False,8136046,Neuler,55 - 60 Jahre,176,95,81
False,8136046,Neuler,60 - 65 Jahre,137,70,67
False,8136046,Neuler,65 - 75 Jahre,245,124,121
False,8136046,Neuler,75 und mehr Jahre,176,64,112
False,8136046,Neuler,Insgesamt,3100,1586,1514
False,8136049,Obergröningen,unter 3 Jahre,15,6,9
False,8136049,Obergröningen,3 -  6 Jahre,16,9,7
False,8136049,Obergröningen,6 - 10 Jahre,30,15,15
False,8136049,Obergröningen,10 - 15 Jahre,23,14,9
False,8136049,Obergröningen,15 - 18 Jahre,18,7,11
False,8136049,Obergröningen,18 - 20 Jahre,13,7,6
False,8136049,Obergröningen,20 - 25 Jahre,12,2,10
False,8136049,Obergröningen,25 - 30 Jahre,22,11,11
False,8136049,Obergröningen,30 - 35 Jahre,32,19,13
False,8136049,Obergröningen,35 - 40 Jahre,43,23,20
False,8136049,Obergröningen,40 - 45 Jahre,37,24,13
False,8136049,Obergröningen,45 - 50 Jahre,40,21,19
False,8136049,Obergröningen,50 - 55 Jahre,19,10,9
False,8136049,Obergröningen,55 - 60 Jahre,41,20,21
False,8136049,Obergröningen,60 - 65 Jahre,22,13,9
False,8136049,Obergröningen,65 - 75 Jahre,55,30,25
False,8136049,Obergröningen,75 und mehr Jahre,22,7,15
False,8136049,Obergröningen,Insgesamt,460,238,222
False,8136050,"Oberkochen, Stadt",unter 3 Jahre,178,88,90
False,8136050,"Oberkochen, Stadt",3 -  6 Jahre,219,90,129
False,8136050,"Oberkochen, Stadt",6 - 10 Jahre,348,160,188
False,8136050,"Oberkochen, Stadt",10 - 15 Jahre,442,220,222
False,8136050,"Oberkochen, Stadt",15 - 18 Jahre,315,155,160
False,8136050,"Oberkochen, Stadt",18 - 20 Jahre,189,107,82
False,8136050,"Oberkochen, Stadt",20 - 25 Jahre,435,247,188
False,8136050,"Oberkochen, Stadt",25 - 30 Jahre,394,189,205
False,8136050,"Oberkochen, Stadt",30 - 35 Jahre,398,206,192
False,8136050,"Oberkochen, Stadt",35 - 40 Jahre,622,326,296
False,8136050,"Oberkochen, Stadt",40 - 45 Jahre,660,335,325
False,8136050,"Oberkochen, Stadt",45 - 50 Jahre,600,319,281
False,8136050,"Oberkochen, Stadt",50 - 55 Jahre,524,265,259
False,8136050,"Oberkochen, Stadt",55 - 60 Jahre,440,210,230
False,8136050,"Oberkochen, Stadt",60 - 65 Jahre,490,232,258
False,8136050,"Oberkochen, Stadt",65 - 75 Jahre,1112,523,589
False,8136050,"Oberkochen, Stadt",75 und mehr Jahre,840,298,542
False,8136050,"Oberkochen, Stadt",Insgesamt,8206,3970,4236
False,8136060,Rosenberg,unter 3 Jahre,76,47,29
False,8136060,Rosenberg,3 -  6 Jahre,95,53,42
False,8136060,Rosenberg,6 - 10 Jahre,131,65,66
False,8136060,Rosenberg,10 - 15 Jahre,217,109,108
False,8136060,Rosenberg,15 - 18 Jahre,120,63,57
False,8136060,Rosenberg,18 - 20 Jahre,71,41,30
False,8136060,Rosenberg,20 - 25 Jahre,173,89,84
False,8136060,Rosenberg,25 - 30 Jahre,140,69,71
False,8136060,Rosenberg,30 - 35 Jahre,123,76,47
False,8136060,Rosenberg,35 - 40 Jahre,196,94,102
False,8136060,Rosenberg,40 - 45 Jahre,246,134,112
False,8136060,Rosenberg,45 - 50 Jahre,218,112,106
False,8136060,Rosenberg,50 - 55 Jahre,186,95,91
False,8136060,Rosenberg,55 - 60 Jahre,123,71,52
False,8136060,Rosenberg,60 - 65 Jahre,103,57,46
False,8136060,Rosenberg,65 - 75 Jahre,218,111,107
False,8136060,Rosenberg,75 und mehr Jahre,186,64,122
False,8136060,Rosenberg,Insgesamt,2622,1350,1272
False,8136061,Ruppertshofen,unter 3 Jahre,53,27,26
False,8136061,Ruppertshofen,3 -  6 Jahre,67,36,31
False,8136061,Ruppertshofen,6 - 10 Jahre,107,50,57
False,8136061,Ruppertshofen,10 - 15 Jahre,174,103,71
False,8136061,Ruppertshofen,15 - 18 Jahre,95,40,55
False,8136061,Ruppertshofen,18 - 20 Jahre,53,23,30
False,8136061,Ruppertshofen,20 - 25 Jahre,115,62,53
False,8136061,Ruppertshofen,25 - 30 Jahre,95,48,47
False,8136061,Ruppertshofen,30 - 35 Jahre,101,40,61
False,8136061,Ruppertshofen,35 - 40 Jahre,167,71,96
False,8136061,Ruppertshofen,40 - 45 Jahre,178,90,88
False,8136061,Ruppertshofen,45 - 50 Jahre,159,89,70
False,8136061,Ruppertshofen,50 - 55 Jahre,129,70,59
False,8136061,Ruppertshofen,55 - 60 Jahre,75,42,33
False,8136061,Ruppertshofen,60 - 65 Jahre,63,26,37
False,8136061,Ruppertshofen,65 - 75 Jahre,149,75,74
False,8136061,Ruppertshofen,75 und mehr Jahre,91,37,54
False,8136061,Ruppertshofen,Insgesamt,1871,929,942
False,8136062,Schechingen,unter 3 Jahre,72,34,38
False,8136062,Schechingen,3 -  6 Jahre,78,39,39
False,8136062,Schechingen,6 - 10 Jahre,135,63,72
False,8136062,Schechingen,10 - 15 Jahre,189,90,99
False,8136062,Schechingen,15 - 18 Jahre,107,55,52
False,8136062,Schechingen,18 - 20 Jahre,66,34,32
False,8136062,Schechingen,20 - 25 Jahre,157,93,64
False,8136062,Schechingen,25 - 30 Jahre,119,48,71
False,8136062,Schechingen,30 - 35 Jahre,153,82,71
False,8136062,Schechingen,35 - 40 Jahre,204,93,111
False,8136062,Schechingen,40 - 45 Jahre,243,121,122
False,8136062,Schechingen,45 - 50 Jahre,208,104,104
False,8136062,Schechingen,50 - 55 Jahre,163,85,78
False,8136062,Schechingen,55 - 60 Jahre,128,72,56
False,8136062,Schechingen,60 - 65 Jahre,80,46,34
False,8136062,Schechingen,65 - 75 Jahre,181,75,106
False,8136062,Schechingen,75 und mehr Jahre,160,44,116
False,8136062,Schechingen,Insgesamt,2443,1178,1265
False,8136065,"Schwäbisch Gmünd, Stadt",unter 3 Jahre,1683,878,805
False,8136065,"Schwäbisch Gmünd, Stadt",3 -  6 Jahre,1728,892,836
False,8136065,"Schwäbisch Gmünd, Stadt",6 - 10 Jahre,2481,1286,1195
False,8136065,"Schwäbisch Gmünd, Stadt",10 - 15 Jahre,3324,1673,1651
False,8136065,"Schwäbisch Gmünd, Stadt",15 - 18 Jahre,2245,1142,1103
False,8136065,"Schwäbisch Gmünd, Stadt",18 - 20 Jahre,1507,759,748
False,8136065,"Schwäbisch Gmünd, Stadt",20 - 25 Jahre,4057,1957,2100
False,8136065,"Schwäbisch Gmünd, Stadt",25 - 30 Jahre,3684,1905,1779
False,8136065,"Schwäbisch Gmünd, Stadt",30 - 35 Jahre,3826,2002,1824
False,8136065,"Schwäbisch Gmünd, Stadt",35 - 40 Jahre,4443,2285,2158
False,8136065,"Schwäbisch Gmünd, Stadt",40 - 45 Jahre,4730,2458,2272
False,8136065,"Schwäbisch Gmünd, Stadt",45 - 50 Jahre,4423,2180,2243
False,8136065,"Schwäbisch Gmünd, Stadt",50 - 55 Jahre,3890,1877,2013
False,8136065,"Schwäbisch Gmünd, Stadt",55 - 60 Jahre,3617,1781,1836
False,8136065,"Schwäbisch Gmünd, Stadt",60 - 65 Jahre,3497,1729,1768
False,8136065,"Schwäbisch Gmünd, Stadt",65 - 75 Jahre,6578,3076,3502
False,8136065,"Schwäbisch Gmünd, Stadt",75 und mehr Jahre,5637,1817,3820
False,8136065,"Schwäbisch Gmünd, Stadt",Insgesamt,61350,29697,31653
False,8136066,Spraitbach,unter 3 Jahre,73,39,34
False,8136066,Spraitbach,3 -  6 Jahre,95,43,52
False,8136066,Spraitbach,6 - 10 Jahre,178,75,103
False,8136066,Spraitbach,10 - 15 Jahre,217,114,103
False,8136066,Spraitbach,15 - 18 Jahre,159,84,75
False,8136066,Spraitbach,18 - 20 Jahre,85,35,50
False,8136066,Spraitbach,20 - 25 Jahre,205,110,95
False,8136066,Spraitbach,25 - 30 Jahre,143,70,73
False,8136066,Spraitbach,30 - 35 Jahre,200,98,102
False,8136066,Spraitbach,35 - 40 Jahre,310,156,154
False,8136066,Spraitbach,40 - 45 Jahre,316,172,144
False,8136066,Spraitbach,45 - 50 Jahre,316,151,165
False,8136066,Spraitbach,50 - 55 Jahre,222,117,105
False,8136066,Spraitbach,55 - 60 Jahre,225,109,116
False,8136066,Spraitbach,60 - 65 Jahre,198,99,99
False,8136066,Spraitbach,65 - 75 Jahre,388,185,203
False,8136066,Spraitbach,75 und mehr Jahre,205,77,128
False,8136066,Spraitbach,Insgesamt,3535,1734,1801
False,8136068,Stödtlen,unter 3 Jahre,47,26,21
False,8136068,Stödtlen,3 -  6 Jahre,71,36,35
False,8136068,Stödtlen,6 - 10 Jahre,112,45,67
False,8136068,Stödtlen,10 - 15 Jahre,132,73,59
False,8136068,Stödtlen,15 - 18 Jahre,72,31,41
False,8136068,Stödtlen,18 - 20 Jahre,53,29,24
False,8136068,Stödtlen,20 - 25 Jahre,100,48,52
False,8136068,Stödtlen,25 - 30 Jahre,126,64,62
False,8136068,Stödtlen,30 - 35 Jahre,131,63,68
False,8136068,Stödtlen,35 - 40 Jahre,189,93,96
False,8136068,Stödtlen,40 - 45 Jahre,176,94,82
False,8136068,Stödtlen,45 - 50 Jahre,133,79,54
False,8136068,Stödtlen,50 - 55 Jahre,116,55,61
False,8136068,Stödtlen,55 - 60 Jahre,121,65,56
False,8136068,Stödtlen,60 - 65 Jahre,87,48,39
False,8136068,Stödtlen,65 - 75 Jahre,168,80,88
False,8136068,Stödtlen,75 und mehr Jahre,157,65,92
False,8136068,Stödtlen,Insgesamt,1991,994,997
False,8136070,Täferrot,unter 3 Jahre,39,14,25
False,8136070,Täferrot,3 -  6 Jahre,45,21,24
False,8136070,Täferrot,6 - 10 Jahre,50,20,30
False,8136070,Täferrot,10 - 15 Jahre,71,37,34
False,8136070,Täferrot,15 - 18 Jahre,35,17,18
False,8136070,Täferrot,18 - 20 Jahre,15,11,4
False,8136070,Täferrot,20 - 25 Jahre,43,22,21
False,8136070,Täferrot,25 - 30 Jahre,44,21,23
False,8136070,Täferrot,30 - 35 Jahre,94,40,54
False,8136070,Täferrot,35 - 40 Jahre,101,61,40
False,8136070,Täferrot,40 - 45 Jahre,101,50,51
False,8136070,Täferrot,45 - 50 Jahre,65,36,29
False,8136070,Täferrot,50 - 55 Jahre,55,26,29
False,8136070,Täferrot,55 - 60 Jahre,56,31,25
False,8136070,Täferrot,60 - 65 Jahre,63,35,28
False,8136070,Täferrot,65 - 75 Jahre,92,44,48
False,8136070,Täferrot,75 und mehr Jahre,63,25,38
False,8136070,Täferrot,Insgesamt,1032,511,521
False,8136071,Tannhausen,unter 3 Jahre,53,32,21
False,8136071,Tannhausen,3 -  6 Jahre,74,35,39
False,8136071,Tannhausen,6 - 10 Jahre,112,63,49
False,8136071,Tannhausen,10 - 15 Jahre,123,60,63
False,8136071,Tannhausen,15 - 18 Jahre,89,47,42
False,8136071,Tannhausen,18 - 20 Jahre,42,22,20
False,8136071,Tannhausen,20 - 25 Jahre,116,68,48
False,8136071,Tannhausen,25 - 30 Jahre,103,51,52
False,8136071,Tannhausen,30 - 35 Jahre,97,52,45
False,8136071,Tannhausen,35 - 40 Jahre,137,66,71
False,8136071,Tannhausen,40 - 45 Jahre,168,97,71
False,8136071,Tannhausen,45 - 50 Jahre,110,55,55
False,8136071,Tannhausen,50 - 55 Jahre,111,53,58
False,8136071,Tannhausen,55 - 60 Jahre,91,48,43
False,8136071,Tannhausen,60 - 65 Jahre,77,41,36
False,8136071,Tannhausen,65 - 75 Jahre,177,85,92
False,8136071,Tannhausen,75 und mehr Jahre,179,59,120
False,8136071,Tannhausen,Insgesamt,1859,934,925
False,8136075,Unterschneidheim,unter 3 Jahre,151,79,72
False,8136075,Unterschneidheim,3 -  6 Jahre,152,81,71
False,8136075,Unterschneidheim,6 - 10 Jahre,230,111,119
False,8136075,Unterschneidheim,10 - 15 Jahre,309,173,136
False,8136075,Unterschneidheim,15 - 18 Jahre,219,114,105
False,8136075,Unterschneidheim,18 - 20 Jahre,147,77,70
False,8136075,Unterschneidheim,20 - 25 Jahre,286,149,137
False,8136075,Unterschneidheim,25 - 30 Jahre,285,149,136
False,8136075,Unterschneidheim,30 - 35 Jahre,337,175,162
False,8136075,Unterschneidheim,35 - 40 Jahre,348,194,154
False,8136075,Unterschneidheim,40 - 45 Jahre,380,190,190
False,8136075,Unterschneidheim,45 - 50 Jahre,346,188,158
False,8136075,Unterschneidheim,50 - 55 Jahre,328,180,148
False,8136075,Unterschneidheim,55 - 60 Jahre,233,119,114
False,8136075,Unterschneidheim,60 - 65 Jahre,202,101,101
False,8136075,Unterschneidheim,65 - 75 Jahre,400,208,192
False,8136075,Unterschneidheim,75 und mehr Jahre,297,113,184
False,8136075,Unterschneidheim,Insgesamt,4650,2401,2249
False,8136079,Waldstetten,unter 3 Jahre,192,104,88
False,8136079,Waldstetten,3 -  6 Jahre,230,119,111
False,8136079,Waldstetten,6 - 10 Jahre,357,167,190
False,8136079,Waldstetten,10 - 15 Jahre,466,240,226
False,8136079,Waldstetten,15 - 18 Jahre,258,132,126
False,8136079,Waldstetten,18 - 20 Jahre,175,103,72
False,8136079,Waldstetten,20 - 25 Jahre,421,223,198
False,8136079,Waldstetten,25 - 30 Jahre,340,155,185
False,8136079,Waldstetten,30 - 35 Jahre,444,224,220
False,8136079,Waldstetten,35 - 40 Jahre,653,337,316
False,8136079,Waldstetten,40 - 45 Jahre,619,323,296
False,8136079,Waldstetten,45 - 50 Jahre,512,233,279
False,8136079,Waldstetten,50 - 55 Jahre,498,263,235
False,8136079,Waldstetten,55 - 60 Jahre,444,212,232
False,8136079,Waldstetten,60 - 65 Jahre,396,186,210
False,8136079,Waldstetten,65 - 75 Jahre,766,379,387
False,8136079,Waldstetten,75 und mehr Jahre,521,197,324
False,8136079,Waldstetten,Insgesamt,7292,3597,3695
False,8136082,Westhausen,unter 3 Jahre,167,92,75
False,8136082,Westhausen,3 -  6 Jahre,200,103,97
False,8136082,Westhausen,6 - 10 Jahre,312,155,157
False,8136082,Westhausen,10 - 15 Jahre,388,198,190
False,8136082,Westhausen,15 - 18 Jahre,226,123,103
False,8136082,Westhausen,18 - 20 Jahre,137,76,61
False,8136082,Westhausen,20 - 25 Jahre,326,159,167
False,8136082,Westhausen,25 - 30 Jahre,351,182,169
False,8136082,Westhausen,30 - 35 Jahre,405,194,211
False,8136082,Westhausen,35 - 40 Jahre,536,266,270
False,8136082,Westhausen,40 - 45 Jahre,488,248,240
False,8136082,Westhausen,45 - 50 Jahre,396,207,189
False,8136082,Westhausen,50 - 55 Jahre,382,195,187
False,8136082,Westhausen,55 - 60 Jahre,315,143,172
False,8136082,Westhausen,60 - 65 Jahre,325,170,155
False,8136082,Westhausen,65 - 75 Jahre,574,299,275
False,8136082,Westhausen,75 und mehr Jahre,350,118,232
False,8136082,Westhausen,Insgesamt,5878,2928,2950
False,8136084,Wört,unter 3 Jahre,37,21,16
False,8136084,Wört,3 -  6 Jahre,51,28,23
False,8136084,Wört,6 - 10 Jahre,71,38,33
False,8136084,Wört,10 - 15 Jahre,94,50,44
False,8136084,Wört,15 - 18 Jahre,59,36,23
False,8136084,Wört,18 - 20 Jahre,47,27,20
False,8136084,Wört,20 - 25 Jahre,103,47,56
False,8136084,Wört,25 - 30 Jahre,73,30,43
False,8136084,Wört,30 - 35 Jahre,125,67,58
False,8136084,Wört,35 - 40 Jahre,101,46,55
False,8136084,Wört,40 - 45 Jahre,120,61,59
False,8136084,Wört,45 - 50 Jahre,130,76,54
False,8136084,Wört,50 - 55 Jahre,90,45,45
False,8136084,Wört,55 - 60 Jahre,76,40,36
False,8136084,Wört,60 - 65 Jahre,52,24,28
False,8136084,Wört,65 - 75 Jahre,132,70,62
False,8136084,Wört,75 und mehr Jahre,77,28,49
False,8136084,Wört,Insgesamt,1438,734,704
False,8136087,Riesbürg,unter 3 Jahre,74,33,41
False,8136087,Riesbürg,3 -  6 Jahre,69,31,38
False,8136087,Riesbürg,6 - 10 Jahre,121,63,58
False,8136087,Riesbürg,10 - 15 Jahre,145,70,75
False,8136087,Riesbürg,15 - 18 Jahre,100,52,48
False,8136087,Riesbürg,18 - 20 Jahre,51,22,29
False,8136087,Riesbürg,20 - 25 Jahre,157,84,73
False,8136087,Riesbürg,25 - 30 Jahre,119,59,60
False,8136087,Riesbürg,30 - 35 Jahre,122,58,64
False,8136087,Riesbürg,35 - 40 Jahre,175,94,81
False,8136087,Riesbürg,40 - 45 Jahre,193,101,92
False,8136087,Riesbürg,45 - 50 Jahre,190,94,96
False,8136087,Riesbürg,50 - 55 Jahre,160,87,73
False,8136087,Riesbürg,55 - 60 Jahre,133,72,61
False,8136087,Riesbürg,60 - 65 Jahre,116,56,60
False,8136087,Riesbürg,65 - 75 Jahre,228,107,121
False,8136087,Riesbürg,75 und mehr Jahre,192,64,128
False,8136087,Riesbürg,Insgesamt,2345,1147,1198
False,8136088,"Aalen, Stadt",unter 3 Jahre,1897,936,961
False,8136088,"Aalen, Stadt",3 -  6 Jahre,2085,1112,973
False,8136088,"Aalen, Stadt",6 - 10 Jahre,3022,1569,1453
False,8136088,"Aalen, Stadt",10 - 15 Jahre,3807,1951,1856
False,8136088,"Aalen, Stadt",15 - 18 Jahre,2385,1238,1147
False,8136088,"Aalen, Stadt",18 - 20 Jahre,1519,777,742
False,8136088,"Aalen, Stadt",20 - 25 Jahre,3772,1920,1852
False,8136088,"Aalen, Stadt",25 - 30 Jahre,3937,2007,1930
False,8136088,"Aalen, Stadt",30 - 35 Jahre,4391,2237,2154
False,8136088,"Aalen, Stadt",35 - 40 Jahre,5485,2788,2697
False,8136088,"Aalen, Stadt",40 - 45 Jahre,5464,2905,2559
False,8136088,"Aalen, Stadt",45 - 50 Jahre,4723,2362,2361
False,8136088,"Aalen, Stadt",50 - 55 Jahre,4216,2089,2127
False,8136088,"Aalen, Stadt",55 - 60 Jahre,3731,1826,1905
False,8136088,"Aalen, Stadt",60 - 65 Jahre,3670,1840,1830
False,8136088,"Aalen, Stadt",65 - 75 Jahre,7178,3402,3776
False,8136088,"Aalen, Stadt",75 und mehr Jahre,5784,2030,3754
False,8136088,"Aalen, Stadt",Insgesamt,67066,32989,34077
False,8136089,Rainau,unter 3 Jahre,105,54,51
False,8136089,Rainau,3 -  6 Jahre,117,68,49
False,8136089,Rainau,6 - 10 Jahre,160,87,73
False,8136089,Rainau,10 - 15 Jahre,241,122,119
False,8136089,Rainau,15 - 18 Jahre,162,72,90
False,8136089,Rainau,18 - 20 Jahre,79,38,41
False,8136089,Rainau,20 - 25 Jahre,196,98,98
False,8136089,Rainau,25 - 30 Jahre,184,107,77
False,8136089,Rainau,30 - 35 Jahre,211,125,86
False,8136089,Rainau,35 - 40 Jahre,257,127,130
False,8136089,Rainau,40 - 45 Jahre,337,176,161
False,8136089,Rainau,45 - 50 Jahre,222,121,101
False,8136089,Rainau,50 - 55 Jahre,228,119,109
False,8136089,Rainau,55 - 60 Jahre,165,88,77
False,8136089,Rainau,60 - 65 Jahre,122,63,59
False,8136089,Rainau,65 - 75 Jahre,281,138,143
False,8136089,Rainau,75 und mehr Jahre,165,58,107
False,8136089,Rainau,Insgesamt,3232,1661,1571
False,82,Regierungsbezirk Karlsruhe,unter 3 Jahre,70844,36424,34420
False,82,Regierungsbezirk Karlsruhe,3 -  6 Jahre,75553,38712,36841
False,82,Regierungsbezirk Karlsruhe,6 - 10 Jahre,110320,56719,53601
False,82,Regierungsbezirk Karlsruhe,10 - 15 Jahre,144036,74056,69980
False,82,Regierungsbezirk Karlsruhe,15 - 18 Jahre,92057,47216,44841
False,82,Regierungsbezirk Karlsruhe,18 - 20 Jahre,60628,30854,29774
False,82,Regierungsbezirk Karlsruhe,20 - 25 Jahre,162952,81269,81683
False,82,Regierungsbezirk Karlsruhe,25 - 30 Jahre,164766,82228,82538
False,82,Regierungsbezirk Karlsruhe,30 - 35 Jahre,170675,85360,85315
False,82,Regierungsbezirk Karlsruhe,35 - 40 Jahre,227194,115750,111444
False,82,Regierungsbezirk Karlsruhe,40 - 45 Jahre,243748,124748,119000
False,82,Regierungsbezirk Karlsruhe,45 - 50 Jahre,211798,108047,103751
False,82,Regierungsbezirk Karlsruhe,50 - 55 Jahre,181308,90509,90799
False,82,Regierungsbezirk Karlsruhe,55 - 60 Jahre,160954,79861,81093
False,82,Regierungsbezirk Karlsruhe,60 - 65 Jahre,147088,72996,74092
False,82,Regierungsbezirk Karlsruhe,65 - 75 Jahre,288268,135926,152342
False,82,Regierungsbezirk Karlsruhe,75 und mehr Jahre,220266,75914,144352
False,82,Regierungsbezirk Karlsruhe,Insgesamt,2732455,1336589,1395866
False,8211,Stadtkreis Baden-Baden,unter 3 Jahre,1184,596,588
False,8211,Stadtkreis Baden-Baden,3 -  6 Jahre,1222,632,590
False,8211,Stadtkreis Baden-Baden,6 - 10 Jahre,1832,931,901
False,8211,Stadtkreis Baden-Baden,10 - 15 Jahre,2404,1245,1159
False,8211,Stadtkreis Baden-Baden,15 - 18 Jahre,1561,782,779
False,8211,Stadtkreis Baden-Baden,18 - 20 Jahre,1035,540,495
False,8211,Stadtkreis Baden-Baden,20 - 25 Jahre,2576,1255,1321
False,8211,Stadtkreis Baden-Baden,25 - 30 Jahre,2687,1275,1412
False,8211,Stadtkreis Baden-Baden,30 - 35 Jahre,2866,1357,1509
False,8211,Stadtkreis Baden-Baden,35 - 40 Jahre,4299,2073,2226
False,8211,Stadtkreis Baden-Baden,40 - 45 Jahre,4406,2153,2253
False,8211,Stadtkreis Baden-Baden,45 - 50 Jahre,4018,1930,2088
False,8211,Stadtkreis Baden-Baden,50 - 55 Jahre,3611,1723,1888
False,8211,Stadtkreis Baden-Baden,55 - 60 Jahre,3616,1710,1906
False,8211,Stadtkreis Baden-Baden,60 - 65 Jahre,3457,1579,1878
False,8211,Stadtkreis Baden-Baden,65 - 75 Jahre,7103,3179,3924
False,8211,Stadtkreis Baden-Baden,75 und mehr Jahre,6704,2204,4500
False,8211,Stadtkreis Baden-Baden,Insgesamt,54581,25164,29417
False,8211000,"Baden-Baden, Stadt",unter 3 Jahre,1184,596,588
False,8211000,"Baden-Baden, Stadt",3 -  6 Jahre,1222,632,590
False,8211000,"Baden-Baden, Stadt",6 - 10 Jahre,1832,931,901
False,8211000,"Baden-Baden, Stadt",10 - 15 Jahre,2404,1245,1159
False,8211000,"Baden-Baden, Stadt",15 - 18 Jahre,1561,782,779
False,8211000,"Baden-Baden, Stadt",18 - 20 Jahre,1035,540,495
False,8211000,"Baden-Baden, Stadt",20 - 25 Jahre,2576,1255,1321
False,8211000,"Baden-Baden, Stadt",25 - 30 Jahre,2687,1275,1412
False,8211000,"Baden-Baden, Stadt",30 - 35 Jahre,2866,1357,1509
False,8211000,"Baden-Baden, Stadt",35 - 40 Jahre,4299,2073,2226
False,8211000,"Baden-Baden, Stadt",40 - 45 Jahre,4406,2153,2253
False,8211000,"Baden-Baden, Stadt",45 - 50 Jahre,4018,1930,2088
False,8211000,"Baden-Baden, Stadt",50 - 55 Jahre,3611,1723,1888
False,8211000,"Baden-Baden, Stadt",55 - 60 Jahre,3616,1710,1906
False,8211000,"Baden-Baden, Stadt",60 - 65 Jahre,3457,1579,1878
False,8211000,"Baden-Baden, Stadt",65 - 75 Jahre,7103,3179,3924
False,8211000,"Baden-Baden, Stadt",75 und mehr Jahre,6704,2204,4500
False,8211000,"Baden-Baden, Stadt",Insgesamt,54581,25164,29417
False,8212,Stadtkreis Karlsruhe,unter 3 Jahre,7439,3842,3597
False,8212,Stadtkreis Karlsruhe,3 -  6 Jahre,7030,3636,3394
False,8212,Stadtkreis Karlsruhe,6 - 10 Jahre,9589,4896,4693
False,8212,Stadtkreis Karlsruhe,10 - 15 Jahre,12156,6293,5863
False,8212,Stadtkreis Karlsruhe,15 - 18 Jahre,7646,3914,3732
False,8212,Stadtkreis Karlsruhe,18 - 20 Jahre,5525,2795,2730
False,8212,Stadtkreis Karlsruhe,20 - 25 Jahre,18818,9937,8881
False,8212,Stadtkreis Karlsruhe,25 - 30 Jahre,21440,11190,10250
False,8212,Stadtkreis Karlsruhe,30 - 35 Jahre,21186,11123,10063
False,8212,Stadtkreis Karlsruhe,35 - 40 Jahre,24985,13248,11737
False,8212,Stadtkreis Karlsruhe,40 - 45 Jahre,24357,12694,11663
False,8212,Stadtkreis Karlsruhe,45 - 50 Jahre,21208,11135,10073
False,8212,Stadtkreis Karlsruhe,50 - 55 Jahre,17799,8827,8972
False,8212,Stadtkreis Karlsruhe,55 - 60 Jahre,16116,7866,8250
False,8212,Stadtkreis Karlsruhe,60 - 65 Jahre,15501,7496,8005
False,8212,Stadtkreis Karlsruhe,65 - 75 Jahre,29199,13386,15813
False,8212,Stadtkreis Karlsruhe,75 und mehr Jahre,25269,8310,16959
False,8212,Stadtkreis Karlsruhe,Insgesamt,285263,140588,144675
False,8212000,"Karlsruhe, Stadt",unter 3 Jahre,7439,3842,3597
False,8212000,"Karlsruhe, Stadt",3 -  6 Jahre,7030,3636,3394
False,8212000,"Karlsruhe, Stadt",6 - 10 Jahre,9589,4896,4693
False,8212000,"Karlsruhe, Stadt",10 - 15 Jahre,12156,6293,5863
False,8212000,"Karlsruhe, Stadt",15 - 18 Jahre,7646,3914,3732
False,8212000,"Karlsruhe, Stadt",18 - 20 Jahre,5525,2795,2730
False,8212000,"Karlsruhe, Stadt",20 - 25 Jahre,18818,9937,8881
False,8212000,"Karlsruhe, Stadt",25 - 30 Jahre,21440,11190,10250
False,8212000,"Karlsruhe, Stadt",30 - 35 Jahre,21186,11123,10063
False,8212000,"Karlsruhe, Stadt",35 - 40 Jahre,24985,13248,11737
False,8212000,"Karlsruhe, Stadt",40 - 45 Jahre,24357,12694,11663
False,8212000,"Karlsruhe, Stadt",45 - 50 Jahre,21208,11135,10073
False,8212000,"Karlsruhe, Stadt",50 - 55 Jahre,17799,8827,8972
False,8212000,"Karlsruhe, Stadt",55 - 60 Jahre,16116,7866,8250
False,8212000,"Karlsruhe, Stadt",60 - 65 Jahre,15501,7496,8005
False,8212000,"Karlsruhe, Stadt",65 - 75 Jahre,29199,13386,15813
False,8212000,"Karlsruhe, Stadt",75 und mehr Jahre,25269,8310,16959
False,8212000,"Karlsruhe, Stadt",Insgesamt,285263,140588,144675
False,8215,Landkreis Karlsruhe,unter 3 Jahre,11090,5777,5313
False,8215,Landkreis Karlsruhe,3 -  6 Jahre,12348,6308,6040
False,8215,Landkreis Karlsruhe,6 - 10 Jahre,18765,9734,9031
False,8215,Landkreis Karlsruhe,10 - 15 Jahre,24263,12509,11754
False,8215,Landkreis Karlsruhe,15 - 18 Jahre,15244,7781,7463
False,8215,Landkreis Karlsruhe,18 - 20 Jahre,9911,5168,4743
False,8215,Landkreis Karlsruhe,20 - 25 Jahre,23563,12109,11454
False,8215,Landkreis Karlsruhe,25 - 30 Jahre,23126,11480,11646
False,8215,Landkreis Karlsruhe,30 - 35 Jahre,25381,12569,12812
False,8215,Landkreis Karlsruhe,35 - 40 Jahre,35328,17727,17601
False,8215,Landkreis Karlsruhe,40 - 45 Jahre,38764,19824,18940
False,8215,Landkreis Karlsruhe,45 - 50 Jahre,34243,17400,16843
False,8215,Landkreis Karlsruhe,50 - 55 Jahre,29920,14970,14950
False,8215,Landkreis Karlsruhe,55 - 60 Jahre,26282,13114,13168
False,8215,Landkreis Karlsruhe,60 - 65 Jahre,22973,11468,11505
False,8215,Landkreis Karlsruhe,65 - 75 Jahre,45920,21928,23992
False,8215,Landkreis Karlsruhe,75 und mehr Jahre,32482,11522,20960
False,8215,Landkreis Karlsruhe,Insgesamt,429603,211388,218215
False,8215007,"Bretten, Stadt",unter 3 Jahre,801,412,389
False,8215007,"Bretten, Stadt",3 -  6 Jahre,885,467,418
False,8215007,"Bretten, Stadt",6 - 10 Jahre,1304,694,610
False,8215007,"Bretten, Stadt",10 - 15 Jahre,1616,847,769
False,8215007,"Bretten, Stadt",15 - 18 Jahre,1052,553,499
False,8215007,"Bretten, Stadt",18 - 20 Jahre,616,317,299
False,8215007,"Bretten, Stadt",20 - 25 Jahre,1575,826,749
False,8215007,"Bretten, Stadt",25 - 30 Jahre,1619,778,841
False,8215007,"Bretten, Stadt",30 - 35 Jahre,1818,868,950
False,8215007,"Bretten, Stadt",35 - 40 Jahre,2291,1170,1121
False,8215007,"Bretten, Stadt",40 - 45 Jahre,2305,1188,1117
False,8215007,"Bretten, Stadt",45 - 50 Jahre,2042,1014,1028
False,8215007,"Bretten, Stadt",50 - 55 Jahre,2054,1035,1019
False,8215007,"Bretten, Stadt",55 - 60 Jahre,1679,836,843
False,8215007,"Bretten, Stadt",60 - 65 Jahre,1475,758,717
False,8215007,"Bretten, Stadt",65 - 75 Jahre,2810,1334,1476
False,8215007,"Bretten, Stadt",75 und mehr Jahre,2155,766,1389
False,8215007,"Bretten, Stadt",Insgesamt,28097,13863,14234
False,8215009,"Bruchsal, Stadt",unter 3 Jahre,1246,641,605
False,8215009,"Bruchsal, Stadt",3 -  6 Jahre,1230,651,579
False,8215009,"Bruchsal, Stadt",6 - 10 Jahre,1764,899,865
False,8215009,"Bruchsal, Stadt",10 - 15 Jahre,2191,1134,1057
False,8215009,"Bruchsal, Stadt",15 - 18 Jahre,1433,768,665
False,8215009,"Bruchsal, Stadt",18 - 20 Jahre,978,493,485
False,8215009,"Bruchsal, Stadt",20 - 25 Jahre,2443,1209,1234
False,8215009,"Bruchsal, Stadt",25 - 30 Jahre,2808,1415,1393
False,8215009,"Bruchsal, Stadt",30 - 35 Jahre,2789,1438,1351
False,8215009,"Bruchsal, Stadt",35 - 40 Jahre,3523,1756,1767
False,8215009,"Bruchsal, Stadt",40 - 45 Jahre,3601,1907,1694
False,8215009,"Bruchsal, Stadt",45 - 50 Jahre,3340,1756,1584
False,8215009,"Bruchsal, Stadt",50 - 55 Jahre,2934,1484,1450
False,8215009,"Bruchsal, Stadt",55 - 60 Jahre,2593,1318,1275
False,8215009,"Bruchsal, Stadt",60 - 65 Jahre,2220,1144,1076
False,8215009,"Bruchsal, Stadt",65 - 75 Jahre,4459,2020,2439
False,8215009,"Bruchsal, Stadt",75 und mehr Jahre,3339,1128,2211
False,8215009,"Bruchsal, Stadt",Insgesamt,42891,21161,21730
False,8215017,"Ettlingen, Stadt",unter 3 Jahre,881,472,409
False,8215017,"Ettlingen, Stadt",3 -  6 Jahre,1006,500,506
False,8215017,"Ettlingen, Stadt",6 - 10 Jahre,1450,761,689
False,8215017,"Ettlingen, Stadt",10 - 15 Jahre,2006,1048,958
False,8215017,"Ettlingen, Stadt",15 - 18 Jahre,1226,599,627
False,8215017,"Ettlingen, Stadt",18 - 20 Jahre,796,415,381
False,8215017,"Ettlingen, Stadt",20 - 25 Jahre,1857,926,931
False,8215017,"Ettlingen, Stadt",25 - 30 Jahre,1900,973,927
False,8215017,"Ettlingen, Stadt",30 - 35 Jahre,2169,1049,1120
False,8215017,"Ettlingen, Stadt",35 - 40 Jahre,2952,1494,1458
False,8215017,"Ettlingen, Stadt",40 - 45 Jahre,3442,1723,1719
False,8215017,"Ettlingen, Stadt",45 - 50 Jahre,2950,1466,1484
False,8215017,"Ettlingen, Stadt",50 - 55 Jahre,2669,1246,1423
False,8215017,"Ettlingen, Stadt",55 - 60 Jahre,2548,1211,1337
False,8215017,"Ettlingen, Stadt",60 - 65 Jahre,2657,1242,1415
False,8215017,"Ettlingen, Stadt",65 - 75 Jahre,4946,2379,2567
False,8215017,"Ettlingen, Stadt",75 und mehr Jahre,3571,1284,2287
False,8215017,"Ettlingen, Stadt",Insgesamt,39026,18788,20238
False,8215021,Forst,unter 3 Jahre,200,90,110
False,8215021,Forst,3 -  6 Jahre,204,100,104
False,8215021,Forst,6 - 10 Jahre,284,158,126
False,8215021,Forst,10 - 15 Jahre,409,213,196
False,8215021,Forst,15 - 18 Jahre,243,131,112
False,8215021,Forst,18 - 20 Jahre,146,92,54
False,8215021,Forst,20 - 25 Jahre,409,224,185
False,8215021,Forst,25 - 30 Jahre,396,191,205
False,8215021,Forst,30 - 35 Jahre,489,244,245
False,8215021,Forst,35 - 40 Jahre,660,329,331
False,8215021,Forst,40 - 45 Jahre,733,384,349
False,8215021,Forst,45 - 50 Jahre,602,303,299
False,8215021,Forst,50 - 55 Jahre,552,277,275
False,8215021,Forst,55 - 60 Jahre,501,257,244
False,8215021,Forst,60 - 65 Jahre,394,189,205
False,8215021,Forst,65 - 75 Jahre,761,376,385
False,8215021,Forst,75 und mehr Jahre,539,200,339
False,8215021,Forst,Insgesamt,7522,3758,3764
False,8215025,Gondelsheim,unter 3 Jahre,79,42,37
False,8215025,Gondelsheim,3 -  6 Jahre,89,50,39
False,8215025,Gondelsheim,6 - 10 Jahre,175,96,79
False,8215025,Gondelsheim,10 - 15 Jahre,201,97,104
False,8215025,Gondelsheim,15 - 18 Jahre,128,71,57
False,8215025,Gondelsheim,18 - 20 Jahre,84,37,47
False,8215025,Gondelsheim,20 - 25 Jahre,192,96,96
False,8215025,Gondelsheim,25 - 30 Jahre,182,92,90
False,8215025,Gondelsheim,30 - 35 Jahre,218,97,121
False,8215025,Gondelsheim,35 - 40 Jahre,256,135,121
False,8215025,Gondelsheim,40 - 45 Jahre,295,153,142
False,8215025,Gondelsheim,45 - 50 Jahre,270,144,126
False,8215025,Gondelsheim,50 - 55 Jahre,236,118,118
False,8215025,Gondelsheim,55 - 60 Jahre,188,95,93
False,8215025,Gondelsheim,60 - 65 Jahre,169,80,89
False,8215025,Gondelsheim,65 - 75 Jahre,281,128,153
False,8215025,Gondelsheim,75 und mehr Jahre,182,61,121
False,8215025,Gondelsheim,Insgesamt,3225,1592,1633
False,8215029,Hambrücken,unter 3 Jahre,155,73,82
False,8215029,Hambrücken,3 -  6 Jahre,192,104,88
False,8215029,Hambrücken,6 - 10 Jahre,265,133,132
False,8215029,Hambrücken,10 - 15 Jahre,341,165,176
False,8215029,Hambrücken,15 - 18 Jahre,211,111,100
False,8215029,Hambrücken,18 - 20 Jahre,134,76,58
False,8215029,Hambrücken,20 - 25 Jahre,316,158,158
False,8215029,Hambrücken,25 - 30 Jahre,325,159,166
False,8215029,Hambrücken,30 - 35 Jahre,344,161,183
False,8215029,Hambrücken,35 - 40 Jahre,483,233,250
False,8215029,Hambrücken,40 - 45 Jahre,524,273,251
False,8215029,Hambrücken,45 - 50 Jahre,488,259,229
False,8215029,Hambrücken,50 - 55 Jahre,348,173,175
False,8215029,Hambrücken,55 - 60 Jahre,299,159,140
False,8215029,Hambrücken,60 - 65 Jahre,206,111,95
False,8215029,Hambrücken,65 - 75 Jahre,495,243,252
False,8215029,Hambrücken,75 und mehr Jahre,264,101,163
False,8215029,Hambrücken,Insgesamt,5390,2692,2698
False,8215039,Kronau,unter 3 Jahre,154,87,67
False,8215039,Kronau,3 -  6 Jahre,152,71,81
False,8215039,Kronau,6 - 10 Jahre,248,124,124
False,8215039,Kronau,10 - 15 Jahre,353,166,187
False,8215039,Kronau,15 - 18 Jahre,218,119,99
False,8215039,Kronau,18 - 20 Jahre,143,85,58
False,8215039,Kronau,20 - 25 Jahre,327,153,174
False,8215039,Kronau,25 - 30 Jahre,318,150,168
False,8215039,Kronau,30 - 35 Jahre,362,165,197
False,8215039,Kronau,35 - 40 Jahre,498,247,251
False,8215039,Kronau,40 - 45 Jahre,510,260,250
False,8215039,Kronau,45 - 50 Jahre,483,244,239
False,8215039,Kronau,50 - 55 Jahre,422,209,213
False,8215039,Kronau,55 - 60 Jahre,342,184,158
False,8215039,Kronau,60 - 65 Jahre,223,107,116
False,8215039,Kronau,65 - 75 Jahre,553,268,285
False,8215039,Kronau,75 und mehr Jahre,320,97,223
False,8215039,Kronau,Insgesamt,5626,2736,2890
False,8215040,Kürnbach,unter 3 Jahre,57,25,32
False,8215040,Kürnbach,3 -  6 Jahre,73,34,39
False,8215040,Kürnbach,6 - 10 Jahre,92,52,40
False,8215040,Kürnbach,10 - 15 Jahre,132,74,58
False,8215040,Kürnbach,15 - 18 Jahre,90,50,40
False,8215040,Kürnbach,18 - 20 Jahre,48,29,19
False,8215040,Kürnbach,20 - 25 Jahre,169,96,73
False,8215040,Kürnbach,25 - 30 Jahre,112,56,56
False,8215040,Kürnbach,30 - 35 Jahre,126,55,71
False,8215040,Kürnbach,35 - 40 Jahre,202,108,94
False,8215040,Kürnbach,40 - 45 Jahre,198,99,99
False,8215040,Kürnbach,45 - 50 Jahre,182,97,85
False,8215040,Kürnbach,50 - 55 Jahre,162,77,85
False,8215040,Kürnbach,55 - 60 Jahre,142,71,71
False,8215040,Kürnbach,60 - 65 Jahre,119,63,56
False,8215040,Kürnbach,65 - 75 Jahre,275,125,150
False,8215040,Kürnbach,75 und mehr Jahre,261,88,173
False,8215040,Kürnbach,Insgesamt,2440,1199,1241
False,8215046,Malsch,unter 3 Jahre,370,201,169
False,8215046,Malsch,3 -  6 Jahre,402,189,213
False,8215046,Malsch,6 - 10 Jahre,653,356,297
False,8215046,Malsch,10 - 15 Jahre,840,444,396
False,8215046,Malsch,15 - 18 Jahre,498,237,261
False,8215046,Malsch,18 - 20 Jahre,351,180,171
False,8215046,Malsch,20 - 25 Jahre,747,388,359
False,8215046,Malsch,25 - 30 Jahre,697,362,335
False,8215046,Malsch,30 - 35 Jahre,777,367,410
False,8215046,Malsch,35 - 40 Jahre,1283,618,665
False,8215046,Malsch,40 - 45 Jahre,1406,727,679
False,8215046,Malsch,45 - 50 Jahre,1198,620,578
False,8215046,Malsch,50 - 55 Jahre,968,474,494
False,8215046,Malsch,55 - 60 Jahre,868,429,439
False,8215046,Malsch,60 - 65 Jahre,716,357,359
False,8215046,Malsch,65 - 75 Jahre,1534,737,797
False,8215046,Malsch,75 und mehr Jahre,1056,381,675
False,8215046,Malsch,Insgesamt,14364,7067,7297
False,8215047,Marxzell,unter 3 Jahre,129,74,55
False,8215047,Marxzell,3 -  6 Jahre,145,81,64
False,8215047,Marxzell,6 - 10 Jahre,190,102,88
False,8215047,Marxzell,10 - 15 Jahre,310,166,144
False,8215047,Marxzell,15 - 18 Jahre,215,107,108
False,8215047,Marxzell,18 - 20 Jahre,122,67,55
False,8215047,Marxzell,20 - 25 Jahre,239,126,113
False,8215047,Marxzell,25 - 30 Jahre,251,116,135
False,8215047,Marxzell,30 - 35 Jahre,267,150,117
False,8215047,Marxzell,35 - 40 Jahre,423,209,214
False,8215047,Marxzell,40 - 45 Jahre,470,220,250
False,8215047,Marxzell,45 - 50 Jahre,459,226,233
False,8215047,Marxzell,50 - 55 Jahre,388,204,184
False,8215047,Marxzell,55 - 60 Jahre,313,176,137
False,8215047,Marxzell,60 - 65 Jahre,271,152,119
False,8215047,Marxzell,65 - 75 Jahre,639,303,336
False,8215047,Marxzell,75 und mehr Jahre,604,201,403
False,8215047,Marxzell,Insgesamt,5435,2680,2755
False,8215059,Oberderdingen,unter 3 Jahre,326,172,154
False,8215059,Oberderdingen,3 -  6 Jahre,360,198,162
False,8215059,Oberderdingen,6 - 10 Jahre,531,272,259
False,8215059,Oberderdingen,10 - 15 Jahre,674,373,301
False,8215059,Oberderdingen,15 - 18 Jahre,442,227,215
False,8215059,Oberderdingen,18 - 20 Jahre,276,129,147
False,8215059,Oberderdingen,20 - 25 Jahre,676,337,339
False,8215059,Oberderdingen,25 - 30 Jahre,645,327,318
False,8215059,Oberderdingen,30 - 35 Jahre,664,349,315
False,8215059,Oberderdingen,35 - 40 Jahre,937,460,477
False,8215059,Oberderdingen,40 - 45 Jahre,930,487,443
False,8215059,Oberderdingen,45 - 50 Jahre,806,425,381
False,8215059,Oberderdingen,50 - 55 Jahre,664,334,330
False,8215059,Oberderdingen,55 - 60 Jahre,528,251,277
False,8215059,Oberderdingen,60 - 65 Jahre,470,233,237
False,8215059,Oberderdingen,65 - 75 Jahre,964,438,526
False,8215059,Oberderdingen,75 und mehr Jahre,732,282,450
False,8215059,Oberderdingen,Insgesamt,10625,5294,5331
False,8215064,"Östringen, Stadt",unter 3 Jahre,363,207,156
False,8215064,"Östringen, Stadt",3 -  6 Jahre,414,210,204
False,8215064,"Östringen, Stadt",6 - 10 Jahre,612,298,314
False,8215064,"Östringen, Stadt",10 - 15 Jahre,773,416,357
False,8215064,"Östringen, Stadt",15 - 18 Jahre,496,241,255
False,8215064,"Östringen, Stadt",18 - 20 Jahre,308,179,129
False,8215064,"Östringen, Stadt",20 - 25 Jahre,815,422,393
False,8215064,"Östringen, Stadt",25 - 30 Jahre,733,390,343
False,8215064,"Östringen, Stadt",30 - 35 Jahre,831,440,391
False,8215064,"Östringen, Stadt",35 - 40 Jahre,1042,543,499
False,8215064,"Östringen, Stadt",40 - 45 Jahre,1201,604,597
False,8215064,"Östringen, Stadt",45 - 50 Jahre,1022,519,503
False,8215064,"Östringen, Stadt",50 - 55 Jahre,850,433,417
False,8215064,"Östringen, Stadt",55 - 60 Jahre,794,418,376
False,8215064,"Östringen, Stadt",60 - 65 Jahre,574,271,303
False,8215064,"Östringen, Stadt",65 - 75 Jahre,1333,659,674
False,8215064,"Östringen, Stadt",75 und mehr Jahre,842,309,533
False,8215064,"Östringen, Stadt",Insgesamt,13003,6559,6444
False,8215066,"Philippsburg, Stadt",unter 3 Jahre,361,192,169
False,8215066,"Philippsburg, Stadt",3 -  6 Jahre,410,206,204
False,8215066,"Philippsburg, Stadt",6 - 10 Jahre,571,315,256
False,8215066,"Philippsburg, Stadt",10 - 15 Jahre,736,403,333
False,8215066,"Philippsburg, Stadt",15 - 18 Jahre,500,239,261
False,8215066,"Philippsburg, Stadt",18 - 20 Jahre,269,131,138
False,8215066,"Philippsburg, Stadt",20 - 25 Jahre,806,413,393
False,8215066,"Philippsburg, Stadt",25 - 30 Jahre,773,402,371
False,8215066,"Philippsburg, Stadt",30 - 35 Jahre,744,364,380
False,8215066,"Philippsburg, Stadt",35 - 40 Jahre,941,474,467
False,8215066,"Philippsburg, Stadt",40 - 45 Jahre,1036,541,495
False,8215066,"Philippsburg, Stadt",45 - 50 Jahre,954,484,470
False,8215066,"Philippsburg, Stadt",50 - 55 Jahre,915,442,473
False,8215066,"Philippsburg, Stadt",55 - 60 Jahre,762,408,354
False,8215066,"Philippsburg, Stadt",60 - 65 Jahre,651,311,340
False,8215066,"Philippsburg, Stadt",65 - 75 Jahre,1247,606,641
False,8215066,"Philippsburg, Stadt",75 und mehr Jahre,886,294,592
False,8215066,"Philippsburg, Stadt",Insgesamt,12562,6225,6337
False,8215082,Sulzfeld,unter 3 Jahre,127,72,55
False,8215082,Sulzfeld,3 -  6 Jahre,146,82,64
False,8215082,Sulzfeld,6 - 10 Jahre,224,133,91
False,8215082,Sulzfeld,10 - 15 Jahre,320,156,164
False,8215082,Sulzfeld,15 - 18 Jahre,168,82,86
False,8215082,Sulzfeld,18 - 20 Jahre,128,74,54
False,8215082,Sulzfeld,20 - 25 Jahre,251,142,109
False,8215082,Sulzfeld,25 - 30 Jahre,242,124,118
False,8215082,Sulzfeld,30 - 35 Jahre,265,138,127
False,8215082,Sulzfeld,35 - 40 Jahre,388,201,187
False,8215082,Sulzfeld,40 - 45 Jahre,430,206,224
False,8215082,Sulzfeld,45 - 50 Jahre,352,195,157
False,8215082,Sulzfeld,50 - 55 Jahre,279,145,134
False,8215082,Sulzfeld,55 - 60 Jahre,250,114,136
False,8215082,Sulzfeld,60 - 65 Jahre,259,128,131
False,8215082,Sulzfeld,65 - 75 Jahre,542,262,280
False,8215082,Sulzfeld,75 und mehr Jahre,319,132,187
False,8215082,Sulzfeld,Insgesamt,4690,2386,2304
False,8215084,Ubstadt-Weiher,unter 3 Jahre,342,169,173
False,8215084,Ubstadt-Weiher,3 -  6 Jahre,352,178,174
False,8215084,Ubstadt-Weiher,6 - 10 Jahre,614,329,285
False,8215084,Ubstadt-Weiher,10 - 15 Jahre,745,386,359
False,8215084,Ubstadt-Weiher,15 - 18 Jahre,500,271,229
False,8215084,Ubstadt-Weiher,18 - 20 Jahre,358,191,167
False,8215084,Ubstadt-Weiher,20 - 25 Jahre,717,354,363
False,8215084,Ubstadt-Weiher,25 - 30 Jahre,696,358,338
False,8215084,Ubstadt-Weiher,30 - 35 Jahre,769,378,391
False,8215084,Ubstadt-Weiher,35 - 40 Jahre,1054,525,529
False,8215084,Ubstadt-Weiher,40 - 45 Jahre,1228,622,606
False,8215084,Ubstadt-Weiher,45 - 50 Jahre,1054,522,532
False,8215084,Ubstadt-Weiher,50 - 55 Jahre,891,466,425
False,8215084,Ubstadt-Weiher,55 - 60 Jahre,679,347,332
False,8215084,Ubstadt-Weiher,60 - 65 Jahre,630,310,320
False,8215084,Ubstadt-Weiher,65 - 75 Jahre,1263,593,670
False,8215084,Ubstadt-Weiher,75 und mehr Jahre,891,334,557
False,8215084,Ubstadt-Weiher,Insgesamt,12783,6333,6450
False,8215089,Walzbachtal,unter 3 Jahre,255,133,122
False,8215089,Walzbachtal,3 -  6 Jahre,287,152,135
False,8215089,Walzbachtal,6 - 10 Jahre,412,211,201
False,8215089,Walzbachtal,10 - 15 Jahre,595,291,304
False,8215089,Walzbachtal,15 - 18 Jahre,318,157,161
False,8215089,Walzbachtal,18 - 20 Jahre,207,112,95
False,8215089,Walzbachtal,20 - 25 Jahre,443,222,221
False,8215089,Walzbachtal,25 - 30 Jahre,463,224,239
False,8215089,Walzbachtal,30 - 35 Jahre,510,254,256
False,8215089,Walzbachtal,35 - 40 Jahre,804,380,424
False,8215089,Walzbachtal,40 - 45 Jahre,827,425,402
False,8215089,Walzbachtal,45 - 50 Jahre,752,367,385
False,8215089,Walzbachtal,50 - 55 Jahre,646,337,309
False,8215089,Walzbachtal,55 - 60 Jahre,518,246,272
False,8215089,Walzbachtal,60 - 65 Jahre,446,226,220
False,8215089,Walzbachtal,65 - 75 Jahre,960,470,490
False,8215089,Walzbachtal,75 und mehr Jahre,670,235,435
False,8215089,Walzbachtal,Insgesamt,9113,4442,4671
False,8215090,Weingarten (Baden),unter 3 Jahre,289,149,140
False,8215090,Weingarten (Baden),3 -  6 Jahre,275,135,140
False,8215090,Weingarten (Baden),6 - 10 Jahre,431,225,206
False,8215090,Weingarten (Baden),10 - 15 Jahre,522,259,263
False,8215090,Weingarten (Baden),15 - 18 Jahre,283,151,132
False,8215090,Weingarten (Baden),18 - 20 Jahre,197,112,85
False,8215090,Weingarten (Baden),20 - 25 Jahre,480,243,237
False,8215090,Weingarten (Baden),25 - 30 Jahre,458,204,254
False,8215090,Weingarten (Baden),30 - 35 Jahre,587,278,309
False,8215090,Weingarten (Baden),35 - 40 Jahre,842,411,431
False,8215090,Weingarten (Baden),40 - 45 Jahre,949,496,453
False,8215090,Weingarten (Baden),45 - 50 Jahre,647,322,325
False,8215090,Weingarten (Baden),50 - 55 Jahre,639,319,320
False,8215090,Weingarten (Baden),55 - 60 Jahre,549,271,278
False,8215090,Weingarten (Baden),60 - 65 Jahre,532,262,270
False,8215090,Weingarten (Baden),65 - 75 Jahre,1031,483,548
False,8215090,Weingarten (Baden),75 und mehr Jahre,906,308,598
False,8215090,Weingarten (Baden),Insgesamt,9617,4628,4989
False,8215094,Zaisenhausen,unter 3 Jahre,42,25,17
False,8215094,Zaisenhausen,3 -  6 Jahre,50,26,24
False,8215094,Zaisenhausen,6 - 10 Jahre,86,54,32
False,8215094,Zaisenhausen,10 - 15 Jahre,106,68,38
False,8215094,Zaisenhausen,15 - 18 Jahre,82,40,42
False,8215094,Zaisenhausen,18 - 20 Jahre,50,23,27
False,8215094,Zaisenhausen,20 - 25 Jahre,114,56,58
False,8215094,Zaisenhausen,25 - 30 Jahre,69,37,32
False,8215094,Zaisenhausen,30 - 35 Jahre,92,55,37
False,8215094,Zaisenhausen,35 - 40 Jahre,152,83,69
False,8215094,Zaisenhausen,40 - 45 Jahre,171,82,89
False,8215094,Zaisenhausen,45 - 50 Jahre,137,73,64
False,8215094,Zaisenhausen,50 - 55 Jahre,91,45,46
False,8215094,Zaisenhausen,55 - 60 Jahre,87,46,41
False,8215094,Zaisenhausen,60 - 65 Jahre,94,49,45
False,8215094,Zaisenhausen,65 - 75 Jahre,195,87,108
False,8215094,Zaisenhausen,75 und mehr Jahre,103,32,71
False,8215094,Zaisenhausen,Insgesamt,1721,881,840
False,8215096,Karlsbad,unter 3 Jahre,397,185,212
False,8215096,Karlsbad,3 -  6 Jahre,439,222,217
False,8215096,Karlsbad,6 - 10 Jahre,737,360,377
False,8215096,Karlsbad,10 - 15 Jahre,938,484,454
False,8215096,Karlsbad,15 - 18 Jahre,621,338,283
False,8215096,Karlsbad,18 - 20 Jahre,386,186,200
False,8215096,Karlsbad,20 - 25 Jahre,883,462,421
False,8215096,Karlsbad,25 - 30 Jahre,859,399,460
False,8215096,Karlsbad,30 - 35 Jahre,890,437,453
False,8215096,Karlsbad,35 - 40 Jahre,1312,640,672
False,8215096,Karlsbad,40 - 45 Jahre,1423,689,734
False,8215096,Karlsbad,45 - 50 Jahre,1346,664,682
False,8215096,Karlsbad,50 - 55 Jahre,1196,584,612
False,8215096,Karlsbad,55 - 60 Jahre,1028,544,484
False,8215096,Karlsbad,60 - 65 Jahre,833,411,422
False,8215096,Karlsbad,65 - 75 Jahre,1687,829,858
False,8215096,Karlsbad,75 und mehr Jahre,1160,402,758
False,8215096,Karlsbad,Insgesamt,16135,7836,8299
False,8215097,"Kraichtal, Stadt",unter 3 Jahre,399,217,182
False,8215097,"Kraichtal, Stadt",3 -  6 Jahre,442,235,207
False,8215097,"Kraichtal, Stadt",6 - 10 Jahre,703,380,323
False,8215097,"Kraichtal, Stadt",10 - 15 Jahre,937,470,467
False,8215097,"Kraichtal, Stadt",15 - 18 Jahre,559,268,291
False,8215097,"Kraichtal, Stadt",18 - 20 Jahre,374,179,195
False,8215097,"Kraichtal, Stadt",20 - 25 Jahre,883,476,407
False,8215097,"Kraichtal, Stadt",25 - 30 Jahre,826,413,413
False,8215097,"Kraichtal, Stadt",30 - 35 Jahre,902,452,450
False,8215097,"Kraichtal, Stadt",35 - 40 Jahre,1226,631,595
False,8215097,"Kraichtal, Stadt",40 - 45 Jahre,1421,744,677
False,8215097,"Kraichtal, Stadt",45 - 50 Jahre,1169,594,575
False,8215097,"Kraichtal, Stadt",50 - 55 Jahre,948,492,456
False,8215097,"Kraichtal, Stadt",55 - 60 Jahre,861,415,446
False,8215097,"Kraichtal, Stadt",60 - 65 Jahre,697,355,342
False,8215097,"Kraichtal, Stadt",65 - 75 Jahre,1483,724,759
False,8215097,"Kraichtal, Stadt",75 und mehr Jahre,1070,378,692
False,8215097,"Kraichtal, Stadt",Insgesamt,14900,7423,7477
False,8215099,Graben-Neudorf,unter 3 Jahre,285,142,143
False,8215099,Graben-Neudorf,3 -  6 Jahre,350,170,180
False,8215099,Graben-Neudorf,6 - 10 Jahre,508,267,241
False,8215099,Graben-Neudorf,10 - 15 Jahre,708,361,347
False,8215099,Graben-Neudorf,15 - 18 Jahre,472,236,236
False,8215099,Graben-Neudorf,18 - 20 Jahre,295,159,136
False,8215099,Graben-Neudorf,20 - 25 Jahre,711,371,340
False,8215099,Graben-Neudorf,25 - 30 Jahre,657,351,306
False,8215099,Graben-Neudorf,30 - 35 Jahre,605,298,307
False,8215099,Graben-Neudorf,35 - 40 Jahre,927,460,467
False,8215099,Graben-Neudorf,40 - 45 Jahre,1115,570,545
False,8215099,Graben-Neudorf,45 - 50 Jahre,1043,514,529
False,8215099,Graben-Neudorf,50 - 55 Jahre,824,433,391
False,8215099,Graben-Neudorf,55 - 60 Jahre,674,359,315
False,8215099,Graben-Neudorf,60 - 65 Jahre,547,279,268
False,8215099,Graben-Neudorf,65 - 75 Jahre,1145,527,618
False,8215099,Graben-Neudorf,75 und mehr Jahre,806,286,520
False,8215099,Graben-Neudorf,Insgesamt,11672,5783,5889
False,8215100,Bad Schönborn,unter 3 Jahre,361,199,162
False,8215100,Bad Schönborn,3 -  6 Jahre,402,211,191
False,8215100,Bad Schönborn,6 - 10 Jahre,580,300,280
False,8215100,Bad Schönborn,10 - 15 Jahre,701,358,343
False,8215100,Bad Schönborn,15 - 18 Jahre,399,194,205
False,8215100,Bad Schönborn,18 - 20 Jahre,303,161,142
False,8215100,Bad Schönborn,20 - 25 Jahre,730,357,373
False,8215100,Bad Schönborn,25 - 30 Jahre,689,308,381
False,8215100,Bad Schönborn,30 - 35 Jahre,675,342,333
False,8215100,Bad Schönborn,35 - 40 Jahre,979,518,461
False,8215100,Bad Schönborn,40 - 45 Jahre,1067,556,511
False,8215100,Bad Schönborn,45 - 50 Jahre,924,482,442
False,8215100,Bad Schönborn,50 - 55 Jahre,790,405,385
False,8215100,Bad Schönborn,55 - 60 Jahre,677,335,342
False,8215100,Bad Schönborn,60 - 65 Jahre,562,299,263
False,8215100,Bad Schönborn,65 - 75 Jahre,1119,532,587
False,8215100,Bad Schönborn,75 und mehr Jahre,1188,376,812
False,8215100,Bad Schönborn,Insgesamt,12146,5933,6213
False,8215101,Pfinztal,unter 3 Jahre,428,214,214
False,8215101,Pfinztal,3 -  6 Jahre,481,231,250
False,8215101,Pfinztal,6 - 10 Jahre,802,419,383
False,8215101,Pfinztal,10 - 15 Jahre,992,482,510
False,8215101,Pfinztal,15 - 18 Jahre,676,329,347
False,8215101,Pfinztal,18 - 20 Jahre,405,197,208
False,8215101,Pfinztal,20 - 25 Jahre,928,483,445
False,8215101,Pfinztal,25 - 30 Jahre,850,435,415
False,8215101,Pfinztal,30 - 35 Jahre,951,466,485
False,8215101,Pfinztal,35 - 40 Jahre,1474,737,737
False,8215101,Pfinztal,40 - 45 Jahre,1640,820,820
False,8215101,Pfinztal,45 - 50 Jahre,1418,709,709
False,8215101,Pfinztal,50 - 55 Jahre,1293,665,628
False,8215101,Pfinztal,55 - 60 Jahre,1130,561,569
False,8215101,Pfinztal,60 - 65 Jahre,959,453,506
False,8215101,Pfinztal,65 - 75 Jahre,1994,962,1032
False,8215101,Pfinztal,75 und mehr Jahre,1556,535,1021
False,8215101,Pfinztal,Insgesamt,17977,8698,9279
False,8215102,Eggenstein-Leopoldshafen,unter 3 Jahre,363,189,174
False,8215102,Eggenstein-Leopoldshafen,3 -  6 Jahre,443,224,219
False,8215102,Eggenstein-Leopoldshafen,6 - 10 Jahre,670,350,320
False,8215102,Eggenstein-Leopoldshafen,10 - 15 Jahre,765,388,377
False,8215102,Eggenstein-Leopoldshafen,15 - 18 Jahre,440,218,222
False,8215102,Eggenstein-Leopoldshafen,18 - 20 Jahre,289,139,150
False,8215102,Eggenstein-Leopoldshafen,20 - 25 Jahre,772,387,385
False,8215102,Eggenstein-Leopoldshafen,25 - 30 Jahre,819,371,448
False,8215102,Eggenstein-Leopoldshafen,30 - 35 Jahre,938,474,464
False,8215102,Eggenstein-Leopoldshafen,35 - 40 Jahre,1329,658,671
False,8215102,Eggenstein-Leopoldshafen,40 - 45 Jahre,1347,706,641
False,8215102,Eggenstein-Leopoldshafen,45 - 50 Jahre,1242,620,622
False,8215102,Eggenstein-Leopoldshafen,50 - 55 Jahre,1053,525,528
False,8215102,Eggenstein-Leopoldshafen,55 - 60 Jahre,1003,467,536
False,8215102,Eggenstein-Leopoldshafen,60 - 65 Jahre,966,479,487
False,8215102,Eggenstein-Leopoldshafen,65 - 75 Jahre,1773,878,895
False,8215102,Eggenstein-Leopoldshafen,75 und mehr Jahre,1008,387,621
False,8215102,Eggenstein-Leopoldshafen,Insgesamt,15220,7460,7760
False,8215103,Karlsdorf-Neuthard,unter 3 Jahre,246,134,112
False,8215103,Karlsdorf-Neuthard,3 -  6 Jahre,306,153,153
False,8215103,Karlsdorf-Neuthard,6 - 10 Jahre,411,208,203
False,8215103,Karlsdorf-Neuthard,10 - 15 Jahre,579,295,284
False,8215103,Karlsdorf-Neuthard,15 - 18 Jahre,334,167,167
False,8215103,Karlsdorf-Neuthard,18 - 20 Jahre,219,127,92
False,8215103,Karlsdorf-Neuthard,20 - 25 Jahre,513,270,243
False,8215103,Karlsdorf-Neuthard,25 - 30 Jahre,504,243,261
False,8215103,Karlsdorf-Neuthard,30 - 35 Jahre,625,308,317
False,8215103,Karlsdorf-Neuthard,35 - 40 Jahre,893,467,426
False,8215103,Karlsdorf-Neuthard,40 - 45 Jahre,893,473,420
False,8215103,Karlsdorf-Neuthard,45 - 50 Jahre,810,418,392
False,8215103,Karlsdorf-Neuthard,50 - 55 Jahre,620,319,301
False,8215103,Karlsdorf-Neuthard,55 - 60 Jahre,587,295,292
False,8215103,Karlsdorf-Neuthard,60 - 65 Jahre,474,255,219
False,8215103,Karlsdorf-Neuthard,65 - 75 Jahre,1021,472,549
False,8215103,Karlsdorf-Neuthard,75 und mehr Jahre,534,191,343
False,8215103,Karlsdorf-Neuthard,Insgesamt,9569,4795,4774
False,8215105,Linkenheim-Hochstetten,unter 3 Jahre,253,131,122
False,8215105,Linkenheim-Hochstetten,3 -  6 Jahre,328,161,167
False,8215105,Linkenheim-Hochstetten,6 - 10 Jahre,553,279,274
False,8215105,Linkenheim-Hochstetten,10 - 15 Jahre,754,387,367
False,8215105,Linkenheim-Hochstetten,15 - 18 Jahre,439,218,221
False,8215105,Linkenheim-Hochstetten,18 - 20 Jahre,274,135,139
False,8215105,Linkenheim-Hochstetten,20 - 25 Jahre,591,308,283
False,8215105,Linkenheim-Hochstetten,25 - 30 Jahre,607,322,285
False,8215105,Linkenheim-Hochstetten,30 - 35 Jahre,644,305,339
False,8215105,Linkenheim-Hochstetten,35 - 40 Jahre,1016,490,526
False,8215105,Linkenheim-Hochstetten,40 - 45 Jahre,1072,542,530
False,8215105,Linkenheim-Hochstetten,45 - 50 Jahre,983,509,474
False,8215105,Linkenheim-Hochstetten,50 - 55 Jahre,827,425,402
False,8215105,Linkenheim-Hochstetten,55 - 60 Jahre,724,358,366
False,8215105,Linkenheim-Hochstetten,60 - 65 Jahre,599,314,285
False,8215105,Linkenheim-Hochstetten,65 - 75 Jahre,1229,598,631
False,8215105,Linkenheim-Hochstetten,75 und mehr Jahre,770,267,503
False,8215105,Linkenheim-Hochstetten,Insgesamt,11663,5749,5914
False,8215106,"Waghäusel, Stadt",unter 3 Jahre,514,265,249
False,8215106,"Waghäusel, Stadt",3 -  6 Jahre,560,274,286
False,8215106,"Waghäusel, Stadt",6 - 10 Jahre,833,426,407
False,8215106,"Waghäusel, Stadt",10 - 15 Jahre,1093,557,536
False,8215106,"Waghäusel, Stadt",15 - 18 Jahre,695,351,344
False,8215106,"Waghäusel, Stadt",18 - 20 Jahre,514,277,237
False,8215106,"Waghäusel, Stadt",20 - 25 Jahre,1203,623,580
False,8215106,"Waghäusel, Stadt",25 - 30 Jahre,1176,591,585
False,8215106,"Waghäusel, Stadt",30 - 35 Jahre,1321,678,643
False,8215106,"Waghäusel, Stadt",35 - 40 Jahre,1686,848,838
False,8215106,"Waghäusel, Stadt",40 - 45 Jahre,1788,920,868
False,8215106,"Waghäusel, Stadt",45 - 50 Jahre,1563,775,788
False,8215106,"Waghäusel, Stadt",50 - 55 Jahre,1440,734,706
False,8215106,"Waghäusel, Stadt",55 - 60 Jahre,1221,604,617
False,8215106,"Waghäusel, Stadt",60 - 65 Jahre,1017,492,525
False,8215106,"Waghäusel, Stadt",65 - 75 Jahre,2135,1041,1094
False,8215106,"Waghäusel, Stadt",75 und mehr Jahre,1426,509,917
False,8215106,"Waghäusel, Stadt",Insgesamt,20185,9965,10220
False,8215107,Oberhausen-Rheinhausen,unter 3 Jahre,196,99,97
False,8215107,Oberhausen-Rheinhausen,3 -  6 Jahre,213,108,105
False,8215107,Oberhausen-Rheinhausen,6 - 10 Jahre,378,162,216
False,8215107,Oberhausen-Rheinhausen,10 - 15 Jahre,531,260,271
False,8215107,Oberhausen-Rheinhausen,15 - 18 Jahre,333,171,162
False,8215107,Oberhausen-Rheinhausen,18 - 20 Jahre,237,141,96
False,8215107,Oberhausen-Rheinhausen,20 - 25 Jahre,510,263,247
False,8215107,Oberhausen-Rheinhausen,25 - 30 Jahre,482,251,231
False,8215107,Oberhausen-Rheinhausen,30 - 35 Jahre,492,245,247
False,8215107,Oberhausen-Rheinhausen,35 - 40 Jahre,736,368,368
False,8215107,Oberhausen-Rheinhausen,40 - 45 Jahre,911,450,461
False,8215107,Oberhausen-Rheinhausen,45 - 50 Jahre,878,468,410
False,8215107,Oberhausen-Rheinhausen,50 - 55 Jahre,685,344,341
False,8215107,Oberhausen-Rheinhausen,55 - 60 Jahre,638,323,315
False,8215107,Oberhausen-Rheinhausen,60 - 65 Jahre,486,275,211
False,8215107,Oberhausen-Rheinhausen,65 - 75 Jahre,1102,517,585
False,8215107,Oberhausen-Rheinhausen,75 und mehr Jahre,693,246,447
False,8215107,Oberhausen-Rheinhausen,Insgesamt,9501,4691,4810
False,8215108,"Rheinstetten, Stadt",unter 3 Jahre,431,219,212
False,8215108,"Rheinstetten, Stadt",3 -  6 Jahre,526,273,253
False,8215108,"Rheinstetten, Stadt",6 - 10 Jahre,851,431,420
False,8215108,"Rheinstetten, Stadt",10 - 15 Jahre,1136,590,546
False,8215108,"Rheinstetten, Stadt",15 - 18 Jahre,697,362,335
False,8215108,"Rheinstetten, Stadt",18 - 20 Jahre,472,229,243
False,8215108,"Rheinstetten, Stadt",20 - 25 Jahre,1046,549,497
False,8215108,"Rheinstetten, Stadt",25 - 30 Jahre,970,459,511
False,8215108,"Rheinstetten, Stadt",30 - 35 Jahre,1084,516,568
False,8215108,"Rheinstetten, Stadt",35 - 40 Jahre,1666,831,835
False,8215108,"Rheinstetten, Stadt",40 - 45 Jahre,1879,951,928
False,8215108,"Rheinstetten, Stadt",45 - 50 Jahre,1629,821,808
False,8215108,"Rheinstetten, Stadt",50 - 55 Jahre,1438,714,724
False,8215108,"Rheinstetten, Stadt",55 - 60 Jahre,1345,626,719
False,8215108,"Rheinstetten, Stadt",60 - 65 Jahre,1298,629,669
False,8215108,"Rheinstetten, Stadt",65 - 75 Jahre,2427,1147,1280
False,8215108,"Rheinstetten, Stadt",75 und mehr Jahre,1511,545,966
False,8215108,"Rheinstetten, Stadt",Insgesamt,20406,9892,10514
False,8215109,"Stutensee, Stadt",unter 3 Jahre,621,317,304
False,8215109,"Stutensee, Stadt",3 -  6 Jahre,709,368,341
False,8215109,"Stutensee, Stadt",6 - 10 Jahre,1052,526,526
False,8215109,"Stutensee, Stadt",10 - 15 Jahre,1276,658,618
False,8215109,"Stutensee, Stadt",15 - 18 Jahre,787,404,383
False,8215109,"Stutensee, Stadt",18 - 20 Jahre,526,272,254
False,8215109,"Stutensee, Stadt",20 - 25 Jahre,1231,657,574
False,8215109,"Stutensee, Stadt",25 - 30 Jahre,1172,551,621
False,8215109,"Stutensee, Stadt",30 - 35 Jahre,1377,677,700
False,8215109,"Stutensee, Stadt",35 - 40 Jahre,1929,1005,924
False,8215109,"Stutensee, Stadt",40 - 45 Jahre,2260,1150,1110
False,8215109,"Stutensee, Stadt",45 - 50 Jahre,1901,991,910
False,8215109,"Stutensee, Stadt",50 - 55 Jahre,1750,842,908
False,8215109,"Stutensee, Stadt",55 - 60 Jahre,1521,777,744
False,8215109,"Stutensee, Stadt",60 - 65 Jahre,1286,661,625
False,8215109,"Stutensee, Stadt",65 - 75 Jahre,2230,1079,1151
False,8215109,"Stutensee, Stadt",75 und mehr Jahre,1504,539,965
False,8215109,"Stutensee, Stadt",Insgesamt,23132,11474,11658
False,8215110,Waldbronn,unter 3 Jahre,275,142,133
False,8215110,Waldbronn,3 -  6 Jahre,306,158,148
False,8215110,Waldbronn,6 - 10 Jahre,479,249,230
False,8215110,Waldbronn,10 - 15 Jahre,611,316,295
False,8215110,Waldbronn,15 - 18 Jahre,389,207,182
False,8215110,Waldbronn,18 - 20 Jahre,232,142,90
False,8215110,Waldbronn,20 - 25 Jahre,635,322,313
False,8215110,Waldbronn,25 - 30 Jahre,535,277,258
False,8215110,Waldbronn,30 - 35 Jahre,670,324,346
False,8215110,Waldbronn,35 - 40 Jahre,913,451,462
False,8215110,Waldbronn,40 - 45 Jahre,1046,542,504
False,8215110,Waldbronn,45 - 50 Jahre,947,452,495
False,8215110,Waldbronn,50 - 55 Jahre,832,412,420
False,8215110,Waldbronn,55 - 60 Jahre,779,380,399
False,8215110,Waldbronn,60 - 65 Jahre,800,392,408
False,8215110,Waldbronn,65 - 75 Jahre,1645,799,846
False,8215110,Waldbronn,75 und mehr Jahre,1127,457,670
False,8215110,Waldbronn,Insgesamt,12221,6022,6199
False,8215111,Dettenheim,unter 3 Jahre,144,88,56
False,8215111,Dettenheim,3 -  6 Jahre,171,86,85
False,8215111,Dettenheim,6 - 10 Jahre,302,165,137
False,8215111,Dettenheim,10 - 15 Jahre,372,197,175
False,8215111,Dettenheim,15 - 18 Jahre,300,164,136
False,8215111,Dettenheim,18 - 20 Jahre,174,82,92
False,8215111,Dettenheim,20 - 25 Jahre,351,190,161
False,8215111,Dettenheim,25 - 30 Jahre,293,151,142
False,8215111,Dettenheim,30 - 35 Jahre,386,197,189
False,8215111,Dettenheim,35 - 40 Jahre,511,247,264
False,8215111,Dettenheim,40 - 45 Jahre,646,314,332
False,8215111,Dettenheim,45 - 50 Jahre,652,347,305
False,8215111,Dettenheim,50 - 55 Jahre,516,258,258
False,8215111,Dettenheim,55 - 60 Jahre,454,233,221
False,8215111,Dettenheim,60 - 65 Jahre,343,181,162
False,8215111,Dettenheim,65 - 75 Jahre,642,312,330
False,8215111,Dettenheim,75 und mehr Jahre,489,171,318
False,8215111,Dettenheim,Insgesamt,6746,3383,3363
False,8216,Landkreis Rastatt,unter 3 Jahre,5759,2952,2807
False,8216,Landkreis Rastatt,3 -  6 Jahre,6496,3354,3142
False,8216,Landkreis Rastatt,6 - 10 Jahre,9529,4864,4665
False,8216,Landkreis Rastatt,10 - 15 Jahre,12927,6679,6248
False,8216,Landkreis Rastatt,15 - 18 Jahre,8271,4233,4038
False,8216,Landkreis Rastatt,18 - 20 Jahre,5227,2688,2539
False,8216,Landkreis Rastatt,20 - 25 Jahre,12769,6489,6280
False,8216,Landkreis Rastatt,25 - 30 Jahre,11987,6008,5979
False,8216,Landkreis Rastatt,30 - 35 Jahre,13095,6473,6622
False,8216,Landkreis Rastatt,35 - 40 Jahre,18423,9324,9099
False,8216,Landkreis Rastatt,40 - 45 Jahre,20390,10366,10024
False,8216,Landkreis Rastatt,45 - 50 Jahre,18370,9404,8966
False,8216,Landkreis Rastatt,50 - 55 Jahre,16068,8079,7989
False,8216,Landkreis Rastatt,55 - 60 Jahre,13227,6679,6548
False,8216,Landkreis Rastatt,60 - 65 Jahre,11877,5941,5936
False,8216,Landkreis Rastatt,65 - 75 Jahre,25395,11901,13494
False,8216,Landkreis Rastatt,75 und mehr Jahre,18598,6530,12068
False,8216,Landkreis Rastatt,Insgesamt,228408,111964,116444
False,8216002,Au am Rhein,unter 3 Jahre,82,37,45
False,8216002,Au am Rhein,3 -  6 Jahre,95,53,42
False,8216002,Au am Rhein,6 - 10 Jahre,168,85,83
False,8216002,Au am Rhein,10 - 15 Jahre,221,104,117
False,8216002,Au am Rhein,15 - 18 Jahre,124,57,67
False,8216002,Au am Rhein,18 - 20 Jahre,66,40,26
False,8216002,Au am Rhein,20 - 25 Jahre,158,95,63
False,8216002,Au am Rhein,25 - 30 Jahre,162,76,86
False,8216002,Au am Rhein,30 - 35 Jahre,182,83,99
False,8216002,Au am Rhein,35 - 40 Jahre,303,162,141
False,8216002,Au am Rhein,40 - 45 Jahre,353,163,190
False,8216002,Au am Rhein,45 - 50 Jahre,307,159,148
False,8216002,Au am Rhein,50 - 55 Jahre,226,125,101
False,8216002,Au am Rhein,55 - 60 Jahre,191,101,90
False,8216002,Au am Rhein,60 - 65 Jahre,131,61,70
False,8216002,Au am Rhein,65 - 75 Jahre,375,169,206
False,8216002,Au am Rhein,75 und mehr Jahre,217,75,142
False,8216002,Au am Rhein,Insgesamt,3361,1645,1716
False,8216005,Bietigheim,unter 3 Jahre,131,61,70
False,8216005,Bietigheim,3 -  6 Jahre,143,71,72
False,8216005,Bietigheim,6 - 10 Jahre,261,131,130
False,8216005,Bietigheim,10 - 15 Jahre,323,151,172
False,8216005,Bietigheim,15 - 18 Jahre,220,109,111
False,8216005,Bietigheim,18 - 20 Jahre,143,87,56
False,8216005,Bietigheim,20 - 25 Jahre,338,155,183
False,8216005,Bietigheim,25 - 30 Jahre,300,154,146
False,8216005,Bietigheim,30 - 35 Jahre,318,166,152
False,8216005,Bietigheim,35 - 40 Jahre,530,261,269
False,8216005,Bietigheim,40 - 45 Jahre,553,266,287
False,8216005,Bietigheim,45 - 50 Jahre,496,243,253
False,8216005,Bietigheim,50 - 55 Jahre,438,231,207
False,8216005,Bietigheim,55 - 60 Jahre,374,191,183
False,8216005,Bietigheim,60 - 65 Jahre,301,142,159
False,8216005,Bietigheim,65 - 75 Jahre,629,309,320
False,8216005,Bietigheim,75 und mehr Jahre,544,168,376
False,8216005,Bietigheim,Insgesamt,6042,2896,3146
False,8216006,Bischweier,unter 3 Jahre,82,43,39
False,8216006,Bischweier,3 -  6 Jahre,106,59,47
False,8216006,Bischweier,6 - 10 Jahre,148,65,83
False,8216006,Bischweier,10 - 15 Jahre,162,82,80
False,8216006,Bischweier,15 - 18 Jahre,85,42,43
False,8216006,Bischweier,18 - 20 Jahre,58,31,27
False,8216006,Bischweier,20 - 25 Jahre,177,82,95
False,8216006,Bischweier,25 - 30 Jahre,174,94,80
False,8216006,Bischweier,30 - 35 Jahre,214,84,130
False,8216006,Bischweier,35 - 40 Jahre,292,131,161
False,8216006,Bischweier,40 - 45 Jahre,324,170,154
False,8216006,Bischweier,45 - 50 Jahre,231,112,119
False,8216006,Bischweier,50 - 55 Jahre,236,125,111
False,8216006,Bischweier,55 - 60 Jahre,168,84,84
False,8216006,Bischweier,60 - 65 Jahre,171,88,83
False,8216006,Bischweier,65 - 75 Jahre,337,174,163
False,8216006,Bischweier,75 und mehr Jahre,200,77,123
False,8216006,Bischweier,Insgesamt,3165,1543,1622
False,8216007,"Bühl, Stadt",unter 3 Jahre,819,417,402
False,8216007,"Bühl, Stadt",3 -  6 Jahre,877,444,433
False,8216007,"Bühl, Stadt",6 - 10 Jahre,1324,684,640
False,8216007,"Bühl, Stadt",10 - 15 Jahre,1781,940,841
False,8216007,"Bühl, Stadt",15 - 18 Jahre,1050,536,514
False,8216007,"Bühl, Stadt",18 - 20 Jahre,619,336,283
False,8216007,"Bühl, Stadt",20 - 25 Jahre,1598,846,752
False,8216007,"Bühl, Stadt",25 - 30 Jahre,1560,785,775
False,8216007,"Bühl, Stadt",30 - 35 Jahre,1826,886,940
False,8216007,"Bühl, Stadt",35 - 40 Jahre,2451,1249,1202
False,8216007,"Bühl, Stadt",40 - 45 Jahre,2706,1345,1361
False,8216007,"Bühl, Stadt",45 - 50 Jahre,2289,1159,1130
False,8216007,"Bühl, Stadt",50 - 55 Jahre,2012,973,1039
False,8216007,"Bühl, Stadt",55 - 60 Jahre,1647,836,811
False,8216007,"Bühl, Stadt",60 - 65 Jahre,1526,757,769
False,8216007,"Bühl, Stadt",65 - 75 Jahre,2964,1376,1588
False,8216007,"Bühl, Stadt",75 und mehr Jahre,2427,804,1623
False,8216007,"Bühl, Stadt",Insgesamt,29476,14373,15103
False,8216008,Bühlertal,unter 3 Jahre,204,102,102
False,8216008,Bühlertal,3 -  6 Jahre,207,105,102
False,8216008,Bühlertal,6 - 10 Jahre,284,154,130
False,8216008,Bühlertal,10 - 15 Jahre,429,212,217
False,8216008,Bühlertal,15 - 18 Jahre,299,149,150
False,8216008,Bühlertal,18 - 20 Jahre,169,81,88
False,8216008,Bühlertal,20 - 25 Jahre,467,241,226
False,8216008,Bühlertal,25 - 30 Jahre,439,230,209
False,8216008,Bühlertal,30 - 35 Jahre,470,253,217
False,8216008,Bühlertal,35 - 40 Jahre,646,350,296
False,8216008,Bühlertal,40 - 45 Jahre,774,390,384
False,8216008,Bühlertal,45 - 50 Jahre,623,302,321
False,8216008,Bühlertal,50 - 55 Jahre,581,306,275
False,8216008,Bühlertal,55 - 60 Jahre,455,246,209
False,8216008,Bühlertal,60 - 65 Jahre,373,196,177
False,8216008,Bühlertal,65 - 75 Jahre,1032,480,552
False,8216008,Bühlertal,75 und mehr Jahre,679,216,463
False,8216008,Bühlertal,Insgesamt,8131,4013,4118
False,8216009,Durmersheim,unter 3 Jahre,291,134,157
False,8216009,Durmersheim,3 -  6 Jahre,377,195,182
False,8216009,Durmersheim,6 - 10 Jahre,500,271,229
False,8216009,Durmersheim,10 - 15 Jahre,617,326,291
False,8216009,Durmersheim,15 - 18 Jahre,420,209,211
False,8216009,Durmersheim,18 - 20 Jahre,244,100,144
False,8216009,Durmersheim,20 - 25 Jahre,681,351,330
False,8216009,Durmersheim,25 - 30 Jahre,646,318,328
False,8216009,Durmersheim,30 - 35 Jahre,808,393,415
False,8216009,Durmersheim,35 - 40 Jahre,1094,561,533
False,8216009,Durmersheim,40 - 45 Jahre,1129,576,553
False,8216009,Durmersheim,45 - 50 Jahre,1015,520,495
False,8216009,Durmersheim,50 - 55 Jahre,826,382,444
False,8216009,Durmersheim,55 - 60 Jahre,753,387,366
False,8216009,Durmersheim,60 - 65 Jahre,671,340,331
False,8216009,Durmersheim,65 - 75 Jahre,1239,607,632
False,8216009,Durmersheim,75 und mehr Jahre,792,293,499
False,8216009,Durmersheim,Insgesamt,12103,5963,6140
False,8216012,Elchesheim-Illingen,unter 3 Jahre,95,39,56
False,8216012,Elchesheim-Illingen,3 -  6 Jahre,89,49,40
False,8216012,Elchesheim-Illingen,6 - 10 Jahre,157,84,73
False,8216012,Elchesheim-Illingen,10 - 15 Jahre,183,91,92
False,8216012,Elchesheim-Illingen,15 - 18 Jahre,98,56,42
False,8216012,Elchesheim-Illingen,18 - 20 Jahre,76,46,30
False,8216012,Elchesheim-Illingen,20 - 25 Jahre,180,82,98
False,8216012,Elchesheim-Illingen,25 - 30 Jahre,156,74,82
False,8216012,Elchesheim-Illingen,30 - 35 Jahre,185,85,100
False,8216012,Elchesheim-Illingen,35 - 40 Jahre,281,141,140
False,8216012,Elchesheim-Illingen,40 - 45 Jahre,272,146,126
False,8216012,Elchesheim-Illingen,45 - 50 Jahre,304,144,160
False,8216012,Elchesheim-Illingen,50 - 55 Jahre,236,132,104
False,8216012,Elchesheim-Illingen,55 - 60 Jahre,192,104,88
False,8216012,Elchesheim-Illingen,60 - 65 Jahre,173,84,89
False,8216012,Elchesheim-Illingen,65 - 75 Jahre,326,154,172
False,8216012,Elchesheim-Illingen,75 und mehr Jahre,232,93,139
False,8216012,Elchesheim-Illingen,Insgesamt,3235,1604,1631
False,8216013,Forbach,unter 3 Jahre,122,66,56
False,8216013,Forbach,3 -  6 Jahre,146,75,71
False,8216013,Forbach,6 - 10 Jahre,251,137,114
False,8216013,Forbach,10 - 15 Jahre,342,185,157
False,8216013,Forbach,15 - 18 Jahre,215,105,110
False,8216013,Forbach,18 - 20 Jahre,96,56,40
False,8216013,Forbach,20 - 25 Jahre,274,131,143
False,8216013,Forbach,25 - 30 Jahre,262,137,125
False,8216013,Forbach,30 - 35 Jahre,279,126,153
False,8216013,Forbach,35 - 40 Jahre,462,239,223
False,8216013,Forbach,40 - 45 Jahre,494,254,240
False,8216013,Forbach,45 - 50 Jahre,423,229,194
False,8216013,Forbach,50 - 55 Jahre,396,204,192
False,8216013,Forbach,55 - 60 Jahre,306,153,153
False,8216013,Forbach,60 - 65 Jahre,286,139,147
False,8216013,Forbach,65 - 75 Jahre,740,333,407
False,8216013,Forbach,75 und mehr Jahre,495,193,302
False,8216013,Forbach,Insgesamt,5589,2762,2827
False,8216015,"Gaggenau, Stadt",unter 3 Jahre,740,391,349
False,8216015,"Gaggenau, Stadt",3 -  6 Jahre,791,409,382
False,8216015,"Gaggenau, Stadt",6 - 10 Jahre,1153,571,582
False,8216015,"Gaggenau, Stadt",10 - 15 Jahre,1606,830,776
False,8216015,"Gaggenau, Stadt",15 - 18 Jahre,1009,496,513
False,8216015,"Gaggenau, Stadt",18 - 20 Jahre,614,320,294
False,8216015,"Gaggenau, Stadt",20 - 25 Jahre,1569,779,790
False,8216015,"Gaggenau, Stadt",25 - 30 Jahre,1534,791,743
False,8216015,"Gaggenau, Stadt",30 - 35 Jahre,1599,823,776
False,8216015,"Gaggenau, Stadt",35 - 40 Jahre,2276,1149,1127
False,8216015,"Gaggenau, Stadt",40 - 45 Jahre,2488,1238,1250
False,8216015,"Gaggenau, Stadt",45 - 50 Jahre,2166,1098,1068
False,8216015,"Gaggenau, Stadt",50 - 55 Jahre,2020,983,1037
False,8216015,"Gaggenau, Stadt",55 - 60 Jahre,1937,974,963
False,8216015,"Gaggenau, Stadt",60 - 65 Jahre,1799,881,918
False,8216015,"Gaggenau, Stadt",65 - 75 Jahre,3674,1752,1922
False,8216015,"Gaggenau, Stadt",75 und mehr Jahre,2734,962,1772
False,8216015,"Gaggenau, Stadt",Insgesamt,29709,14447,15262
False,8216017,"Gernsbach, Stadt",unter 3 Jahre,358,194,164
False,8216017,"Gernsbach, Stadt",3 -  6 Jahre,381,213,168
False,8216017,"Gernsbach, Stadt",6 - 10 Jahre,536,266,270
False,8216017,"Gernsbach, Stadt",10 - 15 Jahre,757,375,382
False,8216017,"Gernsbach, Stadt",15 - 18 Jahre,516,267,249
False,8216017,"Gernsbach, Stadt",18 - 20 Jahre,329,178,151
False,8216017,"Gernsbach, Stadt",20 - 25 Jahre,781,418,363
False,8216017,"Gernsbach, Stadt",25 - 30 Jahre,712,361,351
False,8216017,"Gernsbach, Stadt",30 - 35 Jahre,779,406,373
False,8216017,"Gernsbach, Stadt",35 - 40 Jahre,1138,529,609
False,8216017,"Gernsbach, Stadt",40 - 45 Jahre,1298,700,598
False,8216017,"Gernsbach, Stadt",45 - 50 Jahre,1170,573,597
False,8216017,"Gernsbach, Stadt",50 - 55 Jahre,1033,515,518
False,8216017,"Gernsbach, Stadt",55 - 60 Jahre,888,434,454
False,8216017,"Gernsbach, Stadt",60 - 65 Jahre,853,447,406
False,8216017,"Gernsbach, Stadt",65 - 75 Jahre,1751,804,947
False,8216017,"Gernsbach, Stadt",75 und mehr Jahre,1357,485,872
False,8216017,"Gernsbach, Stadt",Insgesamt,14637,7165,7472
False,8216022,Hügelsheim,unter 3 Jahre,136,61,75
False,8216022,Hügelsheim,3 -  6 Jahre,161,88,73
False,8216022,Hügelsheim,6 - 10 Jahre,288,148,140
False,8216022,Hügelsheim,10 - 15 Jahre,359,175,184
False,8216022,Hügelsheim,15 - 18 Jahre,188,94,94
False,8216022,Hügelsheim,18 - 20 Jahre,154,85,69
False,8216022,Hügelsheim,20 - 25 Jahre,325,166,159
False,8216022,Hügelsheim,25 - 30 Jahre,286,142,144
False,8216022,Hügelsheim,30 - 35 Jahre,322,140,182
False,8216022,Hügelsheim,35 - 40 Jahre,414,211,203
False,8216022,Hügelsheim,40 - 45 Jahre,490,253,237
False,8216022,Hügelsheim,45 - 50 Jahre,467,234,233
False,8216022,Hügelsheim,50 - 55 Jahre,315,162,153
False,8216022,Hügelsheim,55 - 60 Jahre,182,90,92
False,8216022,Hügelsheim,60 - 65 Jahre,135,78,57
False,8216022,Hügelsheim,65 - 75 Jahre,299,134,165
False,8216022,Hügelsheim,75 und mehr Jahre,189,65,124
False,8216022,Hügelsheim,Insgesamt,4710,2326,2384
False,8216023,Iffezheim,unter 3 Jahre,103,59,44
False,8216023,Iffezheim,3 -  6 Jahre,141,65,76
False,8216023,Iffezheim,6 - 10 Jahre,216,132,84
False,8216023,Iffezheim,10 - 15 Jahre,310,155,155
False,8216023,Iffezheim,15 - 18 Jahre,210,97,113
False,8216023,Iffezheim,18 - 20 Jahre,124,62,62
False,8216023,Iffezheim,20 - 25 Jahre,275,138,137
False,8216023,Iffezheim,25 - 30 Jahre,243,127,116
False,8216023,Iffezheim,30 - 35 Jahre,276,139,137
False,8216023,Iffezheim,35 - 40 Jahre,427,220,207
False,8216023,Iffezheim,40 - 45 Jahre,501,244,257
False,8216023,Iffezheim,45 - 50 Jahre,415,230,185
False,8216023,Iffezheim,50 - 55 Jahre,379,200,179
False,8216023,Iffezheim,55 - 60 Jahre,244,126,118
False,8216023,Iffezheim,60 - 65 Jahre,215,102,113
False,8216023,Iffezheim,65 - 75 Jahre,472,235,237
False,8216023,Iffezheim,75 und mehr Jahre,344,121,223
False,8216023,Iffezheim,Insgesamt,4895,2452,2443
False,8216024,"Kuppenheim, Stadt",unter 3 Jahre,159,79,80
False,8216024,"Kuppenheim, Stadt",3 -  6 Jahre,189,103,86
False,8216024,"Kuppenheim, Stadt",6 - 10 Jahre,286,136,150
False,8216024,"Kuppenheim, Stadt",10 - 15 Jahre,405,211,194
False,8216024,"Kuppenheim, Stadt",15 - 18 Jahre,284,152,132
False,8216024,"Kuppenheim, Stadt",18 - 20 Jahre,172,78,94
False,8216024,"Kuppenheim, Stadt",20 - 25 Jahre,379,196,183
False,8216024,"Kuppenheim, Stadt",25 - 30 Jahre,364,184,180
False,8216024,"Kuppenheim, Stadt",30 - 35 Jahre,492,255,237
False,8216024,"Kuppenheim, Stadt",35 - 40 Jahre,629,324,305
False,8216024,"Kuppenheim, Stadt",40 - 45 Jahre,667,349,318
False,8216024,"Kuppenheim, Stadt",45 - 50 Jahre,572,269,303
False,8216024,"Kuppenheim, Stadt",50 - 55 Jahre,556,288,268
False,8216024,"Kuppenheim, Stadt",55 - 60 Jahre,475,234,241
False,8216024,"Kuppenheim, Stadt",60 - 65 Jahre,470,223,247
False,8216024,"Kuppenheim, Stadt",65 - 75 Jahre,899,437,462
False,8216024,"Kuppenheim, Stadt",75 und mehr Jahre,641,226,415
False,8216024,"Kuppenheim, Stadt",Insgesamt,7639,3744,3895
False,8216028,"Lichtenau, Stadt",unter 3 Jahre,145,67,78
False,8216028,"Lichtenau, Stadt",3 -  6 Jahre,171,86,85
False,8216028,"Lichtenau, Stadt",6 - 10 Jahre,216,103,113
False,8216028,"Lichtenau, Stadt",10 - 15 Jahre,353,189,164
False,8216028,"Lichtenau, Stadt",15 - 18 Jahre,201,107,94
False,8216028,"Lichtenau, Stadt",18 - 20 Jahre,117,58,59
False,8216028,"Lichtenau, Stadt",20 - 25 Jahre,280,143,137
False,8216028,"Lichtenau, Stadt",25 - 30 Jahre,274,139,135
False,8216028,"Lichtenau, Stadt",30 - 35 Jahre,307,144,163
False,8216028,"Lichtenau, Stadt",35 - 40 Jahre,436,221,215
False,8216028,"Lichtenau, Stadt",40 - 45 Jahre,461,236,225
False,8216028,"Lichtenau, Stadt",45 - 50 Jahre,421,217,204
False,8216028,"Lichtenau, Stadt",50 - 55 Jahre,319,160,159
False,8216028,"Lichtenau, Stadt",55 - 60 Jahre,296,160,136
False,8216028,"Lichtenau, Stadt",60 - 65 Jahre,232,116,116
False,8216028,"Lichtenau, Stadt",65 - 75 Jahre,516,260,256
False,8216028,"Lichtenau, Stadt",75 und mehr Jahre,311,118,193
False,8216028,"Lichtenau, Stadt",Insgesamt,5056,2524,2532
False,8216029,Loffenau,unter 3 Jahre,65,37,28
False,8216029,Loffenau,3 -  6 Jahre,77,31,46
False,8216029,Loffenau,6 - 10 Jahre,123,67,56
False,8216029,Loffenau,10 - 15 Jahre,174,81,93
False,8216029,Loffenau,15 - 18 Jahre,120,61,59
False,8216029,Loffenau,18 - 20 Jahre,58,31,27
False,8216029,Loffenau,20 - 25 Jahre,118,54,64
False,8216029,Loffenau,25 - 30 Jahre,95,49,46
False,8216029,Loffenau,30 - 35 Jahre,148,76,72
False,8216029,Loffenau,35 - 40 Jahre,248,117,131
False,8216029,Loffenau,40 - 45 Jahre,274,153,121
False,8216029,Loffenau,45 - 50 Jahre,223,125,98
False,8216029,Loffenau,50 - 55 Jahre,177,95,82
False,8216029,Loffenau,55 - 60 Jahre,159,86,73
False,8216029,Loffenau,60 - 65 Jahre,135,60,75
False,8216029,Loffenau,65 - 75 Jahre,328,169,159
False,8216029,Loffenau,75 und mehr Jahre,188,68,120
False,8216029,Loffenau,Insgesamt,2710,1360,1350
False,8216033,Muggensturm,unter 3 Jahre,167,88,79
False,8216033,Muggensturm,3 -  6 Jahre,181,92,89
False,8216033,Muggensturm,6 - 10 Jahre,269,129,140
False,8216033,Muggensturm,10 - 15 Jahre,352,178,174
False,8216033,Muggensturm,15 - 18 Jahre,229,112,117
False,8216033,Muggensturm,18 - 20 Jahre,154,78,76
False,8216033,Muggensturm,20 - 25 Jahre,337,194,143
False,8216033,Muggensturm,25 - 30 Jahre,327,165,162
False,8216033,Muggensturm,30 - 35 Jahre,340,180,160
False,8216033,Muggensturm,35 - 40 Jahre,539,278,261
False,8216033,Muggensturm,40 - 45 Jahre,595,287,308
False,8216033,Muggensturm,45 - 50 Jahre,548,266,282
False,8216033,Muggensturm,50 - 55 Jahre,474,243,231
False,8216033,Muggensturm,55 - 60 Jahre,366,190,176
False,8216033,Muggensturm,60 - 65 Jahre,335,186,149
False,8216033,Muggensturm,65 - 75 Jahre,653,302,351
False,8216033,Muggensturm,75 und mehr Jahre,408,139,269
False,8216033,Muggensturm,Insgesamt,6274,3107,3167
False,8216039,Ötigheim,unter 3 Jahre,86,45,41
False,8216039,Ötigheim,3 -  6 Jahre,119,62,57
False,8216039,Ötigheim,6 - 10 Jahre,186,103,83
False,8216039,Ötigheim,10 - 15 Jahre,254,138,116
False,8216039,Ötigheim,15 - 18 Jahre,157,74,83
False,8216039,Ötigheim,18 - 20 Jahre,102,55,47
False,8216039,Ötigheim,20 - 25 Jahre,247,129,118
False,8216039,Ötigheim,25 - 30 Jahre,214,109,105
False,8216039,Ötigheim,30 - 35 Jahre,243,125,118
False,8216039,Ötigheim,35 - 40 Jahre,368,181,187
False,8216039,Ötigheim,40 - 45 Jahre,354,169,185
False,8216039,Ötigheim,45 - 50 Jahre,358,186,172
False,8216039,Ötigheim,50 - 55 Jahre,339,156,183
False,8216039,Ötigheim,55 - 60 Jahre,298,159,139
False,8216039,Ötigheim,60 - 65 Jahre,229,116,113
False,8216039,Ötigheim,65 - 75 Jahre,458,228,230
False,8216039,Ötigheim,75 und mehr Jahre,301,115,186
False,8216039,Ötigheim,Insgesamt,4313,2150,2163
False,8216041,Ottersweier,unter 3 Jahre,155,85,70
False,8216041,Ottersweier,3 -  6 Jahre,181,98,83
False,8216041,Ottersweier,6 - 10 Jahre,320,165,155
False,8216041,Ottersweier,10 - 15 Jahre,390,196,194
False,8216041,Ottersweier,15 - 18 Jahre,284,149,135
False,8216041,Ottersweier,18 - 20 Jahre,156,85,71
False,8216041,Ottersweier,20 - 25 Jahre,296,143,153
False,8216041,Ottersweier,25 - 30 Jahre,294,154,140
False,8216041,Ottersweier,30 - 35 Jahre,368,202,166
False,8216041,Ottersweier,35 - 40 Jahre,525,258,267
False,8216041,Ottersweier,40 - 45 Jahre,580,297,283
False,8216041,Ottersweier,45 - 50 Jahre,526,267,259
False,8216041,Ottersweier,50 - 55 Jahre,448,243,205
False,8216041,Ottersweier,55 - 60 Jahre,388,198,190
False,8216041,Ottersweier,60 - 65 Jahre,316,178,138
False,8216041,Ottersweier,65 - 75 Jahre,643,308,335
False,8216041,Ottersweier,75 und mehr Jahre,515,204,311
False,8216041,Ottersweier,Insgesamt,6385,3230,3155
False,8216043,"Rastatt, Stadt",unter 3 Jahre,1241,652,589
False,8216043,"Rastatt, Stadt",3 -  6 Jahre,1325,679,646
False,8216043,"Rastatt, Stadt",6 - 10 Jahre,1677,859,818
False,8216043,"Rastatt, Stadt",10 - 15 Jahre,2470,1291,1179
False,8216043,"Rastatt, Stadt",15 - 18 Jahre,1669,924,745
False,8216043,"Rastatt, Stadt",18 - 20 Jahre,1241,622,619
False,8216043,"Rastatt, Stadt",20 - 25 Jahre,3088,1522,1566
False,8216043,"Rastatt, Stadt",25 - 30 Jahre,2777,1348,1429
False,8216043,"Rastatt, Stadt",30 - 35 Jahre,2621,1283,1338
False,8216043,"Rastatt, Stadt",35 - 40 Jahre,3279,1737,1542
False,8216043,"Rastatt, Stadt",40 - 45 Jahre,3804,1954,1850
False,8216043,"Rastatt, Stadt",45 - 50 Jahre,3871,2050,1821
False,8216043,"Rastatt, Stadt",50 - 55 Jahre,3404,1713,1691
False,8216043,"Rastatt, Stadt",55 - 60 Jahre,2654,1279,1375
False,8216043,"Rastatt, Stadt",60 - 65 Jahre,2442,1186,1256
False,8216043,"Rastatt, Stadt",65 - 75 Jahre,5709,2567,3142
False,8216043,"Rastatt, Stadt",75 und mehr Jahre,4416,1542,2874
False,8216043,"Rastatt, Stadt",Insgesamt,47688,23208,24480
False,8216049,Sinzheim,unter 3 Jahre,278,144,134
False,8216049,Sinzheim,3 -  6 Jahre,365,187,178
False,8216049,Sinzheim,6 - 10 Jahre,537,258,279
False,8216049,Sinzheim,10 - 15 Jahre,656,359,297
False,8216049,Sinzheim,15 - 18 Jahre,389,189,200
False,8216049,Sinzheim,18 - 20 Jahre,243,108,135
False,8216049,Sinzheim,20 - 25 Jahre,547,282,265
False,8216049,Sinzheim,25 - 30 Jahre,529,245,284
False,8216049,Sinzheim,30 - 35 Jahre,630,278,352
False,8216049,Sinzheim,35 - 40 Jahre,1042,497,545
False,8216049,Sinzheim,40 - 45 Jahre,1106,564,542
False,8216049,Sinzheim,45 - 50 Jahre,947,455,492
False,8216049,Sinzheim,50 - 55 Jahre,798,415,383
False,8216049,Sinzheim,55 - 60 Jahre,629,318,311
False,8216049,Sinzheim,60 - 65 Jahre,552,294,258
False,8216049,Sinzheim,65 - 75 Jahre,1097,498,599
False,8216049,Sinzheim,75 und mehr Jahre,807,277,530
False,8216049,Sinzheim,Insgesamt,11152,5368,5784
False,8216052,Steinmauern,unter 3 Jahre,61,25,36
False,8216052,Steinmauern,3 -  6 Jahre,85,45,40
False,8216052,Steinmauern,6 - 10 Jahre,148,71,77
False,8216052,Steinmauern,10 - 15 Jahre,203,114,89
False,8216052,Steinmauern,15 - 18 Jahre,131,60,71
False,8216052,Steinmauern,18 - 20 Jahre,67,41,26
False,8216052,Steinmauern,20 - 25 Jahre,146,81,65
False,8216052,Steinmauern,25 - 30 Jahre,160,78,82
False,8216052,Steinmauern,30 - 35 Jahre,161,82,79
False,8216052,Steinmauern,35 - 40 Jahre,239,112,127
False,8216052,Steinmauern,40 - 45 Jahre,289,146,143
False,8216052,Steinmauern,45 - 50 Jahre,249,136,113
False,8216052,Steinmauern,50 - 55 Jahre,189,98,91
False,8216052,Steinmauern,55 - 60 Jahre,160,84,76
False,8216052,Steinmauern,60 - 65 Jahre,131,62,69
False,8216052,Steinmauern,65 - 75 Jahre,298,143,155
False,8216052,Steinmauern,75 und mehr Jahre,197,68,129
False,8216052,Steinmauern,Insgesamt,2914,1446,1468
False,8216059,Weisenbach,unter 3 Jahre,65,34,31
False,8216059,Weisenbach,3 -  6 Jahre,76,41,35
False,8216059,Weisenbach,6 - 10 Jahre,143,76,67
False,8216059,Weisenbach,10 - 15 Jahre,166,85,81
False,8216059,Weisenbach,15 - 18 Jahre,95,59,36
False,8216059,Weisenbach,18 - 20 Jahre,60,24,36
False,8216059,Weisenbach,20 - 25 Jahre,140,71,69
False,8216059,Weisenbach,25 - 30 Jahre,135,73,62
False,8216059,Weisenbach,30 - 35 Jahre,130,68,62
False,8216059,Weisenbach,35 - 40 Jahre,212,91,121
False,8216059,Weisenbach,40 - 45 Jahre,257,141,116
False,8216059,Weisenbach,45 - 50 Jahre,222,131,91
False,8216059,Weisenbach,50 - 55 Jahre,178,73,105
False,8216059,Weisenbach,55 - 60 Jahre,137,83,54
False,8216059,Weisenbach,60 - 65 Jahre,101,45,56
False,8216059,Weisenbach,65 - 75 Jahre,338,160,178
False,8216059,Weisenbach,75 und mehr Jahre,208,75,133
False,8216059,Weisenbach,Insgesamt,2663,1330,1333
False,8216063,Rheinmünster,unter 3 Jahre,174,92,82
False,8216063,Rheinmünster,3 -  6 Jahre,213,104,109
False,8216063,Rheinmünster,6 - 10 Jahre,338,169,169
False,8216063,Rheinmünster,10 - 15 Jahre,414,211,203
False,8216063,Rheinmünster,15 - 18 Jahre,278,129,149
False,8216063,Rheinmünster,18 - 20 Jahre,165,86,79
False,8216063,Rheinmünster,20 - 25 Jahre,368,190,178
False,8216063,Rheinmünster,25 - 30 Jahre,344,175,169
False,8216063,Rheinmünster,30 - 35 Jahre,397,196,201
False,8216063,Rheinmünster,35 - 40 Jahre,592,305,287
False,8216063,Rheinmünster,40 - 45 Jahre,621,325,296
False,8216063,Rheinmünster,45 - 50 Jahre,527,299,228
False,8216063,Rheinmünster,50 - 55 Jahre,488,257,231
False,8216063,Rheinmünster,55 - 60 Jahre,328,162,166
False,8216063,Rheinmünster,60 - 65 Jahre,300,160,140
False,8216063,Rheinmünster,65 - 75 Jahre,618,302,316
False,8216063,Rheinmünster,75 und mehr Jahre,396,146,250
False,8216063,Rheinmünster,Insgesamt,6561,3308,3253
False,8221,Stadtkreis Heidelberg,unter 3 Jahre,3406,1710,1696
False,8221,Stadtkreis Heidelberg,3 -  6 Jahre,3098,1659,1439
False,8221,Stadtkreis Heidelberg,6 - 10 Jahre,4324,2165,2159
False,8221,Stadtkreis Heidelberg,10 - 15 Jahre,5363,2764,2599
False,8221,Stadtkreis Heidelberg,15 - 18 Jahre,3521,1799,1722
False,8221,Stadtkreis Heidelberg,18 - 20 Jahre,2826,1293,1533
False,8221,Stadtkreis Heidelberg,20 - 25 Jahre,13472,5598,7874
False,8221,Stadtkreis Heidelberg,25 - 30 Jahre,13599,6358,7241
False,8221,Stadtkreis Heidelberg,30 - 35 Jahre,11226,5632,5594
False,8221,Stadtkreis Heidelberg,35 - 40 Jahre,12750,6366,6384
False,8221,Stadtkreis Heidelberg,40 - 45 Jahre,13222,6665,6557
False,8221,Stadtkreis Heidelberg,45 - 50 Jahre,10390,5226,5164
False,8221,Stadtkreis Heidelberg,50 - 55 Jahre,8622,4264,4358
False,8221,Stadtkreis Heidelberg,55 - 60 Jahre,7392,3653,3739
False,8221,Stadtkreis Heidelberg,60 - 65 Jahre,6886,3371,3515
False,8221,Stadtkreis Heidelberg,65 - 75 Jahre,11928,5460,6468
False,8221,Stadtkreis Heidelberg,75 und mehr Jahre,10968,3499,7469
False,8221,Stadtkreis Heidelberg,Insgesamt,142993,67482,75511
False,8221000,"Heidelberg, Stadt",unter 3 Jahre,3406,1710,1696
False,8221000,"Heidelberg, Stadt",3 -  6 Jahre,3098,1659,1439
False,8221000,"Heidelberg, Stadt",6 - 10 Jahre,4324,2165,2159
False,8221000,"Heidelberg, Stadt",10 - 15 Jahre,5363,2764,2599
False,8221000,"Heidelberg, Stadt",15 - 18 Jahre,3521,1799,1722
False,8221000,"Heidelberg, Stadt",18 - 20 Jahre,2826,1293,1533
False,8221000,"Heidelberg, Stadt",20 - 25 Jahre,13472,5598,7874
False,8221000,"Heidelberg, Stadt",25 - 30 Jahre,13599,6358,7241
False,8221000,"Heidelberg, Stadt",30 - 35 Jahre,11226,5632,5594
False,8221000,"Heidelberg, Stadt",35 - 40 Jahre,12750,6366,6384
False,8221000,"Heidelberg, Stadt",40 - 45 Jahre,13222,6665,6557
False,8221000,"Heidelberg, Stadt",45 - 50 Jahre,10390,5226,5164
False,8221000,"Heidelberg, Stadt",50 - 55 Jahre,8622,4264,4358
False,8221000,"Heidelberg, Stadt",55 - 60 Jahre,7392,3653,3739
False,8221000,"Heidelberg, Stadt",60 - 65 Jahre,6886,3371,3515
False,8221000,"Heidelberg, Stadt",65 - 75 Jahre,11928,5460,6468
False,8221000,"Heidelberg, Stadt",75 und mehr Jahre,10968,3499,7469
False,8221000,"Heidelberg, Stadt",Insgesamt,142993,67482,75511
False,8222,Stadtkreis Mannheim,unter 3 Jahre,7930,4075,3855
False,8222,Stadtkreis Mannheim,3 -  6 Jahre,7889,3984,3905
False,8222,Stadtkreis Mannheim,6 - 10 Jahre,10899,5538,5361
False,8222,Stadtkreis Mannheim,10 - 15 Jahre,13905,7183,6722
False,8222,Stadtkreis Mannheim,15 - 18 Jahre,8830,4524,4306
False,8222,Stadtkreis Mannheim,18 - 20 Jahre,6014,2929,3085
False,8222,Stadtkreis Mannheim,20 - 25 Jahre,19202,9276,9926
False,8222,Stadtkreis Mannheim,25 - 30 Jahre,21697,10767,10930
False,8222,Stadtkreis Mannheim,30 - 35 Jahre,21289,10783,10506
False,8222,Stadtkreis Mannheim,35 - 40 Jahre,25713,13361,12352
False,8222,Stadtkreis Mannheim,40 - 45 Jahre,28186,14748,13438
False,8222,Stadtkreis Mannheim,45 - 50 Jahre,23232,12210,11022
False,8222,Stadtkreis Mannheim,50 - 55 Jahre,19783,10067,9716
False,8222,Stadtkreis Mannheim,55 - 60 Jahre,18730,9293,9437
False,8222,Stadtkreis Mannheim,60 - 65 Jahre,17143,8743,8400
False,8222,Stadtkreis Mannheim,65 - 75 Jahre,32087,15221,16866
False,8222,Stadtkreis Mannheim,75 und mehr Jahre,25371,8636,16735
False,8222,Stadtkreis Mannheim,Insgesamt,307900,151338,156562
False,8222000,"Mannheim, Universitätsstadt",unter 3 Jahre,7930,4075,3855
False,8222000,"Mannheim, Universitätsstadt",3 -  6 Jahre,7889,3984,3905
False,8222000,"Mannheim, Universitätsstadt",6 - 10 Jahre,10899,5538,5361
False,8222000,"Mannheim, Universitätsstadt",10 - 15 Jahre,13905,7183,6722
False,8222000,"Mannheim, Universitätsstadt",15 - 18 Jahre,8830,4524,4306
False,8222000,"Mannheim, Universitätsstadt",18 - 20 Jahre,6014,2929,3085
False,8222000,"Mannheim, Universitätsstadt",20 - 25 Jahre,19202,9276,9926
False,8222000,"Mannheim, Universitätsstadt",25 - 30 Jahre,21697,10767,10930
False,8222000,"Mannheim, Universitätsstadt",30 - 35 Jahre,21289,10783,10506
False,8222000,"Mannheim, Universitätsstadt",35 - 40 Jahre,25713,13361,12352
False,8222000,"Mannheim, Universitätsstadt",40 - 45 Jahre,28186,14748,13438
False,8222000,"Mannheim, Universitätsstadt",45 - 50 Jahre,23232,12210,11022
False,8222000,"Mannheim, Universitätsstadt",50 - 55 Jahre,19783,10067,9716
False,8222000,"Mannheim, Universitätsstadt",55 - 60 Jahre,18730,9293,9437
False,8222000,"Mannheim, Universitätsstadt",60 - 65 Jahre,17143,8743,8400
False,8222000,"Mannheim, Universitätsstadt",65 - 75 Jahre,32087,15221,16866
False,8222000,"Mannheim, Universitätsstadt",75 und mehr Jahre,25371,8636,16735
False,8222000,"Mannheim, Universitätsstadt",Insgesamt,307900,151338,156562
False,8225,Landkreis Neckar-Odenwald-Kreis,unter 3 Jahre,4012,2101,1911
False,8225,Landkreis Neckar-Odenwald-Kreis,3 -  6 Jahre,4376,2232,2144
False,8225,Landkreis Neckar-Odenwald-Kreis,6 - 10 Jahre,6504,3432,3072
False,8225,Landkreis Neckar-Odenwald-Kreis,10 - 15 Jahre,8911,4592,4319
False,8225,Landkreis Neckar-Odenwald-Kreis,15 - 18 Jahre,5900,2974,2926
False,8225,Landkreis Neckar-Odenwald-Kreis,18 - 20 Jahre,3816,2016,1800
False,8225,Landkreis Neckar-Odenwald-Kreis,20 - 25 Jahre,8713,4518,4195
False,8225,Landkreis Neckar-Odenwald-Kreis,25 - 30 Jahre,8012,4127,3885
False,8225,Landkreis Neckar-Odenwald-Kreis,30 - 35 Jahre,8698,4360,4338
False,8225,Landkreis Neckar-Odenwald-Kreis,35 - 40 Jahre,12229,6506,5723
False,8225,Landkreis Neckar-Odenwald-Kreis,40 - 45 Jahre,13438,7013,6425
False,8225,Landkreis Neckar-Odenwald-Kreis,45 - 50 Jahre,11984,6090,5894
False,8225,Landkreis Neckar-Odenwald-Kreis,50 - 55 Jahre,10181,5194,4987
False,8225,Landkreis Neckar-Odenwald-Kreis,55 - 60 Jahre,8666,4406,4260
False,8225,Landkreis Neckar-Odenwald-Kreis,60 - 65 Jahre,7355,3690,3665
False,8225,Landkreis Neckar-Odenwald-Kreis,65 - 75 Jahre,15661,7547,8114
False,8225,Landkreis Neckar-Odenwald-Kreis,75 und mehr Jahre,12172,4246,7926
False,8225,Landkreis Neckar-Odenwald-Kreis,Insgesamt,150628,75044,75584
False,8225001,"Adelsheim, Stadt",unter 3 Jahre,132,72,60
False,8225001,"Adelsheim, Stadt",3 -  6 Jahre,174,83,91
False,8225001,"Adelsheim, Stadt",6 - 10 Jahre,206,115,91
False,8225001,"Adelsheim, Stadt",10 - 15 Jahre,293,146,147
False,8225001,"Adelsheim, Stadt",15 - 18 Jahre,179,88,91
False,8225001,"Adelsheim, Stadt",18 - 20 Jahre,102,55,47
False,8225001,"Adelsheim, Stadt",20 - 25 Jahre,283,139,144
False,8225001,"Adelsheim, Stadt",25 - 30 Jahre,221,105,116
False,8225001,"Adelsheim, Stadt",30 - 35 Jahre,355,173,182
False,8225001,"Adelsheim, Stadt",35 - 40 Jahre,723,512,211
False,8225001,"Adelsheim, Stadt",40 - 45 Jahre,471,243,228
False,8225001,"Adelsheim, Stadt",45 - 50 Jahre,389,224,165
False,8225001,"Adelsheim, Stadt",50 - 55 Jahre,327,163,164
False,8225001,"Adelsheim, Stadt",55 - 60 Jahre,297,150,147
False,8225001,"Adelsheim, Stadt",60 - 65 Jahre,250,131,119
False,8225001,"Adelsheim, Stadt",65 - 75 Jahre,595,288,307
False,8225001,"Adelsheim, Stadt",75 und mehr Jahre,460,161,299
False,8225001,"Adelsheim, Stadt",Insgesamt,5457,2848,2609
False,8225002,Aglasterhausen,unter 3 Jahre,143,69,74
False,8225002,Aglasterhausen,3 -  6 Jahre,179,96,83
False,8225002,Aglasterhausen,6 - 10 Jahre,236,105,131
False,8225002,Aglasterhausen,10 - 15 Jahre,304,169,135
False,8225002,Aglasterhausen,15 - 18 Jahre,179,83,96
False,8225002,Aglasterhausen,18 - 20 Jahre,123,76,47
False,8225002,Aglasterhausen,20 - 25 Jahre,294,140,154
False,8225002,Aglasterhausen,25 - 30 Jahre,308,157,151
False,8225002,Aglasterhausen,30 - 35 Jahre,307,143,164
False,8225002,Aglasterhausen,35 - 40 Jahre,420,215,205
False,8225002,Aglasterhausen,40 - 45 Jahre,425,219,206
False,8225002,Aglasterhausen,45 - 50 Jahre,415,218,197
False,8225002,Aglasterhausen,50 - 55 Jahre,318,144,174
False,8225002,Aglasterhausen,55 - 60 Jahre,265,140,125
False,8225002,Aglasterhausen,60 - 65 Jahre,200,105,95
False,8225002,Aglasterhausen,65 - 75 Jahre,463,217,246
False,8225002,Aglasterhausen,75 und mehr Jahre,452,141,311
False,8225002,Aglasterhausen,Insgesamt,5031,2437,2594
False,8225009,Billigheim,unter 3 Jahre,166,85,81
False,8225009,Billigheim,3 -  6 Jahre,218,115,103
False,8225009,Billigheim,6 - 10 Jahre,291,168,123
False,8225009,Billigheim,10 - 15 Jahre,361,184,177
False,8225009,Billigheim,15 - 18 Jahre,248,133,115
False,8225009,Billigheim,18 - 20 Jahre,148,73,75
False,8225009,Billigheim,20 - 25 Jahre,313,159,154
False,8225009,Billigheim,25 - 30 Jahre,285,147,138
False,8225009,Billigheim,30 - 35 Jahre,361,179,182
False,8225009,Billigheim,35 - 40 Jahre,489,247,242
False,8225009,Billigheim,40 - 45 Jahre,527,273,254
False,8225009,Billigheim,45 - 50 Jahre,497,277,220
False,8225009,Billigheim,50 - 55 Jahre,375,201,174
False,8225009,Billigheim,55 - 60 Jahre,315,157,158
False,8225009,Billigheim,60 - 65 Jahre,281,146,135
False,8225009,Billigheim,65 - 75 Jahre,606,297,309
False,8225009,Billigheim,75 und mehr Jahre,381,138,243
False,8225009,Billigheim,Insgesamt,5862,2979,2883
False,8225010,Binau,unter 3 Jahre,36,21,15
False,8225010,Binau,3 -  6 Jahre,44,21,23
False,8225010,Binau,6 - 10 Jahre,53,38,15
False,8225010,Binau,10 - 15 Jahre,68,37,31
False,8225010,Binau,15 - 18 Jahre,45,17,28
False,8225010,Binau,18 - 20 Jahre,29,19,10
False,8225010,Binau,20 - 25 Jahre,68,33,35
False,8225010,Binau,25 - 30 Jahre,74,39,35
False,8225010,Binau,30 - 35 Jahre,87,47,40
False,8225010,Binau,35 - 40 Jahre,121,60,61
False,8225010,Binau,40 - 45 Jahre,119,60,59
False,8225010,Binau,45 - 50 Jahre,114,53,61
False,8225010,Binau,50 - 55 Jahre,107,58,49
False,8225010,Binau,55 - 60 Jahre,102,51,51
False,8225010,Binau,60 - 65 Jahre,85,41,44
False,8225010,Binau,65 - 75 Jahre,138,81,57
False,8225010,Binau,75 und mehr Jahre,87,40,47
False,8225010,Binau,Insgesamt,1377,716,661
False,8225014,"Buchen (Odenwald), Stadt",unter 3 Jahre,526,256,270
False,8225014,"Buchen (Odenwald), Stadt",3 -  6 Jahre,559,279,280
False,8225014,"Buchen (Odenwald), Stadt",6 - 10 Jahre,867,449,418
False,8225014,"Buchen (Odenwald), Stadt",10 - 15 Jahre,1139,588,551
False,8225014,"Buchen (Odenwald), Stadt",15 - 18 Jahre,764,392,372
False,8225014,"Buchen (Odenwald), Stadt",18 - 20 Jahre,527,281,246
False,8225014,"Buchen (Odenwald), Stadt",20 - 25 Jahre,1136,595,541
False,8225014,"Buchen (Odenwald), Stadt",25 - 30 Jahre,1080,536,544
False,8225014,"Buchen (Odenwald), Stadt",30 - 35 Jahre,1051,557,494
False,8225014,"Buchen (Odenwald), Stadt",35 - 40 Jahre,1365,725,640
False,8225014,"Buchen (Odenwald), Stadt",40 - 45 Jahre,1555,771,784
False,8225014,"Buchen (Odenwald), Stadt",45 - 50 Jahre,1480,738,742
False,8225014,"Buchen (Odenwald), Stadt",50 - 55 Jahre,1291,638,653
False,8225014,"Buchen (Odenwald), Stadt",55 - 60 Jahre,1109,573,536
False,8225014,"Buchen (Odenwald), Stadt",60 - 65 Jahre,869,429,440
False,8225014,"Buchen (Odenwald), Stadt",65 - 75 Jahre,2005,977,1028
False,8225014,"Buchen (Odenwald), Stadt",75 und mehr Jahre,1521,551,970
False,8225014,"Buchen (Odenwald), Stadt",Insgesamt,18844,9335,9509
False,8225024,Fahrenbach,unter 3 Jahre,83,42,41
False,8225024,Fahrenbach,3 -  6 Jahre,82,37,45
False,8225024,Fahrenbach,6 - 10 Jahre,117,65,52
False,8225024,Fahrenbach,10 - 15 Jahre,158,76,82
False,8225024,Fahrenbach,15 - 18 Jahre,136,62,74
False,8225024,Fahrenbach,18 - 20 Jahre,79,45,34
False,8225024,Fahrenbach,20 - 25 Jahre,145,73,72
False,8225024,Fahrenbach,25 - 30 Jahre,157,80,77
False,8225024,Fahrenbach,30 - 35 Jahre,171,79,92
False,8225024,Fahrenbach,35 - 40 Jahre,218,109,109
False,8225024,Fahrenbach,40 - 45 Jahre,267,135,132
False,8225024,Fahrenbach,45 - 50 Jahre,217,118,99
False,8225024,Fahrenbach,50 - 55 Jahre,192,107,85
False,8225024,Fahrenbach,55 - 60 Jahre,158,73,85
False,8225024,Fahrenbach,60 - 65 Jahre,143,73,70
False,8225024,Fahrenbach,65 - 75 Jahre,308,152,156
False,8225024,Fahrenbach,75 und mehr Jahre,255,78,177
False,8225024,Fahrenbach,Insgesamt,2886,1404,1482
False,8225032,Hardheim,unter 3 Jahre,189,94,95
False,8225032,Hardheim,3 -  6 Jahre,201,106,95
False,8225032,Hardheim,6 - 10 Jahre,293,160,133
False,8225032,Hardheim,10 - 15 Jahre,449,229,220
False,8225032,Hardheim,15 - 18 Jahre,310,168,142
False,8225032,Hardheim,18 - 20 Jahre,204,107,97
False,8225032,Hardheim,20 - 25 Jahre,427,238,189
False,8225032,Hardheim,25 - 30 Jahre,423,227,196
False,8225032,Hardheim,30 - 35 Jahre,413,200,213
False,8225032,Hardheim,35 - 40 Jahre,617,320,297
False,8225032,Hardheim,40 - 45 Jahre,684,368,316
False,8225032,Hardheim,45 - 50 Jahre,602,306,296
False,8225032,Hardheim,50 - 55 Jahre,493,258,235
False,8225032,Hardheim,55 - 60 Jahre,396,205,191
False,8225032,Hardheim,60 - 65 Jahre,336,165,171
False,8225032,Hardheim,65 - 75 Jahre,752,362,390
False,8225032,Hardheim,75 und mehr Jahre,647,227,420
False,8225032,Hardheim,Insgesamt,7436,3740,3696
False,8225033,Haßmersheim,unter 3 Jahre,121,59,62
False,8225033,Haßmersheim,3 -  6 Jahre,157,78,79
False,8225033,Haßmersheim,6 - 10 Jahre,250,123,127
False,8225033,Haßmersheim,10 - 15 Jahre,301,153,148
False,8225033,Haßmersheim,15 - 18 Jahre,183,100,83
False,8225033,Haßmersheim,18 - 20 Jahre,128,71,57
False,8225033,Haßmersheim,20 - 25 Jahre,316,170,146
False,8225033,Haßmersheim,25 - 30 Jahre,257,138,119
False,8225033,Haßmersheim,30 - 35 Jahre,284,139,145
False,8225033,Haßmersheim,35 - 40 Jahre,406,204,202
False,8225033,Haßmersheim,40 - 45 Jahre,417,228,189
False,8225033,Haßmersheim,45 - 50 Jahre,411,201,210
False,8225033,Haßmersheim,50 - 55 Jahre,300,159,141
False,8225033,Haßmersheim,55 - 60 Jahre,249,123,126
False,8225033,Haßmersheim,60 - 65 Jahre,283,140,143
False,8225033,Haßmersheim,65 - 75 Jahre,518,259,259
False,8225033,Haßmersheim,75 und mehr Jahre,336,115,221
False,8225033,Haßmersheim,Insgesamt,4917,2460,2457
False,8225039,Höpfingen,unter 3 Jahre,96,50,46
False,8225039,Höpfingen,3 -  6 Jahre,103,46,57
False,8225039,Höpfingen,6 - 10 Jahre,138,75,63
False,8225039,Höpfingen,10 - 15 Jahre,214,108,106
False,8225039,Höpfingen,15 - 18 Jahre,129,68,61
False,8225039,Höpfingen,18 - 20 Jahre,94,49,45
False,8225039,Höpfingen,20 - 25 Jahre,184,92,92
False,8225039,Höpfingen,25 - 30 Jahre,149,67,82
False,8225039,Höpfingen,30 - 35 Jahre,179,93,86
False,8225039,Höpfingen,35 - 40 Jahre,250,127,123
False,8225039,Höpfingen,40 - 45 Jahre,306,157,149
False,8225039,Höpfingen,45 - 50 Jahre,293,151,142
False,8225039,Höpfingen,50 - 55 Jahre,208,111,97
False,8225039,Höpfingen,55 - 60 Jahre,185,93,92
False,8225039,Höpfingen,60 - 65 Jahre,120,60,60
False,8225039,Höpfingen,65 - 75 Jahre,365,176,189
False,8225039,Höpfingen,75 und mehr Jahre,249,93,156
False,8225039,Höpfingen,Insgesamt,3262,1616,1646
False,8225042,Hüffenhardt,unter 3 Jahre,51,27,24
False,8225042,Hüffenhardt,3 -  6 Jahre,50,28,22
False,8225042,Hüffenhardt,6 - 10 Jahre,89,47,42
False,8225042,Hüffenhardt,10 - 15 Jahre,122,59,63
False,8225042,Hüffenhardt,15 - 18 Jahre,91,43,48
False,8225042,Hüffenhardt,18 - 20 Jahre,64,33,31
False,8225042,Hüffenhardt,20 - 25 Jahre,94,40,54
False,8225042,Hüffenhardt,25 - 30 Jahre,90,52,38
False,8225042,Hüffenhardt,30 - 35 Jahre,111,45,66
False,8225042,Hüffenhardt,35 - 40 Jahre,161,77,84
False,8225042,Hüffenhardt,40 - 45 Jahre,202,114,88
False,8225042,Hüffenhardt,45 - 50 Jahre,170,88,82
False,8225042,Hüffenhardt,50 - 55 Jahre,146,67,79
False,8225042,Hüffenhardt,55 - 60 Jahre,103,57,46
False,8225042,Hüffenhardt,60 - 65 Jahre,98,50,48
False,8225042,Hüffenhardt,65 - 75 Jahre,214,93,121
False,8225042,Hüffenhardt,75 und mehr Jahre,217,68,149
False,8225042,Hüffenhardt,Insgesamt,2073,988,1085
False,8225052,Limbach,unter 3 Jahre,120,59,61
False,8225052,Limbach,3 -  6 Jahre,120,54,66
False,8225052,Limbach,6 - 10 Jahre,196,109,87
False,8225052,Limbach,10 - 15 Jahre,290,152,138
False,8225052,Limbach,15 - 18 Jahre,190,87,103
False,8225052,Limbach,18 - 20 Jahre,120,67,53
False,8225052,Limbach,20 - 25 Jahre,257,128,129
False,8225052,Limbach,25 - 30 Jahre,202,98,104
False,8225052,Limbach,30 - 35 Jahre,238,134,104
False,8225052,Limbach,35 - 40 Jahre,350,192,158
False,8225052,Limbach,40 - 45 Jahre,432,214,218
False,8225052,Limbach,45 - 50 Jahre,382,195,187
False,8225052,Limbach,50 - 55 Jahre,328,182,146
False,8225052,Limbach,55 - 60 Jahre,234,130,104
False,8225052,Limbach,60 - 65 Jahre,202,100,102
False,8225052,Limbach,65 - 75 Jahre,480,235,245
False,8225052,Limbach,75 und mehr Jahre,433,152,281
False,8225052,Limbach,Insgesamt,4574,2288,2286
False,8225058,"Mosbach, Stadt",unter 3 Jahre,628,332,296
False,8225058,"Mosbach, Stadt",3 -  6 Jahre,669,355,314
False,8225058,"Mosbach, Stadt",6 - 10 Jahre,1016,537,479
False,8225058,"Mosbach, Stadt",10 - 15 Jahre,1300,687,613
False,8225058,"Mosbach, Stadt",15 - 18 Jahre,910,453,457
False,8225058,"Mosbach, Stadt",18 - 20 Jahre,678,348,330
False,8225058,"Mosbach, Stadt",20 - 25 Jahre,1593,843,750
False,8225058,"Mosbach, Stadt",25 - 30 Jahre,1475,746,729
False,8225058,"Mosbach, Stadt",30 - 35 Jahre,1467,747,720
False,8225058,"Mosbach, Stadt",35 - 40 Jahre,1927,1023,904
False,8225058,"Mosbach, Stadt",40 - 45 Jahre,2114,1091,1023
False,8225058,"Mosbach, Stadt",45 - 50 Jahre,1890,911,979
False,8225058,"Mosbach, Stadt",50 - 55 Jahre,1728,843,885
False,8225058,"Mosbach, Stadt",55 - 60 Jahre,1602,777,825
False,8225058,"Mosbach, Stadt",60 - 65 Jahre,1428,719,709
False,8225058,"Mosbach, Stadt",65 - 75 Jahre,2599,1225,1374
False,8225058,"Mosbach, Stadt",75 und mehr Jahre,2078,696,1382
False,8225058,"Mosbach, Stadt",Insgesamt,25102,12333,12769
False,8225060,Mudau,unter 3 Jahre,127,74,53
False,8225060,Mudau,3 -  6 Jahre,157,71,86
False,8225060,Mudau,6 - 10 Jahre,215,112,103
False,8225060,Mudau,10 - 15 Jahre,318,154,164
False,8225060,Mudau,15 - 18 Jahre,229,113,116
False,8225060,Mudau,18 - 20 Jahre,130,70,60
False,8225060,Mudau,20 - 25 Jahre,294,168,126
False,8225060,Mudau,25 - 30 Jahre,240,121,119
False,8225060,Mudau,30 - 35 Jahre,289,153,136
False,8225060,Mudau,35 - 40 Jahre,410,209,201
False,8225060,Mudau,40 - 45 Jahre,500,268,232
False,8225060,Mudau,45 - 50 Jahre,454,236,218
False,8225060,Mudau,50 - 55 Jahre,378,223,155
False,8225060,Mudau,55 - 60 Jahre,254,144,110
False,8225060,Mudau,60 - 65 Jahre,193,89,104
False,8225060,Mudau,65 - 75 Jahre,485,226,259
False,8225060,Mudau,75 und mehr Jahre,425,144,281
False,8225060,Mudau,Insgesamt,5098,2575,2523
False,8225064,Neckargerach,unter 3 Jahre,68,38,30
False,8225064,Neckargerach,3 -  6 Jahre,70,34,36
False,8225064,Neckargerach,6 - 10 Jahre,108,51,57
False,8225064,Neckargerach,10 - 15 Jahre,146,73,73
False,8225064,Neckargerach,15 - 18 Jahre,109,54,55
False,8225064,Neckargerach,18 - 20 Jahre,56,29,27
False,8225064,Neckargerach,20 - 25 Jahre,122,54,68
False,8225064,Neckargerach,25 - 30 Jahre,116,60,56
False,8225064,Neckargerach,30 - 35 Jahre,125,69,56
False,8225064,Neckargerach,35 - 40 Jahre,194,104,90
False,8225064,Neckargerach,40 - 45 Jahre,218,115,103
False,8225064,Neckargerach,45 - 50 Jahre,167,102,65
False,8225064,Neckargerach,50 - 55 Jahre,167,76,91
False,8225064,Neckargerach,55 - 60 Jahre,135,63,72
False,8225064,Neckargerach,60 - 65 Jahre,136,65,71
False,8225064,Neckargerach,65 - 75 Jahre,250,124,126
False,8225064,Neckargerach,75 und mehr Jahre,195,57,138
False,8225064,Neckargerach,Insgesamt,2382,1168,1214
False,8225067,Neckarzimmern,unter 3 Jahre,37,24,13
False,8225067,Neckarzimmern,3 -  6 Jahre,48,24,24
False,8225067,Neckarzimmern,6 - 10 Jahre,76,42,34
False,8225067,Neckarzimmern,10 - 15 Jahre,99,56,43
False,8225067,Neckarzimmern,15 - 18 Jahre,73,31,42
False,8225067,Neckarzimmern,18 - 20 Jahre,34,16,18
False,8225067,Neckarzimmern,20 - 25 Jahre,85,40,45
False,8225067,Neckarzimmern,25 - 30 Jahre,85,32,53
False,8225067,Neckarzimmern,30 - 35 Jahre,93,39,54
False,8225067,Neckarzimmern,35 - 40 Jahre,141,71,70
False,8225067,Neckarzimmern,40 - 45 Jahre,124,60,64
False,8225067,Neckarzimmern,45 - 50 Jahre,125,53,72
False,8225067,Neckarzimmern,50 - 55 Jahre,115,63,52
False,8225067,Neckarzimmern,55 - 60 Jahre,110,45,65
False,8225067,Neckarzimmern,60 - 65 Jahre,90,54,36
False,8225067,Neckarzimmern,65 - 75 Jahre,118,60,58
False,8225067,Neckarzimmern,75 und mehr Jahre,105,42,63
False,8225067,Neckarzimmern,Insgesamt,1558,752,806
False,8225068,Neunkirchen,unter 3 Jahre,33,22,11
False,8225068,Neunkirchen,3 -  6 Jahre,58,22,36
False,8225068,Neunkirchen,6 - 10 Jahre,96,50,46
False,8225068,Neunkirchen,10 - 15 Jahre,138,68,70
False,8225068,Neunkirchen,15 - 18 Jahre,60,29,31
False,8225068,Neunkirchen,18 - 20 Jahre,46,25,21
False,8225068,Neunkirchen,20 - 25 Jahre,92,48,44
False,8225068,Neunkirchen,25 - 30 Jahre,85,41,44
False,8225068,Neunkirchen,30 - 35 Jahre,95,57,38
False,8225068,Neunkirchen,35 - 40 Jahre,129,69,60
False,8225068,Neunkirchen,40 - 45 Jahre,219,111,108
False,8225068,Neunkirchen,45 - 50 Jahre,154,84,70
False,8225068,Neunkirchen,50 - 55 Jahre,125,69,56
False,8225068,Neunkirchen,55 - 60 Jahre,82,43,39
False,8225068,Neunkirchen,60 - 65 Jahre,78,38,40
False,8225068,Neunkirchen,65 - 75 Jahre,190,87,103
False,8225068,Neunkirchen,75 und mehr Jahre,116,41,75
False,8225068,Neunkirchen,Insgesamt,1796,904,892
False,8225074,Obrigheim,unter 3 Jahre,145,85,60
False,8225074,Obrigheim,3 -  6 Jahre,142,71,71
False,8225074,Obrigheim,6 - 10 Jahre,214,109,105
False,8225074,Obrigheim,10 - 15 Jahre,308,138,170
False,8225074,Obrigheim,15 - 18 Jahre,217,91,126
False,8225074,Obrigheim,18 - 20 Jahre,122,56,66
False,8225074,Obrigheim,20 - 25 Jahre,270,127,143
False,8225074,Obrigheim,25 - 30 Jahre,262,130,132
False,8225074,Obrigheim,30 - 35 Jahre,315,169,146
False,8225074,Obrigheim,35 - 40 Jahre,443,238,205
False,8225074,Obrigheim,40 - 45 Jahre,431,233,198
False,8225074,Obrigheim,45 - 50 Jahre,400,202,198
False,8225074,Obrigheim,50 - 55 Jahre,360,182,178
False,8225074,Obrigheim,55 - 60 Jahre,331,155,176
False,8225074,Obrigheim,60 - 65 Jahre,331,161,170
False,8225074,Obrigheim,65 - 75 Jahre,609,297,312
False,8225074,Obrigheim,75 und mehr Jahre,393,153,240
False,8225074,Obrigheim,Insgesamt,5293,2597,2696
False,8225075,"Osterburken, Stadt",unter 3 Jahre,216,117,99
False,8225075,"Osterburken, Stadt",3 -  6 Jahre,184,100,84
False,8225075,"Osterburken, Stadt",6 - 10 Jahre,252,132,120
False,8225075,"Osterburken, Stadt",10 - 15 Jahre,352,183,169
False,8225075,"Osterburken, Stadt",15 - 18 Jahre,222,123,99
False,8225075,"Osterburken, Stadt",18 - 20 Jahre,163,74,89
False,8225075,"Osterburken, Stadt",20 - 25 Jahre,404,214,190
False,8225075,"Osterburken, Stadt",25 - 30 Jahre,428,223,205
False,8225075,"Osterburken, Stadt",30 - 35 Jahre,409,190,219
False,8225075,"Osterburken, Stadt",35 - 40 Jahre,480,250,230
False,8225075,"Osterburken, Stadt",40 - 45 Jahre,540,284,256
False,8225075,"Osterburken, Stadt",45 - 50 Jahre,462,246,216
False,8225075,"Osterburken, Stadt",50 - 55 Jahre,452,234,218
False,8225075,"Osterburken, Stadt",55 - 60 Jahre,362,183,179
False,8225075,"Osterburken, Stadt",60 - 65 Jahre,279,141,138
False,8225075,"Osterburken, Stadt",65 - 75 Jahre,679,321,358
False,8225075,"Osterburken, Stadt",75 und mehr Jahre,649,222,427
False,8225075,"Osterburken, Stadt",Insgesamt,6533,3237,3296
False,8225082,Rosenberg,unter 3 Jahre,78,37,41
False,8225082,Rosenberg,3 -  6 Jahre,72,30,42
False,8225082,Rosenberg,6 - 10 Jahre,95,41,54
False,8225082,Rosenberg,10 - 15 Jahre,133,67,66
False,8225082,Rosenberg,15 - 18 Jahre,91,42,49
False,8225082,Rosenberg,18 - 20 Jahre,49,25,24
False,8225082,Rosenberg,20 - 25 Jahre,104,54,50
False,8225082,Rosenberg,25 - 30 Jahre,98,62,36
False,8225082,Rosenberg,30 - 35 Jahre,144,70,74
False,8225082,Rosenberg,35 - 40 Jahre,175,94,81
False,8225082,Rosenberg,40 - 45 Jahre,201,110,91
False,8225082,Rosenberg,45 - 50 Jahre,155,76,79
False,8225082,Rosenberg,50 - 55 Jahre,158,68,90
False,8225082,Rosenberg,55 - 60 Jahre,138,72,66
False,8225082,Rosenberg,60 - 65 Jahre,95,51,44
False,8225082,Rosenberg,65 - 75 Jahre,255,124,131
False,8225082,Rosenberg,75 und mehr Jahre,214,78,136
False,8225082,Rosenberg,Insgesamt,2255,1101,1154
False,8225091,Seckach,unter 3 Jahre,137,83,54
False,8225091,Seckach,3 -  6 Jahre,155,81,74
False,8225091,Seckach,6 - 10 Jahre,225,118,107
False,8225091,Seckach,10 - 15 Jahre,324,169,155
False,8225091,Seckach,15 - 18 Jahre,218,127,91
False,8225091,Seckach,18 - 20 Jahre,101,55,46
False,8225091,Seckach,20 - 25 Jahre,281,146,135
False,8225091,Seckach,25 - 30 Jahre,253,140,113
False,8225091,Seckach,30 - 35 Jahre,237,114,123
False,8225091,Seckach,35 - 40 Jahre,347,172,175
False,8225091,Seckach,40 - 45 Jahre,399,212,187
False,8225091,Seckach,45 - 50 Jahre,358,183,175
False,8225091,Seckach,50 - 55 Jahre,305,151,154
False,8225091,Seckach,55 - 60 Jahre,227,118,109
False,8225091,Seckach,60 - 65 Jahre,173,84,89
False,8225091,Seckach,65 - 75 Jahre,421,203,218
False,8225091,Seckach,75 und mehr Jahre,293,97,196
False,8225091,Seckach,Insgesamt,4454,2253,2201
False,8225109,"Walldürn, Stadt",unter 3 Jahre,300,156,144
False,8225109,"Walldürn, Stadt",3 -  6 Jahre,339,182,157
False,8225109,"Walldürn, Stadt",6 - 10 Jahre,510,278,232
False,8225109,"Walldürn, Stadt",10 - 15 Jahre,734,391,343
False,8225109,"Walldürn, Stadt",15 - 18 Jahre,424,225,199
False,8225109,"Walldürn, Stadt",18 - 20 Jahre,293,149,144
False,8225109,"Walldürn, Stadt",20 - 25 Jahre,710,360,350
False,8225109,"Walldürn, Stadt",25 - 30 Jahre,646,342,304
False,8225109,"Walldürn, Stadt",30 - 35 Jahre,665,322,343
False,8225109,"Walldürn, Stadt",35 - 40 Jahre,970,500,470
False,8225109,"Walldürn, Stadt",40 - 45 Jahre,1059,567,492
False,8225109,"Walldürn, Stadt",45 - 50 Jahre,952,466,486
False,8225109,"Walldürn, Stadt",50 - 55 Jahre,799,409,390
False,8225109,"Walldürn, Stadt",55 - 60 Jahre,696,357,339
False,8225109,"Walldürn, Stadt",60 - 65 Jahre,610,308,302
False,8225109,"Walldürn, Stadt",65 - 75 Jahre,1333,630,703
False,8225109,"Walldürn, Stadt",75 und mehr Jahre,993,333,660
False,8225109,"Walldürn, Stadt",Insgesamt,12033,5975,6058
False,8225113,Zwingenberg,unter 3 Jahre,26,15,11
False,8225113,Zwingenberg,3 -  6 Jahre,22,11,11
False,8225113,Zwingenberg,6 - 10 Jahre,30,19,11
False,8225113,Zwingenberg,10 - 15 Jahre,51,22,29
False,8225113,Zwingenberg,15 - 18 Jahre,27,12,15
False,8225113,Zwingenberg,18 - 20 Jahre,15,6,9
False,8225113,Zwingenberg,20 - 25 Jahre,50,25,25
False,8225113,Zwingenberg,25 - 30 Jahre,39,17,22
False,8225113,Zwingenberg,30 - 35 Jahre,37,16,21
False,8225113,Zwingenberg,35 - 40 Jahre,49,35,14
False,8225113,Zwingenberg,40 - 45 Jahre,57,25,32
False,8225113,Zwingenberg,45 - 50 Jahre,72,35,37
False,8225113,Zwingenberg,50 - 55 Jahre,38,16,22
False,8225113,Zwingenberg,55 - 60 Jahre,47,28,19
False,8225113,Zwingenberg,60 - 65 Jahre,41,17,24
False,8225113,Zwingenberg,65 - 75 Jahre,73,38,35
False,8225113,Zwingenberg,75 und mehr Jahre,70,29,41
False,8225113,Zwingenberg,Insgesamt,744,366,378
False,8225114,"Ravenstein, Stadt",unter 3 Jahre,91,49,42
False,8225114,"Ravenstein, Stadt",3 -  6 Jahre,89,45,44
False,8225114,"Ravenstein, Stadt",6 - 10 Jahre,137,78,59
False,8225114,"Ravenstein, Stadt",10 - 15 Jahre,187,104,83
False,8225114,"Ravenstein, Stadt",15 - 18 Jahre,143,75,68
False,8225114,"Ravenstein, Stadt",18 - 20 Jahre,80,46,34
False,8225114,"Ravenstein, Stadt",20 - 25 Jahre,178,89,89
False,8225114,"Ravenstein, Stadt",25 - 30 Jahre,157,93,64
False,8225114,"Ravenstein, Stadt",30 - 35 Jahre,179,87,92
False,8225114,"Ravenstein, Stadt",35 - 40 Jahre,270,140,130
False,8225114,"Ravenstein, Stadt",40 - 45 Jahre,293,157,136
False,8225114,"Ravenstein, Stadt",45 - 50 Jahre,245,120,125
False,8225114,"Ravenstein, Stadt",50 - 55 Jahre,194,111,83
False,8225114,"Ravenstein, Stadt",55 - 60 Jahre,149,79,70
False,8225114,"Ravenstein, Stadt",60 - 65 Jahre,133,65,68
False,8225114,"Ravenstein, Stadt",65 - 75 Jahre,316,153,163
False,8225114,"Ravenstein, Stadt",75 und mehr Jahre,260,106,154
False,8225114,"Ravenstein, Stadt",Insgesamt,3101,1597,1504
False,8225115,Schefflenz,unter 3 Jahre,111,65,46
False,8225115,Schefflenz,3 -  6 Jahre,118,69,49
False,8225115,Schefflenz,6 - 10 Jahre,192,100,92
False,8225115,Schefflenz,10 - 15 Jahre,251,122,129
False,8225115,Schefflenz,15 - 18 Jahre,199,92,107
False,8225115,Schefflenz,18 - 20 Jahre,105,54,51
False,8225115,Schefflenz,20 - 25 Jahre,234,124,110
False,8225115,Schefflenz,25 - 30 Jahre,199,100,99
False,8225115,Schefflenz,30 - 35 Jahre,260,141,119
False,8225115,Schefflenz,35 - 40 Jahre,307,150,157
False,8225115,Schefflenz,40 - 45 Jahre,387,189,198
False,8225115,Schefflenz,45 - 50 Jahre,341,182,159
False,8225115,Schefflenz,50 - 55 Jahre,305,150,155
False,8225115,Schefflenz,55 - 60 Jahre,279,148,131
False,8225115,Schefflenz,60 - 65 Jahre,217,111,106
False,8225115,Schefflenz,65 - 75 Jahre,439,213,226
False,8225115,Schefflenz,75 und mehr Jahre,346,117,229
False,8225115,Schefflenz,Insgesamt,4290,2127,2163
False,8225116,Schwarzach,unter 3 Jahre,57,29,28
False,8225116,Schwarzach,3 -  6 Jahre,50,30,20
False,8225116,Schwarzach,6 - 10 Jahre,87,44,43
False,8225116,Schwarzach,10 - 15 Jahre,178,105,73
False,8225116,Schwarzach,15 - 18 Jahre,103,57,46
False,8225116,Schwarzach,18 - 20 Jahre,61,42,19
False,8225116,Schwarzach,20 - 25 Jahre,167,90,77
False,8225116,Schwarzach,25 - 30 Jahre,173,103,70
False,8225116,Schwarzach,30 - 35 Jahre,194,106,88
False,8225116,Schwarzach,35 - 40 Jahre,385,211,174
False,8225116,Schwarzach,40 - 45 Jahre,476,274,202
False,8225116,Schwarzach,45 - 50 Jahre,292,161,131
False,8225116,Schwarzach,50 - 55 Jahre,231,121,110
False,8225116,Schwarzach,55 - 60 Jahre,181,103,78
False,8225116,Schwarzach,60 - 65 Jahre,133,76,57
False,8225116,Schwarzach,65 - 75 Jahre,234,112,122
False,8225116,Schwarzach,75 und mehr Jahre,175,57,118
False,8225116,Schwarzach,Insgesamt,3177,1721,1456
False,8225117,Elztal,unter 3 Jahre,163,79,84
False,8225117,Elztal,3 -  6 Jahre,175,97,78
False,8225117,Elztal,6 - 10 Jahre,286,135,151
False,8225117,Elztal,10 - 15 Jahre,391,205,186
False,8225117,Elztal,15 - 18 Jahre,231,115,116
False,8225117,Elztal,18 - 20 Jahre,158,88,70
False,8225117,Elztal,20 - 25 Jahre,377,199,178
False,8225117,Elztal,25 - 30 Jahre,327,173,154
False,8225117,Elztal,30 - 35 Jahre,354,158,196
False,8225117,Elztal,35 - 40 Jahre,460,243,217
False,8225117,Elztal,40 - 45 Jahre,549,283,266
False,8225117,Elztal,45 - 50 Jahre,527,270,257
False,8225117,Elztal,50 - 55 Jahre,389,200,189
False,8225117,Elztal,55 - 60 Jahre,374,186,188
False,8225117,Elztal,60 - 65 Jahre,292,154,138
False,8225117,Elztal,65 - 75 Jahre,646,322,324
False,8225117,Elztal,75 und mehr Jahre,367,147,220
False,8225117,Elztal,Insgesamt,6066,3054,3012
False,8225118,Waldbrunn,unter 3 Jahre,132,62,70
False,8225118,Waldbrunn,3 -  6 Jahre,141,67,74
False,8225118,Waldbrunn,6 - 10 Jahre,229,132,97
False,8225118,Waldbrunn,10 - 15 Jahre,302,147,155
False,8225118,Waldbrunn,15 - 18 Jahre,190,94,96
False,8225118,Waldbrunn,18 - 20 Jahre,107,57,50
False,8225118,Waldbrunn,20 - 25 Jahre,235,130,105
False,8225118,Waldbrunn,25 - 30 Jahre,183,98,85
False,8225118,Waldbrunn,30 - 35 Jahre,278,133,145
False,8225118,Waldbrunn,35 - 40 Jahre,422,209,213
False,8225118,Waldbrunn,40 - 45 Jahre,466,252,214
False,8225118,Waldbrunn,45 - 50 Jahre,420,194,226
False,8225118,Waldbrunn,50 - 55 Jahre,352,190,162
False,8225118,Waldbrunn,55 - 60 Jahre,286,153,133
False,8225118,Waldbrunn,60 - 65 Jahre,259,117,142
False,8225118,Waldbrunn,65 - 75 Jahre,570,275,295
False,8225118,Waldbrunn,75 und mehr Jahre,455,163,292
False,8225118,Waldbrunn,Insgesamt,5027,2473,2554
False,8226,Landkreis Rhein-Neckar-Kreis,unter 3 Jahre,13777,7094,6683
False,8226,Landkreis Rhein-Neckar-Kreis,3 -  6 Jahre,15050,7585,7465
False,8226,Landkreis Rhein-Neckar-Kreis,6 - 10 Jahre,21977,11259,10718
False,8226,Landkreis Rhein-Neckar-Kreis,10 - 15 Jahre,28529,14505,14024
False,8226,Landkreis Rhein-Neckar-Kreis,15 - 18 Jahre,18193,9389,8804
False,8226,Landkreis Rhein-Neckar-Kreis,18 - 20 Jahre,11829,6081,5748
False,8226,Landkreis Rhein-Neckar-Kreis,20 - 25 Jahre,29206,14596,14610
False,8226,Landkreis Rhein-Neckar-Kreis,25 - 30 Jahre,29314,14367,14947
False,8226,Landkreis Rhein-Neckar-Kreis,30 - 35 Jahre,31728,15658,16070
False,8226,Landkreis Rhein-Neckar-Kreis,35 - 40 Jahre,45297,22832,22465
False,8226,Landkreis Rhein-Neckar-Kreis,40 - 45 Jahre,48439,24506,23933
False,8226,Landkreis Rhein-Neckar-Kreis,45 - 50 Jahre,42256,21199,21057
False,8226,Landkreis Rhein-Neckar-Kreis,50 - 55 Jahre,35963,17713,18250
False,8226,Landkreis Rhein-Neckar-Kreis,55 - 60 Jahre,33312,16414,16898
False,8226,Landkreis Rhein-Neckar-Kreis,60 - 65 Jahre,30351,15007,15344
False,8226,Landkreis Rhein-Neckar-Kreis,65 - 75 Jahre,57456,27535,29921
False,8226,Landkreis Rhein-Neckar-Kreis,75 und mehr Jahre,41316,14775,26541
False,8226,Landkreis Rhein-Neckar-Kreis,Insgesamt,533993,260515,273478
False,8226003,Altlußheim,unter 3 Jahre,119,65,54
False,8226003,Altlußheim,3 -  6 Jahre,160,76,84
False,8226003,Altlußheim,6 - 10 Jahre,214,89,125
False,8226003,Altlußheim,10 - 15 Jahre,310,136,174
False,8226003,Altlußheim,15 - 18 Jahre,181,90,91
False,8226003,Altlußheim,18 - 20 Jahre,118,57,61
False,8226003,Altlußheim,20 - 25 Jahre,260,126,134
False,8226003,Altlußheim,25 - 30 Jahre,234,114,120
False,8226003,Altlußheim,30 - 35 Jahre,287,145,142
False,8226003,Altlußheim,35 - 40 Jahre,457,226,231
False,8226003,Altlußheim,40 - 45 Jahre,517,241,276
False,8226003,Altlußheim,45 - 50 Jahre,428,222,206
False,8226003,Altlußheim,50 - 55 Jahre,375,189,186
False,8226003,Altlußheim,55 - 60 Jahre,330,170,160
False,8226003,Altlußheim,60 - 65 Jahre,340,157,183
False,8226003,Altlußheim,65 - 75 Jahre,603,293,310
False,8226003,Altlußheim,75 und mehr Jahre,384,135,249
False,8226003,Altlußheim,Insgesamt,5317,2531,2786
False,8226006,Bammental,unter 3 Jahre,125,66,59
False,8226006,Bammental,3 -  6 Jahre,150,73,77
False,8226006,Bammental,6 - 10 Jahre,283,152,131
False,8226006,Bammental,10 - 15 Jahre,341,184,157
False,8226006,Bammental,15 - 18 Jahre,267,139,128
False,8226006,Bammental,18 - 20 Jahre,179,96,83
False,8226006,Bammental,20 - 25 Jahre,378,197,181
False,8226006,Bammental,25 - 30 Jahre,336,179,157
False,8226006,Bammental,30 - 35 Jahre,375,212,163
False,8226006,Bammental,35 - 40 Jahre,444,234,210
False,8226006,Bammental,40 - 45 Jahre,602,284,318
False,8226006,Bammental,45 - 50 Jahre,532,252,280
False,8226006,Bammental,50 - 55 Jahre,501,248,253
False,8226006,Bammental,55 - 60 Jahre,382,202,180
False,8226006,Bammental,60 - 65 Jahre,371,181,190
False,8226006,Bammental,65 - 75 Jahre,665,302,363
False,8226006,Bammental,75 und mehr Jahre,586,194,392
False,8226006,Bammental,Insgesamt,6517,3195,3322
False,8226009,Brühl,unter 3 Jahre,299,164,135
False,8226009,Brühl,3 -  6 Jahre,330,152,178
False,8226009,Brühl,6 - 10 Jahre,491,251,240
False,8226009,Brühl,10 - 15 Jahre,676,321,355
False,8226009,Brühl,15 - 18 Jahre,463,257,206
False,8226009,Brühl,18 - 20 Jahre,294,150,144
False,8226009,Brühl,20 - 25 Jahre,731,370,361
False,8226009,Brühl,25 - 30 Jahre,787,374,413
False,8226009,Brühl,30 - 35 Jahre,715,350,365
False,8226009,Brühl,35 - 40 Jahre,1185,585,600
False,8226009,Brühl,40 - 45 Jahre,1222,593,629
False,8226009,Brühl,45 - 50 Jahre,1222,591,631
False,8226009,Brühl,50 - 55 Jahre,1041,502,539
False,8226009,Brühl,55 - 60 Jahre,1111,560,551
False,8226009,Brühl,60 - 65 Jahre,928,458,470
False,8226009,Brühl,65 - 75 Jahre,1639,797,842
False,8226009,Brühl,75 und mehr Jahre,1265,410,855
False,8226009,Brühl,Insgesamt,14399,6885,7514
False,8226010,Dielheim,unter 3 Jahre,242,130,112
False,8226010,Dielheim,3 -  6 Jahre,290,151,139
False,8226010,Dielheim,6 - 10 Jahre,435,221,214
False,8226010,Dielheim,10 - 15 Jahre,537,266,271
False,8226010,Dielheim,15 - 18 Jahre,349,182,167
False,8226010,Dielheim,18 - 20 Jahre,221,111,110
False,8226010,Dielheim,20 - 25 Jahre,476,241,235
False,8226010,Dielheim,25 - 30 Jahre,419,213,206
False,8226010,Dielheim,30 - 35 Jahre,511,247,264
False,8226010,Dielheim,35 - 40 Jahre,848,437,411
False,8226010,Dielheim,40 - 45 Jahre,858,403,455
False,8226010,Dielheim,45 - 50 Jahre,716,359,357
False,8226010,Dielheim,50 - 55 Jahre,614,308,306
False,8226010,Dielheim,55 - 60 Jahre,549,279,270
False,8226010,Dielheim,60 - 65 Jahre,444,246,198
False,8226010,Dielheim,65 - 75 Jahre,871,419,452
False,8226010,Dielheim,75 und mehr Jahre,530,197,333
False,8226010,Dielheim,Insgesamt,8910,4410,4500
False,8226012,Dossenheim,unter 3 Jahre,325,162,163
False,8226012,Dossenheim,3 -  6 Jahre,338,182,156
False,8226012,Dossenheim,6 - 10 Jahre,429,236,193
False,8226012,Dossenheim,10 - 15 Jahre,510,263,247
False,8226012,Dossenheim,15 - 18 Jahre,281,153,128
False,8226012,Dossenheim,18 - 20 Jahre,240,111,129
False,8226012,Dossenheim,20 - 25 Jahre,845,362,483
False,8226012,Dossenheim,25 - 30 Jahre,875,387,488
False,8226012,Dossenheim,30 - 35 Jahre,850,433,417
False,8226012,Dossenheim,35 - 40 Jahre,1074,519,555
False,8226012,Dossenheim,40 - 45 Jahre,1121,562,559
False,8226012,Dossenheim,45 - 50 Jahre,939,450,489
False,8226012,Dossenheim,50 - 55 Jahre,727,333,394
False,8226012,Dossenheim,55 - 60 Jahre,659,327,332
False,8226012,Dossenheim,60 - 65 Jahre,559,252,307
False,8226012,Dossenheim,65 - 75 Jahre,1081,511,570
False,8226012,Dossenheim,75 und mehr Jahre,810,289,521
False,8226012,Dossenheim,Insgesamt,11663,5532,6131
False,8226013,"Eberbach, Stadt",unter 3 Jahre,326,159,167
False,8226013,"Eberbach, Stadt",3 -  6 Jahre,394,188,206
False,8226013,"Eberbach, Stadt",6 - 10 Jahre,628,323,305
False,8226013,"Eberbach, Stadt",10 - 15 Jahre,845,427,418
False,8226013,"Eberbach, Stadt",15 - 18 Jahre,535,292,243
False,8226013,"Eberbach, Stadt",18 - 20 Jahre,354,189,165
False,8226013,"Eberbach, Stadt",20 - 25 Jahre,770,386,384
False,8226013,"Eberbach, Stadt",25 - 30 Jahre,749,350,399
False,8226013,"Eberbach, Stadt",30 - 35 Jahre,825,385,440
False,8226013,"Eberbach, Stadt",35 - 40 Jahre,1185,579,606
False,8226013,"Eberbach, Stadt",40 - 45 Jahre,1241,608,633
False,8226013,"Eberbach, Stadt",45 - 50 Jahre,1148,586,562
False,8226013,"Eberbach, Stadt",50 - 55 Jahre,1003,486,517
False,8226013,"Eberbach, Stadt",55 - 60 Jahre,957,443,514
False,8226013,"Eberbach, Stadt",60 - 65 Jahre,882,405,477
False,8226013,"Eberbach, Stadt",65 - 75 Jahre,1920,933,987
False,8226013,"Eberbach, Stadt",75 und mehr Jahre,1637,567,1070
False,8226013,"Eberbach, Stadt",Insgesamt,15399,7306,8093
False,8226017,Epfenbach,unter 3 Jahre,72,40,32
False,8226017,Epfenbach,3 -  6 Jahre,78,40,38
False,8226017,Epfenbach,6 - 10 Jahre,126,72,54
False,8226017,Epfenbach,10 - 15 Jahre,161,78,83
False,8226017,Epfenbach,15 - 18 Jahre,98,59,39
False,8226017,Epfenbach,18 - 20 Jahre,65,32,33
False,8226017,Epfenbach,20 - 25 Jahre,131,70,61
False,8226017,Epfenbach,25 - 30 Jahre,126,64,62
False,8226017,Epfenbach,30 - 35 Jahre,142,76,66
False,8226017,Epfenbach,35 - 40 Jahre,216,103,113
False,8226017,Epfenbach,40 - 45 Jahre,220,127,93
False,8226017,Epfenbach,45 - 50 Jahre,208,104,104
False,8226017,Epfenbach,50 - 55 Jahre,180,87,93
False,8226017,Epfenbach,55 - 60 Jahre,162,91,71
False,8226017,Epfenbach,60 - 65 Jahre,122,52,70
False,8226017,Epfenbach,65 - 75 Jahre,253,134,119
False,8226017,Epfenbach,75 und mehr Jahre,157,63,94
False,8226017,Epfenbach,Insgesamt,2517,1292,1225
False,8226018,"Eppelheim, Stadt",unter 3 Jahre,398,206,192
False,8226018,"Eppelheim, Stadt",3 -  6 Jahre,363,207,156
False,8226018,"Eppelheim, Stadt",6 - 10 Jahre,569,289,280
False,8226018,"Eppelheim, Stadt",10 - 15 Jahre,717,389,328
False,8226018,"Eppelheim, Stadt",15 - 18 Jahre,427,217,210
False,8226018,"Eppelheim, Stadt",18 - 20 Jahre,263,139,124
False,8226018,"Eppelheim, Stadt",20 - 25 Jahre,914,386,528
False,8226018,"Eppelheim, Stadt",25 - 30 Jahre,1077,514,563
False,8226018,"Eppelheim, Stadt",30 - 35 Jahre,990,504,486
False,8226018,"Eppelheim, Stadt",35 - 40 Jahre,1220,635,585
False,8226018,"Eppelheim, Stadt",40 - 45 Jahre,1329,692,637
False,8226018,"Eppelheim, Stadt",45 - 50 Jahre,1042,536,506
False,8226018,"Eppelheim, Stadt",50 - 55 Jahre,896,417,479
False,8226018,"Eppelheim, Stadt",55 - 60 Jahre,844,418,426
False,8226018,"Eppelheim, Stadt",60 - 65 Jahre,783,370,413
False,8226018,"Eppelheim, Stadt",65 - 75 Jahre,1487,715,772
False,8226018,"Eppelheim, Stadt",75 und mehr Jahre,1038,347,691
False,8226018,"Eppelheim, Stadt",Insgesamt,14357,6981,7376
False,8226020,Eschelbronn,unter 3 Jahre,90,39,51
False,8226020,Eschelbronn,3 -  6 Jahre,97,54,43
False,8226020,Eschelbronn,6 - 10 Jahre,114,56,58
False,8226020,Eschelbronn,10 - 15 Jahre,167,94,73
False,8226020,Eschelbronn,15 - 18 Jahre,92,43,49
False,8226020,Eschelbronn,18 - 20 Jahre,54,26,28
False,8226020,Eschelbronn,20 - 25 Jahre,164,82,82
False,8226020,Eschelbronn,25 - 30 Jahre,143,81,62
False,8226020,Eschelbronn,30 - 35 Jahre,148,76,72
False,8226020,Eschelbronn,35 - 40 Jahre,197,100,97
False,8226020,Eschelbronn,40 - 45 Jahre,220,106,114
False,8226020,Eschelbronn,45 - 50 Jahre,184,97,87
False,8226020,Eschelbronn,50 - 55 Jahre,190,95,95
False,8226020,Eschelbronn,55 - 60 Jahre,157,89,68
False,8226020,Eschelbronn,60 - 65 Jahre,113,55,58
False,8226020,Eschelbronn,65 - 75 Jahre,250,131,119
False,8226020,Eschelbronn,75 und mehr Jahre,199,67,132
False,8226020,Eschelbronn,Insgesamt,2579,1291,1288
False,8226022,Gaiberg,unter 3 Jahre,72,35,37
False,8226022,Gaiberg,3 -  6 Jahre,71,41,30
False,8226022,Gaiberg,6 - 10 Jahre,110,62,48
False,8226022,Gaiberg,10 - 15 Jahre,140,73,67
False,8226022,Gaiberg,15 - 18 Jahre,87,50,37
False,8226022,Gaiberg,18 - 20 Jahre,60,30,30
False,8226022,Gaiberg,20 - 25 Jahre,110,68,42
False,8226022,Gaiberg,25 - 30 Jahre,115,51,64
False,8226022,Gaiberg,30 - 35 Jahre,127,65,62
False,8226022,Gaiberg,35 - 40 Jahre,197,91,106
False,8226022,Gaiberg,40 - 45 Jahre,240,110,130
False,8226022,Gaiberg,45 - 50 Jahre,208,123,85
False,8226022,Gaiberg,50 - 55 Jahre,172,73,99
False,8226022,Gaiberg,55 - 60 Jahre,179,80,99
False,8226022,Gaiberg,60 - 65 Jahre,164,81,83
False,8226022,Gaiberg,65 - 75 Jahre,262,125,137
False,8226022,Gaiberg,75 und mehr Jahre,153,67,86
False,8226022,Gaiberg,Insgesamt,2467,1225,1242
False,8226027,Heddesbach,unter 3 Jahre,9,4,5
False,8226027,Heddesbach,3 -  6 Jahre,16,10,6
False,8226027,Heddesbach,6 - 10 Jahre,30,12,18
False,8226027,Heddesbach,10 - 15 Jahre,25,13,12
False,8226027,Heddesbach,15 - 18 Jahre,24,12,12
False,8226027,Heddesbach,18 - 20 Jahre,10,4,6
False,8226027,Heddesbach,20 - 25 Jahre,19,8,11
False,8226027,Heddesbach,25 - 30 Jahre,19,9,10
False,8226027,Heddesbach,30 - 35 Jahre,11,5,6
False,8226027,Heddesbach,35 - 40 Jahre,45,20,25
False,8226027,Heddesbach,40 - 45 Jahre,43,24,19
False,8226027,Heddesbach,45 - 50 Jahre,40,17,23
False,8226027,Heddesbach,50 - 55 Jahre,30,17,13
False,8226027,Heddesbach,55 - 60 Jahre,27,12,15
False,8226027,Heddesbach,60 - 65 Jahre,33,21,12
False,8226027,Heddesbach,65 - 75 Jahre,56,27,29
False,8226027,Heddesbach,75 und mehr Jahre,57,21,36
False,8226027,Heddesbach,Insgesamt,494,236,258
False,8226028,Heddesheim,unter 3 Jahre,288,141,147
False,8226028,Heddesheim,3 -  6 Jahre,297,139,158
False,8226028,Heddesheim,6 - 10 Jahre,483,242,241
False,8226028,Heddesheim,10 - 15 Jahre,570,295,275
False,8226028,Heddesheim,15 - 18 Jahre,333,181,152
False,8226028,Heddesheim,18 - 20 Jahre,231,118,113
False,8226028,Heddesheim,20 - 25 Jahre,585,279,306
False,8226028,Heddesheim,25 - 30 Jahre,571,275,296
False,8226028,Heddesheim,30 - 35 Jahre,708,353,355
False,8226028,Heddesheim,35 - 40 Jahre,1062,561,501
False,8226028,Heddesheim,40 - 45 Jahre,1037,526,511
False,8226028,Heddesheim,45 - 50 Jahre,958,472,486
False,8226028,Heddesheim,50 - 55 Jahre,798,373,425
False,8226028,Heddesheim,55 - 60 Jahre,836,423,413
False,8226028,Heddesheim,60 - 65 Jahre,709,340,369
False,8226028,Heddesheim,65 - 75 Jahre,1295,615,680
False,8226028,Heddesheim,75 und mehr Jahre,897,333,564
False,8226028,Heddesheim,Insgesamt,11658,5666,5992
False,8226029,Heiligkreuzsteinach,unter 3 Jahre,76,40,36
False,8226029,Heiligkreuzsteinach,3 -  6 Jahre,73,35,38
False,8226029,Heiligkreuzsteinach,6 - 10 Jahre,133,70,63
False,8226029,Heiligkreuzsteinach,10 - 15 Jahre,164,84,80
False,8226029,Heiligkreuzsteinach,15 - 18 Jahre,115,57,58
False,8226029,Heiligkreuzsteinach,18 - 20 Jahre,80,43,37
False,8226029,Heiligkreuzsteinach,20 - 25 Jahre,174,92,82
False,8226029,Heiligkreuzsteinach,25 - 30 Jahre,158,84,74
False,8226029,Heiligkreuzsteinach,30 - 35 Jahre,162,81,81
False,8226029,Heiligkreuzsteinach,35 - 40 Jahre,272,142,130
False,8226029,Heiligkreuzsteinach,40 - 45 Jahre,265,142,123
False,8226029,Heiligkreuzsteinach,45 - 50 Jahre,266,156,110
False,8226029,Heiligkreuzsteinach,50 - 55 Jahre,193,100,93
False,8226029,Heiligkreuzsteinach,55 - 60 Jahre,180,90,90
False,8226029,Heiligkreuzsteinach,60 - 65 Jahre,187,99,88
False,8226029,Heiligkreuzsteinach,65 - 75 Jahre,368,193,175
False,8226029,Heiligkreuzsteinach,75 und mehr Jahre,255,100,155
False,8226029,Heiligkreuzsteinach,Insgesamt,3121,1608,1513
False,8226031,"Hemsbach, Stadt",unter 3 Jahre,250,128,122
False,8226031,"Hemsbach, Stadt",3 -  6 Jahre,342,173,169
False,8226031,"Hemsbach, Stadt",6 - 10 Jahre,495,256,239
False,8226031,"Hemsbach, Stadt",10 - 15 Jahre,607,316,291
False,8226031,"Hemsbach, Stadt",15 - 18 Jahre,408,212,196
False,8226031,"Hemsbach, Stadt",18 - 20 Jahre,235,119,116
False,8226031,"Hemsbach, Stadt",20 - 25 Jahre,659,324,335
False,8226031,"Hemsbach, Stadt",25 - 30 Jahre,667,364,303
False,8226031,"Hemsbach, Stadt",30 - 35 Jahre,706,349,357
False,8226031,"Hemsbach, Stadt",35 - 40 Jahre,1026,536,490
False,8226031,"Hemsbach, Stadt",40 - 45 Jahre,1088,579,509
False,8226031,"Hemsbach, Stadt",45 - 50 Jahre,943,478,465
False,8226031,"Hemsbach, Stadt",50 - 55 Jahre,813,401,412
False,8226031,"Hemsbach, Stadt",55 - 60 Jahre,755,365,390
False,8226031,"Hemsbach, Stadt",60 - 65 Jahre,843,405,438
False,8226031,"Hemsbach, Stadt",65 - 75 Jahre,1547,740,807
False,8226031,"Hemsbach, Stadt",75 und mehr Jahre,923,365,558
False,8226031,"Hemsbach, Stadt",Insgesamt,12307,6110,6197
False,8226032,"Hockenheim, Stadt",unter 3 Jahre,541,297,244
False,8226032,"Hockenheim, Stadt",3 -  6 Jahre,633,337,296
False,8226032,"Hockenheim, Stadt",6 - 10 Jahre,877,455,422
False,8226032,"Hockenheim, Stadt",10 - 15 Jahre,1123,556,567
False,8226032,"Hockenheim, Stadt",15 - 18 Jahre,737,371,366
False,8226032,"Hockenheim, Stadt",18 - 20 Jahre,464,244,220
False,8226032,"Hockenheim, Stadt",20 - 25 Jahre,1133,593,540
False,8226032,"Hockenheim, Stadt",25 - 30 Jahre,1202,600,602
False,8226032,"Hockenheim, Stadt",30 - 35 Jahre,1281,647,634
False,8226032,"Hockenheim, Stadt",35 - 40 Jahre,1807,909,898
False,8226032,"Hockenheim, Stadt",40 - 45 Jahre,1946,978,968
False,8226032,"Hockenheim, Stadt",45 - 50 Jahre,1678,834,844
False,8226032,"Hockenheim, Stadt",50 - 55 Jahre,1369,697,672
False,8226032,"Hockenheim, Stadt",55 - 60 Jahre,1265,641,624
False,8226032,"Hockenheim, Stadt",60 - 65 Jahre,1100,564,536
False,8226032,"Hockenheim, Stadt",65 - 75 Jahre,2049,985,1064
False,8226032,"Hockenheim, Stadt",75 und mehr Jahre,1582,518,1064
False,8226032,"Hockenheim, Stadt",Insgesamt,20787,10226,10561
False,8226036,Ilvesheim,unter 3 Jahre,184,103,81
False,8226036,Ilvesheim,3 -  6 Jahre,208,88,120
False,8226036,Ilvesheim,6 - 10 Jahre,276,155,121
False,8226036,Ilvesheim,10 - 15 Jahre,304,171,133
False,8226036,Ilvesheim,15 - 18 Jahre,211,106,105
False,8226036,Ilvesheim,18 - 20 Jahre,130,59,71
False,8226036,Ilvesheim,20 - 25 Jahre,345,179,166
False,8226036,Ilvesheim,25 - 30 Jahre,372,178,194
False,8226036,Ilvesheim,30 - 35 Jahre,458,221,237
False,8226036,Ilvesheim,35 - 40 Jahre,625,316,309
False,8226036,Ilvesheim,40 - 45 Jahre,643,311,332
False,8226036,Ilvesheim,45 - 50 Jahre,615,297,318
False,8226036,Ilvesheim,50 - 55 Jahre,522,253,269
False,8226036,Ilvesheim,55 - 60 Jahre,515,257,258
False,8226036,Ilvesheim,60 - 65 Jahre,450,222,228
False,8226036,Ilvesheim,65 - 75 Jahre,922,426,496
False,8226036,Ilvesheim,75 und mehr Jahre,833,325,508
False,8226036,Ilvesheim,Insgesamt,7613,3667,3946
False,8226037,Ketsch,unter 3 Jahre,306,156,150
False,8226037,Ketsch,3 -  6 Jahre,339,145,194
False,8226037,Ketsch,6 - 10 Jahre,546,297,249
False,8226037,Ketsch,10 - 15 Jahre,651,324,327
False,8226037,Ketsch,15 - 18 Jahre,404,217,187
False,8226037,Ketsch,18 - 20 Jahre,268,122,146
False,8226037,Ketsch,20 - 25 Jahre,661,320,341
False,8226037,Ketsch,25 - 30 Jahre,589,280,309
False,8226037,Ketsch,30 - 35 Jahre,662,320,342
False,8226037,Ketsch,35 - 40 Jahre,1142,558,584
False,8226037,Ketsch,40 - 45 Jahre,1158,630,528
False,8226037,Ketsch,45 - 50 Jahre,990,508,482
False,8226037,Ketsch,50 - 55 Jahre,835,410,425
False,8226037,Ketsch,55 - 60 Jahre,904,439,465
False,8226037,Ketsch,60 - 65 Jahre,893,454,439
False,8226037,Ketsch,65 - 75 Jahre,1537,761,776
False,8226037,Ketsch,75 und mehr Jahre,997,375,622
False,8226037,Ketsch,Insgesamt,12882,6316,6566
False,8226038,"Ladenburg, Stadt",unter 3 Jahre,245,146,99
False,8226038,"Ladenburg, Stadt",3 -  6 Jahre,302,121,181
False,8226038,"Ladenburg, Stadt",6 - 10 Jahre,471,247,224
False,8226038,"Ladenburg, Stadt",10 - 15 Jahre,621,320,301
False,8226038,"Ladenburg, Stadt",15 - 18 Jahre,363,168,195
False,8226038,"Ladenburg, Stadt",18 - 20 Jahre,242,137,105
False,8226038,"Ladenburg, Stadt",20 - 25 Jahre,564,288,276
False,8226038,"Ladenburg, Stadt",25 - 30 Jahre,575,296,279
False,8226038,"Ladenburg, Stadt",30 - 35 Jahre,653,303,350
False,8226038,"Ladenburg, Stadt",35 - 40 Jahre,861,406,455
False,8226038,"Ladenburg, Stadt",40 - 45 Jahre,942,484,458
False,8226038,"Ladenburg, Stadt",45 - 50 Jahre,910,439,471
False,8226038,"Ladenburg, Stadt",50 - 55 Jahre,879,416,463
False,8226038,"Ladenburg, Stadt",55 - 60 Jahre,758,373,385
False,8226038,"Ladenburg, Stadt",60 - 65 Jahre,775,368,407
False,8226038,"Ladenburg, Stadt",65 - 75 Jahre,1454,717,737
False,8226038,"Ladenburg, Stadt",75 und mehr Jahre,895,317,578
False,8226038,"Ladenburg, Stadt",Insgesamt,11510,5546,5964
False,8226040,Laudenbach,unter 3 Jahre,178,104,74
False,8226040,Laudenbach,3 -  6 Jahre,183,103,80
False,8226040,Laudenbach,6 - 10 Jahre,261,143,118
False,8226040,Laudenbach,10 - 15 Jahre,365,188,177
False,8226040,Laudenbach,15 - 18 Jahre,201,98,103
False,8226040,Laudenbach,18 - 20 Jahre,132,61,71
False,8226040,Laudenbach,20 - 25 Jahre,313,158,155
False,8226040,Laudenbach,25 - 30 Jahre,315,157,158
False,8226040,Laudenbach,30 - 35 Jahre,330,147,183
False,8226040,Laudenbach,35 - 40 Jahre,541,268,273
False,8226040,Laudenbach,40 - 45 Jahre,519,262,257
False,8226040,Laudenbach,45 - 50 Jahre,507,229,278
False,8226040,Laudenbach,50 - 55 Jahre,411,206,205
False,8226040,Laudenbach,55 - 60 Jahre,414,186,228
False,8226040,Laudenbach,60 - 65 Jahre,411,213,198
False,8226040,Laudenbach,65 - 75 Jahre,602,307,295
False,8226040,Laudenbach,75 und mehr Jahre,393,151,242
False,8226040,Laudenbach,Insgesamt,6076,2981,3095
False,8226041,"Leimen, Stadt",unter 3 Jahre,739,372,367
False,8226041,"Leimen, Stadt",3 -  6 Jahre,719,381,338
False,8226041,"Leimen, Stadt",6 - 10 Jahre,1027,537,490
False,8226041,"Leimen, Stadt",10 - 15 Jahre,1377,699,678
False,8226041,"Leimen, Stadt",15 - 18 Jahre,1019,507,512
False,8226041,"Leimen, Stadt",18 - 20 Jahre,673,339,334
False,8226041,"Leimen, Stadt",20 - 25 Jahre,1776,844,932
False,8226041,"Leimen, Stadt",25 - 30 Jahre,1818,891,927
False,8226041,"Leimen, Stadt",30 - 35 Jahre,1660,791,869
False,8226041,"Leimen, Stadt",35 - 40 Jahre,2176,1131,1045
False,8226041,"Leimen, Stadt",40 - 45 Jahre,2407,1220,1187
False,8226041,"Leimen, Stadt",45 - 50 Jahre,2279,1146,1133
False,8226041,"Leimen, Stadt",50 - 55 Jahre,1910,941,969
False,8226041,"Leimen, Stadt",55 - 60 Jahre,1593,793,800
False,8226041,"Leimen, Stadt",60 - 65 Jahre,1357,685,672
False,8226041,"Leimen, Stadt",65 - 75 Jahre,2610,1214,1396
False,8226041,"Leimen, Stadt",75 und mehr Jahre,1909,692,1217
False,8226041,"Leimen, Stadt",Insgesamt,27049,13183,13866
False,8226046,Malsch,unter 3 Jahre,106,58,48
False,8226046,Malsch,3 -  6 Jahre,94,44,50
False,8226046,Malsch,6 - 10 Jahre,132,67,65
False,8226046,Malsch,10 - 15 Jahre,200,98,102
False,8226046,Malsch,15 - 18 Jahre,129,73,56
False,8226046,Malsch,18 - 20 Jahre,75,41,34
False,8226046,Malsch,20 - 25 Jahre,181,84,97
False,8226046,Malsch,25 - 30 Jahre,168,76,92
False,8226046,Malsch,30 - 35 Jahre,193,103,90
False,8226046,Malsch,35 - 40 Jahre,298,145,153
False,8226046,Malsch,40 - 45 Jahre,359,181,178
False,8226046,Malsch,45 - 50 Jahre,306,160,146
False,8226046,Malsch,50 - 55 Jahre,234,123,111
False,8226046,Malsch,55 - 60 Jahre,190,105,85
False,8226046,Malsch,60 - 65 Jahre,171,96,75
False,8226046,Malsch,65 - 75 Jahre,323,156,167
False,8226046,Malsch,75 und mehr Jahre,229,77,152
False,8226046,Malsch,Insgesamt,3388,1687,1701
False,8226048,Mauer,unter 3 Jahre,110,55,55
False,8226048,Mauer,3 -  6 Jahre,139,63,76
False,8226048,Mauer,6 - 10 Jahre,175,85,90
False,8226048,Mauer,10 - 15 Jahre,214,90,124
False,8226048,Mauer,15 - 18 Jahre,139,62,77
False,8226048,Mauer,18 - 20 Jahre,91,46,45
False,8226048,Mauer,20 - 25 Jahre,217,87,130
False,8226048,Mauer,25 - 30 Jahre,201,102,99
False,8226048,Mauer,30 - 35 Jahre,242,120,122
False,8226048,Mauer,35 - 40 Jahre,338,184,154
False,8226048,Mauer,40 - 45 Jahre,301,152,149
False,8226048,Mauer,45 - 50 Jahre,299,151,148
False,8226048,Mauer,50 - 55 Jahre,243,131,112
False,8226048,Mauer,55 - 60 Jahre,221,106,115
False,8226048,Mauer,60 - 65 Jahre,213,105,108
False,8226048,Mauer,65 - 75 Jahre,361,182,179
False,8226048,Mauer,75 und mehr Jahre,223,83,140
False,8226048,Mauer,Insgesamt,3727,1804,1923
False,8226049,Meckesheim,unter 3 Jahre,142,74,68
False,8226049,Meckesheim,3 -  6 Jahre,154,69,85
False,8226049,Meckesheim,6 - 10 Jahre,231,124,107
False,8226049,Meckesheim,10 - 15 Jahre,277,148,129
False,8226049,Meckesheim,15 - 18 Jahre,206,130,76
False,8226049,Meckesheim,18 - 20 Jahre,119,67,52
False,8226049,Meckesheim,20 - 25 Jahre,274,134,140
False,8226049,Meckesheim,25 - 30 Jahre,265,130,135
False,8226049,Meckesheim,30 - 35 Jahre,323,161,162
False,8226049,Meckesheim,35 - 40 Jahre,491,264,227
False,8226049,Meckesheim,40 - 45 Jahre,447,238,209
False,8226049,Meckesheim,45 - 50 Jahre,429,226,203
False,8226049,Meckesheim,50 - 55 Jahre,367,184,183
False,8226049,Meckesheim,55 - 60 Jahre,404,195,209
False,8226049,Meckesheim,60 - 65 Jahre,307,173,134
False,8226049,Meckesheim,65 - 75 Jahre,566,265,301
False,8226049,Meckesheim,75 und mehr Jahre,384,141,243
False,8226049,Meckesheim,Insgesamt,5386,2723,2663
False,8226054,Mühlhausen,unter 3 Jahre,252,142,110
False,8226054,Mühlhausen,3 -  6 Jahre,272,138,134
False,8226054,Mühlhausen,6 - 10 Jahre,406,212,194
False,8226054,Mühlhausen,10 - 15 Jahre,552,294,258
False,8226054,Mühlhausen,15 - 18 Jahre,306,142,164
False,8226054,Mühlhausen,18 - 20 Jahre,162,85,77
False,8226054,Mühlhausen,20 - 25 Jahre,461,239,222
False,8226054,Mühlhausen,25 - 30 Jahre,438,206,232
False,8226054,Mühlhausen,30 - 35 Jahre,498,252,246
False,8226054,Mühlhausen,35 - 40 Jahre,762,366,396
False,8226054,Mühlhausen,40 - 45 Jahre,873,471,402
False,8226054,Mühlhausen,45 - 50 Jahre,685,368,317
False,8226054,Mühlhausen,50 - 55 Jahre,547,256,291
False,8226054,Mühlhausen,55 - 60 Jahre,466,239,227
False,8226054,Mühlhausen,60 - 65 Jahre,366,192,174
False,8226054,Mühlhausen,65 - 75 Jahre,728,368,360
False,8226054,Mühlhausen,75 und mehr Jahre,435,150,285
False,8226054,Mühlhausen,Insgesamt,8209,4120,4089
False,8226055,"Neckarbischofsheim, Stadt",unter 3 Jahre,107,47,60
False,8226055,"Neckarbischofsheim, Stadt",3 -  6 Jahre,111,62,49
False,8226055,"Neckarbischofsheim, Stadt",6 - 10 Jahre,146,66,80
False,8226055,"Neckarbischofsheim, Stadt",10 - 15 Jahre,230,121,109
False,8226055,"Neckarbischofsheim, Stadt",15 - 18 Jahre,168,81,87
False,8226055,"Neckarbischofsheim, Stadt",18 - 20 Jahre,106,55,51
False,8226055,"Neckarbischofsheim, Stadt",20 - 25 Jahre,256,140,116
False,8226055,"Neckarbischofsheim, Stadt",25 - 30 Jahre,203,97,106
False,8226055,"Neckarbischofsheim, Stadt",30 - 35 Jahre,206,116,90
False,8226055,"Neckarbischofsheim, Stadt",35 - 40 Jahre,304,153,151
False,8226055,"Neckarbischofsheim, Stadt",40 - 45 Jahre,377,189,188
False,8226055,"Neckarbischofsheim, Stadt",45 - 50 Jahre,347,175,172
False,8226055,"Neckarbischofsheim, Stadt",50 - 55 Jahre,249,131,118
False,8226055,"Neckarbischofsheim, Stadt",55 - 60 Jahre,240,125,115
False,8226055,"Neckarbischofsheim, Stadt",60 - 65 Jahre,193,103,90
False,8226055,"Neckarbischofsheim, Stadt",65 - 75 Jahre,396,181,215
False,8226055,"Neckarbischofsheim, Stadt",75 und mehr Jahre,365,133,232
False,8226055,"Neckarbischofsheim, Stadt",Insgesamt,4004,1975,2029
False,8226056,"Neckargemünd, Stadt",unter 3 Jahre,330,170,160
False,8226056,"Neckargemünd, Stadt",3 -  6 Jahre,332,152,180
False,8226056,"Neckargemünd, Stadt",6 - 10 Jahre,479,241,238
False,8226056,"Neckargemünd, Stadt",10 - 15 Jahre,658,361,297
False,8226056,"Neckargemünd, Stadt",15 - 18 Jahre,429,209,220
False,8226056,"Neckargemünd, Stadt",18 - 20 Jahre,354,182,172
False,8226056,"Neckargemünd, Stadt",20 - 25 Jahre,949,529,420
False,8226056,"Neckargemünd, Stadt",25 - 30 Jahre,854,456,398
False,8226056,"Neckargemünd, Stadt",30 - 35 Jahre,838,424,414
False,8226056,"Neckargemünd, Stadt",35 - 40 Jahre,1143,585,558
False,8226056,"Neckargemünd, Stadt",40 - 45 Jahre,1239,647,592
False,8226056,"Neckargemünd, Stadt",45 - 50 Jahre,1081,536,545
False,8226056,"Neckargemünd, Stadt",50 - 55 Jahre,1036,510,526
False,8226056,"Neckargemünd, Stadt",55 - 60 Jahre,896,416,480
False,8226056,"Neckargemünd, Stadt",60 - 65 Jahre,938,447,491
False,8226056,"Neckargemünd, Stadt",65 - 75 Jahre,1537,740,797
False,8226056,"Neckargemünd, Stadt",75 und mehr Jahre,1187,459,728
False,8226056,"Neckargemünd, Stadt",Insgesamt,14280,7064,7216
False,8226058,Neidenstein,unter 3 Jahre,50,28,22
False,8226058,Neidenstein,3 -  6 Jahre,56,29,27
False,8226058,Neidenstein,6 - 10 Jahre,89,48,41
False,8226058,Neidenstein,10 - 15 Jahre,119,46,73
False,8226058,Neidenstein,15 - 18 Jahre,71,38,33
False,8226058,Neidenstein,18 - 20 Jahre,39,21,18
False,8226058,Neidenstein,20 - 25 Jahre,81,47,34
False,8226058,Neidenstein,25 - 30 Jahre,87,39,48
False,8226058,Neidenstein,30 - 35 Jahre,96,46,50
False,8226058,Neidenstein,35 - 40 Jahre,172,90,82
False,8226058,Neidenstein,40 - 45 Jahre,170,74,96
False,8226058,Neidenstein,45 - 50 Jahre,146,71,75
False,8226058,Neidenstein,50 - 55 Jahre,125,66,59
False,8226058,Neidenstein,55 - 60 Jahre,97,48,49
False,8226058,Neidenstein,60 - 65 Jahre,86,48,38
False,8226058,Neidenstein,65 - 75 Jahre,199,96,103
False,8226058,Neidenstein,75 und mehr Jahre,141,50,91
False,8226058,Neidenstein,Insgesamt,1824,885,939
False,8226059,Neulußheim,unter 3 Jahre,157,71,86
False,8226059,Neulußheim,3 -  6 Jahre,199,91,108
False,8226059,Neulußheim,6 - 10 Jahre,307,157,150
False,8226059,Neulußheim,10 - 15 Jahre,368,191,177
False,8226059,Neulußheim,15 - 18 Jahre,217,132,85
False,8226059,Neulußheim,18 - 20 Jahre,151,68,83
False,8226059,Neulußheim,20 - 25 Jahre,325,180,145
False,8226059,Neulußheim,25 - 30 Jahre,330,153,177
False,8226059,Neulußheim,30 - 35 Jahre,411,206,205
False,8226059,Neulußheim,35 - 40 Jahre,618,284,334
False,8226059,Neulußheim,40 - 45 Jahre,636,329,307
False,8226059,Neulußheim,45 - 50 Jahre,579,297,282
False,8226059,Neulußheim,50 - 55 Jahre,415,210,205
False,8226059,Neulußheim,55 - 60 Jahre,381,187,194
False,8226059,Neulußheim,60 - 65 Jahre,326,166,160
False,8226059,Neulußheim,65 - 75 Jahre,642,303,339
False,8226059,Neulußheim,75 und mehr Jahre,480,175,305
False,8226059,Neulußheim,Insgesamt,6542,3200,3342
False,8226060,Nußloch,unter 3 Jahre,286,171,115
False,8226060,Nußloch,3 -  6 Jahre,307,159,148
False,8226060,Nußloch,6 - 10 Jahre,459,245,214
False,8226060,Nußloch,10 - 15 Jahre,539,271,268
False,8226060,Nußloch,15 - 18 Jahre,353,185,168
False,8226060,Nußloch,18 - 20 Jahre,255,118,137
False,8226060,Nußloch,20 - 25 Jahre,628,308,320
False,8226060,Nußloch,25 - 30 Jahre,615,295,320
False,8226060,Nußloch,30 - 35 Jahre,680,358,322
False,8226060,Nußloch,35 - 40 Jahre,975,467,508
False,8226060,Nußloch,40 - 45 Jahre,956,479,477
False,8226060,Nußloch,45 - 50 Jahre,844,416,428
False,8226060,Nußloch,50 - 55 Jahre,759,372,387
False,8226060,Nußloch,55 - 60 Jahre,666,326,340
False,8226060,Nußloch,60 - 65 Jahre,626,320,306
False,8226060,Nußloch,65 - 75 Jahre,1054,490,564
False,8226060,Nußloch,75 und mehr Jahre,791,287,504
False,8226060,Nußloch,Insgesamt,10793,5267,5526
False,8226062,Oftersheim,unter 3 Jahre,243,135,108
False,8226062,Oftersheim,3 -  6 Jahre,264,126,138
False,8226062,Oftersheim,6 - 10 Jahre,359,172,187
False,8226062,Oftersheim,10 - 15 Jahre,505,265,240
False,8226062,Oftersheim,15 - 18 Jahre,330,177,153
False,8226062,Oftersheim,18 - 20 Jahre,207,116,91
False,8226062,Oftersheim,20 - 25 Jahre,533,266,267
False,8226062,Oftersheim,25 - 30 Jahre,475,235,240
False,8226062,Oftersheim,30 - 35 Jahre,517,252,265
False,8226062,Oftersheim,35 - 40 Jahre,847,393,454
False,8226062,Oftersheim,40 - 45 Jahre,902,446,456
False,8226062,Oftersheim,45 - 50 Jahre,735,348,387
False,8226062,Oftersheim,50 - 55 Jahre,701,314,387
False,8226062,Oftersheim,55 - 60 Jahre,736,367,369
False,8226062,Oftersheim,60 - 65 Jahre,622,297,325
False,8226062,Oftersheim,65 - 75 Jahre,1262,591,671
False,8226062,Oftersheim,75 und mehr Jahre,848,312,536
False,8226062,Oftersheim,Insgesamt,10086,4812,5274
False,8226063,Plankstadt,unter 3 Jahre,222,109,113
False,8226063,Plankstadt,3 -  6 Jahre,231,118,113
False,8226063,Plankstadt,6 - 10 Jahre,384,201,183
False,8226063,Plankstadt,10 - 15 Jahre,509,260,249
False,8226063,Plankstadt,15 - 18 Jahre,298,164,134
False,8226063,Plankstadt,18 - 20 Jahre,244,132,112
False,8226063,Plankstadt,20 - 25 Jahre,493,259,234
False,8226063,Plankstadt,25 - 30 Jahre,426,190,236
False,8226063,Plankstadt,30 - 35 Jahre,525,248,277
False,8226063,Plankstadt,35 - 40 Jahre,801,408,393
False,8226063,Plankstadt,40 - 45 Jahre,852,417,435
False,8226063,Plankstadt,45 - 50 Jahre,718,370,348
False,8226063,Plankstadt,50 - 55 Jahre,684,309,375
False,8226063,Plankstadt,55 - 60 Jahre,646,313,333
False,8226063,Plankstadt,60 - 65 Jahre,552,288,264
False,8226063,Plankstadt,65 - 75 Jahre,1150,544,606
False,8226063,Plankstadt,75 und mehr Jahre,813,263,550
False,8226063,Plankstadt,Insgesamt,9548,4593,4955
False,8226065,"Rauenberg, Stadt",unter 3 Jahre,206,91,115
False,8226065,"Rauenberg, Stadt",3 -  6 Jahre,241,122,119
False,8226065,"Rauenberg, Stadt",6 - 10 Jahre,332,167,165
False,8226065,"Rauenberg, Stadt",10 - 15 Jahre,401,192,209
False,8226065,"Rauenberg, Stadt",15 - 18 Jahre,234,118,116
False,8226065,"Rauenberg, Stadt",18 - 20 Jahre,161,90,71
False,8226065,"Rauenberg, Stadt",20 - 25 Jahre,416,205,211
False,8226065,"Rauenberg, Stadt",25 - 30 Jahre,467,227,240
False,8226065,"Rauenberg, Stadt",30 - 35 Jahre,531,262,269
False,8226065,"Rauenberg, Stadt",35 - 40 Jahre,687,368,319
False,8226065,"Rauenberg, Stadt",40 - 45 Jahre,778,433,345
False,8226065,"Rauenberg, Stadt",45 - 50 Jahre,608,310,298
False,8226065,"Rauenberg, Stadt",50 - 55 Jahre,499,250,249
False,8226065,"Rauenberg, Stadt",55 - 60 Jahre,420,218,202
False,8226065,"Rauenberg, Stadt",60 - 65 Jahre,368,191,177
False,8226065,"Rauenberg, Stadt",65 - 75 Jahre,725,334,391
False,8226065,"Rauenberg, Stadt",75 und mehr Jahre,454,167,287
False,8226065,"Rauenberg, Stadt",Insgesamt,7528,3745,3783
False,8226066,Reichartshausen,unter 3 Jahre,51,24,27
False,8226066,Reichartshausen,3 -  6 Jahre,76,41,35
False,8226066,Reichartshausen,6 - 10 Jahre,117,52,65
False,8226066,Reichartshausen,10 - 15 Jahre,118,55,63
False,8226066,Reichartshausen,15 - 18 Jahre,103,57,46
False,8226066,Reichartshausen,18 - 20 Jahre,45,24,21
False,8226066,Reichartshausen,20 - 25 Jahre,130,62,68
False,8226066,Reichartshausen,25 - 30 Jahre,104,58,46
False,8226066,Reichartshausen,30 - 35 Jahre,122,66,56
False,8226066,Reichartshausen,35 - 40 Jahre,156,72,84
False,8226066,Reichartshausen,40 - 45 Jahre,188,96,92
False,8226066,Reichartshausen,45 - 50 Jahre,173,97,76
False,8226066,Reichartshausen,50 - 55 Jahre,133,67,66
False,8226066,Reichartshausen,55 - 60 Jahre,88,43,45
False,8226066,Reichartshausen,60 - 65 Jahre,86,47,39
False,8226066,Reichartshausen,65 - 75 Jahre,216,108,108
False,8226066,Reichartshausen,75 und mehr Jahre,123,44,79
False,8226066,Reichartshausen,Insgesamt,2029,1013,1016
False,8226068,Reilingen,unter 3 Jahre,178,93,85
False,8226068,Reilingen,3 -  6 Jahre,198,99,99
False,8226068,Reilingen,6 - 10 Jahre,315,158,157
False,8226068,Reilingen,10 - 15 Jahre,397,212,185
False,8226068,Reilingen,15 - 18 Jahre,251,117,134
False,8226068,Reilingen,18 - 20 Jahre,149,69,80
False,8226068,Reilingen,20 - 25 Jahre,388,196,192
False,8226068,Reilingen,25 - 30 Jahre,367,181,186
False,8226068,Reilingen,30 - 35 Jahre,399,193,206
False,8226068,Reilingen,35 - 40 Jahre,590,283,307
False,8226068,Reilingen,40 - 45 Jahre,676,353,323
False,8226068,Reilingen,45 - 50 Jahre,585,302,283
False,8226068,Reilingen,50 - 55 Jahre,480,243,237
False,8226068,Reilingen,55 - 60 Jahre,463,219,244
False,8226068,Reilingen,60 - 65 Jahre,416,227,189
False,8226068,Reilingen,65 - 75 Jahre,734,341,393
False,8226068,Reilingen,75 und mehr Jahre,517,180,337
False,8226068,Reilingen,Insgesamt,7103,3466,3637
False,8226076,Sandhausen,unter 3 Jahre,393,201,192
False,8226076,Sandhausen,3 -  6 Jahre,409,209,200
False,8226076,Sandhausen,6 - 10 Jahre,539,288,251
False,8226076,Sandhausen,10 - 15 Jahre,731,360,371
False,8226076,Sandhausen,15 - 18 Jahre,452,228,224
False,8226076,Sandhausen,18 - 20 Jahre,295,158,137
False,8226076,Sandhausen,20 - 25 Jahre,785,428,357
False,8226076,Sandhausen,25 - 30 Jahre,791,372,419
False,8226076,Sandhausen,30 - 35 Jahre,897,418,479
False,8226076,Sandhausen,35 - 40 Jahre,1215,631,584
False,8226076,Sandhausen,40 - 45 Jahre,1243,606,637
False,8226076,Sandhausen,45 - 50 Jahre,1102,527,575
False,8226076,Sandhausen,50 - 55 Jahre,995,502,493
False,8226076,Sandhausen,55 - 60 Jahre,952,445,507
False,8226076,Sandhausen,60 - 65 Jahre,826,409,417
False,8226076,Sandhausen,65 - 75 Jahre,1605,764,841
False,8226076,Sandhausen,75 und mehr Jahre,1044,389,655
False,8226076,Sandhausen,Insgesamt,14274,6935,7339
False,8226080,"Schönau, Stadt",unter 3 Jahre,103,56,47
False,8226080,"Schönau, Stadt",3 -  6 Jahre,128,69,59
False,8226080,"Schönau, Stadt",6 - 10 Jahre,213,116,97
False,8226080,"Schönau, Stadt",10 - 15 Jahre,277,154,123
False,8226080,"Schönau, Stadt",15 - 18 Jahre,166,82,84
False,8226080,"Schönau, Stadt",18 - 20 Jahre,120,74,46
False,8226080,"Schönau, Stadt",20 - 25 Jahre,219,120,99
False,8226080,"Schönau, Stadt",25 - 30 Jahre,197,101,96
False,8226080,"Schönau, Stadt",30 - 35 Jahre,223,104,119
False,8226080,"Schönau, Stadt",35 - 40 Jahre,387,189,198
False,8226080,"Schönau, Stadt",40 - 45 Jahre,437,210,227
False,8226080,"Schönau, Stadt",45 - 50 Jahre,378,205,173
False,8226080,"Schönau, Stadt",50 - 55 Jahre,347,168,179
False,8226080,"Schönau, Stadt",55 - 60 Jahre,293,147,146
False,8226080,"Schönau, Stadt",60 - 65 Jahre,294,143,151
False,8226080,"Schönau, Stadt",65 - 75 Jahre,557,257,300
False,8226080,"Schönau, Stadt",75 und mehr Jahre,454,154,300
False,8226080,"Schönau, Stadt",Insgesamt,4793,2349,2444
False,8226081,Schönbrunn,unter 3 Jahre,75,43,32
False,8226081,Schönbrunn,3 -  6 Jahre,83,49,34
False,8226081,Schönbrunn,6 - 10 Jahre,121,65,56
False,8226081,Schönbrunn,10 - 15 Jahre,189,90,99
False,8226081,Schönbrunn,15 - 18 Jahre,130,76,54
False,8226081,Schönbrunn,18 - 20 Jahre,79,38,41
False,8226081,Schönbrunn,20 - 25 Jahre,170,93,77
False,8226081,Schönbrunn,25 - 30 Jahre,137,71,66
False,8226081,Schönbrunn,30 - 35 Jahre,139,69,70
False,8226081,Schönbrunn,35 - 40 Jahre,265,141,124
False,8226081,Schönbrunn,40 - 45 Jahre,281,138,143
False,8226081,Schönbrunn,45 - 50 Jahre,250,128,122
False,8226081,Schönbrunn,50 - 55 Jahre,216,110,106
False,8226081,Schönbrunn,55 - 60 Jahre,203,102,101
False,8226081,Schönbrunn,60 - 65 Jahre,172,91,81
False,8226081,Schönbrunn,65 - 75 Jahre,314,161,153
False,8226081,Schönbrunn,75 und mehr Jahre,221,87,134
False,8226081,Schönbrunn,Insgesamt,3045,1552,1493
False,8226082,"Schriesheim, Stadt",unter 3 Jahre,405,216,189
False,8226082,"Schriesheim, Stadt",3 -  6 Jahre,386,188,198
False,8226082,"Schriesheim, Stadt",6 - 10 Jahre,547,270,277
False,8226082,"Schriesheim, Stadt",10 - 15 Jahre,701,372,329
False,8226082,"Schriesheim, Stadt",15 - 18 Jahre,407,229,178
False,8226082,"Schriesheim, Stadt",18 - 20 Jahre,289,153,136
False,8226082,"Schriesheim, Stadt",20 - 25 Jahre,798,402,396
False,8226082,"Schriesheim, Stadt",25 - 30 Jahre,853,386,467
False,8226082,"Schriesheim, Stadt",30 - 35 Jahre,873,430,443
False,8226082,"Schriesheim, Stadt",35 - 40 Jahre,1216,615,601
False,8226082,"Schriesheim, Stadt",40 - 45 Jahre,1315,657,658
False,8226082,"Schriesheim, Stadt",45 - 50 Jahre,1098,536,562
False,8226082,"Schriesheim, Stadt",50 - 55 Jahre,997,485,512
False,8226082,"Schriesheim, Stadt",55 - 60 Jahre,975,471,504
False,8226082,"Schriesheim, Stadt",60 - 65 Jahre,915,453,462
False,8226082,"Schriesheim, Stadt",65 - 75 Jahre,1484,721,763
False,8226082,"Schriesheim, Stadt",75 und mehr Jahre,1232,399,833
False,8226082,"Schriesheim, Stadt",Insgesamt,14491,6983,7508
False,8226084,"Schwetzingen, Stadt",unter 3 Jahre,585,296,289
False,8226084,"Schwetzingen, Stadt",3 -  6 Jahre,579,289,290
False,8226084,"Schwetzingen, Stadt",6 - 10 Jahre,819,393,426
False,8226084,"Schwetzingen, Stadt",10 - 15 Jahre,1096,538,558
False,8226084,"Schwetzingen, Stadt",15 - 18 Jahre,716,370,346
False,8226084,"Schwetzingen, Stadt",18 - 20 Jahre,493,251,242
False,8226084,"Schwetzingen, Stadt",20 - 25 Jahre,1255,620,635
False,8226084,"Schwetzingen, Stadt",25 - 30 Jahre,1512,749,763
False,8226084,"Schwetzingen, Stadt",30 - 35 Jahre,1559,792,767
False,8226084,"Schwetzingen, Stadt",35 - 40 Jahre,2080,1071,1009
False,8226084,"Schwetzingen, Stadt",40 - 45 Jahre,2143,1116,1027
False,8226084,"Schwetzingen, Stadt",45 - 50 Jahre,1835,908,927
False,8226084,"Schwetzingen, Stadt",50 - 55 Jahre,1404,706,698
False,8226084,"Schwetzingen, Stadt",55 - 60 Jahre,1329,687,642
False,8226084,"Schwetzingen, Stadt",60 - 65 Jahre,1209,576,633
False,8226084,"Schwetzingen, Stadt",65 - 75 Jahre,2146,984,1162
False,8226084,"Schwetzingen, Stadt",75 und mehr Jahre,1585,504,1081
False,8226084,"Schwetzingen, Stadt",Insgesamt,22345,10850,11495
False,8226085,"Sinsheim, Stadt",unter 3 Jahre,1035,494,541
False,8226085,"Sinsheim, Stadt",3 -  6 Jahre,1135,566,569
False,8226085,"Sinsheim, Stadt",6 - 10 Jahre,1638,819,819
False,8226085,"Sinsheim, Stadt",10 - 15 Jahre,2155,1052,1103
False,8226085,"Sinsheim, Stadt",15 - 18 Jahre,1411,727,684
False,8226085,"Sinsheim, Stadt",18 - 20 Jahre,916,493,423
False,8226085,"Sinsheim, Stadt",20 - 25 Jahre,2003,1003,1000
False,8226085,"Sinsheim, Stadt",25 - 30 Jahre,2022,1037,985
False,8226085,"Sinsheim, Stadt",30 - 35 Jahre,2221,1073,1148
False,8226085,"Sinsheim, Stadt",35 - 40 Jahre,2878,1475,1403
False,8226085,"Sinsheim, Stadt",40 - 45 Jahre,3143,1613,1530
False,8226085,"Sinsheim, Stadt",45 - 50 Jahre,2831,1422,1409
False,8226085,"Sinsheim, Stadt",50 - 55 Jahre,2467,1212,1255
False,8226085,"Sinsheim, Stadt",55 - 60 Jahre,2087,1081,1006
False,8226085,"Sinsheim, Stadt",60 - 65 Jahre,1717,880,837
False,8226085,"Sinsheim, Stadt",65 - 75 Jahre,3418,1611,1807
False,8226085,"Sinsheim, Stadt",75 und mehr Jahre,2447,840,1607
False,8226085,"Sinsheim, Stadt",Insgesamt,35524,17398,18126
False,8226086,Spechbach,unter 3 Jahre,48,24,24
False,8226086,Spechbach,3 -  6 Jahre,58,31,27
False,8226086,Spechbach,6 - 10 Jahre,66,31,35
False,8226086,Spechbach,10 - 15 Jahre,97,50,47
False,8226086,Spechbach,15 - 18 Jahre,72,50,22
False,8226086,Spechbach,18 - 20 Jahre,42,23,19
False,8226086,Spechbach,20 - 25 Jahre,65,38,27
False,8226086,Spechbach,25 - 30 Jahre,74,34,40
False,8226086,Spechbach,30 - 35 Jahre,93,44,49
False,8226086,Spechbach,35 - 40 Jahre,134,67,67
False,8226086,Spechbach,40 - 45 Jahre,137,72,65
False,8226086,Spechbach,45 - 50 Jahre,144,72,72
False,8226086,Spechbach,50 - 55 Jahre,117,58,59
False,8226086,Spechbach,55 - 60 Jahre,96,54,42
False,8226086,Spechbach,60 - 65 Jahre,91,43,48
False,8226086,Spechbach,65 - 75 Jahre,187,89,98
False,8226086,Spechbach,75 und mehr Jahre,163,54,109
False,8226086,Spechbach,Insgesamt,1684,834,850
False,8226091,"Waibstadt, Stadt",unter 3 Jahre,138,64,74
False,8226091,"Waibstadt, Stadt",3 -  6 Jahre,172,83,89
False,8226091,"Waibstadt, Stadt",6 - 10 Jahre,260,112,148
False,8226091,"Waibstadt, Stadt",10 - 15 Jahre,388,219,169
False,8226091,"Waibstadt, Stadt",15 - 18 Jahre,253,120,133
False,8226091,"Waibstadt, Stadt",18 - 20 Jahre,152,76,76
False,8226091,"Waibstadt, Stadt",20 - 25 Jahre,325,169,156
False,8226091,"Waibstadt, Stadt",25 - 30 Jahre,282,150,132
False,8226091,"Waibstadt, Stadt",30 - 35 Jahre,331,164,167
False,8226091,"Waibstadt, Stadt",35 - 40 Jahre,457,236,221
False,8226091,"Waibstadt, Stadt",40 - 45 Jahre,497,247,250
False,8226091,"Waibstadt, Stadt",45 - 50 Jahre,450,219,231
False,8226091,"Waibstadt, Stadt",50 - 55 Jahre,399,193,206
False,8226091,"Waibstadt, Stadt",55 - 60 Jahre,338,179,159
False,8226091,"Waibstadt, Stadt",60 - 65 Jahre,275,142,133
False,8226091,"Waibstadt, Stadt",65 - 75 Jahre,619,291,328
False,8226091,"Waibstadt, Stadt",75 und mehr Jahre,400,125,275
False,8226091,"Waibstadt, Stadt",Insgesamt,5736,2789,2947
False,8226095,"Walldorf, Stadt",unter 3 Jahre,433,224,209
False,8226095,"Walldorf, Stadt",3 -  6 Jahre,497,264,233
False,8226095,"Walldorf, Stadt",6 - 10 Jahre,648,332,316
False,8226095,"Walldorf, Stadt",10 - 15 Jahre,781,419,362
False,8226095,"Walldorf, Stadt",15 - 18 Jahre,488,266,222
False,8226095,"Walldorf, Stadt",18 - 20 Jahre,307,152,155
False,8226095,"Walldorf, Stadt",20 - 25 Jahre,752,359,393
False,8226095,"Walldorf, Stadt",25 - 30 Jahre,810,402,408
False,8226095,"Walldorf, Stadt",30 - 35 Jahre,895,453,442
False,8226095,"Walldorf, Stadt",35 - 40 Jahre,1400,703,697
False,8226095,"Walldorf, Stadt",40 - 45 Jahre,1407,732,675
False,8226095,"Walldorf, Stadt",45 - 50 Jahre,1047,553,494
False,8226095,"Walldorf, Stadt",50 - 55 Jahre,880,434,446
False,8226095,"Walldorf, Stadt",55 - 60 Jahre,869,415,454
False,8226095,"Walldorf, Stadt",60 - 65 Jahre,795,367,428
False,8226095,"Walldorf, Stadt",65 - 75 Jahre,1613,795,818
False,8226095,"Walldorf, Stadt",75 und mehr Jahre,1063,423,640
False,8226095,"Walldorf, Stadt",Insgesamt,14685,7293,7392
False,8226096,"Weinheim, Stadt",unter 3 Jahre,1052,549,503
False,8226096,"Weinheim, Stadt",3 -  6 Jahre,1156,587,569
False,8226096,"Weinheim, Stadt",6 - 10 Jahre,1717,887,830
False,8226096,"Weinheim, Stadt",10 - 15 Jahre,2156,1116,1040
False,8226096,"Weinheim, Stadt",15 - 18 Jahre,1324,657,667
False,8226096,"Weinheim, Stadt",18 - 20 Jahre,859,439,420
False,8226096,"Weinheim, Stadt",20 - 25 Jahre,2169,1063,1106
False,8226096,"Weinheim, Stadt",25 - 30 Jahre,2175,1041,1134
False,8226096,"Weinheim, Stadt",30 - 35 Jahre,2590,1270,1320
False,8226096,"Weinheim, Stadt",35 - 40 Jahre,3557,1821,1736
False,8226096,"Weinheim, Stadt",40 - 45 Jahre,3768,1920,1848
False,8226096,"Weinheim, Stadt",45 - 50 Jahre,3218,1635,1583
False,8226096,"Weinheim, Stadt",50 - 55 Jahre,2801,1404,1397
False,8226096,"Weinheim, Stadt",55 - 60 Jahre,2653,1250,1403
False,8226096,"Weinheim, Stadt",60 - 65 Jahre,2825,1372,1453
False,8226096,"Weinheim, Stadt",65 - 75 Jahre,5420,2584,2836
False,8226096,"Weinheim, Stadt",75 und mehr Jahre,3977,1462,2515
False,8226096,"Weinheim, Stadt",Insgesamt,43417,21057,22360
False,8226097,Wiesenbach,unter 3 Jahre,83,39,44
False,8226097,Wiesenbach,3 -  6 Jahre,99,55,44
False,8226097,Wiesenbach,6 - 10 Jahre,137,76,61
False,8226097,Wiesenbach,10 - 15 Jahre,214,101,113
False,8226097,Wiesenbach,15 - 18 Jahre,124,62,62
False,8226097,Wiesenbach,18 - 20 Jahre,62,32,30
False,8226097,Wiesenbach,20 - 25 Jahre,137,70,67
False,8226097,Wiesenbach,25 - 30 Jahre,158,81,77
False,8226097,Wiesenbach,30 - 35 Jahre,141,71,70
False,8226097,Wiesenbach,35 - 40 Jahre,257,122,135
False,8226097,Wiesenbach,40 - 45 Jahre,310,141,169
False,8226097,Wiesenbach,45 - 50 Jahre,241,119,122
False,8226097,Wiesenbach,50 - 55 Jahre,183,91,92
False,8226097,Wiesenbach,55 - 60 Jahre,185,78,107
False,8226097,Wiesenbach,60 - 65 Jahre,212,105,107
False,8226097,Wiesenbach,65 - 75 Jahre,369,179,190
False,8226097,Wiesenbach,75 und mehr Jahre,228,93,135
False,8226097,Wiesenbach,Insgesamt,3140,1515,1625
False,8226098,"Wiesloch, Stadt",unter 3 Jahre,747,378,369
False,8226098,"Wiesloch, Stadt",3 -  6 Jahre,790,399,391
False,8226098,"Wiesloch, Stadt",6 - 10 Jahre,1099,582,517
False,8226098,"Wiesloch, Stadt",10 - 15 Jahre,1442,685,757
False,8226098,"Wiesloch, Stadt",15 - 18 Jahre,976,500,476
False,8226098,"Wiesloch, Stadt",18 - 20 Jahre,577,292,285
False,8226098,"Wiesloch, Stadt",20 - 25 Jahre,1379,704,675
False,8226098,"Wiesloch, Stadt",25 - 30 Jahre,1468,710,758
False,8226098,"Wiesloch, Stadt",30 - 35 Jahre,1658,827,831
False,8226098,"Wiesloch, Stadt",35 - 40 Jahre,2368,1228,1140
False,8226098,"Wiesloch, Stadt",40 - 45 Jahre,2402,1174,1228
False,8226098,"Wiesloch, Stadt",45 - 50 Jahre,2075,1025,1050
False,8226098,"Wiesloch, Stadt",50 - 55 Jahre,1759,909,850
False,8226098,"Wiesloch, Stadt",55 - 60 Jahre,1563,779,784
False,8226098,"Wiesloch, Stadt",60 - 65 Jahre,1399,701,698
False,8226098,"Wiesloch, Stadt",65 - 75 Jahre,2573,1245,1328
False,8226098,"Wiesloch, Stadt",75 und mehr Jahre,1954,665,1289
False,8226098,"Wiesloch, Stadt",Insgesamt,26229,12803,13426
False,8226099,Wilhelmsfeld,unter 3 Jahre,76,40,36
False,8226099,Wilhelmsfeld,3 -  6 Jahre,74,33,41
False,8226099,Wilhelmsfeld,6 - 10 Jahre,157,78,79
False,8226099,Wilhelmsfeld,10 - 15 Jahre,187,90,97
False,8226099,Wilhelmsfeld,15 - 18 Jahre,136,66,70
False,8226099,Wilhelmsfeld,18 - 20 Jahre,72,33,39
False,8226099,Wilhelmsfeld,20 - 25 Jahre,157,77,80
False,8226099,Wilhelmsfeld,25 - 30 Jahre,160,79,81
False,8226099,Wilhelmsfeld,30 - 35 Jahre,179,82,97
False,8226099,Wilhelmsfeld,35 - 40 Jahre,284,150,134
False,8226099,Wilhelmsfeld,40 - 45 Jahre,319,158,161
False,8226099,Wilhelmsfeld,45 - 50 Jahre,272,136,136
False,8226099,Wilhelmsfeld,50 - 55 Jahre,226,125,101
False,8226099,Wilhelmsfeld,55 - 60 Jahre,202,106,96
False,8226099,Wilhelmsfeld,60 - 65 Jahre,204,94,110
False,8226099,Wilhelmsfeld,65 - 75 Jahre,376,182,194
False,8226099,Wilhelmsfeld,75 und mehr Jahre,255,96,159
False,8226099,Wilhelmsfeld,Insgesamt,3336,1625,1711
False,8226101,Zuzenhausen,unter 3 Jahre,60,31,29
False,8226101,Zuzenhausen,3 -  6 Jahre,77,30,47
False,8226101,Zuzenhausen,6 - 10 Jahre,83,44,39
False,8226101,Zuzenhausen,10 - 15 Jahre,133,67,66
False,8226101,Zuzenhausen,15 - 18 Jahre,73,38,35
False,8226101,Zuzenhausen,18 - 20 Jahre,41,21,20
False,8226101,Zuzenhausen,20 - 25 Jahre,115,60,55
False,8226101,Zuzenhausen,25 - 30 Jahre,115,56,59
False,8226101,Zuzenhausen,30 - 35 Jahre,132,67,65
False,8226101,Zuzenhausen,35 - 40 Jahre,211,107,104
False,8226101,Zuzenhausen,40 - 45 Jahre,202,102,100
False,8226101,Zuzenhausen,45 - 50 Jahre,156,83,73
False,8226101,Zuzenhausen,50 - 55 Jahre,127,59,68
False,8226101,Zuzenhausen,55 - 60 Jahre,123,58,65
False,8226101,Zuzenhausen,60 - 65 Jahre,118,60,58
False,8226101,Zuzenhausen,65 - 75 Jahre,208,97,111
False,8226101,Zuzenhausen,75 und mehr Jahre,161,60,101
False,8226101,Zuzenhausen,Insgesamt,2135,1040,1095
False,8226102,Angelbachtal,unter 3 Jahre,122,57,65
False,8226102,Angelbachtal,3 -  6 Jahre,154,77,77
False,8226102,Angelbachtal,6 - 10 Jahre,241,117,124
False,8226102,Angelbachtal,10 - 15 Jahre,338,169,169
False,8226102,Angelbachtal,15 - 18 Jahre,189,94,95
False,8226102,Angelbachtal,18 - 20 Jahre,117,73,44
False,8226102,Angelbachtal,20 - 25 Jahre,255,119,136
False,8226102,Angelbachtal,25 - 30 Jahre,208,115,93
False,8226102,Angelbachtal,30 - 35 Jahre,286,124,162
False,8226102,Angelbachtal,35 - 40 Jahre,443,211,232
False,8226102,Angelbachtal,40 - 45 Jahre,497,247,250
False,8226102,Angelbachtal,45 - 50 Jahre,393,208,185
False,8226102,Angelbachtal,50 - 55 Jahre,295,151,144
False,8226102,Angelbachtal,55 - 60 Jahre,282,136,146
False,8226102,Angelbachtal,60 - 65 Jahre,232,118,114
False,8226102,Angelbachtal,65 - 75 Jahre,460,220,240
False,8226102,Angelbachtal,75 und mehr Jahre,405,114,291
False,8226102,Angelbachtal,Insgesamt,4917,2350,2567
False,8226103,St. Leon-Rot,unter 3 Jahre,360,192,168
False,8226103,St. Leon-Rot,3 -  6 Jahre,390,220,170
False,8226103,St. Leon-Rot,6 - 10 Jahre,578,284,294
False,8226103,St. Leon-Rot,10 - 15 Jahre,839,454,385
False,8226103,St. Leon-Rot,15 - 18 Jahre,530,277,253
False,8226103,St. Leon-Rot,18 - 20 Jahre,303,146,157
False,8226103,St. Leon-Rot,20 - 25 Jahre,690,358,332
False,8226103,St. Leon-Rot,25 - 30 Jahre,589,295,294
False,8226103,St. Leon-Rot,30 - 35 Jahre,726,351,375
False,8226103,St. Leon-Rot,35 - 40 Jahre,1044,484,560
False,8226103,St. Leon-Rot,40 - 45 Jahre,1271,658,613
False,8226103,St. Leon-Rot,45 - 50 Jahre,1086,544,542
False,8226103,St. Leon-Rot,50 - 55 Jahre,797,405,392
False,8226103,St. Leon-Rot,55 - 60 Jahre,720,373,347
False,8226103,St. Leon-Rot,60 - 65 Jahre,525,265,260
False,8226103,St. Leon-Rot,65 - 75 Jahre,1268,621,647
False,8226103,St. Leon-Rot,75 und mehr Jahre,720,251,469
False,8226103,St. Leon-Rot,Insgesamt,12436,6178,6258
False,8226104,Lobbach,unter 3 Jahre,69,40,29
False,8226104,Lobbach,3 -  6 Jahre,64,34,30
False,8226104,Lobbach,6 - 10 Jahre,123,72,51
False,8226104,Lobbach,10 - 15 Jahre,147,74,73
False,8226104,Lobbach,15 - 18 Jahre,94,51,43
False,8226104,Lobbach,18 - 20 Jahre,65,31,34
False,8226104,Lobbach,20 - 25 Jahre,106,61,45
False,8226104,Lobbach,25 - 30 Jahre,119,55,64
False,8226104,Lobbach,30 - 35 Jahre,111,51,60
False,8226104,Lobbach,35 - 40 Jahre,220,108,112
False,8226104,Lobbach,40 - 45 Jahre,213,98,115
False,8226104,Lobbach,45 - 50 Jahre,211,108,103
False,8226104,Lobbach,50 - 55 Jahre,206,108,98
False,8226104,Lobbach,55 - 60 Jahre,156,78,78
False,8226104,Lobbach,60 - 65 Jahre,131,64,67
False,8226104,Lobbach,65 - 75 Jahre,233,115,118
False,8226104,Lobbach,75 und mehr Jahre,178,50,128
False,8226104,Lobbach,Insgesamt,2446,1198,1248
False,8226105,Edingen-Neckarhausen,unter 3 Jahre,347,169,178
False,8226105,Edingen-Neckarhausen,3 -  6 Jahre,369,194,175
False,8226105,Edingen-Neckarhausen,6 - 10 Jahre,520,263,257
False,8226105,Edingen-Neckarhausen,10 - 15 Jahre,683,349,334
False,8226105,Edingen-Neckarhausen,15 - 18 Jahre,395,198,197
False,8226105,Edingen-Neckarhausen,18 - 20 Jahre,267,132,135
False,8226105,Edingen-Neckarhausen,20 - 25 Jahre,787,389,398
False,8226105,Edingen-Neckarhausen,25 - 30 Jahre,792,375,417
False,8226105,Edingen-Neckarhausen,30 - 35 Jahre,747,385,362
False,8226105,Edingen-Neckarhausen,35 - 40 Jahre,1058,504,554
False,8226105,Edingen-Neckarhausen,40 - 45 Jahre,1230,602,628
False,8226105,Edingen-Neckarhausen,45 - 50 Jahre,1057,540,517
False,8226105,Edingen-Neckarhausen,50 - 55 Jahre,964,477,487
False,8226105,Edingen-Neckarhausen,55 - 60 Jahre,893,407,486
False,8226105,Edingen-Neckarhausen,60 - 65 Jahre,846,392,454
False,8226105,Edingen-Neckarhausen,65 - 75 Jahre,1679,811,868
False,8226105,Edingen-Neckarhausen,75 und mehr Jahre,1271,527,744
False,8226105,Edingen-Neckarhausen,Insgesamt,13905,6714,7191
False,8226106,Helmstadt-Bargen,unter 3 Jahre,92,47,45
False,8226106,Helmstadt-Bargen,3 -  6 Jahre,123,68,55
False,8226106,Helmstadt-Bargen,6 - 10 Jahre,207,96,111
False,8226106,Helmstadt-Bargen,10 - 15 Jahre,273,140,133
False,8226106,Helmstadt-Bargen,15 - 18 Jahre,193,93,100
False,8226106,Helmstadt-Bargen,18 - 20 Jahre,104,50,54
False,8226106,Helmstadt-Bargen,20 - 25 Jahre,244,133,111
False,8226106,Helmstadt-Bargen,25 - 30 Jahre,214,103,111
False,8226106,Helmstadt-Bargen,30 - 35 Jahre,220,116,104
False,8226106,Helmstadt-Bargen,35 - 40 Jahre,270,135,135
False,8226106,Helmstadt-Bargen,40 - 45 Jahre,346,174,172
False,8226106,Helmstadt-Bargen,45 - 50 Jahre,366,177,189
False,8226106,Helmstadt-Bargen,50 - 55 Jahre,249,125,124
False,8226106,Helmstadt-Bargen,55 - 60 Jahre,231,117,114
False,8226106,Helmstadt-Bargen,60 - 65 Jahre,157,89,68
False,8226106,Helmstadt-Bargen,65 - 75 Jahre,388,187,201
False,8226106,Helmstadt-Bargen,75 und mehr Jahre,264,96,168
False,8226106,Helmstadt-Bargen,Insgesamt,3941,1946,1995
False,8226107,Hirschberg an der Bergstraße,unter 3 Jahre,230,109,121
False,8226107,Hirschberg an der Bergstraße,3 -  6 Jahre,250,131,119
False,8226107,Hirschberg an der Bergstraße,6 - 10 Jahre,335,174,161
False,8226107,Hirschberg an der Bergstraße,10 - 15 Jahre,404,205,199
False,8226107,Hirschberg an der Bergstraße,15 - 18 Jahre,235,109,126
False,8226107,Hirschberg an der Bergstraße,18 - 20 Jahre,198,113,85
False,8226107,Hirschberg an der Bergstraße,20 - 25 Jahre,455,221,234
False,8226107,Hirschberg an der Bergstraße,25 - 30 Jahre,491,249,242
False,8226107,Hirschberg an der Bergstraße,30 - 35 Jahre,525,250,275
False,8226107,Hirschberg an der Bergstraße,35 - 40 Jahre,791,416,375
False,8226107,Hirschberg an der Bergstraße,40 - 45 Jahre,906,454,452
False,8226107,Hirschberg an der Bergstraße,45 - 50 Jahre,698,331,367
False,8226107,Hirschberg an der Bergstraße,50 - 55 Jahre,603,273,330
False,8226107,Hirschberg an der Bergstraße,55 - 60 Jahre,671,306,365
False,8226107,Hirschberg an der Bergstraße,60 - 65 Jahre,674,315,359
False,8226107,Hirschberg an der Bergstraße,65 - 75 Jahre,1175,577,598
False,8226107,Hirschberg an der Bergstraße,75 und mehr Jahre,804,332,472
False,8226107,Hirschberg an der Bergstraße,Insgesamt,9445,4565,4880
False,8231,Stadtkreis Pforzheim,unter 3 Jahre,3139,1598,1541
False,8231,Stadtkreis Pforzheim,3 -  6 Jahre,3366,1744,1622
False,8231,Stadtkreis Pforzheim,6 - 10 Jahre,4673,2402,2271
False,8231,Stadtkreis Pforzheim,10 - 15 Jahre,5988,3045,2943
False,8231,Stadtkreis Pforzheim,15 - 18 Jahre,3945,2073,1872
False,8231,Stadtkreis Pforzheim,18 - 20 Jahre,2650,1344,1306
False,8231,Stadtkreis Pforzheim,20 - 25 Jahre,7521,3723,3798
False,8231,Stadtkreis Pforzheim,25 - 30 Jahre,7520,3731,3789
False,8231,Stadtkreis Pforzheim,30 - 35 Jahre,7232,3647,3585
False,8231,Stadtkreis Pforzheim,35 - 40 Jahre,9046,4665,4381
False,8231,Stadtkreis Pforzheim,40 - 45 Jahre,9881,5109,4772
False,8231,Stadtkreis Pforzheim,45 - 50 Jahre,8816,4461,4355
False,8231,Stadtkreis Pforzheim,50 - 55 Jahre,7615,3694,3921
False,8231,Stadtkreis Pforzheim,55 - 60 Jahre,6843,3216,3627
False,8231,Stadtkreis Pforzheim,60 - 65 Jahre,6523,3096,3427
False,8231,Stadtkreis Pforzheim,65 - 75 Jahre,13285,5989,7296
False,8231,Stadtkreis Pforzheim,75 und mehr Jahre,10978,3557,7421
False,8231,Stadtkreis Pforzheim,Insgesamt,119021,57094,61927
False,8231000,"Pforzheim, Stadt",unter 3 Jahre,3139,1598,1541
False,8231000,"Pforzheim, Stadt",3 -  6 Jahre,3366,1744,1622
False,8231000,"Pforzheim, Stadt",6 - 10 Jahre,4673,2402,2271
False,8231000,"Pforzheim, Stadt",10 - 15 Jahre,5988,3045,2943
False,8231000,"Pforzheim, Stadt",15 - 18 Jahre,3945,2073,1872
False,8231000,"Pforzheim, Stadt",18 - 20 Jahre,2650,1344,1306
False,8231000,"Pforzheim, Stadt",20 - 25 Jahre,7521,3723,3798
False,8231000,"Pforzheim, Stadt",25 - 30 Jahre,7520,3731,3789
False,8231000,"Pforzheim, Stadt",30 - 35 Jahre,7232,3647,3585
False,8231000,"Pforzheim, Stadt",35 - 40 Jahre,9046,4665,4381
False,8231000,"Pforzheim, Stadt",40 - 45 Jahre,9881,5109,4772
False,8231000,"Pforzheim, Stadt",45 - 50 Jahre,8816,4461,4355
False,8231000,"Pforzheim, Stadt",50 - 55 Jahre,7615,3694,3921
False,8231000,"Pforzheim, Stadt",55 - 60 Jahre,6843,3216,3627
False,8231000,"Pforzheim, Stadt",60 - 65 Jahre,6523,3096,3427
False,8231000,"Pforzheim, Stadt",65 - 75 Jahre,13285,5989,7296
False,8231000,"Pforzheim, Stadt",75 und mehr Jahre,10978,3557,7421
False,8231000,"Pforzheim, Stadt",Insgesamt,119021,57094,61927
False,8235,Landkreis Calw,unter 3 Jahre,4379,2232,2147
False,8235,Landkreis Calw,3 -  6 Jahre,4982,2598,2384
False,8235,Landkreis Calw,6 - 10 Jahre,7474,3823,3651
False,8235,Landkreis Calw,10 - 15 Jahre,9782,5030,4752
False,8235,Landkreis Calw,15 - 18 Jahre,6401,3332,3069
False,8235,Landkreis Calw,18 - 20 Jahre,4092,2053,2039
False,8235,Landkreis Calw,20 - 25 Jahre,9309,4775,4534
False,8235,Landkreis Calw,25 - 30 Jahre,8699,4448,4251
False,8235,Landkreis Calw,30 - 35 Jahre,9394,4652,4742
False,8235,Landkreis Calw,35 - 40 Jahre,12869,6445,6424
False,8235,Landkreis Calw,40 - 45 Jahre,14316,7323,6993
False,8235,Landkreis Calw,45 - 50 Jahre,12376,6246,6130
False,8235,Landkreis Calw,50 - 55 Jahre,10659,5322,5337
False,8235,Landkreis Calw,55 - 60 Jahre,9013,4539,4474
False,8235,Landkreis Calw,60 - 65 Jahre,8114,4146,3968
False,8235,Landkreis Calw,65 - 75 Jahre,16775,7913,8862
False,8235,Landkreis Calw,75 und mehr Jahre,12435,4320,8115
False,8235,Landkreis Calw,Insgesamt,161069,79197,81872
False,8235006,"Altensteig, Stadt",unter 3 Jahre,306,168,138
False,8235006,"Altensteig, Stadt",3 -  6 Jahre,385,210,175
False,8235006,"Altensteig, Stadt",6 - 10 Jahre,589,288,301
False,8235006,"Altensteig, Stadt",10 - 15 Jahre,749,354,395
False,8235006,"Altensteig, Stadt",15 - 18 Jahre,500,255,245
False,8235006,"Altensteig, Stadt",18 - 20 Jahre,319,169,150
False,8235006,"Altensteig, Stadt",20 - 25 Jahre,683,341,342
False,8235006,"Altensteig, Stadt",25 - 30 Jahre,660,325,335
False,8235006,"Altensteig, Stadt",30 - 35 Jahre,715,382,333
False,8235006,"Altensteig, Stadt",35 - 40 Jahre,875,446,429
False,8235006,"Altensteig, Stadt",40 - 45 Jahre,871,448,423
False,8235006,"Altensteig, Stadt",45 - 50 Jahre,796,404,392
False,8235006,"Altensteig, Stadt",50 - 55 Jahre,689,348,341
False,8235006,"Altensteig, Stadt",55 - 60 Jahre,558,299,259
False,8235006,"Altensteig, Stadt",60 - 65 Jahre,500,260,240
False,8235006,"Altensteig, Stadt",65 - 75 Jahre,1103,524,579
False,8235006,"Altensteig, Stadt",75 und mehr Jahre,921,315,606
False,8235006,"Altensteig, Stadt",Insgesamt,11219,5536,5683
False,8235007,Althengstett,unter 3 Jahre,264,142,122
False,8235007,Althengstett,3 -  6 Jahre,280,151,129
False,8235007,Althengstett,6 - 10 Jahre,421,208,213
False,8235007,Althengstett,10 - 15 Jahre,572,286,286
False,8235007,Althengstett,15 - 18 Jahre,374,188,186
False,8235007,Althengstett,18 - 20 Jahre,216,123,93
False,8235007,Althengstett,20 - 25 Jahre,428,230,198
False,8235007,Althengstett,25 - 30 Jahre,457,219,238
False,8235007,Althengstett,30 - 35 Jahre,557,282,275
False,8235007,Althengstett,35 - 40 Jahre,661,326,335
False,8235007,Althengstett,40 - 45 Jahre,814,404,410
False,8235007,Althengstett,45 - 50 Jahre,659,340,319
False,8235007,Althengstett,50 - 55 Jahre,582,283,299
False,8235007,Althengstett,55 - 60 Jahre,478,250,228
False,8235007,Althengstett,60 - 65 Jahre,362,186,176
False,8235007,Althengstett,65 - 75 Jahre,652,326,326
False,8235007,Althengstett,75 und mehr Jahre,426,158,268
False,8235007,Althengstett,Insgesamt,8203,4102,4101
False,8235008,"Bad Liebenzell, Stadt",unter 3 Jahre,214,115,99
False,8235008,"Bad Liebenzell, Stadt",3 -  6 Jahre,234,124,110
False,8235008,"Bad Liebenzell, Stadt",6 - 10 Jahre,365,166,199
False,8235008,"Bad Liebenzell, Stadt",10 - 15 Jahre,490,293,197
False,8235008,"Bad Liebenzell, Stadt",15 - 18 Jahre,322,170,152
False,8235008,"Bad Liebenzell, Stadt",18 - 20 Jahre,220,125,95
False,8235008,"Bad Liebenzell, Stadt",20 - 25 Jahre,591,311,280
False,8235008,"Bad Liebenzell, Stadt",25 - 30 Jahre,553,274,279
False,8235008,"Bad Liebenzell, Stadt",30 - 35 Jahre,564,268,296
False,8235008,"Bad Liebenzell, Stadt",35 - 40 Jahre,796,401,395
False,8235008,"Bad Liebenzell, Stadt",40 - 45 Jahre,894,450,444
False,8235008,"Bad Liebenzell, Stadt",45 - 50 Jahre,739,349,390
False,8235008,"Bad Liebenzell, Stadt",50 - 55 Jahre,628,322,306
False,8235008,"Bad Liebenzell, Stadt",55 - 60 Jahre,524,260,264
False,8235008,"Bad Liebenzell, Stadt",60 - 65 Jahre,498,226,272
False,8235008,"Bad Liebenzell, Stadt",65 - 75 Jahre,953,416,537
False,8235008,"Bad Liebenzell, Stadt",75 und mehr Jahre,941,313,628
False,8235008,"Bad Liebenzell, Stadt",Insgesamt,9526,4583,4943
False,8235018,Dobel,unter 3 Jahre,56,27,29
False,8235018,Dobel,3 -  6 Jahre,57,30,27
False,8235018,Dobel,6 - 10 Jahre,99,54,45
False,8235018,Dobel,10 - 15 Jahre,120,68,52
False,8235018,Dobel,15 - 18 Jahre,77,36,41
False,8235018,Dobel,18 - 20 Jahre,53,21,32
False,8235018,Dobel,20 - 25 Jahre,125,73,52
False,8235018,Dobel,25 - 30 Jahre,94,49,45
False,8235018,Dobel,30 - 35 Jahre,103,44,59
False,8235018,Dobel,35 - 40 Jahre,176,82,94
False,8235018,Dobel,40 - 45 Jahre,198,100,98
False,8235018,Dobel,45 - 50 Jahre,183,90,93
False,8235018,Dobel,50 - 55 Jahre,152,89,63
False,8235018,Dobel,55 - 60 Jahre,137,69,68
False,8235018,Dobel,60 - 65 Jahre,105,47,58
False,8235018,Dobel,65 - 75 Jahre,284,143,141
False,8235018,Dobel,75 und mehr Jahre,231,87,144
False,8235018,Dobel,Insgesamt,2250,1109,1141
False,8235020,Ebhausen,unter 3 Jahre,159,89,70
False,8235020,Ebhausen,3 -  6 Jahre,187,105,82
False,8235020,Ebhausen,6 - 10 Jahre,259,134,125
False,8235020,Ebhausen,10 - 15 Jahre,387,211,176
False,8235020,Ebhausen,15 - 18 Jahre,218,105,113
False,8235020,Ebhausen,18 - 20 Jahre,141,61,80
False,8235020,Ebhausen,20 - 25 Jahre,305,163,142
False,8235020,Ebhausen,25 - 30 Jahre,241,118,123
False,8235020,Ebhausen,30 - 35 Jahre,281,144,137
False,8235020,Ebhausen,35 - 40 Jahre,426,210,216
False,8235020,Ebhausen,40 - 45 Jahre,455,227,228
False,8235020,Ebhausen,45 - 50 Jahre,382,197,185
False,8235020,Ebhausen,50 - 55 Jahre,273,142,131
False,8235020,Ebhausen,55 - 60 Jahre,215,110,105
False,8235020,Ebhausen,60 - 65 Jahre,200,96,104
False,8235020,Ebhausen,65 - 75 Jahre,452,213,239
False,8235020,Ebhausen,75 und mehr Jahre,261,94,167
False,8235020,Ebhausen,Insgesamt,4842,2419,2423
False,8235022,Egenhausen,unter 3 Jahre,57,29,28
False,8235022,Egenhausen,3 -  6 Jahre,89,43,46
False,8235022,Egenhausen,6 - 10 Jahre,135,66,69
False,8235022,Egenhausen,10 - 15 Jahre,141,68,73
False,8235022,Egenhausen,15 - 18 Jahre,90,46,44
False,8235022,Egenhausen,18 - 20 Jahre,57,29,28
False,8235022,Egenhausen,20 - 25 Jahre,122,64,58
False,8235022,Egenhausen,25 - 30 Jahre,108,59,49
False,8235022,Egenhausen,30 - 35 Jahre,112,49,63
False,8235022,Egenhausen,35 - 40 Jahre,156,75,81
False,8235022,Egenhausen,40 - 45 Jahre,193,108,85
False,8235022,Egenhausen,45 - 50 Jahre,131,62,69
False,8235022,Egenhausen,50 - 55 Jahre,90,47,43
False,8235022,Egenhausen,55 - 60 Jahre,96,48,48
False,8235022,Egenhausen,60 - 65 Jahre,94,48,46
False,8235022,Egenhausen,65 - 75 Jahre,197,91,106
False,8235022,Egenhausen,75 und mehr Jahre,115,46,69
False,8235022,Egenhausen,Insgesamt,1983,978,1005
False,8235025,Enzklösterle,unter 3 Jahre,32,15,17
False,8235025,Enzklösterle,3 -  6 Jahre,26,12,14
False,8235025,Enzklösterle,6 - 10 Jahre,55,28,27
False,8235025,Enzklösterle,10 - 15 Jahre,73,35,38
False,8235025,Enzklösterle,15 - 18 Jahre,60,39,21
False,8235025,Enzklösterle,18 - 20 Jahre,29,15,14
False,8235025,Enzklösterle,20 - 25 Jahre,67,38,29
False,8235025,Enzklösterle,25 - 30 Jahre,66,30,36
False,8235025,Enzklösterle,30 - 35 Jahre,66,32,34
False,8235025,Enzklösterle,35 - 40 Jahre,88,41,47
False,8235025,Enzklösterle,40 - 45 Jahre,84,43,41
False,8235025,Enzklösterle,45 - 50 Jahre,97,51,46
False,8235025,Enzklösterle,50 - 55 Jahre,71,30,41
False,8235025,Enzklösterle,55 - 60 Jahre,80,38,42
False,8235025,Enzklösterle,60 - 65 Jahre,64,31,33
False,8235025,Enzklösterle,65 - 75 Jahre,176,90,86
False,8235025,Enzklösterle,75 und mehr Jahre,135,38,97
False,8235025,Enzklösterle,Insgesamt,1269,606,663
False,8235029,Gechingen,unter 3 Jahre,115,58,57
False,8235029,Gechingen,3 -  6 Jahre,115,52,63
False,8235029,Gechingen,6 - 10 Jahre,203,107,96
False,8235029,Gechingen,10 - 15 Jahre,229,118,111
False,8235029,Gechingen,15 - 18 Jahre,153,80,73
False,8235029,Gechingen,18 - 20 Jahre,97,44,53
False,8235029,Gechingen,20 - 25 Jahre,218,105,113
False,8235029,Gechingen,25 - 30 Jahre,202,101,101
False,8235029,Gechingen,30 - 35 Jahre,253,123,130
False,8235029,Gechingen,35 - 40 Jahre,343,166,177
False,8235029,Gechingen,40 - 45 Jahre,396,201,195
False,8235029,Gechingen,45 - 50 Jahre,341,184,157
False,8235029,Gechingen,50 - 55 Jahre,269,135,134
False,8235029,Gechingen,55 - 60 Jahre,211,93,118
False,8235029,Gechingen,60 - 65 Jahre,202,106,96
False,8235029,Gechingen,65 - 75 Jahre,382,192,190
False,8235029,Gechingen,75 und mehr Jahre,212,82,130
False,8235029,Gechingen,Insgesamt,3941,1947,1994
False,8235032,"Haiterbach, Stadt",unter 3 Jahre,163,79,84
False,8235032,"Haiterbach, Stadt",3 -  6 Jahre,193,93,100
False,8235032,"Haiterbach, Stadt",6 - 10 Jahre,306,156,150
False,8235032,"Haiterbach, Stadt",10 - 15 Jahre,405,188,217
False,8235032,"Haiterbach, Stadt",15 - 18 Jahre,240,124,116
False,8235032,"Haiterbach, Stadt",18 - 20 Jahre,145,65,80
False,8235032,"Haiterbach, Stadt",20 - 25 Jahre,355,166,189
False,8235032,"Haiterbach, Stadt",25 - 30 Jahre,360,187,173
False,8235032,"Haiterbach, Stadt",30 - 35 Jahre,386,214,172
False,8235032,"Haiterbach, Stadt",35 - 40 Jahre,449,231,218
False,8235032,"Haiterbach, Stadt",40 - 45 Jahre,539,280,259
False,8235032,"Haiterbach, Stadt",45 - 50 Jahre,392,199,193
False,8235032,"Haiterbach, Stadt",50 - 55 Jahre,364,183,181
False,8235032,"Haiterbach, Stadt",55 - 60 Jahre,288,145,143
False,8235032,"Haiterbach, Stadt",60 - 65 Jahre,259,122,137
False,8235032,"Haiterbach, Stadt",65 - 75 Jahre,575,274,301
False,8235032,"Haiterbach, Stadt",75 und mehr Jahre,399,125,274
False,8235032,"Haiterbach, Stadt",Insgesamt,5818,2831,2987
False,8235033,"Bad Herrenalb, Stadt",unter 3 Jahre,159,85,74
False,8235033,"Bad Herrenalb, Stadt",3 -  6 Jahre,157,79,78
False,8235033,"Bad Herrenalb, Stadt",6 - 10 Jahre,256,126,130
False,8235033,"Bad Herrenalb, Stadt",10 - 15 Jahre,336,172,164
False,8235033,"Bad Herrenalb, Stadt",15 - 18 Jahre,244,127,117
False,8235033,"Bad Herrenalb, Stadt",18 - 20 Jahre,166,83,83
False,8235033,"Bad Herrenalb, Stadt",20 - 25 Jahre,375,188,187
False,8235033,"Bad Herrenalb, Stadt",25 - 30 Jahre,367,169,198
False,8235033,"Bad Herrenalb, Stadt",30 - 35 Jahre,335,151,184
False,8235033,"Bad Herrenalb, Stadt",35 - 40 Jahre,529,254,275
False,8235033,"Bad Herrenalb, Stadt",40 - 45 Jahre,609,287,322
False,8235033,"Bad Herrenalb, Stadt",45 - 50 Jahre,578,287,291
False,8235033,"Bad Herrenalb, Stadt",50 - 55 Jahre,516,261,255
False,8235033,"Bad Herrenalb, Stadt",55 - 60 Jahre,468,221,247
False,8235033,"Bad Herrenalb, Stadt",60 - 65 Jahre,429,215,214
False,8235033,"Bad Herrenalb, Stadt",65 - 75 Jahre,1045,472,573
False,8235033,"Bad Herrenalb, Stadt",75 und mehr Jahre,961,340,621
False,8235033,"Bad Herrenalb, Stadt",Insgesamt,7530,3517,4013
False,8235035,Höfen an der Enz,unter 3 Jahre,43,18,25
False,8235035,Höfen an der Enz,3 -  6 Jahre,47,24,23
False,8235035,Höfen an der Enz,6 - 10 Jahre,73,43,30
False,8235035,Höfen an der Enz,10 - 15 Jahre,87,51,36
False,8235035,Höfen an der Enz,15 - 18 Jahre,61,31,30
False,8235035,Höfen an der Enz,18 - 20 Jahre,38,21,17
False,8235035,Höfen an der Enz,20 - 25 Jahre,117,56,61
False,8235035,Höfen an der Enz,25 - 30 Jahre,96,53,43
False,8235035,Höfen an der Enz,30 - 35 Jahre,101,54,47
False,8235035,Höfen an der Enz,35 - 40 Jahre,126,69,57
False,8235035,Höfen an der Enz,40 - 45 Jahre,136,64,72
False,8235035,Höfen an der Enz,45 - 50 Jahre,148,77,71
False,8235035,Höfen an der Enz,50 - 55 Jahre,127,67,60
False,8235035,Höfen an der Enz,55 - 60 Jahre,93,51,42
False,8235035,Höfen an der Enz,60 - 65 Jahre,80,37,43
False,8235035,Höfen an der Enz,65 - 75 Jahre,219,91,128
False,8235035,Höfen an der Enz,75 und mehr Jahre,126,45,81
False,8235035,Höfen an der Enz,Insgesamt,1718,852,866
False,8235046,"Nagold, Stadt",unter 3 Jahre,606,277,329
False,8235046,"Nagold, Stadt",3 -  6 Jahre,677,355,322
False,8235046,"Nagold, Stadt",6 - 10 Jahre,964,501,463
False,8235046,"Nagold, Stadt",10 - 15 Jahre,1314,659,655
False,8235046,"Nagold, Stadt",15 - 18 Jahre,880,466,414
False,8235046,"Nagold, Stadt",18 - 20 Jahre,577,280,297
False,8235046,"Nagold, Stadt",20 - 25 Jahre,1384,698,686
False,8235046,"Nagold, Stadt",25 - 30 Jahre,1360,651,709
False,8235046,"Nagold, Stadt",30 - 35 Jahre,1392,701,691
False,8235046,"Nagold, Stadt",35 - 40 Jahre,1795,910,885
False,8235046,"Nagold, Stadt",40 - 45 Jahre,1919,926,993
False,8235046,"Nagold, Stadt",45 - 50 Jahre,1729,854,875
False,8235046,"Nagold, Stadt",50 - 55 Jahre,1682,800,882
False,8235046,"Nagold, Stadt",55 - 60 Jahre,1339,668,671
False,8235046,"Nagold, Stadt",60 - 65 Jahre,1186,624,562
False,8235046,"Nagold, Stadt",65 - 75 Jahre,2355,1142,1213
False,8235046,"Nagold, Stadt",75 und mehr Jahre,1646,575,1071
False,8235046,"Nagold, Stadt",Insgesamt,22805,11087,11718
False,8235047,"Neubulach, Stadt",unter 3 Jahre,166,103,63
False,8235047,"Neubulach, Stadt",3 -  6 Jahre,215,104,111
False,8235047,"Neubulach, Stadt",6 - 10 Jahre,269,127,142
False,8235047,"Neubulach, Stadt",10 - 15 Jahre,453,242,211
False,8235047,"Neubulach, Stadt",15 - 18 Jahre,232,124,108
False,8235047,"Neubulach, Stadt",18 - 20 Jahre,157,71,86
False,8235047,"Neubulach, Stadt",20 - 25 Jahre,305,169,136
False,8235047,"Neubulach, Stadt",25 - 30 Jahre,261,141,120
False,8235047,"Neubulach, Stadt",30 - 35 Jahre,325,152,173
False,8235047,"Neubulach, Stadt",35 - 40 Jahre,432,228,204
False,8235047,"Neubulach, Stadt",40 - 45 Jahre,511,266,245
False,8235047,"Neubulach, Stadt",45 - 50 Jahre,380,194,186
False,8235047,"Neubulach, Stadt",50 - 55 Jahre,376,198,178
False,8235047,"Neubulach, Stadt",55 - 60 Jahre,260,132,128
False,8235047,"Neubulach, Stadt",60 - 65 Jahre,226,115,111
False,8235047,"Neubulach, Stadt",65 - 75 Jahre,519,237,282
False,8235047,"Neubulach, Stadt",75 und mehr Jahre,437,160,277
False,8235047,"Neubulach, Stadt",Insgesamt,5524,2763,2761
False,8235050,Neuweiler,unter 3 Jahre,87,53,34
False,8235050,Neuweiler,3 -  6 Jahre,127,62,65
False,8235050,Neuweiler,6 - 10 Jahre,164,86,78
False,8235050,Neuweiler,10 - 15 Jahre,223,110,113
False,8235050,Neuweiler,15 - 18 Jahre,141,81,60
False,8235050,Neuweiler,18 - 20 Jahre,102,62,40
False,8235050,Neuweiler,20 - 25 Jahre,178,87,91
False,8235050,Neuweiler,25 - 30 Jahre,131,75,56
False,8235050,Neuweiler,30 - 35 Jahre,166,76,90
False,8235050,Neuweiler,35 - 40 Jahre,255,132,123
False,8235050,Neuweiler,40 - 45 Jahre,320,179,141
False,8235050,Neuweiler,45 - 50 Jahre,267,135,132
False,8235050,Neuweiler,50 - 55 Jahre,163,88,75
False,8235050,Neuweiler,55 - 60 Jahre,154,76,78
False,8235050,Neuweiler,60 - 65 Jahre,148,93,55
False,8235050,Neuweiler,65 - 75 Jahre,359,171,188
False,8235050,Neuweiler,75 und mehr Jahre,211,81,130
False,8235050,Neuweiler,Insgesamt,3196,1647,1549
False,8235055,Oberreichenbach,unter 3 Jahre,77,41,36
False,8235055,Oberreichenbach,3 -  6 Jahre,107,64,43
False,8235055,Oberreichenbach,6 - 10 Jahre,155,83,72
False,8235055,Oberreichenbach,10 - 15 Jahre,176,92,84
False,8235055,Oberreichenbach,15 - 18 Jahre,127,56,71
False,8235055,Oberreichenbach,18 - 20 Jahre,75,39,36
False,8235055,Oberreichenbach,20 - 25 Jahre,187,103,84
False,8235055,Oberreichenbach,25 - 30 Jahre,124,81,43
False,8235055,Oberreichenbach,30 - 35 Jahre,138,63,75
False,8235055,Oberreichenbach,35 - 40 Jahre,268,123,145
False,8235055,Oberreichenbach,40 - 45 Jahre,251,121,130
False,8235055,Oberreichenbach,45 - 50 Jahre,236,120,116
False,8235055,Oberreichenbach,50 - 55 Jahre,184,95,89
False,8235055,Oberreichenbach,55 - 60 Jahre,167,80,87
False,8235055,Oberreichenbach,60 - 65 Jahre,125,66,59
False,8235055,Oberreichenbach,65 - 75 Jahre,278,124,154
False,8235055,Oberreichenbach,75 und mehr Jahre,205,72,133
False,8235055,Oberreichenbach,Insgesamt,2880,1423,1457
False,8235057,Ostelsheim,unter 3 Jahre,82,51,31
False,8235057,Ostelsheim,3 -  6 Jahre,101,50,51
False,8235057,Ostelsheim,6 - 10 Jahre,110,53,57
False,8235057,Ostelsheim,10 - 15 Jahre,155,87,68
False,8235057,Ostelsheim,15 - 18 Jahre,96,44,52
False,8235057,Ostelsheim,18 - 20 Jahre,80,40,40
False,8235057,Ostelsheim,20 - 25 Jahre,145,78,67
False,8235057,Ostelsheim,25 - 30 Jahre,119,64,55
False,8235057,Ostelsheim,30 - 35 Jahre,143,77,66
False,8235057,Ostelsheim,35 - 40 Jahre,240,109,131
False,8235057,Ostelsheim,40 - 45 Jahre,224,115,109
False,8235057,Ostelsheim,45 - 50 Jahre,234,128,106
False,8235057,Ostelsheim,50 - 55 Jahre,142,70,72
False,8235057,Ostelsheim,55 - 60 Jahre,111,51,60
False,8235057,Ostelsheim,60 - 65 Jahre,110,53,57
False,8235057,Ostelsheim,65 - 75 Jahre,271,135,136
False,8235057,Ostelsheim,75 und mehr Jahre,109,44,65
False,8235057,Ostelsheim,Insgesamt,2472,1249,1223
False,8235060,Rohrdorf,unter 3 Jahre,64,29,35
False,8235060,Rohrdorf,3 -  6 Jahre,52,34,18
False,8235060,Rohrdorf,6 - 10 Jahre,77,46,31
False,8235060,Rohrdorf,10 - 15 Jahre,122,61,61
False,8235060,Rohrdorf,15 - 18 Jahre,66,32,34
False,8235060,Rohrdorf,18 - 20 Jahre,58,30,28
False,8235060,Rohrdorf,20 - 25 Jahre,101,59,42
False,8235060,Rohrdorf,25 - 30 Jahre,109,51,58
False,8235060,Rohrdorf,30 - 35 Jahre,113,48,65
False,8235060,Rohrdorf,35 - 40 Jahre,162,78,84
False,8235060,Rohrdorf,40 - 45 Jahre,176,103,73
False,8235060,Rohrdorf,45 - 50 Jahre,152,73,79
False,8235060,Rohrdorf,50 - 55 Jahre,125,62,63
False,8235060,Rohrdorf,55 - 60 Jahre,125,57,68
False,8235060,Rohrdorf,60 - 65 Jahre,100,59,41
False,8235060,Rohrdorf,65 - 75 Jahre,211,103,108
False,8235060,Rohrdorf,75 und mehr Jahre,137,44,93
False,8235060,Rohrdorf,Insgesamt,1950,969,981
False,8235065,Schömberg,unter 3 Jahre,209,101,108
False,8235065,Schömberg,3 -  6 Jahre,216,115,101
False,8235065,Schömberg,6 - 10 Jahre,377,199,178
False,8235065,Schömberg,10 - 15 Jahre,478,242,236
False,8235065,Schömberg,15 - 18 Jahre,319,185,134
False,8235065,Schömberg,18 - 20 Jahre,207,117,90
False,8235065,Schömberg,20 - 25 Jahre,492,261,231
False,8235065,Schömberg,25 - 30 Jahre,428,226,202
False,8235065,Schömberg,30 - 35 Jahre,422,193,229
False,8235065,Schömberg,35 - 40 Jahre,711,362,349
False,8235065,Schömberg,40 - 45 Jahre,955,522,433
False,8235065,Schömberg,45 - 50 Jahre,731,396,335
False,8235065,Schömberg,50 - 55 Jahre,579,284,295
False,8235065,Schömberg,55 - 60 Jahre,496,269,227
False,8235065,Schömberg,60 - 65 Jahre,407,211,196
False,8235065,Schömberg,65 - 75 Jahre,876,422,454
False,8235065,Schömberg,75 und mehr Jahre,710,226,484
False,8235065,Schömberg,Insgesamt,8613,4331,4282
False,8235066,Simmersfeld,unter 3 Jahre,76,33,43
False,8235066,Simmersfeld,3 -  6 Jahre,79,46,33
False,8235066,Simmersfeld,6 - 10 Jahre,130,65,65
False,8235066,Simmersfeld,10 - 15 Jahre,143,80,63
False,8235066,Simmersfeld,15 - 18 Jahre,110,59,51
False,8235066,Simmersfeld,18 - 20 Jahre,67,40,27
False,8235066,Simmersfeld,20 - 25 Jahre,121,64,57
False,8235066,Simmersfeld,25 - 30 Jahre,99,59,40
False,8235066,Simmersfeld,30 - 35 Jahre,124,64,60
False,8235066,Simmersfeld,35 - 40 Jahre,199,105,94
False,8235066,Simmersfeld,40 - 45 Jahre,210,103,107
False,8235066,Simmersfeld,45 - 50 Jahre,157,78,79
False,8235066,Simmersfeld,50 - 55 Jahre,140,76,64
False,8235066,Simmersfeld,55 - 60 Jahre,111,62,49
False,8235066,Simmersfeld,60 - 65 Jahre,109,55,54
False,8235066,Simmersfeld,65 - 75 Jahre,197,91,106
False,8235066,Simmersfeld,75 und mehr Jahre,138,49,89
False,8235066,Simmersfeld,Insgesamt,2210,1129,1081
False,8235067,Simmozheim,unter 3 Jahre,87,35,52
False,8235067,Simmozheim,3 -  6 Jahre,110,61,49
False,8235067,Simmozheim,6 - 10 Jahre,157,85,72
False,8235067,Simmozheim,10 - 15 Jahre,193,91,102
False,8235067,Simmozheim,15 - 18 Jahre,129,64,65
False,8235067,Simmozheim,18 - 20 Jahre,66,32,34
False,8235067,Simmozheim,20 - 25 Jahre,142,68,74
False,8235067,Simmozheim,25 - 30 Jahre,155,79,76
False,8235067,Simmozheim,30 - 35 Jahre,171,79,92
False,8235067,Simmozheim,35 - 40 Jahre,243,127,116
False,8235067,Simmozheim,40 - 45 Jahre,232,113,119
False,8235067,Simmozheim,45 - 50 Jahre,227,112,115
False,8235067,Simmozheim,50 - 55 Jahre,199,102,97
False,8235067,Simmozheim,55 - 60 Jahre,155,82,73
False,8235067,Simmozheim,60 - 65 Jahre,126,67,59
False,8235067,Simmozheim,65 - 75 Jahre,243,114,129
False,8235067,Simmozheim,75 und mehr Jahre,114,38,76
False,8235067,Simmozheim,Insgesamt,2749,1349,1400
False,8235073,Unterreichenbach,unter 3 Jahre,57,30,27
False,8235073,Unterreichenbach,3 -  6 Jahre,71,34,37
False,8235073,Unterreichenbach,6 - 10 Jahre,118,56,62
False,8235073,Unterreichenbach,10 - 15 Jahre,140,70,70
False,8235073,Unterreichenbach,15 - 18 Jahre,89,41,48
False,8235073,Unterreichenbach,18 - 20 Jahre,61,30,31
False,8235073,Unterreichenbach,20 - 25 Jahre,130,69,61
False,8235073,Unterreichenbach,25 - 30 Jahre,107,68,39
False,8235073,Unterreichenbach,30 - 35 Jahre,112,50,62
False,8235073,Unterreichenbach,35 - 40 Jahre,213,104,109
False,8235073,Unterreichenbach,40 - 45 Jahre,227,121,106
False,8235073,Unterreichenbach,45 - 50 Jahre,185,98,87
False,8235073,Unterreichenbach,50 - 55 Jahre,148,72,76
False,8235073,Unterreichenbach,55 - 60 Jahre,138,72,66
False,8235073,Unterreichenbach,60 - 65 Jahre,126,59,67
False,8235073,Unterreichenbach,65 - 75 Jahre,227,106,121
False,8235073,Unterreichenbach,75 und mehr Jahre,184,61,123
False,8235073,Unterreichenbach,Insgesamt,2333,1141,1192
False,8235079,"Bad Wildbad, Stadt",unter 3 Jahre,238,120,118
False,8235079,"Bad Wildbad, Stadt",3 -  6 Jahre,271,132,139
False,8235079,"Bad Wildbad, Stadt",6 - 10 Jahre,423,241,182
False,8235079,"Bad Wildbad, Stadt",10 - 15 Jahre,537,265,272
False,8235079,"Bad Wildbad, Stadt",15 - 18 Jahre,428,213,215
False,8235079,"Bad Wildbad, Stadt",18 - 20 Jahre,259,117,142
False,8235079,"Bad Wildbad, Stadt",20 - 25 Jahre,582,284,298
False,8235079,"Bad Wildbad, Stadt",25 - 30 Jahre,537,286,251
False,8235079,"Bad Wildbad, Stadt",30 - 35 Jahre,615,310,305
False,8235079,"Bad Wildbad, Stadt",35 - 40 Jahre,815,408,407
False,8235079,"Bad Wildbad, Stadt",40 - 45 Jahre,959,526,433
False,8235079,"Bad Wildbad, Stadt",45 - 50 Jahre,821,402,419
False,8235079,"Bad Wildbad, Stadt",50 - 55 Jahre,712,371,341
False,8235079,"Bad Wildbad, Stadt",55 - 60 Jahre,630,301,329
False,8235079,"Bad Wildbad, Stadt",60 - 65 Jahre,646,316,330
False,8235079,"Bad Wildbad, Stadt",65 - 75 Jahre,1466,663,803
False,8235079,"Bad Wildbad, Stadt",75 und mehr Jahre,1116,377,739
False,8235079,"Bad Wildbad, Stadt",Insgesamt,11055,5332,5723
False,8235080,"Wildberg, Stadt",unter 3 Jahre,269,134,135
False,8235080,"Wildberg, Stadt",3 -  6 Jahre,310,157,153
False,8235080,"Wildberg, Stadt",6 - 10 Jahre,459,235,224
False,8235080,"Wildberg, Stadt",10 - 15 Jahre,684,369,315
False,8235080,"Wildberg, Stadt",15 - 18 Jahre,461,246,215
False,8235080,"Wildberg, Stadt",18 - 20 Jahre,250,108,142
False,8235080,"Wildberg, Stadt",20 - 25 Jahre,584,310,274
False,8235080,"Wildberg, Stadt",25 - 30 Jahre,486,229,257
False,8235080,"Wildberg, Stadt",30 - 35 Jahre,567,291,276
False,8235080,"Wildberg, Stadt",35 - 40 Jahre,786,384,402
False,8235080,"Wildberg, Stadt",40 - 45 Jahre,920,461,459
False,8235080,"Wildberg, Stadt",45 - 50 Jahre,793,410,383
False,8235080,"Wildberg, Stadt",50 - 55 Jahre,749,370,379
False,8235080,"Wildberg, Stadt",55 - 60 Jahre,608,309,299
False,8235080,"Wildberg, Stadt",60 - 65 Jahre,518,267,251
False,8235080,"Wildberg, Stadt",65 - 75 Jahre,1011,485,526
False,8235080,"Wildberg, Stadt",75 und mehr Jahre,673,233,440
False,8235080,"Wildberg, Stadt",Insgesamt,10128,4998,5130
False,8235084,"Bad Teinach-Zavelstein, Stadt",unter 3 Jahre,82,46,36
False,8235084,"Bad Teinach-Zavelstein, Stadt",3 -  6 Jahre,88,44,44
False,8235084,"Bad Teinach-Zavelstein, Stadt",6 - 10 Jahre,177,93,84
False,8235084,"Bad Teinach-Zavelstein, Stadt",10 - 15 Jahre,189,98,91
False,8235084,"Bad Teinach-Zavelstein, Stadt",15 - 18 Jahre,123,56,67
False,8235084,"Bad Teinach-Zavelstein, Stadt",18 - 20 Jahre,69,32,37
False,8235084,"Bad Teinach-Zavelstein, Stadt",20 - 25 Jahre,199,98,101
False,8235084,"Bad Teinach-Zavelstein, Stadt",25 - 30 Jahre,115,59,56
False,8235084,"Bad Teinach-Zavelstein, Stadt",30 - 35 Jahre,164,68,96
False,8235084,"Bad Teinach-Zavelstein, Stadt",35 - 40 Jahre,232,119,113
False,8235084,"Bad Teinach-Zavelstein, Stadt",40 - 45 Jahre,302,159,143
False,8235084,"Bad Teinach-Zavelstein, Stadt",45 - 50 Jahre,251,126,125
False,8235084,"Bad Teinach-Zavelstein, Stadt",50 - 55 Jahre,184,90,94
False,8235084,"Bad Teinach-Zavelstein, Stadt",55 - 60 Jahre,144,71,73
False,8235084,"Bad Teinach-Zavelstein, Stadt",60 - 65 Jahre,127,67,60
False,8235084,"Bad Teinach-Zavelstein, Stadt",65 - 75 Jahre,346,157,189
False,8235084,"Bad Teinach-Zavelstein, Stadt",75 und mehr Jahre,235,95,140
False,8235084,"Bad Teinach-Zavelstein, Stadt",Insgesamt,3027,1478,1549
False,8235085,"Calw, Stadt",unter 3 Jahre,711,354,357
False,8235085,"Calw, Stadt",3 -  6 Jahre,788,417,371
False,8235085,"Calw, Stadt",6 - 10 Jahre,1133,577,556
False,8235085,"Calw, Stadt",10 - 15 Jahre,1386,720,666
False,8235085,"Calw, Stadt",15 - 18 Jahre,861,464,397
False,8235085,"Calw, Stadt",18 - 20 Jahre,583,299,284
False,8235085,"Calw, Stadt",20 - 25 Jahre,1373,692,681
False,8235085,"Calw, Stadt",25 - 30 Jahre,1464,795,669
False,8235085,"Calw, Stadt",30 - 35 Jahre,1469,737,732
False,8235085,"Calw, Stadt",35 - 40 Jahre,1893,955,938
False,8235085,"Calw, Stadt",40 - 45 Jahre,1921,996,925
False,8235085,"Calw, Stadt",45 - 50 Jahre,1767,880,887
False,8235085,"Calw, Stadt",50 - 55 Jahre,1515,737,778
False,8235085,"Calw, Stadt",55 - 60 Jahre,1427,725,702
False,8235085,"Calw, Stadt",60 - 65 Jahre,1367,720,647
False,8235085,"Calw, Stadt",65 - 75 Jahre,2378,1131,1247
False,8235085,"Calw, Stadt",75 und mehr Jahre,1792,622,1170
False,8235085,"Calw, Stadt",Insgesamt,23828,11821,12007
False,8236,Landkreis Enzkreis,unter 3 Jahre,5226,2642,2584
False,8236,Landkreis Enzkreis,3 -  6 Jahre,5934,3037,2897
False,8236,Landkreis Enzkreis,6 - 10 Jahre,9254,4784,4470
False,8236,Landkreis Enzkreis,10 - 15 Jahre,12198,6281,5917
False,8236,Landkreis Enzkreis,15 - 18 Jahre,7787,4030,3757
False,8236,Landkreis Enzkreis,18 - 20 Jahre,4669,2453,2216
False,8236,Landkreis Enzkreis,20 - 25 Jahre,10509,5337,5172
False,8236,Landkreis Enzkreis,25 - 30 Jahre,9868,5027,4841
False,8236,Landkreis Enzkreis,30 - 35 Jahre,11010,5436,5574
False,8236,Landkreis Enzkreis,35 - 40 Jahre,16103,8033,8070
False,8236,Landkreis Enzkreis,40 - 45 Jahre,17778,9019,8759
False,8236,Landkreis Enzkreis,45 - 50 Jahre,15534,7938,7596
False,8236,Landkreis Enzkreis,50 - 55 Jahre,13065,6539,6526
False,8236,Landkreis Enzkreis,55 - 60 Jahre,11266,5637,5629
False,8236,Landkreis Enzkreis,60 - 65 Jahre,11053,5594,5459
False,8236,Landkreis Enzkreis,65 - 75 Jahre,20746,9955,10791
False,8236,Landkreis Enzkreis,75 und mehr Jahre,14417,5142,9275
False,8236,Landkreis Enzkreis,Insgesamt,196417,96884,99533
False,8236004,Birkenfeld,unter 3 Jahre,283,148,135
False,8236004,Birkenfeld,3 -  6 Jahre,307,158,149
False,8236004,Birkenfeld,6 - 10 Jahre,479,263,216
False,8236004,Birkenfeld,10 - 15 Jahre,630,335,295
False,8236004,Birkenfeld,15 - 18 Jahre,393,192,201
False,8236004,Birkenfeld,18 - 20 Jahre,249,129,120
False,8236004,Birkenfeld,20 - 25 Jahre,534,280,254
False,8236004,Birkenfeld,25 - 30 Jahre,506,240,266
False,8236004,Birkenfeld,30 - 35 Jahre,598,301,297
False,8236004,Birkenfeld,35 - 40 Jahre,864,443,421
False,8236004,Birkenfeld,40 - 45 Jahre,913,453,460
False,8236004,Birkenfeld,45 - 50 Jahre,835,434,401
False,8236004,Birkenfeld,50 - 55 Jahre,728,360,368
False,8236004,Birkenfeld,55 - 60 Jahre,550,246,304
False,8236004,Birkenfeld,60 - 65 Jahre,601,297,304
False,8236004,Birkenfeld,65 - 75 Jahre,1255,608,647
False,8236004,Birkenfeld,75 und mehr Jahre,885,322,563
False,8236004,Birkenfeld,Insgesamt,10610,5209,5401
False,8236011,Eisingen,unter 3 Jahre,130,66,64
False,8236011,Eisingen,3 -  6 Jahre,137,67,70
False,8236011,Eisingen,6 - 10 Jahre,229,114,115
False,8236011,Eisingen,10 - 15 Jahre,276,143,133
False,8236011,Eisingen,15 - 18 Jahre,191,95,96
False,8236011,Eisingen,18 - 20 Jahre,92,57,35
False,8236011,Eisingen,20 - 25 Jahre,257,131,126
False,8236011,Eisingen,25 - 30 Jahre,226,108,118
False,8236011,Eisingen,30 - 35 Jahre,271,138,133
False,8236011,Eisingen,35 - 40 Jahre,358,171,187
False,8236011,Eisingen,40 - 45 Jahre,374,182,192
False,8236011,Eisingen,45 - 50 Jahre,338,156,182
False,8236011,Eisingen,50 - 55 Jahre,301,142,159
False,8236011,Eisingen,55 - 60 Jahre,283,144,139
False,8236011,Eisingen,60 - 65 Jahre,294,145,149
False,8236011,Eisingen,65 - 75 Jahre,475,225,250
False,8236011,Eisingen,75 und mehr Jahre,300,114,186
False,8236011,Eisingen,Insgesamt,4532,2198,2334
False,8236013,Engelsbrand,unter 3 Jahre,95,47,48
False,8236013,Engelsbrand,3 -  6 Jahre,132,60,72
False,8236013,Engelsbrand,6 - 10 Jahre,190,95,95
False,8236013,Engelsbrand,10 - 15 Jahre,239,114,125
False,8236013,Engelsbrand,15 - 18 Jahre,176,92,84
False,8236013,Engelsbrand,18 - 20 Jahre,104,60,44
False,8236013,Engelsbrand,20 - 25 Jahre,204,99,105
False,8236013,Engelsbrand,25 - 30 Jahre,179,84,95
False,8236013,Engelsbrand,30 - 35 Jahre,173,81,92
False,8236013,Engelsbrand,35 - 40 Jahre,331,162,169
False,8236013,Engelsbrand,40 - 45 Jahre,388,193,195
False,8236013,Engelsbrand,45 - 50 Jahre,331,169,162
False,8236013,Engelsbrand,50 - 55 Jahre,294,131,163
False,8236013,Engelsbrand,55 - 60 Jahre,328,172,156
False,8236013,Engelsbrand,60 - 65 Jahre,281,133,148
False,8236013,Engelsbrand,65 - 75 Jahre,539,263,276
False,8236013,Engelsbrand,75 und mehr Jahre,369,129,240
False,8236013,Engelsbrand,Insgesamt,4353,2084,2269
False,8236019,Friolzheim,unter 3 Jahre,110,58,52
False,8236019,Friolzheim,3 -  6 Jahre,127,69,58
False,8236019,Friolzheim,6 - 10 Jahre,204,106,98
False,8236019,Friolzheim,10 - 15 Jahre,228,117,111
False,8236019,Friolzheim,15 - 18 Jahre,167,68,99
False,8236019,Friolzheim,18 - 20 Jahre,71,40,31
False,8236019,Friolzheim,20 - 25 Jahre,191,89,102
False,8236019,Friolzheim,25 - 30 Jahre,209,108,101
False,8236019,Friolzheim,30 - 35 Jahre,197,93,104
False,8236019,Friolzheim,35 - 40 Jahre,302,146,156
False,8236019,Friolzheim,40 - 45 Jahre,315,170,145
False,8236019,Friolzheim,45 - 50 Jahre,277,140,137
False,8236019,Friolzheim,50 - 55 Jahre,299,147,152
False,8236019,Friolzheim,55 - 60 Jahre,232,123,109
False,8236019,Friolzheim,60 - 65 Jahre,199,116,83
False,8236019,Friolzheim,65 - 75 Jahre,322,151,171
False,8236019,Friolzheim,75 und mehr Jahre,173,62,111
False,8236019,Friolzheim,Insgesamt,3623,1803,1820
False,8236025,"Heimsheim, Stadt",unter 3 Jahre,130,66,64
False,8236025,"Heimsheim, Stadt",3 -  6 Jahre,162,79,83
False,8236025,"Heimsheim, Stadt",6 - 10 Jahre,230,124,106
False,8236025,"Heimsheim, Stadt",10 - 15 Jahre,273,149,124
False,8236025,"Heimsheim, Stadt",15 - 18 Jahre,162,89,73
False,8236025,"Heimsheim, Stadt",18 - 20 Jahre,118,61,57
False,8236025,"Heimsheim, Stadt",20 - 25 Jahre,265,140,125
False,8236025,"Heimsheim, Stadt",25 - 30 Jahre,276,146,130
False,8236025,"Heimsheim, Stadt",30 - 35 Jahre,289,139,150
False,8236025,"Heimsheim, Stadt",35 - 40 Jahre,416,215,201
False,8236025,"Heimsheim, Stadt",40 - 45 Jahre,484,286,198
False,8236025,"Heimsheim, Stadt",45 - 50 Jahre,484,319,165
False,8236025,"Heimsheim, Stadt",50 - 55 Jahre,384,240,144
False,8236025,"Heimsheim, Stadt",55 - 60 Jahre,361,200,161
False,8236025,"Heimsheim, Stadt",60 - 65 Jahre,345,221,124
False,8236025,"Heimsheim, Stadt",65 - 75 Jahre,507,273,234
False,8236025,"Heimsheim, Stadt",75 und mehr Jahre,349,135,214
False,8236025,"Heimsheim, Stadt",Insgesamt,5235,2882,2353
False,8236028,Illingen,unter 3 Jahre,192,87,105
False,8236028,Illingen,3 -  6 Jahre,232,130,102
False,8236028,Illingen,6 - 10 Jahre,347,183,164
False,8236028,Illingen,10 - 15 Jahre,457,240,217
False,8236028,Illingen,15 - 18 Jahre,274,160,114
False,8236028,Illingen,18 - 20 Jahre,166,83,83
False,8236028,Illingen,20 - 25 Jahre,372,180,192
False,8236028,Illingen,25 - 30 Jahre,362,185,177
False,8236028,Illingen,30 - 35 Jahre,414,208,206
False,8236028,Illingen,35 - 40 Jahre,546,265,281
False,8236028,Illingen,40 - 45 Jahre,632,316,316
False,8236028,Illingen,45 - 50 Jahre,556,269,287
False,8236028,Illingen,50 - 55 Jahre,490,247,243
False,8236028,Illingen,55 - 60 Jahre,484,242,242
False,8236028,Illingen,60 - 65 Jahre,448,231,217
False,8236028,Illingen,65 - 75 Jahre,772,371,401
False,8236028,Illingen,75 und mehr Jahre,523,192,331
False,8236028,Illingen,Insgesamt,7267,3589,3678
False,8236030,Ispringen,unter 3 Jahre,123,64,59
False,8236030,Ispringen,3 -  6 Jahre,150,64,86
False,8236030,Ispringen,6 - 10 Jahre,257,139,118
False,8236030,Ispringen,10 - 15 Jahre,313,138,175
False,8236030,Ispringen,15 - 18 Jahre,204,108,96
False,8236030,Ispringen,18 - 20 Jahre,149,83,66
False,8236030,Ispringen,20 - 25 Jahre,349,182,167
False,8236030,Ispringen,25 - 30 Jahre,310,157,153
False,8236030,Ispringen,30 - 35 Jahre,306,158,148
False,8236030,Ispringen,35 - 40 Jahre,478,220,258
False,8236030,Ispringen,40 - 45 Jahre,503,268,235
False,8236030,Ispringen,45 - 50 Jahre,470,239,231
False,8236030,Ispringen,50 - 55 Jahre,393,191,202
False,8236030,Ispringen,55 - 60 Jahre,338,168,170
False,8236030,Ispringen,60 - 65 Jahre,351,162,189
False,8236030,Ispringen,65 - 75 Jahre,797,367,430
False,8236030,Ispringen,75 und mehr Jahre,536,210,326
False,8236030,Ispringen,Insgesamt,6027,2918,3109
False,8236031,Kieselbronn,unter 3 Jahre,87,39,48
False,8236031,Kieselbronn,3 -  6 Jahre,93,47,46
False,8236031,Kieselbronn,6 - 10 Jahre,150,73,77
False,8236031,Kieselbronn,10 - 15 Jahre,162,77,85
False,8236031,Kieselbronn,15 - 18 Jahre,104,43,61
False,8236031,Kieselbronn,18 - 20 Jahre,69,35,34
False,8236031,Kieselbronn,20 - 25 Jahre,172,87,85
False,8236031,Kieselbronn,25 - 30 Jahre,142,74,68
False,8236031,Kieselbronn,30 - 35 Jahre,167,89,78
False,8236031,Kieselbronn,35 - 40 Jahre,236,107,129
False,8236031,Kieselbronn,40 - 45 Jahre,290,150,140
False,8236031,Kieselbronn,45 - 50 Jahre,239,123,116
False,8236031,Kieselbronn,50 - 55 Jahre,197,93,104
False,8236031,Kieselbronn,55 - 60 Jahre,164,102,62
False,8236031,Kieselbronn,60 - 65 Jahre,160,76,84
False,8236031,Kieselbronn,65 - 75 Jahre,296,146,150
False,8236031,Kieselbronn,75 und mehr Jahre,224,85,139
False,8236031,Kieselbronn,Insgesamt,2952,1446,1506
False,8236033,"Knittlingen, Stadt",unter 3 Jahre,223,114,109
False,8236033,"Knittlingen, Stadt",3 -  6 Jahre,251,125,126
False,8236033,"Knittlingen, Stadt",6 - 10 Jahre,367,199,168
False,8236033,"Knittlingen, Stadt",10 - 15 Jahre,541,286,255
False,8236033,"Knittlingen, Stadt",15 - 18 Jahre,313,160,153
False,8236033,"Knittlingen, Stadt",18 - 20 Jahre,180,101,79
False,8236033,"Knittlingen, Stadt",20 - 25 Jahre,446,219,227
False,8236033,"Knittlingen, Stadt",25 - 30 Jahre,405,203,202
False,8236033,"Knittlingen, Stadt",30 - 35 Jahre,439,221,218
False,8236033,"Knittlingen, Stadt",35 - 40 Jahre,613,301,312
False,8236033,"Knittlingen, Stadt",40 - 45 Jahre,695,343,352
False,8236033,"Knittlingen, Stadt",45 - 50 Jahre,578,294,284
False,8236033,"Knittlingen, Stadt",50 - 55 Jahre,488,221,267
False,8236033,"Knittlingen, Stadt",55 - 60 Jahre,428,204,224
False,8236033,"Knittlingen, Stadt",60 - 65 Jahre,387,203,184
False,8236033,"Knittlingen, Stadt",65 - 75 Jahre,779,358,421
False,8236033,"Knittlingen, Stadt",75 und mehr Jahre,481,180,301
False,8236033,"Knittlingen, Stadt",Insgesamt,7614,3732,3882
False,8236038,"Maulbronn, Stadt",unter 3 Jahre,206,102,104
False,8236038,"Maulbronn, Stadt",3 -  6 Jahre,212,109,103
False,8236038,"Maulbronn, Stadt",6 - 10 Jahre,354,186,168
False,8236038,"Maulbronn, Stadt",10 - 15 Jahre,447,192,255
False,8236038,"Maulbronn, Stadt",15 - 18 Jahre,285,154,131
False,8236038,"Maulbronn, Stadt",18 - 20 Jahre,159,84,75
False,8236038,"Maulbronn, Stadt",20 - 25 Jahre,363,192,171
False,8236038,"Maulbronn, Stadt",25 - 30 Jahre,322,177,145
False,8236038,"Maulbronn, Stadt",30 - 35 Jahre,402,191,211
False,8236038,"Maulbronn, Stadt",35 - 40 Jahre,556,287,269
False,8236038,"Maulbronn, Stadt",40 - 45 Jahre,632,321,311
False,8236038,"Maulbronn, Stadt",45 - 50 Jahre,539,260,279
False,8236038,"Maulbronn, Stadt",50 - 55 Jahre,387,194,193
False,8236038,"Maulbronn, Stadt",55 - 60 Jahre,311,160,151
False,8236038,"Maulbronn, Stadt",60 - 65 Jahre,392,199,193
False,8236038,"Maulbronn, Stadt",65 - 75 Jahre,731,361,370
False,8236038,"Maulbronn, Stadt",75 und mehr Jahre,504,179,325
False,8236038,"Maulbronn, Stadt",Insgesamt,6802,3348,3454
False,8236039,Mönsheim,unter 3 Jahre,90,54,36
False,8236039,Mönsheim,3 -  6 Jahre,97,36,61
False,8236039,Mönsheim,6 - 10 Jahre,141,70,71
False,8236039,Mönsheim,10 - 15 Jahre,185,93,92
False,8236039,Mönsheim,15 - 18 Jahre,108,52,56
False,8236039,Mönsheim,18 - 20 Jahre,60,34,26
False,8236039,Mönsheim,20 - 25 Jahre,127,68,59
False,8236039,Mönsheim,25 - 30 Jahre,135,79,56
False,8236039,Mönsheim,30 - 35 Jahre,168,72,96
False,8236039,Mönsheim,35 - 40 Jahre,240,133,107
False,8236039,Mönsheim,40 - 45 Jahre,274,132,142
False,8236039,Mönsheim,45 - 50 Jahre,217,102,115
False,8236039,Mönsheim,50 - 55 Jahre,188,99,89
False,8236039,Mönsheim,55 - 60 Jahre,158,84,74
False,8236039,Mönsheim,60 - 65 Jahre,152,77,75
False,8236039,Mönsheim,65 - 75 Jahre,292,139,153
False,8236039,Mönsheim,75 und mehr Jahre,160,61,99
False,8236039,Mönsheim,Insgesamt,2792,1385,1407
False,8236040,"Mühlacker, Stadt",unter 3 Jahre,775,363,412
False,8236040,"Mühlacker, Stadt",3 -  6 Jahre,776,401,375
False,8236040,"Mühlacker, Stadt",6 - 10 Jahre,1168,628,540
False,8236040,"Mühlacker, Stadt",10 - 15 Jahre,1527,811,716
False,8236040,"Mühlacker, Stadt",15 - 18 Jahre,1061,565,496
False,8236040,"Mühlacker, Stadt",18 - 20 Jahre,630,331,299
False,8236040,"Mühlacker, Stadt",20 - 25 Jahre,1475,755,720
False,8236040,"Mühlacker, Stadt",25 - 30 Jahre,1349,713,636
False,8236040,"Mühlacker, Stadt",30 - 35 Jahre,1543,794,749
False,8236040,"Mühlacker, Stadt",35 - 40 Jahre,2068,1049,1019
False,8236040,"Mühlacker, Stadt",40 - 45 Jahre,2251,1171,1080
False,8236040,"Mühlacker, Stadt",45 - 50 Jahre,1949,993,956
False,8236040,"Mühlacker, Stadt",50 - 55 Jahre,1649,813,836
False,8236040,"Mühlacker, Stadt",55 - 60 Jahre,1450,698,752
False,8236040,"Mühlacker, Stadt",60 - 65 Jahre,1512,777,735
False,8236040,"Mühlacker, Stadt",65 - 75 Jahre,2878,1382,1496
False,8236040,"Mühlacker, Stadt",75 und mehr Jahre,2044,693,1351
False,8236040,"Mühlacker, Stadt",Insgesamt,26105,12937,13168
False,8236043,"Neuenbürg, Stadt",unter 3 Jahre,194,105,89
False,8236043,"Neuenbürg, Stadt",3 -  6 Jahre,214,114,100
False,8236043,"Neuenbürg, Stadt",6 - 10 Jahre,331,181,150
False,8236043,"Neuenbürg, Stadt",10 - 15 Jahre,448,237,211
False,8236043,"Neuenbürg, Stadt",15 - 18 Jahre,286,162,124
False,8236043,"Neuenbürg, Stadt",18 - 20 Jahre,186,103,83
False,8236043,"Neuenbürg, Stadt",20 - 25 Jahre,415,213,202
False,8236043,"Neuenbürg, Stadt",25 - 30 Jahre,363,167,196
False,8236043,"Neuenbürg, Stadt",30 - 35 Jahre,402,212,190
False,8236043,"Neuenbürg, Stadt",35 - 40 Jahre,627,321,306
False,8236043,"Neuenbürg, Stadt",40 - 45 Jahre,709,326,383
False,8236043,"Neuenbürg, Stadt",45 - 50 Jahre,615,316,299
False,8236043,"Neuenbürg, Stadt",50 - 55 Jahre,502,259,243
False,8236043,"Neuenbürg, Stadt",55 - 60 Jahre,420,189,231
False,8236043,"Neuenbürg, Stadt",60 - 65 Jahre,459,222,237
False,8236043,"Neuenbürg, Stadt",65 - 75 Jahre,866,415,451
False,8236043,"Neuenbürg, Stadt",75 und mehr Jahre,686,245,441
False,8236043,"Neuenbürg, Stadt",Insgesamt,7723,3787,3936
False,8236044,Neuhausen,unter 3 Jahre,133,64,69
False,8236044,Neuhausen,3 -  6 Jahre,165,67,98
False,8236044,Neuhausen,6 - 10 Jahre,273,125,148
False,8236044,Neuhausen,10 - 15 Jahre,370,166,204
False,8236044,Neuhausen,15 - 18 Jahre,229,126,103
False,8236044,Neuhausen,18 - 20 Jahre,136,71,65
False,8236044,Neuhausen,20 - 25 Jahre,297,164,133
False,8236044,Neuhausen,25 - 30 Jahre,255,126,129
False,8236044,Neuhausen,30 - 35 Jahre,321,156,165
False,8236044,Neuhausen,35 - 40 Jahre,463,238,225
False,8236044,Neuhausen,40 - 45 Jahre,526,260,266
False,8236044,Neuhausen,45 - 50 Jahre,443,237,206
False,8236044,Neuhausen,50 - 55 Jahre,377,185,192
False,8236044,Neuhausen,55 - 60 Jahre,326,166,160
False,8236044,Neuhausen,60 - 65 Jahre,281,137,144
False,8236044,Neuhausen,65 - 75 Jahre,505,254,251
False,8236044,Neuhausen,75 und mehr Jahre,356,137,219
False,8236044,Neuhausen,Insgesamt,5456,2679,2777
False,8236046,Niefern-Öschelbronn,unter 3 Jahre,318,167,151
False,8236046,Niefern-Öschelbronn,3 -  6 Jahre,383,206,177
False,8236046,Niefern-Öschelbronn,6 - 10 Jahre,564,279,285
False,8236046,Niefern-Öschelbronn,10 - 15 Jahre,729,349,380
False,8236046,Niefern-Öschelbronn,15 - 18 Jahre,492,241,251
False,8236046,Niefern-Öschelbronn,18 - 20 Jahre,293,146,147
False,8236046,Niefern-Öschelbronn,20 - 25 Jahre,640,322,318
False,8236046,Niefern-Öschelbronn,25 - 30 Jahre,684,336,348
False,8236046,Niefern-Öschelbronn,30 - 35 Jahre,712,326,386
False,8236046,Niefern-Öschelbronn,35 - 40 Jahre,928,452,476
False,8236046,Niefern-Öschelbronn,40 - 45 Jahre,1049,527,522
False,8236046,Niefern-Öschelbronn,45 - 50 Jahre,941,488,453
False,8236046,Niefern-Öschelbronn,50 - 55 Jahre,769,363,406
False,8236046,Niefern-Öschelbronn,55 - 60 Jahre,655,325,330
False,8236046,Niefern-Öschelbronn,60 - 65 Jahre,634,298,336
False,8236046,Niefern-Öschelbronn,65 - 75 Jahre,1288,591,697
False,8236046,Niefern-Öschelbronn,75 und mehr Jahre,1130,372,758
False,8236046,Niefern-Öschelbronn,Insgesamt,12209,5788,6421
False,8236050,Ötisheim,unter 3 Jahre,118,58,60
False,8236050,Ötisheim,3 -  6 Jahre,144,75,69
False,8236050,Ötisheim,6 - 10 Jahre,209,111,98
False,8236050,Ötisheim,10 - 15 Jahre,309,163,146
False,8236050,Ötisheim,15 - 18 Jahre,206,106,100
False,8236050,Ötisheim,18 - 20 Jahre,122,53,69
False,8236050,Ötisheim,20 - 25 Jahre,247,129,118
False,8236050,Ötisheim,25 - 30 Jahre,251,136,115
False,8236050,Ötisheim,30 - 35 Jahre,268,112,156
False,8236050,Ötisheim,35 - 40 Jahre,440,212,228
False,8236050,Ötisheim,40 - 45 Jahre,426,231,195
False,8236050,Ötisheim,45 - 50 Jahre,387,183,204
False,8236050,Ötisheim,50 - 55 Jahre,363,190,173
False,8236050,Ötisheim,55 - 60 Jahre,263,148,115
False,8236050,Ötisheim,60 - 65 Jahre,294,149,145
False,8236050,Ötisheim,65 - 75 Jahre,545,264,281
False,8236050,Ötisheim,75 und mehr Jahre,325,116,209
False,8236050,Ötisheim,Insgesamt,4917,2436,2481
False,8236061,Sternenfels,unter 3 Jahre,72,40,32
False,8236061,Sternenfels,3 -  6 Jahre,81,39,42
False,8236061,Sternenfels,6 - 10 Jahre,120,52,68
False,8236061,Sternenfels,10 - 15 Jahre,180,102,78
False,8236061,Sternenfels,15 - 18 Jahre,148,80,68
False,8236061,Sternenfels,18 - 20 Jahre,61,32,29
False,8236061,Sternenfels,20 - 25 Jahre,132,69,63
False,8236061,Sternenfels,25 - 30 Jahre,131,69,62
False,8236061,Sternenfels,30 - 35 Jahre,170,95,75
False,8236061,Sternenfels,35 - 40 Jahre,209,99,110
False,8236061,Sternenfels,40 - 45 Jahre,293,150,143
False,8236061,Sternenfels,45 - 50 Jahre,249,129,120
False,8236061,Sternenfels,50 - 55 Jahre,222,113,109
False,8236061,Sternenfels,55 - 60 Jahre,163,80,83
False,8236061,Sternenfels,60 - 65 Jahre,154,80,74
False,8236061,Sternenfels,65 - 75 Jahre,255,117,138
False,8236061,Sternenfels,75 und mehr Jahre,188,60,128
False,8236061,Sternenfels,Insgesamt,2828,1406,1422
False,8236062,Tiefenbronn,unter 3 Jahre,135,72,63
False,8236062,Tiefenbronn,3 -  6 Jahre,149,77,72
False,8236062,Tiefenbronn,6 - 10 Jahre,266,116,150
False,8236062,Tiefenbronn,10 - 15 Jahre,393,201,192
False,8236062,Tiefenbronn,15 - 18 Jahre,239,128,111
False,8236062,Tiefenbronn,18 - 20 Jahre,141,71,70
False,8236062,Tiefenbronn,20 - 25 Jahre,308,164,144
False,8236062,Tiefenbronn,25 - 30 Jahre,242,123,119
False,8236062,Tiefenbronn,30 - 35 Jahre,263,132,131
False,8236062,Tiefenbronn,35 - 40 Jahre,452,225,227
False,8236062,Tiefenbronn,40 - 45 Jahre,503,234,269
False,8236062,Tiefenbronn,45 - 50 Jahre,486,248,238
False,8236062,Tiefenbronn,50 - 55 Jahre,396,223,173
False,8236062,Tiefenbronn,55 - 60 Jahre,353,181,172
False,8236062,Tiefenbronn,60 - 65 Jahre,332,181,151
False,8236062,Tiefenbronn,65 - 75 Jahre,515,251,264
False,8236062,Tiefenbronn,75 und mehr Jahre,302,112,190
False,8236062,Tiefenbronn,Insgesamt,5475,2739,2736
False,8236065,Wiernsheim,unter 3 Jahre,181,102,79
False,8236065,Wiernsheim,3 -  6 Jahre,202,107,95
False,8236065,Wiernsheim,6 - 10 Jahre,336,182,154
False,8236065,Wiernsheim,10 - 15 Jahre,423,228,195
False,8236065,Wiernsheim,15 - 18 Jahre,268,138,130
False,8236065,Wiernsheim,18 - 20 Jahre,166,78,88
False,8236065,Wiernsheim,20 - 25 Jahre,345,171,174
False,8236065,Wiernsheim,25 - 30 Jahre,367,185,182
False,8236065,Wiernsheim,30 - 35 Jahre,358,193,165
False,8236065,Wiernsheim,35 - 40 Jahre,567,289,278
False,8236065,Wiernsheim,40 - 45 Jahre,656,322,334
False,8236065,Wiernsheim,45 - 50 Jahre,563,289,274
False,8236065,Wiernsheim,50 - 55 Jahre,453,245,208
False,8236065,Wiernsheim,55 - 60 Jahre,379,199,180
False,8236065,Wiernsheim,60 - 65 Jahre,343,176,167
False,8236065,Wiernsheim,65 - 75 Jahre,588,278,310
False,8236065,Wiernsheim,75 und mehr Jahre,368,137,231
False,8236065,Wiernsheim,Insgesamt,6563,3319,3244
False,8236067,Wimsheim,unter 3 Jahre,72,35,37
False,8236067,Wimsheim,3 -  6 Jahre,74,33,41
False,8236067,Wimsheim,6 - 10 Jahre,124,57,67
False,8236067,Wimsheim,10 - 15 Jahre,204,113,91
False,8236067,Wimsheim,15 - 18 Jahre,118,60,58
False,8236067,Wimsheim,18 - 20 Jahre,56,25,31
False,8236067,Wimsheim,20 - 25 Jahre,140,67,73
False,8236067,Wimsheim,25 - 30 Jahre,143,71,72
False,8236067,Wimsheim,30 - 35 Jahre,150,81,69
False,8236067,Wimsheim,35 - 40 Jahre,226,103,123
False,8236067,Wimsheim,40 - 45 Jahre,282,153,129
False,8236067,Wimsheim,45 - 50 Jahre,240,118,122
False,8236067,Wimsheim,50 - 55 Jahre,201,96,105
False,8236067,Wimsheim,55 - 60 Jahre,144,78,66
False,8236067,Wimsheim,60 - 65 Jahre,132,72,60
False,8236067,Wimsheim,65 - 75 Jahre,248,114,134
False,8236067,Wimsheim,75 und mehr Jahre,134,57,77
False,8236067,Wimsheim,Insgesamt,2688,1333,1355
False,8236068,Wurmberg,unter 3 Jahre,89,43,46
False,8236068,Wurmberg,3 -  6 Jahre,107,50,57
False,8236068,Wurmberg,6 - 10 Jahre,169,96,73
False,8236068,Wurmberg,10 - 15 Jahre,240,125,115
False,8236068,Wurmberg,15 - 18 Jahre,144,62,82
False,8236068,Wurmberg,18 - 20 Jahre,85,40,45
False,8236068,Wurmberg,20 - 25 Jahre,165,88,77
False,8236068,Wurmberg,25 - 30 Jahre,127,60,67
False,8236068,Wurmberg,30 - 35 Jahre,144,66,78
False,8236068,Wurmberg,35 - 40 Jahre,220,117,103
False,8236068,Wurmberg,40 - 45 Jahre,267,135,132
False,8236068,Wurmberg,45 - 50 Jahre,215,108,107
False,8236068,Wurmberg,50 - 55 Jahre,158,89,69
False,8236068,Wurmberg,55 - 60 Jahre,131,70,61
False,8236068,Wurmberg,60 - 65 Jahre,135,57,78
False,8236068,Wurmberg,65 - 75 Jahre,292,140,152
False,8236068,Wurmberg,75 und mehr Jahre,216,83,133
False,8236068,Wurmberg,Insgesamt,2904,1429,1475
False,8236070,Keltern,unter 3 Jahre,221,109,112
False,8236070,Keltern,3 -  6 Jahre,249,121,128
False,8236070,Keltern,6 - 10 Jahre,446,214,232
False,8236070,Keltern,10 - 15 Jahre,560,285,275
False,8236070,Keltern,15 - 18 Jahre,327,159,168
False,8236070,Keltern,18 - 20 Jahre,210,130,80
False,8236070,Keltern,20 - 25 Jahre,428,231,197
False,8236070,Keltern,25 - 30 Jahre,479,243,236
False,8236070,Keltern,30 - 35 Jahre,489,235,254
False,8236070,Keltern,35 - 40 Jahre,785,393,392
False,8236070,Keltern,40 - 45 Jahre,869,438,431
False,8236070,Keltern,45 - 50 Jahre,699,348,351
False,8236070,Keltern,50 - 55 Jahre,600,293,307
False,8236070,Keltern,55 - 60 Jahre,545,267,278
False,8236070,Keltern,60 - 65 Jahre,549,276,273
False,8236070,Keltern,65 - 75 Jahre,964,461,503
False,8236070,Keltern,75 und mehr Jahre,719,276,443
False,8236070,Keltern,Insgesamt,9139,4479,4660
False,8236071,Remchingen,unter 3 Jahre,345,177,168
False,8236071,Remchingen,3 -  6 Jahre,372,204,168
False,8236071,Remchingen,6 - 10 Jahre,531,284,247
False,8236071,Remchingen,10 - 15 Jahre,713,373,340
False,8236071,Remchingen,15 - 18 Jahre,474,254,220
False,8236071,Remchingen,18 - 20 Jahre,297,159,138
False,8236071,Remchingen,20 - 25 Jahre,689,338,351
False,8236071,Remchingen,25 - 30 Jahre,658,342,316
False,8236071,Remchingen,30 - 35 Jahre,641,324,317
False,8236071,Remchingen,35 - 40 Jahre,998,481,517
False,8236071,Remchingen,40 - 45 Jahre,1005,516,489
False,8236071,Remchingen,45 - 50 Jahre,855,410,445
False,8236071,Remchingen,50 - 55 Jahre,845,412,433
False,8236071,Remchingen,55 - 60 Jahre,704,354,350
False,8236071,Remchingen,60 - 65 Jahre,625,310,315
False,8236071,Remchingen,65 - 75 Jahre,1181,571,610
False,8236071,Remchingen,75 und mehr Jahre,761,281,480
False,8236071,Remchingen,Insgesamt,11694,5790,5904
False,8236072,Straubenhardt,unter 3 Jahre,258,136,122
False,8236072,Straubenhardt,3 -  6 Jahre,309,173,136
False,8236072,Straubenhardt,6 - 10 Jahre,526,254,272
False,8236072,Straubenhardt,10 - 15 Jahre,698,389,309
False,8236072,Straubenhardt,15 - 18 Jahre,466,247,219
False,8236072,Straubenhardt,18 - 20 Jahre,266,135,131
False,8236072,Straubenhardt,20 - 25 Jahre,551,276,275
False,8236072,Straubenhardt,25 - 30 Jahre,440,223,217
False,8236072,Straubenhardt,30 - 35 Jahre,592,292,300
False,8236072,Straubenhardt,35 - 40 Jahre,881,433,448
False,8236072,Straubenhardt,40 - 45 Jahre,1033,525,508
False,8236072,Straubenhardt,45 - 50 Jahre,918,492,426
False,8236072,Straubenhardt,50 - 55 Jahre,667,338,329
False,8236072,Straubenhardt,55 - 60 Jahre,643,319,324
False,8236072,Straubenhardt,60 - 65 Jahre,572,302,270
False,8236072,Straubenhardt,65 - 75 Jahre,1119,538,581
False,8236072,Straubenhardt,75 und mehr Jahre,796,268,528
False,8236072,Straubenhardt,Insgesamt,10735,5340,5395
False,8236073,Neulingen,unter 3 Jahre,167,83,84
False,8236073,Neulingen,3 -  6 Jahre,208,107,101
False,8236073,Neulingen,6 - 10 Jahre,352,184,168
False,8236073,Neulingen,10 - 15 Jahre,434,233,201
False,8236073,Neulingen,15 - 18 Jahre,308,149,159
False,8236073,Neulingen,18 - 20 Jahre,163,83,80
False,8236073,Neulingen,20 - 25 Jahre,359,190,169
False,8236073,Neulingen,25 - 30 Jahre,316,157,159
False,8236073,Neulingen,30 - 35 Jahre,359,176,183
False,8236073,Neulingen,35 - 40 Jahre,573,278,295
False,8236073,Neulingen,40 - 45 Jahre,634,326,308
False,8236073,Neulingen,45 - 50 Jahre,571,294,277
False,8236073,Neulingen,50 - 55 Jahre,452,232,220
False,8236073,Neulingen,55 - 60 Jahre,332,170,162
False,8236073,Neulingen,60 - 65 Jahre,309,151,158
False,8236073,Neulingen,65 - 75 Jahre,564,258,306
False,8236073,Neulingen,75 und mehr Jahre,518,155,363
False,8236073,Neulingen,Insgesamt,6619,3226,3393
False,8236074,Kämpfelbach,unter 3 Jahre,151,74,77
False,8236074,Kämpfelbach,3 -  6 Jahre,170,104,66
False,8236074,Kämpfelbach,6 - 10 Jahre,284,155,129
False,8236074,Kämpfelbach,10 - 15 Jahre,377,186,191
False,8236074,Kämpfelbach,15 - 18 Jahre,196,100,96
False,8236074,Kämpfelbach,18 - 20 Jahre,143,68,75
False,8236074,Kämpfelbach,20 - 25 Jahre,329,151,178
False,8236074,Kämpfelbach,25 - 30 Jahre,326,178,148
False,8236074,Kämpfelbach,30 - 35 Jahre,374,171,203
False,8236074,Kämpfelbach,35 - 40 Jahre,468,262,206
False,8236074,Kämpfelbach,40 - 45 Jahre,558,280,278
False,8236074,Kämpfelbach,45 - 50 Jahre,528,271,257
False,8236074,Kämpfelbach,50 - 55 Jahre,387,186,201
False,8236074,Kämpfelbach,55 - 60 Jahre,350,181,169
False,8236074,Kämpfelbach,60 - 65 Jahre,332,163,169
False,8236074,Kämpfelbach,65 - 75 Jahre,707,328,379
False,8236074,Kämpfelbach,75 und mehr Jahre,474,171,303
False,8236074,Kämpfelbach,Insgesamt,6154,3029,3125
False,8236075,Ölbronn-Dürrn,unter 3 Jahre,105,50,55
False,8236075,Ölbronn-Dürrn,3 -  6 Jahre,111,49,62
False,8236075,Ölbronn-Dürrn,6 - 10 Jahre,172,86,86
False,8236075,Ölbronn-Dürrn,10 - 15 Jahre,231,124,107
False,8236075,Ölbronn-Dürrn,15 - 18 Jahre,154,95,59
False,8236075,Ölbronn-Dürrn,18 - 20 Jahre,76,48,28
False,8236075,Ölbronn-Dürrn,20 - 25 Jahre,207,98,109
False,8236075,Ölbronn-Dürrn,25 - 30 Jahre,177,95,82
False,8236075,Ölbronn-Dürrn,30 - 35 Jahre,187,87,100
False,8236075,Ölbronn-Dürrn,35 - 40 Jahre,318,152,166
False,8236075,Ölbronn-Dürrn,40 - 45 Jahre,328,168,160
False,8236075,Ölbronn-Dürrn,45 - 50 Jahre,271,135,136
False,8236075,Ölbronn-Dürrn,50 - 55 Jahre,246,128,118
False,8236075,Ölbronn-Dürrn,55 - 60 Jahre,168,91,77
False,8236075,Ölbronn-Dürrn,60 - 65 Jahre,173,79,94
False,8236075,Ölbronn-Dürrn,65 - 75 Jahre,375,190,185
False,8236075,Ölbronn-Dürrn,75 und mehr Jahre,221,84,137
False,8236075,Ölbronn-Dürrn,Insgesamt,3520,1759,1761
False,8236076,Königsbach-Stein,unter 3 Jahre,223,119,104
False,8236076,Königsbach-Stein,3 -  6 Jahre,320,166,154
False,8236076,Königsbach-Stein,6 - 10 Jahre,435,228,207
False,8236076,Königsbach-Stein,10 - 15 Jahre,611,312,299
False,8236076,Königsbach-Stein,15 - 18 Jahre,294,145,149
False,8236076,Königsbach-Stein,18 - 20 Jahre,221,113,108
False,8236076,Königsbach-Stein,20 - 25 Jahre,502,244,258
False,8236076,Königsbach-Stein,25 - 30 Jahre,488,242,246
False,8236076,Königsbach-Stein,30 - 35 Jahre,613,293,320
False,8236076,Königsbach-Stein,35 - 40 Jahre,940,479,461
False,8236076,Königsbach-Stein,40 - 45 Jahre,889,443,446
False,8236076,Königsbach-Stein,45 - 50 Jahre,740,374,366
False,8236076,Königsbach-Stein,50 - 55 Jahre,629,309,320
False,8236076,Königsbach-Stein,55 - 60 Jahre,603,276,327
False,8236076,Königsbach-Stein,60 - 65 Jahre,607,304,303
False,8236076,Königsbach-Stein,65 - 75 Jahre,1091,541,550
False,8236076,Königsbach-Stein,75 und mehr Jahre,675,226,449
False,8236076,Königsbach-Stein,Insgesamt,9881,4814,5067
False,8237,Landkreis Freudenstadt,unter 3 Jahre,3503,1805,1698
False,8237,Landkreis Freudenstadt,3 -  6 Jahre,3762,1943,1819
False,8237,Landkreis Freudenstadt,6 - 10 Jahre,5500,2891,2609
False,8237,Landkreis Freudenstadt,10 - 15 Jahre,7610,3930,3680
False,8237,Landkreis Freudenstadt,15 - 18 Jahre,4758,2385,2373
False,8237,Landkreis Freudenstadt,18 - 20 Jahre,3034,1494,1540
False,8237,Landkreis Freudenstadt,20 - 25 Jahre,7294,3656,3638
False,8237,Landkreis Freudenstadt,25 - 30 Jahre,6817,3450,3367
False,8237,Landkreis Freudenstadt,30 - 35 Jahre,7570,3670,3900
False,8237,Landkreis Freudenstadt,35 - 40 Jahre,10152,5170,4982
False,8237,Landkreis Freudenstadt,40 - 45 Jahre,10571,5328,5243
False,8237,Landkreis Freudenstadt,45 - 50 Jahre,9371,4808,4563
False,8237,Landkreis Freudenstadt,50 - 55 Jahre,8022,4117,3905
False,8237,Landkreis Freudenstadt,55 - 60 Jahre,6491,3334,3157
False,8237,Landkreis Freudenstadt,60 - 65 Jahre,5855,2865,2990
False,8237,Landkreis Freudenstadt,65 - 75 Jahre,12713,5912,6801
False,8237,Landkreis Freudenstadt,75 und mehr Jahre,9556,3173,6383
False,8237,Landkreis Freudenstadt,Insgesamt,122579,59931,62648
False,8237002,"Alpirsbach, Stadt",unter 3 Jahre,188,93,95
False,8237002,"Alpirsbach, Stadt",3 -  6 Jahre,207,96,111
False,8237002,"Alpirsbach, Stadt",6 - 10 Jahre,310,164,146
False,8237002,"Alpirsbach, Stadt",10 - 15 Jahre,392,202,190
False,8237002,"Alpirsbach, Stadt",15 - 18 Jahre,278,136,142
False,8237002,"Alpirsbach, Stadt",18 - 20 Jahre,172,96,76
False,8237002,"Alpirsbach, Stadt",20 - 25 Jahre,396,199,197
False,8237002,"Alpirsbach, Stadt",25 - 30 Jahre,353,205,148
False,8237002,"Alpirsbach, Stadt",30 - 35 Jahre,334,163,171
False,8237002,"Alpirsbach, Stadt",35 - 40 Jahre,522,261,261
False,8237002,"Alpirsbach, Stadt",40 - 45 Jahre,611,295,316
False,8237002,"Alpirsbach, Stadt",45 - 50 Jahre,529,277,252
False,8237002,"Alpirsbach, Stadt",50 - 55 Jahre,459,249,210
False,8237002,"Alpirsbach, Stadt",55 - 60 Jahre,386,198,188
False,8237002,"Alpirsbach, Stadt",60 - 65 Jahre,362,206,156
False,8237002,"Alpirsbach, Stadt",65 - 75 Jahre,805,382,423
False,8237002,"Alpirsbach, Stadt",75 und mehr Jahre,618,189,429
False,8237002,"Alpirsbach, Stadt",Insgesamt,6922,3411,3511
False,8237004,Baiersbronn,unter 3 Jahre,417,217,200
False,8237004,Baiersbronn,3 -  6 Jahre,473,244,229
False,8237004,Baiersbronn,6 - 10 Jahre,676,350,326
False,8237004,Baiersbronn,10 - 15 Jahre,949,492,457
False,8237004,Baiersbronn,15 - 18 Jahre,561,278,283
False,8237004,Baiersbronn,18 - 20 Jahre,413,187,226
False,8237004,Baiersbronn,20 - 25 Jahre,1157,565,592
False,8237004,Baiersbronn,25 - 30 Jahre,927,459,468
False,8237004,Baiersbronn,30 - 35 Jahre,1016,486,530
False,8237004,Baiersbronn,35 - 40 Jahre,1497,723,774
False,8237004,Baiersbronn,40 - 45 Jahre,1366,692,674
False,8237004,Baiersbronn,45 - 50 Jahre,1105,586,519
False,8237004,Baiersbronn,50 - 55 Jahre,943,475,468
False,8237004,Baiersbronn,55 - 60 Jahre,745,359,386
False,8237004,Baiersbronn,60 - 65 Jahre,774,357,417
False,8237004,Baiersbronn,65 - 75 Jahre,1832,846,986
False,8237004,Baiersbronn,75 und mehr Jahre,1372,474,898
False,8237004,Baiersbronn,Insgesamt,16223,7790,8433
False,8237019,"Dornstetten, Stadt",unter 3 Jahre,253,125,128
False,8237019,"Dornstetten, Stadt",3 -  6 Jahre,276,145,131
False,8237019,"Dornstetten, Stadt",6 - 10 Jahre,399,198,201
False,8237019,"Dornstetten, Stadt",10 - 15 Jahre,491,263,228
False,8237019,"Dornstetten, Stadt",15 - 18 Jahre,332,162,170
False,8237019,"Dornstetten, Stadt",18 - 20 Jahre,222,116,106
False,8237019,"Dornstetten, Stadt",20 - 25 Jahre,436,231,205
False,8237019,"Dornstetten, Stadt",25 - 30 Jahre,487,247,240
False,8237019,"Dornstetten, Stadt",30 - 35 Jahre,590,307,283
False,8237019,"Dornstetten, Stadt",35 - 40 Jahre,653,327,326
False,8237019,"Dornstetten, Stadt",40 - 45 Jahre,706,348,358
False,8237019,"Dornstetten, Stadt",45 - 50 Jahre,626,320,306
False,8237019,"Dornstetten, Stadt",50 - 55 Jahre,580,296,284
False,8237019,"Dornstetten, Stadt",55 - 60 Jahre,463,255,208
False,8237019,"Dornstetten, Stadt",60 - 65 Jahre,344,167,177
False,8237019,"Dornstetten, Stadt",65 - 75 Jahre,746,327,419
False,8237019,"Dornstetten, Stadt",75 und mehr Jahre,527,168,359
False,8237019,"Dornstetten, Stadt",Insgesamt,8131,4002,4129
False,8237024,Empfingen,unter 3 Jahre,117,66,51
False,8237024,Empfingen,3 -  6 Jahre,135,71,64
False,8237024,Empfingen,6 - 10 Jahre,178,100,78
False,8237024,Empfingen,10 - 15 Jahre,246,137,109
False,8237024,Empfingen,15 - 18 Jahre,126,50,76
False,8237024,Empfingen,18 - 20 Jahre,74,37,37
False,8237024,Empfingen,20 - 25 Jahre,153,86,67
False,8237024,Empfingen,25 - 30 Jahre,219,116,103
False,8237024,Empfingen,30 - 35 Jahre,404,174,230
False,8237024,Empfingen,35 - 40 Jahre,490,270,220
False,8237024,Empfingen,40 - 45 Jahre,357,185,172
False,8237024,Empfingen,45 - 50 Jahre,399,229,170
False,8237024,Empfingen,50 - 55 Jahre,311,175,136
False,8237024,Empfingen,55 - 60 Jahre,228,98,130
False,8237024,Empfingen,60 - 65 Jahre,120,54,66
False,8237024,Empfingen,65 - 75 Jahre,323,159,164
False,8237024,Empfingen,75 und mehr Jahre,253,89,164
False,8237024,Empfingen,Insgesamt,4133,2096,2037
False,8237027,Eutingen im Gäu,unter 3 Jahre,197,110,87
False,8237027,Eutingen im Gäu,3 -  6 Jahre,209,115,94
False,8237027,Eutingen im Gäu,6 - 10 Jahre,322,171,151
False,8237027,Eutingen im Gäu,10 - 15 Jahre,419,219,200
False,8237027,Eutingen im Gäu,15 - 18 Jahre,208,112,96
False,8237027,Eutingen im Gäu,18 - 20 Jahre,159,71,88
False,8237027,Eutingen im Gäu,20 - 25 Jahre,290,148,142
False,8237027,Eutingen im Gäu,25 - 30 Jahre,295,139,156
False,8237027,Eutingen im Gäu,30 - 35 Jahre,345,156,189
False,8237027,Eutingen im Gäu,35 - 40 Jahre,511,261,250
False,8237027,Eutingen im Gäu,40 - 45 Jahre,534,272,262
False,8237027,Eutingen im Gäu,45 - 50 Jahre,405,212,193
False,8237027,Eutingen im Gäu,50 - 55 Jahre,352,175,177
False,8237027,Eutingen im Gäu,55 - 60 Jahre,260,140,120
False,8237027,Eutingen im Gäu,60 - 65 Jahre,241,130,111
False,8237027,Eutingen im Gäu,65 - 75 Jahre,463,214,249
False,8237027,Eutingen im Gäu,75 und mehr Jahre,275,108,167
False,8237027,Eutingen im Gäu,Insgesamt,5485,2753,2732
False,8237028,"Freudenstadt, Stadt",unter 3 Jahre,611,307,304
False,8237028,"Freudenstadt, Stadt",3 -  6 Jahre,627,332,295
False,8237028,"Freudenstadt, Stadt",6 - 10 Jahre,928,498,430
False,8237028,"Freudenstadt, Stadt",10 - 15 Jahre,1267,637,630
False,8237028,"Freudenstadt, Stadt",15 - 18 Jahre,871,433,438
False,8237028,"Freudenstadt, Stadt",18 - 20 Jahre,538,265,273
False,8237028,"Freudenstadt, Stadt",20 - 25 Jahre,1423,691,732
False,8237028,"Freudenstadt, Stadt",25 - 30 Jahre,1300,664,636
False,8237028,"Freudenstadt, Stadt",30 - 35 Jahre,1351,631,720
False,8237028,"Freudenstadt, Stadt",35 - 40 Jahre,1879,937,942
False,8237028,"Freudenstadt, Stadt",40 - 45 Jahre,1914,962,952
False,8237028,"Freudenstadt, Stadt",45 - 50 Jahre,1803,882,921
False,8237028,"Freudenstadt, Stadt",50 - 55 Jahre,1613,800,813
False,8237028,"Freudenstadt, Stadt",55 - 60 Jahre,1348,690,658
False,8237028,"Freudenstadt, Stadt",60 - 65 Jahre,1310,601,709
False,8237028,"Freudenstadt, Stadt",65 - 75 Jahre,2713,1226,1487
False,8237028,"Freudenstadt, Stadt",75 und mehr Jahre,2414,755,1659
False,8237028,"Freudenstadt, Stadt",Insgesamt,23910,11311,12599
False,8237030,Glatten,unter 3 Jahre,76,43,33
False,8237030,Glatten,3 -  6 Jahre,79,38,41
False,8237030,Glatten,6 - 10 Jahre,115,54,61
False,8237030,Glatten,10 - 15 Jahre,163,87,76
False,8237030,Glatten,15 - 18 Jahre,83,39,44
False,8237030,Glatten,18 - 20 Jahre,59,22,37
False,8237030,Glatten,20 - 25 Jahre,162,75,87
False,8237030,Glatten,25 - 30 Jahre,159,81,78
False,8237030,Glatten,30 - 35 Jahre,125,69,56
False,8237030,Glatten,35 - 40 Jahre,156,92,64
False,8237030,Glatten,40 - 45 Jahre,181,74,107
False,8237030,Glatten,45 - 50 Jahre,189,91,98
False,8237030,Glatten,50 - 55 Jahre,180,103,77
False,8237030,Glatten,55 - 60 Jahre,127,67,60
False,8237030,Glatten,60 - 65 Jahre,120,54,66
False,8237030,Glatten,65 - 75 Jahre,249,116,133
False,8237030,Glatten,75 und mehr Jahre,168,61,107
False,8237030,Glatten,Insgesamt,2391,1166,1225
False,8237032,Grömbach,unter 3 Jahre,20,12,8
False,8237032,Grömbach,3 -  6 Jahre,24,14,10
False,8237032,Grömbach,6 - 10 Jahre,37,18,19
False,8237032,Grömbach,10 - 15 Jahre,47,27,20
False,8237032,Grömbach,15 - 18 Jahre,25,16,9
False,8237032,Grömbach,18 - 20 Jahre,19,13,6
False,8237032,Grömbach,20 - 25 Jahre,49,31,18
False,8237032,Grömbach,25 - 30 Jahre,36,22,14
False,8237032,Grömbach,30 - 35 Jahre,46,23,23
False,8237032,Grömbach,35 - 40 Jahre,67,32,35
False,8237032,Grömbach,40 - 45 Jahre,55,28,27
False,8237032,Grömbach,45 - 50 Jahre,44,22,22
False,8237032,Grömbach,50 - 55 Jahre,49,26,23
False,8237032,Grömbach,55 - 60 Jahre,42,18,24
False,8237032,Grömbach,60 - 65 Jahre,28,15,13
False,8237032,Grömbach,65 - 75 Jahre,56,29,27
False,8237032,Grömbach,75 und mehr Jahre,45,12,33
False,8237032,Grömbach,Insgesamt,689,358,331
False,8237040,"Horb am Neckar, Stadt",unter 3 Jahre,774,395,379
False,8237040,"Horb am Neckar, Stadt",3 -  6 Jahre,840,428,412
False,8237040,"Horb am Neckar, Stadt",6 - 10 Jahre,1180,633,547
False,8237040,"Horb am Neckar, Stadt",10 - 15 Jahre,1655,853,802
False,8237040,"Horb am Neckar, Stadt",15 - 18 Jahre,1100,552,548
False,8237040,"Horb am Neckar, Stadt",18 - 20 Jahre,669,320,349
False,8237040,"Horb am Neckar, Stadt",20 - 25 Jahre,1557,767,790
False,8237040,"Horb am Neckar, Stadt",25 - 30 Jahre,1527,767,760
False,8237040,"Horb am Neckar, Stadt",30 - 35 Jahre,1689,845,844
False,8237040,"Horb am Neckar, Stadt",35 - 40 Jahre,2118,1089,1029
False,8237040,"Horb am Neckar, Stadt",40 - 45 Jahre,2313,1175,1138
False,8237040,"Horb am Neckar, Stadt",45 - 50 Jahre,2061,1062,999
False,8237040,"Horb am Neckar, Stadt",50 - 55 Jahre,1724,875,849
False,8237040,"Horb am Neckar, Stadt",55 - 60 Jahre,1438,749,689
False,8237040,"Horb am Neckar, Stadt",60 - 65 Jahre,1215,624,591
False,8237040,"Horb am Neckar, Stadt",65 - 75 Jahre,2579,1239,1340
False,8237040,"Horb am Neckar, Stadt",75 und mehr Jahre,1666,563,1103
False,8237040,"Horb am Neckar, Stadt",Insgesamt,26105,12936,13169
False,8237045,Loßburg,unter 3 Jahre,227,121,106
False,8237045,Loßburg,3 -  6 Jahre,227,120,107
False,8237045,Loßburg,6 - 10 Jahre,365,187,178
False,8237045,Loßburg,10 - 15 Jahre,545,297,248
False,8237045,Loßburg,15 - 18 Jahre,354,178,176
False,8237045,Loßburg,18 - 20 Jahre,209,111,98
False,8237045,Loßburg,20 - 25 Jahre,476,236,240
False,8237045,Loßburg,25 - 30 Jahre,402,199,203
False,8237045,Loßburg,30 - 35 Jahre,430,207,223
False,8237045,Loßburg,35 - 40 Jahre,635,340,295
False,8237045,Loßburg,40 - 45 Jahre,735,394,341
False,8237045,Loßburg,45 - 50 Jahre,647,315,332
False,8237045,Loßburg,50 - 55 Jahre,484,262,222
False,8237045,Loßburg,55 - 60 Jahre,398,215,183
False,8237045,Loßburg,60 - 65 Jahre,386,195,191
False,8237045,Loßburg,65 - 75 Jahre,858,399,459
False,8237045,Loßburg,75 und mehr Jahre,633,226,407
False,8237045,Loßburg,Insgesamt,8011,4002,4009
False,8237054,Pfalzgrafenweiler,unter 3 Jahre,266,126,140
False,8237054,Pfalzgrafenweiler,3 -  6 Jahre,258,151,107
False,8237054,Pfalzgrafenweiler,6 - 10 Jahre,375,180,195
False,8237054,Pfalzgrafenweiler,10 - 15 Jahre,519,263,256
False,8237054,Pfalzgrafenweiler,15 - 18 Jahre,293,154,139
False,8237054,Pfalzgrafenweiler,18 - 20 Jahre,183,101,82
False,8237054,Pfalzgrafenweiler,20 - 25 Jahre,410,216,194
False,8237054,Pfalzgrafenweiler,25 - 30 Jahre,348,165,183
False,8237054,Pfalzgrafenweiler,30 - 35 Jahre,438,209,229
False,8237054,Pfalzgrafenweiler,35 - 40 Jahre,587,294,293
False,8237054,Pfalzgrafenweiler,40 - 45 Jahre,593,288,305
False,8237054,Pfalzgrafenweiler,45 - 50 Jahre,507,246,261
False,8237054,Pfalzgrafenweiler,50 - 55 Jahre,442,227,215
False,8237054,Pfalzgrafenweiler,55 - 60 Jahre,317,162,155
False,8237054,Pfalzgrafenweiler,60 - 65 Jahre,288,143,145
False,8237054,Pfalzgrafenweiler,65 - 75 Jahre,669,321,348
False,8237054,Pfalzgrafenweiler,75 und mehr Jahre,564,190,374
False,8237054,Pfalzgrafenweiler,Insgesamt,7057,3436,3621
False,8237061,Schopfloch,unter 3 Jahre,71,38,33
False,8237061,Schopfloch,3 -  6 Jahre,89,38,51
False,8237061,Schopfloch,6 - 10 Jahre,134,81,53
False,8237061,Schopfloch,10 - 15 Jahre,171,87,84
False,8237061,Schopfloch,15 - 18 Jahre,107,52,55
False,8237061,Schopfloch,18 - 20 Jahre,68,25,43
False,8237061,Schopfloch,20 - 25 Jahre,134,71,63
False,8237061,Schopfloch,25 - 30 Jahre,148,71,77
False,8237061,Schopfloch,30 - 35 Jahre,154,73,81
False,8237061,Schopfloch,35 - 40 Jahre,206,112,94
False,8237061,Schopfloch,40 - 45 Jahre,213,107,106
False,8237061,Schopfloch,45 - 50 Jahre,183,93,90
False,8237061,Schopfloch,50 - 55 Jahre,181,97,84
False,8237061,Schopfloch,55 - 60 Jahre,129,63,66
False,8237061,Schopfloch,60 - 65 Jahre,124,67,57
False,8237061,Schopfloch,65 - 75 Jahre,249,112,137
False,8237061,Schopfloch,75 und mehr Jahre,184,60,124
False,8237061,Schopfloch,Insgesamt,2545,1247,1298
False,8237072,Wörnersberg,unter 3 Jahre,13,8,5
False,8237072,Wörnersberg,3 -  6 Jahre,12,4,8
False,8237072,Wörnersberg,6 - 10 Jahre,14,7,7
False,8237072,Wörnersberg,10 - 15 Jahre,17,11,6
False,8237072,Wörnersberg,15 - 18 Jahre,14,10,4
False,8237072,Wörnersberg,18 - 20 Jahre,9,3,6
False,8237072,Wörnersberg,20 - 25 Jahre,25,13,12
False,8237072,Wörnersberg,25 - 30 Jahre,12,6,6
False,8237072,Wörnersberg,30 - 35 Jahre,11,2,9
False,8237072,Wörnersberg,35 - 40 Jahre,19,10,9
False,8237072,Wörnersberg,40 - 45 Jahre,28,17,11
False,8237072,Wörnersberg,45 - 50 Jahre,20,7,13
False,8237072,Wörnersberg,50 - 55 Jahre,10,7,3
False,8237072,Wörnersberg,55 - 60 Jahre,7,4,3
False,8237072,Wörnersberg,60 - 65 Jahre,8,4,4
False,8237072,Wörnersberg,65 - 75 Jahre,13,5,8
False,8237072,Wörnersberg,75 und mehr Jahre,17,4,13
False,8237072,Wörnersberg,Insgesamt,249,122,127
False,8237073,Seewald,unter 3 Jahre,60,30,30
False,8237073,Seewald,3 -  6 Jahre,62,29,33
False,8237073,Seewald,6 - 10 Jahre,94,48,46
False,8237073,Seewald,10 - 15 Jahre,159,86,73
False,8237073,Seewald,15 - 18 Jahre,84,41,43
False,8237073,Seewald,18 - 20 Jahre,41,24,17
False,8237073,Seewald,20 - 25 Jahre,130,67,63
False,8237073,Seewald,25 - 30 Jahre,107,61,46
False,8237073,Seewald,30 - 35 Jahre,136,68,68
False,8237073,Seewald,35 - 40 Jahre,177,102,75
False,8237073,Seewald,40 - 45 Jahre,225,109,116
False,8237073,Seewald,45 - 50 Jahre,183,95,88
False,8237073,Seewald,50 - 55 Jahre,132,67,65
False,8237073,Seewald,55 - 60 Jahre,129,72,57
False,8237073,Seewald,60 - 65 Jahre,121,56,65
False,8237073,Seewald,65 - 75 Jahre,303,136,167
False,8237073,Seewald,75 und mehr Jahre,249,83,166
False,8237073,Seewald,Insgesamt,2392,1174,1218
False,8237074,Waldachtal,unter 3 Jahre,155,90,65
False,8237074,Waldachtal,3 -  6 Jahre,178,84,94
False,8237074,Waldachtal,6 - 10 Jahre,263,136,127
False,8237074,Waldachtal,10 - 15 Jahre,422,196,226
False,8237074,Waldachtal,15 - 18 Jahre,248,137,111
False,8237074,Waldachtal,18 - 20 Jahre,153,82,71
False,8237074,Waldachtal,20 - 25 Jahre,372,186,186
False,8237074,Waldachtal,25 - 30 Jahre,379,190,189
False,8237074,Waldachtal,30 - 35 Jahre,376,189,187
False,8237074,Waldachtal,35 - 40 Jahre,464,226,238
False,8237074,Waldachtal,40 - 45 Jahre,531,278,253
False,8237074,Waldachtal,45 - 50 Jahre,492,259,233
False,8237074,Waldachtal,50 - 55 Jahre,440,221,219
False,8237074,Waldachtal,55 - 60 Jahre,346,179,167
False,8237074,Waldachtal,60 - 65 Jahre,295,142,153
False,8237074,Waldachtal,65 - 75 Jahre,560,252,308
False,8237074,Waldachtal,75 und mehr Jahre,340,109,231
False,8237074,Waldachtal,Insgesamt,6014,2956,3058
False,8237075,Bad Rippoldsau-Schapbach,unter 3 Jahre,58,24,34
False,8237075,Bad Rippoldsau-Schapbach,3 -  6 Jahre,66,34,32
False,8237075,Bad Rippoldsau-Schapbach,6 - 10 Jahre,110,66,44
False,8237075,Bad Rippoldsau-Schapbach,10 - 15 Jahre,148,73,75
False,8237075,Bad Rippoldsau-Schapbach,15 - 18 Jahre,74,35,39
False,8237075,Bad Rippoldsau-Schapbach,18 - 20 Jahre,46,21,25
False,8237075,Bad Rippoldsau-Schapbach,20 - 25 Jahre,124,74,50
False,8237075,Bad Rippoldsau-Schapbach,25 - 30 Jahre,118,58,60
False,8237075,Bad Rippoldsau-Schapbach,30 - 35 Jahre,125,68,57
False,8237075,Bad Rippoldsau-Schapbach,35 - 40 Jahre,171,94,77
False,8237075,Bad Rippoldsau-Schapbach,40 - 45 Jahre,209,104,105
False,8237075,Bad Rippoldsau-Schapbach,45 - 50 Jahre,178,112,66
False,8237075,Bad Rippoldsau-Schapbach,50 - 55 Jahre,122,62,60
False,8237075,Bad Rippoldsau-Schapbach,55 - 60 Jahre,128,65,63
False,8237075,Bad Rippoldsau-Schapbach,60 - 65 Jahre,119,50,69
False,8237075,Bad Rippoldsau-Schapbach,65 - 75 Jahre,295,149,146
False,8237075,Bad Rippoldsau-Schapbach,75 und mehr Jahre,231,82,149
False,8237075,Bad Rippoldsau-Schapbach,Insgesamt,2322,1171,1151
False,83,Regierungsbezirk Freiburg,unter 3 Jahre,58617,30198,28419
False,83,Regierungsbezirk Freiburg,3 -  6 Jahre,63935,32575,31360
False,83,Regierungsbezirk Freiburg,6 - 10 Jahre,95138,49113,46025
False,83,Regierungsbezirk Freiburg,10 - 15 Jahre,124161,63838,60323
False,83,Regierungsbezirk Freiburg,15 - 18 Jahre,80275,40885,39390
False,83,Regierungsbezirk Freiburg,18 - 20 Jahre,52482,26538,25944
False,83,Regierungsbezirk Freiburg,20 - 25 Jahre,134483,66818,67665
False,83,Regierungsbezirk Freiburg,25 - 30 Jahre,126958,63382,63576
False,83,Regierungsbezirk Freiburg,30 - 35 Jahre,131213,65298,65915
False,83,Regierungsbezirk Freiburg,35 - 40 Jahre,179378,90192,89186
False,83,Regierungsbezirk Freiburg,40 - 45 Jahre,192786,97880,94906
False,83,Regierungsbezirk Freiburg,45 - 50 Jahre,168726,85484,83242
False,83,Regierungsbezirk Freiburg,50 - 55 Jahre,144339,72044,72295
False,83,Regierungsbezirk Freiburg,55 - 60 Jahre,120886,60282,60604
False,83,Regierungsbezirk Freiburg,60 - 65 Jahre,112383,54814,57569
False,83,Regierungsbezirk Freiburg,65 - 75 Jahre,228815,107955,120860
False,83,Regierungsbezirk Freiburg,75 und mehr Jahre,176152,61157,114995
False,83,Regierungsbezirk Freiburg,Insgesamt,2190727,1068453,1122274
False,8311,Stadtkreis Freiburg im Breisgau,unter 3 Jahre,5820,2984,2836
False,8311,Stadtkreis Freiburg im Breisgau,3 -  6 Jahre,5455,2803,2652
False,8311,Stadtkreis Freiburg im Breisgau,6 - 10 Jahre,7583,3968,3615
False,8311,Stadtkreis Freiburg im Breisgau,10 - 15 Jahre,8810,4449,4361
False,8311,Stadtkreis Freiburg im Breisgau,15 - 18 Jahre,5671,2880,2791
False,8311,Stadtkreis Freiburg im Breisgau,18 - 20 Jahre,4259,2012,2247
False,8311,Stadtkreis Freiburg im Breisgau,20 - 25 Jahre,19609,8432,11177
False,8311,Stadtkreis Freiburg im Breisgau,25 - 30 Jahre,19603,9460,10143
False,8311,Stadtkreis Freiburg im Breisgau,30 - 35 Jahre,16315,8184,8131
False,8311,Stadtkreis Freiburg im Breisgau,35 - 40 Jahre,19093,9575,9518
False,8311,Stadtkreis Freiburg im Breisgau,40 - 45 Jahre,20341,10349,9992
False,8311,Stadtkreis Freiburg im Breisgau,45 - 50 Jahre,16452,8472,7980
False,8311,Stadtkreis Freiburg im Breisgau,50 - 55 Jahre,12924,6465,6459
False,8311,Stadtkreis Freiburg im Breisgau,55 - 60 Jahre,10330,5038,5292
False,8311,Stadtkreis Freiburg im Breisgau,60 - 65 Jahre,9811,4610,5201
False,8311,Stadtkreis Freiburg im Breisgau,65 - 75 Jahre,17556,7750,9806
False,8311,Stadtkreis Freiburg im Breisgau,75 und mehr Jahre,16334,5227,11107
False,8311,Stadtkreis Freiburg im Breisgau,Insgesamt,215966,102658,113308
False,8311000,"Freiburg im Breisgau, Stadt",unter 3 Jahre,5820,2984,2836
False,8311000,"Freiburg im Breisgau, Stadt",3 -  6 Jahre,5455,2803,2652
False,8311000,"Freiburg im Breisgau, Stadt",6 - 10 Jahre,7583,3968,3615
False,8311000,"Freiburg im Breisgau, Stadt",10 - 15 Jahre,8810,4449,4361
False,8311000,"Freiburg im Breisgau, Stadt",15 - 18 Jahre,5671,2880,2791
False,8311000,"Freiburg im Breisgau, Stadt",18 - 20 Jahre,4259,2012,2247
False,8311000,"Freiburg im Breisgau, Stadt",20 - 25 Jahre,19609,8432,11177
False,8311000,"Freiburg im Breisgau, Stadt",25 - 30 Jahre,19603,9460,10143
False,8311000,"Freiburg im Breisgau, Stadt",30 - 35 Jahre,16315,8184,8131
False,8311000,"Freiburg im Breisgau, Stadt",35 - 40 Jahre,19093,9575,9518
False,8311000,"Freiburg im Breisgau, Stadt",40 - 45 Jahre,20341,10349,9992
False,8311000,"Freiburg im Breisgau, Stadt",45 - 50 Jahre,16452,8472,7980
False,8311000,"Freiburg im Breisgau, Stadt",50 - 55 Jahre,12924,6465,6459
False,8311000,"Freiburg im Breisgau, Stadt",55 - 60 Jahre,10330,5038,5292
False,8311000,"Freiburg im Breisgau, Stadt",60 - 65 Jahre,9811,4610,5201
False,8311000,"Freiburg im Breisgau, Stadt",65 - 75 Jahre,17556,7750,9806
False,8311000,"Freiburg im Breisgau, Stadt",75 und mehr Jahre,16334,5227,11107
False,8311000,"Freiburg im Breisgau, Stadt",Insgesamt,215966,102658,113308
False,8315,Landkreis Breisgau-Hochschwarzwald,unter 3 Jahre,6865,3571,3294
False,8315,Landkreis Breisgau-Hochschwarzwald,3 -  6 Jahre,7510,3881,3629
False,8315,Landkreis Breisgau-Hochschwarzwald,6 - 10 Jahre,11141,5898,5243
False,8315,Landkreis Breisgau-Hochschwarzwald,10 - 15 Jahre,14827,7707,7120
False,8315,Landkreis Breisgau-Hochschwarzwald,15 - 18 Jahre,9300,4728,4572
False,8315,Landkreis Breisgau-Hochschwarzwald,18 - 20 Jahre,6049,3069,2980
False,8315,Landkreis Breisgau-Hochschwarzwald,20 - 25 Jahre,13982,6990,6992
False,8315,Landkreis Breisgau-Hochschwarzwald,25 - 30 Jahre,13102,6516,6586
False,8315,Landkreis Breisgau-Hochschwarzwald,30 - 35 Jahre,14275,6940,7335
False,8315,Landkreis Breisgau-Hochschwarzwald,35 - 40 Jahre,20659,10223,10436
False,8315,Landkreis Breisgau-Hochschwarzwald,40 - 45 Jahre,21886,10926,10960
False,8315,Landkreis Breisgau-Hochschwarzwald,45 - 50 Jahre,19332,9713,9619
False,8315,Landkreis Breisgau-Hochschwarzwald,50 - 55 Jahre,17018,8324,8694
False,8315,Landkreis Breisgau-Hochschwarzwald,55 - 60 Jahre,14575,7191,7384
False,8315,Landkreis Breisgau-Hochschwarzwald,60 - 65 Jahre,13628,6627,7001
False,8315,Landkreis Breisgau-Hochschwarzwald,65 - 75 Jahre,25713,12246,13467
False,8315,Landkreis Breisgau-Hochschwarzwald,75 und mehr Jahre,19673,7231,12442
False,8315,Landkreis Breisgau-Hochschwarzwald,Insgesamt,249535,121781,127754
False,8315003,Au,unter 3 Jahre,40,23,17
False,8315003,Au,3 -  6 Jahre,35,18,17
False,8315003,Au,6 - 10 Jahre,72,43,29
False,8315003,Au,10 - 15 Jahre,81,44,37
False,8315003,Au,15 - 18 Jahre,42,27,15
False,8315003,Au,18 - 20 Jahre,29,16,13
False,8315003,Au,20 - 25 Jahre,90,40,50
False,8315003,Au,25 - 30 Jahre,73,44,29
False,8315003,Au,30 - 35 Jahre,71,37,34
False,8315003,Au,35 - 40 Jahre,125,61,64
False,8315003,Au,40 - 45 Jahre,124,62,62
False,8315003,Au,45 - 50 Jahre,109,51,58
False,8315003,Au,50 - 55 Jahre,95,45,50
False,8315003,Au,55 - 60 Jahre,92,45,47
False,8315003,Au,60 - 65 Jahre,85,43,42
False,8315003,Au,65 - 75 Jahre,117,57,60
False,8315003,Au,75 und mehr Jahre,84,34,50
False,8315003,Au,Insgesamt,1364,690,674
False,8315004,Auggen,unter 3 Jahre,83,43,40
False,8315004,Auggen,3 -  6 Jahre,78,43,35
False,8315004,Auggen,6 - 10 Jahre,116,60,56
False,8315004,Auggen,10 - 15 Jahre,168,89,79
False,8315004,Auggen,15 - 18 Jahre,75,35,40
False,8315004,Auggen,18 - 20 Jahre,59,29,30
False,8315004,Auggen,20 - 25 Jahre,150,78,72
False,8315004,Auggen,25 - 30 Jahre,128,66,62
False,8315004,Auggen,30 - 35 Jahre,128,59,69
False,8315004,Auggen,35 - 40 Jahre,224,106,118
False,8315004,Auggen,40 - 45 Jahre,192,103,89
False,8315004,Auggen,45 - 50 Jahre,168,91,77
False,8315004,Auggen,50 - 55 Jahre,164,67,97
False,8315004,Auggen,55 - 60 Jahre,161,89,72
False,8315004,Auggen,60 - 65 Jahre,140,68,72
False,8315004,Auggen,65 - 75 Jahre,231,119,112
False,8315004,Auggen,75 und mehr Jahre,192,71,121
False,8315004,Auggen,Insgesamt,2457,1216,1241
False,8315006,"Bad Krozingen, Stadt",unter 3 Jahre,391,205,186
False,8315006,"Bad Krozingen, Stadt",3 -  6 Jahre,416,220,196
False,8315006,"Bad Krozingen, Stadt",6 - 10 Jahre,674,352,322
False,8315006,"Bad Krozingen, Stadt",10 - 15 Jahre,839,406,433
False,8315006,"Bad Krozingen, Stadt",15 - 18 Jahre,553,287,266
False,8315006,"Bad Krozingen, Stadt",18 - 20 Jahre,356,186,170
False,8315006,"Bad Krozingen, Stadt",20 - 25 Jahre,808,397,411
False,8315006,"Bad Krozingen, Stadt",25 - 30 Jahre,807,392,415
False,8315006,"Bad Krozingen, Stadt",30 - 35 Jahre,847,388,459
False,8315006,"Bad Krozingen, Stadt",35 - 40 Jahre,1114,541,573
False,8315006,"Bad Krozingen, Stadt",40 - 45 Jahre,1252,630,622
False,8315006,"Bad Krozingen, Stadt",45 - 50 Jahre,1154,569,585
False,8315006,"Bad Krozingen, Stadt",50 - 55 Jahre,1105,507,598
False,8315006,"Bad Krozingen, Stadt",55 - 60 Jahre,979,464,515
False,8315006,"Bad Krozingen, Stadt",60 - 65 Jahre,952,449,503
False,8315006,"Bad Krozingen, Stadt",65 - 75 Jahre,1800,798,1002
False,8315006,"Bad Krozingen, Stadt",75 und mehr Jahre,2025,714,1311
False,8315006,"Bad Krozingen, Stadt",Insgesamt,16072,7505,8567
False,8315007,Badenweiler,unter 3 Jahre,75,36,39
False,8315007,Badenweiler,3 -  6 Jahre,85,43,42
False,8315007,Badenweiler,6 - 10 Jahre,130,65,65
False,8315007,Badenweiler,10 - 15 Jahre,191,100,91
False,8315007,Badenweiler,15 - 18 Jahre,104,46,58
False,8315007,Badenweiler,18 - 20 Jahre,101,49,52
False,8315007,Badenweiler,20 - 25 Jahre,205,99,106
False,8315007,Badenweiler,25 - 30 Jahre,167,87,80
False,8315007,Badenweiler,30 - 35 Jahre,182,86,96
False,8315007,Badenweiler,35 - 40 Jahre,260,125,135
False,8315007,Badenweiler,40 - 45 Jahre,269,129,140
False,8315007,Badenweiler,45 - 50 Jahre,277,138,139
False,8315007,Badenweiler,50 - 55 Jahre,277,147,130
False,8315007,Badenweiler,55 - 60 Jahre,246,106,140
False,8315007,Badenweiler,60 - 65 Jahre,279,127,152
False,8315007,Badenweiler,65 - 75 Jahre,559,261,298
False,8315007,Badenweiler,75 und mehr Jahre,519,191,328
False,8315007,Badenweiler,Insgesamt,3926,1835,2091
False,8315008,Ballrechten-Dottingen,unter 3 Jahre,55,30,25
False,8315008,Ballrechten-Dottingen,3 -  6 Jahre,64,30,34
False,8315008,Ballrechten-Dottingen,6 - 10 Jahre,123,68,55
False,8315008,Ballrechten-Dottingen,10 - 15 Jahre,152,80,72
False,8315008,Ballrechten-Dottingen,15 - 18 Jahre,100,46,54
False,8315008,Ballrechten-Dottingen,18 - 20 Jahre,69,40,29
False,8315008,Ballrechten-Dottingen,20 - 25 Jahre,125,64,61
False,8315008,Ballrechten-Dottingen,25 - 30 Jahre,118,61,57
False,8315008,Ballrechten-Dottingen,30 - 35 Jahre,134,63,71
False,8315008,Ballrechten-Dottingen,35 - 40 Jahre,217,101,116
False,8315008,Ballrechten-Dottingen,40 - 45 Jahre,213,106,107
False,8315008,Ballrechten-Dottingen,45 - 50 Jahre,179,88,91
False,8315008,Ballrechten-Dottingen,50 - 55 Jahre,147,74,73
False,8315008,Ballrechten-Dottingen,55 - 60 Jahre,140,69,71
False,8315008,Ballrechten-Dottingen,60 - 65 Jahre,109,54,55
False,8315008,Ballrechten-Dottingen,65 - 75 Jahre,158,83,75
False,8315008,Ballrechten-Dottingen,75 und mehr Jahre,129,51,78
False,8315008,Ballrechten-Dottingen,Insgesamt,2232,1108,1124
False,8315013,Bötzingen,unter 3 Jahre,197,98,99
False,8315013,Bötzingen,3 -  6 Jahre,189,99,90
False,8315013,Bötzingen,6 - 10 Jahre,245,120,125
False,8315013,Bötzingen,10 - 15 Jahre,341,187,154
False,8315013,Bötzingen,15 - 18 Jahre,220,118,102
False,8315013,Bötzingen,18 - 20 Jahre,134,71,63
False,8315013,Bötzingen,20 - 25 Jahre,308,147,161
False,8315013,Bötzingen,25 - 30 Jahre,293,162,131
False,8315013,Bötzingen,30 - 35 Jahre,347,170,177
False,8315013,Bötzingen,35 - 40 Jahre,466,223,243
False,8315013,Bötzingen,40 - 45 Jahre,491,249,242
False,8315013,Bötzingen,45 - 50 Jahre,361,200,161
False,8315013,Bötzingen,50 - 55 Jahre,316,142,174
False,8315013,Bötzingen,55 - 60 Jahre,276,133,143
False,8315013,Bötzingen,60 - 65 Jahre,277,151,126
False,8315013,Bötzingen,65 - 75 Jahre,509,254,255
False,8315013,Bötzingen,75 und mehr Jahre,279,107,172
False,8315013,Bötzingen,Insgesamt,5249,2631,2618
False,8315014,Bollschweil,unter 3 Jahre,70,34,36
False,8315014,Bollschweil,3 -  6 Jahre,59,29,30
False,8315014,Bollschweil,6 - 10 Jahre,92,46,46
False,8315014,Bollschweil,10 - 15 Jahre,145,86,59
False,8315014,Bollschweil,15 - 18 Jahre,92,45,47
False,8315014,Bollschweil,18 - 20 Jahre,56,24,32
False,8315014,Bollschweil,20 - 25 Jahre,103,50,53
False,8315014,Bollschweil,25 - 30 Jahre,92,34,58
False,8315014,Bollschweil,30 - 35 Jahre,115,59,56
False,8315014,Bollschweil,35 - 40 Jahre,193,91,102
False,8315014,Bollschweil,40 - 45 Jahre,237,129,108
False,8315014,Bollschweil,45 - 50 Jahre,179,94,85
False,8315014,Bollschweil,50 - 55 Jahre,166,78,88
False,8315014,Bollschweil,55 - 60 Jahre,154,67,87
False,8315014,Bollschweil,60 - 65 Jahre,128,67,61
False,8315014,Bollschweil,65 - 75 Jahre,242,121,121
False,8315014,Bollschweil,75 und mehr Jahre,153,66,87
False,8315014,Bollschweil,Insgesamt,2276,1120,1156
False,8315015,"Breisach am Rhein, Stadt",unter 3 Jahre,384,194,190
False,8315015,"Breisach am Rhein, Stadt",3 -  6 Jahre,461,252,209
False,8315015,"Breisach am Rhein, Stadt",6 - 10 Jahre,710,377,333
False,8315015,"Breisach am Rhein, Stadt",10 - 15 Jahre,919,471,448
False,8315015,"Breisach am Rhein, Stadt",15 - 18 Jahre,558,315,243
False,8315015,"Breisach am Rhein, Stadt",18 - 20 Jahre,382,190,192
False,8315015,"Breisach am Rhein, Stadt",20 - 25 Jahre,800,433,367
False,8315015,"Breisach am Rhein, Stadt",25 - 30 Jahre,741,385,356
False,8315015,"Breisach am Rhein, Stadt",30 - 35 Jahre,814,396,418
False,8315015,"Breisach am Rhein, Stadt",35 - 40 Jahre,1216,627,589
False,8315015,"Breisach am Rhein, Stadt",40 - 45 Jahre,1228,613,615
False,8315015,"Breisach am Rhein, Stadt",45 - 50 Jahre,1204,572,632
False,8315015,"Breisach am Rhein, Stadt",50 - 55 Jahre,1011,524,487
False,8315015,"Breisach am Rhein, Stadt",55 - 60 Jahre,880,460,420
False,8315015,"Breisach am Rhein, Stadt",60 - 65 Jahre,684,341,343
False,8315015,"Breisach am Rhein, Stadt",65 - 75 Jahre,1357,645,712
False,8315015,"Breisach am Rhein, Stadt",75 und mehr Jahre,915,321,594
False,8315015,"Breisach am Rhein, Stadt",Insgesamt,14264,7116,7148
False,8315016,Breitnau,unter 3 Jahre,79,38,41
False,8315016,Breitnau,3 -  6 Jahre,68,29,39
False,8315016,Breitnau,6 - 10 Jahre,77,44,33
False,8315016,Breitnau,10 - 15 Jahre,84,47,37
False,8315016,Breitnau,15 - 18 Jahre,54,36,18
False,8315016,Breitnau,18 - 20 Jahre,75,34,41
False,8315016,Breitnau,20 - 25 Jahre,137,64,73
False,8315016,Breitnau,25 - 30 Jahre,129,67,62
False,8315016,Breitnau,30 - 35 Jahre,201,95,106
False,8315016,Breitnau,35 - 40 Jahre,200,111,89
False,8315016,Breitnau,40 - 45 Jahre,142,80,62
False,8315016,Breitnau,45 - 50 Jahre,115,68,47
False,8315016,Breitnau,50 - 55 Jahre,112,56,56
False,8315016,Breitnau,55 - 60 Jahre,92,48,44
False,8315016,Breitnau,60 - 65 Jahre,86,48,38
False,8315016,Breitnau,65 - 75 Jahre,167,77,90
False,8315016,Breitnau,75 und mehr Jahre,141,65,76
False,8315016,Breitnau,Insgesamt,1959,1007,952
False,8315020,Buchenbach,unter 3 Jahre,106,61,45
False,8315020,Buchenbach,3 -  6 Jahre,119,62,57
False,8315020,Buchenbach,6 - 10 Jahre,163,87,76
False,8315020,Buchenbach,10 - 15 Jahre,236,125,111
False,8315020,Buchenbach,15 - 18 Jahre,144,73,71
False,8315020,Buchenbach,18 - 20 Jahre,67,31,36
False,8315020,Buchenbach,20 - 25 Jahre,178,85,93
False,8315020,Buchenbach,25 - 30 Jahre,176,92,84
False,8315020,Buchenbach,30 - 35 Jahre,191,94,97
False,8315020,Buchenbach,35 - 40 Jahre,282,145,137
False,8315020,Buchenbach,40 - 45 Jahre,317,148,169
False,8315020,Buchenbach,45 - 50 Jahre,246,126,120
False,8315020,Buchenbach,50 - 55 Jahre,211,92,119
False,8315020,Buchenbach,55 - 60 Jahre,182,95,87
False,8315020,Buchenbach,60 - 65 Jahre,176,82,94
False,8315020,Buchenbach,65 - 75 Jahre,305,141,164
False,8315020,Buchenbach,75 und mehr Jahre,183,56,127
False,8315020,Buchenbach,Insgesamt,3282,1595,1687
False,8315022,Buggingen,unter 3 Jahre,109,60,49
False,8315022,Buggingen,3 -  6 Jahre,114,48,66
False,8315022,Buggingen,6 - 10 Jahre,183,110,73
False,8315022,Buggingen,10 - 15 Jahre,236,122,114
False,8315022,Buggingen,15 - 18 Jahre,159,78,81
False,8315022,Buggingen,18 - 20 Jahre,92,62,30
False,8315022,Buggingen,20 - 25 Jahre,225,109,116
False,8315022,Buggingen,25 - 30 Jahre,205,110,95
False,8315022,Buggingen,30 - 35 Jahre,209,103,106
False,8315022,Buggingen,35 - 40 Jahre,317,171,146
False,8315022,Buggingen,40 - 45 Jahre,346,177,169
False,8315022,Buggingen,45 - 50 Jahre,295,147,148
False,8315022,Buggingen,50 - 55 Jahre,272,150,122
False,8315022,Buggingen,55 - 60 Jahre,213,102,111
False,8315022,Buggingen,60 - 65 Jahre,201,99,102
False,8315022,Buggingen,65 - 75 Jahre,373,182,191
False,8315022,Buggingen,75 und mehr Jahre,276,113,163
False,8315022,Buggingen,Insgesamt,3825,1943,1882
False,8315028,Ebringen,unter 3 Jahre,78,45,33
False,8315028,Ebringen,3 -  6 Jahre,78,47,31
False,8315028,Ebringen,6 - 10 Jahre,122,60,62
False,8315028,Ebringen,10 - 15 Jahre,165,70,95
False,8315028,Ebringen,15 - 18 Jahre,94,50,44
False,8315028,Ebringen,18 - 20 Jahre,80,45,35
False,8315028,Ebringen,20 - 25 Jahre,173,84,89
False,8315028,Ebringen,25 - 30 Jahre,140,65,75
False,8315028,Ebringen,30 - 35 Jahre,156,74,82
False,8315028,Ebringen,35 - 40 Jahre,226,109,117
False,8315028,Ebringen,40 - 45 Jahre,284,146,138
False,8315028,Ebringen,45 - 50 Jahre,213,113,100
False,8315028,Ebringen,50 - 55 Jahre,197,97,100
False,8315028,Ebringen,55 - 60 Jahre,169,85,84
False,8315028,Ebringen,60 - 65 Jahre,135,67,68
False,8315028,Ebringen,65 - 75 Jahre,239,111,128
False,8315028,Ebringen,75 und mehr Jahre,171,66,105
False,8315028,Ebringen,Insgesamt,2720,1334,1386
False,8315030,Eichstetten am Kaiserstuhl,unter 3 Jahre,119,60,59
False,8315030,Eichstetten am Kaiserstuhl,3 -  6 Jahre,131,71,60
False,8315030,Eichstetten am Kaiserstuhl,6 - 10 Jahre,163,79,84
False,8315030,Eichstetten am Kaiserstuhl,10 - 15 Jahre,220,114,106
False,8315030,Eichstetten am Kaiserstuhl,15 - 18 Jahre,159,70,89
False,8315030,Eichstetten am Kaiserstuhl,18 - 20 Jahre,88,49,39
False,8315030,Eichstetten am Kaiserstuhl,20 - 25 Jahre,201,100,101
False,8315030,Eichstetten am Kaiserstuhl,25 - 30 Jahre,171,90,81
False,8315030,Eichstetten am Kaiserstuhl,30 - 35 Jahre,167,76,91
False,8315030,Eichstetten am Kaiserstuhl,35 - 40 Jahre,292,149,143
False,8315030,Eichstetten am Kaiserstuhl,40 - 45 Jahre,312,156,156
False,8315030,Eichstetten am Kaiserstuhl,45 - 50 Jahre,248,132,116
False,8315030,Eichstetten am Kaiserstuhl,50 - 55 Jahre,228,110,118
False,8315030,Eichstetten am Kaiserstuhl,55 - 60 Jahre,180,96,84
False,8315030,Eichstetten am Kaiserstuhl,60 - 65 Jahre,125,61,64
False,8315030,Eichstetten am Kaiserstuhl,65 - 75 Jahre,248,116,132
False,8315030,Eichstetten am Kaiserstuhl,75 und mehr Jahre,204,64,140
False,8315030,Eichstetten am Kaiserstuhl,Insgesamt,3256,1593,1663
False,8315031,Eisenbach (Hochschwarzwald),unter 3 Jahre,54,27,27
False,8315031,Eisenbach (Hochschwarzwald),3 -  6 Jahre,86,46,40
False,8315031,Eisenbach (Hochschwarzwald),6 - 10 Jahre,112,54,58
False,8315031,Eisenbach (Hochschwarzwald),10 - 15 Jahre,154,85,69
False,8315031,Eisenbach (Hochschwarzwald),15 - 18 Jahre,82,42,40
False,8315031,Eisenbach (Hochschwarzwald),18 - 20 Jahre,50,30,20
False,8315031,Eisenbach (Hochschwarzwald),20 - 25 Jahre,103,70,33
False,8315031,Eisenbach (Hochschwarzwald),25 - 30 Jahre,115,55,60
False,8315031,Eisenbach (Hochschwarzwald),30 - 35 Jahre,112,58,54
False,8315031,Eisenbach (Hochschwarzwald),35 - 40 Jahre,176,83,93
False,8315031,Eisenbach (Hochschwarzwald),40 - 45 Jahre,199,107,92
False,8315031,Eisenbach (Hochschwarzwald),45 - 50 Jahre,163,91,72
False,8315031,Eisenbach (Hochschwarzwald),50 - 55 Jahre,132,64,68
False,8315031,Eisenbach (Hochschwarzwald),55 - 60 Jahre,128,65,63
False,8315031,Eisenbach (Hochschwarzwald),60 - 65 Jahre,126,68,58
False,8315031,Eisenbach (Hochschwarzwald),65 - 75 Jahre,267,131,136
False,8315031,Eisenbach (Hochschwarzwald),75 und mehr Jahre,192,80,112
False,8315031,Eisenbach (Hochschwarzwald),Insgesamt,2251,1156,1095
False,8315033,Eschbach,unter 3 Jahre,73,37,36
False,8315033,Eschbach,3 -  6 Jahre,84,40,44
False,8315033,Eschbach,6 - 10 Jahre,117,55,62
False,8315033,Eschbach,10 - 15 Jahre,179,91,88
False,8315033,Eschbach,15 - 18 Jahre,100,57,43
False,8315033,Eschbach,18 - 20 Jahre,44,17,27
False,8315033,Eschbach,20 - 25 Jahre,123,64,59
False,8315033,Eschbach,25 - 30 Jahre,165,83,82
False,8315033,Eschbach,30 - 35 Jahre,151,72,79
False,8315033,Eschbach,35 - 40 Jahre,257,156,101
False,8315033,Eschbach,40 - 45 Jahre,234,128,106
False,8315033,Eschbach,45 - 50 Jahre,198,91,107
False,8315033,Eschbach,50 - 55 Jahre,162,92,70
False,8315033,Eschbach,55 - 60 Jahre,109,53,56
False,8315033,Eschbach,60 - 65 Jahre,92,43,49
False,8315033,Eschbach,65 - 75 Jahre,128,63,65
False,8315033,Eschbach,75 und mehr Jahre,79,37,42
False,8315033,Eschbach,Insgesamt,2295,1179,1116
False,8315037,Feldberg (Schwarzwald),unter 3 Jahre,50,30,20
False,8315037,Feldberg (Schwarzwald),3 -  6 Jahre,40,19,21
False,8315037,Feldberg (Schwarzwald),6 - 10 Jahre,82,44,38
False,8315037,Feldberg (Schwarzwald),10 - 15 Jahre,86,45,41
False,8315037,Feldberg (Schwarzwald),15 - 18 Jahre,54,28,26
False,8315037,Feldberg (Schwarzwald),18 - 20 Jahre,42,23,19
False,8315037,Feldberg (Schwarzwald),20 - 25 Jahre,108,46,62
False,8315037,Feldberg (Schwarzwald),25 - 30 Jahre,96,45,51
False,8315037,Feldberg (Schwarzwald),30 - 35 Jahre,113,50,63
False,8315037,Feldberg (Schwarzwald),35 - 40 Jahre,173,98,75
False,8315037,Feldberg (Schwarzwald),40 - 45 Jahre,177,104,73
False,8315037,Feldberg (Schwarzwald),45 - 50 Jahre,148,68,80
False,8315037,Feldberg (Schwarzwald),50 - 55 Jahre,136,64,72
False,8315037,Feldberg (Schwarzwald),55 - 60 Jahre,95,47,48
False,8315037,Feldberg (Schwarzwald),60 - 65 Jahre,110,57,53
False,8315037,Feldberg (Schwarzwald),65 - 75 Jahre,204,98,106
False,8315037,Feldberg (Schwarzwald),75 und mehr Jahre,177,77,100
False,8315037,Feldberg (Schwarzwald),Insgesamt,1891,943,948
False,8315039,Friedenweiler,unter 3 Jahre,78,37,41
False,8315039,Friedenweiler,3 -  6 Jahre,72,40,32
False,8315039,Friedenweiler,6 - 10 Jahre,87,46,41
False,8315039,Friedenweiler,10 - 15 Jahre,139,71,68
False,8315039,Friedenweiler,15 - 18 Jahre,96,47,49
False,8315039,Friedenweiler,18 - 20 Jahre,48,30,18
False,8315039,Friedenweiler,20 - 25 Jahre,123,64,59
False,8315039,Friedenweiler,25 - 30 Jahre,88,54,34
False,8315039,Friedenweiler,30 - 35 Jahre,128,67,61
False,8315039,Friedenweiler,35 - 40 Jahre,151,71,80
False,8315039,Friedenweiler,40 - 45 Jahre,180,87,93
False,8315039,Friedenweiler,45 - 50 Jahre,143,71,72
False,8315039,Friedenweiler,50 - 55 Jahre,142,67,75
False,8315039,Friedenweiler,55 - 60 Jahre,113,53,60
False,8315039,Friedenweiler,60 - 65 Jahre,96,38,58
False,8315039,Friedenweiler,65 - 75 Jahre,187,101,86
False,8315039,Friedenweiler,75 und mehr Jahre,213,66,147
False,8315039,Friedenweiler,Insgesamt,2084,1010,1074
False,8315041,Glottertal,unter 3 Jahre,128,65,63
False,8315041,Glottertal,3 -  6 Jahre,98,45,53
False,8315041,Glottertal,6 - 10 Jahre,144,71,73
False,8315041,Glottertal,10 - 15 Jahre,173,92,81
False,8315041,Glottertal,15 - 18 Jahre,113,47,66
False,8315041,Glottertal,18 - 20 Jahre,75,34,41
False,8315041,Glottertal,20 - 25 Jahre,190,87,103
False,8315041,Glottertal,25 - 30 Jahre,137,61,76
False,8315041,Glottertal,30 - 35 Jahre,192,90,102
False,8315041,Glottertal,35 - 40 Jahre,278,136,142
False,8315041,Glottertal,40 - 45 Jahre,283,145,138
False,8315041,Glottertal,45 - 50 Jahre,229,122,107
False,8315041,Glottertal,50 - 55 Jahre,188,99,89
False,8315041,Glottertal,55 - 60 Jahre,182,92,90
False,8315041,Glottertal,60 - 65 Jahre,133,74,59
False,8315041,Glottertal,65 - 75 Jahre,285,139,146
False,8315041,Glottertal,75 und mehr Jahre,244,89,155
False,8315041,Glottertal,Insgesamt,3072,1488,1584
False,8315043,Gottenheim,unter 3 Jahre,75,39,36
False,8315043,Gottenheim,3 -  6 Jahre,65,35,30
False,8315043,Gottenheim,6 - 10 Jahre,93,48,45
False,8315043,Gottenheim,10 - 15 Jahre,160,84,76
False,8315043,Gottenheim,15 - 18 Jahre,116,56,60
False,8315043,Gottenheim,18 - 20 Jahre,52,21,31
False,8315043,Gottenheim,20 - 25 Jahre,133,76,57
False,8315043,Gottenheim,25 - 30 Jahre,141,69,72
False,8315043,Gottenheim,30 - 35 Jahre,155,82,73
False,8315043,Gottenheim,35 - 40 Jahre,218,114,104
False,8315043,Gottenheim,40 - 45 Jahre,217,97,120
False,8315043,Gottenheim,45 - 50 Jahre,206,106,100
False,8315043,Gottenheim,50 - 55 Jahre,183,86,97
False,8315043,Gottenheim,55 - 60 Jahre,132,67,65
False,8315043,Gottenheim,60 - 65 Jahre,114,61,53
False,8315043,Gottenheim,65 - 75 Jahre,238,117,121
False,8315043,Gottenheim,75 und mehr Jahre,180,63,117
False,8315043,Gottenheim,Insgesamt,2478,1221,1257
False,8315047,Gundelfingen,unter 3 Jahre,279,149,130
False,8315047,Gundelfingen,3 -  6 Jahre,278,133,145
False,8315047,Gundelfingen,6 - 10 Jahre,443,231,212
False,8315047,Gundelfingen,10 - 15 Jahre,551,305,246
False,8315047,Gundelfingen,15 - 18 Jahre,324,146,178
False,8315047,Gundelfingen,18 - 20 Jahre,231,112,119
False,8315047,Gundelfingen,20 - 25 Jahre,598,273,325
False,8315047,Gundelfingen,25 - 30 Jahre,694,325,369
False,8315047,Gundelfingen,30 - 35 Jahre,685,351,334
False,8315047,Gundelfingen,35 - 40 Jahre,947,477,470
False,8315047,Gundelfingen,40 - 45 Jahre,1110,558,552
False,8315047,Gundelfingen,45 - 50 Jahre,916,461,455
False,8315047,Gundelfingen,50 - 55 Jahre,818,372,446
False,8315047,Gundelfingen,55 - 60 Jahre,755,340,415
False,8315047,Gundelfingen,60 - 65 Jahre,774,378,396
False,8315047,Gundelfingen,65 - 75 Jahre,1276,594,682
False,8315047,Gundelfingen,75 und mehr Jahre,899,335,564
False,8315047,Gundelfingen,Insgesamt,11578,5540,6038
False,8315048,Hartheim,unter 3 Jahre,162,97,65
False,8315048,Hartheim,3 -  6 Jahre,185,91,94
False,8315048,Hartheim,6 - 10 Jahre,251,131,120
False,8315048,Hartheim,10 - 15 Jahre,301,163,138
False,8315048,Hartheim,15 - 18 Jahre,184,105,79
False,8315048,Hartheim,18 - 20 Jahre,101,50,51
False,8315048,Hartheim,20 - 25 Jahre,274,131,143
False,8315048,Hartheim,25 - 30 Jahre,295,135,160
False,8315048,Hartheim,30 - 35 Jahre,313,148,165
False,8315048,Hartheim,35 - 40 Jahre,380,195,185
False,8315048,Hartheim,40 - 45 Jahre,420,209,211
False,8315048,Hartheim,45 - 50 Jahre,363,192,171
False,8315048,Hartheim,50 - 55 Jahre,356,185,171
False,8315048,Hartheim,55 - 60 Jahre,259,140,119
False,8315048,Hartheim,60 - 65 Jahre,195,100,95
False,8315048,Hartheim,65 - 75 Jahre,315,151,164
False,8315048,Hartheim,75 und mehr Jahre,199,86,113
False,8315048,Hartheim,Insgesamt,4553,2309,2244
False,8315050,"Heitersheim, Stadt",unter 3 Jahre,141,75,66
False,8315050,"Heitersheim, Stadt",3 -  6 Jahre,185,99,86
False,8315050,"Heitersheim, Stadt",6 - 10 Jahre,281,144,137
False,8315050,"Heitersheim, Stadt",10 - 15 Jahre,379,189,190
False,8315050,"Heitersheim, Stadt",15 - 18 Jahre,221,123,98
False,8315050,"Heitersheim, Stadt",18 - 20 Jahre,138,67,71
False,8315050,"Heitersheim, Stadt",20 - 25 Jahre,340,164,176
False,8315050,"Heitersheim, Stadt",25 - 30 Jahre,271,147,124
False,8315050,"Heitersheim, Stadt",30 - 35 Jahre,348,166,182
False,8315050,"Heitersheim, Stadt",35 - 40 Jahre,509,262,247
False,8315050,"Heitersheim, Stadt",40 - 45 Jahre,521,246,275
False,8315050,"Heitersheim, Stadt",45 - 50 Jahre,501,244,257
False,8315050,"Heitersheim, Stadt",50 - 55 Jahre,390,196,194
False,8315050,"Heitersheim, Stadt",55 - 60 Jahre,336,159,177
False,8315050,"Heitersheim, Stadt",60 - 65 Jahre,303,150,153
False,8315050,"Heitersheim, Stadt",65 - 75 Jahre,547,273,274
False,8315050,"Heitersheim, Stadt",75 und mehr Jahre,437,131,306
False,8315050,"Heitersheim, Stadt",Insgesamt,5848,2835,3013
False,8315051,Heuweiler,unter 3 Jahre,22,11,11
False,8315051,Heuweiler,3 -  6 Jahre,26,11,15
False,8315051,Heuweiler,6 - 10 Jahre,31,20,11
False,8315051,Heuweiler,10 - 15 Jahre,55,28,27
False,8315051,Heuweiler,15 - 18 Jahre,44,19,25
False,8315051,Heuweiler,18 - 20 Jahre,26,8,18
False,8315051,Heuweiler,20 - 25 Jahre,47,27,20
False,8315051,Heuweiler,25 - 30 Jahre,61,32,29
False,8315051,Heuweiler,30 - 35 Jahre,50,25,25
False,8315051,Heuweiler,35 - 40 Jahre,107,54,53
False,8315051,Heuweiler,40 - 45 Jahre,92,48,44
False,8315051,Heuweiler,45 - 50 Jahre,87,35,52
False,8315051,Heuweiler,50 - 55 Jahre,82,42,40
False,8315051,Heuweiler,55 - 60 Jahre,59,35,24
False,8315051,Heuweiler,60 - 65 Jahre,48,22,26
False,8315051,Heuweiler,65 - 75 Jahre,90,41,49
False,8315051,Heuweiler,75 und mehr Jahre,81,36,45
False,8315051,Heuweiler,Insgesamt,1008,494,514
False,8315052,Hinterzarten,unter 3 Jahre,56,35,21
False,8315052,Hinterzarten,3 -  6 Jahre,78,34,44
False,8315052,Hinterzarten,6 - 10 Jahre,74,36,38
False,8315052,Hinterzarten,10 - 15 Jahre,126,64,62
False,8315052,Hinterzarten,15 - 18 Jahre,83,44,39
False,8315052,Hinterzarten,18 - 20 Jahre,70,39,31
False,8315052,Hinterzarten,20 - 25 Jahre,202,86,116
False,8315052,Hinterzarten,25 - 30 Jahre,163,77,86
False,8315052,Hinterzarten,30 - 35 Jahre,201,88,113
False,8315052,Hinterzarten,35 - 40 Jahre,221,92,129
False,8315052,Hinterzarten,40 - 45 Jahre,204,93,111
False,8315052,Hinterzarten,45 - 50 Jahre,172,82,90
False,8315052,Hinterzarten,50 - 55 Jahre,127,48,79
False,8315052,Hinterzarten,55 - 60 Jahre,157,78,79
False,8315052,Hinterzarten,60 - 65 Jahre,163,75,88
False,8315052,Hinterzarten,65 - 75 Jahre,295,145,150
False,8315052,Hinterzarten,75 und mehr Jahre,214,82,132
False,8315052,Hinterzarten,Insgesamt,2606,1198,1408
False,8315056,Horben,unter 3 Jahre,34,13,21
False,8315056,Horben,3 -  6 Jahre,31,14,17
False,8315056,Horben,6 - 10 Jahre,51,30,21
False,8315056,Horben,10 - 15 Jahre,71,36,35
False,8315056,Horben,15 - 18 Jahre,48,24,24
False,8315056,Horben,18 - 20 Jahre,26,10,16
False,8315056,Horben,20 - 25 Jahre,40,22,18
False,8315056,Horben,25 - 30 Jahre,44,23,21
False,8315056,Horben,30 - 35 Jahre,66,31,35
False,8315056,Horben,35 - 40 Jahre,100,46,54
False,8315056,Horben,40 - 45 Jahre,121,58,63
False,8315056,Horben,45 - 50 Jahre,96,55,41
False,8315056,Horben,50 - 55 Jahre,53,27,26
False,8315056,Horben,55 - 60 Jahre,56,30,26
False,8315056,Horben,60 - 65 Jahre,64,27,37
False,8315056,Horben,65 - 75 Jahre,117,58,59
False,8315056,Horben,75 und mehr Jahre,56,28,28
False,8315056,Horben,Insgesamt,1074,532,542
False,8315059,Ihringen,unter 3 Jahre,166,80,86
False,8315059,Ihringen,3 -  6 Jahre,187,100,87
False,8315059,Ihringen,6 - 10 Jahre,248,126,122
False,8315059,Ihringen,10 - 15 Jahre,344,173,171
False,8315059,Ihringen,15 - 18 Jahre,230,109,121
False,8315059,Ihringen,18 - 20 Jahre,140,64,76
False,8315059,Ihringen,20 - 25 Jahre,325,161,164
False,8315059,Ihringen,25 - 30 Jahre,315,148,167
False,8315059,Ihringen,30 - 35 Jahre,346,182,164
False,8315059,Ihringen,35 - 40 Jahre,521,246,275
False,8315059,Ihringen,40 - 45 Jahre,527,262,265
False,8315059,Ihringen,45 - 50 Jahre,503,261,242
False,8315059,Ihringen,50 - 55 Jahre,428,219,209
False,8315059,Ihringen,55 - 60 Jahre,294,144,150
False,8315059,Ihringen,60 - 65 Jahre,283,131,152
False,8315059,Ihringen,65 - 75 Jahre,627,307,320
False,8315059,Ihringen,75 und mehr Jahre,420,143,277
False,8315059,Ihringen,Insgesamt,5904,2856,3048
False,8315064,Kirchzarten,unter 3 Jahre,252,129,123
False,8315064,Kirchzarten,3 -  6 Jahre,313,161,152
False,8315064,Kirchzarten,6 - 10 Jahre,437,230,207
False,8315064,Kirchzarten,10 - 15 Jahre,536,274,262
False,8315064,Kirchzarten,15 - 18 Jahre,333,168,165
False,8315064,Kirchzarten,18 - 20 Jahre,235,125,110
False,8315064,Kirchzarten,20 - 25 Jahre,514,242,272
False,8315064,Kirchzarten,25 - 30 Jahre,487,239,248
False,8315064,Kirchzarten,30 - 35 Jahre,504,249,255
False,8315064,Kirchzarten,35 - 40 Jahre,749,369,380
False,8315064,Kirchzarten,40 - 45 Jahre,803,379,424
False,8315064,Kirchzarten,45 - 50 Jahre,775,384,391
False,8315064,Kirchzarten,50 - 55 Jahre,646,294,352
False,8315064,Kirchzarten,55 - 60 Jahre,551,252,299
False,8315064,Kirchzarten,60 - 65 Jahre,643,284,359
False,8315064,Kirchzarten,65 - 75 Jahre,1168,548,620
False,8315064,Kirchzarten,75 und mehr Jahre,866,311,555
False,8315064,Kirchzarten,Insgesamt,9812,4638,5174
False,8315068,Lenzkirch,unter 3 Jahre,145,73,72
False,8315068,Lenzkirch,3 -  6 Jahre,144,77,67
False,8315068,Lenzkirch,6 - 10 Jahre,193,94,99
False,8315068,Lenzkirch,10 - 15 Jahre,230,124,106
False,8315068,Lenzkirch,15 - 18 Jahre,195,99,96
False,8315068,Lenzkirch,18 - 20 Jahre,119,58,61
False,8315068,Lenzkirch,20 - 25 Jahre,296,158,138
False,8315068,Lenzkirch,25 - 30 Jahre,280,149,131
False,8315068,Lenzkirch,30 - 35 Jahre,288,132,156
False,8315068,Lenzkirch,35 - 40 Jahre,433,188,245
False,8315068,Lenzkirch,40 - 45 Jahre,396,219,177
False,8315068,Lenzkirch,45 - 50 Jahre,368,191,177
False,8315068,Lenzkirch,50 - 55 Jahre,329,166,163
False,8315068,Lenzkirch,55 - 60 Jahre,316,161,155
False,8315068,Lenzkirch,60 - 65 Jahre,268,131,137
False,8315068,Lenzkirch,65 - 75 Jahre,591,262,329
False,8315068,Lenzkirch,75 und mehr Jahre,507,183,324
False,8315068,Lenzkirch,Insgesamt,5098,2465,2633
False,8315070,"Löffingen, Stadt",unter 3 Jahre,216,112,104
False,8315070,"Löffingen, Stadt",3 -  6 Jahre,280,143,137
False,8315070,"Löffingen, Stadt",6 - 10 Jahre,400,213,187
False,8315070,"Löffingen, Stadt",10 - 15 Jahre,494,253,241
False,8315070,"Löffingen, Stadt",15 - 18 Jahre,322,161,161
False,8315070,"Löffingen, Stadt",18 - 20 Jahre,232,107,125
False,8315070,"Löffingen, Stadt",20 - 25 Jahre,458,255,203
False,8315070,"Löffingen, Stadt",25 - 30 Jahre,434,224,210
False,8315070,"Löffingen, Stadt",30 - 35 Jahre,454,227,227
False,8315070,"Löffingen, Stadt",35 - 40 Jahre,674,335,339
False,8315070,"Löffingen, Stadt",40 - 45 Jahre,665,346,319
False,8315070,"Löffingen, Stadt",45 - 50 Jahre,603,303,300
False,8315070,"Löffingen, Stadt",50 - 55 Jahre,545,275,270
False,8315070,"Löffingen, Stadt",55 - 60 Jahre,402,210,192
False,8315070,"Löffingen, Stadt",60 - 65 Jahre,369,192,177
False,8315070,"Löffingen, Stadt",65 - 75 Jahre,805,386,419
False,8315070,"Löffingen, Stadt",75 und mehr Jahre,618,238,380
False,8315070,"Löffingen, Stadt",Insgesamt,7971,3980,3991
False,8315072,Merdingen,unter 3 Jahre,80,29,51
False,8315072,Merdingen,3 -  6 Jahre,98,51,47
False,8315072,Merdingen,6 - 10 Jahre,129,68,61
False,8315072,Merdingen,10 - 15 Jahre,147,71,76
False,8315072,Merdingen,15 - 18 Jahre,92,33,59
False,8315072,Merdingen,18 - 20 Jahre,73,31,42
False,8315072,Merdingen,20 - 25 Jahre,142,78,64
False,8315072,Merdingen,25 - 30 Jahre,125,59,66
False,8315072,Merdingen,30 - 35 Jahre,177,85,92
False,8315072,Merdingen,35 - 40 Jahre,230,114,116
False,8315072,Merdingen,40 - 45 Jahre,278,148,130
False,8315072,Merdingen,45 - 50 Jahre,214,104,110
False,8315072,Merdingen,50 - 55 Jahre,198,94,104
False,8315072,Merdingen,55 - 60 Jahre,141,72,69
False,8315072,Merdingen,60 - 65 Jahre,106,54,52
False,8315072,Merdingen,65 - 75 Jahre,242,116,126
False,8315072,Merdingen,75 und mehr Jahre,142,58,84
False,8315072,Merdingen,Insgesamt,2614,1265,1349
False,8315073,Merzhausen,unter 3 Jahre,117,61,56
False,8315073,Merzhausen,3 -  6 Jahre,94,47,47
False,8315073,Merzhausen,6 - 10 Jahre,145,81,64
False,8315073,Merzhausen,10 - 15 Jahre,196,96,100
False,8315073,Merzhausen,15 - 18 Jahre,109,47,62
False,8315073,Merzhausen,18 - 20 Jahre,75,41,34
False,8315073,Merzhausen,20 - 25 Jahre,248,119,129
False,8315073,Merzhausen,25 - 30 Jahre,264,123,141
False,8315073,Merzhausen,30 - 35 Jahre,322,163,159
False,8315073,Merzhausen,35 - 40 Jahre,360,188,172
False,8315073,Merzhausen,40 - 45 Jahre,382,175,207
False,8315073,Merzhausen,45 - 50 Jahre,316,158,158
False,8315073,Merzhausen,50 - 55 Jahre,266,106,160
False,8315073,Merzhausen,55 - 60 Jahre,317,146,171
False,8315073,Merzhausen,60 - 65 Jahre,375,169,206
False,8315073,Merzhausen,65 - 75 Jahre,589,261,328
False,8315073,Merzhausen,75 und mehr Jahre,440,160,280
False,8315073,Merzhausen,Insgesamt,4615,2141,2474
False,8315074,"Müllheim, Stadt",unter 3 Jahre,474,247,227
False,8315074,"Müllheim, Stadt",3 -  6 Jahre,514,257,257
False,8315074,"Müllheim, Stadt",6 - 10 Jahre,817,453,364
False,8315074,"Müllheim, Stadt",10 - 15 Jahre,1109,577,532
False,8315074,"Müllheim, Stadt",15 - 18 Jahre,714,371,343
False,8315074,"Müllheim, Stadt",18 - 20 Jahre,465,227,238
False,8315074,"Müllheim, Stadt",20 - 25 Jahre,1056,522,534
False,8315074,"Müllheim, Stadt",25 - 30 Jahre,983,475,508
False,8315074,"Müllheim, Stadt",30 - 35 Jahre,1003,495,508
False,8315074,"Müllheim, Stadt",35 - 40 Jahre,1394,675,719
False,8315074,"Müllheim, Stadt",40 - 45 Jahre,1523,737,786
False,8315074,"Müllheim, Stadt",45 - 50 Jahre,1364,668,696
False,8315074,"Müllheim, Stadt",50 - 55 Jahre,1209,567,642
False,8315074,"Müllheim, Stadt",55 - 60 Jahre,1002,486,516
False,8315074,"Müllheim, Stadt",60 - 65 Jahre,992,481,511
False,8315074,"Müllheim, Stadt",65 - 75 Jahre,1916,874,1042
False,8315074,"Müllheim, Stadt",75 und mehr Jahre,1664,560,1104
False,8315074,"Müllheim, Stadt",Insgesamt,18199,8672,9527
False,8315076,"Neuenburg am Rhein, Stadt",unter 3 Jahre,374,205,169
False,8315076,"Neuenburg am Rhein, Stadt",3 -  6 Jahre,386,205,181
False,8315076,"Neuenburg am Rhein, Stadt",6 - 10 Jahre,633,339,294
False,8315076,"Neuenburg am Rhein, Stadt",10 - 15 Jahre,815,416,399
False,8315076,"Neuenburg am Rhein, Stadt",15 - 18 Jahre,471,237,234
False,8315076,"Neuenburg am Rhein, Stadt",18 - 20 Jahre,285,146,139
False,8315076,"Neuenburg am Rhein, Stadt",20 - 25 Jahre,683,352,331
False,8315076,"Neuenburg am Rhein, Stadt",25 - 30 Jahre,610,287,323
False,8315076,"Neuenburg am Rhein, Stadt",30 - 35 Jahre,764,357,407
False,8315076,"Neuenburg am Rhein, Stadt",35 - 40 Jahre,1067,530,537
False,8315076,"Neuenburg am Rhein, Stadt",40 - 45 Jahre,1132,580,552
False,8315076,"Neuenburg am Rhein, Stadt",45 - 50 Jahre,935,484,451
False,8315076,"Neuenburg am Rhein, Stadt",50 - 55 Jahre,796,416,380
False,8315076,"Neuenburg am Rhein, Stadt",55 - 60 Jahre,652,333,319
False,8315076,"Neuenburg am Rhein, Stadt",60 - 65 Jahre,574,292,282
False,8315076,"Neuenburg am Rhein, Stadt",65 - 75 Jahre,1020,488,532
False,8315076,"Neuenburg am Rhein, Stadt",75 und mehr Jahre,677,261,416
False,8315076,"Neuenburg am Rhein, Stadt",Insgesamt,11874,5928,5946
False,8315084,Oberried,unter 3 Jahre,83,42,41
False,8315084,Oberried,3 -  6 Jahre,106,56,50
False,8315084,Oberried,6 - 10 Jahre,170,86,84
False,8315084,Oberried,10 - 15 Jahre,210,121,89
False,8315084,Oberried,15 - 18 Jahre,101,49,52
False,8315084,Oberried,18 - 20 Jahre,67,33,34
False,8315084,Oberried,20 - 25 Jahre,161,75,86
False,8315084,Oberried,25 - 30 Jahre,149,81,68
False,8315084,Oberried,30 - 35 Jahre,193,94,99
False,8315084,Oberried,35 - 40 Jahre,254,121,133
False,8315084,Oberried,40 - 45 Jahre,274,139,135
False,8315084,Oberried,45 - 50 Jahre,195,108,87
False,8315084,Oberried,50 - 55 Jahre,174,92,82
False,8315084,Oberried,55 - 60 Jahre,155,76,79
False,8315084,Oberried,60 - 65 Jahre,148,74,74
False,8315084,Oberried,65 - 75 Jahre,281,136,145
False,8315084,Oberried,75 und mehr Jahre,169,83,86
False,8315084,Oberried,Insgesamt,2890,1466,1424
False,8315089,Pfaffenweiler,unter 3 Jahre,80,46,34
False,8315089,Pfaffenweiler,3 -  6 Jahre,76,38,38
False,8315089,Pfaffenweiler,6 - 10 Jahre,119,62,57
False,8315089,Pfaffenweiler,10 - 15 Jahre,122,57,65
False,8315089,Pfaffenweiler,15 - 18 Jahre,89,42,47
False,8315089,Pfaffenweiler,18 - 20 Jahre,64,29,35
False,8315089,Pfaffenweiler,20 - 25 Jahre,140,66,74
False,8315089,Pfaffenweiler,25 - 30 Jahre,153,70,83
False,8315089,Pfaffenweiler,30 - 35 Jahre,144,66,78
False,8315089,Pfaffenweiler,35 - 40 Jahre,233,120,113
False,8315089,Pfaffenweiler,40 - 45 Jahre,222,118,104
False,8315089,Pfaffenweiler,45 - 50 Jahre,201,97,104
False,8315089,Pfaffenweiler,50 - 55 Jahre,188,91,97
False,8315089,Pfaffenweiler,55 - 60 Jahre,172,92,80
False,8315089,Pfaffenweiler,60 - 65 Jahre,165,84,81
False,8315089,Pfaffenweiler,65 - 75 Jahre,273,128,145
False,8315089,Pfaffenweiler,75 und mehr Jahre,160,69,91
False,8315089,Pfaffenweiler,Insgesamt,2601,1275,1326
False,8315094,St. Märgen,unter 3 Jahre,73,41,32
False,8315094,St. Märgen,3 -  6 Jahre,76,44,32
False,8315094,St. Märgen,6 - 10 Jahre,92,54,38
False,8315094,St. Märgen,10 - 15 Jahre,136,68,68
False,8315094,St. Märgen,15 - 18 Jahre,70,42,28
False,8315094,St. Märgen,18 - 20 Jahre,48,25,23
False,8315094,St. Märgen,20 - 25 Jahre,114,58,56
False,8315094,St. Märgen,25 - 30 Jahre,108,51,57
False,8315094,St. Märgen,30 - 35 Jahre,106,59,47
False,8315094,St. Märgen,35 - 40 Jahre,147,79,68
False,8315094,St. Märgen,40 - 45 Jahre,170,85,85
False,8315094,St. Märgen,45 - 50 Jahre,124,67,57
False,8315094,St. Märgen,50 - 55 Jahre,109,63,46
False,8315094,St. Märgen,55 - 60 Jahre,96,46,50
False,8315094,St. Märgen,60 - 65 Jahre,93,48,45
False,8315094,St. Märgen,65 - 75 Jahre,193,89,104
False,8315094,St. Märgen,75 und mehr Jahre,167,65,102
False,8315094,St. Märgen,Insgesamt,1922,984,938
False,8315095,St. Peter,unter 3 Jahre,87,48,39
False,8315095,St. Peter,3 -  6 Jahre,93,48,45
False,8315095,St. Peter,6 - 10 Jahre,124,52,72
False,8315095,St. Peter,10 - 15 Jahre,162,99,63
False,8315095,St. Peter,15 - 18 Jahre,103,46,57
False,8315095,St. Peter,18 - 20 Jahre,72,43,29
False,8315095,St. Peter,20 - 25 Jahre,131,71,60
False,8315095,St. Peter,25 - 30 Jahre,107,48,59
False,8315095,St. Peter,30 - 35 Jahre,147,79,68
False,8315095,St. Peter,35 - 40 Jahre,194,96,98
False,8315095,St. Peter,40 - 45 Jahre,238,132,106
False,8315095,St. Peter,45 - 50 Jahre,202,111,91
False,8315095,St. Peter,50 - 55 Jahre,138,80,58
False,8315095,St. Peter,55 - 60 Jahre,128,60,68
False,8315095,St. Peter,60 - 65 Jahre,138,64,74
False,8315095,St. Peter,65 - 75 Jahre,267,133,134
False,8315095,St. Peter,75 und mehr Jahre,177,72,105
False,8315095,St. Peter,Insgesamt,2508,1282,1226
False,8315098,Schallstadt,unter 3 Jahre,171,80,91
False,8315098,Schallstadt,3 -  6 Jahre,160,86,74
False,8315098,Schallstadt,6 - 10 Jahre,266,155,111
False,8315098,Schallstadt,10 - 15 Jahre,355,175,180
False,8315098,Schallstadt,15 - 18 Jahre,213,99,114
False,8315098,Schallstadt,18 - 20 Jahre,136,66,70
False,8315098,Schallstadt,20 - 25 Jahre,327,158,169
False,8315098,Schallstadt,25 - 30 Jahre,290,147,143
False,8315098,Schallstadt,30 - 35 Jahre,314,127,187
False,8315098,Schallstadt,35 - 40 Jahre,534,269,265
False,8315098,Schallstadt,40 - 45 Jahre,511,242,269
False,8315098,Schallstadt,45 - 50 Jahre,480,225,255
False,8315098,Schallstadt,50 - 55 Jahre,421,210,211
False,8315098,Schallstadt,55 - 60 Jahre,394,181,213
False,8315098,Schallstadt,60 - 65 Jahre,325,176,149
False,8315098,Schallstadt,65 - 75 Jahre,574,296,278
False,8315098,Schallstadt,75 und mehr Jahre,356,137,219
False,8315098,Schallstadt,Insgesamt,5827,2829,2998
False,8315102,Schluchsee,unter 3 Jahre,50,31,19
False,8315102,Schluchsee,3 -  6 Jahre,49,24,25
False,8315102,Schluchsee,6 - 10 Jahre,71,35,36
False,8315102,Schluchsee,10 - 15 Jahre,112,59,53
False,8315102,Schluchsee,15 - 18 Jahre,69,40,29
False,8315102,Schluchsee,18 - 20 Jahre,62,33,29
False,8315102,Schluchsee,20 - 25 Jahre,190,85,105
False,8315102,Schluchsee,25 - 30 Jahre,166,75,91
False,8315102,Schluchsee,30 - 35 Jahre,165,90,75
False,8315102,Schluchsee,35 - 40 Jahre,255,121,134
False,8315102,Schluchsee,40 - 45 Jahre,183,87,96
False,8315102,Schluchsee,45 - 50 Jahre,193,116,77
False,8315102,Schluchsee,50 - 55 Jahre,146,61,85
False,8315102,Schluchsee,55 - 60 Jahre,163,75,88
False,8315102,Schluchsee,60 - 65 Jahre,165,81,84
False,8315102,Schluchsee,65 - 75 Jahre,319,160,159
False,8315102,Schluchsee,75 und mehr Jahre,246,97,149
False,8315102,Schluchsee,Insgesamt,2604,1270,1334
False,8315107,Sölden,unter 3 Jahre,29,15,14
False,8315107,Sölden,3 -  6 Jahre,40,18,22
False,8315107,Sölden,6 - 10 Jahre,63,30,33
False,8315107,Sölden,10 - 15 Jahre,65,39,26
False,8315107,Sölden,15 - 18 Jahre,43,15,28
False,8315107,Sölden,18 - 20 Jahre,42,25,17
False,8315107,Sölden,20 - 25 Jahre,70,39,31
False,8315107,Sölden,25 - 30 Jahre,69,31,38
False,8315107,Sölden,30 - 35 Jahre,57,29,28
False,8315107,Sölden,35 - 40 Jahre,61,33,28
False,8315107,Sölden,40 - 45 Jahre,97,44,53
False,8315107,Sölden,45 - 50 Jahre,121,60,61
False,8315107,Sölden,50 - 55 Jahre,98,47,51
False,8315107,Sölden,55 - 60 Jahre,81,42,39
False,8315107,Sölden,60 - 65 Jahre,76,31,45
False,8315107,Sölden,65 - 75 Jahre,100,48,52
False,8315107,Sölden,75 und mehr Jahre,79,29,50
False,8315107,Sölden,Insgesamt,1191,575,616
False,8315108,"Staufen im Breisgau, Stadt",unter 3 Jahre,183,82,101
False,8315108,"Staufen im Breisgau, Stadt",3 -  6 Jahre,197,99,98
False,8315108,"Staufen im Breisgau, Stadt",6 - 10 Jahre,294,158,136
False,8315108,"Staufen im Breisgau, Stadt",10 - 15 Jahre,421,226,195
False,8315108,"Staufen im Breisgau, Stadt",15 - 18 Jahre,293,143,150
False,8315108,"Staufen im Breisgau, Stadt",18 - 20 Jahre,170,96,74
False,8315108,"Staufen im Breisgau, Stadt",20 - 25 Jahre,298,161,137
False,8315108,"Staufen im Breisgau, Stadt",25 - 30 Jahre,311,165,146
False,8315108,"Staufen im Breisgau, Stadt",30 - 35 Jahre,343,178,165
False,8315108,"Staufen im Breisgau, Stadt",35 - 40 Jahre,635,291,344
False,8315108,"Staufen im Breisgau, Stadt",40 - 45 Jahre,667,309,358
False,8315108,"Staufen im Breisgau, Stadt",45 - 50 Jahre,592,271,321
False,8315108,"Staufen im Breisgau, Stadt",50 - 55 Jahre,556,275,281
False,8315108,"Staufen im Breisgau, Stadt",55 - 60 Jahre,547,256,291
False,8315108,"Staufen im Breisgau, Stadt",60 - 65 Jahre,515,266,249
False,8315108,"Staufen im Breisgau, Stadt",65 - 75 Jahre,890,424,466
False,8315108,"Staufen im Breisgau, Stadt",75 und mehr Jahre,845,261,584
False,8315108,"Staufen im Breisgau, Stadt",Insgesamt,7757,3661,4096
False,8315109,Stegen,unter 3 Jahre,118,68,50
False,8315109,Stegen,3 -  6 Jahre,134,67,67
False,8315109,Stegen,6 - 10 Jahre,229,113,116
False,8315109,Stegen,10 - 15 Jahre,308,172,136
False,8315109,Stegen,15 - 18 Jahre,193,109,84
False,8315109,Stegen,18 - 20 Jahre,122,54,68
False,8315109,Stegen,20 - 25 Jahre,263,138,125
False,8315109,Stegen,25 - 30 Jahre,195,83,112
False,8315109,Stegen,30 - 35 Jahre,233,100,133
False,8315109,Stegen,35 - 40 Jahre,325,153,172
False,8315109,Stegen,40 - 45 Jahre,397,171,226
False,8315109,Stegen,45 - 50 Jahre,333,164,169
False,8315109,Stegen,50 - 55 Jahre,290,132,158
False,8315109,Stegen,55 - 60 Jahre,230,115,115
False,8315109,Stegen,60 - 65 Jahre,206,98,108
False,8315109,Stegen,65 - 75 Jahre,537,249,288
False,8315109,Stegen,75 und mehr Jahre,279,122,157
False,8315109,Stegen,Insgesamt,4392,2108,2284
False,8315111,"Sulzburg, Stadt",unter 3 Jahre,57,29,28
False,8315111,"Sulzburg, Stadt",3 -  6 Jahre,79,40,39
False,8315111,"Sulzburg, Stadt",6 - 10 Jahre,135,67,68
False,8315111,"Sulzburg, Stadt",10 - 15 Jahre,191,102,89
False,8315111,"Sulzburg, Stadt",15 - 18 Jahre,116,54,62
False,8315111,"Sulzburg, Stadt",18 - 20 Jahre,54,25,29
False,8315111,"Sulzburg, Stadt",20 - 25 Jahre,149,73,76
False,8315111,"Sulzburg, Stadt",25 - 30 Jahre,116,63,53
False,8315111,"Sulzburg, Stadt",30 - 35 Jahre,120,61,59
False,8315111,"Sulzburg, Stadt",35 - 40 Jahre,240,98,142
False,8315111,"Sulzburg, Stadt",40 - 45 Jahre,246,128,118
False,8315111,"Sulzburg, Stadt",45 - 50 Jahre,213,100,113
False,8315111,"Sulzburg, Stadt",50 - 55 Jahre,192,98,94
False,8315111,"Sulzburg, Stadt",55 - 60 Jahre,154,71,83
False,8315111,"Sulzburg, Stadt",60 - 65 Jahre,144,63,81
False,8315111,"Sulzburg, Stadt",65 - 75 Jahre,298,147,151
False,8315111,"Sulzburg, Stadt",75 und mehr Jahre,235,80,155
False,8315111,"Sulzburg, Stadt",Insgesamt,2739,1299,1440
False,8315113,"Titisee-Neustadt, Stadt",unter 3 Jahre,318,176,142
False,8315113,"Titisee-Neustadt, Stadt",3 -  6 Jahre,318,170,148
False,8315113,"Titisee-Neustadt, Stadt",6 - 10 Jahre,454,246,208
False,8315113,"Titisee-Neustadt, Stadt",10 - 15 Jahre,646,318,328
False,8315113,"Titisee-Neustadt, Stadt",15 - 18 Jahre,401,205,196
False,8315113,"Titisee-Neustadt, Stadt",18 - 20 Jahre,302,162,140
False,8315113,"Titisee-Neustadt, Stadt",20 - 25 Jahre,759,378,381
False,8315113,"Titisee-Neustadt, Stadt",25 - 30 Jahre,700,345,355
False,8315113,"Titisee-Neustadt, Stadt",30 - 35 Jahre,734,358,376
False,8315113,"Titisee-Neustadt, Stadt",35 - 40 Jahre,914,489,425
False,8315113,"Titisee-Neustadt, Stadt",40 - 45 Jahre,880,431,449
False,8315113,"Titisee-Neustadt, Stadt",45 - 50 Jahre,894,444,450
False,8315113,"Titisee-Neustadt, Stadt",50 - 55 Jahre,853,444,409
False,8315113,"Titisee-Neustadt, Stadt",55 - 60 Jahre,694,356,338
False,8315113,"Titisee-Neustadt, Stadt",60 - 65 Jahre,582,289,293
False,8315113,"Titisee-Neustadt, Stadt",65 - 75 Jahre,1267,573,694
False,8315113,"Titisee-Neustadt, Stadt",75 und mehr Jahre,1196,451,745
False,8315113,"Titisee-Neustadt, Stadt",Insgesamt,11912,5835,6077
False,8315115,Umkirch,unter 3 Jahre,135,73,62
False,8315115,Umkirch,3 -  6 Jahre,158,77,81
False,8315115,Umkirch,6 - 10 Jahre,186,114,72
False,8315115,Umkirch,10 - 15 Jahre,303,153,150
False,8315115,Umkirch,15 - 18 Jahre,228,130,98
False,8315115,Umkirch,18 - 20 Jahre,149,76,73
False,8315115,Umkirch,20 - 25 Jahre,325,171,154
False,8315115,Umkirch,25 - 30 Jahre,323,159,164
False,8315115,Umkirch,30 - 35 Jahre,263,140,123
False,8315115,Umkirch,35 - 40 Jahre,369,180,189
False,8315115,Umkirch,40 - 45 Jahre,454,223,231
False,8315115,Umkirch,45 - 50 Jahre,437,220,217
False,8315115,Umkirch,50 - 55 Jahre,411,198,213
False,8315115,Umkirch,55 - 60 Jahre,342,168,174
False,8315115,Umkirch,60 - 65 Jahre,344,157,187
False,8315115,Umkirch,65 - 75 Jahre,583,290,293
False,8315115,Umkirch,75 und mehr Jahre,298,126,172
False,8315115,Umkirch,Insgesamt,5308,2655,2653
False,8315125,Wittnau,unter 3 Jahre,40,21,19
False,8315125,Wittnau,3 -  6 Jahre,31,20,11
False,8315125,Wittnau,6 - 10 Jahre,66,33,33
False,8315125,Wittnau,10 - 15 Jahre,92,46,46
False,8315125,Wittnau,15 - 18 Jahre,65,38,27
False,8315125,Wittnau,18 - 20 Jahre,36,22,14
False,8315125,Wittnau,20 - 25 Jahre,69,35,34
False,8315125,Wittnau,25 - 30 Jahre,72,35,37
False,8315125,Wittnau,30 - 35 Jahre,65,28,37
False,8315125,Wittnau,35 - 40 Jahre,112,46,66
False,8315125,Wittnau,40 - 45 Jahre,134,67,67
False,8315125,Wittnau,45 - 50 Jahre,132,75,57
False,8315125,Wittnau,50 - 55 Jahre,109,49,60
False,8315125,Wittnau,55 - 60 Jahre,82,38,44
False,8315125,Wittnau,60 - 65 Jahre,105,53,52
False,8315125,Wittnau,65 - 75 Jahre,133,73,60
False,8315125,Wittnau,75 und mehr Jahre,108,41,67
False,8315125,Wittnau,Insgesamt,1451,720,731
False,8315130,Münstertal/Schwarzwald,unter 3 Jahre,142,75,67
False,8315130,Münstertal/Schwarzwald,3 -  6 Jahre,173,88,85
False,8315130,Münstertal/Schwarzwald,6 - 10 Jahre,236,125,111
False,8315130,Münstertal/Schwarzwald,10 - 15 Jahre,359,181,178
False,8315130,Münstertal/Schwarzwald,15 - 18 Jahre,203,101,102
False,8315130,Münstertal/Schwarzwald,18 - 20 Jahre,91,51,40
False,8315130,Münstertal/Schwarzwald,20 - 25 Jahre,294,162,132
False,8315130,Münstertal/Schwarzwald,25 - 30 Jahre,269,138,131
False,8315130,Münstertal/Schwarzwald,30 - 35 Jahre,274,136,138
False,8315130,Münstertal/Schwarzwald,35 - 40 Jahre,439,218,221
False,8315130,Münstertal/Schwarzwald,40 - 45 Jahre,466,232,234
False,8315130,Münstertal/Schwarzwald,45 - 50 Jahre,366,181,185
False,8315130,Münstertal/Schwarzwald,50 - 55 Jahre,343,170,173
False,8315130,Münstertal/Schwarzwald,55 - 60 Jahre,266,145,121
False,8315130,Münstertal/Schwarzwald,60 - 65 Jahre,244,106,138
False,8315130,Münstertal/Schwarzwald,65 - 75 Jahre,641,304,337
False,8315130,Münstertal/Schwarzwald,75 und mehr Jahre,437,156,281
False,8315130,Münstertal/Schwarzwald,Insgesamt,5243,2569,2674
False,8315131,Ehrenkirchen,unter 3 Jahre,213,109,104
False,8315131,Ehrenkirchen,3 -  6 Jahre,257,147,110
False,8315131,Ehrenkirchen,6 - 10 Jahre,358,193,165
False,8315131,Ehrenkirchen,10 - 15 Jahre,431,222,209
False,8315131,Ehrenkirchen,15 - 18 Jahre,277,147,130
False,8315131,Ehrenkirchen,18 - 20 Jahre,149,75,74
False,8315131,Ehrenkirchen,20 - 25 Jahre,340,165,175
False,8315131,Ehrenkirchen,25 - 30 Jahre,336,182,154
False,8315131,Ehrenkirchen,30 - 35 Jahre,404,184,220
False,8315131,Ehrenkirchen,35 - 40 Jahre,643,304,339
False,8315131,Ehrenkirchen,40 - 45 Jahre,702,358,344
False,8315131,Ehrenkirchen,45 - 50 Jahre,610,323,287
False,8315131,Ehrenkirchen,50 - 55 Jahre,416,204,212
False,8315131,Ehrenkirchen,55 - 60 Jahre,360,192,168
False,8315131,Ehrenkirchen,60 - 65 Jahre,390,179,211
False,8315131,Ehrenkirchen,65 - 75 Jahre,666,332,334
False,8315131,Ehrenkirchen,75 und mehr Jahre,433,177,256
False,8315131,Ehrenkirchen,Insgesamt,6985,3493,3492
False,8315132,March,unter 3 Jahre,210,98,112
False,8315132,March,3 -  6 Jahre,245,130,115
False,8315132,March,6 - 10 Jahre,378,214,164
False,8315132,March,10 - 15 Jahre,530,286,244
False,8315132,March,15 - 18 Jahre,327,165,162
False,8315132,March,18 - 20 Jahre,233,120,113
False,8315132,March,20 - 25 Jahre,519,245,274
False,8315132,March,25 - 30 Jahre,475,234,241
False,8315132,March,30 - 35 Jahre,489,241,248
False,8315132,March,35 - 40 Jahre,724,367,357
False,8315132,March,40 - 45 Jahre,861,436,425
False,8315132,March,45 - 50 Jahre,760,375,385
False,8315132,March,50 - 55 Jahre,674,326,348
False,8315132,March,55 - 60 Jahre,526,256,270
False,8315132,March,60 - 65 Jahre,491,229,262
False,8315132,March,65 - 75 Jahre,819,420,399
False,8315132,March,75 und mehr Jahre,500,181,319
False,8315132,March,Insgesamt,8761,4323,4438
False,8315133,"Vogtsburg im Kaiserstuhl, Stadt",unter 3 Jahre,114,59,55
False,8315133,"Vogtsburg im Kaiserstuhl, Stadt",3 -  6 Jahre,177,90,87
False,8315133,"Vogtsburg im Kaiserstuhl, Stadt",6 - 10 Jahre,262,136,126
False,8315133,"Vogtsburg im Kaiserstuhl, Stadt",10 - 15 Jahre,362,205,157
False,8315133,"Vogtsburg im Kaiserstuhl, Stadt",15 - 18 Jahre,224,114,110
False,8315133,"Vogtsburg im Kaiserstuhl, Stadt",18 - 20 Jahre,137,68,69
False,8315133,"Vogtsburg im Kaiserstuhl, Stadt",20 - 25 Jahre,327,163,164
False,8315133,"Vogtsburg im Kaiserstuhl, Stadt",25 - 30 Jahre,255,144,111
False,8315133,"Vogtsburg im Kaiserstuhl, Stadt",30 - 35 Jahre,290,152,138
False,8315133,"Vogtsburg im Kaiserstuhl, Stadt",35 - 40 Jahre,503,249,254
False,8315133,"Vogtsburg im Kaiserstuhl, Stadt",40 - 45 Jahre,513,270,243
False,8315133,"Vogtsburg im Kaiserstuhl, Stadt",45 - 50 Jahre,431,216,215
False,8315133,"Vogtsburg im Kaiserstuhl, Stadt",50 - 55 Jahre,413,216,197
False,8315133,"Vogtsburg im Kaiserstuhl, Stadt",55 - 60 Jahre,365,200,165
False,8315133,"Vogtsburg im Kaiserstuhl, Stadt",60 - 65 Jahre,292,145,147
False,8315133,"Vogtsburg im Kaiserstuhl, Stadt",65 - 75 Jahre,660,326,334
False,8315133,"Vogtsburg im Kaiserstuhl, Stadt",75 und mehr Jahre,412,141,271
False,8315133,"Vogtsburg im Kaiserstuhl, Stadt",Insgesamt,5737,2894,2843
False,8316,Landkreis Emmendingen,unter 3 Jahre,4366,2302,2064
False,8316,Landkreis Emmendingen,3 -  6 Jahre,4633,2387,2246
False,8316,Landkreis Emmendingen,6 - 10 Jahre,7122,3591,3531
False,8316,Landkreis Emmendingen,10 - 15 Jahre,9153,4709,4444
False,8316,Landkreis Emmendingen,15 - 18 Jahre,5886,3044,2842
False,8316,Landkreis Emmendingen,18 - 20 Jahre,3868,1942,1926
False,8316,Landkreis Emmendingen,20 - 25 Jahre,8992,4632,4360
False,8316,Landkreis Emmendingen,25 - 30 Jahre,8228,4113,4115
False,8316,Landkreis Emmendingen,30 - 35 Jahre,9060,4444,4616
False,8316,Landkreis Emmendingen,35 - 40 Jahre,13060,6621,6439
False,8316,Landkreis Emmendingen,40 - 45 Jahre,13963,7031,6932
False,8316,Landkreis Emmendingen,45 - 50 Jahre,12487,6206,6281
False,8316,Landkreis Emmendingen,50 - 55 Jahre,10897,5474,5423
False,8316,Landkreis Emmendingen,55 - 60 Jahre,8972,4513,4459
False,8316,Landkreis Emmendingen,60 - 65 Jahre,8142,3911,4231
False,8316,Landkreis Emmendingen,65 - 75 Jahre,16145,7739,8406
False,8316,Landkreis Emmendingen,75 und mehr Jahre,11754,4118,7636
False,8316,Landkreis Emmendingen,Insgesamt,156728,76777,79951
False,8316002,Bahlingen am Kaiserstuhl,unter 3 Jahre,110,52,58
False,8316002,Bahlingen am Kaiserstuhl,3 -  6 Jahre,106,51,55
False,8316002,Bahlingen am Kaiserstuhl,6 - 10 Jahre,176,95,81
False,8316002,Bahlingen am Kaiserstuhl,10 - 15 Jahre,207,109,98
False,8316002,Bahlingen am Kaiserstuhl,15 - 18 Jahre,194,89,105
False,8316002,Bahlingen am Kaiserstuhl,18 - 20 Jahre,89,35,54
False,8316002,Bahlingen am Kaiserstuhl,20 - 25 Jahre,219,107,112
False,8316002,Bahlingen am Kaiserstuhl,25 - 30 Jahre,251,118,133
False,8316002,Bahlingen am Kaiserstuhl,30 - 35 Jahre,211,101,110
False,8316002,Bahlingen am Kaiserstuhl,35 - 40 Jahre,319,172,147
False,8316002,Bahlingen am Kaiserstuhl,40 - 45 Jahre,349,177,172
False,8316002,Bahlingen am Kaiserstuhl,45 - 50 Jahre,325,155,170
False,8316002,Bahlingen am Kaiserstuhl,50 - 55 Jahre,305,153,152
False,8316002,Bahlingen am Kaiserstuhl,55 - 60 Jahre,209,119,90
False,8316002,Bahlingen am Kaiserstuhl,60 - 65 Jahre,152,74,78
False,8316002,Bahlingen am Kaiserstuhl,65 - 75 Jahre,358,178,180
False,8316002,Bahlingen am Kaiserstuhl,75 und mehr Jahre,243,89,154
False,8316002,Bahlingen am Kaiserstuhl,Insgesamt,3823,1874,1949
False,8316003,Biederbach,unter 3 Jahre,56,26,30
False,8316003,Biederbach,3 -  6 Jahre,65,37,28
False,8316003,Biederbach,6 - 10 Jahre,84,48,36
False,8316003,Biederbach,10 - 15 Jahre,109,46,63
False,8316003,Biederbach,15 - 18 Jahre,61,29,32
False,8316003,Biederbach,18 - 20 Jahre,48,28,20
False,8316003,Biederbach,20 - 25 Jahre,98,50,48
False,8316003,Biederbach,25 - 30 Jahre,98,43,55
False,8316003,Biederbach,30 - 35 Jahre,133,64,69
False,8316003,Biederbach,35 - 40 Jahre,157,72,85
False,8316003,Biederbach,40 - 45 Jahre,161,96,65
False,8316003,Biederbach,45 - 50 Jahre,132,69,63
False,8316003,Biederbach,50 - 55 Jahre,91,45,46
False,8316003,Biederbach,55 - 60 Jahre,85,41,44
False,8316003,Biederbach,60 - 65 Jahre,69,37,32
False,8316003,Biederbach,65 - 75 Jahre,162,87,75
False,8316003,Biederbach,75 und mehr Jahre,134,51,83
False,8316003,Biederbach,Insgesamt,1743,869,874
False,8316009,Denzlingen,unter 3 Jahre,378,192,186
False,8316009,Denzlingen,3 -  6 Jahre,357,181,176
False,8316009,Denzlingen,6 - 10 Jahre,560,277,283
False,8316009,Denzlingen,10 - 15 Jahre,697,373,324
False,8316009,Denzlingen,15 - 18 Jahre,420,210,210
False,8316009,Denzlingen,18 - 20 Jahre,310,166,144
False,8316009,Denzlingen,20 - 25 Jahre,840,436,404
False,8316009,Denzlingen,25 - 30 Jahre,712,356,356
False,8316009,Denzlingen,30 - 35 Jahre,783,386,397
False,8316009,Denzlingen,35 - 40 Jahre,1112,560,552
False,8316009,Denzlingen,40 - 45 Jahre,1141,566,575
False,8316009,Denzlingen,45 - 50 Jahre,1024,484,540
False,8316009,Denzlingen,50 - 55 Jahre,953,470,483
False,8316009,Denzlingen,55 - 60 Jahre,891,398,493
False,8316009,Denzlingen,60 - 65 Jahre,874,418,456
False,8316009,Denzlingen,65 - 75 Jahre,1354,640,714
False,8316009,Denzlingen,75 und mehr Jahre,1013,369,644
False,8316009,Denzlingen,Insgesamt,13419,6482,6937
False,8316010,"Elzach, Stadt",unter 3 Jahre,218,113,105
False,8316010,"Elzach, Stadt",3 -  6 Jahre,240,130,110
False,8316010,"Elzach, Stadt",6 - 10 Jahre,384,187,197
False,8316010,"Elzach, Stadt",10 - 15 Jahre,439,207,232
False,8316010,"Elzach, Stadt",15 - 18 Jahre,301,147,154
False,8316010,"Elzach, Stadt",18 - 20 Jahre,198,99,99
False,8316010,"Elzach, Stadt",20 - 25 Jahre,395,212,183
False,8316010,"Elzach, Stadt",25 - 30 Jahre,379,185,194
False,8316010,"Elzach, Stadt",30 - 35 Jahre,434,223,211
False,8316010,"Elzach, Stadt",35 - 40 Jahre,599,314,285
False,8316010,"Elzach, Stadt",40 - 45 Jahre,601,321,280
False,8316010,"Elzach, Stadt",45 - 50 Jahre,553,297,256
False,8316010,"Elzach, Stadt",50 - 55 Jahre,460,229,231
False,8316010,"Elzach, Stadt",55 - 60 Jahre,346,179,167
False,8316010,"Elzach, Stadt",60 - 65 Jahre,277,133,144
False,8316010,"Elzach, Stadt",65 - 75 Jahre,757,371,386
False,8316010,"Elzach, Stadt",75 und mehr Jahre,562,196,366
False,8316010,"Elzach, Stadt",Insgesamt,7143,3543,3600
False,8316011,"Emmendingen, Stadt",unter 3 Jahre,715,385,330
False,8316011,"Emmendingen, Stadt",3 -  6 Jahre,697,350,347
False,8316011,"Emmendingen, Stadt",6 - 10 Jahre,1097,573,524
False,8316011,"Emmendingen, Stadt",10 - 15 Jahre,1468,750,718
False,8316011,"Emmendingen, Stadt",15 - 18 Jahre,913,462,451
False,8316011,"Emmendingen, Stadt",18 - 20 Jahre,626,319,307
False,8316011,"Emmendingen, Stadt",20 - 25 Jahre,1538,793,745
False,8316011,"Emmendingen, Stadt",25 - 30 Jahre,1380,686,694
False,8316011,"Emmendingen, Stadt",30 - 35 Jahre,1479,722,757
False,8316011,"Emmendingen, Stadt",35 - 40 Jahre,2090,1079,1011
False,8316011,"Emmendingen, Stadt",40 - 45 Jahre,2227,1072,1155
False,8316011,"Emmendingen, Stadt",45 - 50 Jahre,2082,1010,1072
False,8316011,"Emmendingen, Stadt",50 - 55 Jahre,1907,917,990
False,8316011,"Emmendingen, Stadt",55 - 60 Jahre,1573,755,818
False,8316011,"Emmendingen, Stadt",60 - 65 Jahre,1502,716,786
False,8316011,"Emmendingen, Stadt",65 - 75 Jahre,2743,1306,1437
False,8316011,"Emmendingen, Stadt",75 und mehr Jahre,2090,712,1378
False,8316011,"Emmendingen, Stadt",Insgesamt,26127,12607,13520
False,8316012,"Endingen am Kaiserstuhl, Stadt",unter 3 Jahre,262,141,121
False,8316012,"Endingen am Kaiserstuhl, Stadt",3 -  6 Jahre,308,165,143
False,8316012,"Endingen am Kaiserstuhl, Stadt",6 - 10 Jahre,367,166,201
False,8316012,"Endingen am Kaiserstuhl, Stadt",10 - 15 Jahre,517,243,274
False,8316012,"Endingen am Kaiserstuhl, Stadt",15 - 18 Jahre,341,197,144
False,8316012,"Endingen am Kaiserstuhl, Stadt",18 - 20 Jahre,250,121,129
False,8316012,"Endingen am Kaiserstuhl, Stadt",20 - 25 Jahre,532,266,266
False,8316012,"Endingen am Kaiserstuhl, Stadt",25 - 30 Jahre,524,277,247
False,8316012,"Endingen am Kaiserstuhl, Stadt",30 - 35 Jahre,543,276,267
False,8316012,"Endingen am Kaiserstuhl, Stadt",35 - 40 Jahre,716,349,367
False,8316012,"Endingen am Kaiserstuhl, Stadt",40 - 45 Jahre,790,393,397
False,8316012,"Endingen am Kaiserstuhl, Stadt",45 - 50 Jahre,689,345,344
False,8316012,"Endingen am Kaiserstuhl, Stadt",50 - 55 Jahre,655,329,326
False,8316012,"Endingen am Kaiserstuhl, Stadt",55 - 60 Jahre,486,239,247
False,8316012,"Endingen am Kaiserstuhl, Stadt",60 - 65 Jahre,435,223,212
False,8316012,"Endingen am Kaiserstuhl, Stadt",65 - 75 Jahre,917,431,486
False,8316012,"Endingen am Kaiserstuhl, Stadt",75 und mehr Jahre,689,225,464
False,8316012,"Endingen am Kaiserstuhl, Stadt",Insgesamt,9021,4386,4635
False,8316013,Forchheim,unter 3 Jahre,58,34,24
False,8316013,Forchheim,3 -  6 Jahre,51,27,24
False,8316013,Forchheim,6 - 10 Jahre,59,27,32
False,8316013,Forchheim,10 - 15 Jahre,74,38,36
False,8316013,Forchheim,15 - 18 Jahre,45,25,20
False,8316013,Forchheim,18 - 20 Jahre,46,21,25
False,8316013,Forchheim,20 - 25 Jahre,81,43,38
False,8316013,Forchheim,25 - 30 Jahre,77,40,37
False,8316013,Forchheim,30 - 35 Jahre,78,39,39
False,8316013,Forchheim,35 - 40 Jahre,111,58,53
False,8316013,Forchheim,40 - 45 Jahre,110,63,47
False,8316013,Forchheim,45 - 50 Jahre,82,40,42
False,8316013,Forchheim,50 - 55 Jahre,82,36,46
False,8316013,Forchheim,55 - 60 Jahre,62,32,30
False,8316013,Forchheim,60 - 65 Jahre,48,19,29
False,8316013,Forchheim,65 - 75 Jahre,116,55,61
False,8316013,Forchheim,75 und mehr Jahre,83,30,53
False,8316013,Forchheim,Insgesamt,1263,627,636
False,8316014,Gutach im Breisgau,unter 3 Jahre,138,78,60
False,8316014,Gutach im Breisgau,3 -  6 Jahre,150,86,64
False,8316014,Gutach im Breisgau,6 - 10 Jahre,213,100,113
False,8316014,Gutach im Breisgau,10 - 15 Jahre,279,146,133
False,8316014,Gutach im Breisgau,15 - 18 Jahre,159,91,68
False,8316014,Gutach im Breisgau,18 - 20 Jahre,95,57,38
False,8316014,Gutach im Breisgau,20 - 25 Jahre,244,114,130
False,8316014,Gutach im Breisgau,25 - 30 Jahre,234,115,119
False,8316014,Gutach im Breisgau,30 - 35 Jahre,281,137,144
False,8316014,Gutach im Breisgau,35 - 40 Jahre,401,197,204
False,8316014,Gutach im Breisgau,40 - 45 Jahre,444,228,216
False,8316014,Gutach im Breisgau,45 - 50 Jahre,343,156,187
False,8316014,Gutach im Breisgau,50 - 55 Jahre,328,165,163
False,8316014,Gutach im Breisgau,55 - 60 Jahre,229,137,92
False,8316014,Gutach im Breisgau,60 - 65 Jahre,185,84,101
False,8316014,Gutach im Breisgau,65 - 75 Jahre,424,201,223
False,8316014,Gutach im Breisgau,75 und mehr Jahre,282,108,174
False,8316014,Gutach im Breisgau,Insgesamt,4429,2200,2229
False,8316017,"Herbolzheim, Stadt",unter 3 Jahre,275,135,140
False,8316017,"Herbolzheim, Stadt",3 -  6 Jahre,304,149,155
False,8316017,"Herbolzheim, Stadt",6 - 10 Jahre,443,222,221
False,8316017,"Herbolzheim, Stadt",10 - 15 Jahre,573,314,259
False,8316017,"Herbolzheim, Stadt",15 - 18 Jahre,415,229,186
False,8316017,"Herbolzheim, Stadt",18 - 20 Jahre,286,131,155
False,8316017,"Herbolzheim, Stadt",20 - 25 Jahre,605,310,295
False,8316017,"Herbolzheim, Stadt",25 - 30 Jahre,554,283,271
False,8316017,"Herbolzheim, Stadt",30 - 35 Jahre,586,299,287
False,8316017,"Herbolzheim, Stadt",35 - 40 Jahre,805,411,394
False,8316017,"Herbolzheim, Stadt",40 - 45 Jahre,859,449,410
False,8316017,"Herbolzheim, Stadt",45 - 50 Jahre,785,395,390
False,8316017,"Herbolzheim, Stadt",50 - 55 Jahre,645,338,307
False,8316017,"Herbolzheim, Stadt",55 - 60 Jahre,529,258,271
False,8316017,"Herbolzheim, Stadt",60 - 65 Jahre,457,226,231
False,8316017,"Herbolzheim, Stadt",65 - 75 Jahre,988,462,526
False,8316017,"Herbolzheim, Stadt",75 und mehr Jahre,737,262,475
False,8316017,"Herbolzheim, Stadt",Insgesamt,9846,4873,4973
False,8316020,"Kenzingen, Stadt",unter 3 Jahre,243,126,117
False,8316020,"Kenzingen, Stadt",3 -  6 Jahre,253,126,127
False,8316020,"Kenzingen, Stadt",6 - 10 Jahre,454,223,231
False,8316020,"Kenzingen, Stadt",10 - 15 Jahre,576,296,280
False,8316020,"Kenzingen, Stadt",15 - 18 Jahre,386,189,197
False,8316020,"Kenzingen, Stadt",18 - 20 Jahre,227,114,113
False,8316020,"Kenzingen, Stadt",20 - 25 Jahre,561,287,274
False,8316020,"Kenzingen, Stadt",25 - 30 Jahre,426,221,205
False,8316020,"Kenzingen, Stadt",30 - 35 Jahre,533,260,273
False,8316020,"Kenzingen, Stadt",35 - 40 Jahre,671,347,324
False,8316020,"Kenzingen, Stadt",40 - 45 Jahre,766,369,397
False,8316020,"Kenzingen, Stadt",45 - 50 Jahre,785,404,381
False,8316020,"Kenzingen, Stadt",50 - 55 Jahre,629,313,316
False,8316020,"Kenzingen, Stadt",55 - 60 Jahre,533,278,255
False,8316020,"Kenzingen, Stadt",60 - 65 Jahre,458,234,224
False,8316020,"Kenzingen, Stadt",65 - 75 Jahre,834,403,431
False,8316020,"Kenzingen, Stadt",75 und mehr Jahre,797,244,553
False,8316020,"Kenzingen, Stadt",Insgesamt,9132,4434,4698
False,8316024,Malterdingen,unter 3 Jahre,70,35,35
False,8316024,Malterdingen,3 -  6 Jahre,114,50,64
False,8316024,Malterdingen,6 - 10 Jahre,141,73,68
False,8316024,Malterdingen,10 - 15 Jahre,181,101,80
False,8316024,Malterdingen,15 - 18 Jahre,127,73,54
False,8316024,Malterdingen,18 - 20 Jahre,80,46,34
False,8316024,Malterdingen,20 - 25 Jahre,144,68,76
False,8316024,Malterdingen,25 - 30 Jahre,158,83,75
False,8316024,Malterdingen,30 - 35 Jahre,180,90,90
False,8316024,Malterdingen,35 - 40 Jahre,260,134,126
False,8316024,Malterdingen,40 - 45 Jahre,272,140,132
False,8316024,Malterdingen,45 - 50 Jahre,255,134,121
False,8316024,Malterdingen,50 - 55 Jahre,214,112,102
False,8316024,Malterdingen,55 - 60 Jahre,165,83,82
False,8316024,Malterdingen,60 - 65 Jahre,118,60,58
False,8316024,Malterdingen,65 - 75 Jahre,269,131,138
False,8316024,Malterdingen,75 und mehr Jahre,180,62,118
False,8316024,Malterdingen,Insgesamt,2928,1475,1453
False,8316036,Reute,unter 3 Jahre,82,55,27
False,8316036,Reute,3 -  6 Jahre,103,58,45
False,8316036,Reute,6 - 10 Jahre,180,96,84
False,8316036,Reute,10 - 15 Jahre,189,90,99
False,8316036,Reute,15 - 18 Jahre,122,59,63
False,8316036,Reute,18 - 20 Jahre,93,50,43
False,8316036,Reute,20 - 25 Jahre,181,95,86
False,8316036,Reute,25 - 30 Jahre,148,66,82
False,8316036,Reute,30 - 35 Jahre,197,93,104
False,8316036,Reute,35 - 40 Jahre,313,155,158
False,8316036,Reute,40 - 45 Jahre,358,179,179
False,8316036,Reute,45 - 50 Jahre,230,114,116
False,8316036,Reute,50 - 55 Jahre,218,103,115
False,8316036,Reute,55 - 60 Jahre,173,93,80
False,8316036,Reute,60 - 65 Jahre,143,76,67
False,8316036,Reute,65 - 75 Jahre,276,145,131
False,8316036,Reute,75 und mehr Jahre,133,42,91
False,8316036,Reute,Insgesamt,3139,1569,1570
False,8316037,Riegel am Kaiserstuhl,unter 3 Jahre,86,38,48
False,8316037,Riegel am Kaiserstuhl,3 -  6 Jahre,90,46,44
False,8316037,Riegel am Kaiserstuhl,6 - 10 Jahre,169,83,86
False,8316037,Riegel am Kaiserstuhl,10 - 15 Jahre,220,115,105
False,8316037,Riegel am Kaiserstuhl,15 - 18 Jahre,163,82,81
False,8316037,Riegel am Kaiserstuhl,18 - 20 Jahre,89,38,51
False,8316037,Riegel am Kaiserstuhl,20 - 25 Jahre,229,133,96
False,8316037,Riegel am Kaiserstuhl,25 - 30 Jahre,202,103,99
False,8316037,Riegel am Kaiserstuhl,30 - 35 Jahre,195,77,118
False,8316037,Riegel am Kaiserstuhl,35 - 40 Jahre,333,166,167
False,8316037,Riegel am Kaiserstuhl,40 - 45 Jahre,357,175,182
False,8316037,Riegel am Kaiserstuhl,45 - 50 Jahre,310,157,153
False,8316037,Riegel am Kaiserstuhl,50 - 55 Jahre,256,145,111
False,8316037,Riegel am Kaiserstuhl,55 - 60 Jahre,189,86,103
False,8316037,Riegel am Kaiserstuhl,60 - 65 Jahre,192,89,103
False,8316037,Riegel am Kaiserstuhl,65 - 75 Jahre,286,142,144
False,8316037,Riegel am Kaiserstuhl,75 und mehr Jahre,189,79,110
False,8316037,Riegel am Kaiserstuhl,Insgesamt,3555,1754,1801
False,8316038,Sasbach am Kaiserstuhl,unter 3 Jahre,85,45,40
False,8316038,Sasbach am Kaiserstuhl,3 -  6 Jahre,109,58,51
False,8316038,Sasbach am Kaiserstuhl,6 - 10 Jahre,156,77,79
False,8316038,Sasbach am Kaiserstuhl,10 - 15 Jahre,204,101,103
False,8316038,Sasbach am Kaiserstuhl,15 - 18 Jahre,137,67,70
False,8316038,Sasbach am Kaiserstuhl,18 - 20 Jahre,75,37,38
False,8316038,Sasbach am Kaiserstuhl,20 - 25 Jahre,183,85,98
False,8316038,Sasbach am Kaiserstuhl,25 - 30 Jahre,158,73,85
False,8316038,Sasbach am Kaiserstuhl,30 - 35 Jahre,186,88,98
False,8316038,Sasbach am Kaiserstuhl,35 - 40 Jahre,295,156,139
False,8316038,Sasbach am Kaiserstuhl,40 - 45 Jahre,313,165,148
False,8316038,Sasbach am Kaiserstuhl,45 - 50 Jahre,272,126,146
False,8316038,Sasbach am Kaiserstuhl,50 - 55 Jahre,236,125,111
False,8316038,Sasbach am Kaiserstuhl,55 - 60 Jahre,210,111,99
False,8316038,Sasbach am Kaiserstuhl,60 - 65 Jahre,165,80,85
False,8316038,Sasbach am Kaiserstuhl,65 - 75 Jahre,345,182,163
False,8316038,Sasbach am Kaiserstuhl,75 und mehr Jahre,235,92,143
False,8316038,Sasbach am Kaiserstuhl,Insgesamt,3364,1668,1696
False,8316039,Sexau,unter 3 Jahre,73,34,39
False,8316039,Sexau,3 -  6 Jahre,76,39,37
False,8316039,Sexau,6 - 10 Jahre,147,72,75
False,8316039,Sexau,10 - 15 Jahre,193,95,98
False,8316039,Sexau,15 - 18 Jahre,118,58,60
False,8316039,Sexau,18 - 20 Jahre,74,35,39
False,8316039,Sexau,20 - 25 Jahre,168,85,83
False,8316039,Sexau,25 - 30 Jahre,167,81,86
False,8316039,Sexau,30 - 35 Jahre,155,81,74
False,8316039,Sexau,35 - 40 Jahre,281,135,146
False,8316039,Sexau,40 - 45 Jahre,302,143,159
False,8316039,Sexau,45 - 50 Jahre,272,138,134
False,8316039,Sexau,50 - 55 Jahre,232,128,104
False,8316039,Sexau,55 - 60 Jahre,218,111,107
False,8316039,Sexau,60 - 65 Jahre,180,89,91
False,8316039,Sexau,65 - 75 Jahre,328,161,167
False,8316039,Sexau,75 und mehr Jahre,220,93,127
False,8316039,Sexau,Insgesamt,3204,1578,1626
False,8316042,Simonswald,unter 3 Jahre,75,36,39
False,8316042,Simonswald,3 -  6 Jahre,83,47,36
False,8316042,Simonswald,6 - 10 Jahre,150,76,74
False,8316042,Simonswald,10 - 15 Jahre,188,93,95
False,8316042,Simonswald,15 - 18 Jahre,107,58,49
False,8316042,Simonswald,18 - 20 Jahre,67,34,33
False,8316042,Simonswald,20 - 25 Jahre,183,103,80
False,8316042,Simonswald,25 - 30 Jahre,178,90,88
False,8316042,Simonswald,30 - 35 Jahre,169,85,84
False,8316042,Simonswald,35 - 40 Jahre,253,130,123
False,8316042,Simonswald,40 - 45 Jahre,305,163,142
False,8316042,Simonswald,45 - 50 Jahre,221,111,110
False,8316042,Simonswald,50 - 55 Jahre,206,114,92
False,8316042,Simonswald,55 - 60 Jahre,169,85,84
False,8316042,Simonswald,60 - 65 Jahre,149,70,79
False,8316042,Simonswald,65 - 75 Jahre,306,149,157
False,8316042,Simonswald,75 und mehr Jahre,249,100,149
False,8316042,Simonswald,Insgesamt,3058,1544,1514
False,8316043,Teningen,unter 3 Jahre,308,172,136
False,8316043,Teningen,3 -  6 Jahre,313,158,155
False,8316043,Teningen,6 - 10 Jahre,528,266,262
False,8316043,Teningen,10 - 15 Jahre,690,371,319
False,8316043,Teningen,15 - 18 Jahre,427,222,205
False,8316043,Teningen,18 - 20 Jahre,266,137,129
False,8316043,Teningen,20 - 25 Jahre,582,301,281
False,8316043,Teningen,25 - 30 Jahre,593,314,279
False,8316043,Teningen,30 - 35 Jahre,664,320,344
False,8316043,Teningen,35 - 40 Jahre,1033,531,502
False,8316043,Teningen,40 - 45 Jahre,1044,517,527
False,8316043,Teningen,45 - 50 Jahre,943,478,465
False,8316043,Teningen,50 - 55 Jahre,851,422,429
False,8316043,Teningen,55 - 60 Jahre,718,386,332
False,8316043,Teningen,60 - 65 Jahre,653,324,329
False,8316043,Teningen,65 - 75 Jahre,1405,662,743
False,8316043,Teningen,75 und mehr Jahre,878,324,554
False,8316043,Teningen,Insgesamt,11896,5905,5991
False,8316045,Vörstetten,unter 3 Jahre,77,32,45
False,8316045,Vörstetten,3 -  6 Jahre,80,41,39
False,8316045,Vörstetten,6 - 10 Jahre,108,51,57
False,8316045,Vörstetten,10 - 15 Jahre,180,110,70
False,8316045,Vörstetten,15 - 18 Jahre,108,57,51
False,8316045,Vörstetten,18 - 20 Jahre,68,33,35
False,8316045,Vörstetten,20 - 25 Jahre,150,66,84
False,8316045,Vörstetten,25 - 30 Jahre,156,73,83
False,8316045,Vörstetten,30 - 35 Jahre,164,80,84
False,8316045,Vörstetten,35 - 40 Jahre,249,114,135
False,8316045,Vörstetten,40 - 45 Jahre,295,166,129
False,8316045,Vörstetten,45 - 50 Jahre,244,114,130
False,8316045,Vörstetten,50 - 55 Jahre,222,106,116
False,8316045,Vörstetten,55 - 60 Jahre,162,90,72
False,8316045,Vörstetten,60 - 65 Jahre,169,85,84
False,8316045,Vörstetten,65 - 75 Jahre,254,126,128
False,8316045,Vörstetten,75 und mehr Jahre,165,69,96
False,8316045,Vörstetten,Insgesamt,2851,1413,1438
False,8316049,Weisweil,unter 3 Jahre,63,32,31
False,8316049,Weisweil,3 -  6 Jahre,58,32,26
False,8316049,Weisweil,6 - 10 Jahre,97,52,45
False,8316049,Weisweil,10 - 15 Jahre,159,63,96
False,8316049,Weisweil,15 - 18 Jahre,108,55,53
False,8316049,Weisweil,18 - 20 Jahre,68,30,38
False,8316049,Weisweil,20 - 25 Jahre,124,75,49
False,8316049,Weisweil,25 - 30 Jahre,93,52,41
False,8316049,Weisweil,30 - 35 Jahre,111,52,59
False,8316049,Weisweil,35 - 40 Jahre,195,93,102
False,8316049,Weisweil,40 - 45 Jahre,220,110,110
False,8316049,Weisweil,45 - 50 Jahre,222,113,109
False,8316049,Weisweil,50 - 55 Jahre,117,62,55
False,8316049,Weisweil,55 - 60 Jahre,111,55,56
False,8316049,Weisweil,60 - 65 Jahre,89,41,48
False,8316049,Weisweil,65 - 75 Jahre,201,92,109
False,8316049,Weisweil,75 und mehr Jahre,117,48,69
False,8316049,Weisweil,Insgesamt,2153,1057,1096
False,8316051,Wyhl am Kaiserstuhl,unter 3 Jahre,89,53,36
False,8316051,Wyhl am Kaiserstuhl,3 -  6 Jahre,116,62,54
False,8316051,Wyhl am Kaiserstuhl,6 - 10 Jahre,187,87,100
False,8316051,Wyhl am Kaiserstuhl,10 - 15 Jahre,232,123,109
False,8316051,Wyhl am Kaiserstuhl,15 - 18 Jahre,149,82,67
False,8316051,Wyhl am Kaiserstuhl,18 - 20 Jahre,104,50,54
False,8316051,Wyhl am Kaiserstuhl,20 - 25 Jahre,238,125,113
False,8316051,Wyhl am Kaiserstuhl,25 - 30 Jahre,208,94,114
False,8316051,Wyhl am Kaiserstuhl,30 - 35 Jahre,214,114,100
False,8316051,Wyhl am Kaiserstuhl,35 - 40 Jahre,342,166,176
False,8316051,Wyhl am Kaiserstuhl,40 - 45 Jahre,361,186,175
False,8316051,Wyhl am Kaiserstuhl,45 - 50 Jahre,354,167,187
False,8316051,Wyhl am Kaiserstuhl,50 - 55 Jahre,248,149,99
False,8316051,Wyhl am Kaiserstuhl,55 - 60 Jahre,181,95,86
False,8316051,Wyhl am Kaiserstuhl,60 - 65 Jahre,138,69,69
False,8316051,Wyhl am Kaiserstuhl,65 - 75 Jahre,302,142,160
False,8316051,Wyhl am Kaiserstuhl,75 und mehr Jahre,204,78,126
False,8316051,Wyhl am Kaiserstuhl,Insgesamt,3667,1842,1825
False,8316053,Rheinhausen,unter 3 Jahre,126,60,66
False,8316053,Rheinhausen,3 -  6 Jahre,116,59,57
False,8316053,Rheinhausen,6 - 10 Jahre,180,109,71
False,8316053,Rheinhausen,10 - 15 Jahre,211,107,104
False,8316053,Rheinhausen,15 - 18 Jahre,135,72,63
False,8316053,Rheinhausen,18 - 20 Jahre,77,48,29
False,8316053,Rheinhausen,20 - 25 Jahre,167,83,84
False,8316053,Rheinhausen,25 - 30 Jahre,182,90,92
False,8316053,Rheinhausen,30 - 35 Jahre,196,104,92
False,8316053,Rheinhausen,35 - 40 Jahre,302,153,149
False,8316053,Rheinhausen,40 - 45 Jahre,325,174,151
False,8316053,Rheinhausen,45 - 50 Jahre,257,124,133
False,8316053,Rheinhausen,50 - 55 Jahre,200,104,96
False,8316053,Rheinhausen,55 - 60 Jahre,190,108,82
False,8316053,Rheinhausen,60 - 65 Jahre,163,73,90
False,8316053,Rheinhausen,65 - 75 Jahre,360,166,194
False,8316053,Rheinhausen,75 und mehr Jahre,202,60,142
False,8316053,Rheinhausen,Insgesamt,3389,1694,1695
False,8316054,Freiamt,unter 3 Jahre,115,63,52
False,8316054,Freiamt,3 -  6 Jahre,151,76,75
False,8316054,Freiamt,6 - 10 Jahre,214,113,101
False,8316054,Freiamt,10 - 15 Jahre,262,141,121
False,8316054,Freiamt,15 - 18 Jahre,161,91,70
False,8316054,Freiamt,18 - 20 Jahre,87,41,46
False,8316054,Freiamt,20 - 25 Jahre,218,109,109
False,8316054,Freiamt,25 - 30 Jahre,194,107,87
False,8316054,Freiamt,30 - 35 Jahre,236,116,120
False,8316054,Freiamt,35 - 40 Jahre,356,186,170
False,8316054,Freiamt,40 - 45 Jahre,402,212,190
False,8316054,Freiamt,45 - 50 Jahre,339,175,164
False,8316054,Freiamt,50 - 55 Jahre,311,157,154
False,8316054,Freiamt,55 - 60 Jahre,245,127,118
False,8316054,Freiamt,60 - 65 Jahre,189,88,101
False,8316054,Freiamt,65 - 75 Jahre,460,222,238
False,8316054,Freiamt,75 und mehr Jahre,336,123,213
False,8316054,Freiamt,Insgesamt,4276,2147,2129
False,8316055,Winden im Elztal,unter 3 Jahre,80,43,37
False,8316055,Winden im Elztal,3 -  6 Jahre,75,43,32
False,8316055,Winden im Elztal,6 - 10 Jahre,155,85,70
False,8316055,Winden im Elztal,10 - 15 Jahre,176,84,92
False,8316055,Winden im Elztal,15 - 18 Jahre,102,50,52
False,8316055,Winden im Elztal,18 - 20 Jahre,83,49,34
False,8316055,Winden im Elztal,20 - 25 Jahre,168,94,74
False,8316055,Winden im Elztal,25 - 30 Jahre,172,92,80
False,8316055,Winden im Elztal,30 - 35 Jahre,173,85,88
False,8316055,Winden im Elztal,35 - 40 Jahre,245,130,115
False,8316055,Winden im Elztal,40 - 45 Jahre,249,126,123
False,8316055,Winden im Elztal,45 - 50 Jahre,247,131,116
False,8316055,Winden im Elztal,50 - 55 Jahre,201,103,98
False,8316055,Winden im Elztal,55 - 60 Jahre,153,80,73
False,8316055,Winden im Elztal,60 - 65 Jahre,100,53,47
False,8316055,Winden im Elztal,65 - 75 Jahre,294,132,162
False,8316055,Winden im Elztal,75 und mehr Jahre,196,67,129
False,8316055,Winden im Elztal,Insgesamt,2869,1447,1422
False,8316056,"Waldkirch, Stadt",unter 3 Jahre,584,322,262
False,8316056,"Waldkirch, Stadt",3 -  6 Jahre,618,316,302
False,8316056,"Waldkirch, Stadt",6 - 10 Jahre,873,433,440
False,8316056,"Waldkirch, Stadt",10 - 15 Jahre,1129,593,536
False,8316056,"Waldkirch, Stadt",15 - 18 Jahre,687,350,337
False,8316056,"Waldkirch, Stadt",18 - 20 Jahre,462,223,239
False,8316056,"Waldkirch, Stadt",20 - 25 Jahre,1144,592,552
False,8316056,"Waldkirch, Stadt",25 - 30 Jahre,984,471,513
False,8316056,"Waldkirch, Stadt",30 - 35 Jahre,1159,552,607
False,8316056,"Waldkirch, Stadt",35 - 40 Jahre,1622,813,809
False,8316056,"Waldkirch, Stadt",40 - 45 Jahre,1712,841,871
False,8316056,"Waldkirch, Stadt",45 - 50 Jahre,1521,769,752
False,8316056,"Waldkirch, Stadt",50 - 55 Jahre,1330,649,681
False,8316056,"Waldkirch, Stadt",55 - 60 Jahre,1145,567,578
False,8316056,"Waldkirch, Stadt",60 - 65 Jahre,1237,550,687
False,8316056,"Waldkirch, Stadt",65 - 75 Jahre,2406,1153,1253
False,8316056,"Waldkirch, Stadt",75 und mehr Jahre,1820,595,1225
False,8316056,"Waldkirch, Stadt",Insgesamt,20433,9789,10644
False,8317,Landkreis Ortenaukreis,unter 3 Jahre,11202,5789,5413
False,8317,Landkreis Ortenaukreis,3 -  6 Jahre,12526,6385,6141
False,8317,Landkreis Ortenaukreis,6 - 10 Jahre,18615,9654,8961
False,8317,Landkreis Ortenaukreis,10 - 15 Jahre,24716,12595,12121
False,8317,Landkreis Ortenaukreis,15 - 18 Jahre,16203,8330,7873
False,8317,Landkreis Ortenaukreis,18 - 20 Jahre,10539,5411,5128
False,8317,Landkreis Ortenaukreis,20 - 25 Jahre,23940,12420,11520
False,8317,Landkreis Ortenaukreis,25 - 30 Jahre,22345,11280,11065
False,8317,Landkreis Ortenaukreis,30 - 35 Jahre,24377,12187,12190
False,8317,Landkreis Ortenaukreis,35 - 40 Jahre,33734,17035,16699
False,8317,Landkreis Ortenaukreis,40 - 45 Jahre,36095,18403,17692
False,8317,Landkreis Ortenaukreis,45 - 50 Jahre,32289,16404,15885
False,8317,Landkreis Ortenaukreis,50 - 55 Jahre,28535,14400,14135
False,8317,Landkreis Ortenaukreis,55 - 60 Jahre,23045,11652,11393
False,8317,Landkreis Ortenaukreis,60 - 65 Jahre,20096,9875,10221
False,8317,Landkreis Ortenaukreis,65 - 75 Jahre,44013,20873,23140
False,8317,Landkreis Ortenaukreis,75 und mehr Jahre,34140,11535,22605
False,8317,Landkreis Ortenaukreis,Insgesamt,416410,204228,212182
False,8317001,"Achern, Stadt",unter 3 Jahre,708,361,347
False,8317001,"Achern, Stadt",3 -  6 Jahre,744,394,350
False,8317001,"Achern, Stadt",6 - 10 Jahre,1178,590,588
False,8317001,"Achern, Stadt",10 - 15 Jahre,1540,813,727
False,8317001,"Achern, Stadt",15 - 18 Jahre,978,496,482
False,8317001,"Achern, Stadt",18 - 20 Jahre,599,303,296
False,8317001,"Achern, Stadt",20 - 25 Jahre,1484,789,695
False,8317001,"Achern, Stadt",25 - 30 Jahre,1353,667,686
False,8317001,"Achern, Stadt",30 - 35 Jahre,1452,748,704
False,8317001,"Achern, Stadt",35 - 40 Jahre,2010,984,1026
False,8317001,"Achern, Stadt",40 - 45 Jahre,2086,1072,1014
False,8317001,"Achern, Stadt",45 - 50 Jahre,1838,891,947
False,8317001,"Achern, Stadt",50 - 55 Jahre,1704,886,818
False,8317001,"Achern, Stadt",55 - 60 Jahre,1305,652,653
False,8317001,"Achern, Stadt",60 - 65 Jahre,1202,563,639
False,8317001,"Achern, Stadt",65 - 75 Jahre,2452,1143,1309
False,8317001,"Achern, Stadt",75 und mehr Jahre,2048,664,1384
False,8317001,"Achern, Stadt",Insgesamt,24681,12016,12665
False,8317005,Appenweier,unter 3 Jahre,237,138,99
False,8317005,Appenweier,3 -  6 Jahre,277,141,136
False,8317005,Appenweier,6 - 10 Jahre,453,250,203
False,8317005,Appenweier,10 - 15 Jahre,581,299,282
False,8317005,Appenweier,15 - 18 Jahre,396,210,186
False,8317005,Appenweier,18 - 20 Jahre,252,117,135
False,8317005,Appenweier,20 - 25 Jahre,542,296,246
False,8317005,Appenweier,25 - 30 Jahre,557,281,276
False,8317005,Appenweier,30 - 35 Jahre,549,288,261
False,8317005,Appenweier,35 - 40 Jahre,769,382,387
False,8317005,Appenweier,40 - 45 Jahre,862,412,450
False,8317005,Appenweier,45 - 50 Jahre,781,387,394
False,8317005,Appenweier,50 - 55 Jahre,700,337,363
False,8317005,Appenweier,55 - 60 Jahre,585,285,300
False,8317005,Appenweier,60 - 65 Jahre,463,233,230
False,8317005,Appenweier,65 - 75 Jahre,961,485,476
False,8317005,Appenweier,75 und mehr Jahre,743,235,508
False,8317005,Appenweier,Insgesamt,9708,4776,4932
False,8317008,Bad Peterstal-Griesbach,unter 3 Jahre,54,28,26
False,8317008,Bad Peterstal-Griesbach,3 -  6 Jahre,71,45,26
False,8317008,Bad Peterstal-Griesbach,6 - 10 Jahre,117,58,59
False,8317008,Bad Peterstal-Griesbach,10 - 15 Jahre,147,79,68
False,8317008,Bad Peterstal-Griesbach,15 - 18 Jahre,102,49,53
False,8317008,Bad Peterstal-Griesbach,18 - 20 Jahre,106,47,59
False,8317008,Bad Peterstal-Griesbach,20 - 25 Jahre,185,82,103
False,8317008,Bad Peterstal-Griesbach,25 - 30 Jahre,142,69,73
False,8317008,Bad Peterstal-Griesbach,30 - 35 Jahre,151,79,72
False,8317008,Bad Peterstal-Griesbach,35 - 40 Jahre,221,124,97
False,8317008,Bad Peterstal-Griesbach,40 - 45 Jahre,189,91,98
False,8317008,Bad Peterstal-Griesbach,45 - 50 Jahre,192,90,102
False,8317008,Bad Peterstal-Griesbach,50 - 55 Jahre,175,96,79
False,8317008,Bad Peterstal-Griesbach,55 - 60 Jahre,153,69,84
False,8317008,Bad Peterstal-Griesbach,60 - 65 Jahre,140,67,73
False,8317008,Bad Peterstal-Griesbach,65 - 75 Jahre,391,196,195
False,8317008,Bad Peterstal-Griesbach,75 und mehr Jahre,317,99,218
False,8317008,Bad Peterstal-Griesbach,Insgesamt,2853,1368,1485
False,8317009,Berghaupten,unter 3 Jahre,62,34,28
False,8317009,Berghaupten,3 -  6 Jahre,89,52,37
False,8317009,Berghaupten,6 - 10 Jahre,110,57,53
False,8317009,Berghaupten,10 - 15 Jahre,136,74,62
False,8317009,Berghaupten,15 - 18 Jahre,108,53,55
False,8317009,Berghaupten,18 - 20 Jahre,56,31,25
False,8317009,Berghaupten,20 - 25 Jahre,127,64,63
False,8317009,Berghaupten,25 - 30 Jahre,125,59,66
False,8317009,Berghaupten,30 - 35 Jahre,125,67,58
False,8317009,Berghaupten,35 - 40 Jahre,218,114,104
False,8317009,Berghaupten,40 - 45 Jahre,218,112,106
False,8317009,Berghaupten,45 - 50 Jahre,187,100,87
False,8317009,Berghaupten,50 - 55 Jahre,156,80,76
False,8317009,Berghaupten,55 - 60 Jahre,158,79,79
False,8317009,Berghaupten,60 - 65 Jahre,106,51,55
False,8317009,Berghaupten,65 - 75 Jahre,249,124,125
False,8317009,Berghaupten,75 und mehr Jahre,160,60,100
False,8317009,Berghaupten,Insgesamt,2390,1211,1179
False,8317011,Biberach,unter 3 Jahre,89,45,44
False,8317011,Biberach,3 -  6 Jahre,92,46,46
False,8317011,Biberach,6 - 10 Jahre,137,74,63
False,8317011,Biberach,10 - 15 Jahre,217,99,118
False,8317011,Biberach,15 - 18 Jahre,135,63,72
False,8317011,Biberach,18 - 20 Jahre,101,51,50
False,8317011,Biberach,20 - 25 Jahre,201,114,87
False,8317011,Biberach,25 - 30 Jahre,168,89,79
False,8317011,Biberach,30 - 35 Jahre,194,94,100
False,8317011,Biberach,35 - 40 Jahre,284,162,122
False,8317011,Biberach,40 - 45 Jahre,282,139,143
False,8317011,Biberach,45 - 50 Jahre,267,136,131
False,8317011,Biberach,50 - 55 Jahre,229,123,106
False,8317011,Biberach,55 - 60 Jahre,165,85,80
False,8317011,Biberach,60 - 65 Jahre,147,72,75
False,8317011,Biberach,65 - 75 Jahre,349,164,185
False,8317011,Biberach,75 und mehr Jahre,248,79,169
False,8317011,Biberach,Insgesamt,3305,1635,1670
False,8317021,Durbach,unter 3 Jahre,113,54,59
False,8317021,Durbach,3 -  6 Jahre,111,57,54
False,8317021,Durbach,6 - 10 Jahre,157,82,75
False,8317021,Durbach,10 - 15 Jahre,202,105,97
False,8317021,Durbach,15 - 18 Jahre,147,78,69
False,8317021,Durbach,18 - 20 Jahre,105,56,49
False,8317021,Durbach,20 - 25 Jahre,215,100,115
False,8317021,Durbach,25 - 30 Jahre,188,95,93
False,8317021,Durbach,30 - 35 Jahre,209,102,107
False,8317021,Durbach,35 - 40 Jahre,314,161,153
False,8317021,Durbach,40 - 45 Jahre,359,187,172
False,8317021,Durbach,45 - 50 Jahre,301,159,142
False,8317021,Durbach,50 - 55 Jahre,292,135,157
False,8317021,Durbach,55 - 60 Jahre,267,148,119
False,8317021,Durbach,60 - 65 Jahre,224,104,120
False,8317021,Durbach,65 - 75 Jahre,413,207,206
False,8317021,Durbach,75 und mehr Jahre,298,110,188
False,8317021,Durbach,Insgesamt,3915,1940,1975
False,8317026,"Ettenheim, Stadt",unter 3 Jahre,295,155,140
False,8317026,"Ettenheim, Stadt",3 -  6 Jahre,360,174,186
False,8317026,"Ettenheim, Stadt",6 - 10 Jahre,547,268,279
False,8317026,"Ettenheim, Stadt",10 - 15 Jahre,736,344,392
False,8317026,"Ettenheim, Stadt",15 - 18 Jahre,485,232,253
False,8317026,"Ettenheim, Stadt",18 - 20 Jahre,299,153,146
False,8317026,"Ettenheim, Stadt",20 - 25 Jahre,637,314,323
False,8317026,"Ettenheim, Stadt",25 - 30 Jahre,610,315,295
False,8317026,"Ettenheim, Stadt",30 - 35 Jahre,741,390,351
False,8317026,"Ettenheim, Stadt",35 - 40 Jahre,1070,557,513
False,8317026,"Ettenheim, Stadt",40 - 45 Jahre,1102,532,570
False,8317026,"Ettenheim, Stadt",45 - 50 Jahre,985,496,489
False,8317026,"Ettenheim, Stadt",50 - 55 Jahre,799,405,394
False,8317026,"Ettenheim, Stadt",55 - 60 Jahre,608,317,291
False,8317026,"Ettenheim, Stadt",60 - 65 Jahre,531,265,266
False,8317026,"Ettenheim, Stadt",65 - 75 Jahre,1237,595,642
False,8317026,"Ettenheim, Stadt",75 und mehr Jahre,893,279,614
False,8317026,"Ettenheim, Stadt",Insgesamt,11935,5791,6144
False,8317029,Fischerbach,unter 3 Jahre,56,33,23
False,8317029,Fischerbach,3 -  6 Jahre,50,28,22
False,8317029,Fischerbach,6 - 10 Jahre,102,57,45
False,8317029,Fischerbach,10 - 15 Jahre,111,60,51
False,8317029,Fischerbach,15 - 18 Jahre,72,46,26
False,8317029,Fischerbach,18 - 20 Jahre,45,26,19
False,8317029,Fischerbach,20 - 25 Jahre,93,50,43
False,8317029,Fischerbach,25 - 30 Jahre,83,52,31
False,8317029,Fischerbach,30 - 35 Jahre,98,42,56
False,8317029,Fischerbach,35 - 40 Jahre,145,69,76
False,8317029,Fischerbach,40 - 45 Jahre,146,73,73
False,8317029,Fischerbach,45 - 50 Jahre,142,80,62
False,8317029,Fischerbach,50 - 55 Jahre,89,46,43
False,8317029,Fischerbach,55 - 60 Jahre,71,32,39
False,8317029,Fischerbach,60 - 65 Jahre,84,36,48
False,8317029,Fischerbach,65 - 75 Jahre,205,101,104
False,8317029,Fischerbach,75 und mehr Jahre,113,50,63
False,8317029,Fischerbach,Insgesamt,1705,881,824
False,8317031,Friesenheim,unter 3 Jahre,349,169,180
False,8317031,Friesenheim,3 -  6 Jahre,366,182,184
False,8317031,Friesenheim,6 - 10 Jahre,565,324,241
False,8317031,Friesenheim,10 - 15 Jahre,759,399,360
False,8317031,Friesenheim,15 - 18 Jahre,486,254,232
False,8317031,Friesenheim,18 - 20 Jahre,319,176,143
False,8317031,Friesenheim,20 - 25 Jahre,778,383,395
False,8317031,Friesenheim,25 - 30 Jahre,713,378,335
False,8317031,Friesenheim,30 - 35 Jahre,699,339,360
False,8317031,Friesenheim,35 - 40 Jahre,1043,519,524
False,8317031,Friesenheim,40 - 45 Jahre,1143,576,567
False,8317031,Friesenheim,45 - 50 Jahre,1083,542,541
False,8317031,Friesenheim,50 - 55 Jahre,891,455,436
False,8317031,Friesenheim,55 - 60 Jahre,651,324,327
False,8317031,Friesenheim,60 - 65 Jahre,608,300,308
False,8317031,Friesenheim,65 - 75 Jahre,1228,563,665
False,8317031,Friesenheim,75 und mehr Jahre,1040,366,674
False,8317031,Friesenheim,Insgesamt,12721,6249,6472
False,8317034,"Gengenbach, Stadt",unter 3 Jahre,290,151,139
False,8317034,"Gengenbach, Stadt",3 -  6 Jahre,271,128,143
False,8317034,"Gengenbach, Stadt",6 - 10 Jahre,401,234,167
False,8317034,"Gengenbach, Stadt",10 - 15 Jahre,574,278,296
False,8317034,"Gengenbach, Stadt",15 - 18 Jahre,409,205,204
False,8317034,"Gengenbach, Stadt",18 - 20 Jahre,237,121,116
False,8317034,"Gengenbach, Stadt",20 - 25 Jahre,624,351,273
False,8317034,"Gengenbach, Stadt",25 - 30 Jahre,571,298,273
False,8317034,"Gengenbach, Stadt",30 - 35 Jahre,593,306,287
False,8317034,"Gengenbach, Stadt",35 - 40 Jahre,878,388,490
False,8317034,"Gengenbach, Stadt",40 - 45 Jahre,953,460,493
False,8317034,"Gengenbach, Stadt",45 - 50 Jahre,779,380,399
False,8317034,"Gengenbach, Stadt",50 - 55 Jahre,779,376,403
False,8317034,"Gengenbach, Stadt",55 - 60 Jahre,659,342,317
False,8317034,"Gengenbach, Stadt",60 - 65 Jahre,593,296,297
False,8317034,"Gengenbach, Stadt",65 - 75 Jahre,1294,611,683
False,8317034,"Gengenbach, Stadt",75 und mehr Jahre,1209,361,848
False,8317034,"Gengenbach, Stadt",Insgesamt,11114,5286,5828
False,8317039,Gutach (Schwarzwaldbahn),unter 3 Jahre,56,24,32
False,8317039,Gutach (Schwarzwaldbahn),3 -  6 Jahre,69,38,31
False,8317039,Gutach (Schwarzwaldbahn),6 - 10 Jahre,103,52,51
False,8317039,Gutach (Schwarzwaldbahn),10 - 15 Jahre,116,53,63
False,8317039,Gutach (Schwarzwaldbahn),15 - 18 Jahre,76,41,35
False,8317039,Gutach (Schwarzwaldbahn),18 - 20 Jahre,49,24,25
False,8317039,Gutach (Schwarzwaldbahn),20 - 25 Jahre,130,68,62
False,8317039,Gutach (Schwarzwaldbahn),25 - 30 Jahre,107,59,48
False,8317039,Gutach (Schwarzwaldbahn),30 - 35 Jahre,126,74,52
False,8317039,Gutach (Schwarzwaldbahn),35 - 40 Jahre,178,88,90
False,8317039,Gutach (Schwarzwaldbahn),40 - 45 Jahre,172,92,80
False,8317039,Gutach (Schwarzwaldbahn),45 - 50 Jahre,158,79,79
False,8317039,Gutach (Schwarzwaldbahn),50 - 55 Jahre,137,72,65
False,8317039,Gutach (Schwarzwaldbahn),55 - 60 Jahre,121,58,63
False,8317039,Gutach (Schwarzwaldbahn),60 - 65 Jahre,134,68,66
False,8317039,Gutach (Schwarzwaldbahn),65 - 75 Jahre,286,143,143
False,8317039,Gutach (Schwarzwaldbahn),75 und mehr Jahre,202,76,126
False,8317039,Gutach (Schwarzwaldbahn),Insgesamt,2220,1109,1111
False,8317040,"Haslach im Kinzigtal, Stadt",unter 3 Jahre,204,117,87
False,8317040,"Haslach im Kinzigtal, Stadt",3 -  6 Jahre,182,107,75
False,8317040,"Haslach im Kinzigtal, Stadt",6 - 10 Jahre,314,167,147
False,8317040,"Haslach im Kinzigtal, Stadt",10 - 15 Jahre,415,189,226
False,8317040,"Haslach im Kinzigtal, Stadt",15 - 18 Jahre,265,142,123
False,8317040,"Haslach im Kinzigtal, Stadt",18 - 20 Jahre,157,82,75
False,8317040,"Haslach im Kinzigtal, Stadt",20 - 25 Jahre,371,197,174
False,8317040,"Haslach im Kinzigtal, Stadt",25 - 30 Jahre,362,172,190
False,8317040,"Haslach im Kinzigtal, Stadt",30 - 35 Jahre,443,237,206
False,8317040,"Haslach im Kinzigtal, Stadt",35 - 40 Jahre,528,263,265
False,8317040,"Haslach im Kinzigtal, Stadt",40 - 45 Jahre,620,308,312
False,8317040,"Haslach im Kinzigtal, Stadt",45 - 50 Jahre,537,266,271
False,8317040,"Haslach im Kinzigtal, Stadt",50 - 55 Jahre,432,225,207
False,8317040,"Haslach im Kinzigtal, Stadt",55 - 60 Jahre,336,169,167
False,8317040,"Haslach im Kinzigtal, Stadt",60 - 65 Jahre,317,147,170
False,8317040,"Haslach im Kinzigtal, Stadt",65 - 75 Jahre,773,373,400
False,8317040,"Haslach im Kinzigtal, Stadt",75 und mehr Jahre,619,186,433
False,8317040,"Haslach im Kinzigtal, Stadt",Insgesamt,6875,3347,3528
False,8317041,"Hausach, Stadt",unter 3 Jahre,156,82,74
False,8317041,"Hausach, Stadt",3 -  6 Jahre,156,72,84
False,8317041,"Hausach, Stadt",6 - 10 Jahre,246,130,116
False,8317041,"Hausach, Stadt",10 - 15 Jahre,347,181,166
False,8317041,"Hausach, Stadt",15 - 18 Jahre,213,103,110
False,8317041,"Hausach, Stadt",18 - 20 Jahre,161,88,73
False,8317041,"Hausach, Stadt",20 - 25 Jahre,356,187,169
False,8317041,"Hausach, Stadt",25 - 30 Jahre,312,145,167
False,8317041,"Hausach, Stadt",30 - 35 Jahre,315,167,148
False,8317041,"Hausach, Stadt",35 - 40 Jahre,441,234,207
False,8317041,"Hausach, Stadt",40 - 45 Jahre,498,246,252
False,8317041,"Hausach, Stadt",45 - 50 Jahre,446,238,208
False,8317041,"Hausach, Stadt",50 - 55 Jahre,401,203,198
False,8317041,"Hausach, Stadt",55 - 60 Jahre,307,153,154
False,8317041,"Hausach, Stadt",60 - 65 Jahre,263,128,135
False,8317041,"Hausach, Stadt",65 - 75 Jahre,671,314,357
False,8317041,"Hausach, Stadt",75 und mehr Jahre,541,184,357
False,8317041,"Hausach, Stadt",Insgesamt,5830,2855,2975
False,8317046,Hofstetten,unter 3 Jahre,53,24,29
False,8317046,Hofstetten,3 -  6 Jahre,75,42,33
False,8317046,Hofstetten,6 - 10 Jahre,109,54,55
False,8317046,Hofstetten,10 - 15 Jahre,92,48,44
False,8317046,Hofstetten,15 - 18 Jahre,56,31,25
False,8317046,Hofstetten,18 - 20 Jahre,39,23,16
False,8317046,Hofstetten,20 - 25 Jahre,113,58,55
False,8317046,Hofstetten,25 - 30 Jahre,100,45,55
False,8317046,Hofstetten,30 - 35 Jahre,110,65,45
False,8317046,Hofstetten,35 - 40 Jahre,149,84,65
False,8317046,Hofstetten,40 - 45 Jahre,149,79,70
False,8317046,Hofstetten,45 - 50 Jahre,108,52,56
False,8317046,Hofstetten,50 - 55 Jahre,108,60,48
False,8317046,Hofstetten,55 - 60 Jahre,89,43,46
False,8317046,Hofstetten,60 - 65 Jahre,91,41,50
False,8317046,Hofstetten,65 - 75 Jahre,155,83,72
False,8317046,Hofstetten,75 und mehr Jahre,93,35,58
False,8317046,Hofstetten,Insgesamt,1689,867,822
False,8317047,Hohberg,unter 3 Jahre,233,106,127
False,8317047,Hohberg,3 -  6 Jahre,237,123,114
False,8317047,Hohberg,6 - 10 Jahre,379,179,200
False,8317047,Hohberg,10 - 15 Jahre,504,256,248
False,8317047,Hohberg,15 - 18 Jahre,318,170,148
False,8317047,Hohberg,18 - 20 Jahre,198,102,96
False,8317047,Hohberg,20 - 25 Jahre,429,232,197
False,8317047,Hohberg,25 - 30 Jahre,373,183,190
False,8317047,Hohberg,30 - 35 Jahre,424,206,218
False,8317047,Hohberg,35 - 40 Jahre,667,319,348
False,8317047,Hohberg,40 - 45 Jahre,711,374,337
False,8317047,Hohberg,45 - 50 Jahre,642,336,306
False,8317047,Hohberg,50 - 55 Jahre,554,272,282
False,8317047,Hohberg,55 - 60 Jahre,434,223,211
False,8317047,Hohberg,60 - 65 Jahre,353,180,173
False,8317047,Hohberg,65 - 75 Jahre,778,365,413
False,8317047,Hohberg,75 und mehr Jahre,595,207,388
False,8317047,Hohberg,Insgesamt,7829,3833,3996
False,8317051,"Hornberg, Stadt",unter 3 Jahre,128,60,68
False,8317051,"Hornberg, Stadt",3 -  6 Jahre,127,61,66
False,8317051,"Hornberg, Stadt",6 - 10 Jahre,169,88,81
False,8317051,"Hornberg, Stadt",10 - 15 Jahre,225,112,113
False,8317051,"Hornberg, Stadt",15 - 18 Jahre,135,72,63
False,8317051,"Hornberg, Stadt",18 - 20 Jahre,108,47,61
False,8317051,"Hornberg, Stadt",20 - 25 Jahre,236,130,106
False,8317051,"Hornberg, Stadt",25 - 30 Jahre,236,107,129
False,8317051,"Hornberg, Stadt",30 - 35 Jahre,247,141,106
False,8317051,"Hornberg, Stadt",35 - 40 Jahre,319,164,155
False,8317051,"Hornberg, Stadt",40 - 45 Jahre,326,172,154
False,8317051,"Hornberg, Stadt",45 - 50 Jahre,361,183,178
False,8317051,"Hornberg, Stadt",50 - 55 Jahre,307,167,140
False,8317051,"Hornberg, Stadt",55 - 60 Jahre,280,156,124
False,8317051,"Hornberg, Stadt",60 - 65 Jahre,207,93,114
False,8317051,"Hornberg, Stadt",65 - 75 Jahre,535,244,291
False,8317051,"Hornberg, Stadt",75 und mehr Jahre,441,151,290
False,8317051,"Hornberg, Stadt",Insgesamt,4387,2148,2239
False,8317056,Kappelrodeck,unter 3 Jahre,142,75,67
False,8317056,Kappelrodeck,3 -  6 Jahre,198,96,102
False,8317056,Kappelrodeck,6 - 10 Jahre,247,110,137
False,8317056,Kappelrodeck,10 - 15 Jahre,362,195,167
False,8317056,Kappelrodeck,15 - 18 Jahre,228,117,111
False,8317056,Kappelrodeck,18 - 20 Jahre,153,79,74
False,8317056,Kappelrodeck,20 - 25 Jahre,317,166,151
False,8317056,Kappelrodeck,25 - 30 Jahre,328,174,154
False,8317056,Kappelrodeck,30 - 35 Jahre,336,164,172
False,8317056,Kappelrodeck,35 - 40 Jahre,475,258,217
False,8317056,Kappelrodeck,40 - 45 Jahre,474,252,222
False,8317056,Kappelrodeck,45 - 50 Jahre,456,237,219
False,8317056,Kappelrodeck,50 - 55 Jahre,382,199,183
False,8317056,Kappelrodeck,55 - 60 Jahre,317,154,163
False,8317056,Kappelrodeck,60 - 65 Jahre,259,110,149
False,8317056,Kappelrodeck,65 - 75 Jahre,651,314,337
False,8317056,Kappelrodeck,75 und mehr Jahre,492,174,318
False,8317056,Kappelrodeck,Insgesamt,5817,2874,2943
False,8317057,"Kehl, Stadt",unter 3 Jahre,922,462,460
False,8317057,"Kehl, Stadt",3 -  6 Jahre,1048,521,527
False,8317057,"Kehl, Stadt",6 - 10 Jahre,1463,725,738
False,8317057,"Kehl, Stadt",10 - 15 Jahre,1891,961,930
False,8317057,"Kehl, Stadt",15 - 18 Jahre,1325,694,631
False,8317057,"Kehl, Stadt",18 - 20 Jahre,830,428,402
False,8317057,"Kehl, Stadt",20 - 25 Jahre,1986,1010,976
False,8317057,"Kehl, Stadt",25 - 30 Jahre,1935,938,997
False,8317057,"Kehl, Stadt",30 - 35 Jahre,2107,1028,1079
False,8317057,"Kehl, Stadt",35 - 40 Jahre,2867,1429,1438
False,8317057,"Kehl, Stadt",40 - 45 Jahre,2733,1354,1379
False,8317057,"Kehl, Stadt",45 - 50 Jahre,2655,1354,1301
False,8317057,"Kehl, Stadt",50 - 55 Jahre,2424,1232,1192
False,8317057,"Kehl, Stadt",55 - 60 Jahre,2091,1044,1047
False,8317057,"Kehl, Stadt",60 - 65 Jahre,1854,951,903
False,8317057,"Kehl, Stadt",65 - 75 Jahre,3668,1726,1942
False,8317057,"Kehl, Stadt",75 und mehr Jahre,2780,963,1817
False,8317057,"Kehl, Stadt",Insgesamt,34579,16820,17759
False,8317059,Kippenheim,unter 3 Jahre,145,79,66
False,8317059,Kippenheim,3 -  6 Jahre,148,82,66
False,8317059,Kippenheim,6 - 10 Jahre,223,115,108
False,8317059,Kippenheim,10 - 15 Jahre,302,156,146
False,8317059,Kippenheim,15 - 18 Jahre,224,119,105
False,8317059,Kippenheim,18 - 20 Jahre,141,62,79
False,8317059,Kippenheim,20 - 25 Jahre,295,142,153
False,8317059,Kippenheim,25 - 30 Jahre,298,152,146
False,8317059,Kippenheim,30 - 35 Jahre,277,135,142
False,8317059,Kippenheim,35 - 40 Jahre,404,219,185
False,8317059,Kippenheim,40 - 45 Jahre,480,226,254
False,8317059,Kippenheim,45 - 50 Jahre,380,204,176
False,8317059,Kippenheim,50 - 55 Jahre,387,198,189
False,8317059,Kippenheim,55 - 60 Jahre,290,159,131
False,8317059,Kippenheim,60 - 65 Jahre,244,119,125
False,8317059,Kippenheim,65 - 75 Jahre,566,271,295
False,8317059,Kippenheim,75 und mehr Jahre,353,132,221
False,8317059,Kippenheim,Insgesamt,5157,2570,2587
False,8317065,"Lahr/Schwarzwald, Stadt",unter 3 Jahre,1281,669,612
False,8317065,"Lahr/Schwarzwald, Stadt",3 -  6 Jahre,1321,684,637
False,8317065,"Lahr/Schwarzwald, Stadt",6 - 10 Jahre,1892,1002,890
False,8317065,"Lahr/Schwarzwald, Stadt",10 - 15 Jahre,2544,1263,1281
False,8317065,"Lahr/Schwarzwald, Stadt",15 - 18 Jahre,1686,830,856
False,8317065,"Lahr/Schwarzwald, Stadt",18 - 20 Jahre,1156,559,597
False,8317065,"Lahr/Schwarzwald, Stadt",20 - 25 Jahre,2748,1395,1353
False,8317065,"Lahr/Schwarzwald, Stadt",25 - 30 Jahre,2515,1280,1235
False,8317065,"Lahr/Schwarzwald, Stadt",30 - 35 Jahre,2635,1337,1298
False,8317065,"Lahr/Schwarzwald, Stadt",35 - 40 Jahre,3436,1728,1708
False,8317065,"Lahr/Schwarzwald, Stadt",40 - 45 Jahre,3537,1829,1708
False,8317065,"Lahr/Schwarzwald, Stadt",45 - 50 Jahre,3215,1599,1616
False,8317065,"Lahr/Schwarzwald, Stadt",50 - 55 Jahre,2955,1485,1470
False,8317065,"Lahr/Schwarzwald, Stadt",55 - 60 Jahre,2361,1182,1179
False,8317065,"Lahr/Schwarzwald, Stadt",60 - 65 Jahre,2031,987,1044
False,8317065,"Lahr/Schwarzwald, Stadt",65 - 75 Jahre,4560,2109,2451
False,8317065,"Lahr/Schwarzwald, Stadt",75 und mehr Jahre,3775,1232,2543
False,8317065,"Lahr/Schwarzwald, Stadt",Insgesamt,43648,21170,22478
False,8317067,Lautenbach,unter 3 Jahre,56,24,32
False,8317067,Lautenbach,3 -  6 Jahre,53,29,24
False,8317067,Lautenbach,6 - 10 Jahre,82,45,37
False,8317067,Lautenbach,10 - 15 Jahre,98,50,48
False,8317067,Lautenbach,15 - 18 Jahre,55,27,28
False,8317067,Lautenbach,18 - 20 Jahre,49,29,20
False,8317067,Lautenbach,20 - 25 Jahre,109,62,47
False,8317067,Lautenbach,25 - 30 Jahre,100,49,51
False,8317067,Lautenbach,30 - 35 Jahre,106,57,49
False,8317067,Lautenbach,35 - 40 Jahre,166,96,70
False,8317067,Lautenbach,40 - 45 Jahre,174,89,85
False,8317067,Lautenbach,45 - 50 Jahre,157,83,74
False,8317067,Lautenbach,50 - 55 Jahre,135,67,68
False,8317067,Lautenbach,55 - 60 Jahre,122,66,56
False,8317067,Lautenbach,60 - 65 Jahre,78,38,40
False,8317067,Lautenbach,65 - 75 Jahre,241,117,124
False,8317067,Lautenbach,75 und mehr Jahre,127,53,74
False,8317067,Lautenbach,Insgesamt,1908,981,927
False,8317068,Lauf,unter 3 Jahre,96,51,45
False,8317068,Lauf,3 -  6 Jahre,122,61,61
False,8317068,Lauf,6 - 10 Jahre,184,94,90
False,8317068,Lauf,10 - 15 Jahre,255,133,122
False,8317068,Lauf,15 - 18 Jahre,138,66,72
False,8317068,Lauf,18 - 20 Jahre,96,61,35
False,8317068,Lauf,20 - 25 Jahre,204,120,84
False,8317068,Lauf,25 - 30 Jahre,186,94,92
False,8317068,Lauf,30 - 35 Jahre,234,115,119
False,8317068,Lauf,35 - 40 Jahre,271,131,140
False,8317068,Lauf,40 - 45 Jahre,358,186,172
False,8317068,Lauf,45 - 50 Jahre,316,156,160
False,8317068,Lauf,50 - 55 Jahre,307,145,162
False,8317068,Lauf,55 - 60 Jahre,224,112,112
False,8317068,Lauf,60 - 65 Jahre,213,106,107
False,8317068,Lauf,65 - 75 Jahre,427,197,230
False,8317068,Lauf,75 und mehr Jahre,359,138,221
False,8317068,Lauf,Insgesamt,3990,1966,2024
False,8317073,"Mahlberg, Stadt",unter 3 Jahre,124,65,59
False,8317073,"Mahlberg, Stadt",3 -  6 Jahre,123,72,51
False,8317073,"Mahlberg, Stadt",6 - 10 Jahre,204,110,94
False,8317073,"Mahlberg, Stadt",10 - 15 Jahre,295,156,139
False,8317073,"Mahlberg, Stadt",15 - 18 Jahre,184,91,93
False,8317073,"Mahlberg, Stadt",18 - 20 Jahre,142,68,74
False,8317073,"Mahlberg, Stadt",20 - 25 Jahre,299,150,149
False,8317073,"Mahlberg, Stadt",25 - 30 Jahre,266,125,141
False,8317073,"Mahlberg, Stadt",30 - 35 Jahre,243,128,115
False,8317073,"Mahlberg, Stadt",35 - 40 Jahre,386,187,199
False,8317073,"Mahlberg, Stadt",40 - 45 Jahre,477,234,243
False,8317073,"Mahlberg, Stadt",45 - 50 Jahre,392,201,191
False,8317073,"Mahlberg, Stadt",50 - 55 Jahre,301,155,146
False,8317073,"Mahlberg, Stadt",55 - 60 Jahre,250,128,122
False,8317073,"Mahlberg, Stadt",60 - 65 Jahre,177,95,82
False,8317073,"Mahlberg, Stadt",65 - 75 Jahre,361,158,203
False,8317073,"Mahlberg, Stadt",75 und mehr Jahre,246,89,157
False,8317073,"Mahlberg, Stadt",Insgesamt,4470,2212,2258
False,8317075,Meißenheim,unter 3 Jahre,84,40,44
False,8317075,Meißenheim,3 -  6 Jahre,121,68,53
False,8317075,Meißenheim,6 - 10 Jahre,164,81,83
False,8317075,Meißenheim,10 - 15 Jahre,225,113,112
False,8317075,Meißenheim,15 - 18 Jahre,155,85,70
False,8317075,Meißenheim,18 - 20 Jahre,75,45,30
False,8317075,Meißenheim,20 - 25 Jahre,166,84,82
False,8317075,Meißenheim,25 - 30 Jahre,162,89,73
False,8317075,Meißenheim,30 - 35 Jahre,197,86,111
False,8317075,Meißenheim,35 - 40 Jahre,335,189,146
False,8317075,Meißenheim,40 - 45 Jahre,331,178,153
False,8317075,Meißenheim,45 - 50 Jahre,326,171,155
False,8317075,Meißenheim,50 - 55 Jahre,273,134,139
False,8317075,Meißenheim,55 - 60 Jahre,202,105,97
False,8317075,Meißenheim,60 - 65 Jahre,170,81,89
False,8317075,Meißenheim,65 - 75 Jahre,382,182,200
False,8317075,Meißenheim,75 und mehr Jahre,275,107,168
False,8317075,Meißenheim,Insgesamt,3643,1838,1805
False,8317078,Mühlenbach,unter 3 Jahre,51,27,24
False,8317078,Mühlenbach,3 -  6 Jahre,59,40,19
False,8317078,Mühlenbach,6 - 10 Jahre,99,54,45
False,8317078,Mühlenbach,10 - 15 Jahre,114,58,56
False,8317078,Mühlenbach,15 - 18 Jahre,89,40,49
False,8317078,Mühlenbach,18 - 20 Jahre,33,17,16
False,8317078,Mühlenbach,20 - 25 Jahre,84,46,38
False,8317078,Mühlenbach,25 - 30 Jahre,100,43,57
False,8317078,Mühlenbach,30 - 35 Jahre,116,63,53
False,8317078,Mühlenbach,35 - 40 Jahre,161,79,82
False,8317078,Mühlenbach,40 - 45 Jahre,143,73,70
False,8317078,Mühlenbach,45 - 50 Jahre,114,68,46
False,8317078,Mühlenbach,50 - 55 Jahre,105,59,46
False,8317078,Mühlenbach,55 - 60 Jahre,73,34,39
False,8317078,Mühlenbach,60 - 65 Jahre,59,28,31
False,8317078,Mühlenbach,65 - 75 Jahre,185,101,84
False,8317078,Mühlenbach,75 und mehr Jahre,127,46,81
False,8317078,Mühlenbach,Insgesamt,1712,876,836
False,8317085,Nordrach,unter 3 Jahre,41,20,21
False,8317085,Nordrach,3 -  6 Jahre,76,38,38
False,8317085,Nordrach,6 - 10 Jahre,114,54,60
False,8317085,Nordrach,10 - 15 Jahre,133,65,68
False,8317085,Nordrach,15 - 18 Jahre,69,35,34
False,8317085,Nordrach,18 - 20 Jahre,45,25,20
False,8317085,Nordrach,20 - 25 Jahre,107,65,42
False,8317085,Nordrach,25 - 30 Jahre,85,39,46
False,8317085,Nordrach,30 - 35 Jahre,85,38,47
False,8317085,Nordrach,35 - 40 Jahre,200,112,88
False,8317085,Nordrach,40 - 45 Jahre,177,91,86
False,8317085,Nordrach,45 - 50 Jahre,161,95,66
False,8317085,Nordrach,50 - 55 Jahre,139,78,61
False,8317085,Nordrach,55 - 60 Jahre,122,65,57
False,8317085,Nordrach,60 - 65 Jahre,103,66,37
False,8317085,Nordrach,65 - 75 Jahre,246,126,120
False,8317085,Nordrach,75 und mehr Jahre,140,48,92
False,8317085,Nordrach,Insgesamt,2043,1060,983
False,8317088,Oberharmersbach,unter 3 Jahre,57,28,29
False,8317088,Oberharmersbach,3 -  6 Jahre,91,51,40
False,8317088,Oberharmersbach,6 - 10 Jahre,147,76,71
False,8317088,Oberharmersbach,10 - 15 Jahre,196,98,98
False,8317088,Oberharmersbach,15 - 18 Jahre,110,58,52
False,8317088,Oberharmersbach,18 - 20 Jahre,91,50,41
False,8317088,Oberharmersbach,20 - 25 Jahre,155,85,70
False,8317088,Oberharmersbach,25 - 30 Jahre,118,69,49
False,8317088,Oberharmersbach,30 - 35 Jahre,124,57,67
False,8317088,Oberharmersbach,35 - 40 Jahre,202,106,96
False,8317088,Oberharmersbach,40 - 45 Jahre,245,130,115
False,8317088,Oberharmersbach,45 - 50 Jahre,203,110,93
False,8317088,Oberharmersbach,50 - 55 Jahre,152,87,65
False,8317088,Oberharmersbach,55 - 60 Jahre,110,52,58
False,8317088,Oberharmersbach,60 - 65 Jahre,87,46,41
False,8317088,Oberharmersbach,65 - 75 Jahre,294,139,155
False,8317088,Oberharmersbach,75 und mehr Jahre,181,61,120
False,8317088,Oberharmersbach,Insgesamt,2563,1303,1260
False,8317089,"Oberkirch, Stadt",unter 3 Jahre,543,292,251
False,8317089,"Oberkirch, Stadt",3 -  6 Jahre,652,328,324
False,8317089,"Oberkirch, Stadt",6 - 10 Jahre,925,484,441
False,8317089,"Oberkirch, Stadt",10 - 15 Jahre,1335,678,657
False,8317089,"Oberkirch, Stadt",15 - 18 Jahre,913,493,420
False,8317089,"Oberkirch, Stadt",18 - 20 Jahre,549,271,278
False,8317089,"Oberkirch, Stadt",20 - 25 Jahre,1208,631,577
False,8317089,"Oberkirch, Stadt",25 - 30 Jahre,1010,531,479
False,8317089,"Oberkirch, Stadt",30 - 35 Jahre,1149,560,589
False,8317089,"Oberkirch, Stadt",35 - 40 Jahre,1605,806,799
False,8317089,"Oberkirch, Stadt",40 - 45 Jahre,1748,893,855
False,8317089,"Oberkirch, Stadt",45 - 50 Jahre,1568,813,755
False,8317089,"Oberkirch, Stadt",50 - 55 Jahre,1316,663,653
False,8317089,"Oberkirch, Stadt",55 - 60 Jahre,1063,547,516
False,8317089,"Oberkirch, Stadt",60 - 65 Jahre,920,461,459
False,8317089,"Oberkirch, Stadt",65 - 75 Jahre,2052,986,1066
False,8317089,"Oberkirch, Stadt",75 und mehr Jahre,1581,562,1019
False,8317089,"Oberkirch, Stadt",Insgesamt,20137,9999,10138
False,8317093,Oberwolfach,unter 3 Jahre,84,41,43
False,8317093,Oberwolfach,3 -  6 Jahre,107,46,61
False,8317093,Oberwolfach,6 - 10 Jahre,135,67,68
False,8317093,Oberwolfach,10 - 15 Jahre,180,98,82
False,8317093,Oberwolfach,15 - 18 Jahre,93,44,49
False,8317093,Oberwolfach,18 - 20 Jahre,65,26,39
False,8317093,Oberwolfach,20 - 25 Jahre,164,89,75
False,8317093,Oberwolfach,25 - 30 Jahre,146,69,77
False,8317093,Oberwolfach,30 - 35 Jahre,146,76,70
False,8317093,Oberwolfach,35 - 40 Jahre,223,115,108
False,8317093,Oberwolfach,40 - 45 Jahre,237,142,95
False,8317093,Oberwolfach,45 - 50 Jahre,193,86,107
False,8317093,Oberwolfach,50 - 55 Jahre,162,77,85
False,8317093,Oberwolfach,55 - 60 Jahre,122,68,54
False,8317093,Oberwolfach,60 - 65 Jahre,128,68,60
False,8317093,Oberwolfach,65 - 75 Jahre,304,142,162
False,8317093,Oberwolfach,75 und mehr Jahre,247,94,153
False,8317093,Oberwolfach,Insgesamt,2736,1348,1388
False,8317096,"Offenburg, Stadt",unter 3 Jahre,1579,792,787
False,8317096,"Offenburg, Stadt",3 -  6 Jahre,1683,829,854
False,8317096,"Offenburg, Stadt",6 - 10 Jahre,2459,1278,1181
False,8317096,"Offenburg, Stadt",10 - 15 Jahre,3212,1688,1524
False,8317096,"Offenburg, Stadt",15 - 18 Jahre,2124,1118,1006
False,8317096,"Offenburg, Stadt",18 - 20 Jahre,1445,768,677
False,8317096,"Offenburg, Stadt",20 - 25 Jahre,3386,1746,1640
False,8317096,"Offenburg, Stadt",25 - 30 Jahre,3397,1729,1668
False,8317096,"Offenburg, Stadt",30 - 35 Jahre,3617,1723,1894
False,8317096,"Offenburg, Stadt",35 - 40 Jahre,4593,2336,2257
False,8317096,"Offenburg, Stadt",40 - 45 Jahre,4803,2437,2366
False,8317096,"Offenburg, Stadt",45 - 50 Jahre,4557,2279,2278
False,8317096,"Offenburg, Stadt",50 - 55 Jahre,4037,1968,2069
False,8317096,"Offenburg, Stadt",55 - 60 Jahre,3349,1634,1715
False,8317096,"Offenburg, Stadt",60 - 65 Jahre,3082,1465,1617
False,8317096,"Offenburg, Stadt",65 - 75 Jahre,6315,2932,3383
False,8317096,"Offenburg, Stadt",75 und mehr Jahre,5155,1721,3434
False,8317096,"Offenburg, Stadt",Insgesamt,58793,28443,30350
False,8317097,Ohlsbach,unter 3 Jahre,92,51,41
False,8317097,Ohlsbach,3 -  6 Jahre,120,68,52
False,8317097,Ohlsbach,6 - 10 Jahre,160,85,75
False,8317097,Ohlsbach,10 - 15 Jahre,182,96,86
False,8317097,Ohlsbach,15 - 18 Jahre,120,66,54
False,8317097,Ohlsbach,18 - 20 Jahre,78,40,38
False,8317097,Ohlsbach,20 - 25 Jahre,165,86,79
False,8317097,Ohlsbach,25 - 30 Jahre,137,72,65
False,8317097,Ohlsbach,30 - 35 Jahre,177,80,97
False,8317097,Ohlsbach,35 - 40 Jahre,297,137,160
False,8317097,Ohlsbach,40 - 45 Jahre,298,156,142
False,8317097,Ohlsbach,45 - 50 Jahre,248,135,113
False,8317097,Ohlsbach,50 - 55 Jahre,224,99,125
False,8317097,Ohlsbach,55 - 60 Jahre,196,96,100
False,8317097,Ohlsbach,60 - 65 Jahre,154,83,71
False,8317097,Ohlsbach,65 - 75 Jahre,316,155,161
False,8317097,Ohlsbach,75 und mehr Jahre,214,91,123
False,8317097,Ohlsbach,Insgesamt,3178,1596,1582
False,8317098,"Oppenau, Stadt",unter 3 Jahre,154,78,76
False,8317098,"Oppenau, Stadt",3 -  6 Jahre,147,84,63
False,8317098,"Oppenau, Stadt",6 - 10 Jahre,223,111,112
False,8317098,"Oppenau, Stadt",10 - 15 Jahre,297,153,144
False,8317098,"Oppenau, Stadt",15 - 18 Jahre,223,114,109
False,8317098,"Oppenau, Stadt",18 - 20 Jahre,129,63,66
False,8317098,"Oppenau, Stadt",20 - 25 Jahre,272,148,124
False,8317098,"Oppenau, Stadt",25 - 30 Jahre,233,116,117
False,8317098,"Oppenau, Stadt",30 - 35 Jahre,268,138,130
False,8317098,"Oppenau, Stadt",35 - 40 Jahre,396,218,178
False,8317098,"Oppenau, Stadt",40 - 45 Jahre,406,211,195
False,8317098,"Oppenau, Stadt",45 - 50 Jahre,348,175,173
False,8317098,"Oppenau, Stadt",50 - 55 Jahre,336,183,153
False,8317098,"Oppenau, Stadt",55 - 60 Jahre,245,126,119
False,8317098,"Oppenau, Stadt",60 - 65 Jahre,210,107,103
False,8317098,"Oppenau, Stadt",65 - 75 Jahre,603,289,314
False,8317098,"Oppenau, Stadt",75 und mehr Jahre,551,170,381
False,8317098,"Oppenau, Stadt",Insgesamt,5041,2484,2557
False,8317100,Ortenberg,unter 3 Jahre,86,44,42
False,8317100,Ortenberg,3 -  6 Jahre,106,53,53
False,8317100,Ortenberg,6 - 10 Jahre,158,83,75
False,8317100,Ortenberg,10 - 15 Jahre,193,98,95
False,8317100,Ortenberg,15 - 18 Jahre,99,43,56
False,8317100,Ortenberg,18 - 20 Jahre,74,41,33
False,8317100,Ortenberg,20 - 25 Jahre,139,70,69
False,8317100,Ortenberg,25 - 30 Jahre,150,77,73
False,8317100,Ortenberg,30 - 35 Jahre,195,83,112
False,8317100,Ortenberg,35 - 40 Jahre,270,146,124
False,8317100,Ortenberg,40 - 45 Jahre,308,161,147
False,8317100,Ortenberg,45 - 50 Jahre,252,134,118
False,8317100,Ortenberg,50 - 55 Jahre,232,113,119
False,8317100,Ortenberg,55 - 60 Jahre,171,82,89
False,8317100,Ortenberg,60 - 65 Jahre,174,88,86
False,8317100,Ortenberg,65 - 75 Jahre,355,171,184
False,8317100,Ortenberg,75 und mehr Jahre,295,107,188
False,8317100,Ortenberg,Insgesamt,3257,1594,1663
False,8317102,Ottenhöfen im Schwarzwald,unter 3 Jahre,88,48,40
False,8317102,Ottenhöfen im Schwarzwald,3 -  6 Jahre,105,44,61
False,8317102,Ottenhöfen im Schwarzwald,6 - 10 Jahre,172,82,90
False,8317102,Ottenhöfen im Schwarzwald,10 - 15 Jahre,217,108,109
False,8317102,Ottenhöfen im Schwarzwald,15 - 18 Jahre,159,80,79
False,8317102,Ottenhöfen im Schwarzwald,18 - 20 Jahre,78,42,36
False,8317102,Ottenhöfen im Schwarzwald,20 - 25 Jahre,207,101,106
False,8317102,Ottenhöfen im Schwarzwald,25 - 30 Jahre,155,81,74
False,8317102,Ottenhöfen im Schwarzwald,30 - 35 Jahre,174,83,91
False,8317102,Ottenhöfen im Schwarzwald,35 - 40 Jahre,269,138,131
False,8317102,Ottenhöfen im Schwarzwald,40 - 45 Jahre,282,142,140
False,8317102,Ottenhöfen im Schwarzwald,45 - 50 Jahre,219,121,98
False,8317102,Ottenhöfen im Schwarzwald,50 - 55 Jahre,171,88,83
False,8317102,Ottenhöfen im Schwarzwald,55 - 60 Jahre,167,81,86
False,8317102,Ottenhöfen im Schwarzwald,60 - 65 Jahre,154,78,76
False,8317102,Ottenhöfen im Schwarzwald,65 - 75 Jahre,367,174,193
False,8317102,Ottenhöfen im Schwarzwald,75 und mehr Jahre,336,120,216
False,8317102,Ottenhöfen im Schwarzwald,Insgesamt,3320,1611,1709
False,8317110,"Renchen, Stadt",unter 3 Jahre,219,133,86
False,8317110,"Renchen, Stadt",3 -  6 Jahre,201,95,106
False,8317110,"Renchen, Stadt",6 - 10 Jahre,323,173,150
False,8317110,"Renchen, Stadt",10 - 15 Jahre,478,231,247
False,8317110,"Renchen, Stadt",15 - 18 Jahre,308,146,162
False,8317110,"Renchen, Stadt",18 - 20 Jahre,206,103,103
False,8317110,"Renchen, Stadt",20 - 25 Jahre,420,226,194
False,8317110,"Renchen, Stadt",25 - 30 Jahre,386,201,185
False,8317110,"Renchen, Stadt",30 - 35 Jahre,456,217,239
False,8317110,"Renchen, Stadt",35 - 40 Jahre,611,300,311
False,8317110,"Renchen, Stadt",40 - 45 Jahre,713,367,346
False,8317110,"Renchen, Stadt",45 - 50 Jahre,570,286,284
False,8317110,"Renchen, Stadt",50 - 55 Jahre,528,272,256
False,8317110,"Renchen, Stadt",55 - 60 Jahre,351,191,160
False,8317110,"Renchen, Stadt",60 - 65 Jahre,324,166,158
False,8317110,"Renchen, Stadt",65 - 75 Jahre,731,344,387
False,8317110,"Renchen, Stadt",75 und mehr Jahre,504,180,324
False,8317110,"Renchen, Stadt",Insgesamt,7329,3631,3698
False,8317113,Ringsheim,unter 3 Jahre,58,40,18
False,8317113,Ringsheim,3 -  6 Jahre,74,45,29
False,8317113,Ringsheim,6 - 10 Jahre,99,61,38
False,8317113,Ringsheim,10 - 15 Jahre,101,47,54
False,8317113,Ringsheim,15 - 18 Jahre,57,27,30
False,8317113,Ringsheim,18 - 20 Jahre,55,25,30
False,8317113,Ringsheim,20 - 25 Jahre,126,57,69
False,8317113,Ringsheim,25 - 30 Jahre,135,63,72
False,8317113,Ringsheim,30 - 35 Jahre,128,74,54
False,8317113,Ringsheim,35 - 40 Jahre,190,102,88
False,8317113,Ringsheim,40 - 45 Jahre,194,96,98
False,8317113,Ringsheim,45 - 50 Jahre,158,85,73
False,8317113,Ringsheim,50 - 55 Jahre,158,84,74
False,8317113,Ringsheim,55 - 60 Jahre,119,61,58
False,8317113,Ringsheim,60 - 65 Jahre,104,54,50
False,8317113,Ringsheim,65 - 75 Jahre,257,128,129
False,8317113,Ringsheim,75 und mehr Jahre,154,57,97
False,8317113,Ringsheim,Insgesamt,2167,1106,1061
False,8317114,Rust,unter 3 Jahre,74,39,35
False,8317114,Rust,3 -  6 Jahre,115,66,49
False,8317114,Rust,6 - 10 Jahre,170,91,79
False,8317114,Rust,10 - 15 Jahre,221,107,114
False,8317114,Rust,15 - 18 Jahre,151,78,73
False,8317114,Rust,18 - 20 Jahre,98,46,52
False,8317114,Rust,20 - 25 Jahre,263,122,141
False,8317114,Rust,25 - 30 Jahre,241,116,125
False,8317114,Rust,30 - 35 Jahre,233,120,113
False,8317114,Rust,35 - 40 Jahre,322,148,174
False,8317114,Rust,40 - 45 Jahre,314,151,163
False,8317114,Rust,45 - 50 Jahre,291,157,134
False,8317114,Rust,50 - 55 Jahre,237,123,114
False,8317114,Rust,55 - 60 Jahre,225,128,97
False,8317114,Rust,60 - 65 Jahre,152,82,70
False,8317114,Rust,65 - 75 Jahre,300,138,162
False,8317114,Rust,75 und mehr Jahre,179,54,125
False,8317114,Rust,Insgesamt,3586,1766,1820
False,8317116,Sasbach,unter 3 Jahre,112,58,54
False,8317116,Sasbach,3 -  6 Jahre,158,71,87
False,8317116,Sasbach,6 - 10 Jahre,247,112,135
False,8317116,Sasbach,10 - 15 Jahre,310,155,155
False,8317116,Sasbach,15 - 18 Jahre,208,118,90
False,8317116,Sasbach,18 - 20 Jahre,139,73,66
False,8317116,Sasbach,20 - 25 Jahre,311,171,140
False,8317116,Sasbach,25 - 30 Jahre,304,168,136
False,8317116,Sasbach,30 - 35 Jahre,365,187,178
False,8317116,Sasbach,35 - 40 Jahre,474,279,195
False,8317116,Sasbach,40 - 45 Jahre,492,274,218
False,8317116,Sasbach,45 - 50 Jahre,401,206,195
False,8317116,Sasbach,50 - 55 Jahre,355,178,177
False,8317116,Sasbach,55 - 60 Jahre,312,158,154
False,8317116,Sasbach,60 - 65 Jahre,248,109,139
False,8317116,Sasbach,65 - 75 Jahre,544,253,291
False,8317116,Sasbach,75 und mehr Jahre,464,143,321
False,8317116,Sasbach,Insgesamt,5444,2713,2731
False,8317118,Sasbachwalden,unter 3 Jahre,64,33,31
False,8317118,Sasbachwalden,3 -  6 Jahre,70,38,32
False,8317118,Sasbachwalden,6 - 10 Jahre,108,53,55
False,8317118,Sasbachwalden,10 - 15 Jahre,123,62,61
False,8317118,Sasbachwalden,15 - 18 Jahre,67,32,35
False,8317118,Sasbachwalden,18 - 20 Jahre,57,37,20
False,8317118,Sasbachwalden,20 - 25 Jahre,119,60,59
False,8317118,Sasbachwalden,25 - 30 Jahre,117,60,57
False,8317118,Sasbachwalden,30 - 35 Jahre,129,69,60
False,8317118,Sasbachwalden,35 - 40 Jahre,225,118,107
False,8317118,Sasbachwalden,40 - 45 Jahre,217,116,101
False,8317118,Sasbachwalden,45 - 50 Jahre,195,110,85
False,8317118,Sasbachwalden,50 - 55 Jahre,188,93,95
False,8317118,Sasbachwalden,55 - 60 Jahre,149,70,79
False,8317118,Sasbachwalden,60 - 65 Jahre,145,68,77
False,8317118,Sasbachwalden,65 - 75 Jahre,330,164,166
False,8317118,Sasbachwalden,75 und mehr Jahre,267,94,173
False,8317118,Sasbachwalden,Insgesamt,2570,1277,1293
False,8317121,Schuttertal,unter 3 Jahre,109,53,56
False,8317121,Schuttertal,3 -  6 Jahre,117,46,71
False,8317121,Schuttertal,6 - 10 Jahre,180,97,83
False,8317121,Schuttertal,10 - 15 Jahre,213,116,97
False,8317121,Schuttertal,15 - 18 Jahre,170,82,88
False,8317121,Schuttertal,18 - 20 Jahre,95,52,43
False,8317121,Schuttertal,20 - 25 Jahre,173,103,70
False,8317121,Schuttertal,25 - 30 Jahre,147,73,74
False,8317121,Schuttertal,30 - 35 Jahre,178,89,89
False,8317121,Schuttertal,35 - 40 Jahre,261,138,123
False,8317121,Schuttertal,40 - 45 Jahre,319,174,145
False,8317121,Schuttertal,45 - 50 Jahre,262,136,126
False,8317121,Schuttertal,50 - 55 Jahre,195,105,90
False,8317121,Schuttertal,55 - 60 Jahre,156,90,66
False,8317121,Schuttertal,60 - 65 Jahre,133,63,70
False,8317121,Schuttertal,65 - 75 Jahre,346,164,182
False,8317121,Schuttertal,75 und mehr Jahre,248,88,160
False,8317121,Schuttertal,Insgesamt,3302,1669,1633
False,8317122,Schutterwald,unter 3 Jahre,183,99,84
False,8317122,Schutterwald,3 -  6 Jahre,201,109,92
False,8317122,Schutterwald,6 - 10 Jahre,315,177,138
False,8317122,Schutterwald,10 - 15 Jahre,457,242,215
False,8317122,Schutterwald,15 - 18 Jahre,273,161,112
False,8317122,Schutterwald,18 - 20 Jahre,166,101,65
False,8317122,Schutterwald,20 - 25 Jahre,357,196,161
False,8317122,Schutterwald,25 - 30 Jahre,275,140,135
False,8317122,Schutterwald,30 - 35 Jahre,382,201,181
False,8317122,Schutterwald,35 - 40 Jahre,597,290,307
False,8317122,Schutterwald,40 - 45 Jahre,648,326,322
False,8317122,Schutterwald,45 - 50 Jahre,572,307,265
False,8317122,Schutterwald,50 - 55 Jahre,493,243,250
False,8317122,Schutterwald,55 - 60 Jahre,433,223,210
False,8317122,Schutterwald,60 - 65 Jahre,372,175,197
False,8317122,Schutterwald,65 - 75 Jahre,855,426,429
False,8317122,Schutterwald,75 und mehr Jahre,536,201,335
False,8317122,Schutterwald,Insgesamt,7115,3617,3498
False,8317126,Seebach,unter 3 Jahre,49,27,22
False,8317126,Seebach,3 -  6 Jahre,63,34,29
False,8317126,Seebach,6 - 10 Jahre,70,42,28
False,8317126,Seebach,10 - 15 Jahre,110,55,55
False,8317126,Seebach,15 - 18 Jahre,55,22,33
False,8317126,Seebach,18 - 20 Jahre,27,15,12
False,8317126,Seebach,20 - 25 Jahre,94,50,44
False,8317126,Seebach,25 - 30 Jahre,91,44,47
False,8317126,Seebach,30 - 35 Jahre,102,58,44
False,8317126,Seebach,35 - 40 Jahre,129,66,63
False,8317126,Seebach,40 - 45 Jahre,127,56,71
False,8317126,Seebach,45 - 50 Jahre,124,72,52
False,8317126,Seebach,50 - 55 Jahre,81,45,36
False,8317126,Seebach,55 - 60 Jahre,63,23,40
False,8317126,Seebach,60 - 65 Jahre,51,27,24
False,8317126,Seebach,65 - 75 Jahre,179,79,100
False,8317126,Seebach,75 und mehr Jahre,118,45,73
False,8317126,Seebach,Insgesamt,1533,760,773
False,8317127,Seelbach,unter 3 Jahre,105,55,50
False,8317127,Seelbach,3 -  6 Jahre,136,63,73
False,8317127,Seelbach,6 - 10 Jahre,206,111,95
False,8317127,Seelbach,10 - 15 Jahre,305,140,165
False,8317127,Seelbach,15 - 18 Jahre,222,120,102
False,8317127,Seelbach,18 - 20 Jahre,138,74,64
False,8317127,Seelbach,20 - 25 Jahre,263,138,125
False,8317127,Seelbach,25 - 30 Jahre,265,149,116
False,8317127,Seelbach,30 - 35 Jahre,244,135,109
False,8317127,Seelbach,35 - 40 Jahre,353,166,187
False,8317127,Seelbach,40 - 45 Jahre,503,255,248
False,8317127,Seelbach,45 - 50 Jahre,425,219,206
False,8317127,Seelbach,50 - 55 Jahre,338,167,171
False,8317127,Seelbach,55 - 60 Jahre,328,173,155
False,8317127,Seelbach,60 - 65 Jahre,274,147,127
False,8317127,Seelbach,65 - 75 Jahre,604,283,321
False,8317127,Seelbach,75 und mehr Jahre,476,152,324
False,8317127,Seelbach,Insgesamt,5185,2547,2638
False,8317129,Steinach,unter 3 Jahre,114,56,58
False,8317129,Steinach,3 -  6 Jahre,144,80,64
False,8317129,Steinach,6 - 10 Jahre,188,92,96
False,8317129,Steinach,10 - 15 Jahre,227,111,116
False,8317129,Steinach,15 - 18 Jahre,180,88,92
False,8317129,Steinach,18 - 20 Jahre,103,53,50
False,8317129,Steinach,20 - 25 Jahre,223,112,111
False,8317129,Steinach,25 - 30 Jahre,203,100,103
False,8317129,Steinach,30 - 35 Jahre,262,138,124
False,8317129,Steinach,35 - 40 Jahre,319,172,147
False,8317129,Steinach,40 - 45 Jahre,384,207,177
False,8317129,Steinach,45 - 50 Jahre,315,172,143
False,8317129,Steinach,50 - 55 Jahre,273,138,135
False,8317129,Steinach,55 - 60 Jahre,173,93,80
False,8317129,Steinach,60 - 65 Jahre,149,72,77
False,8317129,Steinach,65 - 75 Jahre,409,195,214
False,8317129,Steinach,75 und mehr Jahre,284,105,179
False,8317129,Steinach,Insgesamt,3950,1984,1966
False,8317141,Willstätt,unter 3 Jahre,235,115,120
False,8317141,Willstätt,3 -  6 Jahre,297,149,148
False,8317141,Willstätt,6 - 10 Jahre,431,216,215
False,8317141,Willstätt,10 - 15 Jahre,556,301,255
False,8317141,Willstätt,15 - 18 Jahre,376,188,188
False,8317141,Willstätt,18 - 20 Jahre,241,128,113
False,8317141,Willstätt,20 - 25 Jahre,505,245,260
False,8317141,Willstätt,25 - 30 Jahre,466,231,235
False,8317141,Willstätt,30 - 35 Jahre,574,277,297
False,8317141,Willstätt,35 - 40 Jahre,781,388,393
False,8317141,Willstätt,40 - 45 Jahre,864,460,404
False,8317141,Willstätt,45 - 50 Jahre,758,380,378
False,8317141,Willstätt,50 - 55 Jahre,678,333,345
False,8317141,Willstätt,55 - 60 Jahre,533,273,260
False,8317141,Willstätt,60 - 65 Jahre,422,213,209
False,8317141,Willstätt,65 - 75 Jahre,886,433,453
False,8317141,Willstätt,75 und mehr Jahre,548,203,345
False,8317141,Willstätt,Insgesamt,9151,4533,4618
False,8317145,"Wolfach, Stadt",unter 3 Jahre,142,76,66
False,8317145,"Wolfach, Stadt",3 -  6 Jahre,164,90,74
False,8317145,"Wolfach, Stadt",6 - 10 Jahre,238,130,108
False,8317145,"Wolfach, Stadt",10 - 15 Jahre,326,176,150
False,8317145,"Wolfach, Stadt",15 - 18 Jahre,191,94,97
False,8317145,"Wolfach, Stadt",18 - 20 Jahre,129,70,59
False,8317145,"Wolfach, Stadt",20 - 25 Jahre,304,157,147
False,8317145,"Wolfach, Stadt",25 - 30 Jahre,316,141,175
False,8317145,"Wolfach, Stadt",30 - 35 Jahre,354,198,156
False,8317145,"Wolfach, Stadt",35 - 40 Jahre,423,210,213
False,8317145,"Wolfach, Stadt",40 - 45 Jahre,553,316,237
False,8317145,"Wolfach, Stadt",45 - 50 Jahre,412,214,198
False,8317145,"Wolfach, Stadt",50 - 55 Jahre,446,220,226
False,8317145,"Wolfach, Stadt",55 - 60 Jahre,334,183,151
False,8317145,"Wolfach, Stadt",60 - 65 Jahre,328,156,172
False,8317145,"Wolfach, Stadt",65 - 75 Jahre,687,337,350
False,8317145,"Wolfach, Stadt",75 und mehr Jahre,587,187,400
False,8317145,"Wolfach, Stadt",Insgesamt,5934,2955,2979
False,8317146,"Zell am Harmersbach, Stadt",unter 3 Jahre,193,103,90
False,8317146,"Zell am Harmersbach, Stadt",3 -  6 Jahre,234,119,115
False,8317146,"Zell am Harmersbach, Stadt",6 - 10 Jahre,366,204,162
False,8317146,"Zell am Harmersbach, Stadt",10 - 15 Jahre,461,242,219
False,8317146,"Zell am Harmersbach, Stadt",15 - 18 Jahre,295,155,140
False,8317146,"Zell am Harmersbach, Stadt",18 - 20 Jahre,222,117,105
False,8317146,"Zell am Harmersbach, Stadt",20 - 25 Jahre,460,235,225
False,8317146,"Zell am Harmersbach, Stadt",25 - 30 Jahre,456,229,227
False,8317146,"Zell am Harmersbach, Stadt",30 - 35 Jahre,489,249,240
False,8317146,"Zell am Harmersbach, Stadt",35 - 40 Jahre,619,324,295
False,8317146,"Zell am Harmersbach, Stadt",40 - 45 Jahre,691,354,337
False,8317146,"Zell am Harmersbach, Stadt",45 - 50 Jahre,604,288,316
False,8317146,"Zell am Harmersbach, Stadt",50 - 55 Jahre,590,298,292
False,8317146,"Zell am Harmersbach, Stadt",55 - 60 Jahre,432,212,220
False,8317146,"Zell am Harmersbach, Stadt",60 - 65 Jahre,430,209,221
False,8317146,"Zell am Harmersbach, Stadt",65 - 75 Jahre,818,395,423
False,8317146,"Zell am Harmersbach, Stadt",75 und mehr Jahre,703,225,478
False,8317146,"Zell am Harmersbach, Stadt",Insgesamt,8063,3958,4105
False,8317150,Schwanau,unter 3 Jahre,195,114,81
False,8317150,Schwanau,3 -  6 Jahre,236,131,105
False,8317150,Schwanau,6 - 10 Jahre,335,172,163
False,8317150,Schwanau,10 - 15 Jahre,390,187,203
False,8317150,Schwanau,15 - 18 Jahre,265,113,152
False,8317150,Schwanau,18 - 20 Jahre,154,83,71
False,8317150,Schwanau,20 - 25 Jahre,373,192,181
False,8317150,Schwanau,25 - 30 Jahre,324,164,160
False,8317150,Schwanau,30 - 35 Jahre,400,184,216
False,8317150,Schwanau,35 - 40 Jahre,571,300,271
False,8317150,Schwanau,40 - 45 Jahre,649,330,319
False,8317150,Schwanau,45 - 50 Jahre,489,238,251
False,8317150,Schwanau,50 - 55 Jahre,439,227,212
False,8317150,Schwanau,55 - 60 Jahre,365,193,172
False,8317150,Schwanau,60 - 65 Jahre,300,144,156
False,8317150,Schwanau,65 - 75 Jahre,742,347,395
False,8317150,Schwanau,75 und mehr Jahre,572,142,430
False,8317150,Schwanau,Insgesamt,6799,3261,3538
False,8317151,Neuried,unter 3 Jahre,265,132,133
False,8317151,Neuried,3 -  6 Jahre,288,133,155
False,8317151,Neuried,6 - 10 Jahre,439,234,205
False,8317151,Neuried,10 - 15 Jahre,617,320,297
False,8317151,Neuried,15 - 18 Jahre,388,203,185
False,8317151,Neuried,18 - 20 Jahre,238,120,118
False,8317151,Neuried,20 - 25 Jahre,545,271,274
False,8317151,Neuried,25 - 30 Jahre,479,230,249
False,8317151,Neuried,30 - 35 Jahre,516,245,271
False,8317151,Neuried,35 - 40 Jahre,781,373,408
False,8317151,Neuried,40 - 45 Jahre,872,454,418
False,8317151,Neuried,45 - 50 Jahre,762,388,374
False,8317151,Neuried,50 - 55 Jahre,626,315,311
False,8317151,Neuried,55 - 60 Jahre,527,263,264
False,8317151,Neuried,60 - 65 Jahre,391,195,196
False,8317151,Neuried,65 - 75 Jahre,909,443,466
False,8317151,Neuried,75 und mehr Jahre,655,223,432
False,8317151,Neuried,Insgesamt,9298,4542,4756
False,8317152,Kappel-Grafenhausen,unter 3 Jahre,122,56,66
False,8317152,Kappel-Grafenhausen,3 -  6 Jahre,158,77,81
False,8317152,Kappel-Grafenhausen,6 - 10 Jahre,237,118,119
False,8317152,Kappel-Grafenhausen,10 - 15 Jahre,355,182,173
False,8317152,Kappel-Grafenhausen,15 - 18 Jahre,206,106,100
False,8317152,Kappel-Grafenhausen,18 - 20 Jahre,133,61,72
False,8317152,Kappel-Grafenhausen,20 - 25 Jahre,278,153,125
False,8317152,Kappel-Grafenhausen,25 - 30 Jahre,282,153,129
False,8317152,Kappel-Grafenhausen,30 - 35 Jahre,304,152,152
False,8317152,Kappel-Grafenhausen,35 - 40 Jahre,421,203,218
False,8317152,Kappel-Grafenhausen,40 - 45 Jahre,477,248,229
False,8317152,Kappel-Grafenhausen,45 - 50 Jahre,403,204,199
False,8317152,Kappel-Grafenhausen,50 - 55 Jahre,322,174,148
False,8317152,Kappel-Grafenhausen,55 - 60 Jahre,243,118,125
False,8317152,Kappel-Grafenhausen,60 - 65 Jahre,212,110,102
False,8317152,Kappel-Grafenhausen,65 - 75 Jahre,421,203,218
False,8317152,Kappel-Grafenhausen,75 und mehr Jahre,285,105,180
False,8317152,Kappel-Grafenhausen,Insgesamt,4859,2423,2436
False,8317153,"Rheinau, Stadt",unter 3 Jahre,255,133,122
False,8317153,"Rheinau, Stadt",3 -  6 Jahre,313,155,158
False,8317153,"Rheinau, Stadt",6 - 10 Jahre,525,251,274
False,8317153,"Rheinau, Stadt",10 - 15 Jahre,733,365,368
False,8317153,"Rheinau, Stadt",15 - 18 Jahre,416,232,184
False,8317153,"Rheinau, Stadt",18 - 20 Jahre,278,132,146
False,8317153,"Rheinau, Stadt",20 - 25 Jahre,594,321,273
False,8317153,"Rheinau, Stadt",25 - 30 Jahre,537,277,260
False,8317153,"Rheinau, Stadt",30 - 35 Jahre,599,298,301
False,8317153,"Rheinau, Stadt",35 - 40 Jahre,867,416,451
False,8317153,"Rheinau, Stadt",40 - 45 Jahre,1051,510,541
False,8317153,"Rheinau, Stadt",45 - 50 Jahre,981,506,475
False,8317153,"Rheinau, Stadt",50 - 55 Jahre,797,417,380
False,8317153,"Rheinau, Stadt",55 - 60 Jahre,638,330,308
False,8317153,"Rheinau, Stadt",60 - 65 Jahre,501,264,237
False,8317153,"Rheinau, Stadt",65 - 75 Jahre,1125,541,584
False,8317153,"Rheinau, Stadt",75 und mehr Jahre,766,281,485
False,8317153,"Rheinau, Stadt",Insgesamt,10976,5429,5547
False,8325,Landkreis Rottweil,unter 3 Jahre,3910,1960,1950
False,8325,Landkreis Rottweil,3 -  6 Jahre,4267,2166,2101
False,8325,Landkreis Rottweil,6 - 10 Jahre,6664,3391,3273
False,8325,Landkreis Rottweil,10 - 15 Jahre,9039,4623,4416
False,8325,Landkreis Rottweil,15 - 18 Jahre,5793,2943,2850
False,8325,Landkreis Rottweil,18 - 20 Jahre,3493,1714,1779
False,8325,Landkreis Rottweil,20 - 25 Jahre,7950,4121,3829
False,8325,Landkreis Rottweil,25 - 30 Jahre,7478,3800,3678
False,8325,Landkreis Rottweil,30 - 35 Jahre,8309,4233,4076
False,8325,Landkreis Rottweil,35 - 40 Jahre,11428,5919,5509
False,8325,Landkreis Rottweil,40 - 45 Jahre,12091,6217,5874
False,8325,Landkreis Rottweil,45 - 50 Jahre,10646,5469,5177
False,8325,Landkreis Rottweil,50 - 55 Jahre,8920,4474,4446
False,8325,Landkreis Rottweil,55 - 60 Jahre,7750,3880,3870
False,8325,Landkreis Rottweil,60 - 65 Jahre,7396,3721,3675
False,8325,Landkreis Rottweil,65 - 75 Jahre,15465,7276,8189
False,8325,Landkreis Rottweil,75 und mehr Jahre,11549,3922,7627
False,8325,Landkreis Rottweil,Insgesamt,142148,69829,72319
False,8325001,Aichhalden,unter 3 Jahre,113,60,53
False,8325001,Aichhalden,3 -  6 Jahre,122,66,56
False,8325001,Aichhalden,6 - 10 Jahre,216,113,103
False,8325001,Aichhalden,10 - 15 Jahre,297,156,141
False,8325001,Aichhalden,15 - 18 Jahre,158,85,73
False,8325001,Aichhalden,18 - 20 Jahre,110,62,48
False,8325001,Aichhalden,20 - 25 Jahre,250,149,101
False,8325001,Aichhalden,25 - 30 Jahre,212,108,104
False,8325001,Aichhalden,30 - 35 Jahre,205,113,92
False,8325001,Aichhalden,35 - 40 Jahre,336,175,161
False,8325001,Aichhalden,40 - 45 Jahre,369,178,191
False,8325001,Aichhalden,45 - 50 Jahre,334,170,164
False,8325001,Aichhalden,50 - 55 Jahre,236,120,116
False,8325001,Aichhalden,55 - 60 Jahre,233,116,117
False,8325001,Aichhalden,60 - 65 Jahre,221,109,112
False,8325001,Aichhalden,65 - 75 Jahre,464,240,224
False,8325001,Aichhalden,75 und mehr Jahre,271,73,198
False,8325001,Aichhalden,Insgesamt,4147,2093,2054
False,8325009,Bösingen,unter 3 Jahre,121,61,60
False,8325009,Bösingen,3 -  6 Jahre,132,72,60
False,8325009,Bösingen,6 - 10 Jahre,202,89,113
False,8325009,Bösingen,10 - 15 Jahre,262,132,130
False,8325009,Bösingen,15 - 18 Jahre,146,64,82
False,8325009,Bösingen,18 - 20 Jahre,96,61,35
False,8325009,Bösingen,20 - 25 Jahre,209,100,109
False,8325009,Bösingen,25 - 30 Jahre,188,98,90
False,8325009,Bösingen,30 - 35 Jahre,228,119,109
False,8325009,Bösingen,35 - 40 Jahre,350,187,163
False,8325009,Bösingen,40 - 45 Jahre,301,165,136
False,8325009,Bösingen,45 - 50 Jahre,260,134,126
False,8325009,Bösingen,50 - 55 Jahre,205,108,97
False,8325009,Bösingen,55 - 60 Jahre,160,80,80
False,8325009,Bösingen,60 - 65 Jahre,164,88,76
False,8325009,Bösingen,65 - 75 Jahre,298,139,159
False,8325009,Bösingen,75 und mehr Jahre,186,71,115
False,8325009,Bösingen,Insgesamt,3508,1768,1740
False,8325011,Dietingen,unter 3 Jahre,122,58,64
False,8325011,Dietingen,3 -  6 Jahre,135,70,65
False,8325011,Dietingen,6 - 10 Jahre,209,94,115
False,8325011,Dietingen,10 - 15 Jahre,264,126,138
False,8325011,Dietingen,15 - 18 Jahre,161,79,82
False,8325011,Dietingen,18 - 20 Jahre,78,36,42
False,8325011,Dietingen,20 - 25 Jahre,190,90,100
False,8325011,Dietingen,25 - 30 Jahre,193,90,103
False,8325011,Dietingen,30 - 35 Jahre,230,106,124
False,8325011,Dietingen,35 - 40 Jahre,356,181,175
False,8325011,Dietingen,40 - 45 Jahre,372,207,165
False,8325011,Dietingen,45 - 50 Jahre,291,141,150
False,8325011,Dietingen,50 - 55 Jahre,231,124,107
False,8325011,Dietingen,55 - 60 Jahre,206,99,107
False,8325011,Dietingen,60 - 65 Jahre,201,100,101
False,8325011,Dietingen,65 - 75 Jahre,445,219,226
False,8325011,Dietingen,75 und mehr Jahre,277,105,172
False,8325011,Dietingen,Insgesamt,3961,1925,2036
False,8325012,"Dornhan, Stadt",unter 3 Jahre,172,87,85
False,8325012,"Dornhan, Stadt",3 -  6 Jahre,204,97,107
False,8325012,"Dornhan, Stadt",6 - 10 Jahre,298,159,139
False,8325012,"Dornhan, Stadt",10 - 15 Jahre,383,190,193
False,8325012,"Dornhan, Stadt",15 - 18 Jahre,268,141,127
False,8325012,"Dornhan, Stadt",18 - 20 Jahre,158,90,68
False,8325012,"Dornhan, Stadt",20 - 25 Jahre,326,180,146
False,8325012,"Dornhan, Stadt",25 - 30 Jahre,300,148,152
False,8325012,"Dornhan, Stadt",30 - 35 Jahre,371,200,171
False,8325012,"Dornhan, Stadt",35 - 40 Jahre,435,214,221
False,8325012,"Dornhan, Stadt",40 - 45 Jahre,582,308,274
False,8325012,"Dornhan, Stadt",45 - 50 Jahre,428,214,214
False,8325012,"Dornhan, Stadt",50 - 55 Jahre,375,193,182
False,8325012,"Dornhan, Stadt",55 - 60 Jahre,357,193,164
False,8325012,"Dornhan, Stadt",60 - 65 Jahre,311,159,152
False,8325012,"Dornhan, Stadt",65 - 75 Jahre,716,348,368
False,8325012,"Dornhan, Stadt",75 und mehr Jahre,482,157,325
False,8325012,"Dornhan, Stadt",Insgesamt,6166,3078,3088
False,8325014,Dunningen,unter 3 Jahre,173,79,94
False,8325014,Dunningen,3 -  6 Jahre,176,85,91
False,8325014,Dunningen,6 - 10 Jahre,295,152,143
False,8325014,Dunningen,10 - 15 Jahre,407,194,213
False,8325014,Dunningen,15 - 18 Jahre,294,162,132
False,8325014,Dunningen,18 - 20 Jahre,171,87,84
False,8325014,Dunningen,20 - 25 Jahre,361,171,190
False,8325014,Dunningen,25 - 30 Jahre,330,170,160
False,8325014,Dunningen,30 - 35 Jahre,356,178,178
False,8325014,Dunningen,35 - 40 Jahre,500,259,241
False,8325014,Dunningen,40 - 45 Jahre,532,271,261
False,8325014,Dunningen,45 - 50 Jahre,491,272,219
False,8325014,Dunningen,50 - 55 Jahre,420,216,204
False,8325014,Dunningen,55 - 60 Jahre,282,148,134
False,8325014,Dunningen,60 - 65 Jahre,235,124,111
False,8325014,Dunningen,65 - 75 Jahre,601,297,304
False,8325014,Dunningen,75 und mehr Jahre,415,145,270
False,8325014,Dunningen,Insgesamt,6039,3010,3029
False,8325015,Epfendorf,unter 3 Jahre,92,53,39
False,8325015,Epfendorf,3 -  6 Jahre,116,60,56
False,8325015,Epfendorf,6 - 10 Jahre,199,86,113
False,8325015,Epfendorf,10 - 15 Jahre,216,123,93
False,8325015,Epfendorf,15 - 18 Jahre,151,71,80
False,8325015,Epfendorf,18 - 20 Jahre,96,43,53
False,8325015,Epfendorf,20 - 25 Jahre,179,94,85
False,8325015,Epfendorf,25 - 30 Jahre,162,73,89
False,8325015,Epfendorf,30 - 35 Jahre,183,82,101
False,8325015,Epfendorf,35 - 40 Jahre,297,166,131
False,8325015,Epfendorf,40 - 45 Jahre,318,145,173
False,8325015,Epfendorf,45 - 50 Jahre,309,172,137
False,8325015,Epfendorf,50 - 55 Jahre,194,97,97
False,8325015,Epfendorf,55 - 60 Jahre,196,105,91
False,8325015,Epfendorf,60 - 65 Jahre,167,81,86
False,8325015,Epfendorf,65 - 75 Jahre,392,182,210
False,8325015,Epfendorf,75 und mehr Jahre,273,90,183
False,8325015,Epfendorf,Insgesamt,3540,1723,1817
False,8325024,Hardt,unter 3 Jahre,89,45,44
False,8325024,Hardt,3 -  6 Jahre,92,42,50
False,8325024,Hardt,6 - 10 Jahre,119,56,63
False,8325024,Hardt,10 - 15 Jahre,184,95,89
False,8325024,Hardt,15 - 18 Jahre,106,52,54
False,8325024,Hardt,18 - 20 Jahre,63,36,27
False,8325024,Hardt,20 - 25 Jahre,158,80,78
False,8325024,Hardt,25 - 30 Jahre,148,75,73
False,8325024,Hardt,30 - 35 Jahre,170,83,87
False,8325024,Hardt,35 - 40 Jahre,225,115,110
False,8325024,Hardt,40 - 45 Jahre,209,110,99
False,8325024,Hardt,45 - 50 Jahre,171,77,94
False,8325024,Hardt,50 - 55 Jahre,191,103,88
False,8325024,Hardt,55 - 60 Jahre,132,62,70
False,8325024,Hardt,60 - 65 Jahre,149,70,79
False,8325024,Hardt,65 - 75 Jahre,280,143,137
False,8325024,Hardt,75 und mehr Jahre,153,67,86
False,8325024,Hardt,Insgesamt,2639,1311,1328
False,8325036,Lauterbach,unter 3 Jahre,82,36,46
False,8325036,Lauterbach,3 -  6 Jahre,92,53,39
False,8325036,Lauterbach,6 - 10 Jahre,145,81,64
False,8325036,Lauterbach,10 - 15 Jahre,229,118,111
False,8325036,Lauterbach,15 - 18 Jahre,110,61,49
False,8325036,Lauterbach,18 - 20 Jahre,71,36,35
False,8325036,Lauterbach,20 - 25 Jahre,155,89,66
False,8325036,Lauterbach,25 - 30 Jahre,127,63,64
False,8325036,Lauterbach,30 - 35 Jahre,190,95,95
False,8325036,Lauterbach,35 - 40 Jahre,262,143,119
False,8325036,Lauterbach,40 - 45 Jahre,255,130,125
False,8325036,Lauterbach,45 - 50 Jahre,211,109,102
False,8325036,Lauterbach,50 - 55 Jahre,167,76,91
False,8325036,Lauterbach,55 - 60 Jahre,163,83,80
False,8325036,Lauterbach,60 - 65 Jahre,197,94,103
False,8325036,Lauterbach,65 - 75 Jahre,426,190,236
False,8325036,Lauterbach,75 und mehr Jahre,275,101,174
False,8325036,Lauterbach,Insgesamt,3157,1558,1599
False,8325045,"Oberndorf am Neckar, Stadt",unter 3 Jahre,414,195,219
False,8325045,"Oberndorf am Neckar, Stadt",3 -  6 Jahre,443,222,221
False,8325045,"Oberndorf am Neckar, Stadt",6 - 10 Jahre,668,365,303
False,8325045,"Oberndorf am Neckar, Stadt",10 - 15 Jahre,848,426,422
False,8325045,"Oberndorf am Neckar, Stadt",15 - 18 Jahre,539,269,270
False,8325045,"Oberndorf am Neckar, Stadt",18 - 20 Jahre,353,154,199
False,8325045,"Oberndorf am Neckar, Stadt",20 - 25 Jahre,830,414,416
False,8325045,"Oberndorf am Neckar, Stadt",25 - 30 Jahre,761,396,365
False,8325045,"Oberndorf am Neckar, Stadt",30 - 35 Jahre,838,417,421
False,8325045,"Oberndorf am Neckar, Stadt",35 - 40 Jahre,1182,622,560
False,8325045,"Oberndorf am Neckar, Stadt",40 - 45 Jahre,1243,664,579
False,8325045,"Oberndorf am Neckar, Stadt",45 - 50 Jahre,1002,546,456
False,8325045,"Oberndorf am Neckar, Stadt",50 - 55 Jahre,877,437,440
False,8325045,"Oberndorf am Neckar, Stadt",55 - 60 Jahre,878,415,463
False,8325045,"Oberndorf am Neckar, Stadt",60 - 65 Jahre,877,445,432
False,8325045,"Oberndorf am Neckar, Stadt",65 - 75 Jahre,1674,789,885
False,8325045,"Oberndorf am Neckar, Stadt",75 und mehr Jahre,1296,438,858
False,8325045,"Oberndorf am Neckar, Stadt",Insgesamt,14723,7214,7509
False,8325049,"Rottweil, Stadt",unter 3 Jahre,651,333,318
False,8325049,"Rottweil, Stadt",3 -  6 Jahre,695,375,320
False,8325049,"Rottweil, Stadt",6 - 10 Jahre,1090,547,543
False,8325049,"Rottweil, Stadt",10 - 15 Jahre,1468,719,749
False,8325049,"Rottweil, Stadt",15 - 18 Jahre,968,472,496
False,8325049,"Rottweil, Stadt",18 - 20 Jahre,634,309,325
False,8325049,"Rottweil, Stadt",20 - 25 Jahre,1437,716,721
False,8325049,"Rottweil, Stadt",25 - 30 Jahre,1554,788,766
False,8325049,"Rottweil, Stadt",30 - 35 Jahre,1585,825,760
False,8325049,"Rottweil, Stadt",35 - 40 Jahre,2058,1062,996
False,8325049,"Rottweil, Stadt",40 - 45 Jahre,2083,1049,1034
False,8325049,"Rottweil, Stadt",45 - 50 Jahre,1890,961,929
False,8325049,"Rottweil, Stadt",50 - 55 Jahre,1702,850,852
False,8325049,"Rottweil, Stadt",55 - 60 Jahre,1509,719,790
False,8325049,"Rottweil, Stadt",60 - 65 Jahre,1402,681,721
False,8325049,"Rottweil, Stadt",65 - 75 Jahre,2678,1245,1433
False,8325049,"Rottweil, Stadt",75 und mehr Jahre,2274,727,1547
False,8325049,"Rottweil, Stadt",Insgesamt,25678,12378,13300
False,8325050,Schenkenzell,unter 3 Jahre,44,23,21
False,8325050,Schenkenzell,3 -  6 Jahre,42,23,19
False,8325050,Schenkenzell,6 - 10 Jahre,92,43,49
False,8325050,Schenkenzell,10 - 15 Jahre,136,69,67
False,8325050,Schenkenzell,15 - 18 Jahre,80,52,28
False,8325050,Schenkenzell,18 - 20 Jahre,47,20,27
False,8325050,Schenkenzell,20 - 25 Jahre,96,59,37
False,8325050,Schenkenzell,25 - 30 Jahre,73,40,33
False,8325050,Schenkenzell,30 - 35 Jahre,95,52,43
False,8325050,Schenkenzell,35 - 40 Jahre,125,58,67
False,8325050,Schenkenzell,40 - 45 Jahre,172,88,84
False,8325050,Schenkenzell,45 - 50 Jahre,146,83,63
False,8325050,Schenkenzell,50 - 55 Jahre,94,49,45
False,8325050,Schenkenzell,55 - 60 Jahre,77,40,37
False,8325050,Schenkenzell,60 - 65 Jahre,94,47,47
False,8325050,Schenkenzell,65 - 75 Jahre,231,107,124
False,8325050,Schenkenzell,75 und mehr Jahre,169,62,107
False,8325050,Schenkenzell,Insgesamt,1813,915,898
False,8325051,"Schiltach, Stadt",unter 3 Jahre,83,42,41
False,8325051,"Schiltach, Stadt",3 -  6 Jahre,116,55,61
False,8325051,"Schiltach, Stadt",6 - 10 Jahre,206,88,118
False,8325051,"Schiltach, Stadt",10 - 15 Jahre,262,142,120
False,8325051,"Schiltach, Stadt",15 - 18 Jahre,148,74,74
False,8325051,"Schiltach, Stadt",18 - 20 Jahre,82,40,42
False,8325051,"Schiltach, Stadt",20 - 25 Jahre,234,115,119
False,8325051,"Schiltach, Stadt",25 - 30 Jahre,189,106,83
False,8325051,"Schiltach, Stadt",30 - 35 Jahre,165,76,89
False,8325051,"Schiltach, Stadt",35 - 40 Jahre,306,155,151
False,8325051,"Schiltach, Stadt",40 - 45 Jahre,351,178,173
False,8325051,"Schiltach, Stadt",45 - 50 Jahre,312,160,152
False,8325051,"Schiltach, Stadt",50 - 55 Jahre,255,126,129
False,8325051,"Schiltach, Stadt",55 - 60 Jahre,199,111,88
False,8325051,"Schiltach, Stadt",60 - 65 Jahre,201,95,106
False,8325051,"Schiltach, Stadt",65 - 75 Jahre,499,235,264
False,8325051,"Schiltach, Stadt",75 und mehr Jahre,431,156,275
False,8325051,"Schiltach, Stadt",Insgesamt,4039,1954,2085
False,8325053,"Schramberg, Stadt",unter 3 Jahre,567,304,263
False,8325053,"Schramberg, Stadt",3 -  6 Jahre,630,315,315
False,8325053,"Schramberg, Stadt",6 - 10 Jahre,960,509,451
False,8325053,"Schramberg, Stadt",10 - 15 Jahre,1412,718,694
False,8325053,"Schramberg, Stadt",15 - 18 Jahre,921,483,438
False,8325053,"Schramberg, Stadt",18 - 20 Jahre,493,250,243
False,8325053,"Schramberg, Stadt",20 - 25 Jahre,1289,697,592
False,8325053,"Schramberg, Stadt",25 - 30 Jahre,1173,597,576
False,8325053,"Schramberg, Stadt",30 - 35 Jahre,1284,691,593
False,8325053,"Schramberg, Stadt",35 - 40 Jahre,1698,865,833
False,8325053,"Schramberg, Stadt",40 - 45 Jahre,1703,884,819
False,8325053,"Schramberg, Stadt",45 - 50 Jahre,1593,809,784
False,8325053,"Schramberg, Stadt",50 - 55 Jahre,1395,687,708
False,8325053,"Schramberg, Stadt",55 - 60 Jahre,1244,609,635
False,8325053,"Schramberg, Stadt",60 - 65 Jahre,1234,620,614
False,8325053,"Schramberg, Stadt",65 - 75 Jahre,2487,1128,1359
False,8325053,"Schramberg, Stadt",75 und mehr Jahre,2072,689,1383
False,8325053,"Schramberg, Stadt",Insgesamt,22155,10855,11300
False,8325057,"Sulz am Neckar, Stadt",unter 3 Jahre,329,152,177
False,8325057,"Sulz am Neckar, Stadt",3 -  6 Jahre,376,179,197
False,8325057,"Sulz am Neckar, Stadt",6 - 10 Jahre,646,323,323
False,8325057,"Sulz am Neckar, Stadt",10 - 15 Jahre,846,437,409
False,8325057,"Sulz am Neckar, Stadt",15 - 18 Jahre,549,278,271
False,8325057,"Sulz am Neckar, Stadt",18 - 20 Jahre,311,140,171
False,8325057,"Sulz am Neckar, Stadt",20 - 25 Jahre,714,378,336
False,8325057,"Sulz am Neckar, Stadt",25 - 30 Jahre,625,340,285
False,8325057,"Sulz am Neckar, Stadt",30 - 35 Jahre,703,343,360
False,8325057,"Sulz am Neckar, Stadt",35 - 40 Jahre,987,517,470
False,8325057,"Sulz am Neckar, Stadt",40 - 45 Jahre,1129,559,570
False,8325057,"Sulz am Neckar, Stadt",45 - 50 Jahre,988,500,488
False,8325057,"Sulz am Neckar, Stadt",50 - 55 Jahre,783,397,386
False,8325057,"Sulz am Neckar, Stadt",55 - 60 Jahre,644,331,313
False,8325057,"Sulz am Neckar, Stadt",60 - 65 Jahre,575,304,271
False,8325057,"Sulz am Neckar, Stadt",65 - 75 Jahre,1369,648,721
False,8325057,"Sulz am Neckar, Stadt",75 und mehr Jahre,1062,350,712
False,8325057,"Sulz am Neckar, Stadt",Insgesamt,12636,6176,6460
False,8325060,Villingendorf,unter 3 Jahre,100,50,50
False,8325060,Villingendorf,3 -  6 Jahre,108,55,53
False,8325060,Villingendorf,6 - 10 Jahre,185,89,96
False,8325060,Villingendorf,10 - 15 Jahre,239,125,114
False,8325060,Villingendorf,15 - 18 Jahre,155,83,72
False,8325060,Villingendorf,18 - 20 Jahre,85,40,45
False,8325060,Villingendorf,20 - 25 Jahre,192,94,98
False,8325060,Villingendorf,25 - 30 Jahre,179,92,87
False,8325060,Villingendorf,30 - 35 Jahre,223,109,114
False,8325060,Villingendorf,35 - 40 Jahre,276,142,134
False,8325060,Villingendorf,40 - 45 Jahre,289,137,152
False,8325060,Villingendorf,45 - 50 Jahre,244,119,125
False,8325060,Villingendorf,50 - 55 Jahre,212,104,108
False,8325060,Villingendorf,55 - 60 Jahre,161,87,74
False,8325060,Villingendorf,60 - 65 Jahre,145,78,67
False,8325060,Villingendorf,65 - 75 Jahre,301,141,160
False,8325060,Villingendorf,75 und mehr Jahre,191,69,122
False,8325060,Villingendorf,Insgesamt,3285,1614,1671
False,8325061,Vöhringen,unter 3 Jahre,149,79,70
False,8325061,Vöhringen,3 -  6 Jahre,168,93,75
False,8325061,Vöhringen,6 - 10 Jahre,214,114,100
False,8325061,Vöhringen,10 - 15 Jahre,290,159,131
False,8325061,Vöhringen,15 - 18 Jahre,165,91,74
False,8325061,Vöhringen,18 - 20 Jahre,113,47,66
False,8325061,Vöhringen,20 - 25 Jahre,212,117,95
False,8325061,Vöhringen,25 - 30 Jahre,213,104,109
False,8325061,Vöhringen,30 - 35 Jahre,296,149,147
False,8325061,Vöhringen,35 - 40 Jahre,334,184,150
False,8325061,Vöhringen,40 - 45 Jahre,391,201,190
False,8325061,Vöhringen,45 - 50 Jahre,295,156,139
False,8325061,Vöhringen,50 - 55 Jahre,220,108,112
False,8325061,Vöhringen,55 - 60 Jahre,217,120,97
False,8325061,Vöhringen,60 - 65 Jahre,207,96,111
False,8325061,Vöhringen,65 - 75 Jahre,414,191,223
False,8325061,Vöhringen,75 und mehr Jahre,255,80,175
False,8325061,Vöhringen,Insgesamt,4153,2089,2064
False,8325064,Wellendingen,unter 3 Jahre,116,59,57
False,8325064,Wellendingen,3 -  6 Jahre,94,41,53
False,8325064,Wellendingen,6 - 10 Jahre,148,85,63
False,8325064,Wellendingen,10 - 15 Jahre,191,97,94
False,8325064,Wellendingen,15 - 18 Jahre,116,65,51
False,8325064,Wellendingen,18 - 20 Jahre,89,44,45
False,8325064,Wellendingen,20 - 25 Jahre,188,86,102
False,8325064,Wellendingen,25 - 30 Jahre,161,88,73
False,8325064,Wellendingen,30 - 35 Jahre,193,94,99
False,8325064,Wellendingen,35 - 40 Jahre,230,132,98
False,8325064,Wellendingen,40 - 45 Jahre,291,145,146
False,8325064,Wellendingen,45 - 50 Jahre,260,133,127
False,8325064,Wellendingen,50 - 55 Jahre,212,112,100
False,8325064,Wellendingen,55 - 60 Jahre,142,77,65
False,8325064,Wellendingen,60 - 65 Jahre,153,89,64
False,8325064,Wellendingen,65 - 75 Jahre,283,130,153
False,8325064,Wellendingen,75 und mehr Jahre,185,65,120
False,8325064,Wellendingen,Insgesamt,3052,1542,1510
False,8325069,Zimmern ob Rottweil,unter 3 Jahre,161,82,79
False,8325069,Zimmern ob Rottweil,3 -  6 Jahre,168,87,81
False,8325069,Zimmern ob Rottweil,6 - 10 Jahre,262,132,130
False,8325069,Zimmern ob Rottweil,10 - 15 Jahre,356,180,176
False,8325069,Zimmern ob Rottweil,15 - 18 Jahre,282,116,166
False,8325069,Zimmern ob Rottweil,18 - 20 Jahre,175,86,89
False,8325069,Zimmern ob Rottweil,20 - 25 Jahre,333,165,168
False,8325069,Zimmern ob Rottweil,25 - 30 Jahre,331,159,172
False,8325069,Zimmern ob Rottweil,30 - 35 Jahre,370,183,187
False,8325069,Zimmern ob Rottweil,35 - 40 Jahre,486,247,239
False,8325069,Zimmern ob Rottweil,40 - 45 Jahre,500,267,233
False,8325069,Zimmern ob Rottweil,45 - 50 Jahre,526,248,278
False,8325069,Zimmern ob Rottweil,50 - 55 Jahre,428,211,217
False,8325069,Zimmern ob Rottweil,55 - 60 Jahre,331,172,159
False,8325069,Zimmern ob Rottweil,60 - 65 Jahre,295,152,143
False,8325069,Zimmern ob Rottweil,65 - 75 Jahre,611,291,320
False,8325069,Zimmern ob Rottweil,75 und mehr Jahre,411,156,255
False,8325069,Zimmern ob Rottweil,Insgesamt,6026,2934,3092
False,8325070,Fluorn-Winzeln,unter 3 Jahre,86,37,49
False,8325070,Fluorn-Winzeln,3 -  6 Jahre,94,50,44
False,8325070,Fluorn-Winzeln,6 - 10 Jahre,157,83,74
False,8325070,Fluorn-Winzeln,10 - 15 Jahre,229,124,105
False,8325070,Fluorn-Winzeln,15 - 18 Jahre,130,63,67
False,8325070,Fluorn-Winzeln,18 - 20 Jahre,74,45,29
False,8325070,Fluorn-Winzeln,20 - 25 Jahre,148,65,83
False,8325070,Fluorn-Winzeln,25 - 30 Jahre,150,84,66
False,8325070,Fluorn-Winzeln,30 - 35 Jahre,199,102,97
False,8325070,Fluorn-Winzeln,35 - 40 Jahre,310,160,150
False,8325070,Fluorn-Winzeln,40 - 45 Jahre,288,160,128
False,8325070,Fluorn-Winzeln,45 - 50 Jahre,244,140,104
False,8325070,Fluorn-Winzeln,50 - 55 Jahre,162,82,80
False,8325070,Fluorn-Winzeln,55 - 60 Jahre,182,86,96
False,8325070,Fluorn-Winzeln,60 - 65 Jahre,176,97,79
False,8325070,Fluorn-Winzeln,65 - 75 Jahre,364,169,195
False,8325070,Fluorn-Winzeln,75 und mehr Jahre,229,80,149
False,8325070,Fluorn-Winzeln,Insgesamt,3222,1627,1595
False,8325071,Eschbronn,unter 3 Jahre,78,33,45
False,8325071,Eschbronn,3 -  6 Jahre,75,32,43
False,8325071,Eschbronn,6 - 10 Jahre,101,56,45
False,8325071,Eschbronn,10 - 15 Jahre,120,68,52
False,8325071,Eschbronn,15 - 18 Jahre,72,41,31
False,8325071,Eschbronn,18 - 20 Jahre,44,21,23
False,8325071,Eschbronn,20 - 25 Jahre,99,59,40
False,8325071,Eschbronn,25 - 30 Jahre,93,39,54
False,8325071,Eschbronn,30 - 35 Jahre,125,60,65
False,8325071,Eschbronn,35 - 40 Jahre,183,97,86
False,8325071,Eschbronn,40 - 45 Jahre,187,101,86
False,8325071,Eschbronn,45 - 50 Jahre,155,78,77
False,8325071,Eschbronn,50 - 55 Jahre,134,70,64
False,8325071,Eschbronn,55 - 60 Jahre,108,50,58
False,8325071,Eschbronn,60 - 65 Jahre,127,60,67
False,8325071,Eschbronn,65 - 75 Jahre,271,138,133
False,8325071,Eschbronn,75 und mehr Jahre,150,55,95
False,8325071,Eschbronn,Insgesamt,2122,1058,1064
False,8325072,Deißlingen,unter 3 Jahre,168,92,76
False,8325072,Deißlingen,3 -  6 Jahre,189,94,95
False,8325072,Deißlingen,6 - 10 Jahre,252,127,125
False,8325072,Deißlingen,10 - 15 Jahre,400,225,175
False,8325072,Deißlingen,15 - 18 Jahre,274,141,133
False,8325072,Deißlingen,18 - 20 Jahre,150,67,83
False,8325072,Deißlingen,20 - 25 Jahre,350,203,147
False,8325072,Deißlingen,25 - 30 Jahre,316,142,174
False,8325072,Deißlingen,30 - 35 Jahre,300,156,144
False,8325072,Deißlingen,35 - 40 Jahre,492,238,254
False,8325072,Deißlingen,40 - 45 Jahre,526,270,256
False,8325072,Deißlingen,45 - 50 Jahre,496,247,249
False,8325072,Deißlingen,50 - 55 Jahre,427,204,223
False,8325072,Deißlingen,55 - 60 Jahre,329,177,152
False,8325072,Deißlingen,60 - 65 Jahre,265,132,133
False,8325072,Deißlingen,65 - 75 Jahre,661,306,355
False,8325072,Deißlingen,75 und mehr Jahre,492,186,306
False,8325072,Deißlingen,Insgesamt,6087,3007,3080
False,8326,Landkreis Schwarzw.-Baar-Kreis,unter 3 Jahre,5511,2819,2692
False,8326,Landkreis Schwarzw.-Baar-Kreis,3 -  6 Jahre,5987,3015,2972
False,8326,Landkreis Schwarzw.-Baar-Kreis,6 - 10 Jahre,9087,4838,4249
False,8326,Landkreis Schwarzw.-Baar-Kreis,10 - 15 Jahre,11959,6162,5797
False,8326,Landkreis Schwarzw.-Baar-Kreis,15 - 18 Jahre,7996,4119,3877
False,8326,Landkreis Schwarzw.-Baar-Kreis,18 - 20 Jahre,5305,2701,2604
False,8326,Landkreis Schwarzw.-Baar-Kreis,20 - 25 Jahre,12295,6277,6018
False,8326,Landkreis Schwarzw.-Baar-Kreis,25 - 30 Jahre,11491,5904,5587
False,8326,Landkreis Schwarzw.-Baar-Kreis,30 - 35 Jahre,11832,5942,5890
False,8326,Landkreis Schwarzw.-Baar-Kreis,35 - 40 Jahre,15997,8068,7929
False,8326,Landkreis Schwarzw.-Baar-Kreis,40 - 45 Jahre,17179,8771,8408
False,8326,Landkreis Schwarzw.-Baar-Kreis,45 - 50 Jahre,15946,8068,7878
False,8326,Landkreis Schwarzw.-Baar-Kreis,50 - 55 Jahre,13917,6750,7167
False,8326,Landkreis Schwarzw.-Baar-Kreis,55 - 60 Jahre,12283,6123,6160
False,8326,Landkreis Schwarzw.-Baar-Kreis,60 - 65 Jahre,11542,5643,5899
False,8326,Landkreis Schwarzw.-Baar-Kreis,65 - 75 Jahre,24371,11389,12982
False,8326,Landkreis Schwarzw.-Baar-Kreis,75 und mehr Jahre,18622,6517,12105
False,8326,Landkreis Schwarzw.-Baar-Kreis,Insgesamt,211320,103106,108214
False,8326003,"Bad Dürrheim, Stadt",unter 3 Jahre,266,142,124
False,8326003,"Bad Dürrheim, Stadt",3 -  6 Jahre,299,145,154
False,8326003,"Bad Dürrheim, Stadt",6 - 10 Jahre,473,241,232
False,8326003,"Bad Dürrheim, Stadt",10 - 15 Jahre,580,301,279
False,8326003,"Bad Dürrheim, Stadt",15 - 18 Jahre,397,195,202
False,8326003,"Bad Dürrheim, Stadt",18 - 20 Jahre,230,106,124
False,8326003,"Bad Dürrheim, Stadt",20 - 25 Jahre,615,329,286
False,8326003,"Bad Dürrheim, Stadt",25 - 30 Jahre,583,294,289
False,8326003,"Bad Dürrheim, Stadt",30 - 35 Jahre,652,314,338
False,8326003,"Bad Dürrheim, Stadt",35 - 40 Jahre,853,443,410
False,8326003,"Bad Dürrheim, Stadt",40 - 45 Jahre,1010,482,528
False,8326003,"Bad Dürrheim, Stadt",45 - 50 Jahre,930,463,467
False,8326003,"Bad Dürrheim, Stadt",50 - 55 Jahre,802,356,446
False,8326003,"Bad Dürrheim, Stadt",55 - 60 Jahre,746,357,389
False,8326003,"Bad Dürrheim, Stadt",60 - 65 Jahre,782,355,427
False,8326003,"Bad Dürrheim, Stadt",65 - 75 Jahre,1684,751,933
False,8326003,"Bad Dürrheim, Stadt",75 und mehr Jahre,1904,625,1279
False,8326003,"Bad Dürrheim, Stadt",Insgesamt,12806,5899,6907
False,8326005,"Blumberg, Stadt",unter 3 Jahre,328,168,160
False,8326005,"Blumberg, Stadt",3 -  6 Jahre,310,165,145
False,8326005,"Blumberg, Stadt",6 - 10 Jahre,483,252,231
False,8326005,"Blumberg, Stadt",10 - 15 Jahre,676,333,343
False,8326005,"Blumberg, Stadt",15 - 18 Jahre,419,227,192
False,8326005,"Blumberg, Stadt",18 - 20 Jahre,263,128,135
False,8326005,"Blumberg, Stadt",20 - 25 Jahre,618,315,303
False,8326005,"Blumberg, Stadt",25 - 30 Jahre,552,281,271
False,8326005,"Blumberg, Stadt",30 - 35 Jahre,638,311,327
False,8326005,"Blumberg, Stadt",35 - 40 Jahre,780,395,385
False,8326005,"Blumberg, Stadt",40 - 45 Jahre,864,452,412
False,8326005,"Blumberg, Stadt",45 - 50 Jahre,787,406,381
False,8326005,"Blumberg, Stadt",50 - 55 Jahre,670,318,352
False,8326005,"Blumberg, Stadt",55 - 60 Jahre,612,316,296
False,8326005,"Blumberg, Stadt",60 - 65 Jahre,570,314,256
False,8326005,"Blumberg, Stadt",65 - 75 Jahre,1165,547,618
False,8326005,"Blumberg, Stadt",75 und mehr Jahre,785,292,493
False,8326005,"Blumberg, Stadt",Insgesamt,10520,5220,5300
False,8326006,"Bräunlingen, Stadt",unter 3 Jahre,168,86,82
False,8326006,"Bräunlingen, Stadt",3 -  6 Jahre,189,97,92
False,8326006,"Bräunlingen, Stadt",6 - 10 Jahre,298,158,140
False,8326006,"Bräunlingen, Stadt",10 - 15 Jahre,426,200,226
False,8326006,"Bräunlingen, Stadt",15 - 18 Jahre,279,124,155
False,8326006,"Bräunlingen, Stadt",18 - 20 Jahre,170,83,87
False,8326006,"Bräunlingen, Stadt",20 - 25 Jahre,375,186,189
False,8326006,"Bräunlingen, Stadt",25 - 30 Jahre,327,147,180
False,8326006,"Bräunlingen, Stadt",30 - 35 Jahre,362,176,186
False,8326006,"Bräunlingen, Stadt",35 - 40 Jahre,507,260,247
False,8326006,"Bräunlingen, Stadt",40 - 45 Jahre,592,303,289
False,8326006,"Bräunlingen, Stadt",45 - 50 Jahre,514,263,251
False,8326006,"Bräunlingen, Stadt",50 - 55 Jahre,408,217,191
False,8326006,"Bräunlingen, Stadt",55 - 60 Jahre,312,157,155
False,8326006,"Bräunlingen, Stadt",60 - 65 Jahre,246,136,110
False,8326006,"Bräunlingen, Stadt",65 - 75 Jahre,581,281,300
False,8326006,"Bräunlingen, Stadt",75 und mehr Jahre,430,149,281
False,8326006,"Bräunlingen, Stadt",Insgesamt,6184,3023,3161
False,8326010,Dauchingen,unter 3 Jahre,106,59,47
False,8326010,Dauchingen,3 -  6 Jahre,99,50,49
False,8326010,Dauchingen,6 - 10 Jahre,141,79,62
False,8326010,Dauchingen,10 - 15 Jahre,209,113,96
False,8326010,Dauchingen,15 - 18 Jahre,129,71,58
False,8326010,Dauchingen,18 - 20 Jahre,100,62,38
False,8326010,Dauchingen,20 - 25 Jahre,205,97,108
False,8326010,Dauchingen,25 - 30 Jahre,174,89,85
False,8326010,Dauchingen,30 - 35 Jahre,197,90,107
False,8326010,Dauchingen,35 - 40 Jahre,308,144,164
False,8326010,Dauchingen,40 - 45 Jahre,347,180,167
False,8326010,Dauchingen,45 - 50 Jahre,293,148,145
False,8326010,Dauchingen,50 - 55 Jahre,259,119,140
False,8326010,Dauchingen,55 - 60 Jahre,209,108,101
False,8326010,Dauchingen,60 - 65 Jahre,197,99,98
False,8326010,Dauchingen,65 - 75 Jahre,446,225,221
False,8326010,Dauchingen,75 und mehr Jahre,214,85,129
False,8326010,Dauchingen,Insgesamt,3633,1818,1815
False,8326012,"Donaueschingen, Stadt",unter 3 Jahre,600,303,297
False,8326012,"Donaueschingen, Stadt",3 -  6 Jahre,668,347,321
False,8326012,"Donaueschingen, Stadt",6 - 10 Jahre,982,492,490
False,8326012,"Donaueschingen, Stadt",10 - 15 Jahre,1219,652,567
False,8326012,"Donaueschingen, Stadt",15 - 18 Jahre,794,397,397
False,8326012,"Donaueschingen, Stadt",18 - 20 Jahre,590,303,287
False,8326012,"Donaueschingen, Stadt",20 - 25 Jahre,1259,655,604
False,8326012,"Donaueschingen, Stadt",25 - 30 Jahre,1265,629,636
False,8326012,"Donaueschingen, Stadt",30 - 35 Jahre,1231,628,603
False,8326012,"Donaueschingen, Stadt",35 - 40 Jahre,1684,854,830
False,8326012,"Donaueschingen, Stadt",40 - 45 Jahre,1675,825,850
False,8326012,"Donaueschingen, Stadt",45 - 50 Jahre,1695,868,827
False,8326012,"Donaueschingen, Stadt",50 - 55 Jahre,1519,750,769
False,8326012,"Donaueschingen, Stadt",55 - 60 Jahre,1215,635,580
False,8326012,"Donaueschingen, Stadt",60 - 65 Jahre,1044,521,523
False,8326012,"Donaueschingen, Stadt",65 - 75 Jahre,2292,1063,1229
False,8326012,"Donaueschingen, Stadt",75 und mehr Jahre,1707,591,1116
False,8326012,"Donaueschingen, Stadt",Insgesamt,21439,10513,10926
False,8326017,"Furtwangen im Schwarzwald, Stadt",unter 3 Jahre,231,118,113
False,8326017,"Furtwangen im Schwarzwald, Stadt",3 -  6 Jahre,281,140,141
False,8326017,"Furtwangen im Schwarzwald, Stadt",6 - 10 Jahre,421,219,202
False,8326017,"Furtwangen im Schwarzwald, Stadt",10 - 15 Jahre,573,293,280
False,8326017,"Furtwangen im Schwarzwald, Stadt",15 - 18 Jahre,384,195,189
False,8326017,"Furtwangen im Schwarzwald, Stadt",18 - 20 Jahre,236,141,95
False,8326017,"Furtwangen im Schwarzwald, Stadt",20 - 25 Jahre,684,387,297
False,8326017,"Furtwangen im Schwarzwald, Stadt",25 - 30 Jahre,535,306,229
False,8326017,"Furtwangen im Schwarzwald, Stadt",30 - 35 Jahre,498,264,234
False,8326017,"Furtwangen im Schwarzwald, Stadt",35 - 40 Jahre,753,410,343
False,8326017,"Furtwangen im Schwarzwald, Stadt",40 - 45 Jahre,933,554,379
False,8326017,"Furtwangen im Schwarzwald, Stadt",45 - 50 Jahre,748,387,361
False,8326017,"Furtwangen im Schwarzwald, Stadt",50 - 55 Jahre,566,302,264
False,8326017,"Furtwangen im Schwarzwald, Stadt",55 - 60 Jahre,493,256,237
False,8326017,"Furtwangen im Schwarzwald, Stadt",60 - 65 Jahre,448,219,229
False,8326017,"Furtwangen im Schwarzwald, Stadt",65 - 75 Jahre,1050,505,545
False,8326017,"Furtwangen im Schwarzwald, Stadt",75 und mehr Jahre,788,258,530
False,8326017,"Furtwangen im Schwarzwald, Stadt",Insgesamt,9622,4954,4668
False,8326020,Gütenbach,unter 3 Jahre,25,10,15
False,8326020,Gütenbach,3 -  6 Jahre,40,19,21
False,8326020,Gütenbach,6 - 10 Jahre,47,20,27
False,8326020,Gütenbach,10 - 15 Jahre,77,40,37
False,8326020,Gütenbach,15 - 18 Jahre,53,35,18
False,8326020,Gütenbach,18 - 20 Jahre,40,21,19
False,8326020,Gütenbach,20 - 25 Jahre,96,50,46
False,8326020,Gütenbach,25 - 30 Jahre,58,31,27
False,8326020,Gütenbach,30 - 35 Jahre,49,28,21
False,8326020,Gütenbach,35 - 40 Jahre,88,37,51
False,8326020,Gütenbach,40 - 45 Jahre,113,57,56
False,8326020,Gütenbach,45 - 50 Jahre,126,65,61
False,8326020,Gütenbach,50 - 55 Jahre,93,47,46
False,8326020,Gütenbach,55 - 60 Jahre,61,35,26
False,8326020,Gütenbach,60 - 65 Jahre,65,35,30
False,8326020,Gütenbach,65 - 75 Jahre,168,79,89
False,8326020,Gütenbach,75 und mehr Jahre,123,53,70
False,8326020,Gütenbach,Insgesamt,1322,662,660
False,8326027,"Hüfingen, Stadt",unter 3 Jahre,237,134,103
False,8326027,"Hüfingen, Stadt",3 -  6 Jahre,251,115,136
False,8326027,"Hüfingen, Stadt",6 - 10 Jahre,387,226,161
False,8326027,"Hüfingen, Stadt",10 - 15 Jahre,544,280,264
False,8326027,"Hüfingen, Stadt",15 - 18 Jahre,332,198,134
False,8326027,"Hüfingen, Stadt",18 - 20 Jahre,202,113,89
False,8326027,"Hüfingen, Stadt",20 - 25 Jahre,475,239,236
False,8326027,"Hüfingen, Stadt",25 - 30 Jahre,474,238,236
False,8326027,"Hüfingen, Stadt",30 - 35 Jahre,444,228,216
False,8326027,"Hüfingen, Stadt",35 - 40 Jahre,677,320,357
False,8326027,"Hüfingen, Stadt",40 - 45 Jahre,691,362,329
False,8326027,"Hüfingen, Stadt",45 - 50 Jahre,615,310,305
False,8326027,"Hüfingen, Stadt",50 - 55 Jahre,497,239,258
False,8326027,"Hüfingen, Stadt",55 - 60 Jahre,394,204,190
False,8326027,"Hüfingen, Stadt",60 - 65 Jahre,324,168,156
False,8326027,"Hüfingen, Stadt",65 - 75 Jahre,709,336,373
False,8326027,"Hüfingen, Stadt",75 und mehr Jahre,570,209,361
False,8326027,"Hüfingen, Stadt",Insgesamt,7823,3919,3904
False,8326031,Königsfeld im Schwarzwald,unter 3 Jahre,126,63,63
False,8326031,Königsfeld im Schwarzwald,3 -  6 Jahre,147,72,75
False,8326031,Königsfeld im Schwarzwald,6 - 10 Jahre,253,143,110
False,8326031,Königsfeld im Schwarzwald,10 - 15 Jahre,387,201,186
False,8326031,Königsfeld im Schwarzwald,15 - 18 Jahre,262,137,125
False,8326031,Königsfeld im Schwarzwald,18 - 20 Jahre,196,100,96
False,8326031,Königsfeld im Schwarzwald,20 - 25 Jahre,329,171,158
False,8326031,Königsfeld im Schwarzwald,25 - 30 Jahre,248,123,125
False,8326031,Königsfeld im Schwarzwald,30 - 35 Jahre,312,136,176
False,8326031,Königsfeld im Schwarzwald,35 - 40 Jahre,484,255,229
False,8326031,Königsfeld im Schwarzwald,40 - 45 Jahre,475,223,252
False,8326031,Königsfeld im Schwarzwald,45 - 50 Jahre,485,231,254
False,8326031,Königsfeld im Schwarzwald,50 - 55 Jahre,450,214,236
False,8326031,Königsfeld im Schwarzwald,55 - 60 Jahre,370,187,183
False,8326031,Königsfeld im Schwarzwald,60 - 65 Jahre,315,149,166
False,8326031,Königsfeld im Schwarzwald,65 - 75 Jahre,667,309,358
False,8326031,Königsfeld im Schwarzwald,75 und mehr Jahre,660,192,468
False,8326031,Königsfeld im Schwarzwald,Insgesamt,6166,2906,3260
False,8326037,Mönchweiler,unter 3 Jahre,87,54,33
False,8326037,Mönchweiler,3 -  6 Jahre,82,41,41
False,8326037,Mönchweiler,6 - 10 Jahre,140,74,66
False,8326037,Mönchweiler,10 - 15 Jahre,166,79,87
False,8326037,Mönchweiler,15 - 18 Jahre,111,61,50
False,8326037,Mönchweiler,18 - 20 Jahre,66,26,40
False,8326037,Mönchweiler,20 - 25 Jahre,186,89,97
False,8326037,Mönchweiler,25 - 30 Jahre,162,89,73
False,8326037,Mönchweiler,30 - 35 Jahre,171,90,81
False,8326037,Mönchweiler,35 - 40 Jahre,273,137,136
False,8326037,Mönchweiler,40 - 45 Jahre,244,116,128
False,8326037,Mönchweiler,45 - 50 Jahre,249,114,135
False,8326037,Mönchweiler,50 - 55 Jahre,236,118,118
False,8326037,Mönchweiler,55 - 60 Jahre,201,97,104
False,8326037,Mönchweiler,60 - 65 Jahre,201,104,97
False,8326037,Mönchweiler,65 - 75 Jahre,391,200,191
False,8326037,Mönchweiler,75 und mehr Jahre,227,82,145
False,8326037,Mönchweiler,Insgesamt,3193,1571,1622
False,8326041,Niedereschach,unter 3 Jahre,188,97,91
False,8326041,Niedereschach,3 -  6 Jahre,206,103,103
False,8326041,Niedereschach,6 - 10 Jahre,290,158,132
False,8326041,Niedereschach,10 - 15 Jahre,370,186,184
False,8326041,Niedereschach,15 - 18 Jahre,262,135,127
False,8326041,Niedereschach,18 - 20 Jahre,159,90,69
False,8326041,Niedereschach,20 - 25 Jahre,299,137,162
False,8326041,Niedereschach,25 - 30 Jahre,304,150,154
False,8326041,Niedereschach,30 - 35 Jahre,337,171,166
False,8326041,Niedereschach,35 - 40 Jahre,501,251,250
False,8326041,Niedereschach,40 - 45 Jahre,598,296,302
False,8326041,Niedereschach,45 - 50 Jahre,504,264,240
False,8326041,Niedereschach,50 - 55 Jahre,428,220,208
False,8326041,Niedereschach,55 - 60 Jahre,361,196,165
False,8326041,Niedereschach,60 - 65 Jahre,308,155,153
False,8326041,Niedereschach,65 - 75 Jahre,542,243,299
False,8326041,Niedereschach,75 und mehr Jahre,354,141,213
False,8326041,Niedereschach,Insgesamt,6011,2993,3018
False,8326052,"St. Georgen im Schwarzwald, Stadt",unter 3 Jahre,322,154,168
False,8326052,"St. Georgen im Schwarzwald, Stadt",3 -  6 Jahre,375,189,186
False,8326052,"St. Georgen im Schwarzwald, Stadt",6 - 10 Jahre,579,319,260
False,8326052,"St. Georgen im Schwarzwald, Stadt",10 - 15 Jahre,821,425,396
False,8326052,"St. Georgen im Schwarzwald, Stadt",15 - 18 Jahre,518,258,260
False,8326052,"St. Georgen im Schwarzwald, Stadt",18 - 20 Jahre,334,185,149
False,8326052,"St. Georgen im Schwarzwald, Stadt",20 - 25 Jahre,737,381,356
False,8326052,"St. Georgen im Schwarzwald, Stadt",25 - 30 Jahre,672,356,316
False,8326052,"St. Georgen im Schwarzwald, Stadt",30 - 35 Jahre,739,377,362
False,8326052,"St. Georgen im Schwarzwald, Stadt",35 - 40 Jahre,983,472,511
False,8326052,"St. Georgen im Schwarzwald, Stadt",40 - 45 Jahre,1129,558,571
False,8326052,"St. Georgen im Schwarzwald, Stadt",45 - 50 Jahre,998,517,481
False,8326052,"St. Georgen im Schwarzwald, Stadt",50 - 55 Jahre,868,398,470
False,8326052,"St. Georgen im Schwarzwald, Stadt",55 - 60 Jahre,801,392,409
False,8326052,"St. Georgen im Schwarzwald, Stadt",60 - 65 Jahre,782,378,404
False,8326052,"St. Georgen im Schwarzwald, Stadt",65 - 75 Jahre,1684,789,895
False,8326052,"St. Georgen im Schwarzwald, Stadt",75 und mehr Jahre,1320,467,853
False,8326052,"St. Georgen im Schwarzwald, Stadt",Insgesamt,13662,6615,7047
False,8326054,Schönwald im Schwarzwald,unter 3 Jahre,55,30,25
False,8326054,Schönwald im Schwarzwald,3 -  6 Jahre,62,33,29
False,8326054,Schönwald im Schwarzwald,6 - 10 Jahre,95,55,40
False,8326054,Schönwald im Schwarzwald,10 - 15 Jahre,151,76,75
False,8326054,Schönwald im Schwarzwald,15 - 18 Jahre,94,54,40
False,8326054,Schönwald im Schwarzwald,18 - 20 Jahre,58,32,26
False,8326054,Schönwald im Schwarzwald,20 - 25 Jahre,143,75,68
False,8326054,Schönwald im Schwarzwald,25 - 30 Jahre,125,64,61
False,8326054,Schönwald im Schwarzwald,30 - 35 Jahre,131,66,65
False,8326054,Schönwald im Schwarzwald,35 - 40 Jahre,177,81,96
False,8326054,Schönwald im Schwarzwald,40 - 45 Jahre,218,112,106
False,8326054,Schönwald im Schwarzwald,45 - 50 Jahre,181,83,98
False,8326054,Schönwald im Schwarzwald,50 - 55 Jahre,148,78,70
False,8326054,Schönwald im Schwarzwald,55 - 60 Jahre,158,81,77
False,8326054,Schönwald im Schwarzwald,60 - 65 Jahre,146,74,72
False,8326054,Schönwald im Schwarzwald,65 - 75 Jahre,338,166,172
False,8326054,Schönwald im Schwarzwald,75 und mehr Jahre,208,76,132
False,8326054,Schönwald im Schwarzwald,Insgesamt,2488,1236,1252
False,8326055,Schonach im Schwarzwald,unter 3 Jahre,95,53,42
False,8326055,Schonach im Schwarzwald,3 -  6 Jahre,116,66,50
False,8326055,Schonach im Schwarzwald,6 - 10 Jahre,209,107,102
False,8326055,Schonach im Schwarzwald,10 - 15 Jahre,268,138,130
False,8326055,Schonach im Schwarzwald,15 - 18 Jahre,174,92,82
False,8326055,Schonach im Schwarzwald,18 - 20 Jahre,117,55,62
False,8326055,Schonach im Schwarzwald,20 - 25 Jahre,211,124,87
False,8326055,Schonach im Schwarzwald,25 - 30 Jahre,202,104,98
False,8326055,Schonach im Schwarzwald,30 - 35 Jahre,216,121,95
False,8326055,Schonach im Schwarzwald,35 - 40 Jahre,292,160,132
False,8326055,Schonach im Schwarzwald,40 - 45 Jahre,328,152,176
False,8326055,Schonach im Schwarzwald,45 - 50 Jahre,294,162,132
False,8326055,Schonach im Schwarzwald,50 - 55 Jahre,280,126,154
False,8326055,Schonach im Schwarzwald,55 - 60 Jahre,240,124,116
False,8326055,Schonach im Schwarzwald,60 - 65 Jahre,251,119,132
False,8326055,Schonach im Schwarzwald,65 - 75 Jahre,633,302,331
False,8326055,Schonach im Schwarzwald,75 und mehr Jahre,308,128,180
False,8326055,Schonach im Schwarzwald,Insgesamt,4234,2133,2101
False,8326060,"Triberg im Schwarzwald, Stadt",unter 3 Jahre,126,59,67
False,8326060,"Triberg im Schwarzwald, Stadt",3 -  6 Jahre,125,61,64
False,8326060,"Triberg im Schwarzwald, Stadt",6 - 10 Jahre,236,125,111
False,8326060,"Triberg im Schwarzwald, Stadt",10 - 15 Jahre,300,150,150
False,8326060,"Triberg im Schwarzwald, Stadt",15 - 18 Jahre,224,113,111
False,8326060,"Triberg im Schwarzwald, Stadt",18 - 20 Jahre,145,64,81
False,8326060,"Triberg im Schwarzwald, Stadt",20 - 25 Jahre,269,160,109
False,8326060,"Triberg im Schwarzwald, Stadt",25 - 30 Jahre,231,115,116
False,8326060,"Triberg im Schwarzwald, Stadt",30 - 35 Jahre,265,135,130
False,8326060,"Triberg im Schwarzwald, Stadt",35 - 40 Jahre,372,179,193
False,8326060,"Triberg im Schwarzwald, Stadt",40 - 45 Jahre,442,226,216
False,8326060,"Triberg im Schwarzwald, Stadt",45 - 50 Jahre,358,197,161
False,8326060,"Triberg im Schwarzwald, Stadt",50 - 55 Jahre,297,147,150
False,8326060,"Triberg im Schwarzwald, Stadt",55 - 60 Jahre,280,151,129
False,8326060,"Triberg im Schwarzwald, Stadt",60 - 65 Jahre,280,133,147
False,8326060,"Triberg im Schwarzwald, Stadt",65 - 75 Jahre,692,306,386
False,8326060,"Triberg im Schwarzwald, Stadt",75 und mehr Jahre,570,204,366
False,8326060,"Triberg im Schwarzwald, Stadt",Insgesamt,5212,2525,2687
False,8326061,Tuningen,unter 3 Jahre,76,28,48
False,8326061,Tuningen,3 -  6 Jahre,91,44,47
False,8326061,Tuningen,6 - 10 Jahre,139,63,76
False,8326061,Tuningen,10 - 15 Jahre,213,111,102
False,8326061,Tuningen,15 - 18 Jahre,109,50,59
False,8326061,Tuningen,18 - 20 Jahre,83,47,36
False,8326061,Tuningen,20 - 25 Jahre,185,91,94
False,8326061,Tuningen,25 - 30 Jahre,138,75,63
False,8326061,Tuningen,30 - 35 Jahre,169,75,94
False,8326061,Tuningen,35 - 40 Jahre,249,115,134
False,8326061,Tuningen,40 - 45 Jahre,269,144,125
False,8326061,Tuningen,45 - 50 Jahre,220,110,110
False,8326061,Tuningen,50 - 55 Jahre,174,93,81
False,8326061,Tuningen,55 - 60 Jahre,146,82,64
False,8326061,Tuningen,60 - 65 Jahre,142,66,76
False,8326061,Tuningen,65 - 75 Jahre,254,121,133
False,8326061,Tuningen,75 und mehr Jahre,208,72,136
False,8326061,Tuningen,Insgesamt,2865,1387,1478
False,8326065,Unterkirnach,unter 3 Jahre,82,45,37
False,8326065,Unterkirnach,3 -  6 Jahre,76,36,40
False,8326065,Unterkirnach,6 - 10 Jahre,130,69,61
False,8326065,Unterkirnach,10 - 15 Jahre,138,84,54
False,8326065,Unterkirnach,15 - 18 Jahre,115,64,51
False,8326065,Unterkirnach,18 - 20 Jahre,79,37,42
False,8326065,Unterkirnach,20 - 25 Jahre,201,109,92
False,8326065,Unterkirnach,25 - 30 Jahre,179,101,78
False,8326065,Unterkirnach,30 - 35 Jahre,177,104,73
False,8326065,Unterkirnach,35 - 40 Jahre,249,128,121
False,8326065,Unterkirnach,40 - 45 Jahre,276,154,122
False,8326065,Unterkirnach,45 - 50 Jahre,236,117,119
False,8326065,Unterkirnach,50 - 55 Jahre,189,99,90
False,8326065,Unterkirnach,55 - 60 Jahre,179,101,78
False,8326065,Unterkirnach,60 - 65 Jahre,154,73,81
False,8326065,Unterkirnach,65 - 75 Jahre,301,155,146
False,8326065,Unterkirnach,75 und mehr Jahre,141,56,85
False,8326065,Unterkirnach,Insgesamt,2902,1532,1370
False,8326068,"Vöhrenbach, Stadt",unter 3 Jahre,102,47,55
False,8326068,"Vöhrenbach, Stadt",3 -  6 Jahre,136,68,68
False,8326068,"Vöhrenbach, Stadt",6 - 10 Jahre,203,100,103
False,8326068,"Vöhrenbach, Stadt",10 - 15 Jahre,253,129,124
False,8326068,"Vöhrenbach, Stadt",15 - 18 Jahre,158,75,83
False,8326068,"Vöhrenbach, Stadt",18 - 20 Jahre,106,55,51
False,8326068,"Vöhrenbach, Stadt",20 - 25 Jahre,226,102,124
False,8326068,"Vöhrenbach, Stadt",25 - 30 Jahre,192,107,85
False,8326068,"Vöhrenbach, Stadt",30 - 35 Jahre,228,119,109
False,8326068,"Vöhrenbach, Stadt",35 - 40 Jahre,333,177,156
False,8326068,"Vöhrenbach, Stadt",40 - 45 Jahre,339,173,166
False,8326068,"Vöhrenbach, Stadt",45 - 50 Jahre,306,180,126
False,8326068,"Vöhrenbach, Stadt",50 - 55 Jahre,227,116,111
False,8326068,"Vöhrenbach, Stadt",55 - 60 Jahre,245,125,120
False,8326068,"Vöhrenbach, Stadt",60 - 65 Jahre,204,109,95
False,8326068,"Vöhrenbach, Stadt",65 - 75 Jahre,488,247,241
False,8326068,"Vöhrenbach, Stadt",75 und mehr Jahre,351,140,211
False,8326068,"Vöhrenbach, Stadt",Insgesamt,4097,2069,2028
False,8326074,"Villingen-Schwenningen, Stadt",unter 3 Jahre,2137,1098,1039
False,8326074,"Villingen-Schwenningen, Stadt",3 -  6 Jahre,2259,1135,1124
False,8326074,"Villingen-Schwenningen, Stadt",6 - 10 Jahre,3334,1810,1524
False,8326074,"Villingen-Schwenningen, Stadt",10 - 15 Jahre,4302,2214,2088
False,8326074,"Villingen-Schwenningen, Stadt",15 - 18 Jahre,2956,1522,1434
False,8326074,"Villingen-Schwenningen, Stadt",18 - 20 Jahre,1997,996,1001
False,8326074,"Villingen-Schwenningen, Stadt",20 - 25 Jahre,4857,2429,2428
False,8326074,"Villingen-Schwenningen, Stadt",25 - 30 Jahre,4752,2439,2313
False,8326074,"Villingen-Schwenningen, Stadt",30 - 35 Jahre,4672,2339,2333
False,8326074,"Villingen-Schwenningen, Stadt",35 - 40 Jahre,5998,3050,2948
False,8326074,"Villingen-Schwenningen, Stadt",40 - 45 Jahre,6188,3171,3017
False,8326074,"Villingen-Schwenningen, Stadt",45 - 50 Jahre,5943,2949,2994
False,8326074,"Villingen-Schwenningen, Stadt",50 - 55 Jahre,5400,2603,2797
False,8326074,"Villingen-Schwenningen, Stadt",55 - 60 Jahre,4917,2347,2570
False,8326074,"Villingen-Schwenningen, Stadt",60 - 65 Jahre,4819,2304,2515
False,8326074,"Villingen-Schwenningen, Stadt",65 - 75 Jahre,9789,4515,5274
False,8326074,"Villingen-Schwenningen, Stadt",75 und mehr Jahre,7458,2583,4875
False,8326074,"Villingen-Schwenningen, Stadt",Insgesamt,81778,39504,42274
False,8326075,Brigachtal,unter 3 Jahre,154,71,83
False,8326075,Brigachtal,3 -  6 Jahre,175,89,86
False,8326075,Brigachtal,6 - 10 Jahre,247,128,119
False,8326075,Brigachtal,10 - 15 Jahre,286,157,129
False,8326075,Brigachtal,15 - 18 Jahre,226,116,110
False,8326075,Brigachtal,18 - 20 Jahre,134,57,77
False,8326075,Brigachtal,20 - 25 Jahre,325,151,174
False,8326075,Brigachtal,25 - 30 Jahre,318,166,152
False,8326075,Brigachtal,30 - 35 Jahre,344,170,174
False,8326075,Brigachtal,35 - 40 Jahre,436,200,236
False,8326075,Brigachtal,40 - 45 Jahre,448,231,217
False,8326075,Brigachtal,45 - 50 Jahre,464,234,230
False,8326075,Brigachtal,50 - 55 Jahre,406,190,216
False,8326075,Brigachtal,55 - 60 Jahre,343,172,171
False,8326075,Brigachtal,60 - 65 Jahre,264,132,132
False,8326075,Brigachtal,65 - 75 Jahre,497,249,248
False,8326075,Brigachtal,75 und mehr Jahre,296,114,182
False,8326075,Brigachtal,Insgesamt,5363,2627,2736
False,8327,Landkreis Tuttlingen,unter 3 Jahre,4037,2087,1950
False,8327,Landkreis Tuttlingen,3 -  6 Jahre,4352,2198,2154
False,8327,Landkreis Tuttlingen,6 - 10 Jahre,6321,3256,3065
False,8327,Landkreis Tuttlingen,10 - 15 Jahre,8131,4169,3962
False,8327,Landkreis Tuttlingen,15 - 18 Jahre,5424,2693,2731
False,8327,Landkreis Tuttlingen,18 - 20 Jahre,3464,1805,1659
False,8327,Landkreis Tuttlingen,20 - 25 Jahre,8056,4237,3819
False,8327,Landkreis Tuttlingen,25 - 30 Jahre,7972,4038,3934
False,8327,Landkreis Tuttlingen,30 - 35 Jahre,8334,4309,4025
False,8327,Landkreis Tuttlingen,35 - 40 Jahre,10481,5373,5108
False,8327,Landkreis Tuttlingen,40 - 45 Jahre,11186,5770,5416
False,8327,Landkreis Tuttlingen,45 - 50 Jahre,10123,5079,5044
False,8327,Landkreis Tuttlingen,50 - 55 Jahre,8789,4388,4401
False,8327,Landkreis Tuttlingen,55 - 60 Jahre,7148,3598,3550
False,8327,Landkreis Tuttlingen,60 - 65 Jahre,6750,3314,3436
False,8327,Landkreis Tuttlingen,65 - 75 Jahre,14356,6850,7506
False,8327,Landkreis Tuttlingen,75 und mehr Jahre,10373,3709,6664
False,8327,Landkreis Tuttlingen,Insgesamt,135297,66873,68424
False,8327002,Aldingen,unter 3 Jahre,231,105,126
False,8327002,Aldingen,3 -  6 Jahre,262,130,132
False,8327002,Aldingen,6 - 10 Jahre,351,193,158
False,8327002,Aldingen,10 - 15 Jahre,510,274,236
False,8327002,Aldingen,15 - 18 Jahre,319,159,160
False,8327002,Aldingen,18 - 20 Jahre,207,104,103
False,8327002,Aldingen,20 - 25 Jahre,416,226,190
False,8327002,Aldingen,25 - 30 Jahre,463,218,245
False,8327002,Aldingen,30 - 35 Jahre,492,254,238
False,8327002,Aldingen,35 - 40 Jahre,630,303,327
False,8327002,Aldingen,40 - 45 Jahre,618,338,280
False,8327002,Aldingen,45 - 50 Jahre,537,281,256
False,8327002,Aldingen,50 - 55 Jahre,489,237,252
False,8327002,Aldingen,55 - 60 Jahre,367,191,176
False,8327002,Aldingen,60 - 65 Jahre,332,164,168
False,8327002,Aldingen,65 - 75 Jahre,801,388,413
False,8327002,Aldingen,75 und mehr Jahre,569,201,368
False,8327002,Aldingen,Insgesamt,7594,3766,3828
False,8327004,Bärenthal,unter 3 Jahre,10,4,6
False,8327004,Bärenthal,3 -  6 Jahre,12,6,6
False,8327004,Bärenthal,6 - 10 Jahre,22,11,11
False,8327004,Bärenthal,10 - 15 Jahre,21,9,12
False,8327004,Bärenthal,15 - 18 Jahre,14,4,10
False,8327004,Bärenthal,18 - 20 Jahre,13,9,4
False,8327004,Bärenthal,20 - 25 Jahre,25,16,9
False,8327004,Bärenthal,25 - 30 Jahre,20,10,10
False,8327004,Bärenthal,30 - 35 Jahre,21,12,9
False,8327004,Bärenthal,35 - 40 Jahre,28,12,16
False,8327004,Bärenthal,40 - 45 Jahre,34,22,12
False,8327004,Bärenthal,45 - 50 Jahre,38,16,22
False,8327004,Bärenthal,50 - 55 Jahre,31,19,12
False,8327004,Bärenthal,55 - 60 Jahre,14,7,7
False,8327004,Bärenthal,60 - 65 Jahre,20,9,11
False,8327004,Bärenthal,65 - 75 Jahre,56,25,31
False,8327004,Bärenthal,75 und mehr Jahre,45,18,27
False,8327004,Bärenthal,Insgesamt,424,209,215
False,8327005,Balgheim,unter 3 Jahre,21,14,7
False,8327005,Balgheim,3 -  6 Jahre,30,13,17
False,8327005,Balgheim,6 - 10 Jahre,51,27,24
False,8327005,Balgheim,10 - 15 Jahre,70,39,31
False,8327005,Balgheim,15 - 18 Jahre,42,30,12
False,8327005,Balgheim,18 - 20 Jahre,22,11,11
False,8327005,Balgheim,20 - 25 Jahre,60,32,28
False,8327005,Balgheim,25 - 30 Jahre,50,28,22
False,8327005,Balgheim,30 - 35 Jahre,61,34,27
False,8327005,Balgheim,35 - 40 Jahre,96,44,52
False,8327005,Balgheim,40 - 45 Jahre,82,38,44
False,8327005,Balgheim,45 - 50 Jahre,79,39,40
False,8327005,Balgheim,50 - 55 Jahre,72,35,37
False,8327005,Balgheim,55 - 60 Jahre,59,31,28
False,8327005,Balgheim,60 - 65 Jahre,49,21,28
False,8327005,Balgheim,65 - 75 Jahre,86,48,38
False,8327005,Balgheim,75 und mehr Jahre,64,27,37
False,8327005,Balgheim,Insgesamt,994,511,483
False,8327006,Böttingen,unter 3 Jahre,59,34,25
False,8327006,Böttingen,3 -  6 Jahre,53,28,25
False,8327006,Böttingen,6 - 10 Jahre,73,42,31
False,8327006,Böttingen,10 - 15 Jahre,110,52,58
False,8327006,Böttingen,15 - 18 Jahre,60,36,24
False,8327006,Böttingen,18 - 20 Jahre,32,22,10
False,8327006,Böttingen,20 - 25 Jahre,80,36,44
False,8327006,Böttingen,25 - 30 Jahre,80,44,36
False,8327006,Böttingen,30 - 35 Jahre,99,42,57
False,8327006,Böttingen,35 - 40 Jahre,126,65,61
False,8327006,Böttingen,40 - 45 Jahre,155,78,77
False,8327006,Böttingen,45 - 50 Jahre,105,67,38
False,8327006,Böttingen,50 - 55 Jahre,100,47,53
False,8327006,Böttingen,55 - 60 Jahre,66,39,27
False,8327006,Böttingen,60 - 65 Jahre,59,29,30
False,8327006,Böttingen,65 - 75 Jahre,167,77,90
False,8327006,Böttingen,75 und mehr Jahre,93,26,67
False,8327006,Böttingen,Insgesamt,1517,764,753
False,8327007,Bubsheim,unter 3 Jahre,37,22,15
False,8327007,Bubsheim,3 -  6 Jahre,50,25,25
False,8327007,Bubsheim,6 - 10 Jahre,58,35,23
False,8327007,Bubsheim,10 - 15 Jahre,66,27,39
False,8327007,Bubsheim,15 - 18 Jahre,46,29,17
False,8327007,Bubsheim,18 - 20 Jahre,27,19,8
False,8327007,Bubsheim,20 - 25 Jahre,101,67,34
False,8327007,Bubsheim,25 - 30 Jahre,96,55,41
False,8327007,Bubsheim,30 - 35 Jahre,86,45,41
False,8327007,Bubsheim,35 - 40 Jahre,72,46,26
False,8327007,Bubsheim,40 - 45 Jahre,87,50,37
False,8327007,Bubsheim,45 - 50 Jahre,96,44,52
False,8327007,Bubsheim,50 - 55 Jahre,86,44,42
False,8327007,Bubsheim,55 - 60 Jahre,59,28,31
False,8327007,Bubsheim,60 - 65 Jahre,33,18,15
False,8327007,Bubsheim,65 - 75 Jahre,103,48,55
False,8327007,Bubsheim,75 und mehr Jahre,47,18,29
False,8327007,Bubsheim,Insgesamt,1150,620,530
False,8327008,Buchheim,unter 3 Jahre,16,8,8
False,8327008,Buchheim,3 -  6 Jahre,21,8,13
False,8327008,Buchheim,6 - 10 Jahre,34,16,18
False,8327008,Buchheim,10 - 15 Jahre,57,29,28
False,8327008,Buchheim,15 - 18 Jahre,25,9,16
False,8327008,Buchheim,18 - 20 Jahre,20,11,9
False,8327008,Buchheim,20 - 25 Jahre,48,30,18
False,8327008,Buchheim,25 - 30 Jahre,31,17,14
False,8327008,Buchheim,30 - 35 Jahre,36,16,20
False,8327008,Buchheim,35 - 40 Jahre,44,25,19
False,8327008,Buchheim,40 - 45 Jahre,51,29,22
False,8327008,Buchheim,45 - 50 Jahre,51,27,24
False,8327008,Buchheim,50 - 55 Jahre,52,27,25
False,8327008,Buchheim,55 - 60 Jahre,38,25,13
False,8327008,Buchheim,60 - 65 Jahre,13,6,7
False,8327008,Buchheim,65 - 75 Jahre,52,23,29
False,8327008,Buchheim,75 und mehr Jahre,60,25,35
False,8327008,Buchheim,Insgesamt,649,331,318
False,8327009,Deilingen,unter 3 Jahre,58,25,33
False,8327009,Deilingen,3 -  6 Jahre,58,36,22
False,8327009,Deilingen,6 - 10 Jahre,86,42,44
False,8327009,Deilingen,10 - 15 Jahre,120,65,55
False,8327009,Deilingen,15 - 18 Jahre,60,23,37
False,8327009,Deilingen,18 - 20 Jahre,57,29,28
False,8327009,Deilingen,20 - 25 Jahre,100,48,52
False,8327009,Deilingen,25 - 30 Jahre,127,63,64
False,8327009,Deilingen,30 - 35 Jahre,106,61,45
False,8327009,Deilingen,35 - 40 Jahre,131,69,62
False,8327009,Deilingen,40 - 45 Jahre,133,67,66
False,8327009,Deilingen,45 - 50 Jahre,134,66,68
False,8327009,Deilingen,50 - 55 Jahre,116,63,53
False,8327009,Deilingen,55 - 60 Jahre,92,53,39
False,8327009,Deilingen,60 - 65 Jahre,62,30,32
False,8327009,Deilingen,65 - 75 Jahre,176,68,108
False,8327009,Deilingen,75 und mehr Jahre,113,39,74
False,8327009,Deilingen,Insgesamt,1729,847,882
False,8327010,Denkingen,unter 3 Jahre,80,42,38
False,8327010,Denkingen,3 -  6 Jahre,90,45,45
False,8327010,Denkingen,6 - 10 Jahre,120,65,55
False,8327010,Denkingen,10 - 15 Jahre,188,102,86
False,8327010,Denkingen,15 - 18 Jahre,107,55,52
False,8327010,Denkingen,18 - 20 Jahre,69,37,32
False,8327010,Denkingen,20 - 25 Jahre,145,80,65
False,8327010,Denkingen,25 - 30 Jahre,137,70,67
False,8327010,Denkingen,30 - 35 Jahre,169,87,82
False,8327010,Denkingen,35 - 40 Jahre,210,115,95
False,8327010,Denkingen,40 - 45 Jahre,220,112,108
False,8327010,Denkingen,45 - 50 Jahre,163,78,85
False,8327010,Denkingen,50 - 55 Jahre,174,85,89
False,8327010,Denkingen,55 - 60 Jahre,136,71,65
False,8327010,Denkingen,60 - 65 Jahre,119,55,64
False,8327010,Denkingen,65 - 75 Jahre,264,139,125
False,8327010,Denkingen,75 und mehr Jahre,155,63,92
False,8327010,Denkingen,Insgesamt,2546,1301,1245
False,8327011,Dürbheim,unter 3 Jahre,59,36,23
False,8327011,Dürbheim,3 -  6 Jahre,43,20,23
False,8327011,Dürbheim,6 - 10 Jahre,85,58,27
False,8327011,Dürbheim,10 - 15 Jahre,115,62,53
False,8327011,Dürbheim,15 - 18 Jahre,75,39,36
False,8327011,Dürbheim,18 - 20 Jahre,52,27,25
False,8327011,Dürbheim,20 - 25 Jahre,69,33,36
False,8327011,Dürbheim,25 - 30 Jahre,89,45,44
False,8327011,Dürbheim,30 - 35 Jahre,103,50,53
False,8327011,Dürbheim,35 - 40 Jahre,140,62,78
False,8327011,Dürbheim,40 - 45 Jahre,185,102,83
False,8327011,Dürbheim,45 - 50 Jahre,132,71,61
False,8327011,Dürbheim,50 - 55 Jahre,100,49,51
False,8327011,Dürbheim,55 - 60 Jahre,93,47,46
False,8327011,Dürbheim,60 - 65 Jahre,73,41,32
False,8327011,Dürbheim,65 - 75 Jahre,164,85,79
False,8327011,Dürbheim,75 und mehr Jahre,106,43,63
False,8327011,Dürbheim,Insgesamt,1683,870,813
False,8327012,Durchhausen,unter 3 Jahre,25,13,12
False,8327012,Durchhausen,3 -  6 Jahre,18,10,8
False,8327012,Durchhausen,6 - 10 Jahre,43,22,21
False,8327012,Durchhausen,10 - 15 Jahre,62,31,31
False,8327012,Durchhausen,15 - 18 Jahre,39,20,19
False,8327012,Durchhausen,18 - 20 Jahre,24,15,9
False,8327012,Durchhausen,20 - 25 Jahre,39,27,12
False,8327012,Durchhausen,25 - 30 Jahre,39,21,18
False,8327012,Durchhausen,30 - 35 Jahre,49,30,19
False,8327012,Durchhausen,35 - 40 Jahre,66,35,31
False,8327012,Durchhausen,40 - 45 Jahre,68,35,33
False,8327012,Durchhausen,45 - 50 Jahre,80,40,40
False,8327012,Durchhausen,50 - 55 Jahre,50,30,20
False,8327012,Durchhausen,55 - 60 Jahre,42,22,20
False,8327012,Durchhausen,60 - 65 Jahre,50,19,31
False,8327012,Durchhausen,65 - 75 Jahre,106,55,51
False,8327012,Durchhausen,75 und mehr Jahre,76,32,44
False,8327012,Durchhausen,Insgesamt,876,457,419
False,8327013,Egesheim,unter 3 Jahre,17,5,12
False,8327013,Egesheim,3 -  6 Jahre,19,8,11
False,8327013,Egesheim,6 - 10 Jahre,37,21,16
False,8327013,Egesheim,10 - 15 Jahre,39,18,21
False,8327013,Egesheim,15 - 18 Jahre,27,18,9
False,8327013,Egesheim,18 - 20 Jahre,17,9,8
False,8327013,Egesheim,20 - 25 Jahre,50,24,26
False,8327013,Egesheim,25 - 30 Jahre,49,30,19
False,8327013,Egesheim,30 - 35 Jahre,42,20,22
False,8327013,Egesheim,35 - 40 Jahre,44,29,15
False,8327013,Egesheim,40 - 45 Jahre,49,26,23
False,8327013,Egesheim,45 - 50 Jahre,53,29,24
False,8327013,Egesheim,50 - 55 Jahre,24,12,12
False,8327013,Egesheim,55 - 60 Jahre,36,13,23
False,8327013,Egesheim,60 - 65 Jahre,27,19,8
False,8327013,Egesheim,65 - 75 Jahre,56,25,31
False,8327013,Egesheim,75 und mehr Jahre,35,10,25
False,8327013,Egesheim,Insgesamt,621,316,305
False,8327016,"Fridingen an der Donau, Stadt",unter 3 Jahre,71,40,31
False,8327016,"Fridingen an der Donau, Stadt",3 -  6 Jahre,91,42,49
False,8327016,"Fridingen an der Donau, Stadt",6 - 10 Jahre,150,82,68
False,8327016,"Fridingen an der Donau, Stadt",10 - 15 Jahre,226,113,113
False,8327016,"Fridingen an der Donau, Stadt",15 - 18 Jahre,138,63,75
False,8327016,"Fridingen an der Donau, Stadt",18 - 20 Jahre,98,50,48
False,8327016,"Fridingen an der Donau, Stadt",20 - 25 Jahre,177,102,75
False,8327016,"Fridingen an der Donau, Stadt",25 - 30 Jahre,157,80,77
False,8327016,"Fridingen an der Donau, Stadt",30 - 35 Jahre,137,75,62
False,8327016,"Fridingen an der Donau, Stadt",35 - 40 Jahre,225,113,112
False,8327016,"Fridingen an der Donau, Stadt",40 - 45 Jahre,301,143,158
False,8327016,"Fridingen an der Donau, Stadt",45 - 50 Jahre,268,133,135
False,8327016,"Fridingen an der Donau, Stadt",50 - 55 Jahre,223,111,112
False,8327016,"Fridingen an der Donau, Stadt",55 - 60 Jahre,189,102,87
False,8327016,"Fridingen an der Donau, Stadt",60 - 65 Jahre,168,82,86
False,8327016,"Fridingen an der Donau, Stadt",65 - 75 Jahre,389,183,206
False,8327016,"Fridingen an der Donau, Stadt",75 und mehr Jahre,242,99,143
False,8327016,"Fridingen an der Donau, Stadt",Insgesamt,3250,1613,1637
False,8327017,Frittlingen,unter 3 Jahre,59,30,29
False,8327017,Frittlingen,3 -  6 Jahre,56,31,25
False,8327017,Frittlingen,6 - 10 Jahre,102,55,47
False,8327017,Frittlingen,10 - 15 Jahre,160,75,85
False,8327017,Frittlingen,15 - 18 Jahre,82,43,39
False,8327017,Frittlingen,18 - 20 Jahre,46,16,30
False,8327017,Frittlingen,20 - 25 Jahre,143,72,71
False,8327017,Frittlingen,25 - 30 Jahre,114,64,50
False,8327017,Frittlingen,30 - 35 Jahre,119,58,61
False,8327017,Frittlingen,35 - 40 Jahre,176,91,85
False,8327017,Frittlingen,40 - 45 Jahre,187,99,88
False,8327017,Frittlingen,45 - 50 Jahre,169,84,85
False,8327017,Frittlingen,50 - 55 Jahre,144,80,64
False,8327017,Frittlingen,55 - 60 Jahre,108,54,54
False,8327017,Frittlingen,60 - 65 Jahre,86,53,33
False,8327017,Frittlingen,65 - 75 Jahre,204,97,107
False,8327017,Frittlingen,75 und mehr Jahre,144,50,94
False,8327017,Frittlingen,Insgesamt,2099,1052,1047
False,8327018,"Geisingen, Stadt",unter 3 Jahre,192,106,86
False,8327018,"Geisingen, Stadt",3 -  6 Jahre,201,93,108
False,8327018,"Geisingen, Stadt",6 - 10 Jahre,304,148,156
False,8327018,"Geisingen, Stadt",10 - 15 Jahre,373,187,186
False,8327018,"Geisingen, Stadt",15 - 18 Jahre,231,125,106
False,8327018,"Geisingen, Stadt",18 - 20 Jahre,146,82,64
False,8327018,"Geisingen, Stadt",20 - 25 Jahre,355,167,188
False,8327018,"Geisingen, Stadt",25 - 30 Jahre,362,172,190
False,8327018,"Geisingen, Stadt",30 - 35 Jahre,375,187,188
False,8327018,"Geisingen, Stadt",35 - 40 Jahre,429,217,212
False,8327018,"Geisingen, Stadt",40 - 45 Jahre,493,277,216
False,8327018,"Geisingen, Stadt",45 - 50 Jahre,456,228,228
False,8327018,"Geisingen, Stadt",50 - 55 Jahre,469,249,220
False,8327018,"Geisingen, Stadt",55 - 60 Jahre,335,166,169
False,8327018,"Geisingen, Stadt",60 - 65 Jahre,289,153,136
False,8327018,"Geisingen, Stadt",65 - 75 Jahre,618,310,308
False,8327018,"Geisingen, Stadt",75 und mehr Jahre,489,174,315
False,8327018,"Geisingen, Stadt",Insgesamt,6117,3041,3076
False,8327019,Gosheim,unter 3 Jahre,134,54,80
False,8327019,Gosheim,3 -  6 Jahre,147,86,61
False,8327019,Gosheim,6 - 10 Jahre,189,98,91
False,8327019,Gosheim,10 - 15 Jahre,253,139,114
False,8327019,Gosheim,15 - 18 Jahre,181,96,85
False,8327019,Gosheim,18 - 20 Jahre,110,61,49
False,8327019,Gosheim,20 - 25 Jahre,242,127,115
False,8327019,Gosheim,25 - 30 Jahre,237,125,112
False,8327019,Gosheim,30 - 35 Jahre,216,104,112
False,8327019,Gosheim,35 - 40 Jahre,255,130,125
False,8327019,Gosheim,40 - 45 Jahre,343,164,179
False,8327019,Gosheim,45 - 50 Jahre,320,166,154
False,8327019,Gosheim,50 - 55 Jahre,228,128,100
False,8327019,Gosheim,55 - 60 Jahre,177,90,87
False,8327019,Gosheim,60 - 65 Jahre,160,76,84
False,8327019,Gosheim,65 - 75 Jahre,405,170,235
False,8327019,Gosheim,75 und mehr Jahre,247,94,153
False,8327019,Gosheim,Insgesamt,3844,1908,1936
False,8327020,Gunningen,unter 3 Jahre,16,7,9
False,8327020,Gunningen,3 -  6 Jahre,21,9,12
False,8327020,Gunningen,6 - 10 Jahre,33,16,17
False,8327020,Gunningen,10 - 15 Jahre,53,25,28
False,8327020,Gunningen,15 - 18 Jahre,38,18,20
False,8327020,Gunningen,18 - 20 Jahre,18,5,13
False,8327020,Gunningen,20 - 25 Jahre,45,29,16
False,8327020,Gunningen,25 - 30 Jahre,43,22,21
False,8327020,Gunningen,30 - 35 Jahre,43,25,18
False,8327020,Gunningen,35 - 40 Jahre,63,29,34
False,8327020,Gunningen,40 - 45 Jahre,55,24,31
False,8327020,Gunningen,45 - 50 Jahre,59,30,29
False,8327020,Gunningen,50 - 55 Jahre,55,28,27
False,8327020,Gunningen,55 - 60 Jahre,29,13,16
False,8327020,Gunningen,60 - 65 Jahre,46,26,20
False,8327020,Gunningen,65 - 75 Jahre,54,29,25
False,8327020,Gunningen,75 und mehr Jahre,41,13,28
False,8327020,Gunningen,Insgesamt,712,348,364
False,8327023,Hausen ob Verena,unter 3 Jahre,20,11,9
False,8327023,Hausen ob Verena,3 -  6 Jahre,20,9,11
False,8327023,Hausen ob Verena,6 - 10 Jahre,30,15,15
False,8327023,Hausen ob Verena,10 - 15 Jahre,57,32,25
False,8327023,Hausen ob Verena,15 - 18 Jahre,35,17,18
False,8327023,Hausen ob Verena,18 - 20 Jahre,20,8,12
False,8327023,Hausen ob Verena,20 - 25 Jahre,32,17,15
False,8327023,Hausen ob Verena,25 - 30 Jahre,39,20,19
False,8327023,Hausen ob Verena,30 - 35 Jahre,36,16,20
False,8327023,Hausen ob Verena,35 - 40 Jahre,63,33,30
False,8327023,Hausen ob Verena,40 - 45 Jahre,74,36,38
False,8327023,Hausen ob Verena,45 - 50 Jahre,56,21,35
False,8327023,Hausen ob Verena,50 - 55 Jahre,42,22,20
False,8327023,Hausen ob Verena,55 - 60 Jahre,36,20,16
False,8327023,Hausen ob Verena,60 - 65 Jahre,40,19,21
False,8327023,Hausen ob Verena,65 - 75 Jahre,89,51,38
False,8327023,Hausen ob Verena,75 und mehr Jahre,56,19,37
False,8327023,Hausen ob Verena,Insgesamt,745,366,379
False,8327025,Immendingen,unter 3 Jahre,224,109,115
False,8327025,Immendingen,3 -  6 Jahre,215,118,97
False,8327025,Immendingen,6 - 10 Jahre,270,140,130
False,8327025,Immendingen,10 - 15 Jahre,328,173,155
False,8327025,Immendingen,15 - 18 Jahre,213,106,107
False,8327025,Immendingen,18 - 20 Jahre,148,82,66
False,8327025,Immendingen,20 - 25 Jahre,404,233,171
False,8327025,Immendingen,25 - 30 Jahre,369,207,162
False,8327025,Immendingen,30 - 35 Jahre,436,251,185
False,8327025,Immendingen,35 - 40 Jahre,564,346,218
False,8327025,Immendingen,40 - 45 Jahre,539,310,229
False,8327025,Immendingen,45 - 50 Jahre,402,210,192
False,8327025,Immendingen,50 - 55 Jahre,342,168,174
False,8327025,Immendingen,55 - 60 Jahre,305,162,143
False,8327025,Immendingen,60 - 65 Jahre,259,133,126
False,8327025,Immendingen,65 - 75 Jahre,580,280,300
False,8327025,Immendingen,75 und mehr Jahre,343,140,203
False,8327025,Immendingen,Insgesamt,5941,3168,2773
False,8327027,Irndorf,unter 3 Jahre,21,10,11
False,8327027,Irndorf,3 -  6 Jahre,30,15,15
False,8327027,Irndorf,6 - 10 Jahre,36,13,23
False,8327027,Irndorf,10 - 15 Jahre,52,23,29
False,8327027,Irndorf,15 - 18 Jahre,25,9,16
False,8327027,Irndorf,18 - 20 Jahre,17,8,9
False,8327027,Irndorf,20 - 25 Jahre,35,19,16
False,8327027,Irndorf,25 - 30 Jahre,39,22,17
False,8327027,Irndorf,30 - 35 Jahre,35,14,21
False,8327027,Irndorf,35 - 40 Jahre,65,36,29
False,8327027,Irndorf,40 - 45 Jahre,72,34,38
False,8327027,Irndorf,45 - 50 Jahre,62,28,34
False,8327027,Irndorf,50 - 55 Jahre,50,29,21
False,8327027,Irndorf,55 - 60 Jahre,21,13,8
False,8327027,Irndorf,60 - 65 Jahre,33,12,21
False,8327027,Irndorf,65 - 75 Jahre,106,58,48
False,8327027,Irndorf,75 und mehr Jahre,78,23,55
False,8327027,Irndorf,Insgesamt,777,366,411
False,8327029,Königsheim,unter 3 Jahre,20,13,7
False,8327029,Königsheim,3 -  6 Jahre,16,12,4
False,8327029,Königsheim,6 - 10 Jahre,32,17,15
False,8327029,Königsheim,10 - 15 Jahre,39,21,18
False,8327029,Königsheim,15 - 18 Jahre,23,9,14
False,8327029,Königsheim,18 - 20 Jahre,14,8,6
False,8327029,Königsheim,20 - 25 Jahre,30,18,12
False,8327029,Königsheim,25 - 30 Jahre,40,18,22
False,8327029,Königsheim,30 - 35 Jahre,35,21,14
False,8327029,Königsheim,35 - 40 Jahre,45,19,26
False,8327029,Königsheim,40 - 45 Jahre,58,30,28
False,8327029,Königsheim,45 - 50 Jahre,42,25,17
False,8327029,Königsheim,50 - 55 Jahre,35,18,17
False,8327029,Königsheim,55 - 60 Jahre,20,8,12
False,8327029,Königsheim,60 - 65 Jahre,21,11,10
False,8327029,Königsheim,65 - 75 Jahre,64,33,31
False,8327029,Königsheim,75 und mehr Jahre,29,11,18
False,8327029,Königsheim,Insgesamt,563,292,271
False,8327030,Kolbingen,unter 3 Jahre,40,23,17
False,8327030,Kolbingen,3 -  6 Jahre,38,21,17
False,8327030,Kolbingen,6 - 10 Jahre,68,27,41
False,8327030,Kolbingen,10 - 15 Jahre,93,43,50
False,8327030,Kolbingen,15 - 18 Jahre,44,22,22
False,8327030,Kolbingen,18 - 20 Jahre,26,14,12
False,8327030,Kolbingen,20 - 25 Jahre,64,29,35
False,8327030,Kolbingen,25 - 30 Jahre,67,36,31
False,8327030,Kolbingen,30 - 35 Jahre,80,42,38
False,8327030,Kolbingen,35 - 40 Jahre,124,68,56
False,8327030,Kolbingen,40 - 45 Jahre,119,62,57
False,8327030,Kolbingen,45 - 50 Jahre,100,50,50
False,8327030,Kolbingen,50 - 55 Jahre,80,37,43
False,8327030,Kolbingen,55 - 60 Jahre,74,40,34
False,8327030,Kolbingen,60 - 65 Jahre,64,29,35
False,8327030,Kolbingen,65 - 75 Jahre,154,77,77
False,8327030,Kolbingen,75 und mehr Jahre,92,33,59
False,8327030,Kolbingen,Insgesamt,1327,653,674
False,8327033,Mahlstetten,unter 3 Jahre,17,9,8
False,8327033,Mahlstetten,3 -  6 Jahre,16,7,9
False,8327033,Mahlstetten,6 - 10 Jahre,36,20,16
False,8327033,Mahlstetten,10 - 15 Jahre,43,24,19
False,8327033,Mahlstetten,15 - 18 Jahre,35,17,18
False,8327033,Mahlstetten,18 - 20 Jahre,18,11,7
False,8327033,Mahlstetten,20 - 25 Jahre,47,29,18
False,8327033,Mahlstetten,25 - 30 Jahre,31,20,11
False,8327033,Mahlstetten,30 - 35 Jahre,36,17,19
False,8327033,Mahlstetten,35 - 40 Jahre,49,28,21
False,8327033,Mahlstetten,40 - 45 Jahre,56,25,31
False,8327033,Mahlstetten,45 - 50 Jahre,85,42,43
False,8327033,Mahlstetten,50 - 55 Jahre,54,32,22
False,8327033,Mahlstetten,55 - 60 Jahre,30,17,13
False,8327033,Mahlstetten,60 - 65 Jahre,27,13,14
False,8327033,Mahlstetten,65 - 75 Jahre,93,41,52
False,8327033,Mahlstetten,75 und mehr Jahre,67,28,39
False,8327033,Mahlstetten,Insgesamt,740,380,360
False,8327036,"Mühlheim an der Donau, Stadt",unter 3 Jahre,82,44,38
False,8327036,"Mühlheim an der Donau, Stadt",3 -  6 Jahre,124,57,67
False,8327036,"Mühlheim an der Donau, Stadt",6 - 10 Jahre,164,90,74
False,8327036,"Mühlheim an der Donau, Stadt",10 - 15 Jahre,176,82,94
False,8327036,"Mühlheim an der Donau, Stadt",15 - 18 Jahre,126,67,59
False,8327036,"Mühlheim an der Donau, Stadt",18 - 20 Jahre,76,44,32
False,8327036,"Mühlheim an der Donau, Stadt",20 - 25 Jahre,176,89,87
False,8327036,"Mühlheim an der Donau, Stadt",25 - 30 Jahre,174,96,78
False,8327036,"Mühlheim an der Donau, Stadt",30 - 35 Jahre,222,117,105
False,8327036,"Mühlheim an der Donau, Stadt",35 - 40 Jahre,283,131,152
False,8327036,"Mühlheim an der Donau, Stadt",40 - 45 Jahre,293,151,142
False,8327036,"Mühlheim an der Donau, Stadt",45 - 50 Jahre,244,121,123
False,8327036,"Mühlheim an der Donau, Stadt",50 - 55 Jahre,240,112,128
False,8327036,"Mühlheim an der Donau, Stadt",55 - 60 Jahre,224,106,118
False,8327036,"Mühlheim an der Donau, Stadt",60 - 65 Jahre,220,119,101
False,8327036,"Mühlheim an der Donau, Stadt",65 - 75 Jahre,391,199,192
False,8327036,"Mühlheim an der Donau, Stadt",75 und mehr Jahre,261,107,154
False,8327036,"Mühlheim an der Donau, Stadt",Insgesamt,3476,1732,1744
False,8327038,Neuhausen ob Eck,unter 3 Jahre,104,56,48
False,8327038,Neuhausen ob Eck,3 -  6 Jahre,130,61,69
False,8327038,Neuhausen ob Eck,6 - 10 Jahre,237,113,124
False,8327038,Neuhausen ob Eck,10 - 15 Jahre,269,145,124
False,8327038,Neuhausen ob Eck,15 - 18 Jahre,187,106,81
False,8327038,Neuhausen ob Eck,18 - 20 Jahre,116,65,51
False,8327038,Neuhausen ob Eck,20 - 25 Jahre,256,150,106
False,8327038,Neuhausen ob Eck,25 - 30 Jahre,192,95,97
False,8327038,Neuhausen ob Eck,30 - 35 Jahre,213,104,109
False,8327038,Neuhausen ob Eck,35 - 40 Jahre,310,162,148
False,8327038,Neuhausen ob Eck,40 - 45 Jahre,381,191,190
False,8327038,Neuhausen ob Eck,45 - 50 Jahre,327,165,162
False,8327038,Neuhausen ob Eck,50 - 55 Jahre,241,127,114
False,8327038,Neuhausen ob Eck,55 - 60 Jahre,165,84,81
False,8327038,Neuhausen ob Eck,60 - 65 Jahre,157,64,93
False,8327038,Neuhausen ob Eck,65 - 75 Jahre,367,184,183
False,8327038,Neuhausen ob Eck,75 und mehr Jahre,226,77,149
False,8327038,Neuhausen ob Eck,Insgesamt,3878,1949,1929
False,8327040,Reichenbach am Heuberg,unter 3 Jahre,25,9,16
False,8327040,Reichenbach am Heuberg,3 -  6 Jahre,17,8,9
False,8327040,Reichenbach am Heuberg,6 - 10 Jahre,29,20,9
False,8327040,Reichenbach am Heuberg,10 - 15 Jahre,45,23,22
False,8327040,Reichenbach am Heuberg,15 - 18 Jahre,29,16,13
False,8327040,Reichenbach am Heuberg,18 - 20 Jahre,19,11,8
False,8327040,Reichenbach am Heuberg,20 - 25 Jahre,33,13,20
False,8327040,Reichenbach am Heuberg,25 - 30 Jahre,32,14,18
False,8327040,Reichenbach am Heuberg,30 - 35 Jahre,31,17,14
False,8327040,Reichenbach am Heuberg,35 - 40 Jahre,37,16,21
False,8327040,Reichenbach am Heuberg,40 - 45 Jahre,52,24,28
False,8327040,Reichenbach am Heuberg,45 - 50 Jahre,50,28,22
False,8327040,Reichenbach am Heuberg,50 - 55 Jahre,33,21,12
False,8327040,Reichenbach am Heuberg,55 - 60 Jahre,20,8,12
False,8327040,Reichenbach am Heuberg,60 - 65 Jahre,15,4,11
False,8327040,Reichenbach am Heuberg,65 - 75 Jahre,59,25,34
False,8327040,Reichenbach am Heuberg,75 und mehr Jahre,24,6,18
False,8327040,Reichenbach am Heuberg,Insgesamt,550,263,287
False,8327041,Renquishausen,unter 3 Jahre,24,11,13
False,8327041,Renquishausen,3 -  6 Jahre,31,16,15
False,8327041,Renquishausen,6 - 10 Jahre,33,18,15
False,8327041,Renquishausen,10 - 15 Jahre,56,31,25
False,8327041,Renquishausen,15 - 18 Jahre,37,23,14
False,8327041,Renquishausen,18 - 20 Jahre,19,8,11
False,8327041,Renquishausen,20 - 25 Jahre,36,20,16
False,8327041,Renquishausen,25 - 30 Jahre,49,21,28
False,8327041,Renquishausen,30 - 35 Jahre,35,18,17
False,8327041,Renquishausen,35 - 40 Jahre,78,46,32
False,8327041,Renquishausen,40 - 45 Jahre,71,32,39
False,8327041,Renquishausen,45 - 50 Jahre,65,33,32
False,8327041,Renquishausen,50 - 55 Jahre,47,26,21
False,8327041,Renquishausen,55 - 60 Jahre,35,17,18
False,8327041,Renquishausen,60 - 65 Jahre,31,16,15
False,8327041,Renquishausen,65 - 75 Jahre,55,28,27
False,8327041,Renquishausen,75 und mehr Jahre,52,27,25
False,8327041,Renquishausen,Insgesamt,754,391,363
False,8327046,"Spaichingen, Stadt",unter 3 Jahre,327,165,162
False,8327046,"Spaichingen, Stadt",3 -  6 Jahre,393,195,198
False,8327046,"Spaichingen, Stadt",6 - 10 Jahre,555,301,254
False,8327046,"Spaichingen, Stadt",10 - 15 Jahre,742,394,348
False,8327046,"Spaichingen, Stadt",15 - 18 Jahre,464,220,244
False,8327046,"Spaichingen, Stadt",18 - 20 Jahre,320,161,159
False,8327046,"Spaichingen, Stadt",20 - 25 Jahre,753,390,363
False,8327046,"Spaichingen, Stadt",25 - 30 Jahre,714,363,351
False,8327046,"Spaichingen, Stadt",30 - 35 Jahre,764,368,396
False,8327046,"Spaichingen, Stadt",35 - 40 Jahre,840,443,397
False,8327046,"Spaichingen, Stadt",40 - 45 Jahre,976,480,496
False,8327046,"Spaichingen, Stadt",45 - 50 Jahre,891,454,437
False,8327046,"Spaichingen, Stadt",50 - 55 Jahre,880,417,463
False,8327046,"Spaichingen, Stadt",55 - 60 Jahre,690,344,346
False,8327046,"Spaichingen, Stadt",60 - 65 Jahre,653,317,336
False,8327046,"Spaichingen, Stadt",65 - 75 Jahre,1404,678,726
False,8327046,"Spaichingen, Stadt",75 und mehr Jahre,1058,339,719
False,8327046,"Spaichingen, Stadt",Insgesamt,12424,6029,6395
False,8327048,Talheim,unter 3 Jahre,38,19,19
False,8327048,Talheim,3 -  6 Jahre,44,18,26
False,8327048,Talheim,6 - 10 Jahre,61,26,35
False,8327048,Talheim,10 - 15 Jahre,81,46,35
False,8327048,Talheim,15 - 18 Jahre,44,21,23
False,8327048,Talheim,18 - 20 Jahre,25,12,13
False,8327048,Talheim,20 - 25 Jahre,64,37,27
False,8327048,Talheim,25 - 30 Jahre,77,42,35
False,8327048,Talheim,30 - 35 Jahre,60,31,29
False,8327048,Talheim,35 - 40 Jahre,104,43,61
False,8327048,Talheim,40 - 45 Jahre,107,57,50
False,8327048,Talheim,45 - 50 Jahre,90,41,49
False,8327048,Talheim,50 - 55 Jahre,78,44,34
False,8327048,Talheim,55 - 60 Jahre,58,26,32
False,8327048,Talheim,60 - 65 Jahre,60,33,27
False,8327048,Talheim,65 - 75 Jahre,122,55,67
False,8327048,Talheim,75 und mehr Jahre,103,36,67
False,8327048,Talheim,Insgesamt,1216,587,629
False,8327049,"Trossingen, Stadt",unter 3 Jahre,482,272,210
False,8327049,"Trossingen, Stadt",3 -  6 Jahre,496,260,236
False,8327049,"Trossingen, Stadt",6 - 10 Jahre,689,352,337
False,8327049,"Trossingen, Stadt",10 - 15 Jahre,867,433,434
False,8327049,"Trossingen, Stadt",15 - 18 Jahre,635,310,325
False,8327049,"Trossingen, Stadt",18 - 20 Jahre,387,178,209
False,8327049,"Trossingen, Stadt",20 - 25 Jahre,997,508,489
False,8327049,"Trossingen, Stadt",25 - 30 Jahre,931,456,475
False,8327049,"Trossingen, Stadt",30 - 35 Jahre,914,504,410
False,8327049,"Trossingen, Stadt",35 - 40 Jahre,1116,553,563
False,8327049,"Trossingen, Stadt",40 - 45 Jahre,1147,593,554
False,8327049,"Trossingen, Stadt",45 - 50 Jahre,1088,518,570
False,8327049,"Trossingen, Stadt",50 - 55 Jahre,1012,501,511
False,8327049,"Trossingen, Stadt",55 - 60 Jahre,809,397,412
False,8327049,"Trossingen, Stadt",60 - 65 Jahre,743,365,378
False,8327049,"Trossingen, Stadt",65 - 75 Jahre,1583,742,841
False,8327049,"Trossingen, Stadt",75 und mehr Jahre,1257,420,837
False,8327049,"Trossingen, Stadt",Insgesamt,15153,7362,7791
False,8327050,"Tuttlingen, Stadt",unter 3 Jahre,1035,549,486
False,8327050,"Tuttlingen, Stadt",3 -  6 Jahre,1054,535,519
False,8327050,"Tuttlingen, Stadt",6 - 10 Jahre,1498,756,742
False,8327050,"Tuttlingen, Stadt",10 - 15 Jahre,1873,962,911
False,8327050,"Tuttlingen, Stadt",15 - 18 Jahre,1353,636,717
False,8327050,"Tuttlingen, Stadt",18 - 20 Jahre,859,454,405
False,8327050,"Tuttlingen, Stadt",20 - 25 Jahre,2059,1065,994
False,8327050,"Tuttlingen, Stadt",25 - 30 Jahre,2187,1090,1097
False,8327050,"Tuttlingen, Stadt",30 - 35 Jahre,2278,1195,1083
False,8327050,"Tuttlingen, Stadt",35 - 40 Jahre,2681,1378,1303
False,8327050,"Tuttlingen, Stadt",40 - 45 Jahre,2651,1362,1289
False,8327050,"Tuttlingen, Stadt",45 - 50 Jahre,2535,1254,1281
False,8327050,"Tuttlingen, Stadt",50 - 55 Jahre,2130,1027,1103
False,8327050,"Tuttlingen, Stadt",55 - 60 Jahre,1893,915,978
False,8327050,"Tuttlingen, Stadt",60 - 65 Jahre,1954,961,993
False,8327050,"Tuttlingen, Stadt",65 - 75 Jahre,3786,1751,2035
False,8327050,"Tuttlingen, Stadt",75 und mehr Jahre,3060,1066,1994
False,8327050,"Tuttlingen, Stadt",Insgesamt,34886,16956,17930
False,8327051,Wehingen,unter 3 Jahre,122,64,58
False,8327051,Wehingen,3 -  6 Jahre,120,57,63
False,8327051,Wehingen,6 - 10 Jahre,196,101,95
False,8327051,Wehingen,10 - 15 Jahre,229,119,110
False,8327051,Wehingen,15 - 18 Jahre,172,89,83
False,8327051,Wehingen,18 - 20 Jahre,92,45,47
False,8327051,Wehingen,20 - 25 Jahre,252,132,120
False,8327051,Wehingen,25 - 30 Jahre,223,122,101
False,8327051,Wehingen,30 - 35 Jahre,209,100,109
False,8327051,Wehingen,35 - 40 Jahre,279,141,138
False,8327051,Wehingen,40 - 45 Jahre,320,183,137
False,8327051,Wehingen,45 - 50 Jahre,257,124,133
False,8327051,Wehingen,50 - 55 Jahre,243,117,126
False,8327051,Wehingen,55 - 60 Jahre,208,109,99
False,8327051,Wehingen,60 - 65 Jahre,167,82,85
False,8327051,Wehingen,65 - 75 Jahre,371,175,196
False,8327051,Wehingen,75 und mehr Jahre,243,74,169
False,8327051,Wehingen,Insgesamt,3703,1834,1869
False,8327054,Wurmlingen,unter 3 Jahre,91,38,53
False,8327054,Wurmlingen,3 -  6 Jahre,104,59,45
False,8327054,Wurmlingen,6 - 10 Jahre,170,84,86
False,8327054,Wurmlingen,10 - 15 Jahre,206,92,114
False,8327054,Wurmlingen,15 - 18 Jahre,141,75,66
False,8327054,Wurmlingen,18 - 20 Jahre,96,53,43
False,8327054,Wurmlingen,20 - 25 Jahre,231,125,106
False,8327054,Wurmlingen,25 - 30 Jahre,173,91,82
False,8327054,Wurmlingen,30 - 35 Jahre,169,80,89
False,8327054,Wurmlingen,35 - 40 Jahre,274,122,152
False,8327054,Wurmlingen,40 - 45 Jahre,344,173,171
False,8327054,Wurmlingen,45 - 50 Jahre,327,169,158
False,8327054,Wurmlingen,50 - 55 Jahre,253,130,123
False,8327054,Wurmlingen,55 - 60 Jahre,218,122,96
False,8327054,Wurmlingen,60 - 65 Jahre,230,110,120
False,8327054,Wurmlingen,65 - 75 Jahre,494,234,260
False,8327054,Wurmlingen,75 und mehr Jahre,295,116,179
False,8327054,Wurmlingen,Insgesamt,3816,1873,1943
False,8327055,Seitingen-Oberflacht,unter 3 Jahre,68,32,36
False,8327055,Seitingen-Oberflacht,3 -  6 Jahre,85,41,44
False,8327055,Seitingen-Oberflacht,6 - 10 Jahre,130,65,65
False,8327055,Seitingen-Oberflacht,10 - 15 Jahre,143,74,69
False,8327055,Seitingen-Oberflacht,15 - 18 Jahre,100,57,43
False,8327055,Seitingen-Oberflacht,18 - 20 Jahre,66,40,26
False,8327055,Seitingen-Oberflacht,20 - 25 Jahre,98,56,42
False,8327055,Seitingen-Oberflacht,25 - 30 Jahre,125,60,65
False,8327055,Seitingen-Oberflacht,30 - 35 Jahre,140,63,77
False,8327055,Seitingen-Oberflacht,35 - 40 Jahre,184,93,91
False,8327055,Seitingen-Oberflacht,40 - 45 Jahre,211,102,109
False,8327055,Seitingen-Oberflacht,45 - 50 Jahre,177,105,72
False,8327055,Seitingen-Oberflacht,50 - 55 Jahre,129,59,70
False,8327055,Seitingen-Oberflacht,55 - 60 Jahre,136,65,71
False,8327055,Seitingen-Oberflacht,60 - 65 Jahre,135,60,75
False,8327055,Seitingen-Oberflacht,65 - 75 Jahre,234,123,111
False,8327055,Seitingen-Oberflacht,75 und mehr Jahre,138,63,75
False,8327055,Seitingen-Oberflacht,Insgesamt,2299,1158,1141
False,8327056,Rietheim-Weilheim,unter 3 Jahre,76,44,32
False,8327056,Rietheim-Weilheim,3 -  6 Jahre,80,35,45
False,8327056,Rietheim-Weilheim,6 - 10 Jahre,111,45,66
False,8327056,Rietheim-Weilheim,10 - 15 Jahre,142,71,71
False,8327056,Rietheim-Weilheim,15 - 18 Jahre,85,46,39
False,8327056,Rietheim-Weilheim,18 - 20 Jahre,75,41,34
False,8327056,Rietheim-Weilheim,20 - 25 Jahre,147,69,78
False,8327056,Rietheim-Weilheim,25 - 30 Jahre,164,86,78
False,8327056,Rietheim-Weilheim,30 - 35 Jahre,163,85,78
False,8327056,Rietheim-Weilheim,35 - 40 Jahre,231,117,114
False,8327056,Rietheim-Weilheim,40 - 45 Jahre,238,103,135
False,8327056,Rietheim-Weilheim,45 - 50 Jahre,214,100,114
False,8327056,Rietheim-Weilheim,50 - 55 Jahre,171,84,87
False,8327056,Rietheim-Weilheim,55 - 60 Jahre,139,67,72
False,8327056,Rietheim-Weilheim,60 - 65 Jahre,149,63,86
False,8327056,Rietheim-Weilheim,65 - 75 Jahre,291,145,146
False,8327056,Rietheim-Weilheim,75 und mehr Jahre,204,90,114
False,8327056,Rietheim-Weilheim,Insgesamt,2680,1291,1389
False,8327057,Emmingen-Liptingen,unter 3 Jahre,136,64,72
False,8327057,Emmingen-Liptingen,3 -  6 Jahre,167,84,83
False,8327057,Emmingen-Liptingen,6 - 10 Jahre,238,122,116
False,8327057,Emmingen-Liptingen,10 - 15 Jahre,267,134,133
False,8327057,Emmingen-Liptingen,15 - 18 Jahre,192,80,112
False,8327057,Emmingen-Liptingen,18 - 20 Jahre,113,55,58
False,8327057,Emmingen-Liptingen,20 - 25 Jahre,247,122,125
False,8327057,Emmingen-Liptingen,25 - 30 Jahre,252,115,137
False,8327057,Emmingen-Liptingen,30 - 35 Jahre,324,166,158
False,8327057,Emmingen-Liptingen,35 - 40 Jahre,419,213,206
False,8327057,Emmingen-Liptingen,40 - 45 Jahre,416,218,198
False,8327057,Emmingen-Liptingen,45 - 50 Jahre,371,192,179
False,8327057,Emmingen-Liptingen,50 - 55 Jahre,316,173,143
False,8327057,Emmingen-Liptingen,55 - 60 Jahre,227,126,101
False,8327057,Emmingen-Liptingen,60 - 65 Jahre,206,102,104
False,8327057,Emmingen-Liptingen,65 - 75 Jahre,412,201,211
False,8327057,Emmingen-Liptingen,75 und mehr Jahre,261,102,159
False,8327057,Emmingen-Liptingen,Insgesamt,4564,2269,2295
False,8335,Landkreis Konstanz,unter 3 Jahre,6868,3515,3353
False,8335,Landkreis Konstanz,3 -  6 Jahre,7626,3821,3805
False,8335,Landkreis Konstanz,6 - 10 Jahre,11186,5655,5531
False,8335,Landkreis Konstanz,10 - 15 Jahre,14160,7337,6823
False,8335,Landkreis Konstanz,15 - 18 Jahre,8894,4460,4434
False,8335,Landkreis Konstanz,18 - 20 Jahre,6060,3020,3040
False,8335,Landkreis Konstanz,20 - 25 Jahre,18199,8783,9416
False,8335,Landkreis Konstanz,25 - 30 Jahre,16486,8265,8221
False,8335,Landkreis Konstanz,30 - 35 Jahre,16301,8095,8206
False,8335,Landkreis Konstanz,35 - 40 Jahre,23140,11454,11686
False,8335,Landkreis Konstanz,40 - 45 Jahre,25380,13002,12378
False,8335,Landkreis Konstanz,45 - 50 Jahre,20863,10632,10231
False,8335,Landkreis Konstanz,50 - 55 Jahre,17437,8675,8762
False,8335,Landkreis Konstanz,55 - 60 Jahre,15178,7516,7662
False,8335,Landkreis Konstanz,60 - 65 Jahre,14926,7255,7671
False,8335,Landkreis Konstanz,65 - 75 Jahre,29344,13924,15420
False,8335,Landkreis Konstanz,75 und mehr Jahre,22644,7854,14790
False,8335,Landkreis Konstanz,Insgesamt,274692,133263,141429
False,8335001,"Aach, Stadt",unter 3 Jahre,71,38,33
False,8335001,"Aach, Stadt",3 -  6 Jahre,75,32,43
False,8335001,"Aach, Stadt",6 - 10 Jahre,123,70,53
False,8335001,"Aach, Stadt",10 - 15 Jahre,160,94,66
False,8335001,"Aach, Stadt",15 - 18 Jahre,79,41,38
False,8335001,"Aach, Stadt",18 - 20 Jahre,53,26,27
False,8335001,"Aach, Stadt",20 - 25 Jahre,118,61,57
False,8335001,"Aach, Stadt",25 - 30 Jahre,129,59,70
False,8335001,"Aach, Stadt",30 - 35 Jahre,131,72,59
False,8335001,"Aach, Stadt",35 - 40 Jahre,218,130,88
False,8335001,"Aach, Stadt",40 - 45 Jahre,219,110,109
False,8335001,"Aach, Stadt",45 - 50 Jahre,178,86,92
False,8335001,"Aach, Stadt",50 - 55 Jahre,154,74,80
False,8335001,"Aach, Stadt",55 - 60 Jahre,105,59,46
False,8335001,"Aach, Stadt",60 - 65 Jahre,78,40,38
False,8335001,"Aach, Stadt",65 - 75 Jahre,189,89,100
False,8335001,"Aach, Stadt",75 und mehr Jahre,150,53,97
False,8335001,"Aach, Stadt",Insgesamt,2230,1134,1096
False,8335002,Allensbach,unter 3 Jahre,154,88,66
False,8335002,Allensbach,3 -  6 Jahre,212,116,96
False,8335002,Allensbach,6 - 10 Jahre,284,139,145
False,8335002,Allensbach,10 - 15 Jahre,378,194,184
False,8335002,Allensbach,15 - 18 Jahre,231,108,123
False,8335002,Allensbach,18 - 20 Jahre,141,64,77
False,8335002,Allensbach,20 - 25 Jahre,357,172,185
False,8335002,Allensbach,25 - 30 Jahre,351,169,182
False,8335002,Allensbach,30 - 35 Jahre,385,159,226
False,8335002,Allensbach,35 - 40 Jahre,588,256,332
False,8335002,Allensbach,40 - 45 Jahre,716,339,377
False,8335002,Allensbach,45 - 50 Jahre,596,285,311
False,8335002,Allensbach,50 - 55 Jahre,492,252,240
False,8335002,Allensbach,55 - 60 Jahre,399,180,219
False,8335002,Allensbach,60 - 65 Jahre,479,232,247
False,8335002,Allensbach,65 - 75 Jahre,732,322,410
False,8335002,Allensbach,75 und mehr Jahre,616,187,429
False,8335002,Allensbach,Insgesamt,7111,3262,3849
False,8335015,Büsingen am Hochrhein,unter 3 Jahre,23,11,12
False,8335015,Büsingen am Hochrhein,3 -  6 Jahre,33,17,16
False,8335015,Büsingen am Hochrhein,6 - 10 Jahre,57,27,30
False,8335015,Büsingen am Hochrhein,10 - 15 Jahre,73,41,32
False,8335015,Büsingen am Hochrhein,15 - 18 Jahre,57,24,33
False,8335015,Büsingen am Hochrhein,18 - 20 Jahre,37,21,16
False,8335015,Büsingen am Hochrhein,20 - 25 Jahre,69,43,26
False,8335015,Büsingen am Hochrhein,25 - 30 Jahre,48,23,25
False,8335015,Büsingen am Hochrhein,30 - 35 Jahre,57,32,25
False,8335015,Büsingen am Hochrhein,35 - 40 Jahre,82,35,47
False,8335015,Büsingen am Hochrhein,40 - 45 Jahre,108,57,51
False,8335015,Büsingen am Hochrhein,45 - 50 Jahre,91,40,51
False,8335015,Büsingen am Hochrhein,50 - 55 Jahre,106,59,47
False,8335015,Büsingen am Hochrhein,55 - 60 Jahre,91,33,58
False,8335015,Büsingen am Hochrhein,60 - 65 Jahre,91,40,51
False,8335015,Büsingen am Hochrhein,65 - 75 Jahre,239,118,121
False,8335015,Büsingen am Hochrhein,75 und mehr Jahre,167,75,92
False,8335015,Büsingen am Hochrhein,Insgesamt,1429,696,733
False,8335021,Eigeltingen,unter 3 Jahre,92,49,43
False,8335021,Eigeltingen,3 -  6 Jahre,119,54,65
False,8335021,Eigeltingen,6 - 10 Jahre,187,95,92
False,8335021,Eigeltingen,10 - 15 Jahre,251,117,134
False,8335021,Eigeltingen,15 - 18 Jahre,122,70,52
False,8335021,Eigeltingen,18 - 20 Jahre,92,54,38
False,8335021,Eigeltingen,20 - 25 Jahre,193,100,93
False,8335021,Eigeltingen,25 - 30 Jahre,206,90,116
False,8335021,Eigeltingen,30 - 35 Jahre,173,75,98
False,8335021,Eigeltingen,35 - 40 Jahre,308,166,142
False,8335021,Eigeltingen,40 - 45 Jahre,320,158,162
False,8335021,Eigeltingen,45 - 50 Jahre,307,155,152
False,8335021,Eigeltingen,50 - 55 Jahre,230,120,110
False,8335021,Eigeltingen,55 - 60 Jahre,198,104,94
False,8335021,Eigeltingen,60 - 65 Jahre,162,83,79
False,8335021,Eigeltingen,65 - 75 Jahre,330,155,175
False,8335021,Eigeltingen,75 und mehr Jahre,226,83,143
False,8335021,Eigeltingen,Insgesamt,3516,1728,1788
False,8335022,"Engen, Stadt",unter 3 Jahre,278,140,138
False,8335022,"Engen, Stadt",3 -  6 Jahre,321,162,159
False,8335022,"Engen, Stadt",6 - 10 Jahre,508,266,242
False,8335022,"Engen, Stadt",10 - 15 Jahre,625,334,291
False,8335022,"Engen, Stadt",15 - 18 Jahre,411,211,200
False,8335022,"Engen, Stadt",18 - 20 Jahre,224,117,107
False,8335022,"Engen, Stadt",20 - 25 Jahre,542,263,279
False,8335022,"Engen, Stadt",25 - 30 Jahre,506,231,275
False,8335022,"Engen, Stadt",30 - 35 Jahre,621,299,322
False,8335022,"Engen, Stadt",35 - 40 Jahre,802,397,405
False,8335022,"Engen, Stadt",40 - 45 Jahre,926,489,437
False,8335022,"Engen, Stadt",45 - 50 Jahre,789,414,375
False,8335022,"Engen, Stadt",50 - 55 Jahre,644,326,318
False,8335022,"Engen, Stadt",55 - 60 Jahre,548,269,279
False,8335022,"Engen, Stadt",60 - 65 Jahre,528,247,281
False,8335022,"Engen, Stadt",65 - 75 Jahre,1172,573,599
False,8335022,"Engen, Stadt",75 und mehr Jahre,780,242,538
False,8335022,"Engen, Stadt",Insgesamt,10225,4980,5245
False,8335025,Gaienhofen,unter 3 Jahre,71,34,37
False,8335025,Gaienhofen,3 -  6 Jahre,71,38,33
False,8335025,Gaienhofen,6 - 10 Jahre,111,47,64
False,8335025,Gaienhofen,10 - 15 Jahre,153,93,60
False,8335025,Gaienhofen,15 - 18 Jahre,116,66,50
False,8335025,Gaienhofen,18 - 20 Jahre,78,35,43
False,8335025,Gaienhofen,20 - 25 Jahre,153,80,73
False,8335025,Gaienhofen,25 - 30 Jahre,163,91,72
False,8335025,Gaienhofen,30 - 35 Jahre,196,99,97
False,8335025,Gaienhofen,35 - 40 Jahre,228,97,131
False,8335025,Gaienhofen,40 - 45 Jahre,252,128,124
False,8335025,Gaienhofen,45 - 50 Jahre,245,101,144
False,8335025,Gaienhofen,50 - 55 Jahre,231,113,118
False,8335025,Gaienhofen,55 - 60 Jahre,224,109,115
False,8335025,Gaienhofen,60 - 65 Jahre,239,109,130
False,8335025,Gaienhofen,65 - 75 Jahre,410,210,200
False,8335025,Gaienhofen,75 und mehr Jahre,276,98,178
False,8335025,Gaienhofen,Insgesamt,3217,1548,1669
False,8335026,Gailingen am Hochrhein,unter 3 Jahre,73,37,36
False,8335026,Gailingen am Hochrhein,3 -  6 Jahre,88,45,43
False,8335026,Gailingen am Hochrhein,6 - 10 Jahre,118,53,65
False,8335026,Gailingen am Hochrhein,10 - 15 Jahre,152,81,71
False,8335026,Gailingen am Hochrhein,15 - 18 Jahre,84,44,40
False,8335026,Gailingen am Hochrhein,18 - 20 Jahre,60,25,35
False,8335026,Gailingen am Hochrhein,20 - 25 Jahre,145,67,78
False,8335026,Gailingen am Hochrhein,25 - 30 Jahre,166,73,93
False,8335026,Gailingen am Hochrhein,30 - 35 Jahre,266,145,121
False,8335026,Gailingen am Hochrhein,35 - 40 Jahre,374,221,153
False,8335026,Gailingen am Hochrhein,40 - 45 Jahre,238,115,123
False,8335026,Gailingen am Hochrhein,45 - 50 Jahre,236,115,121
False,8335026,Gailingen am Hochrhein,50 - 55 Jahre,180,87,93
False,8335026,Gailingen am Hochrhein,55 - 60 Jahre,141,71,70
False,8335026,Gailingen am Hochrhein,60 - 65 Jahre,156,79,77
False,8335026,Gailingen am Hochrhein,65 - 75 Jahre,328,157,171
False,8335026,Gailingen am Hochrhein,75 und mehr Jahre,265,102,163
False,8335026,Gailingen am Hochrhein,Insgesamt,3070,1517,1553
False,8335028,Gottmadingen,unter 3 Jahre,272,137,135
False,8335028,Gottmadingen,3 -  6 Jahre,340,167,173
False,8335028,Gottmadingen,6 - 10 Jahre,509,273,236
False,8335028,Gottmadingen,10 - 15 Jahre,616,328,288
False,8335028,Gottmadingen,15 - 18 Jahre,387,203,184
False,8335028,Gottmadingen,18 - 20 Jahre,205,110,95
False,8335028,Gottmadingen,20 - 25 Jahre,506,266,240
False,8335028,Gottmadingen,25 - 30 Jahre,552,275,277
False,8335028,Gottmadingen,30 - 35 Jahre,636,293,343
False,8335028,Gottmadingen,35 - 40 Jahre,895,426,469
False,8335028,Gottmadingen,40 - 45 Jahre,910,446,464
False,8335028,Gottmadingen,45 - 50 Jahre,786,413,373
False,8335028,Gottmadingen,50 - 55 Jahre,570,294,276
False,8335028,Gottmadingen,55 - 60 Jahre,559,280,279
False,8335028,Gottmadingen,60 - 65 Jahre,544,252,292
False,8335028,Gottmadingen,65 - 75 Jahre,1193,559,634
False,8335028,Gottmadingen,75 und mehr Jahre,923,347,576
False,8335028,Gottmadingen,Insgesamt,10403,5069,5334
False,8335035,Hilzingen,unter 3 Jahre,229,109,120
False,8335035,Hilzingen,3 -  6 Jahre,281,132,149
False,8335035,Hilzingen,6 - 10 Jahre,372,187,185
False,8335035,Hilzingen,10 - 15 Jahre,532,263,269
False,8335035,Hilzingen,15 - 18 Jahre,342,170,172
False,8335035,Hilzingen,18 - 20 Jahre,211,120,91
False,8335035,Hilzingen,20 - 25 Jahre,430,223,207
False,8335035,Hilzingen,25 - 30 Jahre,426,210,216
False,8335035,Hilzingen,30 - 35 Jahre,503,244,259
False,8335035,Hilzingen,35 - 40 Jahre,757,371,386
False,8335035,Hilzingen,40 - 45 Jahre,877,445,432
False,8335035,Hilzingen,45 - 50 Jahre,604,303,301
False,8335035,Hilzingen,50 - 55 Jahre,568,278,290
False,8335035,Hilzingen,55 - 60 Jahre,466,237,229
False,8335035,Hilzingen,60 - 65 Jahre,427,198,229
False,8335035,Hilzingen,65 - 75 Jahre,843,428,415
False,8335035,Hilzingen,75 und mehr Jahre,512,197,315
False,8335035,Hilzingen,Insgesamt,8380,4115,4265
False,8335043,"Konstanz, Universitätsstadt",unter 3 Jahre,1856,941,915
False,8335043,"Konstanz, Universitätsstadt",3 -  6 Jahre,1846,929,917
False,8335043,"Konstanz, Universitätsstadt",6 - 10 Jahre,2748,1363,1385
False,8335043,"Konstanz, Universitätsstadt",10 - 15 Jahre,3276,1673,1603
False,8335043,"Konstanz, Universitätsstadt",15 - 18 Jahre,2124,1080,1044
False,8335043,"Konstanz, Universitätsstadt",18 - 20 Jahre,1584,746,838
False,8335043,"Konstanz, Universitätsstadt",20 - 25 Jahre,7857,3607,4250
False,8335043,"Konstanz, Universitätsstadt",25 - 30 Jahre,6468,3271,3197
False,8335043,"Konstanz, Universitätsstadt",30 - 35 Jahre,5196,2761,2435
False,8335043,"Konstanz, Universitätsstadt",35 - 40 Jahre,7051,3502,3549
False,8335043,"Konstanz, Universitätsstadt",40 - 45 Jahre,7891,4189,3702
False,8335043,"Konstanz, Universitätsstadt",45 - 50 Jahre,5826,2978,2848
False,8335043,"Konstanz, Universitätsstadt",50 - 55 Jahre,4597,2215,2382
False,8335043,"Konstanz, Universitätsstadt",55 - 60 Jahre,4044,1965,2079
False,8335043,"Konstanz, Universitätsstadt",60 - 65 Jahre,4359,2079,2280
False,8335043,"Konstanz, Universitätsstadt",65 - 75 Jahre,8046,3741,4305
False,8335043,"Konstanz, Universitätsstadt",75 und mehr Jahre,6448,2131,4317
False,8335043,"Konstanz, Universitätsstadt",Insgesamt,81217,39171,42046
False,8335055,Moos,unter 3 Jahre,70,40,30
False,8335055,Moos,3 -  6 Jahre,104,47,57
False,8335055,Moos,6 - 10 Jahre,141,79,62
False,8335055,Moos,10 - 15 Jahre,197,102,95
False,8335055,Moos,15 - 18 Jahre,110,62,48
False,8335055,Moos,18 - 20 Jahre,71,39,32
False,8335055,Moos,20 - 25 Jahre,143,70,73
False,8335055,Moos,25 - 30 Jahre,121,64,57
False,8335055,Moos,30 - 35 Jahre,158,72,86
False,8335055,Moos,35 - 40 Jahre,262,122,140
False,8335055,Moos,40 - 45 Jahre,351,181,170
False,8335055,Moos,45 - 50 Jahre,306,143,163
False,8335055,Moos,50 - 55 Jahre,249,141,108
False,8335055,Moos,55 - 60 Jahre,214,106,108
False,8335055,Moos,60 - 65 Jahre,198,101,97
False,8335055,Moos,65 - 75 Jahre,304,154,150
False,8335055,Moos,75 und mehr Jahre,230,86,144
False,8335055,Moos,Insgesamt,3229,1609,1620
False,8335057,Mühlingen,unter 3 Jahre,68,40,28
False,8335057,Mühlingen,3 -  6 Jahre,85,47,38
False,8335057,Mühlingen,6 - 10 Jahre,150,70,80
False,8335057,Mühlingen,10 - 15 Jahre,140,73,67
False,8335057,Mühlingen,15 - 18 Jahre,81,37,44
False,8335057,Mühlingen,18 - 20 Jahre,63,34,29
False,8335057,Mühlingen,20 - 25 Jahre,139,75,64
False,8335057,Mühlingen,25 - 30 Jahre,144,71,73
False,8335057,Mühlingen,30 - 35 Jahre,138,58,80
False,8335057,Mühlingen,35 - 40 Jahre,218,118,100
False,8335057,Mühlingen,40 - 45 Jahre,216,107,109
False,8335057,Mühlingen,45 - 50 Jahre,190,96,94
False,8335057,Mühlingen,50 - 55 Jahre,149,77,72
False,8335057,Mühlingen,55 - 60 Jahre,107,63,44
False,8335057,Mühlingen,60 - 65 Jahre,87,46,41
False,8335057,Mühlingen,65 - 75 Jahre,203,94,109
False,8335057,Mühlingen,75 und mehr Jahre,164,61,103
False,8335057,Mühlingen,Insgesamt,2342,1167,1175
False,8335061,Öhningen,unter 3 Jahre,72,36,36
False,8335061,Öhningen,3 -  6 Jahre,123,64,59
False,8335061,Öhningen,6 - 10 Jahre,134,63,71
False,8335061,Öhningen,10 - 15 Jahre,191,103,88
False,8335061,Öhningen,15 - 18 Jahre,111,58,53
False,8335061,Öhningen,18 - 20 Jahre,83,42,41
False,8335061,Öhningen,20 - 25 Jahre,158,85,73
False,8335061,Öhningen,25 - 30 Jahre,170,87,83
False,8335061,Öhningen,30 - 35 Jahre,159,69,90
False,8335061,Öhningen,35 - 40 Jahre,282,145,137
False,8335061,Öhningen,40 - 45 Jahre,377,200,177
False,8335061,Öhningen,45 - 50 Jahre,272,133,139
False,8335061,Öhningen,50 - 55 Jahre,239,129,110
False,8335061,Öhningen,55 - 60 Jahre,226,101,125
False,8335061,Öhningen,60 - 65 Jahre,265,136,129
False,8335061,Öhningen,65 - 75 Jahre,498,250,248
False,8335061,Öhningen,75 und mehr Jahre,354,146,208
False,8335061,Öhningen,Insgesamt,3714,1847,1867
False,8335063,"Radolfzell am Bodensee, Stadt",unter 3 Jahre,792,414,378
False,8335063,"Radolfzell am Bodensee, Stadt",3 -  6 Jahre,794,396,398
False,8335063,"Radolfzell am Bodensee, Stadt",6 - 10 Jahre,1225,637,588
False,8335063,"Radolfzell am Bodensee, Stadt",10 - 15 Jahre,1561,806,755
False,8335063,"Radolfzell am Bodensee, Stadt",15 - 18 Jahre,960,480,480
False,8335063,"Radolfzell am Bodensee, Stadt",18 - 20 Jahre,725,385,340
False,8335063,"Radolfzell am Bodensee, Stadt",20 - 25 Jahre,1614,817,797
False,8335063,"Radolfzell am Bodensee, Stadt",25 - 30 Jahre,1631,803,828
False,8335063,"Radolfzell am Bodensee, Stadt",30 - 35 Jahre,1755,839,916
False,8335063,"Radolfzell am Bodensee, Stadt",35 - 40 Jahre,2580,1262,1318
False,8335063,"Radolfzell am Bodensee, Stadt",40 - 45 Jahre,2799,1374,1425
False,8335063,"Radolfzell am Bodensee, Stadt",45 - 50 Jahre,2417,1226,1191
False,8335063,"Radolfzell am Bodensee, Stadt",50 - 55 Jahre,2138,1056,1082
False,8335063,"Radolfzell am Bodensee, Stadt",55 - 60 Jahre,1774,903,871
False,8335063,"Radolfzell am Bodensee, Stadt",60 - 65 Jahre,1790,883,907
False,8335063,"Radolfzell am Bodensee, Stadt",65 - 75 Jahre,3150,1515,1635
False,8335063,"Radolfzell am Bodensee, Stadt",75 und mehr Jahre,2547,839,1708
False,8335063,"Radolfzell am Bodensee, Stadt",Insgesamt,30252,14635,15617
False,8335066,Reichenau,unter 3 Jahre,135,75,60
False,8335066,Reichenau,3 -  6 Jahre,149,74,75
False,8335066,Reichenau,6 - 10 Jahre,237,128,109
False,8335066,Reichenau,10 - 15 Jahre,309,165,144
False,8335066,Reichenau,15 - 18 Jahre,166,94,72
False,8335066,Reichenau,18 - 20 Jahre,126,53,73
False,8335066,Reichenau,20 - 25 Jahre,314,132,182
False,8335066,Reichenau,25 - 30 Jahre,246,117,129
False,8335066,Reichenau,30 - 35 Jahre,329,152,177
False,8335066,Reichenau,35 - 40 Jahre,488,239,249
False,8335066,Reichenau,40 - 45 Jahre,524,252,272
False,8335066,Reichenau,45 - 50 Jahre,439,227,212
False,8335066,Reichenau,50 - 55 Jahre,313,157,156
False,8335066,Reichenau,55 - 60 Jahre,275,139,136
False,8335066,Reichenau,60 - 65 Jahre,227,114,113
False,8335066,Reichenau,65 - 75 Jahre,509,250,259
False,8335066,Reichenau,75 und mehr Jahre,349,128,221
False,8335066,Reichenau,Insgesamt,5135,2496,2639
False,8335075,"Singen (Hohentwiel), Stadt",unter 3 Jahre,1198,599,599
False,8335075,"Singen (Hohentwiel), Stadt",3 -  6 Jahre,1334,685,649
False,8335075,"Singen (Hohentwiel), Stadt",6 - 10 Jahre,1895,963,932
False,8335075,"Singen (Hohentwiel), Stadt",10 - 15 Jahre,2443,1252,1191
False,8335075,"Singen (Hohentwiel), Stadt",15 - 18 Jahre,1460,683,777
False,8335075,"Singen (Hohentwiel), Stadt",18 - 20 Jahre,973,475,498
False,8335075,"Singen (Hohentwiel), Stadt",20 - 25 Jahre,2523,1257,1266
False,8335075,"Singen (Hohentwiel), Stadt",25 - 30 Jahre,2503,1255,1248
False,8335075,"Singen (Hohentwiel), Stadt",30 - 35 Jahre,2600,1324,1276
False,8335075,"Singen (Hohentwiel), Stadt",35 - 40 Jahre,3500,1719,1781
False,8335075,"Singen (Hohentwiel), Stadt",40 - 45 Jahre,3731,1894,1837
False,8335075,"Singen (Hohentwiel), Stadt",45 - 50 Jahre,3252,1708,1544
False,8335075,"Singen (Hohentwiel), Stadt",50 - 55 Jahre,2937,1445,1492
False,8335075,"Singen (Hohentwiel), Stadt",55 - 60 Jahre,2629,1302,1327
False,8335075,"Singen (Hohentwiel), Stadt",60 - 65 Jahre,2556,1230,1326
False,8335075,"Singen (Hohentwiel), Stadt",65 - 75 Jahre,5517,2554,2963
False,8335075,"Singen (Hohentwiel), Stadt",75 und mehr Jahre,4315,1519,2796
False,8335075,"Singen (Hohentwiel), Stadt",Insgesamt,45366,21864,23502
False,8335077,Steißlingen,unter 3 Jahre,140,76,64
False,8335077,Steißlingen,3 -  6 Jahre,151,70,81
False,8335077,Steißlingen,6 - 10 Jahre,229,120,109
False,8335077,Steißlingen,10 - 15 Jahre,281,152,129
False,8335077,Steißlingen,15 - 18 Jahre,158,75,83
False,8335077,Steißlingen,18 - 20 Jahre,113,58,55
False,8335077,Steißlingen,20 - 25 Jahre,218,94,124
False,8335077,Steißlingen,25 - 30 Jahre,202,113,89
False,8335077,Steißlingen,30 - 35 Jahre,279,120,159
False,8335077,Steißlingen,35 - 40 Jahre,424,218,206
False,8335077,Steißlingen,40 - 45 Jahre,420,215,205
False,8335077,Steißlingen,45 - 50 Jahre,371,197,174
False,8335077,Steißlingen,50 - 55 Jahre,254,140,114
False,8335077,Steißlingen,55 - 60 Jahre,254,128,126
False,8335077,Steißlingen,60 - 65 Jahre,228,115,113
False,8335077,Steißlingen,65 - 75 Jahre,483,231,252
False,8335077,Steißlingen,75 und mehr Jahre,336,123,213
False,8335077,Steißlingen,Insgesamt,4541,2245,2296
False,8335079,"Stockach, Stadt",unter 3 Jahre,405,220,185
False,8335079,"Stockach, Stadt",3 -  6 Jahre,513,274,239
False,8335079,"Stockach, Stadt",6 - 10 Jahre,748,369,379
False,8335079,"Stockach, Stadt",10 - 15 Jahre,1010,528,482
False,8335079,"Stockach, Stadt",15 - 18 Jahre,717,354,363
False,8335079,"Stockach, Stadt",18 - 20 Jahre,472,233,239
False,8335079,"Stockach, Stadt",20 - 25 Jahre,1017,507,510
False,8335079,"Stockach, Stadt",25 - 30 Jahre,822,424,398
False,8335079,"Stockach, Stadt",30 - 35 Jahre,905,414,491
False,8335079,"Stockach, Stadt",35 - 40 Jahre,1284,608,676
False,8335079,"Stockach, Stadt",40 - 45 Jahre,1474,726,748
False,8335079,"Stockach, Stadt",45 - 50 Jahre,1366,672,694
False,8335079,"Stockach, Stadt",50 - 55 Jahre,1201,605,596
False,8335079,"Stockach, Stadt",55 - 60 Jahre,1049,539,510
False,8335079,"Stockach, Stadt",60 - 65 Jahre,808,407,401
False,8335079,"Stockach, Stadt",65 - 75 Jahre,1632,771,861
False,8335079,"Stockach, Stadt",75 und mehr Jahre,1387,487,900
False,8335079,"Stockach, Stadt",Insgesamt,16810,8138,8672
False,8335080,"Tengen, Stadt",unter 3 Jahre,121,59,62
False,8335080,"Tengen, Stadt",3 -  6 Jahre,125,49,76
False,8335080,"Tengen, Stadt",6 - 10 Jahre,223,111,112
False,8335080,"Tengen, Stadt",10 - 15 Jahre,280,149,131
False,8335080,"Tengen, Stadt",15 - 18 Jahre,198,95,103
False,8335080,"Tengen, Stadt",18 - 20 Jahre,122,61,61
False,8335080,"Tengen, Stadt",20 - 25 Jahre,251,124,127
False,8335080,"Tengen, Stadt",25 - 30 Jahre,190,103,87
False,8335080,"Tengen, Stadt",30 - 35 Jahre,198,92,106
False,8335080,"Tengen, Stadt",35 - 40 Jahre,427,218,209
False,8335080,"Tengen, Stadt",40 - 45 Jahre,459,240,219
False,8335080,"Tengen, Stadt",45 - 50 Jahre,372,184,188
False,8335080,"Tengen, Stadt",50 - 55 Jahre,314,161,153
False,8335080,"Tengen, Stadt",55 - 60 Jahre,242,129,113
False,8335080,"Tengen, Stadt",60 - 65 Jahre,186,94,92
False,8335080,"Tengen, Stadt",65 - 75 Jahre,539,264,275
False,8335080,"Tengen, Stadt",75 und mehr Jahre,485,168,317
False,8335080,"Tengen, Stadt",Insgesamt,4732,2301,2431
False,8335081,Volkertshausen,unter 3 Jahre,80,36,44
False,8335081,Volkertshausen,3 -  6 Jahre,80,35,45
False,8335081,Volkertshausen,6 - 10 Jahre,130,81,49
False,8335081,Volkertshausen,10 - 15 Jahre,180,101,79
False,8335081,Volkertshausen,15 - 18 Jahre,133,69,64
False,8335081,Volkertshausen,18 - 20 Jahre,64,32,32
False,8335081,Volkertshausen,20 - 25 Jahre,163,91,72
False,8335081,Volkertshausen,25 - 30 Jahre,157,74,83
False,8335081,Volkertshausen,30 - 35 Jahre,145,66,79
False,8335081,Volkertshausen,35 - 40 Jahre,223,115,108
False,8335081,Volkertshausen,40 - 45 Jahre,283,149,134
False,8335081,Volkertshausen,45 - 50 Jahre,257,138,119
False,8335081,Volkertshausen,50 - 55 Jahre,186,89,97
False,8335081,Volkertshausen,55 - 60 Jahre,149,81,68
False,8335081,Volkertshausen,60 - 65 Jahre,120,60,60
False,8335081,Volkertshausen,65 - 75 Jahre,262,116,146
False,8335081,Volkertshausen,75 und mehr Jahre,180,67,113
False,8335081,Volkertshausen,Insgesamt,2792,1400,1392
False,8335096,Hohenfels,unter 3 Jahre,64,33,31
False,8335096,Hohenfels,3 -  6 Jahre,68,31,37
False,8335096,Hohenfels,6 - 10 Jahre,105,52,53
False,8335096,Hohenfels,10 - 15 Jahre,145,79,66
False,8335096,Hohenfels,15 - 18 Jahre,77,45,32
False,8335096,Hohenfels,18 - 20 Jahre,53,28,25
False,8335096,Hohenfels,20 - 25 Jahre,118,59,59
False,8335096,Hohenfels,25 - 30 Jahre,118,79,39
False,8335096,Hohenfels,30 - 35 Jahre,129,60,69
False,8335096,Hohenfels,35 - 40 Jahre,150,84,66
False,8335096,Hohenfels,40 - 45 Jahre,173,85,88
False,8335096,Hohenfels,45 - 50 Jahre,149,77,72
False,8335096,Hohenfels,50 - 55 Jahre,118,57,61
False,8335096,Hohenfels,55 - 60 Jahre,141,71,70
False,8335096,Hohenfels,60 - 65 Jahre,115,65,50
False,8335096,Hohenfels,65 - 75 Jahre,186,104,82
False,8335096,Hohenfels,75 und mehr Jahre,108,38,70
False,8335096,Hohenfels,Insgesamt,2017,1047,970
False,8335097,Mühlhausen-Ehingen,unter 3 Jahre,97,54,43
False,8335097,Mühlhausen-Ehingen,3 -  6 Jahre,129,66,63
False,8335097,Mühlhausen-Ehingen,6 - 10 Jahre,159,80,79
False,8335097,Mühlhausen-Ehingen,10 - 15 Jahre,240,119,121
False,8335097,Mühlhausen-Ehingen,15 - 18 Jahre,150,81,69
False,8335097,Mühlhausen-Ehingen,18 - 20 Jahre,92,46,46
False,8335097,Mühlhausen-Ehingen,20 - 25 Jahre,217,117,100
False,8335097,Mühlhausen-Ehingen,25 - 30 Jahre,169,80,89
False,8335097,Mühlhausen-Ehingen,30 - 35 Jahre,201,100,101
False,8335097,Mühlhausen-Ehingen,35 - 40 Jahre,329,175,154
False,8335097,Mühlhausen-Ehingen,40 - 45 Jahre,328,177,151
False,8335097,Mühlhausen-Ehingen,45 - 50 Jahre,310,157,153
False,8335097,Mühlhausen-Ehingen,50 - 55 Jahre,256,125,131
False,8335097,Mühlhausen-Ehingen,55 - 60 Jahre,201,102,99
False,8335097,Mühlhausen-Ehingen,60 - 65 Jahre,192,97,95
False,8335097,Mühlhausen-Ehingen,65 - 75 Jahre,373,187,186
False,8335097,Mühlhausen-Ehingen,75 und mehr Jahre,236,94,142
False,8335097,Mühlhausen-Ehingen,Insgesamt,3679,1857,1822
False,8335098,Bodman-Ludwigshafen,unter 3 Jahre,117,56,61
False,8335098,Bodman-Ludwigshafen,3 -  6 Jahre,119,52,67
False,8335098,Bodman-Ludwigshafen,6 - 10 Jahre,141,70,71
False,8335098,Bodman-Ludwigshafen,10 - 15 Jahre,145,69,76
False,8335098,Bodman-Ludwigshafen,15 - 18 Jahre,108,48,60
False,8335098,Bodman-Ludwigshafen,18 - 20 Jahre,83,48,35
False,8335098,Bodman-Ludwigshafen,20 - 25 Jahre,203,95,108
False,8335098,Bodman-Ludwigshafen,25 - 30 Jahre,206,105,101
False,8335098,Bodman-Ludwigshafen,30 - 35 Jahre,256,136,120
False,8335098,Bodman-Ludwigshafen,35 - 40 Jahre,335,161,174
False,8335098,Bodman-Ludwigshafen,40 - 45 Jahre,362,184,178
False,8335098,Bodman-Ludwigshafen,45 - 50 Jahre,301,166,135
False,8335098,Bodman-Ludwigshafen,50 - 55 Jahre,317,162,155
False,8335098,Bodman-Ludwigshafen,55 - 60 Jahre,291,148,143
False,8335098,Bodman-Ludwigshafen,60 - 65 Jahre,246,131,115
False,8335098,Bodman-Ludwigshafen,65 - 75 Jahre,541,256,285
False,8335098,Bodman-Ludwigshafen,75 und mehr Jahre,468,179,289
False,8335098,Bodman-Ludwigshafen,Insgesamt,4239,2066,2173
False,8335099,Orsingen-Nenzingen,unter 3 Jahre,105,50,55
False,8335099,Orsingen-Nenzingen,3 -  6 Jahre,130,64,66
False,8335099,Orsingen-Nenzingen,6 - 10 Jahre,160,81,79
False,8335099,Orsingen-Nenzingen,10 - 15 Jahre,202,109,93
False,8335099,Orsingen-Nenzingen,15 - 18 Jahre,120,57,63
False,8335099,Orsingen-Nenzingen,18 - 20 Jahre,78,45,33
False,8335099,Orsingen-Nenzingen,20 - 25 Jahre,154,78,76
False,8335099,Orsingen-Nenzingen,25 - 30 Jahre,154,84,70
False,8335099,Orsingen-Nenzingen,30 - 35 Jahre,191,86,105
False,8335099,Orsingen-Nenzingen,35 - 40 Jahre,324,169,155
False,8335099,Orsingen-Nenzingen,40 - 45 Jahre,302,151,151
False,8335099,Orsingen-Nenzingen,45 - 50 Jahre,253,135,118
False,8335099,Orsingen-Nenzingen,50 - 55 Jahre,185,97,88
False,8335099,Orsingen-Nenzingen,55 - 60 Jahre,159,92,67
False,8335099,Orsingen-Nenzingen,60 - 65 Jahre,140,68,72
False,8335099,Orsingen-Nenzingen,65 - 75 Jahre,292,145,147
False,8335099,Orsingen-Nenzingen,75 und mehr Jahre,177,66,111
False,8335099,Orsingen-Nenzingen,Insgesamt,3126,1577,1549
False,8335100,Rielasingen-Worblingen,unter 3 Jahre,285,143,142
False,8335100,Rielasingen-Worblingen,3 -  6 Jahre,336,175,161
False,8335100,Rielasingen-Worblingen,6 - 10 Jahre,492,231,261
False,8335100,Rielasingen-Worblingen,10 - 15 Jahre,620,312,308
False,8335100,Rielasingen-Worblingen,15 - 18 Jahre,392,205,187
False,8335100,Rielasingen-Worblingen,18 - 20 Jahre,257,123,134
False,8335100,Rielasingen-Worblingen,20 - 25 Jahre,597,300,297
False,8335100,Rielasingen-Worblingen,25 - 30 Jahre,638,314,324
False,8335100,Rielasingen-Worblingen,30 - 35 Jahre,694,328,366
False,8335100,Rielasingen-Worblingen,35 - 40 Jahre,1011,500,511
False,8335100,Rielasingen-Worblingen,40 - 45 Jahre,1124,591,533
False,8335100,Rielasingen-Worblingen,45 - 50 Jahre,950,483,467
False,8335100,Rielasingen-Worblingen,50 - 55 Jahre,809,416,393
False,8335100,Rielasingen-Worblingen,55 - 60 Jahre,692,305,387
False,8335100,Rielasingen-Worblingen,60 - 65 Jahre,705,349,356
False,8335100,Rielasingen-Worblingen,65 - 75 Jahre,1373,681,692
False,8335100,Rielasingen-Worblingen,75 und mehr Jahre,945,338,607
False,8335100,Rielasingen-Worblingen,Insgesamt,11920,5794,6126
False,8336,Landkreis Lörrach,unter 3 Jahre,5549,2840,2709
False,8336,Landkreis Lörrach,3 -  6 Jahre,6459,3315,3144
False,8336,Landkreis Lörrach,6 - 10 Jahre,9897,5022,4875
False,8336,Landkreis Lörrach,10 - 15 Jahre,13118,6797,6321
False,8336,Landkreis Lörrach,15 - 18 Jahre,8472,4305,4167
False,8336,Landkreis Lörrach,18 - 20 Jahre,5223,2684,2539
False,8336,Landkreis Lörrach,20 - 25 Jahre,11893,6030,5863
False,8336,Landkreis Lörrach,25 - 30 Jahre,11477,5607,5870
False,8336,Landkreis Lörrach,30 - 35 Jahre,12864,6333,6531
False,8336,Landkreis Lörrach,35 - 40 Jahre,18520,9338,9182
False,8336,Landkreis Lörrach,40 - 45 Jahre,20237,10086,10151
False,8336,Landkreis Lörrach,45 - 50 Jahre,17832,8934,8898
False,8336,Landkreis Lörrach,50 - 55 Jahre,14788,7528,7260
False,8336,Landkreis Lörrach,55 - 60 Jahre,12275,6078,6197
False,8336,Landkreis Lörrach,60 - 65 Jahre,11585,5654,5931
False,8336,Landkreis Lörrach,65 - 75 Jahre,23906,11321,12585
False,8336,Landkreis Lörrach,75 und mehr Jahre,17262,6133,11129
False,8336,Landkreis Lörrach,Insgesamt,221357,108005,113352
False,8336004,Aitern,unter 3 Jahre,11,4,7
False,8336004,Aitern,3 -  6 Jahre,15,6,9
False,8336004,Aitern,6 - 10 Jahre,25,18,7
False,8336004,Aitern,10 - 15 Jahre,42,23,19
False,8336004,Aitern,15 - 18 Jahre,19,12,7
False,8336004,Aitern,18 - 20 Jahre,19,12,7
False,8336004,Aitern,20 - 25 Jahre,28,14,14
False,8336004,Aitern,25 - 30 Jahre,34,21,13
False,8336004,Aitern,30 - 35 Jahre,31,15,16
False,8336004,Aitern,35 - 40 Jahre,46,25,21
False,8336004,Aitern,40 - 45 Jahre,56,30,26
False,8336004,Aitern,45 - 50 Jahre,42,23,19
False,8336004,Aitern,50 - 55 Jahre,35,20,15
False,8336004,Aitern,55 - 60 Jahre,31,17,14
False,8336004,Aitern,60 - 65 Jahre,23,12,11
False,8336004,Aitern,65 - 75 Jahre,59,27,32
False,8336004,Aitern,75 und mehr Jahre,33,15,18
False,8336004,Aitern,Insgesamt,549,294,255
False,8336006,Bad Bellingen,unter 3 Jahre,72,31,41
False,8336006,Bad Bellingen,3 -  6 Jahre,101,49,52
False,8336006,Bad Bellingen,6 - 10 Jahre,151,79,72
False,8336006,Bad Bellingen,10 - 15 Jahre,177,92,85
False,8336006,Bad Bellingen,15 - 18 Jahre,134,69,65
False,8336006,Bad Bellingen,18 - 20 Jahre,80,34,46
False,8336006,Bad Bellingen,20 - 25 Jahre,205,113,92
False,8336006,Bad Bellingen,25 - 30 Jahre,225,101,124
False,8336006,Bad Bellingen,30 - 35 Jahre,189,105,84
False,8336006,Bad Bellingen,35 - 40 Jahre,304,159,145
False,8336006,Bad Bellingen,40 - 45 Jahre,329,167,162
False,8336006,Bad Bellingen,45 - 50 Jahre,304,146,158
False,8336006,Bad Bellingen,50 - 55 Jahre,292,155,137
False,8336006,Bad Bellingen,55 - 60 Jahre,227,123,104
False,8336006,Bad Bellingen,60 - 65 Jahre,207,86,121
False,8336006,Bad Bellingen,65 - 75 Jahre,470,239,231
False,8336006,Bad Bellingen,75 und mehr Jahre,383,140,243
False,8336006,Bad Bellingen,Insgesamt,3850,1888,1962
False,8336008,Binzen,unter 3 Jahre,79,36,43
False,8336008,Binzen,3 -  6 Jahre,112,61,51
False,8336008,Binzen,6 - 10 Jahre,158,85,73
False,8336008,Binzen,10 - 15 Jahre,147,79,68
False,8336008,Binzen,15 - 18 Jahre,114,55,59
False,8336008,Binzen,18 - 20 Jahre,68,31,37
False,8336008,Binzen,20 - 25 Jahre,123,54,69
False,8336008,Binzen,25 - 30 Jahre,121,62,59
False,8336008,Binzen,30 - 35 Jahre,158,74,84
False,8336008,Binzen,35 - 40 Jahre,297,135,162
False,8336008,Binzen,40 - 45 Jahre,270,135,135
False,8336008,Binzen,45 - 50 Jahre,207,104,103
False,8336008,Binzen,50 - 55 Jahre,195,95,100
False,8336008,Binzen,55 - 60 Jahre,164,83,81
False,8336008,Binzen,60 - 65 Jahre,158,72,86
False,8336008,Binzen,65 - 75 Jahre,281,146,135
False,8336008,Binzen,75 und mehr Jahre,180,69,111
False,8336008,Binzen,Insgesamt,2832,1376,1456
False,8336010,Böllen,unter 3 Jahre,2,1,1
False,8336010,Böllen,3 -  6 Jahre,2,1,1
False,8336010,Böllen,6 - 10 Jahre,7,4,3
False,8336010,Böllen,10 - 15 Jahre,11,4,7
False,8336010,Böllen,15 - 18 Jahre,2,2,0
False,8336010,Böllen,18 - 20 Jahre,1,0,1
False,8336010,Böllen,20 - 25 Jahre,1,1,0
False,8336010,Böllen,25 - 30 Jahre,3,1,2
False,8336010,Böllen,30 - 35 Jahre,8,5,3
False,8336010,Böllen,35 - 40 Jahre,12,5,7
False,8336010,Böllen,40 - 45 Jahre,12,8,4
False,8336010,Böllen,45 - 50 Jahre,12,7,5
False,8336010,Böllen,50 - 55 Jahre,5,1,4
False,8336010,Böllen,55 - 60 Jahre,2,2,0
False,8336010,Böllen,60 - 65 Jahre,2,2,0
False,8336010,Böllen,65 - 75 Jahre,9,5,4
False,8336010,Böllen,75 und mehr Jahre,12,6,6
False,8336010,Böllen,Insgesamt,103,55,48
False,8336014,Efringen-Kirchen,unter 3 Jahre,203,112,91
False,8336014,Efringen-Kirchen,3 -  6 Jahre,223,120,103
False,8336014,Efringen-Kirchen,6 - 10 Jahre,376,190,186
False,8336014,Efringen-Kirchen,10 - 15 Jahre,517,295,222
False,8336014,Efringen-Kirchen,15 - 18 Jahre,364,193,171
False,8336014,Efringen-Kirchen,18 - 20 Jahre,195,101,94
False,8336014,Efringen-Kirchen,20 - 25 Jahre,494,266,228
False,8336014,Efringen-Kirchen,25 - 30 Jahre,417,220,197
False,8336014,Efringen-Kirchen,30 - 35 Jahre,443,224,219
False,8336014,Efringen-Kirchen,35 - 40 Jahre,730,385,345
False,8336014,Efringen-Kirchen,40 - 45 Jahre,779,379,400
False,8336014,Efringen-Kirchen,45 - 50 Jahre,755,396,359
False,8336014,Efringen-Kirchen,50 - 55 Jahre,631,318,313
False,8336014,Efringen-Kirchen,55 - 60 Jahre,419,224,195
False,8336014,Efringen-Kirchen,60 - 65 Jahre,414,200,214
False,8336014,Efringen-Kirchen,65 - 75 Jahre,778,390,388
False,8336014,Efringen-Kirchen,75 und mehr Jahre,510,202,308
False,8336014,Efringen-Kirchen,Insgesamt,8248,4215,4033
False,8336019,Eimeldingen,unter 3 Jahre,68,41,27
False,8336019,Eimeldingen,3 -  6 Jahre,82,33,49
False,8336019,Eimeldingen,6 - 10 Jahre,102,59,43
False,8336019,Eimeldingen,10 - 15 Jahre,151,68,83
False,8336019,Eimeldingen,15 - 18 Jahre,85,51,34
False,8336019,Eimeldingen,18 - 20 Jahre,56,25,31
False,8336019,Eimeldingen,20 - 25 Jahre,126,63,63
False,8336019,Eimeldingen,25 - 30 Jahre,122,71,51
False,8336019,Eimeldingen,30 - 35 Jahre,165,76,89
False,8336019,Eimeldingen,35 - 40 Jahre,232,120,112
False,8336019,Eimeldingen,40 - 45 Jahre,243,120,123
False,8336019,Eimeldingen,45 - 50 Jahre,207,116,91
False,8336019,Eimeldingen,50 - 55 Jahre,148,72,76
False,8336019,Eimeldingen,55 - 60 Jahre,121,59,62
False,8336019,Eimeldingen,60 - 65 Jahre,102,46,56
False,8336019,Eimeldingen,65 - 75 Jahre,180,89,91
False,8336019,Eimeldingen,75 und mehr Jahre,95,35,60
False,8336019,Eimeldingen,Insgesamt,2285,1144,1141
False,8336024,Fischingen,unter 3 Jahre,21,11,10
False,8336024,Fischingen,3 -  6 Jahre,34,16,18
False,8336024,Fischingen,6 - 10 Jahre,37,18,19
False,8336024,Fischingen,10 - 15 Jahre,31,18,13
False,8336024,Fischingen,15 - 18 Jahre,20,15,5
False,8336024,Fischingen,18 - 20 Jahre,8,4,4
False,8336024,Fischingen,20 - 25 Jahre,39,22,17
False,8336024,Fischingen,25 - 30 Jahre,40,17,23
False,8336024,Fischingen,30 - 35 Jahre,44,19,25
False,8336024,Fischingen,35 - 40 Jahre,67,35,32
False,8336024,Fischingen,40 - 45 Jahre,59,35,24
False,8336024,Fischingen,45 - 50 Jahre,67,33,34
False,8336024,Fischingen,50 - 55 Jahre,54,30,24
False,8336024,Fischingen,55 - 60 Jahre,42,20,22
False,8336024,Fischingen,60 - 65 Jahre,48,23,25
False,8336024,Fischingen,65 - 75 Jahre,65,32,33
False,8336024,Fischingen,75 und mehr Jahre,40,14,26
False,8336024,Fischingen,Insgesamt,716,362,354
False,8336025,Fröhnd,unter 3 Jahre,19,7,12
False,8336025,Fröhnd,3 -  6 Jahre,11,5,6
False,8336025,Fröhnd,6 - 10 Jahre,21,9,12
False,8336025,Fröhnd,10 - 15 Jahre,33,18,15
False,8336025,Fröhnd,15 - 18 Jahre,25,16,9
False,8336025,Fröhnd,18 - 20 Jahre,12,7,5
False,8336025,Fröhnd,20 - 25 Jahre,34,15,19
False,8336025,Fröhnd,25 - 30 Jahre,19,9,10
False,8336025,Fröhnd,30 - 35 Jahre,23,11,12
False,8336025,Fröhnd,35 - 40 Jahre,44,25,19
False,8336025,Fröhnd,40 - 45 Jahre,45,20,25
False,8336025,Fröhnd,45 - 50 Jahre,48,24,24
False,8336025,Fröhnd,50 - 55 Jahre,37,24,13
False,8336025,Fröhnd,55 - 60 Jahre,16,10,6
False,8336025,Fröhnd,60 - 65 Jahre,13,4,9
False,8336025,Fröhnd,65 - 75 Jahre,55,31,24
False,8336025,Fröhnd,75 und mehr Jahre,35,14,21
False,8336025,Fröhnd,Insgesamt,490,249,241
False,8336034,Hasel,unter 3 Jahre,24,11,13
False,8336034,Hasel,3 -  6 Jahre,43,29,14
False,8336034,Hasel,6 - 10 Jahre,45,27,18
False,8336034,Hasel,10 - 15 Jahre,63,32,31
False,8336034,Hasel,15 - 18 Jahre,50,17,33
False,8336034,Hasel,18 - 20 Jahre,34,16,18
False,8336034,Hasel,20 - 25 Jahre,54,30,24
False,8336034,Hasel,25 - 30 Jahre,57,25,32
False,8336034,Hasel,30 - 35 Jahre,71,34,37
False,8336034,Hasel,35 - 40 Jahre,84,48,36
False,8336034,Hasel,40 - 45 Jahre,102,50,52
False,8336034,Hasel,45 - 50 Jahre,85,41,44
False,8336034,Hasel,50 - 55 Jahre,78,48,30
False,8336034,Hasel,55 - 60 Jahre,52,28,24
False,8336034,Hasel,60 - 65 Jahre,57,27,30
False,8336034,Hasel,65 - 75 Jahre,139,69,70
False,8336034,Hasel,75 und mehr Jahre,71,28,43
False,8336034,Hasel,Insgesamt,1109,560,549
False,8336036,Hausen im Wiesental,unter 3 Jahre,57,32,25
False,8336036,Hausen im Wiesental,3 -  6 Jahre,69,31,38
False,8336036,Hausen im Wiesental,6 - 10 Jahre,126,77,49
False,8336036,Hausen im Wiesental,10 - 15 Jahre,177,97,80
False,8336036,Hausen im Wiesental,15 - 18 Jahre,98,48,50
False,8336036,Hausen im Wiesental,18 - 20 Jahre,55,32,23
False,8336036,Hausen im Wiesental,20 - 25 Jahre,132,63,69
False,8336036,Hausen im Wiesental,25 - 30 Jahre,91,42,49
False,8336036,Hausen im Wiesental,30 - 35 Jahre,139,80,59
False,8336036,Hausen im Wiesental,35 - 40 Jahre,210,99,111
False,8336036,Hausen im Wiesental,40 - 45 Jahre,234,126,108
False,8336036,Hausen im Wiesental,45 - 50 Jahre,185,92,93
False,8336036,Hausen im Wiesental,50 - 55 Jahre,143,72,71
False,8336036,Hausen im Wiesental,55 - 60 Jahre,134,71,63
False,8336036,Hausen im Wiesental,60 - 65 Jahre,116,51,65
False,8336036,Hausen im Wiesental,65 - 75 Jahre,264,132,132
False,8336036,Hausen im Wiesental,75 und mehr Jahre,167,49,118
False,8336036,Hausen im Wiesental,Insgesamt,2397,1194,1203
False,8336043,Inzlingen,unter 3 Jahre,72,41,31
False,8336043,Inzlingen,3 -  6 Jahre,69,33,36
False,8336043,Inzlingen,6 - 10 Jahre,80,40,40
False,8336043,Inzlingen,10 - 15 Jahre,133,61,72
False,8336043,Inzlingen,15 - 18 Jahre,73,32,41
False,8336043,Inzlingen,18 - 20 Jahre,51,25,26
False,8336043,Inzlingen,20 - 25 Jahre,118,62,56
False,8336043,Inzlingen,25 - 30 Jahre,116,63,53
False,8336043,Inzlingen,30 - 35 Jahre,112,53,59
False,8336043,Inzlingen,35 - 40 Jahre,240,99,141
False,8336043,Inzlingen,40 - 45 Jahre,206,97,109
False,8336043,Inzlingen,45 - 50 Jahre,218,116,102
False,8336043,Inzlingen,50 - 55 Jahre,182,86,96
False,8336043,Inzlingen,55 - 60 Jahre,140,68,72
False,8336043,Inzlingen,60 - 65 Jahre,153,72,81
False,8336043,Inzlingen,65 - 75 Jahre,336,162,174
False,8336043,Inzlingen,75 und mehr Jahre,201,87,114
False,8336043,Inzlingen,Insgesamt,2500,1197,1303
False,8336045,"Kandern, Stadt",unter 3 Jahre,183,88,95
False,8336045,"Kandern, Stadt",3 -  6 Jahre,213,127,86
False,8336045,"Kandern, Stadt",6 - 10 Jahre,343,171,172
False,8336045,"Kandern, Stadt",10 - 15 Jahre,482,251,231
False,8336045,"Kandern, Stadt",15 - 18 Jahre,372,163,209
False,8336045,"Kandern, Stadt",18 - 20 Jahre,195,87,108
False,8336045,"Kandern, Stadt",20 - 25 Jahre,387,189,198
False,8336045,"Kandern, Stadt",25 - 30 Jahre,365,178,187
False,8336045,"Kandern, Stadt",30 - 35 Jahre,366,167,199
False,8336045,"Kandern, Stadt",35 - 40 Jahre,693,332,361
False,8336045,"Kandern, Stadt",40 - 45 Jahre,775,371,404
False,8336045,"Kandern, Stadt",45 - 50 Jahre,711,354,357
False,8336045,"Kandern, Stadt",50 - 55 Jahre,549,295,254
False,8336045,"Kandern, Stadt",55 - 60 Jahre,431,216,215
False,8336045,"Kandern, Stadt",60 - 65 Jahre,402,201,201
False,8336045,"Kandern, Stadt",65 - 75 Jahre,828,407,421
False,8336045,"Kandern, Stadt",75 und mehr Jahre,793,244,549
False,8336045,"Kandern, Stadt",Insgesamt,8088,3841,4247
False,8336050,"Lörrach, Stadt",unter 3 Jahre,1191,601,590
False,8336050,"Lörrach, Stadt",3 -  6 Jahre,1310,675,635
False,8336050,"Lörrach, Stadt",6 - 10 Jahre,1971,985,986
False,8336050,"Lörrach, Stadt",10 - 15 Jahre,2568,1343,1225
False,8336050,"Lörrach, Stadt",15 - 18 Jahre,1593,828,765
False,8336050,"Lörrach, Stadt",18 - 20 Jahre,1027,549,478
False,8336050,"Lörrach, Stadt",20 - 25 Jahre,2596,1279,1317
False,8336050,"Lörrach, Stadt",25 - 30 Jahre,2694,1309,1385
False,8336050,"Lörrach, Stadt",30 - 35 Jahre,2943,1480,1463
False,8336050,"Lörrach, Stadt",35 - 40 Jahre,3826,1966,1860
False,8336050,"Lörrach, Stadt",40 - 45 Jahre,4255,2040,2215
False,8336050,"Lörrach, Stadt",45 - 50 Jahre,3712,1881,1831
False,8336050,"Lörrach, Stadt",50 - 55 Jahre,3112,1599,1513
False,8336050,"Lörrach, Stadt",55 - 60 Jahre,2688,1290,1398
False,8336050,"Lörrach, Stadt",60 - 65 Jahre,2390,1149,1241
False,8336050,"Lörrach, Stadt",65 - 75 Jahre,5075,2340,2735
False,8336050,"Lörrach, Stadt",75 und mehr Jahre,4075,1384,2691
False,8336050,"Lörrach, Stadt",Insgesamt,47026,22698,24328
False,8336057,Maulburg,unter 3 Jahre,113,62,51
False,8336057,Maulburg,3 -  6 Jahre,121,72,49
False,8336057,Maulburg,6 - 10 Jahre,179,93,86
False,8336057,Maulburg,10 - 15 Jahre,297,163,134
False,8336057,Maulburg,15 - 18 Jahre,177,92,85
False,8336057,Maulburg,18 - 20 Jahre,106,61,45
False,8336057,Maulburg,20 - 25 Jahre,229,121,108
False,8336057,Maulburg,25 - 30 Jahre,213,115,98
False,8336057,Maulburg,30 - 35 Jahre,224,111,113
False,8336057,Maulburg,35 - 40 Jahre,297,142,155
False,8336057,Maulburg,40 - 45 Jahre,366,192,174
False,8336057,Maulburg,45 - 50 Jahre,373,185,188
False,8336057,Maulburg,50 - 55 Jahre,274,142,132
False,8336057,Maulburg,55 - 60 Jahre,228,118,110
False,8336057,Maulburg,60 - 65 Jahre,217,102,115
False,8336057,Maulburg,65 - 75 Jahre,405,198,207
False,8336057,Maulburg,75 und mehr Jahre,267,102,165
False,8336057,Maulburg,Insgesamt,4086,2071,2015
False,8336069,"Rheinfelden (Baden), Stadt",unter 3 Jahre,860,454,406
False,8336069,"Rheinfelden (Baden), Stadt",3 -  6 Jahre,932,482,450
False,8336069,"Rheinfelden (Baden), Stadt",6 - 10 Jahre,1513,769,744
False,8336069,"Rheinfelden (Baden), Stadt",10 - 15 Jahre,1924,992,932
False,8336069,"Rheinfelden (Baden), Stadt",15 - 18 Jahre,1247,634,613
False,8336069,"Rheinfelden (Baden), Stadt",18 - 20 Jahre,748,376,372
False,8336069,"Rheinfelden (Baden), Stadt",20 - 25 Jahre,1717,871,846
False,8336069,"Rheinfelden (Baden), Stadt",25 - 30 Jahre,1767,891,876
False,8336069,"Rheinfelden (Baden), Stadt",30 - 35 Jahre,1976,1010,966
False,8336069,"Rheinfelden (Baden), Stadt",35 - 40 Jahre,2805,1435,1370
False,8336069,"Rheinfelden (Baden), Stadt",40 - 45 Jahre,2907,1450,1457
False,8336069,"Rheinfelden (Baden), Stadt",45 - 50 Jahre,2590,1304,1286
False,8336069,"Rheinfelden (Baden), Stadt",50 - 55 Jahre,2033,1003,1030
False,8336069,"Rheinfelden (Baden), Stadt",55 - 60 Jahre,1681,816,865
False,8336069,"Rheinfelden (Baden), Stadt",60 - 65 Jahre,1775,847,928
False,8336069,"Rheinfelden (Baden), Stadt",65 - 75 Jahre,3570,1643,1927
False,8336069,"Rheinfelden (Baden), Stadt",75 und mehr Jahre,2181,775,1406
False,8336069,"Rheinfelden (Baden), Stadt",Insgesamt,32226,15752,16474
False,8336073,Rümmingen,unter 3 Jahre,32,14,18
False,8336073,Rümmingen,3 -  6 Jahre,51,25,26
False,8336073,Rümmingen,6 - 10 Jahre,72,45,27
False,8336073,Rümmingen,10 - 15 Jahre,97,45,52
False,8336073,Rümmingen,15 - 18 Jahre,62,29,33
False,8336073,Rümmingen,18 - 20 Jahre,39,19,20
False,8336073,Rümmingen,20 - 25 Jahre,93,44,49
False,8336073,Rümmingen,25 - 30 Jahre,84,35,49
False,8336073,Rümmingen,30 - 35 Jahre,107,60,47
False,8336073,Rümmingen,35 - 40 Jahre,129,54,75
False,8336073,Rümmingen,40 - 45 Jahre,158,82,76
False,8336073,Rümmingen,45 - 50 Jahre,139,73,66
False,8336073,Rümmingen,50 - 55 Jahre,111,47,64
False,8336073,Rümmingen,55 - 60 Jahre,128,67,61
False,8336073,Rümmingen,60 - 65 Jahre,111,64,47
False,8336073,Rümmingen,65 - 75 Jahre,136,72,64
False,8336073,Rümmingen,75 und mehr Jahre,84,32,52
False,8336073,Rümmingen,Insgesamt,1633,807,826
False,8336075,Schallbach,unter 3 Jahre,16,10,6
False,8336075,Schallbach,3 -  6 Jahre,26,11,15
False,8336075,Schallbach,6 - 10 Jahre,43,26,17
False,8336075,Schallbach,10 - 15 Jahre,36,18,18
False,8336075,Schallbach,15 - 18 Jahre,30,11,19
False,8336075,Schallbach,18 - 20 Jahre,23,10,13
False,8336075,Schallbach,20 - 25 Jahre,33,13,20
False,8336075,Schallbach,25 - 30 Jahre,36,20,16
False,8336075,Schallbach,30 - 35 Jahre,37,16,21
False,8336075,Schallbach,35 - 40 Jahre,52,28,24
False,8336075,Schallbach,40 - 45 Jahre,67,25,42
False,8336075,Schallbach,45 - 50 Jahre,45,25,20
False,8336075,Schallbach,50 - 55 Jahre,66,35,31
False,8336075,Schallbach,55 - 60 Jahre,55,24,31
False,8336075,Schallbach,60 - 65 Jahre,35,20,15
False,8336075,Schallbach,65 - 75 Jahre,66,33,33
False,8336075,Schallbach,75 und mehr Jahre,43,17,26
False,8336075,Schallbach,Insgesamt,709,342,367
False,8336078,Schliengen,unter 3 Jahre,141,75,66
False,8336078,Schliengen,3 -  6 Jahre,176,79,97
False,8336078,Schliengen,6 - 10 Jahre,255,131,124
False,8336078,Schliengen,10 - 15 Jahre,354,179,175
False,8336078,Schliengen,15 - 18 Jahre,186,106,80
False,8336078,Schliengen,18 - 20 Jahre,143,79,64
False,8336078,Schliengen,20 - 25 Jahre,267,136,131
False,8336078,Schliengen,25 - 30 Jahre,258,123,135
False,8336078,Schliengen,30 - 35 Jahre,303,131,172
False,8336078,Schliengen,35 - 40 Jahre,481,241,240
False,8336078,Schliengen,40 - 45 Jahre,448,240,208
False,8336078,Schliengen,45 - 50 Jahre,460,232,228
False,8336078,Schliengen,50 - 55 Jahre,354,183,171
False,8336078,Schliengen,55 - 60 Jahre,297,161,136
False,8336078,Schliengen,60 - 65 Jahre,246,120,126
False,8336078,Schliengen,65 - 75 Jahre,490,238,252
False,8336078,Schliengen,75 und mehr Jahre,371,140,231
False,8336078,Schliengen,Insgesamt,5230,2594,2636
False,8336079,"Schönau im Schwarzwald, Stadt",unter 3 Jahre,78,41,37
False,8336079,"Schönau im Schwarzwald, Stadt",3 -  6 Jahre,82,36,46
False,8336079,"Schönau im Schwarzwald, Stadt",6 - 10 Jahre,109,50,59
False,8336079,"Schönau im Schwarzwald, Stadt",10 - 15 Jahre,171,95,76
False,8336079,"Schönau im Schwarzwald, Stadt",15 - 18 Jahre,104,53,51
False,8336079,"Schönau im Schwarzwald, Stadt",18 - 20 Jahre,51,22,29
False,8336079,"Schönau im Schwarzwald, Stadt",20 - 25 Jahre,154,76,78
False,8336079,"Schönau im Schwarzwald, Stadt",25 - 30 Jahre,146,71,75
False,8336079,"Schönau im Schwarzwald, Stadt",30 - 35 Jahre,156,81,75
False,8336079,"Schönau im Schwarzwald, Stadt",35 - 40 Jahre,179,91,88
False,8336079,"Schönau im Schwarzwald, Stadt",40 - 45 Jahre,197,97,100
False,8336079,"Schönau im Schwarzwald, Stadt",45 - 50 Jahre,178,98,80
False,8336079,"Schönau im Schwarzwald, Stadt",50 - 55 Jahre,156,66,90
False,8336079,"Schönau im Schwarzwald, Stadt",55 - 60 Jahre,147,77,70
False,8336079,"Schönau im Schwarzwald, Stadt",60 - 65 Jahre,125,59,66
False,8336079,"Schönau im Schwarzwald, Stadt",65 - 75 Jahre,298,141,157
False,8336079,"Schönau im Schwarzwald, Stadt",75 und mehr Jahre,217,78,139
False,8336079,"Schönau im Schwarzwald, Stadt",Insgesamt,2548,1232,1316
False,8336080,Schönenberg,unter 3 Jahre,7,3,4
False,8336080,Schönenberg,3 -  6 Jahre,15,10,5
False,8336080,Schönenberg,6 - 10 Jahre,19,10,9
False,8336080,Schönenberg,10 - 15 Jahre,19,7,12
False,8336080,Schönenberg,15 - 18 Jahre,13,6,7
False,8336080,Schönenberg,18 - 20 Jahre,9,7,2
False,8336080,Schönenberg,20 - 25 Jahre,10,7,3
False,8336080,Schönenberg,25 - 30 Jahre,22,11,11
False,8336080,Schönenberg,30 - 35 Jahre,25,13,12
False,8336080,Schönenberg,35 - 40 Jahre,26,13,13
False,8336080,Schönenberg,40 - 45 Jahre,36,20,16
False,8336080,Schönenberg,45 - 50 Jahre,26,13,13
False,8336080,Schönenberg,50 - 55 Jahre,13,5,8
False,8336080,Schönenberg,55 - 60 Jahre,20,9,11
False,8336080,Schönenberg,60 - 65 Jahre,16,9,7
False,8336080,Schönenberg,65 - 75 Jahre,52,31,21
False,8336080,Schönenberg,75 und mehr Jahre,19,6,13
False,8336080,Schönenberg,Insgesamt,347,180,167
False,8336081,"Schopfheim, Stadt",unter 3 Jahre,461,235,226
False,8336081,"Schopfheim, Stadt",3 -  6 Jahre,556,280,276
False,8336081,"Schopfheim, Stadt",6 - 10 Jahre,900,455,445
False,8336081,"Schopfheim, Stadt",10 - 15 Jahre,1218,593,625
False,8336081,"Schopfheim, Stadt",15 - 18 Jahre,776,382,394
False,8336081,"Schopfheim, Stadt",18 - 20 Jahre,486,243,243
False,8336081,"Schopfheim, Stadt",20 - 25 Jahre,1132,592,540
False,8336081,"Schopfheim, Stadt",25 - 30 Jahre,932,470,462
False,8336081,"Schopfheim, Stadt",30 - 35 Jahre,1027,485,542
False,8336081,"Schopfheim, Stadt",35 - 40 Jahre,1511,772,739
False,8336081,"Schopfheim, Stadt",40 - 45 Jahre,1799,891,908
False,8336081,"Schopfheim, Stadt",45 - 50 Jahre,1573,787,786
False,8336081,"Schopfheim, Stadt",50 - 55 Jahre,1337,665,672
False,8336081,"Schopfheim, Stadt",55 - 60 Jahre,1065,548,517
False,8336081,"Schopfheim, Stadt",60 - 65 Jahre,968,466,502
False,8336081,"Schopfheim, Stadt",65 - 75 Jahre,1938,934,1004
False,8336081,"Schopfheim, Stadt",75 und mehr Jahre,1640,544,1096
False,8336081,"Schopfheim, Stadt",Insgesamt,19319,9342,9977
False,8336082,Schwörstadt,unter 3 Jahre,66,32,34
False,8336082,Schwörstadt,3 -  6 Jahre,57,29,28
False,8336082,Schwörstadt,6 - 10 Jahre,103,47,56
False,8336082,Schwörstadt,10 - 15 Jahre,164,79,85
False,8336082,Schwörstadt,15 - 18 Jahre,94,47,47
False,8336082,Schwörstadt,18 - 20 Jahre,69,39,30
False,8336082,Schwörstadt,20 - 25 Jahre,138,74,64
False,8336082,Schwörstadt,25 - 30 Jahre,112,54,58
False,8336082,Schwörstadt,30 - 35 Jahre,143,64,79
False,8336082,Schwörstadt,35 - 40 Jahre,229,122,107
False,8336082,Schwörstadt,40 - 45 Jahre,213,103,110
False,8336082,Schwörstadt,45 - 50 Jahre,187,90,97
False,8336082,Schwörstadt,50 - 55 Jahre,168,87,81
False,8336082,Schwörstadt,55 - 60 Jahre,136,70,66
False,8336082,Schwörstadt,60 - 65 Jahre,144,70,74
False,8336082,Schwörstadt,65 - 75 Jahre,253,131,122
False,8336082,Schwörstadt,75 und mehr Jahre,180,74,106
False,8336082,Schwörstadt,Insgesamt,2456,1212,1244
False,8336084,Steinen,unter 3 Jahre,233,119,114
False,8336084,Steinen,3 -  6 Jahre,312,177,135
False,8336084,Steinen,6 - 10 Jahre,463,231,232
False,8336084,Steinen,10 - 15 Jahre,612,307,305
False,8336084,Steinen,15 - 18 Jahre,393,202,191
False,8336084,Steinen,18 - 20 Jahre,253,137,116
False,8336084,Steinen,20 - 25 Jahre,497,253,244
False,8336084,Steinen,25 - 30 Jahre,453,224,229
False,8336084,Steinen,30 - 35 Jahre,499,235,264
False,8336084,Steinen,35 - 40 Jahre,858,414,444
False,8336084,Steinen,40 - 45 Jahre,1022,507,515
False,8336084,Steinen,45 - 50 Jahre,828,405,423
False,8336084,Steinen,50 - 55 Jahre,719,363,356
False,8336084,Steinen,55 - 60 Jahre,555,282,273
False,8336084,Steinen,60 - 65 Jahre,523,271,252
False,8336084,Steinen,65 - 75 Jahre,1089,508,581
False,8336084,Steinen,75 und mehr Jahre,758,271,487
False,8336084,Steinen,Insgesamt,10067,4906,5161
False,8336087,"Todtnau, Stadt",unter 3 Jahre,111,56,55
False,8336087,"Todtnau, Stadt",3 -  6 Jahre,140,66,74
False,8336087,"Todtnau, Stadt",6 - 10 Jahre,269,137,132
False,8336087,"Todtnau, Stadt",10 - 15 Jahre,321,163,158
False,8336087,"Todtnau, Stadt",15 - 18 Jahre,173,94,79
False,8336087,"Todtnau, Stadt",18 - 20 Jahre,100,54,46
False,8336087,"Todtnau, Stadt",20 - 25 Jahre,244,113,131
False,8336087,"Todtnau, Stadt",25 - 30 Jahre,250,103,147
False,8336087,"Todtnau, Stadt",30 - 35 Jahre,282,137,145
False,8336087,"Todtnau, Stadt",35 - 40 Jahre,409,207,202
False,8336087,"Todtnau, Stadt",40 - 45 Jahre,502,269,233
False,8336087,"Todtnau, Stadt",45 - 50 Jahre,354,181,173
False,8336087,"Todtnau, Stadt",50 - 55 Jahre,303,162,141
False,8336087,"Todtnau, Stadt",55 - 60 Jahre,260,123,137
False,8336087,"Todtnau, Stadt",60 - 65 Jahre,259,124,135
False,8336087,"Todtnau, Stadt",65 - 75 Jahre,599,294,305
False,8336087,"Todtnau, Stadt",75 und mehr Jahre,464,158,306
False,8336087,"Todtnau, Stadt",Insgesamt,5040,2441,2599
False,8336089,Tunau,unter 3 Jahre,6,3,3
False,8336089,Tunau,3 -  6 Jahre,6,3,3
False,8336089,Tunau,6 - 10 Jahre,4,3,1
False,8336089,Tunau,10 - 15 Jahre,8,4,4
False,8336089,Tunau,15 - 18 Jahre,8,4,4
False,8336089,Tunau,18 - 20 Jahre,2,1,1
False,8336089,Tunau,20 - 25 Jahre,6,1,5
False,8336089,Tunau,25 - 30 Jahre,13,7,6
False,8336089,Tunau,30 - 35 Jahre,18,9,9
False,8336089,Tunau,35 - 40 Jahre,9,4,5
False,8336089,Tunau,40 - 45 Jahre,15,7,8
False,8336089,Tunau,45 - 50 Jahre,15,6,9
False,8336089,Tunau,50 - 55 Jahre,15,10,5
False,8336089,Tunau,55 - 60 Jahre,10,7,3
False,8336089,Tunau,60 - 65 Jahre,3,2,1
False,8336089,Tunau,65 - 75 Jahre,30,12,18
False,8336089,Tunau,75 und mehr Jahre,13,4,9
False,8336089,Tunau,Insgesamt,181,87,94
False,8336090,Utzenfeld,unter 3 Jahre,22,8,14
False,8336090,Utzenfeld,3 -  6 Jahre,16,7,9
False,8336090,Utzenfeld,6 - 10 Jahre,31,16,15
False,8336090,Utzenfeld,10 - 15 Jahre,46,23,23
False,8336090,Utzenfeld,15 - 18 Jahre,25,14,11
False,8336090,Utzenfeld,18 - 20 Jahre,17,5,12
False,8336090,Utzenfeld,20 - 25 Jahre,40,25,15
False,8336090,Utzenfeld,25 - 30 Jahre,38,14,24
False,8336090,Utzenfeld,30 - 35 Jahre,30,14,16
False,8336090,Utzenfeld,35 - 40 Jahre,38,23,15
False,8336090,Utzenfeld,40 - 45 Jahre,57,29,28
False,8336090,Utzenfeld,45 - 50 Jahre,70,34,36
False,8336090,Utzenfeld,50 - 55 Jahre,44,24,20
False,8336090,Utzenfeld,55 - 60 Jahre,22,15,7
False,8336090,Utzenfeld,60 - 65 Jahre,38,17,21
False,8336090,Utzenfeld,65 - 75 Jahre,75,35,40
False,8336090,Utzenfeld,75 und mehr Jahre,50,21,29
False,8336090,Utzenfeld,Insgesamt,659,324,335
False,8336091,"Weil am Rhein, Stadt",unter 3 Jahre,741,379,362
False,8336091,"Weil am Rhein, Stadt",3 -  6 Jahre,914,463,451
False,8336091,"Weil am Rhein, Stadt",6 - 10 Jahre,1317,647,670
False,8336091,"Weil am Rhein, Stadt",10 - 15 Jahre,1625,857,768
False,8336091,"Weil am Rhein, Stadt",15 - 18 Jahre,1127,563,564
False,8336091,"Weil am Rhein, Stadt",18 - 20 Jahre,698,350,348
False,8336091,"Weil am Rhein, Stadt",20 - 25 Jahre,1549,767,782
False,8336091,"Weil am Rhein, Stadt",25 - 30 Jahre,1611,748,863
False,8336091,"Weil am Rhein, Stadt",30 - 35 Jahre,1840,905,935
False,8336091,"Weil am Rhein, Stadt",35 - 40 Jahre,2483,1255,1228
False,8336091,"Weil am Rhein, Stadt",40 - 45 Jahre,2537,1298,1239
False,8336091,"Weil am Rhein, Stadt",45 - 50 Jahre,2289,1115,1174
False,8336091,"Weil am Rhein, Stadt",50 - 55 Jahre,1887,941,946
False,8336091,"Weil am Rhein, Stadt",55 - 60 Jahre,1677,804,873
False,8336091,"Weil am Rhein, Stadt",60 - 65 Jahre,1642,830,812
False,8336091,"Weil am Rhein, Stadt",65 - 75 Jahre,3293,1542,1751
False,8336091,"Weil am Rhein, Stadt",75 und mehr Jahre,2303,833,1470
False,8336091,"Weil am Rhein, Stadt",Insgesamt,29533,14297,15236
False,8336094,Wembach,unter 3 Jahre,8,4,4
False,8336094,Wembach,3 -  6 Jahre,13,8,5
False,8336094,Wembach,6 - 10 Jahre,15,9,6
False,8336094,Wembach,10 - 15 Jahre,17,8,9
False,8336094,Wembach,15 - 18 Jahre,21,11,10
False,8336094,Wembach,18 - 20 Jahre,6,3,3
False,8336094,Wembach,20 - 25 Jahre,23,15,8
False,8336094,Wembach,25 - 30 Jahre,13,5,8
False,8336094,Wembach,30 - 35 Jahre,27,13,14
False,8336094,Wembach,35 - 40 Jahre,29,16,13
False,8336094,Wembach,40 - 45 Jahre,17,7,10
False,8336094,Wembach,45 - 50 Jahre,20,9,11
False,8336094,Wembach,50 - 55 Jahre,27,16,11
False,8336094,Wembach,55 - 60 Jahre,22,7,15
False,8336094,Wembach,60 - 65 Jahre,9,5,4
False,8336094,Wembach,65 - 75 Jahre,37,18,19
False,8336094,Wembach,75 und mehr Jahre,30,12,18
False,8336094,Wembach,Insgesamt,334,166,168
False,8336096,Wieden,unter 3 Jahre,19,8,11
False,8336096,Wieden,3 -  6 Jahre,23,15,8
False,8336096,Wieden,6 - 10 Jahre,30,17,13
False,8336096,Wieden,10 - 15 Jahre,45,15,30
False,8336096,Wieden,15 - 18 Jahre,29,17,12
False,8336096,Wieden,18 - 20 Jahre,21,10,11
False,8336096,Wieden,20 - 25 Jahre,43,28,15
False,8336096,Wieden,25 - 30 Jahre,26,19,7
False,8336096,Wieden,30 - 35 Jahre,38,15,23
False,8336096,Wieden,35 - 40 Jahre,37,17,20
False,8336096,Wieden,40 - 45 Jahre,46,23,23
False,8336096,Wieden,45 - 50 Jahre,42,18,24
False,8336096,Wieden,50 - 55 Jahre,40,22,18
False,8336096,Wieden,55 - 60 Jahre,31,12,19
False,8336096,Wieden,60 - 65 Jahre,35,22,13
False,8336096,Wieden,65 - 75 Jahre,41,26,15
False,8336096,Wieden,75 und mehr Jahre,36,13,23
False,8336096,Wieden,Insgesamt,582,297,285
False,8336100,Wittlingen,unter 3 Jahre,26,17,9
False,8336100,Wittlingen,3 -  6 Jahre,29,13,16
False,8336100,Wittlingen,6 - 10 Jahre,61,37,24
False,8336100,Wittlingen,10 - 15 Jahre,76,34,42
False,8336100,Wittlingen,15 - 18 Jahre,52,13,39
False,8336100,Wittlingen,18 - 20 Jahre,32,20,12
False,8336100,Wittlingen,20 - 25 Jahre,56,27,29
False,8336100,Wittlingen,25 - 30 Jahre,28,9,19
False,8336100,Wittlingen,30 - 35 Jahre,51,25,26
False,8336100,Wittlingen,35 - 40 Jahre,76,34,42
False,8336100,Wittlingen,40 - 45 Jahre,106,43,63
False,8336100,Wittlingen,45 - 50 Jahre,96,57,39
False,8336100,Wittlingen,50 - 55 Jahre,62,39,23
False,8336100,Wittlingen,55 - 60 Jahre,37,16,21
False,8336100,Wittlingen,60 - 65 Jahre,33,16,17
False,8336100,Wittlingen,65 - 75 Jahre,90,42,48
False,8336100,Wittlingen,75 und mehr Jahre,47,19,28
False,8336100,Wittlingen,Insgesamt,958,461,497
False,8336103,"Zell im Wiesental, Stadt",unter 3 Jahre,159,74,85
False,8336103,"Zell im Wiesental, Stadt",3 -  6 Jahre,160,76,84
False,8336103,"Zell im Wiesental, Stadt",6 - 10 Jahre,274,141,133
False,8336103,"Zell im Wiesental, Stadt",10 - 15 Jahre,415,225,190
False,8336103,"Zell im Wiesental, Stadt",15 - 18 Jahre,282,139,143
False,8336103,"Zell im Wiesental, Stadt",18 - 20 Jahre,174,100,74
False,8336103,"Zell im Wiesental, Stadt",20 - 25 Jahre,363,192,171
False,8336103,"Zell im Wiesental, Stadt",25 - 30 Jahre,286,158,128
False,8336103,"Zell im Wiesental, Stadt",30 - 35 Jahre,330,153,177
False,8336103,"Zell im Wiesental, Stadt",35 - 40 Jahre,480,240,240
False,8336103,"Zell im Wiesental, Stadt",40 - 45 Jahre,564,290,274
False,8336103,"Zell im Wiesental, Stadt",45 - 50 Jahre,471,248,223
False,8336103,"Zell im Wiesental, Stadt",50 - 55 Jahre,384,203,181
False,8336103,"Zell im Wiesental, Stadt",55 - 60 Jahre,319,169,150
False,8336103,"Zell im Wiesental, Stadt",60 - 65 Jahre,290,153,137
False,8336103,"Zell im Wiesental, Stadt",65 - 75 Jahre,654,291,363
False,8336103,"Zell im Wiesental, Stadt",75 und mehr Jahre,439,159,280
False,8336103,"Zell im Wiesental, Stadt",Insgesamt,6044,3011,3033
False,8336104,Malsburg-Marzell,unter 3 Jahre,37,22,15
False,8336104,Malsburg-Marzell,3 -  6 Jahre,41,23,18
False,8336104,Malsburg-Marzell,6 - 10 Jahre,60,29,31
False,8336104,Malsburg-Marzell,10 - 15 Jahre,98,62,36
False,8336104,Malsburg-Marzell,15 - 18 Jahre,90,47,43
False,8336104,Malsburg-Marzell,18 - 20 Jahre,47,31,16
False,8336104,Malsburg-Marzell,20 - 25 Jahre,81,40,41
False,8336104,Malsburg-Marzell,25 - 30 Jahre,58,22,36
False,8336104,Malsburg-Marzell,30 - 35 Jahre,76,40,36
False,8336104,Malsburg-Marzell,35 - 40 Jahre,113,50,63
False,8336104,Malsburg-Marzell,40 - 45 Jahre,150,77,73
False,8336104,Malsburg-Marzell,45 - 50 Jahre,116,57,59
False,8336104,Malsburg-Marzell,50 - 55 Jahre,114,62,52
False,8336104,Malsburg-Marzell,55 - 60 Jahre,82,38,44
False,8336104,Malsburg-Marzell,60 - 65 Jahre,85,45,40
False,8336104,Malsburg-Marzell,65 - 75 Jahre,155,74,81
False,8336104,Malsburg-Marzell,75 und mehr Jahre,130,49,81
False,8336104,Malsburg-Marzell,Insgesamt,1533,768,765
False,8336105,Grenzach-Wyhlen,unter 3 Jahre,317,157,160
False,8336105,Grenzach-Wyhlen,3 -  6 Jahre,386,192,194
False,8336105,Grenzach-Wyhlen,6 - 10 Jahre,564,280,284
False,8336105,Grenzach-Wyhlen,10 - 15 Jahre,768,391,377
False,8336105,Grenzach-Wyhlen,15 - 18 Jahre,467,248,219
False,8336105,Grenzach-Wyhlen,18 - 20 Jahre,315,156,159
False,8336105,Grenzach-Wyhlen,20 - 25 Jahre,695,364,331
False,8336105,Grenzach-Wyhlen,25 - 30 Jahre,672,314,358
False,8336105,Grenzach-Wyhlen,30 - 35 Jahre,795,377,418
False,8336105,Grenzach-Wyhlen,35 - 40 Jahre,1178,570,608
False,8336105,Grenzach-Wyhlen,40 - 45 Jahre,1285,663,622
False,8336105,Grenzach-Wyhlen,45 - 50 Jahre,1070,496,574
False,8336105,Grenzach-Wyhlen,50 - 55 Jahre,933,476,457
False,8336105,Grenzach-Wyhlen,55 - 60 Jahre,839,406,433
False,8336105,Grenzach-Wyhlen,60 - 65 Jahre,774,379,395
False,8336105,Grenzach-Wyhlen,65 - 75 Jahre,1674,793,881
False,8336105,Grenzach-Wyhlen,75 und mehr Jahre,1068,412,656
False,8336105,Grenzach-Wyhlen,Insgesamt,13800,6674,7126
False,8336106,Häg-Ehrsberg,unter 3 Jahre,26,14,12
False,8336106,Häg-Ehrsberg,3 -  6 Jahre,22,13,9
False,8336106,Häg-Ehrsberg,6 - 10 Jahre,50,27,23
False,8336106,Häg-Ehrsberg,10 - 15 Jahre,57,33,24
False,8336106,Häg-Ehrsberg,15 - 18 Jahre,37,16,21
False,8336106,Häg-Ehrsberg,18 - 20 Jahre,18,8,10
False,8336106,Häg-Ehrsberg,20 - 25 Jahre,55,39,16
False,8336106,Häg-Ehrsberg,25 - 30 Jahre,47,24,23
False,8336106,Häg-Ehrsberg,30 - 35 Jahre,36,22,14
False,8336106,Häg-Ehrsberg,35 - 40 Jahre,70,41,29
False,8336106,Häg-Ehrsberg,40 - 45 Jahre,68,46,22
False,8336106,Häg-Ehrsberg,45 - 50 Jahre,77,31,46
False,8336106,Häg-Ehrsberg,50 - 55 Jahre,68,40,28
False,8336106,Häg-Ehrsberg,55 - 60 Jahre,35,16,19
False,8336106,Häg-Ehrsberg,60 - 65 Jahre,24,11,13
False,8336106,Häg-Ehrsberg,65 - 75 Jahre,92,37,55
False,8336106,Häg-Ehrsberg,75 und mehr Jahre,71,33,38
False,8336106,Häg-Ehrsberg,Insgesamt,853,451,402
False,8336107,Kleines Wiesental,unter 3 Jahre,68,37,31
False,8336107,Kleines Wiesental,3 -  6 Jahre,97,49,48
False,8336107,Kleines Wiesental,6 - 10 Jahre,124,60,64
False,8336107,Kleines Wiesental,10 - 15 Jahre,218,123,95
False,8336107,Kleines Wiesental,15 - 18 Jahre,130,76,54
False,8336107,Kleines Wiesental,18 - 20 Jahre,65,30,35
False,8336107,Kleines Wiesental,20 - 25 Jahre,131,61,70
False,8336107,Kleines Wiesental,25 - 30 Jahre,108,51,57
False,8336107,Kleines Wiesental,30 - 35 Jahre,152,74,78
False,8336107,Kleines Wiesental,35 - 40 Jahre,246,136,110
False,8336107,Kleines Wiesental,40 - 45 Jahre,312,149,163
False,8336107,Kleines Wiesental,45 - 50 Jahre,260,137,123
False,8336107,Kleines Wiesental,50 - 55 Jahre,219,122,97
False,8336107,Kleines Wiesental,55 - 60 Jahre,162,82,80
False,8336107,Kleines Wiesental,60 - 65 Jahre,148,77,71
False,8336107,Kleines Wiesental,65 - 75 Jahre,330,159,171
False,8336107,Kleines Wiesental,75 und mehr Jahre,256,94,162
False,8336107,Kleines Wiesental,Insgesamt,3026,1517,1509
False,8337,Landkreis Waldshut,unter 3 Jahre,4489,2331,2158
False,8337,Landkreis Waldshut,3 -  6 Jahre,5120,2604,2516
False,8337,Landkreis Waldshut,6 - 10 Jahre,7522,3840,3682
False,8337,Landkreis Waldshut,10 - 15 Jahre,10248,5290,4958
False,8337,Landkreis Waldshut,15 - 18 Jahre,6636,3383,3253
False,8337,Landkreis Waldshut,18 - 20 Jahre,4222,2180,2042
False,8337,Landkreis Waldshut,20 - 25 Jahre,9567,4896,4671
False,8337,Landkreis Waldshut,25 - 30 Jahre,8776,4399,4377
False,8337,Landkreis Waldshut,30 - 35 Jahre,9546,4631,4915
False,8337,Landkreis Waldshut,35 - 40 Jahre,13266,6586,6680
False,8337,Landkreis Waldshut,40 - 45 Jahre,14428,7325,7103
False,8337,Landkreis Waldshut,45 - 50 Jahre,12756,6507,6249
False,8337,Landkreis Waldshut,50 - 55 Jahre,11114,5566,5548
False,8337,Landkreis Waldshut,55 - 60 Jahre,9330,4693,4637
False,8337,Landkreis Waldshut,60 - 65 Jahre,8507,4204,4303
False,8337,Landkreis Waldshut,65 - 75 Jahre,17946,8587,9359
False,8337,Landkreis Waldshut,75 und mehr Jahre,13801,4911,8890
False,8337,Landkreis Waldshut,Insgesamt,167274,81933,85341
False,8337002,Albbruck,unter 3 Jahre,222,115,107
False,8337002,Albbruck,3 -  6 Jahre,258,127,131
False,8337002,Albbruck,6 - 10 Jahre,336,187,149
False,8337002,Albbruck,10 - 15 Jahre,513,271,242
False,8337002,Albbruck,15 - 18 Jahre,323,160,163
False,8337002,Albbruck,18 - 20 Jahre,211,122,89
False,8337002,Albbruck,20 - 25 Jahre,454,251,203
False,8337002,Albbruck,25 - 30 Jahre,434,218,216
False,8337002,Albbruck,30 - 35 Jahre,392,198,194
False,8337002,Albbruck,35 - 40 Jahre,573,286,287
False,8337002,Albbruck,40 - 45 Jahre,652,328,324
False,8337002,Albbruck,45 - 50 Jahre,618,314,304
False,8337002,Albbruck,50 - 55 Jahre,473,234,239
False,8337002,Albbruck,55 - 60 Jahre,358,195,163
False,8337002,Albbruck,60 - 65 Jahre,334,148,186
False,8337002,Albbruck,65 - 75 Jahre,693,334,359
False,8337002,Albbruck,75 und mehr Jahre,556,216,340
False,8337002,Albbruck,Insgesamt,7400,3704,3696
False,8337013,Bernau im Schwarzwald,unter 3 Jahre,44,27,17
False,8337013,Bernau im Schwarzwald,3 -  6 Jahre,51,26,25
False,8337013,Bernau im Schwarzwald,6 - 10 Jahre,84,37,47
False,8337013,Bernau im Schwarzwald,10 - 15 Jahre,115,61,54
False,8337013,Bernau im Schwarzwald,15 - 18 Jahre,81,43,38
False,8337013,Bernau im Schwarzwald,18 - 20 Jahre,47,26,21
False,8337013,Bernau im Schwarzwald,20 - 25 Jahre,101,53,48
False,8337013,Bernau im Schwarzwald,25 - 30 Jahre,103,57,46
False,8337013,Bernau im Schwarzwald,30 - 35 Jahre,72,32,40
False,8337013,Bernau im Schwarzwald,35 - 40 Jahre,134,65,69
False,8337013,Bernau im Schwarzwald,40 - 45 Jahre,164,84,80
False,8337013,Bernau im Schwarzwald,45 - 50 Jahre,163,84,79
False,8337013,Bernau im Schwarzwald,50 - 55 Jahre,137,64,73
False,8337013,Bernau im Schwarzwald,55 - 60 Jahre,117,53,64
False,8337013,Bernau im Schwarzwald,60 - 65 Jahre,115,61,54
False,8337013,Bernau im Schwarzwald,65 - 75 Jahre,217,108,109
False,8337013,Bernau im Schwarzwald,75 und mehr Jahre,180,79,101
False,8337013,Bernau im Schwarzwald,Insgesamt,1925,960,965
False,8337022,"Bonndorf im Schwarzwald, Stadt",unter 3 Jahre,200,104,96
False,8337022,"Bonndorf im Schwarzwald, Stadt",3 -  6 Jahre,222,117,105
False,8337022,"Bonndorf im Schwarzwald, Stadt",6 - 10 Jahre,368,201,167
False,8337022,"Bonndorf im Schwarzwald, Stadt",10 - 15 Jahre,474,250,224
False,8337022,"Bonndorf im Schwarzwald, Stadt",15 - 18 Jahre,299,150,149
False,8337022,"Bonndorf im Schwarzwald, Stadt",18 - 20 Jahre,179,82,97
False,8337022,"Bonndorf im Schwarzwald, Stadt",20 - 25 Jahre,386,196,190
False,8337022,"Bonndorf im Schwarzwald, Stadt",25 - 30 Jahre,358,175,183
False,8337022,"Bonndorf im Schwarzwald, Stadt",30 - 35 Jahre,384,193,191
False,8337022,"Bonndorf im Schwarzwald, Stadt",35 - 40 Jahre,587,296,291
False,8337022,"Bonndorf im Schwarzwald, Stadt",40 - 45 Jahre,625,324,301
False,8337022,"Bonndorf im Schwarzwald, Stadt",45 - 50 Jahre,491,250,241
False,8337022,"Bonndorf im Schwarzwald, Stadt",50 - 55 Jahre,437,226,211
False,8337022,"Bonndorf im Schwarzwald, Stadt",55 - 60 Jahre,337,173,164
False,8337022,"Bonndorf im Schwarzwald, Stadt",60 - 65 Jahre,296,143,153
False,8337022,"Bonndorf im Schwarzwald, Stadt",65 - 75 Jahre,710,348,362
False,8337022,"Bonndorf im Schwarzwald, Stadt",75 und mehr Jahre,503,172,331
False,8337022,"Bonndorf im Schwarzwald, Stadt",Insgesamt,6856,3400,3456
False,8337027,Dachsberg (Südschwarzwald),unter 3 Jahre,35,20,15
False,8337027,Dachsberg (Südschwarzwald),3 -  6 Jahre,56,29,27
False,8337027,Dachsberg (Südschwarzwald),6 - 10 Jahre,86,47,39
False,8337027,Dachsberg (Südschwarzwald),10 - 15 Jahre,108,54,54
False,8337027,Dachsberg (Südschwarzwald),15 - 18 Jahre,77,48,29
False,8337027,Dachsberg (Südschwarzwald),18 - 20 Jahre,30,16,14
False,8337027,Dachsberg (Südschwarzwald),20 - 25 Jahre,73,35,38
False,8337027,Dachsberg (Südschwarzwald),25 - 30 Jahre,58,43,15
False,8337027,Dachsberg (Südschwarzwald),30 - 35 Jahre,48,20,28
False,8337027,Dachsberg (Südschwarzwald),35 - 40 Jahre,96,49,47
False,8337027,Dachsberg (Südschwarzwald),40 - 45 Jahre,140,65,75
False,8337027,Dachsberg (Südschwarzwald),45 - 50 Jahre,113,62,51
False,8337027,Dachsberg (Südschwarzwald),50 - 55 Jahre,88,50,38
False,8337027,Dachsberg (Südschwarzwald),55 - 60 Jahre,65,32,33
False,8337027,Dachsberg (Südschwarzwald),60 - 65 Jahre,68,29,39
False,8337027,Dachsberg (Südschwarzwald),65 - 75 Jahre,162,69,93
False,8337027,Dachsberg (Südschwarzwald),75 und mehr Jahre,116,46,70
False,8337027,Dachsberg (Südschwarzwald),Insgesamt,1419,714,705
False,8337030,Dettighofen,unter 3 Jahre,38,20,18
False,8337030,Dettighofen,3 -  6 Jahre,32,17,15
False,8337030,Dettighofen,6 - 10 Jahre,63,33,30
False,8337030,Dettighofen,10 - 15 Jahre,78,43,35
False,8337030,Dettighofen,15 - 18 Jahre,38,17,21
False,8337030,Dettighofen,18 - 20 Jahre,18,10,8
False,8337030,Dettighofen,20 - 25 Jahre,53,27,26
False,8337030,Dettighofen,25 - 30 Jahre,56,27,29
False,8337030,Dettighofen,30 - 35 Jahre,62,24,38
False,8337030,Dettighofen,35 - 40 Jahre,87,43,44
False,8337030,Dettighofen,40 - 45 Jahre,103,56,47
False,8337030,Dettighofen,45 - 50 Jahre,84,43,41
False,8337030,Dettighofen,50 - 55 Jahre,85,46,39
False,8337030,Dettighofen,55 - 60 Jahre,59,36,23
False,8337030,Dettighofen,60 - 65 Jahre,52,21,31
False,8337030,Dettighofen,65 - 75 Jahre,99,47,52
False,8337030,Dettighofen,75 und mehr Jahre,99,45,54
False,8337030,Dettighofen,Insgesamt,1106,555,551
False,8337032,Dogern,unter 3 Jahre,63,28,35
False,8337032,Dogern,3 -  6 Jahre,70,40,30
False,8337032,Dogern,6 - 10 Jahre,104,52,52
False,8337032,Dogern,10 - 15 Jahre,127,70,57
False,8337032,Dogern,15 - 18 Jahre,79,37,42
False,8337032,Dogern,18 - 20 Jahre,53,25,28
False,8337032,Dogern,20 - 25 Jahre,128,76,52
False,8337032,Dogern,25 - 30 Jahre,120,66,54
False,8337032,Dogern,30 - 35 Jahre,115,54,61
False,8337032,Dogern,35 - 40 Jahre,153,83,70
False,8337032,Dogern,40 - 45 Jahre,201,99,102
False,8337032,Dogern,45 - 50 Jahre,218,101,117
False,8337032,Dogern,50 - 55 Jahre,172,90,82
False,8337032,Dogern,55 - 60 Jahre,139,66,73
False,8337032,Dogern,60 - 65 Jahre,120,62,58
False,8337032,Dogern,65 - 75 Jahre,273,131,142
False,8337032,Dogern,75 und mehr Jahre,198,68,130
False,8337032,Dogern,Insgesamt,2333,1148,1185
False,8337038,Görwihl,unter 3 Jahre,140,64,76
False,8337038,Görwihl,3 -  6 Jahre,142,78,64
False,8337038,Görwihl,6 - 10 Jahre,212,112,100
False,8337038,Görwihl,10 - 15 Jahre,315,169,146
False,8337038,Görwihl,15 - 18 Jahre,214,118,96
False,8337038,Görwihl,18 - 20 Jahre,124,56,68
False,8337038,Görwihl,20 - 25 Jahre,288,149,139
False,8337038,Görwihl,25 - 30 Jahre,226,122,104
False,8337038,Görwihl,30 - 35 Jahre,235,116,119
False,8337038,Görwihl,35 - 40 Jahre,373,179,194
False,8337038,Görwihl,40 - 45 Jahre,397,215,182
False,8337038,Görwihl,45 - 50 Jahre,344,175,169
False,8337038,Görwihl,50 - 55 Jahre,281,132,149
False,8337038,Görwihl,55 - 60 Jahre,244,121,123
False,8337038,Görwihl,60 - 65 Jahre,210,98,112
False,8337038,Görwihl,65 - 75 Jahre,416,201,215
False,8337038,Görwihl,75 und mehr Jahre,334,111,223
False,8337038,Görwihl,Insgesamt,4495,2216,2279
False,8337039,Grafenhausen,unter 3 Jahre,59,40,19
False,8337039,Grafenhausen,3 -  6 Jahre,87,36,51
False,8337039,Grafenhausen,6 - 10 Jahre,127,66,61
False,8337039,Grafenhausen,10 - 15 Jahre,141,73,68
False,8337039,Grafenhausen,15 - 18 Jahre,82,48,34
False,8337039,Grafenhausen,18 - 20 Jahre,55,31,24
False,8337039,Grafenhausen,20 - 25 Jahre,136,83,53
False,8337039,Grafenhausen,25 - 30 Jahre,121,59,62
False,8337039,Grafenhausen,30 - 35 Jahre,142,68,74
False,8337039,Grafenhausen,35 - 40 Jahre,168,87,81
False,8337039,Grafenhausen,40 - 45 Jahre,196,101,95
False,8337039,Grafenhausen,45 - 50 Jahre,158,76,82
False,8337039,Grafenhausen,50 - 55 Jahre,156,79,77
False,8337039,Grafenhausen,55 - 60 Jahre,128,64,64
False,8337039,Grafenhausen,60 - 65 Jahre,124,67,57
False,8337039,Grafenhausen,65 - 75 Jahre,271,128,143
False,8337039,Grafenhausen,75 und mehr Jahre,204,76,128
False,8337039,Grafenhausen,Insgesamt,2355,1182,1173
False,8337045,Häusern,unter 3 Jahre,23,11,12
False,8337045,Häusern,3 -  6 Jahre,41,15,26
False,8337045,Häusern,6 - 10 Jahre,60,38,22
False,8337045,Häusern,10 - 15 Jahre,70,30,40
False,8337045,Häusern,15 - 18 Jahre,50,27,23
False,8337045,Häusern,18 - 20 Jahre,40,23,17
False,8337045,Häusern,20 - 25 Jahre,85,32,53
False,8337045,Häusern,25 - 30 Jahre,57,27,30
False,8337045,Häusern,30 - 35 Jahre,63,28,35
False,8337045,Häusern,35 - 40 Jahre,118,64,54
False,8337045,Häusern,40 - 45 Jahre,90,34,56
False,8337045,Häusern,45 - 50 Jahre,98,52,46
False,8337045,Häusern,50 - 55 Jahre,92,51,41
False,8337045,Häusern,55 - 60 Jahre,74,33,41
False,8337045,Häusern,60 - 65 Jahre,69,34,35
False,8337045,Häusern,65 - 75 Jahre,165,74,91
False,8337045,Häusern,75 und mehr Jahre,116,46,70
False,8337045,Häusern,Insgesamt,1311,619,692
False,8337049,Herrischried,unter 3 Jahre,62,35,27
False,8337049,Herrischried,3 -  6 Jahre,75,45,30
False,8337049,Herrischried,6 - 10 Jahre,130,58,72
False,8337049,Herrischried,10 - 15 Jahre,175,95,80
False,8337049,Herrischried,15 - 18 Jahre,95,53,42
False,8337049,Herrischried,18 - 20 Jahre,61,32,29
False,8337049,Herrischried,20 - 25 Jahre,141,84,57
False,8337049,Herrischried,25 - 30 Jahre,99,53,46
False,8337049,Herrischried,30 - 35 Jahre,115,51,64
False,8337049,Herrischried,35 - 40 Jahre,218,107,111
False,8337049,Herrischried,40 - 45 Jahre,222,123,99
False,8337049,Herrischried,45 - 50 Jahre,204,102,102
False,8337049,Herrischried,50 - 55 Jahre,165,95,70
False,8337049,Herrischried,55 - 60 Jahre,142,66,76
False,8337049,Herrischried,60 - 65 Jahre,145,73,72
False,8337049,Herrischried,65 - 75 Jahre,360,179,181
False,8337049,Herrischried,75 und mehr Jahre,375,141,234
False,8337049,Herrischried,Insgesamt,2784,1392,1392
False,8337051,Höchenschwand,unter 3 Jahre,49,31,18
False,8337051,Höchenschwand,3 -  6 Jahre,55,22,33
False,8337051,Höchenschwand,6 - 10 Jahre,85,35,50
False,8337051,Höchenschwand,10 - 15 Jahre,149,91,58
False,8337051,Höchenschwand,15 - 18 Jahre,89,51,38
False,8337051,Höchenschwand,18 - 20 Jahre,51,28,23
False,8337051,Höchenschwand,20 - 25 Jahre,146,81,65
False,8337051,Höchenschwand,25 - 30 Jahre,95,47,48
False,8337051,Höchenschwand,30 - 35 Jahre,113,52,61
False,8337051,Höchenschwand,35 - 40 Jahre,203,88,115
False,8337051,Höchenschwand,40 - 45 Jahre,235,110,125
False,8337051,Höchenschwand,45 - 50 Jahre,190,92,98
False,8337051,Höchenschwand,50 - 55 Jahre,155,83,72
False,8337051,Höchenschwand,55 - 60 Jahre,140,62,78
False,8337051,Höchenschwand,60 - 65 Jahre,151,69,82
False,8337051,Höchenschwand,65 - 75 Jahre,353,153,200
False,8337051,Höchenschwand,75 und mehr Jahre,251,91,160
False,8337051,Höchenschwand,Insgesamt,2510,1186,1324
False,8337053,Hohentengen am Hochrhein,unter 3 Jahre,106,67,39
False,8337053,Hohentengen am Hochrhein,3 -  6 Jahre,122,58,64
False,8337053,Hohentengen am Hochrhein,6 - 10 Jahre,167,80,87
False,8337053,Hohentengen am Hochrhein,10 - 15 Jahre,239,129,110
False,8337053,Hohentengen am Hochrhein,15 - 18 Jahre,119,69,50
False,8337053,Hohentengen am Hochrhein,18 - 20 Jahre,80,41,39
False,8337053,Hohentengen am Hochrhein,20 - 25 Jahre,170,81,89
False,8337053,Hohentengen am Hochrhein,25 - 30 Jahre,219,111,108
False,8337053,Hohentengen am Hochrhein,30 - 35 Jahre,195,98,97
False,8337053,Hohentengen am Hochrhein,35 - 40 Jahre,303,128,175
False,8337053,Hohentengen am Hochrhein,40 - 45 Jahre,309,176,133
False,8337053,Hohentengen am Hochrhein,45 - 50 Jahre,330,173,157
False,8337053,Hohentengen am Hochrhein,50 - 55 Jahre,253,129,124
False,8337053,Hohentengen am Hochrhein,55 - 60 Jahre,194,91,103
False,8337053,Hohentengen am Hochrhein,60 - 65 Jahre,182,95,87
False,8337053,Hohentengen am Hochrhein,65 - 75 Jahre,364,174,190
False,8337053,Hohentengen am Hochrhein,75 und mehr Jahre,273,120,153
False,8337053,Hohentengen am Hochrhein,Insgesamt,3625,1820,1805
False,8337059,Ibach,unter 3 Jahre,9,4,5
False,8337059,Ibach,3 -  6 Jahre,9,6,3
False,8337059,Ibach,6 - 10 Jahre,18,5,13
False,8337059,Ibach,10 - 15 Jahre,22,12,10
False,8337059,Ibach,15 - 18 Jahre,16,5,11
False,8337059,Ibach,18 - 20 Jahre,7,4,3
False,8337059,Ibach,20 - 25 Jahre,18,11,7
False,8337059,Ibach,25 - 30 Jahre,18,7,11
False,8337059,Ibach,30 - 35 Jahre,18,10,8
False,8337059,Ibach,35 - 40 Jahre,25,12,13
False,8337059,Ibach,40 - 45 Jahre,44,17,27
False,8337059,Ibach,45 - 50 Jahre,30,12,18
False,8337059,Ibach,50 - 55 Jahre,30,15,15
False,8337059,Ibach,55 - 60 Jahre,22,9,13
False,8337059,Ibach,60 - 65 Jahre,21,9,12
False,8337059,Ibach,65 - 75 Jahre,60,33,27
False,8337059,Ibach,75 und mehr Jahre,36,17,19
False,8337059,Ibach,Insgesamt,403,188,215
False,8337060,Jestetten,unter 3 Jahre,116,64,52
False,8337060,Jestetten,3 -  6 Jahre,153,84,69
False,8337060,Jestetten,6 - 10 Jahre,241,128,113
False,8337060,Jestetten,10 - 15 Jahre,328,170,158
False,8337060,Jestetten,15 - 18 Jahre,210,110,100
False,8337060,Jestetten,18 - 20 Jahre,140,68,72
False,8337060,Jestetten,20 - 25 Jahre,288,151,137
False,8337060,Jestetten,25 - 30 Jahre,243,118,125
False,8337060,Jestetten,30 - 35 Jahre,305,146,159
False,8337060,Jestetten,35 - 40 Jahre,383,184,199
False,8337060,Jestetten,40 - 45 Jahre,471,241,230
False,8337060,Jestetten,45 - 50 Jahre,401,193,208
False,8337060,Jestetten,50 - 55 Jahre,315,150,165
False,8337060,Jestetten,55 - 60 Jahre,285,141,144
False,8337060,Jestetten,60 - 65 Jahre,274,133,141
False,8337060,Jestetten,65 - 75 Jahre,556,275,281
False,8337060,Jestetten,75 und mehr Jahre,463,154,309
False,8337060,Jestetten,Insgesamt,5172,2510,2662
False,8337062,Klettgau,unter 3 Jahre,215,97,118
False,8337062,Klettgau,3 -  6 Jahre,252,129,123
False,8337062,Klettgau,6 - 10 Jahre,401,193,208
False,8337062,Klettgau,10 - 15 Jahre,462,233,229
False,8337062,Klettgau,15 - 18 Jahre,276,149,127
False,8337062,Klettgau,18 - 20 Jahre,179,96,83
False,8337062,Klettgau,20 - 25 Jahre,433,225,208
False,8337062,Klettgau,25 - 30 Jahre,364,182,182
False,8337062,Klettgau,30 - 35 Jahre,410,196,214
False,8337062,Klettgau,35 - 40 Jahre,655,313,342
False,8337062,Klettgau,40 - 45 Jahre,667,345,322
False,8337062,Klettgau,45 - 50 Jahre,550,294,256
False,8337062,Klettgau,50 - 55 Jahre,483,258,225
False,8337062,Klettgau,55 - 60 Jahre,387,211,176
False,8337062,Klettgau,60 - 65 Jahre,344,162,182
False,8337062,Klettgau,65 - 75 Jahre,732,360,372
False,8337062,Klettgau,75 und mehr Jahre,587,210,377
False,8337062,Klettgau,Insgesamt,7397,3653,3744
False,8337065,Lauchringen,unter 3 Jahre,205,106,99
False,8337065,Lauchringen,3 -  6 Jahre,233,110,123
False,8337065,Lauchringen,6 - 10 Jahre,326,164,162
False,8337065,Lauchringen,10 - 15 Jahre,447,228,219
False,8337065,Lauchringen,15 - 18 Jahre,280,127,153
False,8337065,Lauchringen,18 - 20 Jahre,183,91,92
False,8337065,Lauchringen,20 - 25 Jahre,478,244,234
False,8337065,Lauchringen,25 - 30 Jahre,424,229,195
False,8337065,Lauchringen,30 - 35 Jahre,449,225,224
False,8337065,Lauchringen,35 - 40 Jahre,591,275,316
False,8337065,Lauchringen,40 - 45 Jahre,602,299,303
False,8337065,Lauchringen,45 - 50 Jahre,582,300,282
False,8337065,Lauchringen,50 - 55 Jahre,524,244,280
False,8337065,Lauchringen,55 - 60 Jahre,453,222,231
False,8337065,Lauchringen,60 - 65 Jahre,414,209,205
False,8337065,Lauchringen,65 - 75 Jahre,727,358,369
False,8337065,Lauchringen,75 und mehr Jahre,481,174,307
False,8337065,Lauchringen,Insgesamt,7399,3605,3794
False,8337066,"Laufenburg (Baden), Stadt",unter 3 Jahre,194,98,96
False,8337066,"Laufenburg (Baden), Stadt",3 -  6 Jahre,258,126,132
False,8337066,"Laufenburg (Baden), Stadt",6 - 10 Jahre,332,162,170
False,8337066,"Laufenburg (Baden), Stadt",10 - 15 Jahre,559,274,285
False,8337066,"Laufenburg (Baden), Stadt",15 - 18 Jahre,354,163,191
False,8337066,"Laufenburg (Baden), Stadt",18 - 20 Jahre,247,144,103
False,8337066,"Laufenburg (Baden), Stadt",20 - 25 Jahre,496,251,245
False,8337066,"Laufenburg (Baden), Stadt",25 - 30 Jahre,429,206,223
False,8337066,"Laufenburg (Baden), Stadt",30 - 35 Jahre,507,241,266
False,8337066,"Laufenburg (Baden), Stadt",35 - 40 Jahre,726,355,371
False,8337066,"Laufenburg (Baden), Stadt",40 - 45 Jahre,776,379,397
False,8337066,"Laufenburg (Baden), Stadt",45 - 50 Jahre,715,349,366
False,8337066,"Laufenburg (Baden), Stadt",50 - 55 Jahre,576,299,277
False,8337066,"Laufenburg (Baden), Stadt",55 - 60 Jahre,464,230,234
False,8337066,"Laufenburg (Baden), Stadt",60 - 65 Jahre,427,222,205
False,8337066,"Laufenburg (Baden), Stadt",65 - 75 Jahre,857,416,441
False,8337066,"Laufenburg (Baden), Stadt",75 und mehr Jahre,612,225,387
False,8337066,"Laufenburg (Baden), Stadt",Insgesamt,8529,4140,4389
False,8337070,Lottstetten,unter 3 Jahre,64,25,39
False,8337070,Lottstetten,3 -  6 Jahre,64,33,31
False,8337070,Lottstetten,6 - 10 Jahre,99,58,41
False,8337070,Lottstetten,10 - 15 Jahre,154,79,75
False,8337070,Lottstetten,15 - 18 Jahre,68,40,28
False,8337070,Lottstetten,18 - 20 Jahre,42,23,19
False,8337070,Lottstetten,20 - 25 Jahre,121,64,57
False,8337070,Lottstetten,25 - 30 Jahre,118,71,47
False,8337070,Lottstetten,30 - 35 Jahre,136,42,94
False,8337070,Lottstetten,35 - 40 Jahre,190,112,78
False,8337070,Lottstetten,40 - 45 Jahre,214,107,107
False,8337070,Lottstetten,45 - 50 Jahre,169,90,79
False,8337070,Lottstetten,50 - 55 Jahre,130,70,60
False,8337070,Lottstetten,55 - 60 Jahre,107,52,55
False,8337070,Lottstetten,60 - 65 Jahre,137,61,76
False,8337070,Lottstetten,65 - 75 Jahre,238,114,124
False,8337070,Lottstetten,75 und mehr Jahre,140,47,93
False,8337070,Lottstetten,Insgesamt,2191,1088,1103
False,8337076,Murg,unter 3 Jahre,199,111,88
False,8337076,Murg,3 -  6 Jahre,209,100,109
False,8337076,Murg,6 - 10 Jahre,326,172,154
False,8337076,Murg,10 - 15 Jahre,401,188,213
False,8337076,Murg,15 - 18 Jahre,321,162,159
False,8337076,Murg,18 - 20 Jahre,180,86,94
False,8337076,Murg,20 - 25 Jahre,425,216,209
False,8337076,Murg,25 - 30 Jahre,378,193,185
False,8337076,Murg,30 - 35 Jahre,401,188,213
False,8337076,Murg,35 - 40 Jahre,589,300,289
False,8337076,Murg,40 - 45 Jahre,586,283,303
False,8337076,Murg,45 - 50 Jahre,514,258,256
False,8337076,Murg,50 - 55 Jahre,492,247,245
False,8337076,Murg,55 - 60 Jahre,361,190,171
False,8337076,Murg,60 - 65 Jahre,323,164,159
False,8337076,Murg,65 - 75 Jahre,721,352,369
False,8337076,Murg,75 und mehr Jahre,525,182,343
False,8337076,Murg,Insgesamt,6951,3392,3559
False,8337090,Rickenbach,unter 3 Jahre,109,51,58
False,8337090,Rickenbach,3 -  6 Jahre,127,57,70
False,8337090,Rickenbach,6 - 10 Jahre,175,86,89
False,8337090,Rickenbach,10 - 15 Jahre,228,118,110
False,8337090,Rickenbach,15 - 18 Jahre,179,96,83
False,8337090,Rickenbach,18 - 20 Jahre,81,47,34
False,8337090,Rickenbach,20 - 25 Jahre,223,111,112
False,8337090,Rickenbach,25 - 30 Jahre,205,98,107
False,8337090,Rickenbach,30 - 35 Jahre,226,121,105
False,8337090,Rickenbach,35 - 40 Jahre,283,141,142
False,8337090,Rickenbach,40 - 45 Jahre,353,160,193
False,8337090,Rickenbach,45 - 50 Jahre,290,144,146
False,8337090,Rickenbach,50 - 55 Jahre,249,134,115
False,8337090,Rickenbach,55 - 60 Jahre,219,119,100
False,8337090,Rickenbach,60 - 65 Jahre,183,87,96
False,8337090,Rickenbach,65 - 75 Jahre,449,224,225
False,8337090,Rickenbach,75 und mehr Jahre,269,106,163
False,8337090,Rickenbach,Insgesamt,3848,1900,1948
False,8337096,"Bad Säckingen, Stadt",unter 3 Jahre,406,205,201
False,8337096,"Bad Säckingen, Stadt",3 -  6 Jahre,492,250,242
False,8337096,"Bad Säckingen, Stadt",6 - 10 Jahre,730,407,323
False,8337096,"Bad Säckingen, Stadt",10 - 15 Jahre,898,478,420
False,8337096,"Bad Säckingen, Stadt",15 - 18 Jahre,584,293,291
False,8337096,"Bad Säckingen, Stadt",18 - 20 Jahre,381,187,194
False,8337096,"Bad Säckingen, Stadt",20 - 25 Jahre,949,464,485
False,8337096,"Bad Säckingen, Stadt",25 - 30 Jahre,868,405,463
False,8337096,"Bad Säckingen, Stadt",30 - 35 Jahre,947,462,485
False,8337096,"Bad Säckingen, Stadt",35 - 40 Jahre,1309,656,653
False,8337096,"Bad Säckingen, Stadt",40 - 45 Jahre,1286,645,641
False,8337096,"Bad Säckingen, Stadt",45 - 50 Jahre,1200,605,595
False,8337096,"Bad Säckingen, Stadt",50 - 55 Jahre,1093,547,546
False,8337096,"Bad Säckingen, Stadt",55 - 60 Jahre,1010,481,529
False,8337096,"Bad Säckingen, Stadt",60 - 65 Jahre,958,464,494
False,8337096,"Bad Säckingen, Stadt",65 - 75 Jahre,1937,875,1062
False,8337096,"Bad Säckingen, Stadt",75 und mehr Jahre,1666,540,1126
False,8337096,"Bad Säckingen, Stadt",Insgesamt,16714,7964,8750
False,8337097,"St. Blasien, Stadt",unter 3 Jahre,83,38,45
False,8337097,"St. Blasien, Stadt",3 -  6 Jahre,93,42,51
False,8337097,"St. Blasien, Stadt",6 - 10 Jahre,150,78,72
False,8337097,"St. Blasien, Stadt",10 - 15 Jahre,196,105,91
False,8337097,"St. Blasien, Stadt",15 - 18 Jahre,170,90,80
False,8337097,"St. Blasien, Stadt",18 - 20 Jahre,131,71,60
False,8337097,"St. Blasien, Stadt",20 - 25 Jahre,237,119,118
False,8337097,"St. Blasien, Stadt",25 - 30 Jahre,241,120,121
False,8337097,"St. Blasien, Stadt",30 - 35 Jahre,291,173,118
False,8337097,"St. Blasien, Stadt",35 - 40 Jahre,370,256,114
False,8337097,"St. Blasien, Stadt",40 - 45 Jahre,245,105,140
False,8337097,"St. Blasien, Stadt",45 - 50 Jahre,280,143,137
False,8337097,"St. Blasien, Stadt",50 - 55 Jahre,259,119,140
False,8337097,"St. Blasien, Stadt",55 - 60 Jahre,268,134,134
False,8337097,"St. Blasien, Stadt",60 - 65 Jahre,201,94,107
False,8337097,"St. Blasien, Stadt",65 - 75 Jahre,458,210,248
False,8337097,"St. Blasien, Stadt",75 und mehr Jahre,394,136,258
False,8337097,"St. Blasien, Stadt",Insgesamt,4067,2033,2034
False,8337106,"Stühlingen, Stadt",unter 3 Jahre,138,74,64
False,8337106,"Stühlingen, Stadt",3 -  6 Jahre,179,95,84
False,8337106,"Stühlingen, Stadt",6 - 10 Jahre,261,124,137
False,8337106,"Stühlingen, Stadt",10 - 15 Jahre,337,161,176
False,8337106,"Stühlingen, Stadt",15 - 18 Jahre,230,124,106
False,8337106,"Stühlingen, Stadt",18 - 20 Jahre,147,75,72
False,8337106,"Stühlingen, Stadt",20 - 25 Jahre,272,139,133
False,8337106,"Stühlingen, Stadt",25 - 30 Jahre,283,138,145
False,8337106,"Stühlingen, Stadt",30 - 35 Jahre,310,158,152
False,8337106,"Stühlingen, Stadt",35 - 40 Jahre,420,209,211
False,8337106,"Stühlingen, Stadt",40 - 45 Jahre,472,241,231
False,8337106,"Stühlingen, Stadt",45 - 50 Jahre,417,219,198
False,8337106,"Stühlingen, Stadt",50 - 55 Jahre,358,202,156
False,8337106,"Stühlingen, Stadt",55 - 60 Jahre,279,139,140
False,8337106,"Stühlingen, Stadt",60 - 65 Jahre,222,116,106
False,8337106,"Stühlingen, Stadt",65 - 75 Jahre,545,275,270
False,8337106,"Stühlingen, Stadt",75 und mehr Jahre,413,142,271
False,8337106,"Stühlingen, Stadt",Insgesamt,5283,2631,2652
False,8337108,Todtmoos,unter 3 Jahre,46,22,24
False,8337108,Todtmoos,3 -  6 Jahre,48,23,25
False,8337108,Todtmoos,6 - 10 Jahre,72,38,34
False,8337108,Todtmoos,10 - 15 Jahre,104,50,54
False,8337108,Todtmoos,15 - 18 Jahre,77,37,40
False,8337108,Todtmoos,18 - 20 Jahre,73,41,32
False,8337108,Todtmoos,20 - 25 Jahre,105,52,53
False,8337108,Todtmoos,25 - 30 Jahre,100,48,52
False,8337108,Todtmoos,30 - 35 Jahre,106,51,55
False,8337108,Todtmoos,35 - 40 Jahre,129,61,68
False,8337108,Todtmoos,40 - 45 Jahre,216,97,119
False,8337108,Todtmoos,45 - 50 Jahre,166,92,74
False,8337108,Todtmoos,50 - 55 Jahre,156,61,95
False,8337108,Todtmoos,55 - 60 Jahre,145,80,65
False,8337108,Todtmoos,60 - 65 Jahre,122,68,54
False,8337108,Todtmoos,65 - 75 Jahre,236,105,131
False,8337108,Todtmoos,75 und mehr Jahre,165,58,107
False,8337108,Todtmoos,Insgesamt,2066,984,1082
False,8337116,"Wehr, Stadt",unter 3 Jahre,328,167,161
False,8337116,"Wehr, Stadt",3 -  6 Jahre,340,170,170
False,8337116,"Wehr, Stadt",6 - 10 Jahre,537,270,267
False,8337116,"Wehr, Stadt",10 - 15 Jahre,780,394,386
False,8337116,"Wehr, Stadt",15 - 18 Jahre,516,246,270
False,8337116,"Wehr, Stadt",18 - 20 Jahre,332,149,183
False,8337116,"Wehr, Stadt",20 - 25 Jahre,664,322,342
False,8337116,"Wehr, Stadt",25 - 30 Jahre,652,320,332
False,8337116,"Wehr, Stadt",30 - 35 Jahre,800,377,423
False,8337116,"Wehr, Stadt",35 - 40 Jahre,1009,502,507
False,8337116,"Wehr, Stadt",40 - 45 Jahre,1152,601,551
False,8337116,"Wehr, Stadt",45 - 50 Jahre,980,480,500
False,8337116,"Wehr, Stadt",50 - 55 Jahre,886,433,453
False,8337116,"Wehr, Stadt",55 - 60 Jahre,728,364,364
False,8337116,"Wehr, Stadt",60 - 65 Jahre,730,352,378
False,8337116,"Wehr, Stadt",65 - 75 Jahre,1541,735,806
False,8337116,"Wehr, Stadt",75 und mehr Jahre,1015,357,658
False,8337116,"Wehr, Stadt",Insgesamt,12990,6239,6751
False,8337118,Weilheim,unter 3 Jahre,81,44,37
False,8337118,Weilheim,3 -  6 Jahre,114,63,51
False,8337118,Weilheim,6 - 10 Jahre,148,70,78
False,8337118,Weilheim,10 - 15 Jahre,255,120,135
False,8337118,Weilheim,15 - 18 Jahre,142,65,77
False,8337118,Weilheim,18 - 20 Jahre,76,41,35
False,8337118,Weilheim,20 - 25 Jahre,183,99,84
False,8337118,Weilheim,25 - 30 Jahre,141,65,76
False,8337118,Weilheim,30 - 35 Jahre,156,70,86
False,8337118,Weilheim,35 - 40 Jahre,265,125,140
False,8337118,Weilheim,40 - 45 Jahre,368,184,184
False,8337118,Weilheim,45 - 50 Jahre,264,147,117
False,8337118,Weilheim,50 - 55 Jahre,189,101,88
False,8337118,Weilheim,55 - 60 Jahre,148,83,65
False,8337118,Weilheim,60 - 65 Jahre,134,69,65
False,8337118,Weilheim,65 - 75 Jahre,311,150,161
False,8337118,Weilheim,75 und mehr Jahre,189,78,111
False,8337118,Weilheim,Insgesamt,3164,1574,1590
False,8337123,Wutöschingen,unter 3 Jahre,200,102,98
False,8337123,Wutöschingen,3 -  6 Jahre,243,137,106
False,8337123,Wutöschingen,6 - 10 Jahre,321,160,161
False,8337123,Wutöschingen,10 - 15 Jahre,439,241,198
False,8337123,Wutöschingen,15 - 18 Jahre,276,145,131
False,8337123,Wutöschingen,18 - 20 Jahre,167,75,92
False,8337123,Wutöschingen,20 - 25 Jahre,370,203,167
False,8337123,Wutöschingen,25 - 30 Jahre,387,195,192
False,8337123,Wutöschingen,30 - 35 Jahre,438,207,231
False,8337123,Wutöschingen,35 - 40 Jahre,560,279,281
False,8337123,Wutöschingen,40 - 45 Jahre,599,315,284
False,8337123,Wutöschingen,45 - 50 Jahre,454,228,226
False,8337123,Wutöschingen,50 - 55 Jahre,425,213,212
False,8337123,Wutöschingen,55 - 60 Jahre,366,179,187
False,8337123,Wutöschingen,60 - 65 Jahre,328,176,152
False,8337123,Wutöschingen,65 - 75 Jahre,650,330,320
False,8337123,Wutöschingen,75 und mehr Jahre,391,136,255
False,8337123,Wutöschingen,Insgesamt,6614,3321,3293
False,8337124,Eggingen,unter 3 Jahre,58,29,29
False,8337124,Eggingen,3 -  6 Jahre,62,31,31
False,8337124,Eggingen,6 - 10 Jahre,91,46,45
False,8337124,Eggingen,10 - 15 Jahre,132,67,65
False,8337124,Eggingen,15 - 18 Jahre,75,35,40
False,8337124,Eggingen,18 - 20 Jahre,56,36,20
False,8337124,Eggingen,20 - 25 Jahre,105,50,55
False,8337124,Eggingen,25 - 30 Jahre,114,58,56
False,8337124,Eggingen,30 - 35 Jahre,85,34,51
False,8337124,Eggingen,35 - 40 Jahre,139,64,75
False,8337124,Eggingen,40 - 45 Jahre,150,80,70
False,8337124,Eggingen,45 - 50 Jahre,144,71,73
False,8337124,Eggingen,50 - 55 Jahre,111,63,48
False,8337124,Eggingen,55 - 60 Jahre,95,46,49
False,8337124,Eggingen,60 - 65 Jahre,75,40,35
False,8337124,Eggingen,65 - 75 Jahre,147,75,72
False,8337124,Eggingen,75 und mehr Jahre,103,36,67
False,8337124,Eggingen,Insgesamt,1742,861,881
False,8337125,Küssaberg,unter 3 Jahre,141,70,71
False,8337125,Küssaberg,3 -  6 Jahre,165,86,79
False,8337125,Küssaberg,6 - 10 Jahre,267,136,131
False,8337125,Küssaberg,10 - 15 Jahre,312,156,156
False,8337125,Küssaberg,15 - 18 Jahre,193,109,84
False,8337125,Küssaberg,18 - 20 Jahre,119,71,48
False,8337125,Küssaberg,20 - 25 Jahre,290,145,145
False,8337125,Küssaberg,25 - 30 Jahre,280,139,141
False,8337125,Küssaberg,30 - 35 Jahre,306,146,160
False,8337125,Küssaberg,35 - 40 Jahre,521,254,267
False,8337125,Küssaberg,40 - 45 Jahre,510,284,226
False,8337125,Küssaberg,45 - 50 Jahre,452,233,219
False,8337125,Küssaberg,50 - 55 Jahre,338,159,179
False,8337125,Küssaberg,55 - 60 Jahre,312,144,168
False,8337125,Küssaberg,60 - 65 Jahre,285,142,143
False,8337125,Küssaberg,65 - 75 Jahre,582,294,288
False,8337125,Küssaberg,75 und mehr Jahre,418,158,260
False,8337125,Küssaberg,Insgesamt,5491,2726,2765
False,8337126,"Waldshut-Tiengen, Stadt",unter 3 Jahre,658,358,300
False,8337126,"Waldshut-Tiengen, Stadt",3 -  6 Jahre,644,338,306
False,8337126,"Waldshut-Tiengen, Stadt",6 - 10 Jahre,855,424,431
False,8337126,"Waldshut-Tiengen, Stadt",10 - 15 Jahre,1260,650,610
False,8337126,"Waldshut-Tiengen, Stadt",15 - 18 Jahre,826,414,412
False,8337126,"Waldshut-Tiengen, Stadt",18 - 20 Jahre,573,303,270
False,8337126,"Waldshut-Tiengen, Stadt",20 - 25 Jahre,1368,685,683
False,8337126,"Waldshut-Tiengen, Stadt",25 - 30 Jahre,1274,636,638
False,8337126,"Waldshut-Tiengen, Stadt",30 - 35 Jahre,1341,654,687
False,8337126,"Waldshut-Tiengen, Stadt",35 - 40 Jahre,1621,778,843
False,8337126,"Waldshut-Tiengen, Stadt",40 - 45 Jahre,1827,941,886
False,8337126,"Waldshut-Tiengen, Stadt",45 - 50 Jahre,1677,861,816
False,8337126,"Waldshut-Tiengen, Stadt",50 - 55 Jahre,1648,788,860
False,8337126,"Waldshut-Tiengen, Stadt",55 - 60 Jahre,1350,696,654
False,8337126,"Waldshut-Tiengen, Stadt",60 - 65 Jahre,1143,573,570
False,8337126,"Waldshut-Tiengen, Stadt",65 - 75 Jahre,2410,1112,1298
False,8337126,"Waldshut-Tiengen, Stadt",75 und mehr Jahre,2195,732,1463
False,8337126,"Waldshut-Tiengen, Stadt",Insgesamt,22670,10943,11727
False,8337127,Wutach,unter 3 Jahre,43,25,18
False,8337127,Wutach,3 -  6 Jahre,38,13,25
False,8337127,Wutach,6 - 10 Jahre,81,30,51
False,8337127,Wutach,10 - 15 Jahre,84,40,44
False,8337127,Wutach,15 - 18 Jahre,56,21,35
False,8337127,Wutach,18 - 20 Jahre,23,12,11
False,8337127,Wutach,20 - 25 Jahre,66,36,30
False,8337127,Wutach,25 - 30 Jahre,66,35,31
False,8337127,Wutach,30 - 35 Jahre,78,38,40
False,8337127,Wutach,35 - 40 Jahre,87,50,37
False,8337127,Wutach,40 - 45 Jahre,119,65,54
False,8337127,Wutach,45 - 50 Jahre,83,49,34
False,8337127,Wutach,50 - 55 Jahre,68,34,34
False,8337127,Wutach,55 - 60 Jahre,58,33,25
False,8337127,Wutach,60 - 65 Jahre,46,19,27
False,8337127,Wutach,65 - 75 Jahre,158,84,74
False,8337127,Wutach,75 und mehr Jahre,94,34,60
False,8337127,Wutach,Insgesamt,1248,618,630
False,8337128,Ühlingen-Birkendorf,unter 3 Jahre,155,79,76
False,8337128,Ühlingen-Birkendorf,3 -  6 Jahre,186,101,85
False,8337128,Ühlingen-Birkendorf,6 - 10 Jahre,269,143,126
False,8337128,Ühlingen-Birkendorf,10 - 15 Jahre,346,190,156
False,8337128,Ühlingen-Birkendorf,15 - 18 Jahre,241,131,110
False,8337128,Ühlingen-Birkendorf,18 - 20 Jahre,136,68,68
False,8337128,Ühlingen-Birkendorf,20 - 25 Jahre,315,161,154
False,8337128,Ühlingen-Birkendorf,25 - 30 Jahre,245,131,114
False,8337128,Ühlingen-Birkendorf,30 - 35 Jahre,300,158,142
False,8337128,Ühlingen-Birkendorf,35 - 40 Jahre,381,185,196
False,8337128,Ühlingen-Birkendorf,40 - 45 Jahre,437,221,216
False,8337128,Ühlingen-Birkendorf,45 - 50 Jahre,377,215,162
False,8337128,Ühlingen-Birkendorf,50 - 55 Jahre,290,150,140
False,8337128,Ühlingen-Birkendorf,55 - 60 Jahre,276,148,128
False,8337128,Ühlingen-Birkendorf,60 - 65 Jahre,274,144,130
False,8337128,Ühlingen-Birkendorf,65 - 75 Jahre,548,264,284
False,8337128,Ühlingen-Birkendorf,75 und mehr Jahre,440,178,262
False,8337128,Ühlingen-Birkendorf,Insgesamt,5216,2667,2549
False,84,Regierungsbezirk Tübingen,unter 3 Jahre,50144,25839,24305
False,84,Regierungsbezirk Tübingen,3 -  6 Jahre,54836,28157,26679
False,84,Regierungsbezirk Tübingen,6 - 10 Jahre,81798,41847,39951
False,84,Regierungsbezirk Tübingen,10 - 15 Jahre,106775,54788,51987
False,84,Regierungsbezirk Tübingen,15 - 18 Jahre,69406,35420,33986
False,84,Regierungsbezirk Tübingen,18 - 20 Jahre,44732,22935,21797
False,84,Regierungsbezirk Tübingen,20 - 25 Jahre,109623,55248,54375
False,84,Regierungsbezirk Tübingen,25 - 30 Jahre,106173,53661,52512
False,84,Regierungsbezirk Tübingen,30 - 35 Jahre,112496,56611,55885
False,84,Regierungsbezirk Tübingen,35 - 40 Jahre,149258,76421,72837
False,84,Regierungsbezirk Tübingen,40 - 45 Jahre,158420,81321,77099
False,84,Regierungsbezirk Tübingen,45 - 50 Jahre,138662,70463,68199
False,84,Regierungsbezirk Tübingen,50 - 55 Jahre,116206,58226,57980
False,84,Regierungsbezirk Tübingen,55 - 60 Jahre,99680,50428,49252
False,84,Regierungsbezirk Tübingen,60 - 65 Jahre,91214,45292,45922
False,84,Regierungsbezirk Tübingen,65 - 75 Jahre,180564,85949,94615
False,84,Regierungsbezirk Tübingen,75 und mehr Jahre,135159,46813,88346
False,84,Regierungsbezirk Tübingen,Insgesamt,1805146,889419,915727
False,8415,Landkreis Reutlingen,unter 3 Jahre,7751,3964,3787
False,8415,Landkreis Reutlingen,3 -  6 Jahre,8444,4432,4012
False,8415,Landkreis Reutlingen,6 - 10 Jahre,12461,6394,6067
False,8415,Landkreis Reutlingen,10 - 15 Jahre,16222,8316,7906
False,8415,Landkreis Reutlingen,15 - 18 Jahre,10430,5266,5164
False,8415,Landkreis Reutlingen,18 - 20 Jahre,6697,3414,3283
False,8415,Landkreis Reutlingen,20 - 25 Jahre,16555,8313,8242
False,8415,Landkreis Reutlingen,25 - 30 Jahre,16029,7953,8076
False,8415,Landkreis Reutlingen,30 - 35 Jahre,17585,8873,8712
False,8415,Landkreis Reutlingen,35 - 40 Jahre,23485,11954,11531
False,8415,Landkreis Reutlingen,40 - 45 Jahre,24815,12624,12191
False,8415,Landkreis Reutlingen,45 - 50 Jahre,21788,11129,10659
False,8415,Landkreis Reutlingen,50 - 55 Jahre,18099,8982,9117
False,8415,Landkreis Reutlingen,55 - 60 Jahre,15529,7722,7807
False,8415,Landkreis Reutlingen,60 - 65 Jahre,14691,7186,7505
False,8415,Landkreis Reutlingen,65 - 75 Jahre,30005,14110,15895
False,8415,Landkreis Reutlingen,75 und mehr Jahre,21463,7388,14075
False,8415,Landkreis Reutlingen,Insgesamt,282049,138020,144029
False,8415014,Dettingen an der Erms,unter 3 Jahre,260,121,139
False,8415014,Dettingen an der Erms,3 -  6 Jahre,284,137,147
False,8415014,Dettingen an der Erms,6 - 10 Jahre,411,218,193
False,8415014,Dettingen an der Erms,10 - 15 Jahre,527,258,269
False,8415014,Dettingen an der Erms,15 - 18 Jahre,339,176,163
False,8415014,Dettingen an der Erms,18 - 20 Jahre,222,117,105
False,8415014,Dettingen an der Erms,20 - 25 Jahre,521,281,240
False,8415014,Dettingen an der Erms,25 - 30 Jahre,504,251,253
False,8415014,Dettingen an der Erms,30 - 35 Jahre,531,272,259
False,8415014,Dettingen an der Erms,35 - 40 Jahre,804,389,415
False,8415014,Dettingen an der Erms,40 - 45 Jahre,828,433,395
False,8415014,Dettingen an der Erms,45 - 50 Jahre,715,376,339
False,8415014,Dettingen an der Erms,50 - 55 Jahre,536,289,247
False,8415014,Dettingen an der Erms,55 - 60 Jahre,512,258,254
False,8415014,Dettingen an der Erms,60 - 65 Jahre,511,255,256
False,8415014,Dettingen an der Erms,65 - 75 Jahre,1015,482,533
False,8415014,Dettingen an der Erms,75 und mehr Jahre,732,237,495
False,8415014,Dettingen an der Erms,Insgesamt,9252,4550,4702
False,8415019,Eningen unter Achalm,unter 3 Jahre,288,130,158
False,8415019,Eningen unter Achalm,3 -  6 Jahre,307,159,148
False,8415019,Eningen unter Achalm,6 - 10 Jahre,516,250,266
False,8415019,Eningen unter Achalm,10 - 15 Jahre,583,301,282
False,8415019,Eningen unter Achalm,15 - 18 Jahre,342,154,188
False,8415019,Eningen unter Achalm,18 - 20 Jahre,232,111,121
False,8415019,Eningen unter Achalm,20 - 25 Jahre,618,322,296
False,8415019,Eningen unter Achalm,25 - 30 Jahre,587,274,313
False,8415019,Eningen unter Achalm,30 - 35 Jahre,671,350,321
False,8415019,Eningen unter Achalm,35 - 40 Jahre,953,466,487
False,8415019,Eningen unter Achalm,40 - 45 Jahre,965,502,463
False,8415019,Eningen unter Achalm,45 - 50 Jahre,831,444,387
False,8415019,Eningen unter Achalm,50 - 55 Jahre,682,330,352
False,8415019,Eningen unter Achalm,55 - 60 Jahre,645,314,331
False,8415019,Eningen unter Achalm,60 - 65 Jahre,602,300,302
False,8415019,Eningen unter Achalm,65 - 75 Jahre,1171,546,625
False,8415019,Eningen unter Achalm,75 und mehr Jahre,864,308,556
False,8415019,Eningen unter Achalm,Insgesamt,10857,5261,5596
False,8415027,Gomadingen,unter 3 Jahre,48,24,24
False,8415027,Gomadingen,3 -  6 Jahre,60,37,23
False,8415027,Gomadingen,6 - 10 Jahre,108,54,54
False,8415027,Gomadingen,10 - 15 Jahre,162,83,79
False,8415027,Gomadingen,15 - 18 Jahre,76,37,39
False,8415027,Gomadingen,18 - 20 Jahre,57,27,30
False,8415027,Gomadingen,20 - 25 Jahre,123,63,60
False,8415027,Gomadingen,25 - 30 Jahre,98,48,50
False,8415027,Gomadingen,30 - 35 Jahre,116,56,60
False,8415027,Gomadingen,35 - 40 Jahre,190,94,96
False,8415027,Gomadingen,40 - 45 Jahre,203,101,102
False,8415027,Gomadingen,45 - 50 Jahre,197,114,83
False,8415027,Gomadingen,50 - 55 Jahre,161,95,66
False,8415027,Gomadingen,55 - 60 Jahre,112,61,51
False,8415027,Gomadingen,60 - 65 Jahre,109,61,48
False,8415027,Gomadingen,65 - 75 Jahre,234,111,123
False,8415027,Gomadingen,75 und mehr Jahre,154,64,90
False,8415027,Gomadingen,Insgesamt,2208,1130,1078
False,8415028,Grabenstetten,unter 3 Jahre,48,25,23
False,8415028,Grabenstetten,3 -  6 Jahre,66,33,33
False,8415028,Grabenstetten,6 - 10 Jahre,78,38,40
False,8415028,Grabenstetten,10 - 15 Jahre,86,39,47
False,8415028,Grabenstetten,15 - 18 Jahre,76,41,35
False,8415028,Grabenstetten,18 - 20 Jahre,51,33,18
False,8415028,Grabenstetten,20 - 25 Jahre,89,54,35
False,8415028,Grabenstetten,25 - 30 Jahre,68,42,26
False,8415028,Grabenstetten,30 - 35 Jahre,89,49,40
False,8415028,Grabenstetten,35 - 40 Jahre,123,68,55
False,8415028,Grabenstetten,40 - 45 Jahre,126,59,67
False,8415028,Grabenstetten,45 - 50 Jahre,135,64,71
False,8415028,Grabenstetten,50 - 55 Jahre,128,63,65
False,8415028,Grabenstetten,55 - 60 Jahre,87,53,34
False,8415028,Grabenstetten,60 - 65 Jahre,51,25,26
False,8415028,Grabenstetten,65 - 75 Jahre,159,77,82
False,8415028,Grabenstetten,75 und mehr Jahre,116,51,65
False,8415028,Grabenstetten,Insgesamt,1576,814,762
False,8415029,Grafenberg,unter 3 Jahre,61,27,34
False,8415029,Grafenberg,3 -  6 Jahre,89,48,41
False,8415029,Grafenberg,6 - 10 Jahre,157,89,68
False,8415029,Grafenberg,10 - 15 Jahre,153,80,73
False,8415029,Grafenberg,15 - 18 Jahre,98,56,42
False,8415029,Grafenberg,18 - 20 Jahre,77,42,35
False,8415029,Grafenberg,20 - 25 Jahre,153,81,72
False,8415029,Grafenberg,25 - 30 Jahre,131,68,63
False,8415029,Grafenberg,30 - 35 Jahre,131,73,58
False,8415029,Grafenberg,35 - 40 Jahre,256,127,129
False,8415029,Grafenberg,40 - 45 Jahre,225,122,103
False,8415029,Grafenberg,45 - 50 Jahre,223,112,111
False,8415029,Grafenberg,50 - 55 Jahre,185,95,90
False,8415029,Grafenberg,55 - 60 Jahre,163,82,81
False,8415029,Grafenberg,60 - 65 Jahre,127,65,62
False,8415029,Grafenberg,65 - 75 Jahre,265,133,132
False,8415029,Grafenberg,75 und mehr Jahre,131,50,81
False,8415029,Grafenberg,Insgesamt,2625,1350,1275
False,8415034,"Hayingen, Stadt",unter 3 Jahre,77,39,38
False,8415034,"Hayingen, Stadt",3 -  6 Jahre,70,35,35
False,8415034,"Hayingen, Stadt",6 - 10 Jahre,103,56,47
False,8415034,"Hayingen, Stadt",10 - 15 Jahre,134,81,53
False,8415034,"Hayingen, Stadt",15 - 18 Jahre,97,50,47
False,8415034,"Hayingen, Stadt",18 - 20 Jahre,54,32,22
False,8415034,"Hayingen, Stadt",20 - 25 Jahre,138,52,86
False,8415034,"Hayingen, Stadt",25 - 30 Jahre,137,73,64
False,8415034,"Hayingen, Stadt",30 - 35 Jahre,148,87,61
False,8415034,"Hayingen, Stadt",35 - 40 Jahre,171,93,78
False,8415034,"Hayingen, Stadt",40 - 45 Jahre,186,93,93
False,8415034,"Hayingen, Stadt",45 - 50 Jahre,143,80,63
False,8415034,"Hayingen, Stadt",50 - 55 Jahre,116,54,62
False,8415034,"Hayingen, Stadt",55 - 60 Jahre,128,68,60
False,8415034,"Hayingen, Stadt",60 - 65 Jahre,119,68,51
False,8415034,"Hayingen, Stadt",65 - 75 Jahre,240,121,119
False,8415034,"Hayingen, Stadt",75 und mehr Jahre,163,62,101
False,8415034,"Hayingen, Stadt",Insgesamt,2224,1144,1080
False,8415039,Hülben,unter 3 Jahre,91,48,43
False,8415039,Hülben,3 -  6 Jahre,87,44,43
False,8415039,Hülben,6 - 10 Jahre,148,76,72
False,8415039,Hülben,10 - 15 Jahre,197,98,99
False,8415039,Hülben,15 - 18 Jahre,109,51,58
False,8415039,Hülben,18 - 20 Jahre,61,30,31
False,8415039,Hülben,20 - 25 Jahre,140,60,80
False,8415039,Hülben,25 - 30 Jahre,133,72,61
False,8415039,Hülben,30 - 35 Jahre,178,88,90
False,8415039,Hülben,35 - 40 Jahre,237,118,119
False,8415039,Hülben,40 - 45 Jahre,284,148,136
False,8415039,Hülben,45 - 50 Jahre,208,99,109
False,8415039,Hülben,50 - 55 Jahre,163,84,79
False,8415039,Hülben,55 - 60 Jahre,163,82,81
False,8415039,Hülben,60 - 65 Jahre,124,64,60
False,8415039,Hülben,65 - 75 Jahre,326,142,184
False,8415039,Hülben,75 und mehr Jahre,236,84,152
False,8415039,Hülben,Insgesamt,2885,1388,1497
False,8415048,Mehrstetten,unter 3 Jahre,38,19,19
False,8415048,Mehrstetten,3 -  6 Jahre,43,29,14
False,8415048,Mehrstetten,6 - 10 Jahre,78,38,40
False,8415048,Mehrstetten,10 - 15 Jahre,89,51,38
False,8415048,Mehrstetten,15 - 18 Jahre,65,31,34
False,8415048,Mehrstetten,18 - 20 Jahre,47,32,15
False,8415048,Mehrstetten,20 - 25 Jahre,99,50,49
False,8415048,Mehrstetten,25 - 30 Jahre,92,46,46
False,8415048,Mehrstetten,30 - 35 Jahre,76,43,33
False,8415048,Mehrstetten,35 - 40 Jahre,115,60,55
False,8415048,Mehrstetten,40 - 45 Jahre,143,78,65
False,8415048,Mehrstetten,45 - 50 Jahre,104,53,51
False,8415048,Mehrstetten,50 - 55 Jahre,104,47,57
False,8415048,Mehrstetten,55 - 60 Jahre,76,44,32
False,8415048,Mehrstetten,60 - 65 Jahre,55,24,31
False,8415048,Mehrstetten,65 - 75 Jahre,124,61,63
False,8415048,Mehrstetten,75 und mehr Jahre,98,35,63
False,8415048,Mehrstetten,Insgesamt,1446,741,705
False,8415050,"Metzingen, Stadt",unter 3 Jahre,602,303,299
False,8415050,"Metzingen, Stadt",3 -  6 Jahre,668,329,339
False,8415050,"Metzingen, Stadt",6 - 10 Jahre,882,457,425
False,8415050,"Metzingen, Stadt",10 - 15 Jahre,1215,592,623
False,8415050,"Metzingen, Stadt",15 - 18 Jahre,803,398,405
False,8415050,"Metzingen, Stadt",18 - 20 Jahre,512,261,251
False,8415050,"Metzingen, Stadt",20 - 25 Jahre,1220,597,623
False,8415050,"Metzingen, Stadt",25 - 30 Jahre,1269,617,652
False,8415050,"Metzingen, Stadt",30 - 35 Jahre,1417,724,693
False,8415050,"Metzingen, Stadt",35 - 40 Jahre,1685,846,839
False,8415050,"Metzingen, Stadt",40 - 45 Jahre,1814,952,862
False,8415050,"Metzingen, Stadt",45 - 50 Jahre,1621,786,835
False,8415050,"Metzingen, Stadt",50 - 55 Jahre,1376,660,716
False,8415050,"Metzingen, Stadt",55 - 60 Jahre,1229,606,623
False,8415050,"Metzingen, Stadt",60 - 65 Jahre,1152,565,587
False,8415050,"Metzingen, Stadt",65 - 75 Jahre,2626,1242,1384
False,8415050,"Metzingen, Stadt",75 und mehr Jahre,1892,648,1244
False,8415050,"Metzingen, Stadt",Insgesamt,21983,10583,11400
False,8415053,"Münsingen, Stadt",unter 3 Jahre,438,220,218
False,8415053,"Münsingen, Stadt",3 -  6 Jahre,506,266,240
False,8415053,"Münsingen, Stadt",6 - 10 Jahre,670,327,343
False,8415053,"Münsingen, Stadt",10 - 15 Jahre,898,436,462
False,8415053,"Münsingen, Stadt",15 - 18 Jahre,604,298,306
False,8415053,"Münsingen, Stadt",18 - 20 Jahre,380,191,189
False,8415053,"Münsingen, Stadt",20 - 25 Jahre,916,485,431
False,8415053,"Münsingen, Stadt",25 - 30 Jahre,752,404,348
False,8415053,"Münsingen, Stadt",30 - 35 Jahre,853,416,437
False,8415053,"Münsingen, Stadt",35 - 40 Jahre,1163,607,556
False,8415053,"Münsingen, Stadt",40 - 45 Jahre,1283,659,624
False,8415053,"Münsingen, Stadt",45 - 50 Jahre,1110,552,558
False,8415053,"Münsingen, Stadt",50 - 55 Jahre,926,462,464
False,8415053,"Münsingen, Stadt",55 - 60 Jahre,756,377,379
False,8415053,"Münsingen, Stadt",60 - 65 Jahre,682,324,358
False,8415053,"Münsingen, Stadt",65 - 75 Jahre,1545,709,836
False,8415053,"Münsingen, Stadt",75 und mehr Jahre,1100,354,746
False,8415053,"Münsingen, Stadt",Insgesamt,14582,7087,7495
False,8415058,Pfronstetten,unter 3 Jahre,50,27,23
False,8415058,Pfronstetten,3 -  6 Jahre,57,29,28
False,8415058,Pfronstetten,6 - 10 Jahre,75,45,30
False,8415058,Pfronstetten,10 - 15 Jahre,114,65,49
False,8415058,Pfronstetten,15 - 18 Jahre,74,47,27
False,8415058,Pfronstetten,18 - 20 Jahre,49,21,28
False,8415058,Pfronstetten,20 - 25 Jahre,89,48,41
False,8415058,Pfronstetten,25 - 30 Jahre,77,37,40
False,8415058,Pfronstetten,30 - 35 Jahre,103,58,45
False,8415058,Pfronstetten,35 - 40 Jahre,127,58,69
False,8415058,Pfronstetten,40 - 45 Jahre,135,77,58
False,8415058,Pfronstetten,45 - 50 Jahre,106,61,45
False,8415058,Pfronstetten,50 - 55 Jahre,105,59,46
False,8415058,Pfronstetten,55 - 60 Jahre,62,35,27
False,8415058,Pfronstetten,60 - 65 Jahre,64,34,30
False,8415058,Pfronstetten,65 - 75 Jahre,144,79,65
False,8415058,Pfronstetten,75 und mehr Jahre,136,46,90
False,8415058,Pfronstetten,Insgesamt,1567,826,741
False,8415059,"Pfullingen, Stadt",unter 3 Jahre,520,260,260
False,8415059,"Pfullingen, Stadt",3 -  6 Jahre,549,297,252
False,8415059,"Pfullingen, Stadt",6 - 10 Jahre,825,415,410
False,8415059,"Pfullingen, Stadt",10 - 15 Jahre,1001,493,508
False,8415059,"Pfullingen, Stadt",15 - 18 Jahre,635,306,329
False,8415059,"Pfullingen, Stadt",18 - 20 Jahre,394,204,190
False,8415059,"Pfullingen, Stadt",20 - 25 Jahre,1046,535,511
False,8415059,"Pfullingen, Stadt",25 - 30 Jahre,1058,521,537
False,8415059,"Pfullingen, Stadt",30 - 35 Jahre,1092,557,535
False,8415059,"Pfullingen, Stadt",35 - 40 Jahre,1496,755,741
False,8415059,"Pfullingen, Stadt",40 - 45 Jahre,1639,844,795
False,8415059,"Pfullingen, Stadt",45 - 50 Jahre,1450,741,709
False,8415059,"Pfullingen, Stadt",50 - 55 Jahre,1126,519,607
False,8415059,"Pfullingen, Stadt",55 - 60 Jahre,1011,491,520
False,8415059,"Pfullingen, Stadt",60 - 65 Jahre,1027,487,540
False,8415059,"Pfullingen, Stadt",65 - 75 Jahre,2027,947,1080
False,8415059,"Pfullingen, Stadt",75 und mehr Jahre,1413,482,931
False,8415059,"Pfullingen, Stadt",Insgesamt,18309,8854,9455
False,8415060,Pliezhausen,unter 3 Jahre,259,136,123
False,8415060,Pliezhausen,3 -  6 Jahre,300,160,140
False,8415060,Pliezhausen,6 - 10 Jahre,509,263,246
False,8415060,Pliezhausen,10 - 15 Jahre,596,303,293
False,8415060,Pliezhausen,15 - 18 Jahre,383,196,187
False,8415060,Pliezhausen,18 - 20 Jahre,210,124,86
False,8415060,Pliezhausen,20 - 25 Jahre,539,292,247
False,8415060,Pliezhausen,25 - 30 Jahre,528,266,262
False,8415060,Pliezhausen,30 - 35 Jahre,570,274,296
False,8415060,Pliezhausen,35 - 40 Jahre,861,435,426
False,8415060,Pliezhausen,40 - 45 Jahre,971,472,499
False,8415060,Pliezhausen,45 - 50 Jahre,771,381,390
False,8415060,Pliezhausen,50 - 55 Jahre,574,299,275
False,8415060,Pliezhausen,55 - 60 Jahre,558,281,277
False,8415060,Pliezhausen,60 - 65 Jahre,497,258,239
False,8415060,Pliezhausen,65 - 75 Jahre,876,429,447
False,8415060,Pliezhausen,75 und mehr Jahre,534,185,349
False,8415060,Pliezhausen,Insgesamt,9536,4754,4782
False,8415061,"Reutlingen, Stadt",unter 3 Jahre,2916,1535,1381
False,8415061,"Reutlingen, Stadt",3 -  6 Jahre,3147,1658,1489
False,8415061,"Reutlingen, Stadt",6 - 10 Jahre,4533,2334,2199
False,8415061,"Reutlingen, Stadt",10 - 15 Jahre,5966,3114,2852
False,8415061,"Reutlingen, Stadt",15 - 18 Jahre,3810,1952,1858
False,8415061,"Reutlingen, Stadt",18 - 20 Jahre,2656,1323,1333
False,8415061,"Reutlingen, Stadt",20 - 25 Jahre,7012,3453,3559
False,8415061,"Reutlingen, Stadt",25 - 30 Jahre,6925,3366,3559
False,8415061,"Reutlingen, Stadt",30 - 35 Jahre,7404,3754,3650
False,8415061,"Reutlingen, Stadt",35 - 40 Jahre,9390,4842,4548
False,8415061,"Reutlingen, Stadt",40 - 45 Jahre,9687,4866,4821
False,8415061,"Reutlingen, Stadt",45 - 50 Jahre,8561,4335,4226
False,8415061,"Reutlingen, Stadt",50 - 55 Jahre,7292,3608,3684
False,8415061,"Reutlingen, Stadt",55 - 60 Jahre,6130,2957,3173
False,8415061,"Reutlingen, Stadt",60 - 65 Jahre,6096,2957,3139
False,8415061,"Reutlingen, Stadt",65 - 75 Jahre,11834,5514,6320
False,8415061,"Reutlingen, Stadt",75 und mehr Jahre,8893,3031,5862
False,8415061,"Reutlingen, Stadt",Insgesamt,112252,54599,57653
False,8415062,Riederich,unter 3 Jahre,131,61,70
False,8415062,Riederich,3 -  6 Jahre,121,67,54
False,8415062,Riederich,6 - 10 Jahre,189,97,92
False,8415062,Riederich,10 - 15 Jahre,225,101,124
False,8415062,Riederich,15 - 18 Jahre,152,80,72
False,8415062,Riederich,18 - 20 Jahre,110,55,55
False,8415062,Riederich,20 - 25 Jahre,229,122,107
False,8415062,Riederich,25 - 30 Jahre,239,118,121
False,8415062,Riederich,30 - 35 Jahre,282,128,154
False,8415062,Riederich,35 - 40 Jahre,406,213,193
False,8415062,Riederich,40 - 45 Jahre,363,187,176
False,8415062,Riederich,45 - 50 Jahre,350,177,173
False,8415062,Riederich,50 - 55 Jahre,288,129,159
False,8415062,Riederich,55 - 60 Jahre,280,147,133
False,8415062,Riederich,60 - 65 Jahre,258,119,139
False,8415062,Riederich,65 - 75 Jahre,462,225,237
False,8415062,Riederich,75 und mehr Jahre,234,91,143
False,8415062,Riederich,Insgesamt,4319,2117,2202
False,8415073,"Trochtelfingen, Stadt",unter 3 Jahre,188,98,90
False,8415073,"Trochtelfingen, Stadt",3 -  6 Jahre,219,125,94
False,8415073,"Trochtelfingen, Stadt",6 - 10 Jahre,322,171,151
False,8415073,"Trochtelfingen, Stadt",10 - 15 Jahre,474,246,228
False,8415073,"Trochtelfingen, Stadt",15 - 18 Jahre,271,135,136
False,8415073,"Trochtelfingen, Stadt",18 - 20 Jahre,165,84,81
False,8415073,"Trochtelfingen, Stadt",20 - 25 Jahre,320,145,175
False,8415073,"Trochtelfingen, Stadt",25 - 30 Jahre,386,198,188
False,8415073,"Trochtelfingen, Stadt",30 - 35 Jahre,388,195,193
False,8415073,"Trochtelfingen, Stadt",35 - 40 Jahre,585,319,266
False,8415073,"Trochtelfingen, Stadt",40 - 45 Jahre,562,287,275
False,8415073,"Trochtelfingen, Stadt",45 - 50 Jahre,538,289,249
False,8415073,"Trochtelfingen, Stadt",50 - 55 Jahre,419,211,208
False,8415073,"Trochtelfingen, Stadt",55 - 60 Jahre,354,171,183
False,8415073,"Trochtelfingen, Stadt",60 - 65 Jahre,321,163,158
False,8415073,"Trochtelfingen, Stadt",65 - 75 Jahre,635,312,323
False,8415073,"Trochtelfingen, Stadt",75 und mehr Jahre,477,148,329
False,8415073,"Trochtelfingen, Stadt",Insgesamt,6624,3297,3327
False,8415078,"Bad Urach, Stadt",unter 3 Jahre,334,162,172
False,8415078,"Bad Urach, Stadt",3 -  6 Jahre,358,186,172
False,8415078,"Bad Urach, Stadt",6 - 10 Jahre,530,285,245
False,8415078,"Bad Urach, Stadt",10 - 15 Jahre,743,382,361
False,8415078,"Bad Urach, Stadt",15 - 18 Jahre,523,261,262
False,8415078,"Bad Urach, Stadt",18 - 20 Jahre,301,151,150
False,8415078,"Bad Urach, Stadt",20 - 25 Jahre,725,367,358
False,8415078,"Bad Urach, Stadt",25 - 30 Jahre,681,341,340
False,8415078,"Bad Urach, Stadt",30 - 35 Jahre,732,358,374
False,8415078,"Bad Urach, Stadt",35 - 40 Jahre,998,520,478
False,8415078,"Bad Urach, Stadt",40 - 45 Jahre,1071,521,550
False,8415078,"Bad Urach, Stadt",45 - 50 Jahre,951,503,448
False,8415078,"Bad Urach, Stadt",50 - 55 Jahre,848,405,443
False,8415078,"Bad Urach, Stadt",55 - 60 Jahre,741,394,347
False,8415078,"Bad Urach, Stadt",60 - 65 Jahre,696,345,351
False,8415078,"Bad Urach, Stadt",65 - 75 Jahre,1457,662,795
False,8415078,"Bad Urach, Stadt",75 und mehr Jahre,1043,363,680
False,8415078,"Bad Urach, Stadt",Insgesamt,12732,6206,6526
False,8415080,Wannweil,unter 3 Jahre,164,88,76
False,8415080,Wannweil,3 -  6 Jahre,135,75,60
False,8415080,Wannweil,6 - 10 Jahre,254,124,130
False,8415080,Wannweil,10 - 15 Jahre,304,153,151
False,8415080,Wannweil,15 - 18 Jahre,175,81,94
False,8415080,Wannweil,18 - 20 Jahre,98,51,47
False,8415080,Wannweil,20 - 25 Jahre,268,134,134
False,8415080,Wannweil,25 - 30 Jahre,251,125,126
False,8415080,Wannweil,30 - 35 Jahre,343,180,163
False,8415080,Wannweil,35 - 40 Jahre,431,217,214
False,8415080,Wannweil,40 - 45 Jahre,469,222,247
False,8415080,Wannweil,45 - 50 Jahre,427,219,208
False,8415080,Wannweil,50 - 55 Jahre,329,167,162
False,8415080,Wannweil,55 - 60 Jahre,287,141,146
False,8415080,Wannweil,60 - 65 Jahre,259,135,124
False,8415080,Wannweil,65 - 75 Jahre,515,239,276
False,8415080,Wannweil,75 und mehr Jahre,405,141,264
False,8415080,Wannweil,Insgesamt,5114,2492,2622
False,8415085,Zwiefalten,unter 3 Jahre,63,31,32
False,8415085,Zwiefalten,3 -  6 Jahre,54,31,23
False,8415085,Zwiefalten,6 - 10 Jahre,96,48,48
False,8415085,Zwiefalten,10 - 15 Jahre,134,78,56
False,8415085,Zwiefalten,15 - 18 Jahre,94,45,49
False,8415085,Zwiefalten,18 - 20 Jahre,57,32,25
False,8415085,Zwiefalten,20 - 25 Jahre,121,71,50
False,8415085,Zwiefalten,25 - 30 Jahre,111,60,51
False,8415085,Zwiefalten,30 - 35 Jahre,127,67,60
False,8415085,Zwiefalten,35 - 40 Jahre,151,77,74
False,8415085,Zwiefalten,40 - 45 Jahre,201,112,89
False,8415085,Zwiefalten,45 - 50 Jahre,157,78,79
False,8415085,Zwiefalten,50 - 55 Jahre,142,74,68
False,8415085,Zwiefalten,55 - 60 Jahre,118,71,47
False,8415085,Zwiefalten,60 - 65 Jahre,87,47,40
False,8415085,Zwiefalten,65 - 75 Jahre,253,114,139
False,8415085,Zwiefalten,75 und mehr Jahre,167,55,112
False,8415085,Zwiefalten,Insgesamt,2133,1091,1042
False,8415086,Gutsbezirk Münsingen,unter 3 Jahre,4,0,4
False,8415086,Gutsbezirk Münsingen,3 -  6 Jahre,3,0,3
False,8415086,Gutsbezirk Münsingen,6 - 10 Jahre,3,2,1
False,8415086,Gutsbezirk Münsingen,10 - 15 Jahre,6,4,2
False,8415086,Gutsbezirk Münsingen,15 - 18 Jahre,10,4,6
False,8415086,Gutsbezirk Münsingen,18 - 20 Jahre,6,2,4
False,8415086,Gutsbezirk Münsingen,20 - 25 Jahre,12,4,8
False,8415086,Gutsbezirk Münsingen,25 - 30 Jahre,23,11,12
False,8415086,Gutsbezirk Münsingen,30 - 35 Jahre,17,6,11
False,8415086,Gutsbezirk Münsingen,35 - 40 Jahre,24,10,14
False,8415086,Gutsbezirk Münsingen,40 - 45 Jahre,28,21,7
False,8415086,Gutsbezirk Münsingen,45 - 50 Jahre,21,10,11
False,8415086,Gutsbezirk Münsingen,50 - 55 Jahre,8,5,3
False,8415086,Gutsbezirk Münsingen,55 - 60 Jahre,14,6,8
False,8415086,Gutsbezirk Münsingen,60 - 65 Jahre,13,6,7
False,8415086,Gutsbezirk Münsingen,65 - 75 Jahre,20,12,8
False,8415086,Gutsbezirk Münsingen,75 und mehr Jahre,16,9,7
False,8415086,Gutsbezirk Münsingen,Insgesamt,228,112,116
False,8415087,Walddorfhäslach,unter 3 Jahre,139,76,63
False,8415087,Walddorfhäslach,3 -  6 Jahre,157,86,71
False,8415087,Walddorfhäslach,6 - 10 Jahre,246,122,124
False,8415087,Walddorfhäslach,10 - 15 Jahre,336,166,170
False,8415087,Walddorfhäslach,15 - 18 Jahre,228,115,113
False,8415087,Walddorfhäslach,18 - 20 Jahre,109,57,52
False,8415087,Walddorfhäslach,20 - 25 Jahre,292,145,147
False,8415087,Walddorfhäslach,25 - 30 Jahre,276,138,138
False,8415087,Walddorfhäslach,30 - 35 Jahre,270,121,149
False,8415087,Walddorfhäslach,35 - 40 Jahre,432,205,227
False,8415087,Walddorfhäslach,40 - 45 Jahre,475,258,217
False,8415087,Walddorfhäslach,45 - 50 Jahre,417,214,203
False,8415087,Walddorfhäslach,50 - 55 Jahre,349,177,172
False,8415087,Walddorfhäslach,55 - 60 Jahre,266,140,126
False,8415087,Walddorfhäslach,60 - 65 Jahre,217,111,106
False,8415087,Walddorfhäslach,65 - 75 Jahre,378,194,184
False,8415087,Walddorfhäslach,75 und mehr Jahre,211,71,140
False,8415087,Walddorfhäslach,Insgesamt,4798,2396,2402
False,8415088,Römerstein,unter 3 Jahre,111,45,66
False,8415088,Römerstein,3 -  6 Jahre,136,60,76
False,8415088,Römerstein,6 - 10 Jahre,230,117,113
False,8415088,Römerstein,10 - 15 Jahre,268,128,140
False,8415088,Römerstein,15 - 18 Jahre,148,74,74
False,8415088,Römerstein,18 - 20 Jahre,104,45,59
False,8415088,Römerstein,20 - 25 Jahre,194,100,94
False,8415088,Römerstein,25 - 30 Jahre,171,87,84
False,8415088,Römerstein,30 - 35 Jahre,237,123,114
False,8415088,Römerstein,35 - 40 Jahre,338,163,175
False,8415088,Römerstein,40 - 45 Jahre,335,169,166
False,8415088,Römerstein,45 - 50 Jahre,274,153,121
False,8415088,Römerstein,50 - 55 Jahre,240,124,116
False,8415088,Römerstein,55 - 60 Jahre,225,117,108
False,8415088,Römerstein,60 - 65 Jahre,170,81,89
False,8415088,Römerstein,65 - 75 Jahre,433,197,236
False,8415088,Römerstein,75 und mehr Jahre,297,109,188
False,8415088,Römerstein,Insgesamt,3911,1892,2019
False,8415089,Engstingen,unter 3 Jahre,171,94,77
False,8415089,Engstingen,3 -  6 Jahre,218,115,103
False,8415089,Engstingen,6 - 10 Jahre,289,141,148
False,8415089,Engstingen,10 - 15 Jahre,397,199,198
False,8415089,Engstingen,15 - 18 Jahre,260,128,132
False,8415089,Engstingen,18 - 20 Jahre,157,82,75
False,8415089,Engstingen,20 - 25 Jahre,316,152,164
False,8415089,Engstingen,25 - 30 Jahre,242,119,123
False,8415089,Engstingen,30 - 35 Jahre,289,149,140
False,8415089,Engstingen,35 - 40 Jahre,456,247,209
False,8415089,Engstingen,40 - 45 Jahre,531,272,259
False,8415089,Engstingen,45 - 50 Jahre,457,233,224
False,8415089,Engstingen,50 - 55 Jahre,348,174,174
False,8415089,Engstingen,55 - 60 Jahre,274,147,127
False,8415089,Engstingen,60 - 65 Jahre,240,119,121
False,8415089,Engstingen,65 - 75 Jahre,533,254,279
False,8415089,Engstingen,75 und mehr Jahre,341,111,230
False,8415089,Engstingen,Insgesamt,5519,2736,2783
False,8415090,Hohenstein,unter 3 Jahre,127,64,63
False,8415090,Hohenstein,3 -  6 Jahre,149,81,68
False,8415090,Hohenstein,6 - 10 Jahre,209,106,103
False,8415090,Hohenstein,10 - 15 Jahre,282,153,129
False,8415090,Hohenstein,15 - 18 Jahre,144,78,66
False,8415090,Hohenstein,18 - 20 Jahre,92,47,45
False,8415090,Hohenstein,20 - 25 Jahre,196,91,105
False,8415090,Hohenstein,25 - 30 Jahre,221,116,105
False,8415090,Hohenstein,30 - 35 Jahre,247,112,135
False,8415090,Hohenstein,35 - 40 Jahre,331,163,168
False,8415090,Hohenstein,40 - 45 Jahre,337,183,154
False,8415090,Hohenstein,45 - 50 Jahre,298,139,159
False,8415090,Hohenstein,50 - 55 Jahre,202,96,106
False,8415090,Hohenstein,55 - 60 Jahre,179,102,77
False,8415090,Hohenstein,60 - 65 Jahre,145,63,82
False,8415090,Hohenstein,65 - 75 Jahre,356,177,179
False,8415090,Hohenstein,75 und mehr Jahre,234,91,143
False,8415090,Hohenstein,Insgesamt,3749,1862,1887
False,8415091,Sonnenbühl,unter 3 Jahre,211,124,87
False,8415091,Sonnenbühl,3 -  6 Jahre,264,136,128
False,8415091,Sonnenbühl,6 - 10 Jahre,346,176,170
False,8415091,Sonnenbühl,10 - 15 Jahre,443,221,222
False,8415091,Sonnenbühl,15 - 18 Jahre,267,152,115
False,8415091,Sonnenbühl,18 - 20 Jahre,167,76,91
False,8415091,Sonnenbühl,20 - 25 Jahre,339,177,162
False,8415091,Sonnenbühl,25 - 30 Jahre,333,193,140
False,8415091,Sonnenbühl,30 - 35 Jahre,451,215,236
False,8415091,Sonnenbühl,35 - 40 Jahre,636,319,317
False,8415091,Sonnenbühl,40 - 45 Jahre,680,349,331
False,8415091,Sonnenbühl,45 - 50 Jahre,537,283,254
False,8415091,Sonnenbühl,50 - 55 Jahre,458,247,211
False,8415091,Sonnenbühl,55 - 60 Jahre,397,203,194
False,8415091,Sonnenbühl,60 - 65 Jahre,314,154,160
False,8415091,Sonnenbühl,65 - 75 Jahre,795,379,416
False,8415091,Sonnenbühl,75 und mehr Jahre,421,153,268
False,8415091,Sonnenbühl,Insgesamt,7059,3557,3502
False,8415092,Lichtenstein,unter 3 Jahre,267,140,127
False,8415092,Lichtenstein,3 -  6 Jahre,242,128,114
False,8415092,Lichtenstein,6 - 10 Jahre,402,215,187
False,8415092,Lichtenstein,10 - 15 Jahre,554,308,246
False,8415092,Lichtenstein,15 - 18 Jahre,402,194,208
False,8415092,Lichtenstein,18 - 20 Jahre,221,115,106
False,8415092,Lichtenstein,20 - 25 Jahre,558,282,276
False,8415092,Lichtenstein,25 - 30 Jahre,512,250,262
False,8415092,Lichtenstein,30 - 35 Jahre,544,280,264
False,8415092,Lichtenstein,35 - 40 Jahre,681,316,365
False,8415092,Lichtenstein,40 - 45 Jahre,772,382,390
False,8415092,Lichtenstein,45 - 50 Jahre,771,418,353
False,8415092,Lichtenstein,50 - 55 Jahre,649,320,329
False,8415092,Lichtenstein,55 - 60 Jahre,481,243,238
False,8415092,Lichtenstein,60 - 65 Jahre,481,223,258
False,8415092,Lichtenstein,65 - 75 Jahre,1017,483,534
False,8415092,Lichtenstein,75 und mehr Jahre,726,246,480
False,8415092,Lichtenstein,Insgesamt,9280,4543,4737
False,8415093,St. Johann,unter 3 Jahre,145,67,78
False,8415093,St. Johann,3 -  6 Jahre,155,81,74
False,8415093,St. Johann,6 - 10 Jahre,252,130,122
False,8415093,St. Johann,10 - 15 Jahre,335,183,152
False,8415093,St. Johann,15 - 18 Jahre,245,126,119
False,8415093,St. Johann,18 - 20 Jahre,108,69,39
False,8415093,St. Johann,20 - 25 Jahre,282,150,132
False,8415093,St. Johann,25 - 30 Jahre,224,112,112
False,8415093,St. Johann,30 - 35 Jahre,279,138,141
False,8415093,St. Johann,35 - 40 Jahre,445,227,218
False,8415093,St. Johann,40 - 45 Jahre,502,255,247
False,8415093,St. Johann,45 - 50 Jahre,415,215,200
False,8415093,St. Johann,50 - 55 Jahre,345,189,156
False,8415093,St. Johann,55 - 60 Jahre,281,131,150
False,8415093,St. Johann,60 - 65 Jahre,274,133,141
False,8415093,St. Johann,65 - 75 Jahre,565,269,296
False,8415093,St. Johann,75 und mehr Jahre,429,163,266
False,8415093,St. Johann,Insgesamt,5281,2638,2643
False,8416,Landkreis Tübingen,unter 3 Jahre,6153,3136,3017
False,8416,Landkreis Tübingen,3 -  6 Jahre,6500,3331,3169
False,8416,Landkreis Tübingen,6 - 10 Jahre,9438,4854,4584
False,8416,Landkreis Tübingen,10 - 15 Jahre,11922,6120,5802
False,8416,Landkreis Tübingen,15 - 18 Jahre,7816,3995,3821
False,8416,Landkreis Tübingen,18 - 20 Jahre,5046,2500,2546
False,8416,Landkreis Tübingen,20 - 25 Jahre,15921,7577,8344
False,8416,Landkreis Tübingen,25 - 30 Jahre,15264,7468,7796
False,8416,Landkreis Tübingen,30 - 35 Jahre,13696,6742,6954
False,8416,Landkreis Tübingen,35 - 40 Jahre,18269,9246,9023
False,8416,Landkreis Tübingen,40 - 45 Jahre,21466,11072,10394
False,8416,Landkreis Tübingen,45 - 50 Jahre,18476,9600,8876
False,8416,Landkreis Tübingen,50 - 55 Jahre,14170,7177,6993
False,8416,Landkreis Tübingen,55 - 60 Jahre,11078,5736,5342
False,8416,Landkreis Tübingen,60 - 65 Jahre,9473,4799,4674
False,8416,Landkreis Tübingen,65 - 75 Jahre,18291,8659,9632
False,8416,Landkreis Tübingen,75 und mehr Jahre,13498,4600,8898
False,8416,Landkreis Tübingen,Insgesamt,216477,106612,109865
False,8416006,Bodelshausen,unter 3 Jahre,181,95,86
False,8416006,Bodelshausen,3 -  6 Jahre,221,110,111
False,8416006,Bodelshausen,6 - 10 Jahre,258,128,130
False,8416006,Bodelshausen,10 - 15 Jahre,336,176,160
False,8416006,Bodelshausen,15 - 18 Jahre,242,132,110
False,8416006,Bodelshausen,18 - 20 Jahre,145,80,65
False,8416006,Bodelshausen,20 - 25 Jahre,367,198,169
False,8416006,Bodelshausen,25 - 30 Jahre,371,187,184
False,8416006,Bodelshausen,30 - 35 Jahre,398,192,206
False,8416006,Bodelshausen,35 - 40 Jahre,497,247,250
False,8416006,Bodelshausen,40 - 45 Jahre,476,251,225
False,8416006,Bodelshausen,45 - 50 Jahre,449,236,213
False,8416006,Bodelshausen,50 - 55 Jahre,415,193,222
False,8416006,Bodelshausen,55 - 60 Jahre,333,170,163
False,8416006,Bodelshausen,60 - 65 Jahre,299,154,145
False,8416006,Bodelshausen,65 - 75 Jahre,584,288,296
False,8416006,Bodelshausen,75 und mehr Jahre,364,126,238
False,8416006,Bodelshausen,Insgesamt,5936,2963,2973
False,8416009,Dettenhausen,unter 3 Jahre,155,83,72
False,8416009,Dettenhausen,3 -  6 Jahre,165,89,76
False,8416009,Dettenhausen,6 - 10 Jahre,235,116,119
False,8416009,Dettenhausen,10 - 15 Jahre,332,177,155
False,8416009,Dettenhausen,15 - 18 Jahre,193,107,86
False,8416009,Dettenhausen,18 - 20 Jahre,133,69,64
False,8416009,Dettenhausen,20 - 25 Jahre,316,177,139
False,8416009,Dettenhausen,25 - 30 Jahre,303,134,169
False,8416009,Dettenhausen,30 - 35 Jahre,299,133,166
False,8416009,Dettenhausen,35 - 40 Jahre,442,233,209
False,8416009,Dettenhausen,40 - 45 Jahre,487,237,250
False,8416009,Dettenhausen,45 - 50 Jahre,459,240,219
False,8416009,Dettenhausen,50 - 55 Jahre,346,177,169
False,8416009,Dettenhausen,55 - 60 Jahre,327,157,170
False,8416009,Dettenhausen,60 - 65 Jahre,346,177,169
False,8416009,Dettenhausen,65 - 75 Jahre,518,248,270
False,8416009,Dettenhausen,75 und mehr Jahre,336,120,216
False,8416009,Dettenhausen,Insgesamt,5392,2674,2718
False,8416011,Dußlingen,unter 3 Jahre,176,90,86
False,8416011,Dußlingen,3 -  6 Jahre,193,94,99
False,8416011,Dußlingen,6 - 10 Jahre,287,144,143
False,8416011,Dußlingen,10 - 15 Jahre,350,184,166
False,8416011,Dußlingen,15 - 18 Jahre,233,119,114
False,8416011,Dußlingen,18 - 20 Jahre,110,62,48
False,8416011,Dußlingen,20 - 25 Jahre,316,155,161
False,8416011,Dußlingen,25 - 30 Jahre,321,164,157
False,8416011,Dußlingen,30 - 35 Jahre,351,171,180
False,8416011,Dußlingen,35 - 40 Jahre,464,246,218
False,8416011,Dußlingen,40 - 45 Jahre,523,277,246
False,8416011,Dußlingen,45 - 50 Jahre,437,234,203
False,8416011,Dußlingen,50 - 55 Jahre,314,149,165
False,8416011,Dußlingen,55 - 60 Jahre,245,136,109
False,8416011,Dußlingen,60 - 65 Jahre,214,100,114
False,8416011,Dußlingen,65 - 75 Jahre,549,259,290
False,8416011,Dußlingen,75 und mehr Jahre,384,118,266
False,8416011,Dußlingen,Insgesamt,5467,2702,2765
False,8416015,Gomaringen,unter 3 Jahre,278,144,134
False,8416015,Gomaringen,3 -  6 Jahre,297,156,141
False,8416015,Gomaringen,6 - 10 Jahre,442,218,224
False,8416015,Gomaringen,10 - 15 Jahre,506,271,235
False,8416015,Gomaringen,15 - 18 Jahre,341,171,170
False,8416015,Gomaringen,18 - 20 Jahre,237,117,120
False,8416015,Gomaringen,20 - 25 Jahre,467,234,233
False,8416015,Gomaringen,25 - 30 Jahre,458,224,234
False,8416015,Gomaringen,30 - 35 Jahre,535,262,273
False,8416015,Gomaringen,35 - 40 Jahre,744,348,396
False,8416015,Gomaringen,40 - 45 Jahre,806,413,393
False,8416015,Gomaringen,45 - 50 Jahre,705,366,339
False,8416015,Gomaringen,50 - 55 Jahre,520,245,275
False,8416015,Gomaringen,55 - 60 Jahre,434,224,210
False,8416015,Gomaringen,60 - 65 Jahre,394,193,201
False,8416015,Gomaringen,65 - 75 Jahre,812,384,428
False,8416015,Gomaringen,75 und mehr Jahre,567,200,367
False,8416015,Gomaringen,Insgesamt,8543,4170,4373
False,8416018,Hirrlingen,unter 3 Jahre,75,33,42
False,8416018,Hirrlingen,3 -  6 Jahre,78,38,40
False,8416018,Hirrlingen,6 - 10 Jahre,178,105,73
False,8416018,Hirrlingen,10 - 15 Jahre,238,106,132
False,8416018,Hirrlingen,15 - 18 Jahre,158,76,82
False,8416018,Hirrlingen,18 - 20 Jahre,68,42,26
False,8416018,Hirrlingen,20 - 25 Jahre,158,81,77
False,8416018,Hirrlingen,25 - 30 Jahre,141,71,70
False,8416018,Hirrlingen,30 - 35 Jahre,170,87,83
False,8416018,Hirrlingen,35 - 40 Jahre,235,117,118
False,8416018,Hirrlingen,40 - 45 Jahre,313,173,140
False,8416018,Hirrlingen,45 - 50 Jahre,240,125,115
False,8416018,Hirrlingen,50 - 55 Jahre,200,97,103
False,8416018,Hirrlingen,55 - 60 Jahre,142,80,62
False,8416018,Hirrlingen,60 - 65 Jahre,80,41,39
False,8416018,Hirrlingen,65 - 75 Jahre,263,129,134
False,8416018,Hirrlingen,75 und mehr Jahre,195,64,131
False,8416018,Hirrlingen,Insgesamt,2932,1465,1467
False,8416022,Kirchentellinsfurt,unter 3 Jahre,185,82,103
False,8416022,Kirchentellinsfurt,3 -  6 Jahre,172,92,80
False,8416022,Kirchentellinsfurt,6 - 10 Jahre,248,117,131
False,8416022,Kirchentellinsfurt,10 - 15 Jahre,302,155,147
False,8416022,Kirchentellinsfurt,15 - 18 Jahre,195,106,89
False,8416022,Kirchentellinsfurt,18 - 20 Jahre,111,65,46
False,8416022,Kirchentellinsfurt,20 - 25 Jahre,356,182,174
False,8416022,Kirchentellinsfurt,25 - 30 Jahre,330,169,161
False,8416022,Kirchentellinsfurt,30 - 35 Jahre,314,153,161
False,8416022,Kirchentellinsfurt,35 - 40 Jahre,499,260,239
False,8416022,Kirchentellinsfurt,40 - 45 Jahre,523,272,251
False,8416022,Kirchentellinsfurt,45 - 50 Jahre,475,231,244
False,8416022,Kirchentellinsfurt,50 - 55 Jahre,383,194,189
False,8416022,Kirchentellinsfurt,55 - 60 Jahre,305,156,149
False,8416022,Kirchentellinsfurt,60 - 65 Jahre,295,147,148
False,8416022,Kirchentellinsfurt,65 - 75 Jahre,474,227,247
False,8416022,Kirchentellinsfurt,75 und mehr Jahre,330,119,211
False,8416022,Kirchentellinsfurt,Insgesamt,5497,2727,2770
False,8416023,Kusterdingen,unter 3 Jahre,237,111,126
False,8416023,Kusterdingen,3 -  6 Jahre,275,138,137
False,8416023,Kusterdingen,6 - 10 Jahre,406,206,200
False,8416023,Kusterdingen,10 - 15 Jahre,564,288,276
False,8416023,Kusterdingen,15 - 18 Jahre,325,181,144
False,8416023,Kusterdingen,18 - 20 Jahre,191,85,106
False,8416023,Kusterdingen,20 - 25 Jahre,467,226,241
False,8416023,Kusterdingen,25 - 30 Jahre,465,221,244
False,8416023,Kusterdingen,30 - 35 Jahre,469,230,239
False,8416023,Kusterdingen,35 - 40 Jahre,737,370,367
False,8416023,Kusterdingen,40 - 45 Jahre,822,392,430
False,8416023,Kusterdingen,45 - 50 Jahre,667,355,312
False,8416023,Kusterdingen,50 - 55 Jahre,546,300,246
False,8416023,Kusterdingen,55 - 60 Jahre,413,208,205
False,8416023,Kusterdingen,60 - 65 Jahre,358,170,188
False,8416023,Kusterdingen,65 - 75 Jahre,825,400,425
False,8416023,Kusterdingen,75 und mehr Jahre,474,180,294
False,8416023,Kusterdingen,Insgesamt,8241,4061,4180
False,8416025,"Mössingen, Stadt",unter 3 Jahre,557,300,257
False,8416025,"Mössingen, Stadt",3 -  6 Jahre,638,345,293
False,8416025,"Mössingen, Stadt",6 - 10 Jahre,978,517,461
False,8416025,"Mössingen, Stadt",10 - 15 Jahre,1248,659,589
False,8416025,"Mössingen, Stadt",15 - 18 Jahre,860,440,420
False,8416025,"Mössingen, Stadt",18 - 20 Jahre,534,285,249
False,8416025,"Mössingen, Stadt",20 - 25 Jahre,1245,653,592
False,8416025,"Mössingen, Stadt",25 - 30 Jahre,1120,546,574
False,8416025,"Mössingen, Stadt",30 - 35 Jahre,1158,551,607
False,8416025,"Mössingen, Stadt",35 - 40 Jahre,1579,780,799
False,8416025,"Mössingen, Stadt",40 - 45 Jahre,1715,880,835
False,8416025,"Mössingen, Stadt",45 - 50 Jahre,1582,800,782
False,8416025,"Mössingen, Stadt",50 - 55 Jahre,1336,641,695
False,8416025,"Mössingen, Stadt",55 - 60 Jahre,1102,553,549
False,8416025,"Mössingen, Stadt",60 - 65 Jahre,947,494,453
False,8416025,"Mössingen, Stadt",65 - 75 Jahre,1945,921,1024
False,8416025,"Mössingen, Stadt",75 und mehr Jahre,1397,485,912
False,8416025,"Mössingen, Stadt",Insgesamt,19941,9850,10091
False,8416026,Nehren,unter 3 Jahre,146,75,71
False,8416026,Nehren,3 -  6 Jahre,166,83,83
False,8416026,Nehren,6 - 10 Jahre,178,93,85
False,8416026,Nehren,10 - 15 Jahre,240,126,114
False,8416026,Nehren,15 - 18 Jahre,164,82,82
False,8416026,Nehren,18 - 20 Jahre,100,59,41
False,8416026,Nehren,20 - 25 Jahre,230,121,109
False,8416026,Nehren,25 - 30 Jahre,306,131,175
False,8416026,Nehren,30 - 35 Jahre,305,138,167
False,8416026,Nehren,35 - 40 Jahre,377,192,185
False,8416026,Nehren,40 - 45 Jahre,357,194,163
False,8416026,Nehren,45 - 50 Jahre,328,152,176
False,8416026,Nehren,50 - 55 Jahre,297,144,153
False,8416026,Nehren,55 - 60 Jahre,247,127,120
False,8416026,Nehren,60 - 65 Jahre,194,104,90
False,8416026,Nehren,65 - 75 Jahre,352,160,192
False,8416026,Nehren,75 und mehr Jahre,272,93,179
False,8416026,Nehren,Insgesamt,4259,2074,2185
False,8416031,Ofterdingen,unter 3 Jahre,139,79,60
False,8416031,Ofterdingen,3 -  6 Jahre,149,79,70
False,8416031,Ofterdingen,6 - 10 Jahre,211,110,101
False,8416031,Ofterdingen,10 - 15 Jahre,261,126,135
False,8416031,Ofterdingen,15 - 18 Jahre,160,67,93
False,8416031,Ofterdingen,18 - 20 Jahre,93,44,49
False,8416031,Ofterdingen,20 - 25 Jahre,274,144,130
False,8416031,Ofterdingen,25 - 30 Jahre,245,131,114
False,8416031,Ofterdingen,30 - 35 Jahre,302,144,158
False,8416031,Ofterdingen,35 - 40 Jahre,369,186,183
False,8416031,Ofterdingen,40 - 45 Jahre,422,227,195
False,8416031,Ofterdingen,45 - 50 Jahre,319,163,156
False,8416031,Ofterdingen,50 - 55 Jahre,315,158,157
False,8416031,Ofterdingen,55 - 60 Jahre,277,142,135
False,8416031,Ofterdingen,60 - 65 Jahre,194,110,84
False,8416031,Ofterdingen,65 - 75 Jahre,408,200,208
False,8416031,Ofterdingen,75 und mehr Jahre,293,109,184
False,8416031,Ofterdingen,Insgesamt,4431,2219,2212
False,8416036,"Rottenburg am Neckar, Stadt",unter 3 Jahre,1221,633,588
False,8416036,"Rottenburg am Neckar, Stadt",3 -  6 Jahre,1314,652,662
False,8416036,"Rottenburg am Neckar, Stadt",6 - 10 Jahre,2077,1084,993
False,8416036,"Rottenburg am Neckar, Stadt",10 - 15 Jahre,2730,1407,1323
False,8416036,"Rottenburg am Neckar, Stadt",15 - 18 Jahre,1812,917,895
False,8416036,"Rottenburg am Neckar, Stadt",18 - 20 Jahre,1118,568,550
False,8416036,"Rottenburg am Neckar, Stadt",20 - 25 Jahre,2719,1413,1306
False,8416036,"Rottenburg am Neckar, Stadt",25 - 30 Jahre,2501,1270,1231
False,8416036,"Rottenburg am Neckar, Stadt",30 - 35 Jahre,2545,1270,1275
False,8416036,"Rottenburg am Neckar, Stadt",35 - 40 Jahre,3497,1740,1757
False,8416036,"Rottenburg am Neckar, Stadt",40 - 45 Jahre,4039,2153,1886
False,8416036,"Rottenburg am Neckar, Stadt",45 - 50 Jahre,3650,1913,1737
False,8416036,"Rottenburg am Neckar, Stadt",50 - 55 Jahre,2902,1500,1402
False,8416036,"Rottenburg am Neckar, Stadt",55 - 60 Jahre,2205,1139,1066
False,8416036,"Rottenburg am Neckar, Stadt",60 - 65 Jahre,1982,1043,939
False,8416036,"Rottenburg am Neckar, Stadt",65 - 75 Jahre,3859,1899,1960
False,8416036,"Rottenburg am Neckar, Stadt",75 und mehr Jahre,2690,930,1760
False,8416036,"Rottenburg am Neckar, Stadt",Insgesamt,42861,21531,21330
False,8416041,"Tübingen, Universitätsstadt",unter 3 Jahre,2193,1099,1094
False,8416041,"Tübingen, Universitätsstadt",3 -  6 Jahre,2147,1104,1043
False,8416041,"Tübingen, Universitätsstadt",6 - 10 Jahre,2840,1454,1386
False,8416041,"Tübingen, Universitätsstadt",10 - 15 Jahre,3555,1793,1762
False,8416041,"Tübingen, Universitätsstadt",15 - 18 Jahre,2272,1165,1107
False,8416041,"Tübingen, Universitätsstadt",18 - 20 Jahre,1697,762,935
False,8416041,"Tübingen, Universitätsstadt",20 - 25 Jahre,7843,3396,4447
False,8416041,"Tübingen, Universitätsstadt",25 - 30 Jahre,7654,3702,3952
False,8416041,"Tübingen, Universitätsstadt",30 - 35 Jahre,5670,2819,2851
False,8416041,"Tübingen, Universitätsstadt",35 - 40 Jahre,7079,3681,3398
False,8416041,"Tübingen, Universitätsstadt",40 - 45 Jahre,9096,4653,4443
False,8416041,"Tübingen, Universitätsstadt",45 - 50 Jahre,7528,3927,3601
False,8416041,"Tübingen, Universitätsstadt",50 - 55 Jahre,5323,2737,2586
False,8416041,"Tübingen, Universitätsstadt",55 - 60 Jahre,4087,2126,1961
False,8416041,"Tübingen, Universitätsstadt",60 - 65 Jahre,3406,1677,1729
False,8416041,"Tübingen, Universitätsstadt",65 - 75 Jahre,5990,2719,3271
False,8416041,"Tübingen, Universitätsstadt",75 und mehr Jahre,5116,1670,3446
False,8416041,"Tübingen, Universitätsstadt",Insgesamt,83496,40484,43012
False,8416048,Ammerbuch,unter 3 Jahre,356,196,160
False,8416048,Ammerbuch,3 -  6 Jahre,393,206,187
False,8416048,Ammerbuch,6 - 10 Jahre,653,339,314
False,8416048,Ammerbuch,10 - 15 Jahre,725,388,337
False,8416048,Ammerbuch,15 - 18 Jahre,481,238,243
False,8416048,Ammerbuch,18 - 20 Jahre,301,165,136
False,8416048,Ammerbuch,20 - 25 Jahre,693,345,348
False,8416048,Ammerbuch,25 - 30 Jahre,669,326,343
False,8416048,Ammerbuch,30 - 35 Jahre,685,329,356
False,8416048,Ammerbuch,35 - 40 Jahre,1013,485,528
False,8416048,Ammerbuch,40 - 45 Jahre,1089,557,532
False,8416048,Ammerbuch,45 - 50 Jahre,975,517,458
False,8416048,Ammerbuch,50 - 55 Jahre,756,358,398
False,8416048,Ammerbuch,55 - 60 Jahre,617,334,283
False,8416048,Ammerbuch,60 - 65 Jahre,498,255,243
False,8416048,Ammerbuch,65 - 75 Jahre,1053,503,550
False,8416048,Ammerbuch,75 und mehr Jahre,614,227,387
False,8416048,Ammerbuch,Insgesamt,11571,5768,5803
False,8416049,Neustetten,unter 3 Jahre,112,54,58
False,8416049,Neustetten,3 -  6 Jahre,121,66,55
False,8416049,Neustetten,6 - 10 Jahre,201,103,98
False,8416049,Neustetten,10 - 15 Jahre,245,116,129
False,8416049,Neustetten,15 - 18 Jahre,167,84,83
False,8416049,Neustetten,18 - 20 Jahre,92,39,53
False,8416049,Neustetten,20 - 25 Jahre,230,133,97
False,8416049,Neustetten,25 - 30 Jahre,191,99,92
False,8416049,Neustetten,30 - 35 Jahre,204,106,98
False,8416049,Neustetten,35 - 40 Jahre,308,159,149
False,8416049,Neustetten,40 - 45 Jahre,328,153,175
False,8416049,Neustetten,45 - 50 Jahre,294,147,147
False,8416049,Neustetten,50 - 55 Jahre,238,136,102
False,8416049,Neustetten,55 - 60 Jahre,176,83,93
False,8416049,Neustetten,60 - 65 Jahre,118,59,59
False,8416049,Neustetten,65 - 75 Jahre,234,116,118
False,8416049,Neustetten,75 und mehr Jahre,186,61,125
False,8416049,Neustetten,Insgesamt,3445,1714,1731
False,8416050,Starzach,unter 3 Jahre,142,62,80
False,8416050,Starzach,3 -  6 Jahre,171,79,92
False,8416050,Starzach,6 - 10 Jahre,246,120,126
False,8416050,Starzach,10 - 15 Jahre,290,148,142
False,8416050,Starzach,15 - 18 Jahre,213,110,103
False,8416050,Starzach,18 - 20 Jahre,116,58,58
False,8416050,Starzach,20 - 25 Jahre,240,119,121
False,8416050,Starzach,25 - 30 Jahre,189,93,96
False,8416050,Starzach,30 - 35 Jahre,291,157,134
False,8416050,Starzach,35 - 40 Jahre,429,202,227
False,8416050,Starzach,40 - 45 Jahre,470,240,230
False,8416050,Starzach,45 - 50 Jahre,368,194,174
False,8416050,Starzach,50 - 55 Jahre,279,148,131
False,8416050,Starzach,55 - 60 Jahre,168,101,67
False,8416050,Starzach,60 - 65 Jahre,148,75,73
False,8416050,Starzach,65 - 75 Jahre,425,206,219
False,8416050,Starzach,75 und mehr Jahre,280,98,182
False,8416050,Starzach,Insgesamt,4465,2210,2255
False,8417,Landkreis Zollernalbkreis,unter 3 Jahre,4818,2514,2304
False,8417,Landkreis Zollernalbkreis,3 -  6 Jahre,5486,2842,2644
False,8417,Landkreis Zollernalbkreis,6 - 10 Jahre,8202,4255,3947
False,8417,Landkreis Zollernalbkreis,10 - 15 Jahre,11627,5909,5718
False,8417,Landkreis Zollernalbkreis,15 - 18 Jahre,7561,3926,3635
False,8417,Landkreis Zollernalbkreis,18 - 20 Jahre,4761,2495,2266
False,8417,Landkreis Zollernalbkreis,20 - 25 Jahre,10834,5605,5229
False,8417,Landkreis Zollernalbkreis,25 - 30 Jahre,10172,5272,4900
False,8417,Landkreis Zollernalbkreis,30 - 35 Jahre,11207,5665,5542
False,8417,Landkreis Zollernalbkreis,35 - 40 Jahre,14990,7636,7354
False,8417,Landkreis Zollernalbkreis,40 - 45 Jahre,16703,8550,8153
False,8417,Landkreis Zollernalbkreis,45 - 50 Jahre,14966,7654,7312
False,8417,Landkreis Zollernalbkreis,50 - 55 Jahre,12866,6431,6435
False,8417,Landkreis Zollernalbkreis,55 - 60 Jahre,10963,5529,5434
False,8417,Landkreis Zollernalbkreis,60 - 65 Jahre,9869,4820,5049
False,8417,Landkreis Zollernalbkreis,65 - 75 Jahre,21855,10232,11623
False,8417,Landkreis Zollernalbkreis,75 und mehr Jahre,15842,5420,10422
False,8417,Landkreis Zollernalbkreis,Insgesamt,192722,94755,97967
False,8417002,"Balingen, Stadt",unter 3 Jahre,867,463,404
False,8417002,"Balingen, Stadt",3 -  6 Jahre,987,502,485
False,8417002,"Balingen, Stadt",6 - 10 Jahre,1434,762,672
False,8417002,"Balingen, Stadt",10 - 15 Jahre,1881,990,891
False,8417002,"Balingen, Stadt",15 - 18 Jahre,1289,693,596
False,8417002,"Balingen, Stadt",18 - 20 Jahre,789,412,377
False,8417002,"Balingen, Stadt",20 - 25 Jahre,1856,919,937
False,8417002,"Balingen, Stadt",25 - 30 Jahre,1874,951,923
False,8417002,"Balingen, Stadt",30 - 35 Jahre,1996,1046,950
False,8417002,"Balingen, Stadt",35 - 40 Jahre,2634,1296,1338
False,8417002,"Balingen, Stadt",40 - 45 Jahre,2898,1473,1425
False,8417002,"Balingen, Stadt",45 - 50 Jahre,2613,1266,1347
False,8417002,"Balingen, Stadt",50 - 55 Jahre,2324,1151,1173
False,8417002,"Balingen, Stadt",55 - 60 Jahre,2002,982,1020
False,8417002,"Balingen, Stadt",60 - 65 Jahre,1885,914,971
False,8417002,"Balingen, Stadt",65 - 75 Jahre,4029,1897,2132
False,8417002,"Balingen, Stadt",75 und mehr Jahre,3044,1044,2000
False,8417002,"Balingen, Stadt",Insgesamt,34402,16761,17641
False,8417008,Bisingen,unter 3 Jahre,219,110,109
False,8417008,Bisingen,3 -  6 Jahre,263,141,122
False,8417008,Bisingen,6 - 10 Jahre,387,198,189
False,8417008,Bisingen,10 - 15 Jahre,594,313,281
False,8417008,Bisingen,15 - 18 Jahre,368,192,176
False,8417008,Bisingen,18 - 20 Jahre,243,126,117
False,8417008,Bisingen,20 - 25 Jahre,503,268,235
False,8417008,Bisingen,25 - 30 Jahre,522,258,264
False,8417008,Bisingen,30 - 35 Jahre,579,281,298
False,8417008,Bisingen,35 - 40 Jahre,730,374,356
False,8417008,Bisingen,40 - 45 Jahre,797,407,390
False,8417008,Bisingen,45 - 50 Jahre,755,380,375
False,8417008,Bisingen,50 - 55 Jahre,681,356,325
False,8417008,Bisingen,55 - 60 Jahre,523,261,262
False,8417008,Bisingen,60 - 65 Jahre,428,209,219
False,8417008,Bisingen,65 - 75 Jahre,971,461,510
False,8417008,Bisingen,75 und mehr Jahre,748,257,491
False,8417008,Bisingen,Insgesamt,9311,4592,4719
False,8417010,Bitz,unter 3 Jahre,83,52,31
False,8417010,Bitz,3 -  6 Jahre,112,53,59
False,8417010,Bitz,6 - 10 Jahre,154,75,79
False,8417010,Bitz,10 - 15 Jahre,222,116,106
False,8417010,Bitz,15 - 18 Jahre,122,51,71
False,8417010,Bitz,18 - 20 Jahre,84,36,48
False,8417010,Bitz,20 - 25 Jahre,200,108,92
False,8417010,Bitz,25 - 30 Jahre,171,87,84
False,8417010,Bitz,30 - 35 Jahre,206,102,104
False,8417010,Bitz,35 - 40 Jahre,316,168,148
False,8417010,Bitz,40 - 45 Jahre,343,168,175
False,8417010,Bitz,45 - 50 Jahre,308,168,140
False,8417010,Bitz,50 - 55 Jahre,241,122,119
False,8417010,Bitz,55 - 60 Jahre,220,106,114
False,8417010,Bitz,60 - 65 Jahre,233,108,125
False,8417010,Bitz,65 - 75 Jahre,449,203,246
False,8417010,Bitz,75 und mehr Jahre,319,111,208
False,8417010,Bitz,Insgesamt,3783,1834,1949
False,8417013,"Burladingen, Stadt",unter 3 Jahre,335,168,167
False,8417013,"Burladingen, Stadt",3 -  6 Jahre,403,208,195
False,8417013,"Burladingen, Stadt",6 - 10 Jahre,559,288,271
False,8417013,"Burladingen, Stadt",10 - 15 Jahre,822,430,392
False,8417013,"Burladingen, Stadt",15 - 18 Jahre,518,262,256
False,8417013,"Burladingen, Stadt",18 - 20 Jahre,306,163,143
False,8417013,"Burladingen, Stadt",20 - 25 Jahre,646,330,316
False,8417013,"Burladingen, Stadt",25 - 30 Jahre,675,337,338
False,8417013,"Burladingen, Stadt",30 - 35 Jahre,754,363,391
False,8417013,"Burladingen, Stadt",35 - 40 Jahre,1110,587,523
False,8417013,"Burladingen, Stadt",40 - 45 Jahre,1157,586,571
False,8417013,"Burladingen, Stadt",45 - 50 Jahre,1023,541,482
False,8417013,"Burladingen, Stadt",50 - 55 Jahre,864,407,457
False,8417013,"Burladingen, Stadt",55 - 60 Jahre,713,383,330
False,8417013,"Burladingen, Stadt",60 - 65 Jahre,579,282,297
False,8417013,"Burladingen, Stadt",65 - 75 Jahre,1446,661,785
False,8417013,"Burladingen, Stadt",75 und mehr Jahre,1054,323,731
False,8417013,"Burladingen, Stadt",Insgesamt,12964,6319,6645
False,8417014,Dautmergen,unter 3 Jahre,10,5,5
False,8417014,Dautmergen,3 -  6 Jahre,14,5,9
False,8417014,Dautmergen,6 - 10 Jahre,17,9,8
False,8417014,Dautmergen,10 - 15 Jahre,29,13,16
False,8417014,Dautmergen,15 - 18 Jahre,22,9,13
False,8417014,Dautmergen,18 - 20 Jahre,7,4,3
False,8417014,Dautmergen,20 - 25 Jahre,19,10,9
False,8417014,Dautmergen,25 - 30 Jahre,19,11,8
False,8417014,Dautmergen,30 - 35 Jahre,28,14,14
False,8417014,Dautmergen,35 - 40 Jahre,41,24,17
False,8417014,Dautmergen,40 - 45 Jahre,32,19,13
False,8417014,Dautmergen,45 - 50 Jahre,36,14,22
False,8417014,Dautmergen,50 - 55 Jahre,32,15,17
False,8417014,Dautmergen,55 - 60 Jahre,21,15,6
False,8417014,Dautmergen,60 - 65 Jahre,19,8,11
False,8417014,Dautmergen,65 - 75 Jahre,44,20,24
False,8417014,Dautmergen,75 und mehr Jahre,26,7,19
False,8417014,Dautmergen,Insgesamt,416,202,214
False,8417015,Dormettingen,unter 3 Jahre,31,16,15
False,8417015,Dormettingen,3 -  6 Jahre,50,26,24
False,8417015,Dormettingen,6 - 10 Jahre,47,19,28
False,8417015,Dormettingen,10 - 15 Jahre,90,51,39
False,8417015,Dormettingen,15 - 18 Jahre,44,23,21
False,8417015,Dormettingen,18 - 20 Jahre,27,16,11
False,8417015,Dormettingen,20 - 25 Jahre,77,43,34
False,8417015,Dormettingen,25 - 30 Jahre,44,19,25
False,8417015,Dormettingen,30 - 35 Jahre,54,28,26
False,8417015,Dormettingen,35 - 40 Jahre,86,42,44
False,8417015,Dormettingen,40 - 45 Jahre,105,56,49
False,8417015,Dormettingen,45 - 50 Jahre,103,51,52
False,8417015,Dormettingen,50 - 55 Jahre,64,37,27
False,8417015,Dormettingen,55 - 60 Jahre,40,24,16
False,8417015,Dormettingen,60 - 65 Jahre,44,25,19
False,8417015,Dormettingen,65 - 75 Jahre,95,47,48
False,8417015,Dormettingen,75 und mehr Jahre,71,28,43
False,8417015,Dormettingen,Insgesamt,1072,551,521
False,8417016,Dotternhausen,unter 3 Jahre,46,28,18
False,8417016,Dotternhausen,3 -  6 Jahre,58,31,27
False,8417016,Dotternhausen,6 - 10 Jahre,92,45,47
False,8417016,Dotternhausen,10 - 15 Jahre,131,74,57
False,8417016,Dotternhausen,15 - 18 Jahre,74,40,34
False,8417016,Dotternhausen,18 - 20 Jahre,58,25,33
False,8417016,Dotternhausen,20 - 25 Jahre,112,60,52
False,8417016,Dotternhausen,25 - 30 Jahre,89,43,46
False,8417016,Dotternhausen,30 - 35 Jahre,103,50,53
False,8417016,Dotternhausen,35 - 40 Jahre,142,72,70
False,8417016,Dotternhausen,40 - 45 Jahre,169,88,81
False,8417016,Dotternhausen,45 - 50 Jahre,197,99,98
False,8417016,Dotternhausen,50 - 55 Jahre,160,82,78
False,8417016,Dotternhausen,55 - 60 Jahre,96,49,47
False,8417016,Dotternhausen,60 - 65 Jahre,73,36,37
False,8417016,Dotternhausen,65 - 75 Jahre,167,74,93
False,8417016,Dotternhausen,75 und mehr Jahre,98,33,65
False,8417016,Dotternhausen,Insgesamt,1865,929,936
False,8417022,"Geislingen, Stadt",unter 3 Jahre,120,62,58
False,8417022,"Geislingen, Stadt",3 -  6 Jahre,206,101,105
False,8417022,"Geislingen, Stadt",6 - 10 Jahre,300,170,130
False,8417022,"Geislingen, Stadt",10 - 15 Jahre,437,225,212
False,8417022,"Geislingen, Stadt",15 - 18 Jahre,255,142,113
False,8417022,"Geislingen, Stadt",18 - 20 Jahre,154,86,68
False,8417022,"Geislingen, Stadt",20 - 25 Jahre,315,164,151
False,8417022,"Geislingen, Stadt",25 - 30 Jahre,279,155,124
False,8417022,"Geislingen, Stadt",30 - 35 Jahre,332,158,174
False,8417022,"Geislingen, Stadt",35 - 40 Jahre,530,254,276
False,8417022,"Geislingen, Stadt",40 - 45 Jahre,591,316,275
False,8417022,"Geislingen, Stadt",45 - 50 Jahre,464,254,210
False,8417022,"Geislingen, Stadt",50 - 55 Jahre,358,184,174
False,8417022,"Geislingen, Stadt",55 - 60 Jahre,342,171,171
False,8417022,"Geislingen, Stadt",60 - 65 Jahre,260,137,123
False,8417022,"Geislingen, Stadt",65 - 75 Jahre,699,324,375
False,8417022,"Geislingen, Stadt",75 und mehr Jahre,380,141,239
False,8417022,"Geislingen, Stadt",Insgesamt,6022,3044,2978
False,8417023,Grosselfingen,unter 3 Jahre,80,46,34
False,8417023,Grosselfingen,3 -  6 Jahre,70,43,27
False,8417023,Grosselfingen,6 - 10 Jahre,101,48,53
False,8417023,Grosselfingen,10 - 15 Jahre,112,56,56
False,8417023,Grosselfingen,15 - 18 Jahre,72,43,29
False,8417023,Grosselfingen,18 - 20 Jahre,41,24,17
False,8417023,Grosselfingen,20 - 25 Jahre,112,66,46
False,8417023,Grosselfingen,25 - 30 Jahre,121,54,67
False,8417023,Grosselfingen,30 - 35 Jahre,155,81,74
False,8417023,Grosselfingen,35 - 40 Jahre,193,101,92
False,8417023,Grosselfingen,40 - 45 Jahre,192,91,101
False,8417023,Grosselfingen,45 - 50 Jahre,171,94,77
False,8417023,Grosselfingen,50 - 55 Jahre,138,71,67
False,8417023,Grosselfingen,55 - 60 Jahre,117,70,47
False,8417023,Grosselfingen,60 - 65 Jahre,83,43,40
False,8417023,Grosselfingen,65 - 75 Jahre,195,87,108
False,8417023,Grosselfingen,75 und mehr Jahre,177,56,121
False,8417023,Grosselfingen,Insgesamt,2130,1074,1056
False,8417025,"Haigerloch, Stadt",unter 3 Jahre,303,144,159
False,8417025,"Haigerloch, Stadt",3 -  6 Jahre,341,180,161
False,8417025,"Haigerloch, Stadt",6 - 10 Jahre,535,280,255
False,8417025,"Haigerloch, Stadt",10 - 15 Jahre,741,367,374
False,8417025,"Haigerloch, Stadt",15 - 18 Jahre,489,249,240
False,8417025,"Haigerloch, Stadt",18 - 20 Jahre,256,144,112
False,8417025,"Haigerloch, Stadt",20 - 25 Jahre,531,268,263
False,8417025,"Haigerloch, Stadt",25 - 30 Jahre,541,292,249
False,8417025,"Haigerloch, Stadt",30 - 35 Jahre,669,327,342
False,8417025,"Haigerloch, Stadt",35 - 40 Jahre,963,488,475
False,8417025,"Haigerloch, Stadt",40 - 45 Jahre,1023,538,485
False,8417025,"Haigerloch, Stadt",45 - 50 Jahre,866,463,403
False,8417025,"Haigerloch, Stadt",50 - 55 Jahre,652,334,318
False,8417025,"Haigerloch, Stadt",55 - 60 Jahre,619,314,305
False,8417025,"Haigerloch, Stadt",60 - 65 Jahre,479,245,234
False,8417025,"Haigerloch, Stadt",65 - 75 Jahre,1161,537,624
False,8417025,"Haigerloch, Stadt",75 und mehr Jahre,752,274,478
False,8417025,"Haigerloch, Stadt",Insgesamt,10921,5444,5477
False,8417029,Hausen am Tann,unter 3 Jahre,18,6,12
False,8417029,Hausen am Tann,3 -  6 Jahre,8,5,3
False,8417029,Hausen am Tann,6 - 10 Jahre,24,11,13
False,8417029,Hausen am Tann,10 - 15 Jahre,31,14,17
False,8417029,Hausen am Tann,15 - 18 Jahre,18,8,10
False,8417029,Hausen am Tann,18 - 20 Jahre,14,11,3
False,8417029,Hausen am Tann,20 - 25 Jahre,32,17,15
False,8417029,Hausen am Tann,25 - 30 Jahre,33,15,18
False,8417029,Hausen am Tann,30 - 35 Jahre,31,18,13
False,8417029,Hausen am Tann,35 - 40 Jahre,30,17,13
False,8417029,Hausen am Tann,40 - 45 Jahre,51,27,24
False,8417029,Hausen am Tann,45 - 50 Jahre,48,26,22
False,8417029,Hausen am Tann,50 - 55 Jahre,30,13,17
False,8417029,Hausen am Tann,55 - 60 Jahre,28,16,12
False,8417029,Hausen am Tann,60 - 65 Jahre,17,12,5
False,8417029,Hausen am Tann,65 - 75 Jahre,43,20,23
False,8417029,Hausen am Tann,75 und mehr Jahre,48,20,28
False,8417029,Hausen am Tann,Insgesamt,504,256,248
False,8417031,"Hechingen, Stadt",unter 3 Jahre,494,273,221
False,8417031,"Hechingen, Stadt",3 -  6 Jahre,528,266,262
False,8417031,"Hechingen, Stadt",6 - 10 Jahre,785,413,372
False,8417031,"Hechingen, Stadt",10 - 15 Jahre,1165,565,600
False,8417031,"Hechingen, Stadt",15 - 18 Jahre,769,398,371
False,8417031,"Hechingen, Stadt",18 - 20 Jahre,551,269,282
False,8417031,"Hechingen, Stadt",20 - 25 Jahre,1171,601,570
False,8417031,"Hechingen, Stadt",25 - 30 Jahre,1107,592,515
False,8417031,"Hechingen, Stadt",30 - 35 Jahre,1131,618,513
False,8417031,"Hechingen, Stadt",35 - 40 Jahre,1371,664,707
False,8417031,"Hechingen, Stadt",40 - 45 Jahre,1609,791,818
False,8417031,"Hechingen, Stadt",45 - 50 Jahre,1525,791,734
False,8417031,"Hechingen, Stadt",50 - 55 Jahre,1372,685,687
False,8417031,"Hechingen, Stadt",55 - 60 Jahre,1063,540,523
False,8417031,"Hechingen, Stadt",60 - 65 Jahre,1025,482,543
False,8417031,"Hechingen, Stadt",65 - 75 Jahre,2138,989,1149
False,8417031,"Hechingen, Stadt",75 und mehr Jahre,1596,544,1052
False,8417031,"Hechingen, Stadt",Insgesamt,19400,9481,9919
False,8417036,Jungingen,unter 3 Jahre,29,16,13
False,8417036,Jungingen,3 -  6 Jahre,35,14,21
False,8417036,Jungingen,6 - 10 Jahre,57,34,23
False,8417036,Jungingen,10 - 15 Jahre,77,42,35
False,8417036,Jungingen,15 - 18 Jahre,58,22,36
False,8417036,Jungingen,18 - 20 Jahre,36,20,16
False,8417036,Jungingen,20 - 25 Jahre,59,35,24
False,8417036,Jungingen,25 - 30 Jahre,66,35,31
False,8417036,Jungingen,30 - 35 Jahre,71,32,39
False,8417036,Jungingen,35 - 40 Jahre,98,43,55
False,8417036,Jungingen,40 - 45 Jahre,113,58,55
False,8417036,Jungingen,45 - 50 Jahre,121,61,60
False,8417036,Jungingen,50 - 55 Jahre,103,47,56
False,8417036,Jungingen,55 - 60 Jahre,108,50,58
False,8417036,Jungingen,60 - 65 Jahre,96,54,42
False,8417036,Jungingen,65 - 75 Jahre,179,83,96
False,8417036,Jungingen,75 und mehr Jahre,137,50,87
False,8417036,Jungingen,Insgesamt,1443,696,747
False,8417044,"Meßstetten, Stadt",unter 3 Jahre,262,133,129
False,8417044,"Meßstetten, Stadt",3 -  6 Jahre,317,170,147
False,8417044,"Meßstetten, Stadt",6 - 10 Jahre,450,246,204
False,8417044,"Meßstetten, Stadt",10 - 15 Jahre,705,346,359
False,8417044,"Meßstetten, Stadt",15 - 18 Jahre,441,223,218
False,8417044,"Meßstetten, Stadt",18 - 20 Jahre,322,169,153
False,8417044,"Meßstetten, Stadt",20 - 25 Jahre,679,376,303
False,8417044,"Meßstetten, Stadt",25 - 30 Jahre,627,343,284
False,8417044,"Meßstetten, Stadt",30 - 35 Jahre,596,284,312
False,8417044,"Meßstetten, Stadt",35 - 40 Jahre,818,437,381
False,8417044,"Meßstetten, Stadt",40 - 45 Jahre,1045,554,491
False,8417044,"Meßstetten, Stadt",45 - 50 Jahre,943,480,463
False,8417044,"Meßstetten, Stadt",50 - 55 Jahre,743,389,354
False,8417044,"Meßstetten, Stadt",55 - 60 Jahre,588,293,295
False,8417044,"Meßstetten, Stadt",60 - 65 Jahre,543,280,263
False,8417044,"Meßstetten, Stadt",65 - 75 Jahre,1095,519,576
False,8417044,"Meßstetten, Stadt",75 und mehr Jahre,694,239,455
False,8417044,"Meßstetten, Stadt",Insgesamt,10868,5481,5387
False,8417045,Nusplingen,unter 3 Jahre,49,25,24
False,8417045,Nusplingen,3 -  6 Jahre,55,30,25
False,8417045,Nusplingen,6 - 10 Jahre,78,36,42
False,8417045,Nusplingen,10 - 15 Jahre,113,60,53
False,8417045,Nusplingen,15 - 18 Jahre,80,37,43
False,8417045,Nusplingen,18 - 20 Jahre,47,26,21
False,8417045,Nusplingen,20 - 25 Jahre,90,50,40
False,8417045,Nusplingen,25 - 30 Jahre,94,47,47
False,8417045,Nusplingen,30 - 35 Jahre,121,63,58
False,8417045,Nusplingen,35 - 40 Jahre,121,57,64
False,8417045,Nusplingen,40 - 45 Jahre,166,85,81
False,8417045,Nusplingen,45 - 50 Jahre,161,89,72
False,8417045,Nusplingen,50 - 55 Jahre,106,59,47
False,8417045,Nusplingen,55 - 60 Jahre,93,42,51
False,8417045,Nusplingen,60 - 65 Jahre,83,43,40
False,8417045,Nusplingen,65 - 75 Jahre,237,103,134
False,8417045,Nusplingen,75 und mehr Jahre,138,52,86
False,8417045,Nusplingen,Insgesamt,1832,904,928
False,8417047,Obernheim,unter 3 Jahre,44,23,21
False,8417047,Obernheim,3 -  6 Jahre,60,29,31
False,8417047,Obernheim,6 - 10 Jahre,93,42,51
False,8417047,Obernheim,10 - 15 Jahre,113,58,55
False,8417047,Obernheim,15 - 18 Jahre,58,28,30
False,8417047,Obernheim,18 - 20 Jahre,34,16,18
False,8417047,Obernheim,20 - 25 Jahre,52,22,30
False,8417047,Obernheim,25 - 30 Jahre,80,40,40
False,8417047,Obernheim,30 - 35 Jahre,95,53,42
False,8417047,Obernheim,35 - 40 Jahre,138,71,67
False,8417047,Obernheim,40 - 45 Jahre,132,67,65
False,8417047,Obernheim,45 - 50 Jahre,115,62,53
False,8417047,Obernheim,50 - 55 Jahre,97,51,46
False,8417047,Obernheim,55 - 60 Jahre,94,46,48
False,8417047,Obernheim,60 - 65 Jahre,64,30,34
False,8417047,Obernheim,65 - 75 Jahre,179,88,91
False,8417047,Obernheim,75 und mehr Jahre,93,32,61
False,8417047,Obernheim,Insgesamt,1541,758,783
False,8417051,Rangendingen,unter 3 Jahre,146,74,72
False,8417051,Rangendingen,3 -  6 Jahre,142,77,65
False,8417051,Rangendingen,6 - 10 Jahre,230,122,108
False,8417051,Rangendingen,10 - 15 Jahre,306,137,169
False,8417051,Rangendingen,15 - 18 Jahre,221,104,117
False,8417051,Rangendingen,18 - 20 Jahre,122,71,51
False,8417051,Rangendingen,20 - 25 Jahre,332,170,162
False,8417051,Rangendingen,25 - 30 Jahre,287,132,155
False,8417051,Rangendingen,30 - 35 Jahre,354,173,181
False,8417051,Rangendingen,35 - 40 Jahre,422,219,203
False,8417051,Rangendingen,40 - 45 Jahre,454,226,228
False,8417051,Rangendingen,45 - 50 Jahre,412,190,222
False,8417051,Rangendingen,50 - 55 Jahre,370,180,190
False,8417051,Rangendingen,55 - 60 Jahre,330,169,161
False,8417051,Rangendingen,60 - 65 Jahre,274,145,129
False,8417051,Rangendingen,65 - 75 Jahre,485,249,236
False,8417051,Rangendingen,75 und mehr Jahre,338,110,228
False,8417051,Rangendingen,Insgesamt,5225,2548,2677
False,8417052,Ratshausen,unter 3 Jahre,15,6,9
False,8417052,Ratshausen,3 -  6 Jahre,24,8,16
False,8417052,Ratshausen,6 - 10 Jahre,27,9,18
False,8417052,Ratshausen,10 - 15 Jahre,65,34,31
False,8417052,Ratshausen,15 - 18 Jahre,32,16,16
False,8417052,Ratshausen,18 - 20 Jahre,13,8,5
False,8417052,Ratshausen,20 - 25 Jahre,39,19,20
False,8417052,Ratshausen,25 - 30 Jahre,37,22,15
False,8417052,Ratshausen,30 - 35 Jahre,53,23,30
False,8417052,Ratshausen,35 - 40 Jahre,59,36,23
False,8417052,Ratshausen,40 - 45 Jahre,64,31,33
False,8417052,Ratshausen,45 - 50 Jahre,58,32,26
False,8417052,Ratshausen,50 - 55 Jahre,44,22,22
False,8417052,Ratshausen,55 - 60 Jahre,55,27,28
False,8417052,Ratshausen,60 - 65 Jahre,45,25,20
False,8417052,Ratshausen,65 - 75 Jahre,76,29,47
False,8417052,Ratshausen,75 und mehr Jahre,87,27,60
False,8417052,Ratshausen,Insgesamt,793,374,419
False,8417054,"Rosenfeld, Stadt",unter 3 Jahre,197,104,93
False,8417054,"Rosenfeld, Stadt",3 -  6 Jahre,225,129,96
False,8417054,"Rosenfeld, Stadt",6 - 10 Jahre,333,166,167
False,8417054,"Rosenfeld, Stadt",10 - 15 Jahre,444,212,232
False,8417054,"Rosenfeld, Stadt",15 - 18 Jahre,301,159,142
False,8417054,"Rosenfeld, Stadt",18 - 20 Jahre,176,93,83
False,8417054,"Rosenfeld, Stadt",20 - 25 Jahre,329,180,149
False,8417054,"Rosenfeld, Stadt",25 - 30 Jahre,334,183,151
False,8417054,"Rosenfeld, Stadt",30 - 35 Jahre,405,204,201
False,8417054,"Rosenfeld, Stadt",35 - 40 Jahre,558,283,275
False,8417054,"Rosenfeld, Stadt",40 - 45 Jahre,579,314,265
False,8417054,"Rosenfeld, Stadt",45 - 50 Jahre,483,247,236
False,8417054,"Rosenfeld, Stadt",50 - 55 Jahre,397,209,188
False,8417054,"Rosenfeld, Stadt",55 - 60 Jahre,339,165,174
False,8417054,"Rosenfeld, Stadt",60 - 65 Jahre,320,159,161
False,8417054,"Rosenfeld, Stadt",65 - 75 Jahre,647,324,323
False,8417054,"Rosenfeld, Stadt",75 und mehr Jahre,478,171,307
False,8417054,"Rosenfeld, Stadt",Insgesamt,6545,3302,3243
False,8417057,"Schömberg, Stadt",unter 3 Jahre,121,74,47
False,8417057,"Schömberg, Stadt",3 -  6 Jahre,140,71,69
False,8417057,"Schömberg, Stadt",6 - 10 Jahre,236,114,122
False,8417057,"Schömberg, Stadt",10 - 15 Jahre,351,178,173
False,8417057,"Schömberg, Stadt",15 - 18 Jahre,183,94,89
False,8417057,"Schömberg, Stadt",18 - 20 Jahre,119,63,56
False,8417057,"Schömberg, Stadt",20 - 25 Jahre,308,151,157
False,8417057,"Schömberg, Stadt",25 - 30 Jahre,269,149,120
False,8417057,"Schömberg, Stadt",30 - 35 Jahre,298,154,144
False,8417057,"Schömberg, Stadt",35 - 40 Jahre,377,204,173
False,8417057,"Schömberg, Stadt",40 - 45 Jahre,410,208,202
False,8417057,"Schömberg, Stadt",45 - 50 Jahre,356,182,174
False,8417057,"Schömberg, Stadt",50 - 55 Jahre,290,153,137
False,8417057,"Schömberg, Stadt",55 - 60 Jahre,276,141,135
False,8417057,"Schömberg, Stadt",60 - 65 Jahre,200,114,86
False,8417057,"Schömberg, Stadt",65 - 75 Jahre,417,202,215
False,8417057,"Schömberg, Stadt",75 und mehr Jahre,336,121,215
False,8417057,"Schömberg, Stadt",Insgesamt,4687,2373,2314
False,8417063,Straßberg,unter 3 Jahre,69,40,29
False,8417063,Straßberg,3 -  6 Jahre,69,39,30
False,8417063,Straßberg,6 - 10 Jahre,102,50,52
False,8417063,Straßberg,10 - 15 Jahre,164,94,70
False,8417063,Straßberg,15 - 18 Jahre,124,67,57
False,8417063,Straßberg,18 - 20 Jahre,67,42,25
False,8417063,Straßberg,20 - 25 Jahre,155,86,69
False,8417063,Straßberg,25 - 30 Jahre,118,55,63
False,8417063,Straßberg,30 - 35 Jahre,161,71,90
False,8417063,Straßberg,35 - 40 Jahre,201,89,112
False,8417063,Straßberg,40 - 45 Jahre,247,121,126
False,8417063,Straßberg,45 - 50 Jahre,213,115,98
False,8417063,Straßberg,50 - 55 Jahre,186,87,99
False,8417063,Straßberg,55 - 60 Jahre,182,99,83
False,8417063,Straßberg,60 - 65 Jahre,136,54,82
False,8417063,Straßberg,65 - 75 Jahre,296,157,139
False,8417063,Straßberg,75 und mehr Jahre,220,68,152
False,8417063,Straßberg,Insgesamt,2710,1334,1376
False,8417071,Weilen unter den Rinnen,unter 3 Jahre,24,11,13
False,8417071,Weilen unter den Rinnen,3 -  6 Jahre,26,17,9
False,8417071,Weilen unter den Rinnen,6 - 10 Jahre,44,24,20
False,8417071,Weilen unter den Rinnen,10 - 15 Jahre,49,23,26
False,8417071,Weilen unter den Rinnen,15 - 18 Jahre,33,14,19
False,8417071,Weilen unter den Rinnen,18 - 20 Jahre,13,8,5
False,8417071,Weilen unter den Rinnen,20 - 25 Jahre,27,12,15
False,8417071,Weilen unter den Rinnen,25 - 30 Jahre,27,10,17
False,8417071,Weilen unter den Rinnen,30 - 35 Jahre,42,20,22
False,8417071,Weilen unter den Rinnen,35 - 40 Jahre,69,35,34
False,8417071,Weilen unter den Rinnen,40 - 45 Jahre,69,36,33
False,8417071,Weilen unter den Rinnen,45 - 50 Jahre,56,33,23
False,8417071,Weilen unter den Rinnen,50 - 55 Jahre,36,20,16
False,8417071,Weilen unter den Rinnen,55 - 60 Jahre,29,16,13
False,8417071,Weilen unter den Rinnen,60 - 65 Jahre,20,11,9
False,8417071,Weilen unter den Rinnen,65 - 75 Jahre,43,18,25
False,8417071,Weilen unter den Rinnen,75 und mehr Jahre,24,8,16
False,8417071,Weilen unter den Rinnen,Insgesamt,631,316,315
False,8417075,Winterlingen,unter 3 Jahre,162,81,81
False,8417075,Winterlingen,3 -  6 Jahre,202,110,92
False,8417075,Winterlingen,6 - 10 Jahre,289,146,143
False,8417075,Winterlingen,10 - 15 Jahre,417,219,198
False,8417075,Winterlingen,15 - 18 Jahre,297,154,143
False,8417075,Winterlingen,18 - 20 Jahre,168,99,69
False,8417075,Winterlingen,20 - 25 Jahre,381,179,202
False,8417075,Winterlingen,25 - 30 Jahre,307,163,144
False,8417075,Winterlingen,30 - 35 Jahre,323,178,145
False,8417075,Winterlingen,35 - 40 Jahre,534,278,256
False,8417075,Winterlingen,40 - 45 Jahre,573,290,283
False,8417075,Winterlingen,45 - 50 Jahre,530,283,247
False,8417075,Winterlingen,50 - 55 Jahre,440,222,218
False,8417075,Winterlingen,55 - 60 Jahre,370,189,181
False,8417075,Winterlingen,60 - 65 Jahre,312,154,158
False,8417075,Winterlingen,65 - 75 Jahre,759,356,403
False,8417075,Winterlingen,75 und mehr Jahre,600,206,394
False,8417075,Winterlingen,Insgesamt,6664,3307,3357
False,8417078,Zimmern unter der Burg,unter 3 Jahre,13,8,5
False,8417078,Zimmern unter der Burg,3 -  6 Jahre,19,12,7
False,8417078,Zimmern unter der Burg,6 - 10 Jahre,27,7,20
False,8417078,Zimmern unter der Burg,10 - 15 Jahre,42,27,15
False,8417078,Zimmern unter der Burg,15 - 18 Jahre,18,11,7
False,8417078,Zimmern unter der Burg,18 - 20 Jahre,17,10,7
False,8417078,Zimmern unter der Burg,20 - 25 Jahre,21,10,11
False,8417078,Zimmern unter der Burg,25 - 30 Jahre,21,14,7
False,8417078,Zimmern unter der Burg,30 - 35 Jahre,31,18,13
False,8417078,Zimmern unter der Burg,35 - 40 Jahre,41,22,19
False,8417078,Zimmern unter der Burg,40 - 45 Jahre,32,13,19
False,8417078,Zimmern unter der Burg,45 - 50 Jahre,44,23,21
False,8417078,Zimmern unter der Burg,50 - 55 Jahre,22,10,12
False,8417078,Zimmern unter der Burg,55 - 60 Jahre,29,17,12
False,8417078,Zimmern unter der Burg,60 - 65 Jahre,26,16,10
False,8417078,Zimmern unter der Burg,65 - 75 Jahre,42,17,25
False,8417078,Zimmern unter der Burg,75 und mehr Jahre,43,16,27
False,8417078,Zimmern unter der Burg,Insgesamt,488,251,237
False,8417079,"Albstadt, Stadt",unter 3 Jahre,1081,546,535
False,8417079,"Albstadt, Stadt",3 -  6 Jahre,1132,575,557
False,8417079,"Albstadt, Stadt",6 - 10 Jahre,1801,941,860
False,8417079,"Albstadt, Stadt",10 - 15 Jahre,2526,1265,1261
False,8417079,"Albstadt, Stadt",15 - 18 Jahre,1675,887,788
False,8417079,"Albstadt, Stadt",18 - 20 Jahre,1097,554,543
False,8417079,"Albstadt, Stadt",20 - 25 Jahre,2788,1461,1327
False,8417079,"Albstadt, Stadt",25 - 30 Jahre,2430,1265,1165
False,8417079,"Albstadt, Stadt",30 - 35 Jahre,2619,1306,1313
False,8417079,"Albstadt, Stadt",35 - 40 Jahre,3408,1775,1633
False,8417079,"Albstadt, Stadt",40 - 45 Jahre,3852,1987,1865
False,8417079,"Albstadt, Stadt",45 - 50 Jahre,3365,1710,1655
False,8417079,"Albstadt, Stadt",50 - 55 Jahre,3116,1525,1591
False,8417079,"Albstadt, Stadt",55 - 60 Jahre,2686,1344,1342
False,8417079,"Albstadt, Stadt",60 - 65 Jahre,2625,1234,1391
False,8417079,"Albstadt, Stadt",65 - 75 Jahre,5963,2767,3196
False,8417079,"Albstadt, Stadt",75 und mehr Jahre,4341,1482,2859
False,8417079,"Albstadt, Stadt",Insgesamt,46505,22624,23881
False,8421,Stadtkreis Ulm,unter 3 Jahre,3324,1727,1597
False,8421,Stadtkreis Ulm,3 -  6 Jahre,3194,1652,1542
False,8421,Stadtkreis Ulm,6 - 10 Jahre,4525,2344,2181
False,8421,Stadtkreis Ulm,10 - 15 Jahre,5627,2856,2771
False,8421,Stadtkreis Ulm,15 - 18 Jahre,3687,1880,1807
False,8421,Stadtkreis Ulm,18 - 20 Jahre,2549,1292,1257
False,8421,Stadtkreis Ulm,20 - 25 Jahre,8655,4197,4458
False,8421,Stadtkreis Ulm,25 - 30 Jahre,9565,4860,4705
False,8421,Stadtkreis Ulm,30 - 35 Jahre,8986,4673,4313
False,8421,Stadtkreis Ulm,35 - 40 Jahre,9876,5321,4555
False,8421,Stadtkreis Ulm,40 - 45 Jahre,9769,5058,4711
False,8421,Stadtkreis Ulm,45 - 50 Jahre,8561,4254,4307
False,8421,Stadtkreis Ulm,50 - 55 Jahre,7440,3605,3835
False,8421,Stadtkreis Ulm,55 - 60 Jahre,6932,3449,3483
False,8421,Stadtkreis Ulm,60 - 65 Jahre,6633,3289,3344
False,8421,Stadtkreis Ulm,65 - 75 Jahre,11422,5363,6059
False,8421,Stadtkreis Ulm,75 und mehr Jahre,9880,3344,6536
False,8421,Stadtkreis Ulm,Insgesamt,120625,59164,61461
False,8421000,"Ulm, Universitätsstadt",unter 3 Jahre,3324,1727,1597
False,8421000,"Ulm, Universitätsstadt",3 -  6 Jahre,3194,1652,1542
False,8421000,"Ulm, Universitätsstadt",6 - 10 Jahre,4525,2344,2181
False,8421000,"Ulm, Universitätsstadt",10 - 15 Jahre,5627,2856,2771
False,8421000,"Ulm, Universitätsstadt",15 - 18 Jahre,3687,1880,1807
False,8421000,"Ulm, Universitätsstadt",18 - 20 Jahre,2549,1292,1257
False,8421000,"Ulm, Universitätsstadt",20 - 25 Jahre,8655,4197,4458
False,8421000,"Ulm, Universitätsstadt",25 - 30 Jahre,9565,4860,4705
False,8421000,"Ulm, Universitätsstadt",30 - 35 Jahre,8986,4673,4313
False,8421000,"Ulm, Universitätsstadt",35 - 40 Jahre,9876,5321,4555
False,8421000,"Ulm, Universitätsstadt",40 - 45 Jahre,9769,5058,4711
False,8421000,"Ulm, Universitätsstadt",45 - 50 Jahre,8561,4254,4307
False,8421000,"Ulm, Universitätsstadt",50 - 55 Jahre,7440,3605,3835
False,8421000,"Ulm, Universitätsstadt",55 - 60 Jahre,6932,3449,3483
False,8421000,"Ulm, Universitätsstadt",60 - 65 Jahre,6633,3289,3344
False,8421000,"Ulm, Universitätsstadt",65 - 75 Jahre,11422,5363,6059
False,8421000,"Ulm, Universitätsstadt",75 und mehr Jahre,9880,3344,6536
False,8421000,"Ulm, Universitätsstadt",Insgesamt,120625,59164,61461
False,8425,Landkreis Alb-Donau-Kreis,unter 3 Jahre,5698,2923,2775
False,8425,Landkreis Alb-Donau-Kreis,3 -  6 Jahre,6302,3227,3075
False,8425,Landkreis Alb-Donau-Kreis,6 - 10 Jahre,9365,4721,4644
False,8425,Landkreis Alb-Donau-Kreis,10 - 15 Jahre,11956,6176,5780
False,8425,Landkreis Alb-Donau-Kreis,15 - 18 Jahre,7736,3808,3928
False,8425,Landkreis Alb-Donau-Kreis,18 - 20 Jahre,4929,2594,2335
False,8425,Landkreis Alb-Donau-Kreis,20 - 25 Jahre,11000,5784,5216
False,8425,Landkreis Alb-Donau-Kreis,25 - 30 Jahre,10587,5505,5082
False,8425,Landkreis Alb-Donau-Kreis,30 - 35 Jahre,11872,6014,5858
False,8425,Landkreis Alb-Donau-Kreis,35 - 40 Jahre,15677,8044,7633
False,8425,Landkreis Alb-Donau-Kreis,40 - 45 Jahre,16509,8613,7896
False,8425,Landkreis Alb-Donau-Kreis,45 - 50 Jahre,14430,7367,7063
False,8425,Landkreis Alb-Donau-Kreis,50 - 55 Jahre,12282,6339,5943
False,8425,Landkreis Alb-Donau-Kreis,55 - 60 Jahre,10323,5323,5000
False,8425,Landkreis Alb-Donau-Kreis,60 - 65 Jahre,9165,4546,4619
False,8425,Landkreis Alb-Donau-Kreis,65 - 75 Jahre,18600,8939,9661
False,8425,Landkreis Alb-Donau-Kreis,75 und mehr Jahre,13802,4923,8879
False,8425,Landkreis Alb-Donau-Kreis,Insgesamt,190233,94846,95387
False,8425002,Allmendingen,unter 3 Jahre,131,60,71
False,8425002,Allmendingen,3 -  6 Jahre,180,99,81
False,8425002,Allmendingen,6 - 10 Jahre,242,109,133
False,8425002,Allmendingen,10 - 15 Jahre,307,156,151
False,8425002,Allmendingen,15 - 18 Jahre,203,110,93
False,8425002,Allmendingen,18 - 20 Jahre,122,61,61
False,8425002,Allmendingen,20 - 25 Jahre,262,123,139
False,8425002,Allmendingen,25 - 30 Jahre,228,118,110
False,8425002,Allmendingen,30 - 35 Jahre,267,138,129
False,8425002,Allmendingen,35 - 40 Jahre,347,165,182
False,8425002,Allmendingen,40 - 45 Jahre,399,223,176
False,8425002,Allmendingen,45 - 50 Jahre,356,184,172
False,8425002,Allmendingen,50 - 55 Jahre,290,158,132
False,8425002,Allmendingen,55 - 60 Jahre,253,122,131
False,8425002,Allmendingen,60 - 65 Jahre,207,105,102
False,8425002,Allmendingen,65 - 75 Jahre,492,240,252
False,8425002,Allmendingen,75 und mehr Jahre,315,112,203
False,8425002,Allmendingen,Insgesamt,4601,2283,2318
False,8425004,Altheim,unter 3 Jahre,16,5,11
False,8425004,Altheim,3 -  6 Jahre,17,9,8
False,8425004,Altheim,6 - 10 Jahre,54,30,24
False,8425004,Altheim,10 - 15 Jahre,40,25,15
False,8425004,Altheim,15 - 18 Jahre,29,11,18
False,8425004,Altheim,18 - 20 Jahre,13,7,6
False,8425004,Altheim,20 - 25 Jahre,31,13,18
False,8425004,Altheim,25 - 30 Jahre,40,24,16
False,8425004,Altheim,30 - 35 Jahre,44,28,16
False,8425004,Altheim,35 - 40 Jahre,43,23,20
False,8425004,Altheim,40 - 45 Jahre,43,28,15
False,8425004,Altheim,45 - 50 Jahre,24,11,13
False,8425004,Altheim,50 - 55 Jahre,44,20,24
False,8425004,Altheim,55 - 60 Jahre,36,16,20
False,8425004,Altheim,60 - 65 Jahre,29,12,17
False,8425004,Altheim,65 - 75 Jahre,48,25,23
False,8425004,Altheim,75 und mehr Jahre,22,13,9
False,8425004,Altheim,Insgesamt,573,300,273
False,8425005,Altheim (Alb),unter 3 Jahre,53,29,24
False,8425005,Altheim (Alb),3 -  6 Jahre,65,31,34
False,8425005,Altheim (Alb),6 - 10 Jahre,87,43,44
False,8425005,Altheim (Alb),10 - 15 Jahre,128,72,56
False,8425005,Altheim (Alb),15 - 18 Jahre,73,32,41
False,8425005,Altheim (Alb),18 - 20 Jahre,55,31,24
False,8425005,Altheim (Alb),20 - 25 Jahre,107,57,50
False,8425005,Altheim (Alb),25 - 30 Jahre,86,45,41
False,8425005,Altheim (Alb),30 - 35 Jahre,92,53,39
False,8425005,Altheim (Alb),35 - 40 Jahre,147,73,74
False,8425005,Altheim (Alb),40 - 45 Jahre,158,83,75
False,8425005,Altheim (Alb),45 - 50 Jahre,143,70,73
False,8425005,Altheim (Alb),50 - 55 Jahre,104,54,50
False,8425005,Altheim (Alb),55 - 60 Jahre,104,56,48
False,8425005,Altheim (Alb),60 - 65 Jahre,77,40,37
False,8425005,Altheim (Alb),65 - 75 Jahre,184,89,95
False,8425005,Altheim (Alb),75 und mehr Jahre,142,60,82
False,8425005,Altheim (Alb),Insgesamt,1805,918,887
False,8425008,Amstetten,unter 3 Jahre,131,63,68
False,8425008,Amstetten,3 -  6 Jahre,149,92,57
False,8425008,Amstetten,6 - 10 Jahre,247,117,130
False,8425008,Amstetten,10 - 15 Jahre,249,125,124
False,8425008,Amstetten,15 - 18 Jahre,169,85,84
False,8425008,Amstetten,18 - 20 Jahre,96,52,44
False,8425008,Amstetten,20 - 25 Jahre,218,122,96
False,8425008,Amstetten,25 - 30 Jahre,202,105,97
False,8425008,Amstetten,30 - 35 Jahre,236,126,110
False,8425008,Amstetten,35 - 40 Jahre,348,163,185
False,8425008,Amstetten,40 - 45 Jahre,323,183,140
False,8425008,Amstetten,45 - 50 Jahre,265,137,128
False,8425008,Amstetten,50 - 55 Jahre,279,136,143
False,8425008,Amstetten,55 - 60 Jahre,187,104,83
False,8425008,Amstetten,60 - 65 Jahre,214,106,108
False,8425008,Amstetten,65 - 75 Jahre,380,190,190
False,8425008,Amstetten,75 und mehr Jahre,281,101,180
False,8425008,Amstetten,Insgesamt,3974,2007,1967
False,8425011,Asselfingen,unter 3 Jahre,33,18,15
False,8425011,Asselfingen,3 -  6 Jahre,34,18,16
False,8425011,Asselfingen,6 - 10 Jahre,57,28,29
False,8425011,Asselfingen,10 - 15 Jahre,81,46,35
False,8425011,Asselfingen,15 - 18 Jahre,47,21,26
False,8425011,Asselfingen,18 - 20 Jahre,30,16,14
False,8425011,Asselfingen,20 - 25 Jahre,62,39,23
False,8425011,Asselfingen,25 - 30 Jahre,40,26,14
False,8425011,Asselfingen,30 - 35 Jahre,42,19,23
False,8425011,Asselfingen,35 - 40 Jahre,84,44,40
False,8425011,Asselfingen,40 - 45 Jahre,113,69,44
False,8425011,Asselfingen,45 - 50 Jahre,81,41,40
False,8425011,Asselfingen,50 - 55 Jahre,73,41,32
False,8425011,Asselfingen,55 - 60 Jahre,43,21,22
False,8425011,Asselfingen,60 - 65 Jahre,41,23,18
False,8425011,Asselfingen,65 - 75 Jahre,73,44,29
False,8425011,Asselfingen,75 und mehr Jahre,66,21,45
False,8425011,Asselfingen,Insgesamt,1000,535,465
False,8425013,Ballendorf,unter 3 Jahre,14,7,7
False,8425013,Ballendorf,3 -  6 Jahre,20,12,8
False,8425013,Ballendorf,6 - 10 Jahre,27,10,17
False,8425013,Ballendorf,10 - 15 Jahre,42,18,24
False,8425013,Ballendorf,15 - 18 Jahre,30,14,16
False,8425013,Ballendorf,18 - 20 Jahre,20,9,11
False,8425013,Ballendorf,20 - 25 Jahre,26,15,11
False,8425013,Ballendorf,25 - 30 Jahre,26,12,14
False,8425013,Ballendorf,30 - 35 Jahre,37,17,20
False,8425013,Ballendorf,35 - 40 Jahre,58,30,28
False,8425013,Ballendorf,40 - 45 Jahre,52,28,24
False,8425013,Ballendorf,45 - 50 Jahre,46,27,19
False,8425013,Ballendorf,50 - 55 Jahre,46,21,25
False,8425013,Ballendorf,55 - 60 Jahre,18,9,9
False,8425013,Ballendorf,60 - 65 Jahre,39,18,21
False,8425013,Ballendorf,65 - 75 Jahre,74,35,39
False,8425013,Ballendorf,75 und mehr Jahre,68,24,44
False,8425013,Ballendorf,Insgesamt,643,306,337
False,8425014,Beimerstetten,unter 3 Jahre,74,31,43
False,8425014,Beimerstetten,3 -  6 Jahre,97,54,43
False,8425014,Beimerstetten,6 - 10 Jahre,124,67,57
False,8425014,Beimerstetten,10 - 15 Jahre,149,73,76
False,8425014,Beimerstetten,15 - 18 Jahre,98,47,51
False,8425014,Beimerstetten,18 - 20 Jahre,61,38,23
False,8425014,Beimerstetten,20 - 25 Jahre,132,63,69
False,8425014,Beimerstetten,25 - 30 Jahre,141,72,69
False,8425014,Beimerstetten,30 - 35 Jahre,150,74,76
False,8425014,Beimerstetten,35 - 40 Jahre,216,114,102
False,8425014,Beimerstetten,40 - 45 Jahre,218,126,92
False,8425014,Beimerstetten,45 - 50 Jahre,200,96,104
False,8425014,Beimerstetten,50 - 55 Jahre,167,87,80
False,8425014,Beimerstetten,55 - 60 Jahre,121,62,59
False,8425014,Beimerstetten,60 - 65 Jahre,126,64,62
False,8425014,Beimerstetten,65 - 75 Jahre,233,115,118
False,8425014,Beimerstetten,75 und mehr Jahre,171,47,124
False,8425014,Beimerstetten,Insgesamt,2478,1230,1248
False,8425017,Berghülen,unter 3 Jahre,72,33,39
False,8425017,Berghülen,3 -  6 Jahre,76,40,36
False,8425017,Berghülen,6 - 10 Jahre,106,51,55
False,8425017,Berghülen,10 - 15 Jahre,150,81,69
False,8425017,Berghülen,15 - 18 Jahre,81,39,42
False,8425017,Berghülen,18 - 20 Jahre,66,41,25
False,8425017,Berghülen,20 - 25 Jahre,115,66,49
False,8425017,Berghülen,25 - 30 Jahre,90,51,39
False,8425017,Berghülen,30 - 35 Jahre,104,51,53
False,8425017,Berghülen,35 - 40 Jahre,149,80,69
False,8425017,Berghülen,40 - 45 Jahre,165,87,78
False,8425017,Berghülen,45 - 50 Jahre,171,86,85
False,8425017,Berghülen,50 - 55 Jahre,135,72,63
False,8425017,Berghülen,55 - 60 Jahre,101,55,46
False,8425017,Berghülen,60 - 65 Jahre,88,47,41
False,8425017,Berghülen,65 - 75 Jahre,165,79,86
False,8425017,Berghülen,75 und mehr Jahre,122,47,75
False,8425017,Berghülen,Insgesamt,1956,1006,950
False,8425019,Bernstadt,unter 3 Jahre,66,38,28
False,8425019,Bernstadt,3 -  6 Jahre,91,48,43
False,8425019,Bernstadt,6 - 10 Jahre,76,45,31
False,8425019,Bernstadt,10 - 15 Jahre,134,57,77
False,8425019,Bernstadt,15 - 18 Jahre,82,42,40
False,8425019,Bernstadt,18 - 20 Jahre,51,24,27
False,8425019,Bernstadt,20 - 25 Jahre,97,53,44
False,8425019,Bernstadt,25 - 30 Jahre,126,55,71
False,8425019,Bernstadt,30 - 35 Jahre,122,57,65
False,8425019,Bernstadt,35 - 40 Jahre,173,97,76
False,8425019,Bernstadt,40 - 45 Jahre,188,94,94
False,8425019,Bernstadt,45 - 50 Jahre,166,84,82
False,8425019,Bernstadt,50 - 55 Jahre,113,54,59
False,8425019,Bernstadt,55 - 60 Jahre,122,62,60
False,8425019,Bernstadt,60 - 65 Jahre,107,58,49
False,8425019,Bernstadt,65 - 75 Jahre,175,88,87
False,8425019,Bernstadt,75 und mehr Jahre,130,45,85
False,8425019,Bernstadt,Insgesamt,2019,1001,1018
False,8425020,"Blaubeuren, Stadt",unter 3 Jahre,352,175,177
False,8425020,"Blaubeuren, Stadt",3 -  6 Jahre,392,196,196
False,8425020,"Blaubeuren, Stadt",6 - 10 Jahre,596,304,292
False,8425020,"Blaubeuren, Stadt",10 - 15 Jahre,770,392,378
False,8425020,"Blaubeuren, Stadt",15 - 18 Jahre,478,223,255
False,8425020,"Blaubeuren, Stadt",18 - 20 Jahre,301,153,148
False,8425020,"Blaubeuren, Stadt",20 - 25 Jahre,629,322,307
False,8425020,"Blaubeuren, Stadt",25 - 30 Jahre,637,316,321
False,8425020,"Blaubeuren, Stadt",30 - 35 Jahre,716,380,336
False,8425020,"Blaubeuren, Stadt",35 - 40 Jahre,908,475,433
False,8425020,"Blaubeuren, Stadt",40 - 45 Jahre,946,511,435
False,8425020,"Blaubeuren, Stadt",45 - 50 Jahre,834,421,413
False,8425020,"Blaubeuren, Stadt",50 - 55 Jahre,728,386,342
False,8425020,"Blaubeuren, Stadt",55 - 60 Jahre,621,304,317
False,8425020,"Blaubeuren, Stadt",60 - 65 Jahre,624,306,318
False,8425020,"Blaubeuren, Stadt",65 - 75 Jahre,1279,584,695
False,8425020,"Blaubeuren, Stadt",75 und mehr Jahre,1070,339,731
False,8425020,"Blaubeuren, Stadt",Insgesamt,11881,5787,6094
False,8425022,Börslingen,unter 3 Jahre,7,4,3
False,8425022,Börslingen,3 -  6 Jahre,6,3,3
False,8425022,Börslingen,6 - 10 Jahre,8,2,6
False,8425022,Börslingen,10 - 15 Jahre,12,6,6
False,8425022,Börslingen,15 - 18 Jahre,3,1,2
False,8425022,Börslingen,18 - 20 Jahre,4,3,1
False,8425022,Börslingen,20 - 25 Jahre,14,8,6
False,8425022,Börslingen,25 - 30 Jahre,18,9,9
False,8425022,Börslingen,30 - 35 Jahre,11,7,4
False,8425022,Börslingen,35 - 40 Jahre,11,5,6
False,8425022,Börslingen,40 - 45 Jahre,10,4,6
False,8425022,Börslingen,45 - 50 Jahre,7,3,4
False,8425022,Börslingen,50 - 55 Jahre,12,7,5
False,8425022,Börslingen,55 - 60 Jahre,12,7,5
False,8425022,Börslingen,60 - 65 Jahre,8,5,3
False,8425022,Börslingen,65 - 75 Jahre,13,7,6
False,8425022,Börslingen,75 und mehr Jahre,11,5,6
False,8425022,Börslingen,Insgesamt,167,86,81
False,8425024,Breitingen,unter 3 Jahre,6,3,3
False,8425024,Breitingen,3 -  6 Jahre,10,4,6
False,8425024,Breitingen,6 - 10 Jahre,9,6,3
False,8425024,Breitingen,10 - 15 Jahre,15,6,9
False,8425024,Breitingen,15 - 18 Jahre,9,4,5
False,8425024,Breitingen,18 - 20 Jahre,10,4,6
False,8425024,Breitingen,20 - 25 Jahre,20,15,5
False,8425024,Breitingen,25 - 30 Jahre,13,7,6
False,8425024,Breitingen,30 - 35 Jahre,17,14,3
False,8425024,Breitingen,35 - 40 Jahre,18,9,9
False,8425024,Breitingen,40 - 45 Jahre,26,11,15
False,8425024,Breitingen,45 - 50 Jahre,25,14,11
False,8425024,Breitingen,50 - 55 Jahre,26,11,15
False,8425024,Breitingen,55 - 60 Jahre,12,8,4
False,8425024,Breitingen,60 - 65 Jahre,10,6,4
False,8425024,Breitingen,65 - 75 Jahre,12,5,7
False,8425024,Breitingen,75 und mehr Jahre,19,9,10
False,8425024,Breitingen,Insgesamt,257,136,121
False,8425028,"Dietenheim, Stadt",unter 3 Jahre,202,96,106
False,8425028,"Dietenheim, Stadt",3 -  6 Jahre,184,84,100
False,8425028,"Dietenheim, Stadt",6 - 10 Jahre,308,165,143
False,8425028,"Dietenheim, Stadt",10 - 15 Jahre,431,227,204
False,8425028,"Dietenheim, Stadt",15 - 18 Jahre,287,159,128
False,8425028,"Dietenheim, Stadt",18 - 20 Jahre,176,90,86
False,8425028,"Dietenheim, Stadt",20 - 25 Jahre,407,222,185
False,8425028,"Dietenheim, Stadt",25 - 30 Jahre,370,180,190
False,8425028,"Dietenheim, Stadt",30 - 35 Jahre,418,228,190
False,8425028,"Dietenheim, Stadt",35 - 40 Jahre,476,262,214
False,8425028,"Dietenheim, Stadt",40 - 45 Jahre,548,275,273
False,8425028,"Dietenheim, Stadt",45 - 50 Jahre,544,274,270
False,8425028,"Dietenheim, Stadt",50 - 55 Jahre,396,211,185
False,8425028,"Dietenheim, Stadt",55 - 60 Jahre,339,174,165
False,8425028,"Dietenheim, Stadt",60 - 65 Jahre,319,150,169
False,8425028,"Dietenheim, Stadt",65 - 75 Jahre,622,288,334
False,8425028,"Dietenheim, Stadt",75 und mehr Jahre,542,185,357
False,8425028,"Dietenheim, Stadt",Insgesamt,6569,3270,3299
False,8425031,Dornstadt,unter 3 Jahre,271,129,142
False,8425031,Dornstadt,3 -  6 Jahre,258,141,117
False,8425031,Dornstadt,6 - 10 Jahre,369,192,177
False,8425031,Dornstadt,10 - 15 Jahre,479,253,226
False,8425031,Dornstadt,15 - 18 Jahre,328,167,161
False,8425031,Dornstadt,18 - 20 Jahre,210,100,110
False,8425031,Dornstadt,20 - 25 Jahre,473,229,244
False,8425031,Dornstadt,25 - 30 Jahre,509,265,244
False,8425031,Dornstadt,30 - 35 Jahre,518,255,263
False,8425031,Dornstadt,35 - 40 Jahre,662,354,308
False,8425031,Dornstadt,40 - 45 Jahre,700,357,343
False,8425031,Dornstadt,45 - 50 Jahre,618,288,330
False,8425031,Dornstadt,50 - 55 Jahre,574,300,274
False,8425031,Dornstadt,55 - 60 Jahre,502,263,239
False,8425031,Dornstadt,60 - 65 Jahre,503,238,265
False,8425031,Dornstadt,65 - 75 Jahre,910,450,460
False,8425031,Dornstadt,75 und mehr Jahre,687,229,458
False,8425031,Dornstadt,Insgesamt,8571,4210,4361
False,8425033,"Ehingen (Donau), Stadt",unter 3 Jahre,762,405,357
False,8425033,"Ehingen (Donau), Stadt",3 -  6 Jahre,781,384,397
False,8425033,"Ehingen (Donau), Stadt",6 - 10 Jahre,1202,586,616
False,8425033,"Ehingen (Donau), Stadt",10 - 15 Jahre,1565,793,772
False,8425033,"Ehingen (Donau), Stadt",15 - 18 Jahre,1047,489,558
False,8425033,"Ehingen (Donau), Stadt",18 - 20 Jahre,698,368,330
False,8425033,"Ehingen (Donau), Stadt",20 - 25 Jahre,1597,801,796
False,8425033,"Ehingen (Donau), Stadt",25 - 30 Jahre,1626,856,770
False,8425033,"Ehingen (Donau), Stadt",30 - 35 Jahre,1762,897,865
False,8425033,"Ehingen (Donau), Stadt",35 - 40 Jahre,2126,1067,1059
False,8425033,"Ehingen (Donau), Stadt",40 - 45 Jahre,2208,1202,1006
False,8425033,"Ehingen (Donau), Stadt",45 - 50 Jahre,1906,948,958
False,8425033,"Ehingen (Donau), Stadt",50 - 55 Jahre,1715,851,864
False,8425033,"Ehingen (Donau), Stadt",55 - 60 Jahre,1550,793,757
False,8425033,"Ehingen (Donau), Stadt",60 - 65 Jahre,1275,651,624
False,8425033,"Ehingen (Donau), Stadt",65 - 75 Jahre,2390,1136,1254
False,8425033,"Ehingen (Donau), Stadt",75 und mehr Jahre,1807,649,1158
False,8425033,"Ehingen (Donau), Stadt",Insgesamt,26017,12876,13141
False,8425035,Emeringen,unter 3 Jahre,2,1,1
False,8425035,Emeringen,3 -  6 Jahre,2,0,2
False,8425035,Emeringen,6 - 10 Jahre,6,3,3
False,8425035,Emeringen,10 - 15 Jahre,13,6,7
False,8425035,Emeringen,15 - 18 Jahre,10,3,7
False,8425035,Emeringen,18 - 20 Jahre,11,6,5
False,8425035,Emeringen,20 - 25 Jahre,4,3,1
False,8425035,Emeringen,25 - 30 Jahre,2,0,2
False,8425035,Emeringen,30 - 35 Jahre,4,2,2
False,8425035,Emeringen,35 - 40 Jahre,13,7,6
False,8425035,Emeringen,40 - 45 Jahre,13,5,8
False,8425035,Emeringen,45 - 50 Jahre,11,4,7
False,8425035,Emeringen,50 - 55 Jahre,6,4,2
False,8425035,Emeringen,55 - 60 Jahre,9,6,3
False,8425035,Emeringen,60 - 65 Jahre,4,3,1
False,8425035,Emeringen,65 - 75 Jahre,16,7,9
False,8425035,Emeringen,75 und mehr Jahre,9,4,5
False,8425035,Emeringen,Insgesamt,135,64,71
False,8425036,Emerkingen,unter 3 Jahre,37,21,16
False,8425036,Emerkingen,3 -  6 Jahre,50,22,28
False,8425036,Emerkingen,6 - 10 Jahre,62,32,30
False,8425036,Emerkingen,10 - 15 Jahre,52,27,25
False,8425036,Emerkingen,15 - 18 Jahre,29,10,19
False,8425036,Emerkingen,18 - 20 Jahre,8,2,6
False,8425036,Emerkingen,20 - 25 Jahre,40,19,21
False,8425036,Emerkingen,25 - 30 Jahre,62,38,24
False,8425036,Emerkingen,30 - 35 Jahre,72,35,37
False,8425036,Emerkingen,35 - 40 Jahre,70,36,34
False,8425036,Emerkingen,40 - 45 Jahre,79,44,35
False,8425036,Emerkingen,45 - 50 Jahre,42,23,19
False,8425036,Emerkingen,50 - 55 Jahre,44,25,19
False,8425036,Emerkingen,55 - 60 Jahre,39,19,20
False,8425036,Emerkingen,60 - 65 Jahre,42,25,17
False,8425036,Emerkingen,65 - 75 Jahre,58,31,27
False,8425036,Emerkingen,75 und mehr Jahre,48,12,36
False,8425036,Emerkingen,Insgesamt,834,421,413
False,8425039,"Erbach, Stadt",unter 3 Jahre,387,194,193
False,8425039,"Erbach, Stadt",3 -  6 Jahre,445,219,226
False,8425039,"Erbach, Stadt",6 - 10 Jahre,649,345,304
False,8425039,"Erbach, Stadt",10 - 15 Jahre,829,437,392
False,8425039,"Erbach, Stadt",15 - 18 Jahre,533,238,295
False,8425039,"Erbach, Stadt",18 - 20 Jahre,354,187,167
False,8425039,"Erbach, Stadt",20 - 25 Jahre,793,418,375
False,8425039,"Erbach, Stadt",25 - 30 Jahre,762,387,375
False,8425039,"Erbach, Stadt",30 - 35 Jahre,812,409,403
False,8425039,"Erbach, Stadt",35 - 40 Jahre,1112,565,547
False,8425039,"Erbach, Stadt",40 - 45 Jahre,1181,647,534
False,8425039,"Erbach, Stadt",45 - 50 Jahre,972,504,468
False,8425039,"Erbach, Stadt",50 - 55 Jahre,927,469,458
False,8425039,"Erbach, Stadt",55 - 60 Jahre,717,376,341
False,8425039,"Erbach, Stadt",60 - 65 Jahre,591,286,305
False,8425039,"Erbach, Stadt",65 - 75 Jahre,1272,618,654
False,8425039,"Erbach, Stadt",75 und mehr Jahre,865,330,535
False,8425039,"Erbach, Stadt",Insgesamt,13201,6629,6572
False,8425050,Griesingen,unter 3 Jahre,43,21,22
False,8425050,Griesingen,3 -  6 Jahre,47,24,23
False,8425050,Griesingen,6 - 10 Jahre,49,25,24
False,8425050,Griesingen,10 - 15 Jahre,73,31,42
False,8425050,Griesingen,15 - 18 Jahre,43,21,22
False,8425050,Griesingen,18 - 20 Jahre,24,14,10
False,8425050,Griesingen,20 - 25 Jahre,70,28,42
False,8425050,Griesingen,25 - 30 Jahre,54,31,23
False,8425050,Griesingen,30 - 35 Jahre,67,30,37
False,8425050,Griesingen,35 - 40 Jahre,94,40,54
False,8425050,Griesingen,40 - 45 Jahre,85,45,40
False,8425050,Griesingen,45 - 50 Jahre,95,49,46
False,8425050,Griesingen,50 - 55 Jahre,66,42,24
False,8425050,Griesingen,55 - 60 Jahre,44,23,21
False,8425050,Griesingen,60 - 65 Jahre,26,9,17
False,8425050,Griesingen,65 - 75 Jahre,75,35,40
False,8425050,Griesingen,75 und mehr Jahre,55,18,37
False,8425050,Griesingen,Insgesamt,1010,486,524
False,8425052,Grundsheim,unter 3 Jahre,6,3,3
False,8425052,Grundsheim,3 -  6 Jahre,6,2,4
False,8425052,Grundsheim,6 - 10 Jahre,13,6,7
False,8425052,Grundsheim,10 - 15 Jahre,9,3,6
False,8425052,Grundsheim,15 - 18 Jahre,7,1,6
False,8425052,Grundsheim,18 - 20 Jahre,4,2,2
False,8425052,Grundsheim,20 - 25 Jahre,10,6,4
False,8425052,Grundsheim,25 - 30 Jahre,11,7,4
False,8425052,Grundsheim,30 - 35 Jahre,11,5,6
False,8425052,Grundsheim,35 - 40 Jahre,20,8,12
False,8425052,Grundsheim,40 - 45 Jahre,15,12,3
False,8425052,Grundsheim,45 - 50 Jahre,16,8,8
False,8425052,Grundsheim,50 - 55 Jahre,10,7,3
False,8425052,Grundsheim,55 - 60 Jahre,13,9,4
False,8425052,Grundsheim,60 - 65 Jahre,3,1,2
False,8425052,Grundsheim,65 - 75 Jahre,32,13,19
False,8425052,Grundsheim,75 und mehr Jahre,15,7,8
False,8425052,Grundsheim,Insgesamt,201,100,101
False,8425055,Hausen am Bussen,unter 3 Jahre,6,2,4
False,8425055,Hausen am Bussen,3 -  6 Jahre,14,7,7
False,8425055,Hausen am Bussen,6 - 10 Jahre,15,8,7
False,8425055,Hausen am Bussen,10 - 15 Jahre,19,12,7
False,8425055,Hausen am Bussen,15 - 18 Jahre,20,9,11
False,8425055,Hausen am Bussen,18 - 20 Jahre,7,3,4
False,8425055,Hausen am Bussen,20 - 25 Jahre,24,12,12
False,8425055,Hausen am Bussen,25 - 30 Jahre,17,9,8
False,8425055,Hausen am Bussen,30 - 35 Jahre,26,17,9
False,8425055,Hausen am Bussen,35 - 40 Jahre,19,10,9
False,8425055,Hausen am Bussen,40 - 45 Jahre,30,13,17
False,8425055,Hausen am Bussen,45 - 50 Jahre,20,16,4
False,8425055,Hausen am Bussen,50 - 55 Jahre,21,11,10
False,8425055,Hausen am Bussen,55 - 60 Jahre,18,10,8
False,8425055,Hausen am Bussen,60 - 65 Jahre,10,4,6
False,8425055,Hausen am Bussen,65 - 75 Jahre,28,15,13
False,8425055,Hausen am Bussen,75 und mehr Jahre,14,6,8
False,8425055,Hausen am Bussen,Insgesamt,308,164,144
False,8425062,Holzkirch,unter 3 Jahre,8,3,5
False,8425062,Holzkirch,3 -  6 Jahre,2,1,1
False,8425062,Holzkirch,6 - 10 Jahre,13,7,6
False,8425062,Holzkirch,10 - 15 Jahre,27,16,11
False,8425062,Holzkirch,15 - 18 Jahre,10,5,5
False,8425062,Holzkirch,18 - 20 Jahre,7,3,4
False,8425062,Holzkirch,20 - 25 Jahre,15,6,9
False,8425062,Holzkirch,25 - 30 Jahre,8,3,5
False,8425062,Holzkirch,30 - 35 Jahre,13,9,4
False,8425062,Holzkirch,35 - 40 Jahre,28,10,18
False,8425062,Holzkirch,40 - 45 Jahre,32,19,13
False,8425062,Holzkirch,45 - 50 Jahre,12,5,7
False,8425062,Holzkirch,50 - 55 Jahre,13,8,5
False,8425062,Holzkirch,55 - 60 Jahre,11,8,3
False,8425062,Holzkirch,60 - 65 Jahre,7,3,4
False,8425062,Holzkirch,65 - 75 Jahre,35,17,18
False,8425062,Holzkirch,75 und mehr Jahre,28,8,20
False,8425062,Holzkirch,Insgesamt,269,131,138
False,8425064,Hüttisheim,unter 3 Jahre,38,16,22
False,8425064,Hüttisheim,3 -  6 Jahre,44,13,31
False,8425064,Hüttisheim,6 - 10 Jahre,79,34,45
False,8425064,Hüttisheim,10 - 15 Jahre,90,46,44
False,8425064,Hüttisheim,15 - 18 Jahre,49,27,22
False,8425064,Hüttisheim,18 - 20 Jahre,48,29,19
False,8425064,Hüttisheim,20 - 25 Jahre,83,52,31
False,8425064,Hüttisheim,25 - 30 Jahre,61,32,29
False,8425064,Hüttisheim,30 - 35 Jahre,73,34,39
False,8425064,Hüttisheim,35 - 40 Jahre,141,71,70
False,8425064,Hüttisheim,40 - 45 Jahre,103,51,52
False,8425064,Hüttisheim,45 - 50 Jahre,121,57,64
False,8425064,Hüttisheim,50 - 55 Jahre,84,46,38
False,8425064,Hüttisheim,55 - 60 Jahre,65,34,31
False,8425064,Hüttisheim,60 - 65 Jahre,68,33,35
False,8425064,Hüttisheim,65 - 75 Jahre,151,70,81
False,8425064,Hüttisheim,75 und mehr Jahre,72,29,43
False,8425064,Hüttisheim,Insgesamt,1370,674,696
False,8425066,Illerrieden,unter 3 Jahre,93,46,47
False,8425066,Illerrieden,3 -  6 Jahre,84,35,49
False,8425066,Illerrieden,6 - 10 Jahre,135,68,67
False,8425066,Illerrieden,10 - 15 Jahre,200,92,108
False,8425066,Illerrieden,15 - 18 Jahre,120,59,61
False,8425066,Illerrieden,18 - 20 Jahre,92,50,42
False,8425066,Illerrieden,20 - 25 Jahre,209,105,104
False,8425066,Illerrieden,25 - 30 Jahre,221,116,105
False,8425066,Illerrieden,30 - 35 Jahre,211,99,112
False,8425066,Illerrieden,35 - 40 Jahre,270,141,129
False,8425066,Illerrieden,40 - 45 Jahre,297,155,142
False,8425066,Illerrieden,45 - 50 Jahre,259,133,126
False,8425066,Illerrieden,50 - 55 Jahre,233,116,117
False,8425066,Illerrieden,55 - 60 Jahre,216,114,102
False,8425066,Illerrieden,60 - 65 Jahre,187,98,89
False,8425066,Illerrieden,65 - 75 Jahre,287,149,138
False,8425066,Illerrieden,75 und mehr Jahre,222,77,145
False,8425066,Illerrieden,Insgesamt,3336,1653,1683
False,8425071,"Laichingen, Stadt",unter 3 Jahre,338,180,158
False,8425071,"Laichingen, Stadt",3 -  6 Jahre,408,215,193
False,8425071,"Laichingen, Stadt",6 - 10 Jahre,563,278,285
False,8425071,"Laichingen, Stadt",10 - 15 Jahre,746,389,357
False,8425071,"Laichingen, Stadt",15 - 18 Jahre,489,227,262
False,8425071,"Laichingen, Stadt",18 - 20 Jahre,284,153,131
False,8425071,"Laichingen, Stadt",20 - 25 Jahre,606,323,283
False,8425071,"Laichingen, Stadt",25 - 30 Jahre,578,291,287
False,8425071,"Laichingen, Stadt",30 - 35 Jahre,673,338,335
False,8425071,"Laichingen, Stadt",35 - 40 Jahre,917,467,450
False,8425071,"Laichingen, Stadt",40 - 45 Jahre,934,482,452
False,8425071,"Laichingen, Stadt",45 - 50 Jahre,777,420,357
False,8425071,"Laichingen, Stadt",50 - 55 Jahre,670,337,333
False,8425071,"Laichingen, Stadt",55 - 60 Jahre,597,300,297
False,8425071,"Laichingen, Stadt",60 - 65 Jahre,483,259,224
False,8425071,"Laichingen, Stadt",65 - 75 Jahre,1068,505,563
False,8425071,"Laichingen, Stadt",75 und mehr Jahre,859,309,550
False,8425071,"Laichingen, Stadt",Insgesamt,10990,5473,5517
False,8425072,"Langenau, Stadt",unter 3 Jahre,408,218,190
False,8425072,"Langenau, Stadt",3 -  6 Jahre,464,240,224
False,8425072,"Langenau, Stadt",6 - 10 Jahre,677,337,340
False,8425072,"Langenau, Stadt",10 - 15 Jahre,873,469,404
False,8425072,"Langenau, Stadt",15 - 18 Jahre,537,271,266
False,8425072,"Langenau, Stadt",18 - 20 Jahre,345,169,176
False,8425072,"Langenau, Stadt",20 - 25 Jahre,814,433,381
False,8425072,"Langenau, Stadt",25 - 30 Jahre,826,441,385
False,8425072,"Langenau, Stadt",30 - 35 Jahre,884,453,431
False,8425072,"Langenau, Stadt",35 - 40 Jahre,1264,646,618
False,8425072,"Langenau, Stadt",40 - 45 Jahre,1283,654,629
False,8425072,"Langenau, Stadt",45 - 50 Jahre,1089,569,520
False,8425072,"Langenau, Stadt",50 - 55 Jahre,904,480,424
False,8425072,"Langenau, Stadt",55 - 60 Jahre,789,419,370
False,8425072,"Langenau, Stadt",60 - 65 Jahre,636,310,326
False,8425072,"Langenau, Stadt",65 - 75 Jahre,1395,673,722
False,8425072,"Langenau, Stadt",75 und mehr Jahre,1047,385,662
False,8425072,"Langenau, Stadt",Insgesamt,14235,7167,7068
False,8425073,Lauterach,unter 3 Jahre,10,6,4
False,8425073,Lauterach,3 -  6 Jahre,28,19,9
False,8425073,Lauterach,6 - 10 Jahre,37,17,20
False,8425073,Lauterach,10 - 15 Jahre,38,17,21
False,8425073,Lauterach,15 - 18 Jahre,30,17,13
False,8425073,Lauterach,18 - 20 Jahre,13,6,7
False,8425073,Lauterach,20 - 25 Jahre,40,28,12
False,8425073,Lauterach,25 - 30 Jahre,32,17,15
False,8425073,Lauterach,30 - 35 Jahre,44,22,22
False,8425073,Lauterach,35 - 40 Jahre,50,31,19
False,8425073,Lauterach,40 - 45 Jahre,55,33,22
False,8425073,Lauterach,45 - 50 Jahre,49,30,19
False,8425073,Lauterach,50 - 55 Jahre,41,22,19
False,8425073,Lauterach,55 - 60 Jahre,36,20,16
False,8425073,Lauterach,60 - 65 Jahre,23,10,13
False,8425073,Lauterach,65 - 75 Jahre,39,12,27
False,8425073,Lauterach,75 und mehr Jahre,39,16,23
False,8425073,Lauterach,Insgesamt,604,323,281
False,8425075,Lonsee,unter 3 Jahre,148,82,66
False,8425075,Lonsee,3 -  6 Jahre,167,88,79
False,8425075,Lonsee,6 - 10 Jahre,264,137,127
False,8425075,Lonsee,10 - 15 Jahre,328,163,165
False,8425075,Lonsee,15 - 18 Jahre,208,114,94
False,8425075,Lonsee,18 - 20 Jahre,128,73,55
False,8425075,Lonsee,20 - 25 Jahre,308,168,140
False,8425075,Lonsee,25 - 30 Jahre,237,119,118
False,8425075,Lonsee,30 - 35 Jahre,280,139,141
False,8425075,Lonsee,35 - 40 Jahre,350,174,176
False,8425075,Lonsee,40 - 45 Jahre,457,238,219
False,8425075,Lonsee,45 - 50 Jahre,387,210,177
False,8425075,Lonsee,50 - 55 Jahre,297,142,155
False,8425075,Lonsee,55 - 60 Jahre,255,135,120
False,8425075,Lonsee,60 - 65 Jahre,197,106,91
False,8425075,Lonsee,65 - 75 Jahre,437,211,226
False,8425075,Lonsee,75 und mehr Jahre,298,100,198
False,8425075,Lonsee,Insgesamt,4746,2399,2347
False,8425079,Merklingen,unter 3 Jahre,59,35,24
False,8425079,Merklingen,3 -  6 Jahre,64,34,30
False,8425079,Merklingen,6 - 10 Jahre,99,50,49
False,8425079,Merklingen,10 - 15 Jahre,141,68,73
False,8425079,Merklingen,15 - 18 Jahre,70,34,36
False,8425079,Merklingen,18 - 20 Jahre,44,24,20
False,8425079,Merklingen,20 - 25 Jahre,68,34,34
False,8425079,Merklingen,25 - 30 Jahre,74,36,38
False,8425079,Merklingen,30 - 35 Jahre,122,57,65
False,8425079,Merklingen,35 - 40 Jahre,179,88,91
False,8425079,Merklingen,40 - 45 Jahre,185,96,89
False,8425079,Merklingen,45 - 50 Jahre,124,66,58
False,8425079,Merklingen,50 - 55 Jahre,104,53,51
False,8425079,Merklingen,55 - 60 Jahre,90,44,46
False,8425079,Merklingen,60 - 65 Jahre,84,44,40
False,8425079,Merklingen,65 - 75 Jahre,214,104,110
False,8425079,Merklingen,75 und mehr Jahre,150,53,97
False,8425079,Merklingen,Insgesamt,1871,920,951
False,8425081,"Munderkingen, Stadt",unter 3 Jahre,129,76,53
False,8425081,"Munderkingen, Stadt",3 -  6 Jahre,146,73,73
False,8425081,"Munderkingen, Stadt",6 - 10 Jahre,227,123,104
False,8425081,"Munderkingen, Stadt",10 - 15 Jahre,315,147,168
False,8425081,"Munderkingen, Stadt",15 - 18 Jahre,250,118,132
False,8425081,"Munderkingen, Stadt",18 - 20 Jahre,162,81,81
False,8425081,"Munderkingen, Stadt",20 - 25 Jahre,335,174,161
False,8425081,"Munderkingen, Stadt",25 - 30 Jahre,260,144,116
False,8425081,"Munderkingen, Stadt",30 - 35 Jahre,277,150,127
False,8425081,"Munderkingen, Stadt",35 - 40 Jahre,307,160,147
False,8425081,"Munderkingen, Stadt",40 - 45 Jahre,401,179,222
False,8425081,"Munderkingen, Stadt",45 - 50 Jahre,439,224,215
False,8425081,"Munderkingen, Stadt",50 - 55 Jahre,331,166,165
False,8425081,"Munderkingen, Stadt",55 - 60 Jahre,269,132,137
False,8425081,"Munderkingen, Stadt",60 - 65 Jahre,272,126,146
False,8425081,"Munderkingen, Stadt",65 - 75 Jahre,551,255,296
False,8425081,"Munderkingen, Stadt",75 und mehr Jahre,428,146,282
False,8425081,"Munderkingen, Stadt",Insgesamt,5099,2474,2625
False,8425083,Neenstetten,unter 3 Jahre,32,17,15
False,8425083,Neenstetten,3 -  6 Jahre,36,13,23
False,8425083,Neenstetten,6 - 10 Jahre,53,23,30
False,8425083,Neenstetten,10 - 15 Jahre,53,23,30
False,8425083,Neenstetten,15 - 18 Jahre,36,22,14
False,8425083,Neenstetten,18 - 20 Jahre,16,8,8
False,8425083,Neenstetten,20 - 25 Jahre,35,14,21
False,8425083,Neenstetten,25 - 30 Jahre,35,19,16
False,8425083,Neenstetten,30 - 35 Jahre,57,23,34
False,8425083,Neenstetten,35 - 40 Jahre,79,45,34
False,8425083,Neenstetten,40 - 45 Jahre,74,36,38
False,8425083,Neenstetten,45 - 50 Jahre,65,30,35
False,8425083,Neenstetten,50 - 55 Jahre,40,24,16
False,8425083,Neenstetten,55 - 60 Jahre,37,15,22
False,8425083,Neenstetten,60 - 65 Jahre,44,26,18
False,8425083,Neenstetten,65 - 75 Jahre,67,33,34
False,8425083,Neenstetten,75 und mehr Jahre,47,18,29
False,8425083,Neenstetten,Insgesamt,806,389,417
False,8425084,Nellingen,unter 3 Jahre,77,44,33
False,8425084,Nellingen,3 -  6 Jahre,70,44,26
False,8425084,Nellingen,6 - 10 Jahre,104,52,52
False,8425084,Nellingen,10 - 15 Jahre,127,72,55
False,8425084,Nellingen,15 - 18 Jahre,71,36,35
False,8425084,Nellingen,18 - 20 Jahre,40,19,21
False,8425084,Nellingen,20 - 25 Jahre,90,54,36
False,8425084,Nellingen,25 - 30 Jahre,78,37,41
False,8425084,Nellingen,30 - 35 Jahre,114,56,58
False,8425084,Nellingen,35 - 40 Jahre,179,87,92
False,8425084,Nellingen,40 - 45 Jahre,180,90,90
False,8425084,Nellingen,45 - 50 Jahre,149,82,67
False,8425084,Nellingen,50 - 55 Jahre,128,67,61
False,8425084,Nellingen,55 - 60 Jahre,103,60,43
False,8425084,Nellingen,60 - 65 Jahre,86,43,43
False,8425084,Nellingen,65 - 75 Jahre,164,77,87
False,8425084,Nellingen,75 und mehr Jahre,122,48,74
False,8425084,Nellingen,Insgesamt,1882,968,914
False,8425085,Nerenstetten,unter 3 Jahre,7,4,3
False,8425085,Nerenstetten,3 -  6 Jahre,15,4,11
False,8425085,Nerenstetten,6 - 10 Jahre,23,13,10
False,8425085,Nerenstetten,10 - 15 Jahre,21,9,12
False,8425085,Nerenstetten,15 - 18 Jahre,23,12,11
False,8425085,Nerenstetten,18 - 20 Jahre,13,5,8
False,8425085,Nerenstetten,20 - 25 Jahre,28,14,14
False,8425085,Nerenstetten,25 - 30 Jahre,13,8,5
False,8425085,Nerenstetten,30 - 35 Jahre,24,9,15
False,8425085,Nerenstetten,35 - 40 Jahre,35,15,20
False,8425085,Nerenstetten,40 - 45 Jahre,36,21,15
False,8425085,Nerenstetten,45 - 50 Jahre,18,7,11
False,8425085,Nerenstetten,50 - 55 Jahre,30,20,10
False,8425085,Nerenstetten,55 - 60 Jahre,14,7,7
False,8425085,Nerenstetten,60 - 65 Jahre,16,10,6
False,8425085,Nerenstetten,65 - 75 Jahre,27,15,12
False,8425085,Nerenstetten,75 und mehr Jahre,23,8,15
False,8425085,Nerenstetten,Insgesamt,366,181,185
False,8425088,Oberdischingen,unter 3 Jahre,47,23,24
False,8425088,Oberdischingen,3 -  6 Jahre,78,39,39
False,8425088,Oberdischingen,6 - 10 Jahre,107,46,61
False,8425088,Oberdischingen,10 - 15 Jahre,131,67,64
False,8425088,Oberdischingen,15 - 18 Jahre,94,58,36
False,8425088,Oberdischingen,18 - 20 Jahre,50,33,17
False,8425088,Oberdischingen,20 - 25 Jahre,114,62,52
False,8425088,Oberdischingen,25 - 30 Jahre,104,56,48
False,8425088,Oberdischingen,30 - 35 Jahre,111,53,58
False,8425088,Oberdischingen,35 - 40 Jahre,158,74,84
False,8425088,Oberdischingen,40 - 45 Jahre,138,58,80
False,8425088,Oberdischingen,45 - 50 Jahre,183,96,87
False,8425088,Oberdischingen,50 - 55 Jahre,136,72,64
False,8425088,Oberdischingen,55 - 60 Jahre,91,48,43
False,8425088,Oberdischingen,60 - 65 Jahre,72,42,30
False,8425088,Oberdischingen,65 - 75 Jahre,178,84,94
False,8425088,Oberdischingen,75 und mehr Jahre,179,59,120
False,8425088,Oberdischingen,Insgesamt,1971,970,1001
False,8425090,Obermarchtal,unter 3 Jahre,35,16,19
False,8425090,Obermarchtal,3 -  6 Jahre,55,29,26
False,8425090,Obermarchtal,6 - 10 Jahre,92,48,44
False,8425090,Obermarchtal,10 - 15 Jahre,90,49,41
False,8425090,Obermarchtal,15 - 18 Jahre,60,27,33
False,8425090,Obermarchtal,18 - 20 Jahre,32,18,14
False,8425090,Obermarchtal,20 - 25 Jahre,71,37,34
False,8425090,Obermarchtal,25 - 30 Jahre,65,30,35
False,8425090,Obermarchtal,30 - 35 Jahre,90,46,44
False,8425090,Obermarchtal,35 - 40 Jahre,105,55,50
False,8425090,Obermarchtal,40 - 45 Jahre,105,43,62
False,8425090,Obermarchtal,45 - 50 Jahre,89,48,41
False,8425090,Obermarchtal,50 - 55 Jahre,81,48,33
False,8425090,Obermarchtal,55 - 60 Jahre,69,31,38
False,8425090,Obermarchtal,60 - 65 Jahre,52,26,26
False,8425090,Obermarchtal,65 - 75 Jahre,103,51,52
False,8425090,Obermarchtal,75 und mehr Jahre,82,33,49
False,8425090,Obermarchtal,Insgesamt,1276,635,641
False,8425091,Oberstadion,unter 3 Jahre,43,24,19
False,8425091,Oberstadion,3 -  6 Jahre,67,40,27
False,8425091,Oberstadion,6 - 10 Jahre,94,49,45
False,8425091,Oberstadion,10 - 15 Jahre,112,70,42
False,8425091,Oberstadion,15 - 18 Jahre,78,40,38
False,8425091,Oberstadion,18 - 20 Jahre,50,28,22
False,8425091,Oberstadion,20 - 25 Jahre,120,72,48
False,8425091,Oberstadion,25 - 30 Jahre,87,50,37
False,8425091,Oberstadion,30 - 35 Jahre,115,53,62
False,8425091,Oberstadion,35 - 40 Jahre,121,63,58
False,8425091,Oberstadion,40 - 45 Jahre,143,84,59
False,8425091,Oberstadion,45 - 50 Jahre,151,75,76
False,8425091,Oberstadion,50 - 55 Jahre,111,60,51
False,8425091,Oberstadion,55 - 60 Jahre,60,38,22
False,8425091,Oberstadion,60 - 65 Jahre,47,18,29
False,8425091,Oberstadion,65 - 75 Jahre,116,57,59
False,8425091,Oberstadion,75 und mehr Jahre,100,45,55
False,8425091,Oberstadion,Insgesamt,1615,866,749
False,8425092,Öllingen,unter 3 Jahre,25,15,10
False,8425092,Öllingen,3 -  6 Jahre,20,13,7
False,8425092,Öllingen,6 - 10 Jahre,23,10,13
False,8425092,Öllingen,10 - 15 Jahre,44,22,22
False,8425092,Öllingen,15 - 18 Jahre,27,13,14
False,8425092,Öllingen,18 - 20 Jahre,7,3,4
False,8425092,Öllingen,20 - 25 Jahre,22,10,12
False,8425092,Öllingen,25 - 30 Jahre,28,16,12
False,8425092,Öllingen,30 - 35 Jahre,25,12,13
False,8425092,Öllingen,35 - 40 Jahre,42,25,17
False,8425092,Öllingen,40 - 45 Jahre,41,21,20
False,8425092,Öllingen,45 - 50 Jahre,46,30,16
False,8425092,Öllingen,50 - 55 Jahre,21,7,14
False,8425092,Öllingen,55 - 60 Jahre,16,8,8
False,8425092,Öllingen,60 - 65 Jahre,20,9,11
False,8425092,Öllingen,65 - 75 Jahre,57,31,26
False,8425092,Öllingen,75 und mehr Jahre,32,13,19
False,8425092,Öllingen,Insgesamt,496,258,238
False,8425093,Öpfingen,unter 3 Jahre,79,37,42
False,8425093,Öpfingen,3 -  6 Jahre,76,47,29
False,8425093,Öpfingen,6 - 10 Jahre,110,63,47
False,8425093,Öpfingen,10 - 15 Jahre,140,79,61
False,8425093,Öpfingen,15 - 18 Jahre,89,39,50
False,8425093,Öpfingen,18 - 20 Jahre,56,23,33
False,8425093,Öpfingen,20 - 25 Jahre,121,64,57
False,8425093,Öpfingen,25 - 30 Jahre,141,71,70
False,8425093,Öpfingen,30 - 35 Jahre,143,68,75
False,8425093,Öpfingen,35 - 40 Jahre,184,109,75
False,8425093,Öpfingen,40 - 45 Jahre,197,98,99
False,8425093,Öpfingen,45 - 50 Jahre,176,93,83
False,8425093,Öpfingen,50 - 55 Jahre,139,59,80
False,8425093,Öpfingen,55 - 60 Jahre,118,66,52
False,8425093,Öpfingen,60 - 65 Jahre,136,65,71
False,8425093,Öpfingen,65 - 75 Jahre,223,116,107
False,8425093,Öpfingen,75 und mehr Jahre,144,59,85
False,8425093,Öpfingen,Insgesamt,2272,1156,1116
False,8425097,Rammingen,unter 3 Jahre,42,18,24
False,8425097,Rammingen,3 -  6 Jahre,44,28,16
False,8425097,Rammingen,6 - 10 Jahre,66,27,39
False,8425097,Rammingen,10 - 15 Jahre,96,51,45
False,8425097,Rammingen,15 - 18 Jahre,54,30,24
False,8425097,Rammingen,18 - 20 Jahre,36,17,19
False,8425097,Rammingen,20 - 25 Jahre,70,44,26
False,8425097,Rammingen,25 - 30 Jahre,58,28,30
False,8425097,Rammingen,30 - 35 Jahre,85,31,54
False,8425097,Rammingen,35 - 40 Jahre,103,54,49
False,8425097,Rammingen,40 - 45 Jahre,142,81,61
False,8425097,Rammingen,45 - 50 Jahre,95,50,45
False,8425097,Rammingen,50 - 55 Jahre,94,47,47
False,8425097,Rammingen,55 - 60 Jahre,77,42,35
False,8425097,Rammingen,60 - 65 Jahre,63,37,26
False,8425097,Rammingen,65 - 75 Jahre,115,58,57
False,8425097,Rammingen,75 und mehr Jahre,66,24,42
False,8425097,Rammingen,Insgesamt,1306,667,639
False,8425098,Rechtenstein,unter 3 Jahre,11,5,6
False,8425098,Rechtenstein,3 -  6 Jahre,3,1,2
False,8425098,Rechtenstein,6 - 10 Jahre,9,4,5
False,8425098,Rechtenstein,10 - 15 Jahre,13,8,5
False,8425098,Rechtenstein,15 - 18 Jahre,9,3,6
False,8425098,Rechtenstein,18 - 20 Jahre,9,6,3
False,8425098,Rechtenstein,20 - 25 Jahre,28,15,13
False,8425098,Rechtenstein,25 - 30 Jahre,15,8,7
False,8425098,Rechtenstein,30 - 35 Jahre,13,2,11
False,8425098,Rechtenstein,35 - 40 Jahre,25,16,9
False,8425098,Rechtenstein,40 - 45 Jahre,30,14,16
False,8425098,Rechtenstein,45 - 50 Jahre,33,20,13
False,8425098,Rechtenstein,50 - 55 Jahre,20,10,10
False,8425098,Rechtenstein,55 - 60 Jahre,17,11,6
False,8425098,Rechtenstein,60 - 65 Jahre,14,7,7
False,8425098,Rechtenstein,65 - 75 Jahre,33,16,17
False,8425098,Rechtenstein,75 und mehr Jahre,11,2,9
False,8425098,Rechtenstein,Insgesamt,293,148,145
False,8425104,Rottenacker,unter 3 Jahre,68,38,30
False,8425104,Rottenacker,3 -  6 Jahre,54,29,25
False,8425104,Rottenacker,6 - 10 Jahre,117,63,54
False,8425104,Rottenacker,10 - 15 Jahre,154,91,63
False,8425104,Rottenacker,15 - 18 Jahre,96,52,44
False,8425104,Rottenacker,18 - 20 Jahre,65,33,32
False,8425104,Rottenacker,20 - 25 Jahre,118,73,45
False,8425104,Rottenacker,25 - 30 Jahre,105,62,43
False,8425104,Rottenacker,30 - 35 Jahre,120,51,69
False,8425104,Rottenacker,35 - 40 Jahre,175,89,86
False,8425104,Rottenacker,40 - 45 Jahre,214,111,103
False,8425104,Rottenacker,45 - 50 Jahre,173,87,86
False,8425104,Rottenacker,50 - 55 Jahre,150,73,77
False,8425104,Rottenacker,55 - 60 Jahre,105,57,48
False,8425104,Rottenacker,60 - 65 Jahre,92,47,45
False,8425104,Rottenacker,65 - 75 Jahre,235,110,125
False,8425104,Rottenacker,75 und mehr Jahre,157,50,107
False,8425104,Rottenacker,Insgesamt,2198,1116,1082
False,8425108,"Schelklingen, Stadt",unter 3 Jahre,189,102,87
False,8425108,"Schelklingen, Stadt",3 -  6 Jahre,235,101,134
False,8425108,"Schelklingen, Stadt",6 - 10 Jahre,323,169,154
False,8425108,"Schelklingen, Stadt",10 - 15 Jahre,417,213,204
False,8425108,"Schelklingen, Stadt",15 - 18 Jahre,297,165,132
False,8425108,"Schelklingen, Stadt",18 - 20 Jahre,231,141,90
False,8425108,"Schelklingen, Stadt",20 - 25 Jahre,457,242,215
False,8425108,"Schelklingen, Stadt",25 - 30 Jahre,443,264,179
False,8425108,"Schelklingen, Stadt",30 - 35 Jahre,489,269,220
False,8425108,"Schelklingen, Stadt",35 - 40 Jahre,604,324,280
False,8425108,"Schelklingen, Stadt",40 - 45 Jahre,577,293,284
False,8425108,"Schelklingen, Stadt",45 - 50 Jahre,541,281,260
False,8425108,"Schelklingen, Stadt",50 - 55 Jahre,432,218,214
False,8425108,"Schelklingen, Stadt",55 - 60 Jahre,362,178,184
False,8425108,"Schelklingen, Stadt",60 - 65 Jahre,311,147,164
False,8425108,"Schelklingen, Stadt",65 - 75 Jahre,755,352,403
False,8425108,"Schelklingen, Stadt",75 und mehr Jahre,502,182,320
False,8425108,"Schelklingen, Stadt",Insgesamt,7165,3641,3524
False,8425110,Schnürpflingen,unter 3 Jahre,36,18,18
False,8425110,Schnürpflingen,3 -  6 Jahre,35,20,15
False,8425110,Schnürpflingen,6 - 10 Jahre,72,36,36
False,8425110,Schnürpflingen,10 - 15 Jahre,89,36,53
False,8425110,Schnürpflingen,15 - 18 Jahre,69,32,37
False,8425110,Schnürpflingen,18 - 20 Jahre,41,23,18
False,8425110,Schnürpflingen,20 - 25 Jahre,98,46,52
False,8425110,Schnürpflingen,25 - 30 Jahre,74,41,33
False,8425110,Schnürpflingen,30 - 35 Jahre,83,42,41
False,8425110,Schnürpflingen,35 - 40 Jahre,108,54,54
False,8425110,Schnürpflingen,40 - 45 Jahre,105,48,57
False,8425110,Schnürpflingen,45 - 50 Jahre,124,63,61
False,8425110,Schnürpflingen,50 - 55 Jahre,96,50,46
False,8425110,Schnürpflingen,55 - 60 Jahre,88,52,36
False,8425110,Schnürpflingen,60 - 65 Jahre,61,30,31
False,8425110,Schnürpflingen,65 - 75 Jahre,91,41,50
False,8425110,Schnürpflingen,75 und mehr Jahre,90,37,53
False,8425110,Schnürpflingen,Insgesamt,1360,669,691
False,8425112,Setzingen,unter 3 Jahre,17,13,4
False,8425112,Setzingen,3 -  6 Jahre,24,15,9
False,8425112,Setzingen,6 - 10 Jahre,36,22,14
False,8425112,Setzingen,10 - 15 Jahre,36,20,16
False,8425112,Setzingen,15 - 18 Jahre,28,12,16
False,8425112,Setzingen,18 - 20 Jahre,19,11,8
False,8425112,Setzingen,20 - 25 Jahre,43,23,20
False,8425112,Setzingen,25 - 30 Jahre,26,13,13
False,8425112,Setzingen,30 - 35 Jahre,41,17,24
False,8425112,Setzingen,35 - 40 Jahre,46,20,26
False,8425112,Setzingen,40 - 45 Jahre,65,38,27
False,8425112,Setzingen,45 - 50 Jahre,51,25,26
False,8425112,Setzingen,50 - 55 Jahre,38,18,20
False,8425112,Setzingen,55 - 60 Jahre,42,23,19
False,8425112,Setzingen,60 - 65 Jahre,40,21,19
False,8425112,Setzingen,65 - 75 Jahre,48,25,23
False,8425112,Setzingen,75 und mehr Jahre,36,8,28
False,8425112,Setzingen,Insgesamt,636,324,312
False,8425123,Untermarchtal,unter 3 Jahre,22,10,12
False,8425123,Untermarchtal,3 -  6 Jahre,29,17,12
False,8425123,Untermarchtal,6 - 10 Jahre,45,21,24
False,8425123,Untermarchtal,10 - 15 Jahre,48,22,26
False,8425123,Untermarchtal,15 - 18 Jahre,25,15,10
False,8425123,Untermarchtal,18 - 20 Jahre,20,11,9
False,8425123,Untermarchtal,20 - 25 Jahre,30,18,12
False,8425123,Untermarchtal,25 - 30 Jahre,35,15,20
False,8425123,Untermarchtal,30 - 35 Jahre,43,22,21
False,8425123,Untermarchtal,35 - 40 Jahre,70,33,37
False,8425123,Untermarchtal,40 - 45 Jahre,63,27,36
False,8425123,Untermarchtal,45 - 50 Jahre,52,24,28
False,8425123,Untermarchtal,50 - 55 Jahre,54,26,28
False,8425123,Untermarchtal,55 - 60 Jahre,35,16,19
False,8425123,Untermarchtal,60 - 65 Jahre,38,13,25
False,8425123,Untermarchtal,65 - 75 Jahre,124,24,100
False,8425123,Untermarchtal,75 und mehr Jahre,214,25,189
False,8425123,Untermarchtal,Insgesamt,947,339,608
False,8425124,Unterstadion,unter 3 Jahre,29,10,19
False,8425124,Unterstadion,3 -  6 Jahre,32,14,18
False,8425124,Unterstadion,6 - 10 Jahre,42,23,19
False,8425124,Unterstadion,10 - 15 Jahre,55,34,21
False,8425124,Unterstadion,15 - 18 Jahre,28,6,22
False,8425124,Unterstadion,18 - 20 Jahre,21,10,11
False,8425124,Unterstadion,20 - 25 Jahre,43,18,25
False,8425124,Unterstadion,25 - 30 Jahre,40,20,20
False,8425124,Unterstadion,30 - 35 Jahre,51,22,29
False,8425124,Unterstadion,35 - 40 Jahre,73,39,34
False,8425124,Unterstadion,40 - 45 Jahre,52,26,26
False,8425124,Unterstadion,45 - 50 Jahre,55,28,27
False,8425124,Unterstadion,50 - 55 Jahre,52,29,23
False,8425124,Unterstadion,55 - 60 Jahre,47,27,20
False,8425124,Unterstadion,60 - 65 Jahre,23,9,14
False,8425124,Unterstadion,65 - 75 Jahre,49,22,27
False,8425124,Unterstadion,75 und mehr Jahre,36,15,21
False,8425124,Unterstadion,Insgesamt,728,352,376
False,8425125,Unterwachingen,unter 3 Jahre,9,4,5
False,8425125,Unterwachingen,3 -  6 Jahre,7,6,1
False,8425125,Unterwachingen,6 - 10 Jahre,12,7,5
False,8425125,Unterwachingen,10 - 15 Jahre,9,5,4
False,8425125,Unterwachingen,15 - 18 Jahre,7,4,3
False,8425125,Unterwachingen,18 - 20 Jahre,2,2,0
False,8425125,Unterwachingen,20 - 25 Jahre,8,4,4
False,8425125,Unterwachingen,25 - 30 Jahre,12,3,9
False,8425125,Unterwachingen,30 - 35 Jahre,13,7,6
False,8425125,Unterwachingen,35 - 40 Jahre,17,10,7
False,8425125,Unterwachingen,40 - 45 Jahre,11,8,3
False,8425125,Unterwachingen,45 - 50 Jahre,7,3,4
False,8425125,Unterwachingen,50 - 55 Jahre,12,7,5
False,8425125,Unterwachingen,55 - 60 Jahre,12,7,5
False,8425125,Unterwachingen,60 - 65 Jahre,9,4,5
False,8425125,Unterwachingen,65 - 75 Jahre,21,10,11
False,8425125,Unterwachingen,75 und mehr Jahre,12,2,10
False,8425125,Unterwachingen,Insgesamt,180,93,87
False,8425130,Weidenstetten,unter 3 Jahre,41,17,24
False,8425130,Weidenstetten,3 -  6 Jahre,47,23,24
False,8425130,Weidenstetten,6 - 10 Jahre,66,33,33
False,8425130,Weidenstetten,10 - 15 Jahre,84,48,36
False,8425130,Weidenstetten,15 - 18 Jahre,36,19,17
False,8425130,Weidenstetten,18 - 20 Jahre,26,14,12
False,8425130,Weidenstetten,20 - 25 Jahre,59,30,29
False,8425130,Weidenstetten,25 - 30 Jahre,63,29,34
False,8425130,Weidenstetten,30 - 35 Jahre,69,38,31
False,8425130,Weidenstetten,35 - 40 Jahre,111,58,53
False,8425130,Weidenstetten,40 - 45 Jahre,95,56,39
False,8425130,Weidenstetten,45 - 50 Jahre,105,54,51
False,8425130,Weidenstetten,50 - 55 Jahre,66,35,31
False,8425130,Weidenstetten,55 - 60 Jahre,59,29,30
False,8425130,Weidenstetten,60 - 65 Jahre,56,29,27
False,8425130,Weidenstetten,65 - 75 Jahre,162,79,83
False,8425130,Weidenstetten,75 und mehr Jahre,80,36,44
False,8425130,Weidenstetten,Insgesamt,1225,627,598
False,8425134,Westerheim,unter 3 Jahre,108,57,51
False,8425134,Westerheim,3 -  6 Jahre,110,59,51
False,8425134,Westerheim,6 - 10 Jahre,139,70,69
False,8425134,Westerheim,10 - 15 Jahre,175,95,80
False,8425134,Westerheim,15 - 18 Jahre,120,68,52
False,8425134,Westerheim,18 - 20 Jahre,68,32,36
False,8425134,Westerheim,20 - 25 Jahre,168,80,88
False,8425134,Westerheim,25 - 30 Jahre,155,70,85
False,8425134,Westerheim,30 - 35 Jahre,179,85,94
False,8425134,Westerheim,35 - 40 Jahre,238,128,110
False,8425134,Westerheim,40 - 45 Jahre,247,126,121
False,8425134,Westerheim,45 - 50 Jahre,192,92,100
False,8425134,Westerheim,50 - 55 Jahre,197,99,98
False,8425134,Westerheim,55 - 60 Jahre,144,72,72
False,8425134,Westerheim,60 - 65 Jahre,158,76,82
False,8425134,Westerheim,65 - 75 Jahre,308,154,154
False,8425134,Westerheim,75 und mehr Jahre,142,54,88
False,8425134,Westerheim,Insgesamt,2848,1417,1431
False,8425135,Westerstetten,unter 3 Jahre,65,28,37
False,8425135,Westerstetten,3 -  6 Jahre,84,42,42
False,8425135,Westerstetten,6 - 10 Jahre,106,56,50
False,8425135,Westerstetten,10 - 15 Jahre,161,81,80
False,8425135,Westerstetten,15 - 18 Jahre,91,55,36
False,8425135,Westerstetten,18 - 20 Jahre,56,26,30
False,8425135,Westerstetten,20 - 25 Jahre,151,90,61
False,8425135,Westerstetten,25 - 30 Jahre,124,66,58
False,8425135,Westerstetten,30 - 35 Jahre,162,76,86
False,8425135,Westerstetten,35 - 40 Jahre,159,79,80
False,8425135,Westerstetten,40 - 45 Jahre,204,100,104
False,8425135,Westerstetten,45 - 50 Jahre,206,101,105
False,8425135,Westerstetten,50 - 55 Jahre,150,87,63
False,8425135,Westerstetten,55 - 60 Jahre,111,53,58
False,8425135,Westerstetten,60 - 65 Jahre,102,57,45
False,8425135,Westerstetten,65 - 75 Jahre,154,70,84
False,8425135,Westerstetten,75 und mehr Jahre,127,39,88
False,8425135,Westerstetten,Insgesamt,2213,1106,1107
False,8425137,Illerkirchberg,unter 3 Jahre,137,72,65
False,8425137,Illerkirchberg,3 -  6 Jahre,138,71,67
False,8425137,Illerkirchberg,6 - 10 Jahre,228,104,124
False,8425137,Illerkirchberg,10 - 15 Jahre,284,145,139
False,8425137,Illerkirchberg,15 - 18 Jahre,177,76,101
False,8425137,Illerkirchberg,18 - 20 Jahre,110,46,64
False,8425137,Illerkirchberg,20 - 25 Jahre,258,141,117
False,8425137,Illerkirchberg,25 - 30 Jahre,251,128,123
False,8425137,Illerkirchberg,30 - 35 Jahre,274,134,140
False,8425137,Illerkirchberg,35 - 40 Jahre,414,219,195
False,8425137,Illerkirchberg,40 - 45 Jahre,401,212,189
False,8425137,Illerkirchberg,45 - 50 Jahre,352,171,181
False,8425137,Illerkirchberg,50 - 55 Jahre,364,197,167
False,8425137,Illerkirchberg,55 - 60 Jahre,304,156,148
False,8425137,Illerkirchberg,60 - 65 Jahre,238,120,118
False,8425137,Illerkirchberg,65 - 75 Jahre,478,242,236
False,8425137,Illerkirchberg,75 und mehr Jahre,338,128,210
False,8425137,Illerkirchberg,Insgesamt,4746,2362,2384
False,8425138,Staig,unter 3 Jahre,63,35,28
False,8425138,Staig,3 -  6 Jahre,92,47,45
False,8425138,Staig,6 - 10 Jahre,161,86,75
False,8425138,Staig,10 - 15 Jahre,193,105,88
False,8425138,Staig,15 - 18 Jahre,130,58,72
False,8425138,Staig,18 - 20 Jahre,76,34,42
False,8425138,Staig,20 - 25 Jahre,186,105,81
False,8425138,Staig,25 - 30 Jahre,147,66,81
False,8425138,Staig,30 - 35 Jahre,167,80,87
False,8425138,Staig,35 - 40 Jahre,260,118,142
False,8425138,Staig,40 - 45 Jahre,309,137,172
False,8425138,Staig,45 - 50 Jahre,266,138,128
False,8425138,Staig,50 - 55 Jahre,226,121,105
False,8425138,Staig,55 - 60 Jahre,178,94,84
False,8425138,Staig,60 - 65 Jahre,173,89,84
False,8425138,Staig,65 - 75 Jahre,353,183,170
False,8425138,Staig,75 und mehr Jahre,222,86,136
False,8425138,Staig,Insgesamt,3202,1582,1620
False,8425139,Heroldstatt,unter 3 Jahre,81,40,41
False,8425139,Heroldstatt,3 -  6 Jahre,82,40,42
False,8425139,Heroldstatt,6 - 10 Jahre,152,79,73
False,8425139,Heroldstatt,10 - 15 Jahre,195,101,94
False,8425139,Heroldstatt,15 - 18 Jahre,109,64,45
False,8425139,Heroldstatt,18 - 20 Jahre,57,38,19
False,8425139,Heroldstatt,20 - 25 Jahre,124,68,56
False,8425139,Heroldstatt,25 - 30 Jahre,123,62,61
False,8425139,Heroldstatt,30 - 35 Jahre,152,74,78
False,8425139,Heroldstatt,35 - 40 Jahre,222,117,105
False,8425139,Heroldstatt,40 - 45 Jahre,275,144,131
False,8425139,Heroldstatt,45 - 50 Jahre,208,115,93
False,8425139,Heroldstatt,50 - 55 Jahre,143,74,69
False,8425139,Heroldstatt,55 - 60 Jahre,132,66,66
False,8425139,Heroldstatt,60 - 65 Jahre,115,59,56
False,8425139,Heroldstatt,65 - 75 Jahre,248,115,133
False,8425139,Heroldstatt,75 und mehr Jahre,190,57,133
False,8425139,Heroldstatt,Insgesamt,2608,1313,1295
False,8425140,Balzheim,unter 3 Jahre,71,43,28
False,8425140,Balzheim,3 -  6 Jahre,68,39,29
False,8425140,Balzheim,6 - 10 Jahre,123,59,64
False,8425140,Balzheim,10 - 15 Jahre,134,66,68
False,8425140,Balzheim,15 - 18 Jahre,93,56,37
False,8425140,Balzheim,18 - 20 Jahre,63,40,23
False,8425140,Balzheim,20 - 25 Jahre,104,65,39
False,8425140,Balzheim,25 - 30 Jahre,106,58,48
False,8425140,Balzheim,30 - 35 Jahre,101,59,42
False,8425140,Balzheim,35 - 40 Jahre,201,97,104
False,8425140,Balzheim,40 - 45 Jahre,200,105,95
False,8425140,Balzheim,45 - 50 Jahre,181,86,95
False,8425140,Balzheim,50 - 55 Jahre,132,80,52
False,8425140,Balzheim,55 - 60 Jahre,103,57,46
False,8425140,Balzheim,60 - 65 Jahre,79,31,48
False,8425140,Balzheim,65 - 75 Jahre,164,88,76
False,8425140,Balzheim,75 und mehr Jahre,97,41,56
False,8425140,Balzheim,Insgesamt,2020,1070,950
False,8425141,Blaustein,unter 3 Jahre,462,233,229
False,8425141,Blaustein,3 -  6 Jahre,470,239,231
False,8425141,Blaustein,6 - 10 Jahre,662,333,329
False,8425141,Blaustein,10 - 15 Jahre,790,411,379
False,8425141,Blaustein,15 - 18 Jahre,520,248,272
False,8425141,Blaustein,18 - 20 Jahre,321,174,147
False,8425141,Blaustein,20 - 25 Jahre,845,438,407
False,8425141,Blaustein,25 - 30 Jahre,902,473,429
False,8425141,Blaustein,30 - 35 Jahre,1046,542,504
False,8425141,Blaustein,35 - 40 Jahre,1348,701,647
False,8425141,Blaustein,40 - 45 Jahre,1358,682,676
False,8425141,Blaustein,45 - 50 Jahre,1113,566,547
False,8425141,Blaustein,50 - 55 Jahre,917,474,443
False,8425141,Blaustein,55 - 60 Jahre,810,405,405
False,8425141,Blaustein,60 - 65 Jahre,820,385,435
False,8425141,Blaustein,65 - 75 Jahre,1619,796,823
False,8425141,Blaustein,75 und mehr Jahre,1151,468,683
False,8425141,Blaustein,Insgesamt,15154,7568,7586
False,8426,Landkreis Biberach,unter 3 Jahre,5625,2878,2747
False,8426,Landkreis Biberach,3 -  6 Jahre,6089,3077,3012
False,8426,Landkreis Biberach,6 - 10 Jahre,9396,4748,4648
False,8426,Landkreis Biberach,10 - 15 Jahre,12310,6238,6072
False,8426,Landkreis Biberach,15 - 18 Jahre,7952,4112,3840
False,8426,Landkreis Biberach,18 - 20 Jahre,5035,2625,2410
False,8426,Landkreis Biberach,20 - 25 Jahre,11224,5796,5428
False,8426,Landkreis Biberach,25 - 30 Jahre,10491,5345,5146
False,8426,Landkreis Biberach,30 - 35 Jahre,11803,5918,5885
False,8426,Landkreis Biberach,35 - 40 Jahre,15507,7947,7560
False,8426,Landkreis Biberach,40 - 45 Jahre,16002,8301,7701
False,8426,Landkreis Biberach,45 - 50 Jahre,14460,7294,7166
False,8426,Landkreis Biberach,50 - 55 Jahre,12169,6269,5900
False,8426,Landkreis Biberach,55 - 60 Jahre,10106,5237,4869
False,8426,Landkreis Biberach,60 - 65 Jahre,8522,4289,4233
False,8426,Landkreis Biberach,65 - 75 Jahre,18152,8675,9477
False,8426,Landkreis Biberach,75 und mehr Jahre,13689,4752,8937
False,8426,Landkreis Biberach,Insgesamt,188532,93501,95031
False,8426001,Achstetten,unter 3 Jahre,134,72,62
False,8426001,Achstetten,3 -  6 Jahre,147,72,75
False,8426001,Achstetten,6 - 10 Jahre,174,98,76
False,8426001,Achstetten,10 - 15 Jahre,274,128,146
False,8426001,Achstetten,15 - 18 Jahre,167,83,84
False,8426001,Achstetten,18 - 20 Jahre,109,52,57
False,8426001,Achstetten,20 - 25 Jahre,231,120,111
False,8426001,Achstetten,25 - 30 Jahre,256,139,117
False,8426001,Achstetten,30 - 35 Jahre,283,147,136
False,8426001,Achstetten,35 - 40 Jahre,351,188,163
False,8426001,Achstetten,40 - 45 Jahre,360,174,186
False,8426001,Achstetten,45 - 50 Jahre,274,138,136
False,8426001,Achstetten,50 - 55 Jahre,255,115,140
False,8426001,Achstetten,55 - 60 Jahre,229,123,106
False,8426001,Achstetten,60 - 65 Jahre,162,95,67
False,8426001,Achstetten,65 - 75 Jahre,291,144,147
False,8426001,Achstetten,75 und mehr Jahre,228,79,149
False,8426001,Achstetten,Insgesamt,3925,1967,1958
False,8426005,Alleshausen,unter 3 Jahre,15,7,8
False,8426005,Alleshausen,3 -  6 Jahre,19,8,11
False,8426005,Alleshausen,6 - 10 Jahre,34,21,13
False,8426005,Alleshausen,10 - 15 Jahre,37,19,18
False,8426005,Alleshausen,15 - 18 Jahre,23,12,11
False,8426005,Alleshausen,18 - 20 Jahre,18,12,6
False,8426005,Alleshausen,20 - 25 Jahre,38,20,18
False,8426005,Alleshausen,25 - 30 Jahre,23,9,14
False,8426005,Alleshausen,30 - 35 Jahre,18,13,5
False,8426005,Alleshausen,35 - 40 Jahre,48,20,28
False,8426005,Alleshausen,40 - 45 Jahre,43,25,18
False,8426005,Alleshausen,45 - 50 Jahre,40,19,21
False,8426005,Alleshausen,50 - 55 Jahre,23,13,10
False,8426005,Alleshausen,55 - 60 Jahre,27,16,11
False,8426005,Alleshausen,60 - 65 Jahre,8,3,5
False,8426005,Alleshausen,65 - 75 Jahre,40,17,23
False,8426005,Alleshausen,75 und mehr Jahre,51,19,32
False,8426005,Alleshausen,Insgesamt,505,253,252
False,8426006,Allmannsweiler,unter 3 Jahre,7,2,5
False,8426006,Allmannsweiler,3 -  6 Jahre,16,8,8
False,8426006,Allmannsweiler,6 - 10 Jahre,20,6,14
False,8426006,Allmannsweiler,10 - 15 Jahre,26,10,16
False,8426006,Allmannsweiler,15 - 18 Jahre,14,7,7
False,8426006,Allmannsweiler,18 - 20 Jahre,13,9,4
False,8426006,Allmannsweiler,20 - 25 Jahre,20,10,10
False,8426006,Allmannsweiler,25 - 30 Jahre,13,6,7
False,8426006,Allmannsweiler,30 - 35 Jahre,17,7,10
False,8426006,Allmannsweiler,35 - 40 Jahre,27,13,14
False,8426006,Allmannsweiler,40 - 45 Jahre,39,20,19
False,8426006,Allmannsweiler,45 - 50 Jahre,22,12,10
False,8426006,Allmannsweiler,50 - 55 Jahre,21,14,7
False,8426006,Allmannsweiler,55 - 60 Jahre,7,3,4
False,8426006,Allmannsweiler,60 - 65 Jahre,10,6,4
False,8426006,Allmannsweiler,65 - 75 Jahre,30,13,17
False,8426006,Allmannsweiler,75 und mehr Jahre,15,11,4
False,8426006,Allmannsweiler,Insgesamt,317,157,160
False,8426008,Altheim,unter 3 Jahre,74,45,29
False,8426008,Altheim,3 -  6 Jahre,69,34,35
False,8426008,Altheim,6 - 10 Jahre,126,54,72
False,8426008,Altheim,10 - 15 Jahre,147,60,87
False,8426008,Altheim,15 - 18 Jahre,104,54,50
False,8426008,Altheim,18 - 20 Jahre,57,33,24
False,8426008,Altheim,20 - 25 Jahre,122,69,53
False,8426008,Altheim,25 - 30 Jahre,126,70,56
False,8426008,Altheim,30 - 35 Jahre,145,61,84
False,8426008,Altheim,35 - 40 Jahre,207,108,99
False,8426008,Altheim,40 - 45 Jahre,192,102,90
False,8426008,Altheim,45 - 50 Jahre,197,95,102
False,8426008,Altheim,50 - 55 Jahre,140,82,58
False,8426008,Altheim,55 - 60 Jahre,133,70,63
False,8426008,Altheim,60 - 65 Jahre,97,52,45
False,8426008,Altheim,65 - 75 Jahre,196,99,97
False,8426008,Altheim,75 und mehr Jahre,150,53,97
False,8426008,Altheim,Insgesamt,2282,1141,1141
False,8426011,Attenweiler,unter 3 Jahre,56,30,26
False,8426011,Attenweiler,3 -  6 Jahre,66,40,26
False,8426011,Attenweiler,6 - 10 Jahre,108,59,49
False,8426011,Attenweiler,10 - 15 Jahre,119,64,55
False,8426011,Attenweiler,15 - 18 Jahre,84,42,42
False,8426011,Attenweiler,18 - 20 Jahre,44,26,18
False,8426011,Attenweiler,20 - 25 Jahre,96,51,45
False,8426011,Attenweiler,25 - 30 Jahre,87,43,44
False,8426011,Attenweiler,30 - 35 Jahre,101,64,37
False,8426011,Attenweiler,35 - 40 Jahre,166,80,86
False,8426011,Attenweiler,40 - 45 Jahre,150,91,59
False,8426011,Attenweiler,45 - 50 Jahre,131,73,58
False,8426011,Attenweiler,50 - 55 Jahre,120,60,60
False,8426011,Attenweiler,55 - 60 Jahre,71,39,32
False,8426011,Attenweiler,60 - 65 Jahre,79,39,40
False,8426011,Attenweiler,65 - 75 Jahre,170,86,84
False,8426011,Attenweiler,75 und mehr Jahre,86,31,55
False,8426011,Attenweiler,Insgesamt,1734,918,816
False,8426013,"Bad Buchau, Stadt",unter 3 Jahre,96,50,46
False,8426013,"Bad Buchau, Stadt",3 -  6 Jahre,98,45,53
False,8426013,"Bad Buchau, Stadt",6 - 10 Jahre,174,85,89
False,8426013,"Bad Buchau, Stadt",10 - 15 Jahre,232,112,120
False,8426013,"Bad Buchau, Stadt",15 - 18 Jahre,153,92,61
False,8426013,"Bad Buchau, Stadt",18 - 20 Jahre,101,53,48
False,8426013,"Bad Buchau, Stadt",20 - 25 Jahre,245,136,109
False,8426013,"Bad Buchau, Stadt",25 - 30 Jahre,186,102,84
False,8426013,"Bad Buchau, Stadt",30 - 35 Jahre,234,123,111
False,8426013,"Bad Buchau, Stadt",35 - 40 Jahre,306,160,146
False,8426013,"Bad Buchau, Stadt",40 - 45 Jahre,293,174,119
False,8426013,"Bad Buchau, Stadt",45 - 50 Jahre,310,136,174
False,8426013,"Bad Buchau, Stadt",50 - 55 Jahre,257,121,136
False,8426013,"Bad Buchau, Stadt",55 - 60 Jahre,254,119,135
False,8426013,"Bad Buchau, Stadt",60 - 65 Jahre,239,126,113
False,8426013,"Bad Buchau, Stadt",65 - 75 Jahre,490,232,258
False,8426013,"Bad Buchau, Stadt",75 und mehr Jahre,412,129,283
False,8426013,"Bad Buchau, Stadt",Insgesamt,4080,1995,2085
False,8426014,"Bad Schussenried, Stadt",unter 3 Jahre,254,122,132
False,8426014,"Bad Schussenried, Stadt",3 -  6 Jahre,276,151,125
False,8426014,"Bad Schussenried, Stadt",6 - 10 Jahre,398,220,178
False,8426014,"Bad Schussenried, Stadt",10 - 15 Jahre,499,258,241
False,8426014,"Bad Schussenried, Stadt",15 - 18 Jahre,343,174,169
False,8426014,"Bad Schussenried, Stadt",18 - 20 Jahre,195,100,95
False,8426014,"Bad Schussenried, Stadt",20 - 25 Jahre,464,216,248
False,8426014,"Bad Schussenried, Stadt",25 - 30 Jahre,406,201,205
False,8426014,"Bad Schussenried, Stadt",30 - 35 Jahre,455,226,229
False,8426014,"Bad Schussenried, Stadt",35 - 40 Jahre,649,335,314
False,8426014,"Bad Schussenried, Stadt",40 - 45 Jahre,721,360,361
False,8426014,"Bad Schussenried, Stadt",45 - 50 Jahre,668,335,333
False,8426014,"Bad Schussenried, Stadt",50 - 55 Jahre,562,297,265
False,8426014,"Bad Schussenried, Stadt",55 - 60 Jahre,427,223,204
False,8426014,"Bad Schussenried, Stadt",60 - 65 Jahre,432,230,202
False,8426014,"Bad Schussenried, Stadt",65 - 75 Jahre,923,450,473
False,8426014,"Bad Schussenried, Stadt",75 und mehr Jahre,786,268,518
False,8426014,"Bad Schussenried, Stadt",Insgesamt,8458,4166,4292
False,8426019,Berkheim,unter 3 Jahre,83,44,39
False,8426019,Berkheim,3 -  6 Jahre,74,39,35
False,8426019,Berkheim,6 - 10 Jahre,152,80,72
False,8426019,Berkheim,10 - 15 Jahre,167,86,81
False,8426019,Berkheim,15 - 18 Jahre,110,61,49
False,8426019,Berkheim,18 - 20 Jahre,79,39,40
False,8426019,Berkheim,20 - 25 Jahre,162,88,74
False,8426019,Berkheim,25 - 30 Jahre,182,90,92
False,8426019,Berkheim,30 - 35 Jahre,213,84,129
False,8426019,Berkheim,35 - 40 Jahre,214,112,102
False,8426019,Berkheim,40 - 45 Jahre,189,100,89
False,8426019,Berkheim,45 - 50 Jahre,184,93,91
False,8426019,Berkheim,50 - 55 Jahre,205,106,99
False,8426019,Berkheim,55 - 60 Jahre,159,89,70
False,8426019,Berkheim,60 - 65 Jahre,113,56,57
False,8426019,Berkheim,65 - 75 Jahre,227,110,117
False,8426019,Berkheim,75 und mehr Jahre,170,62,108
False,8426019,Berkheim,Insgesamt,2683,1339,1344
False,8426020,Betzenweiler,unter 3 Jahre,19,10,9
False,8426020,Betzenweiler,3 -  6 Jahre,37,18,19
False,8426020,Betzenweiler,6 - 10 Jahre,48,22,26
False,8426020,Betzenweiler,10 - 15 Jahre,48,28,20
False,8426020,Betzenweiler,15 - 18 Jahre,43,24,19
False,8426020,Betzenweiler,18 - 20 Jahre,20,10,10
False,8426020,Betzenweiler,20 - 25 Jahre,50,30,20
False,8426020,Betzenweiler,25 - 30 Jahre,35,19,16
False,8426020,Betzenweiler,30 - 35 Jahre,48,25,23
False,8426020,Betzenweiler,35 - 40 Jahre,61,25,36
False,8426020,Betzenweiler,40 - 45 Jahre,61,37,24
False,8426020,Betzenweiler,45 - 50 Jahre,46,18,28
False,8426020,Betzenweiler,50 - 55 Jahre,53,31,22
False,8426020,Betzenweiler,55 - 60 Jahre,36,21,15
False,8426020,Betzenweiler,60 - 65 Jahre,24,9,15
False,8426020,Betzenweiler,65 - 75 Jahre,54,22,32
False,8426020,Betzenweiler,75 und mehr Jahre,39,15,24
False,8426020,Betzenweiler,Insgesamt,722,364,358
False,8426021,"Biberach an der Riß, Stadt",unter 3 Jahre,874,431,443
False,8426021,"Biberach an der Riß, Stadt",3 -  6 Jahre,881,446,435
False,8426021,"Biberach an der Riß, Stadt",6 - 10 Jahre,1365,685,680
False,8426021,"Biberach an der Riß, Stadt",10 - 15 Jahre,1812,944,868
False,8426021,"Biberach an der Riß, Stadt",15 - 18 Jahre,1199,575,624
False,8426021,"Biberach an der Riß, Stadt",18 - 20 Jahre,771,392,379
False,8426021,"Biberach an der Riß, Stadt",20 - 25 Jahre,1900,919,981
False,8426021,"Biberach an der Riß, Stadt",25 - 30 Jahre,1920,943,977
False,8426021,"Biberach an der Riß, Stadt",30 - 35 Jahre,1981,1005,976
False,8426021,"Biberach an der Riß, Stadt",35 - 40 Jahre,2547,1333,1214
False,8426021,"Biberach an der Riß, Stadt",40 - 45 Jahre,2553,1310,1243
False,8426021,"Biberach an der Riß, Stadt",45 - 50 Jahre,2413,1170,1243
False,8426021,"Biberach an der Riß, Stadt",50 - 55 Jahre,2057,1003,1054
False,8426021,"Biberach an der Riß, Stadt",55 - 60 Jahre,1865,915,950
False,8426021,"Biberach an der Riß, Stadt",60 - 65 Jahre,1589,771,818
False,8426021,"Biberach an der Riß, Stadt",65 - 75 Jahre,3625,1657,1968
False,8426021,"Biberach an der Riß, Stadt",75 und mehr Jahre,2930,1004,1926
False,8426021,"Biberach an der Riß, Stadt",Insgesamt,32282,15503,16779
False,8426028,Burgrieden,unter 3 Jahre,103,52,51
False,8426028,Burgrieden,3 -  6 Jahre,134,74,60
False,8426028,Burgrieden,6 - 10 Jahre,211,99,112
False,8426028,Burgrieden,10 - 15 Jahre,267,135,132
False,8426028,Burgrieden,15 - 18 Jahre,154,88,66
False,8426028,Burgrieden,18 - 20 Jahre,91,54,37
False,8426028,Burgrieden,20 - 25 Jahre,195,105,90
False,8426028,Burgrieden,25 - 30 Jahre,166,86,80
False,8426028,Burgrieden,30 - 35 Jahre,216,95,121
False,8426028,Burgrieden,35 - 40 Jahre,353,183,170
False,8426028,Burgrieden,40 - 45 Jahre,381,205,176
False,8426028,Burgrieden,45 - 50 Jahre,286,151,135
False,8426028,Burgrieden,50 - 55 Jahre,222,118,104
False,8426028,Burgrieden,55 - 60 Jahre,160,87,73
False,8426028,Burgrieden,60 - 65 Jahre,151,86,65
False,8426028,Burgrieden,65 - 75 Jahre,277,121,156
False,8426028,Burgrieden,75 und mehr Jahre,219,95,124
False,8426028,Burgrieden,Insgesamt,3586,1834,1752
False,8426031,Dettingen an der Iller,unter 3 Jahre,72,35,37
False,8426031,Dettingen an der Iller,3 -  6 Jahre,94,48,46
False,8426031,Dettingen an der Iller,6 - 10 Jahre,128,61,67
False,8426031,Dettingen an der Iller,10 - 15 Jahre,172,87,85
False,8426031,Dettingen an der Iller,15 - 18 Jahre,139,75,64
False,8426031,Dettingen an der Iller,18 - 20 Jahre,65,28,37
False,8426031,Dettingen an der Iller,20 - 25 Jahre,125,59,66
False,8426031,Dettingen an der Iller,25 - 30 Jahre,109,52,57
False,8426031,Dettingen an der Iller,30 - 35 Jahre,145,74,71
False,8426031,Dettingen an der Iller,35 - 40 Jahre,186,100,86
False,8426031,Dettingen an der Iller,40 - 45 Jahre,213,100,113
False,8426031,Dettingen an der Iller,45 - 50 Jahre,187,98,89
False,8426031,Dettingen an der Iller,50 - 55 Jahre,131,71,60
False,8426031,Dettingen an der Iller,55 - 60 Jahre,85,51,34
False,8426031,Dettingen an der Iller,60 - 65 Jahre,93,46,47
False,8426031,Dettingen an der Iller,65 - 75 Jahre,212,100,112
False,8426031,Dettingen an der Iller,75 und mehr Jahre,99,46,53
False,8426031,Dettingen an der Iller,Insgesamt,2255,1131,1124
False,8426035,Dürmentingen,unter 3 Jahre,82,45,37
False,8426035,Dürmentingen,3 -  6 Jahre,103,50,53
False,8426035,Dürmentingen,6 - 10 Jahre,142,73,69
False,8426035,Dürmentingen,10 - 15 Jahre,189,102,87
False,8426035,Dürmentingen,15 - 18 Jahre,116,53,63
False,8426035,Dürmentingen,18 - 20 Jahre,81,44,37
False,8426035,Dürmentingen,20 - 25 Jahre,157,82,75
False,8426035,Dürmentingen,25 - 30 Jahre,148,74,74
False,8426035,Dürmentingen,30 - 35 Jahre,161,98,63
False,8426035,Dürmentingen,35 - 40 Jahre,195,106,89
False,8426035,Dürmentingen,40 - 45 Jahre,197,101,96
False,8426035,Dürmentingen,45 - 50 Jahre,198,110,88
False,8426035,Dürmentingen,50 - 55 Jahre,162,90,72
False,8426035,Dürmentingen,55 - 60 Jahre,137,67,70
False,8426035,Dürmentingen,60 - 65 Jahre,89,40,49
False,8426035,Dürmentingen,65 - 75 Jahre,258,120,138
False,8426035,Dürmentingen,75 und mehr Jahre,182,69,113
False,8426035,Dürmentingen,Insgesamt,2597,1324,1273
False,8426036,Dürnau,unter 3 Jahre,10,5,5
False,8426036,Dürnau,3 -  6 Jahre,19,9,10
False,8426036,Dürnau,6 - 10 Jahre,33,17,16
False,8426036,Dürnau,10 - 15 Jahre,23,12,11
False,8426036,Dürnau,15 - 18 Jahre,20,11,9
False,8426036,Dürnau,18 - 20 Jahre,12,8,4
False,8426036,Dürnau,20 - 25 Jahre,32,18,14
False,8426036,Dürnau,25 - 30 Jahre,24,15,9
False,8426036,Dürnau,30 - 35 Jahre,32,16,16
False,8426036,Dürnau,35 - 40 Jahre,46,24,22
False,8426036,Dürnau,40 - 45 Jahre,36,17,19
False,8426036,Dürnau,45 - 50 Jahre,23,14,9
False,8426036,Dürnau,50 - 55 Jahre,31,15,16
False,8426036,Dürnau,55 - 60 Jahre,27,13,14
False,8426036,Dürnau,60 - 65 Jahre,13,3,10
False,8426036,Dürnau,65 - 75 Jahre,43,23,20
False,8426036,Dürnau,75 und mehr Jahre,33,14,19
False,8426036,Dürnau,Insgesamt,457,234,223
False,8426038,Eberhardzell,unter 3 Jahre,156,86,70
False,8426038,Eberhardzell,3 -  6 Jahre,126,67,59
False,8426038,Eberhardzell,6 - 10 Jahre,221,109,112
False,8426038,Eberhardzell,10 - 15 Jahre,286,155,131
False,8426038,Eberhardzell,15 - 18 Jahre,187,100,87
False,8426038,Eberhardzell,18 - 20 Jahre,119,63,56
False,8426038,Eberhardzell,20 - 25 Jahre,238,138,100
False,8426038,Eberhardzell,25 - 30 Jahre,202,95,107
False,8426038,Eberhardzell,30 - 35 Jahre,237,107,130
False,8426038,Eberhardzell,35 - 40 Jahre,375,200,175
False,8426038,Eberhardzell,40 - 45 Jahre,359,191,168
False,8426038,Eberhardzell,45 - 50 Jahre,329,162,167
False,8426038,Eberhardzell,50 - 55 Jahre,274,154,120
False,8426038,Eberhardzell,55 - 60 Jahre,185,106,79
False,8426038,Eberhardzell,60 - 65 Jahre,152,72,80
False,8426038,Eberhardzell,65 - 75 Jahre,313,152,161
False,8426038,Eberhardzell,75 und mehr Jahre,277,99,178
False,8426038,Eberhardzell,Insgesamt,4036,2056,1980
False,8426043,Erlenmoos,unter 3 Jahre,52,23,29
False,8426043,Erlenmoos,3 -  6 Jahre,79,27,52
False,8426043,Erlenmoos,6 - 10 Jahre,103,59,44
False,8426043,Erlenmoos,10 - 15 Jahre,109,56,53
False,8426043,Erlenmoos,15 - 18 Jahre,66,40,26
False,8426043,Erlenmoos,18 - 20 Jahre,50,22,28
False,8426043,Erlenmoos,20 - 25 Jahre,97,48,49
False,8426043,Erlenmoos,25 - 30 Jahre,94,46,48
False,8426043,Erlenmoos,30 - 35 Jahre,108,53,55
False,8426043,Erlenmoos,35 - 40 Jahre,169,98,71
False,8426043,Erlenmoos,40 - 45 Jahre,120,66,54
False,8426043,Erlenmoos,45 - 50 Jahre,133,69,64
False,8426043,Erlenmoos,50 - 55 Jahre,95,53,42
False,8426043,Erlenmoos,55 - 60 Jahre,81,50,31
False,8426043,Erlenmoos,60 - 65 Jahre,54,25,29
False,8426043,Erlenmoos,65 - 75 Jahre,166,90,76
False,8426043,Erlenmoos,75 und mehr Jahre,92,32,60
False,8426043,Erlenmoos,Insgesamt,1668,857,811
False,8426044,Erolzheim,unter 3 Jahre,94,53,41
False,8426044,Erolzheim,3 -  6 Jahre,100,55,45
False,8426044,Erolzheim,6 - 10 Jahre,138,65,73
False,8426044,Erolzheim,10 - 15 Jahre,213,108,105
False,8426044,Erolzheim,15 - 18 Jahre,156,85,71
False,8426044,Erolzheim,18 - 20 Jahre,94,43,51
False,8426044,Erolzheim,20 - 25 Jahre,210,102,108
False,8426044,Erolzheim,25 - 30 Jahre,140,70,70
False,8426044,Erolzheim,30 - 35 Jahre,176,87,89
False,8426044,Erolzheim,35 - 40 Jahre,246,105,141
False,8426044,Erolzheim,40 - 45 Jahre,298,149,149
False,8426044,Erolzheim,45 - 50 Jahre,254,118,136
False,8426044,Erolzheim,50 - 55 Jahre,211,112,99
False,8426044,Erolzheim,55 - 60 Jahre,167,89,78
False,8426044,Erolzheim,60 - 65 Jahre,119,66,53
False,8426044,Erolzheim,65 - 75 Jahre,276,134,142
False,8426044,Erolzheim,75 und mehr Jahre,227,75,152
False,8426044,Erolzheim,Insgesamt,3119,1516,1603
False,8426045,Ertingen,unter 3 Jahre,172,92,80
False,8426045,Ertingen,3 -  6 Jahre,195,104,91
False,8426045,Ertingen,6 - 10 Jahre,284,158,126
False,8426045,Ertingen,10 - 15 Jahre,386,198,188
False,8426045,Ertingen,15 - 18 Jahre,263,150,113
False,8426045,Ertingen,18 - 20 Jahre,168,103,65
False,8426045,Ertingen,20 - 25 Jahre,341,183,158
False,8426045,Ertingen,25 - 30 Jahre,288,143,145
False,8426045,Ertingen,30 - 35 Jahre,353,174,179
False,8426045,Ertingen,35 - 40 Jahre,441,209,232
False,8426045,Ertingen,40 - 45 Jahre,436,211,225
False,8426045,Ertingen,45 - 50 Jahre,432,211,221
False,8426045,Ertingen,50 - 55 Jahre,358,198,160
False,8426045,Ertingen,55 - 60 Jahre,256,130,126
False,8426045,Ertingen,60 - 65 Jahre,223,115,108
False,8426045,Ertingen,65 - 75 Jahre,537,251,286
False,8426045,Ertingen,75 und mehr Jahre,424,147,277
False,8426045,Ertingen,Insgesamt,5557,2777,2780
False,8426058,Hochdorf,unter 3 Jahre,58,25,33
False,8426058,Hochdorf,3 -  6 Jahre,75,38,37
False,8426058,Hochdorf,6 - 10 Jahre,104,56,48
False,8426058,Hochdorf,10 - 15 Jahre,154,70,84
False,8426058,Hochdorf,15 - 18 Jahre,81,44,37
False,8426058,Hochdorf,18 - 20 Jahre,46,20,26
False,8426058,Hochdorf,20 - 25 Jahre,112,58,54
False,8426058,Hochdorf,25 - 30 Jahre,124,61,63
False,8426058,Hochdorf,30 - 35 Jahre,139,71,68
False,8426058,Hochdorf,35 - 40 Jahre,163,92,71
False,8426058,Hochdorf,40 - 45 Jahre,195,101,94
False,8426058,Hochdorf,45 - 50 Jahre,153,68,85
False,8426058,Hochdorf,50 - 55 Jahre,142,80,62
False,8426058,Hochdorf,55 - 60 Jahre,142,73,69
False,8426058,Hochdorf,60 - 65 Jahre,105,56,49
False,8426058,Hochdorf,65 - 75 Jahre,186,94,92
False,8426058,Hochdorf,75 und mehr Jahre,120,47,73
False,8426058,Hochdorf,Insgesamt,2099,1054,1045
False,8426062,Ingoldingen,unter 3 Jahre,66,38,28
False,8426062,Ingoldingen,3 -  6 Jahre,66,37,29
False,8426062,Ingoldingen,6 - 10 Jahre,134,66,68
False,8426062,Ingoldingen,10 - 15 Jahre,196,105,91
False,8426062,Ingoldingen,15 - 18 Jahre,139,79,60
False,8426062,Ingoldingen,18 - 20 Jahre,75,36,39
False,8426062,Ingoldingen,20 - 25 Jahre,170,76,94
False,8426062,Ingoldingen,25 - 30 Jahre,172,94,78
False,8426062,Ingoldingen,30 - 35 Jahre,130,69,61
False,8426062,Ingoldingen,35 - 40 Jahre,214,112,102
False,8426062,Ingoldingen,40 - 45 Jahre,183,95,88
False,8426062,Ingoldingen,45 - 50 Jahre,205,103,102
False,8426062,Ingoldingen,50 - 55 Jahre,206,105,101
False,8426062,Ingoldingen,55 - 60 Jahre,168,85,83
False,8426062,Ingoldingen,60 - 65 Jahre,147,82,65
False,8426062,Ingoldingen,65 - 75 Jahre,222,116,106
False,8426062,Ingoldingen,75 und mehr Jahre,183,78,105
False,8426062,Ingoldingen,Insgesamt,2676,1376,1300
False,8426064,Kanzach,unter 3 Jahre,13,3,10
False,8426064,Kanzach,3 -  6 Jahre,13,9,4
False,8426064,Kanzach,6 - 10 Jahre,17,8,9
False,8426064,Kanzach,10 - 15 Jahre,41,19,22
False,8426064,Kanzach,15 - 18 Jahre,24,12,12
False,8426064,Kanzach,18 - 20 Jahre,23,11,12
False,8426064,Kanzach,20 - 25 Jahre,40,21,19
False,8426064,Kanzach,25 - 30 Jahre,19,8,11
False,8426064,Kanzach,30 - 35 Jahre,22,10,12
False,8426064,Kanzach,35 - 40 Jahre,32,19,13
False,8426064,Kanzach,40 - 45 Jahre,48,23,25
False,8426064,Kanzach,45 - 50 Jahre,39,21,18
False,8426064,Kanzach,50 - 55 Jahre,41,24,17
False,8426064,Kanzach,55 - 60 Jahre,20,8,12
False,8426064,Kanzach,60 - 65 Jahre,14,7,7
False,8426064,Kanzach,65 - 75 Jahre,50,28,22
False,8426064,Kanzach,75 und mehr Jahre,45,14,31
False,8426064,Kanzach,Insgesamt,501,245,256
False,8426065,Kirchberg an der Iller,unter 3 Jahre,58,31,27
False,8426065,Kirchberg an der Iller,3 -  6 Jahre,64,33,31
False,8426065,Kirchberg an der Iller,6 - 10 Jahre,88,40,48
False,8426065,Kirchberg an der Iller,10 - 15 Jahre,108,47,61
False,8426065,Kirchberg an der Iller,15 - 18 Jahre,94,50,44
False,8426065,Kirchberg an der Iller,18 - 20 Jahre,64,31,33
False,8426065,Kirchberg an der Iller,20 - 25 Jahre,123,73,50
False,8426065,Kirchberg an der Iller,25 - 30 Jahre,103,45,58
False,8426065,Kirchberg an der Iller,30 - 35 Jahre,132,66,66
False,8426065,Kirchberg an der Iller,35 - 40 Jahre,149,69,80
False,8426065,Kirchberg an der Iller,40 - 45 Jahre,173,88,85
False,8426065,Kirchberg an der Iller,45 - 50 Jahre,123,67,56
False,8426065,Kirchberg an der Iller,50 - 55 Jahre,128,66,62
False,8426065,Kirchberg an der Iller,55 - 60 Jahre,120,58,62
False,8426065,Kirchberg an der Iller,60 - 65 Jahre,97,57,40
False,8426065,Kirchberg an der Iller,65 - 75 Jahre,178,82,96
False,8426065,Kirchberg an der Iller,75 und mehr Jahre,124,52,72
False,8426065,Kirchberg an der Iller,Insgesamt,1926,955,971
False,8426066,Kirchdorf an der Iller,unter 3 Jahre,110,53,57
False,8426066,Kirchdorf an der Iller,3 -  6 Jahre,140,74,66
False,8426066,Kirchdorf an der Iller,6 - 10 Jahre,214,128,86
False,8426066,Kirchdorf an der Iller,10 - 15 Jahre,240,117,123
False,8426066,Kirchdorf an der Iller,15 - 18 Jahre,165,71,94
False,8426066,Kirchdorf an der Iller,18 - 20 Jahre,107,57,50
False,8426066,Kirchdorf an der Iller,20 - 25 Jahre,252,123,129
False,8426066,Kirchdorf an der Iller,25 - 30 Jahre,222,120,102
False,8426066,Kirchdorf an der Iller,30 - 35 Jahre,204,96,108
False,8426066,Kirchdorf an der Iller,35 - 40 Jahre,275,142,133
False,8426066,Kirchdorf an der Iller,40 - 45 Jahre,329,168,161
False,8426066,Kirchdorf an der Iller,45 - 50 Jahre,261,137,124
False,8426066,Kirchdorf an der Iller,50 - 55 Jahre,247,122,125
False,8426066,Kirchdorf an der Iller,55 - 60 Jahre,197,112,85
False,8426066,Kirchdorf an der Iller,60 - 65 Jahre,148,65,83
False,8426066,Kirchdorf an der Iller,65 - 75 Jahre,269,127,142
False,8426066,Kirchdorf an der Iller,75 und mehr Jahre,214,82,132
False,8426066,Kirchdorf an der Iller,Insgesamt,3594,1794,1800
False,8426067,Langenenslingen,unter 3 Jahre,124,61,63
False,8426067,Langenenslingen,3 -  6 Jahre,126,59,67
False,8426067,Langenenslingen,6 - 10 Jahre,222,110,112
False,8426067,Langenenslingen,10 - 15 Jahre,271,139,132
False,8426067,Langenenslingen,15 - 18 Jahre,166,84,82
False,8426067,Langenenslingen,18 - 20 Jahre,94,49,45
False,8426067,Langenenslingen,20 - 25 Jahre,187,99,88
False,8426067,Langenenslingen,25 - 30 Jahre,169,90,79
False,8426067,Langenenslingen,30 - 35 Jahre,198,88,110
False,8426067,Langenenslingen,35 - 40 Jahre,291,146,145
False,8426067,Langenenslingen,40 - 45 Jahre,298,148,150
False,8426067,Langenenslingen,45 - 50 Jahre,287,155,132
False,8426067,Langenenslingen,50 - 55 Jahre,190,103,87
False,8426067,Langenenslingen,55 - 60 Jahre,155,81,74
False,8426067,Langenenslingen,60 - 65 Jahre,120,61,59
False,8426067,Langenenslingen,65 - 75 Jahre,377,178,199
False,8426067,Langenenslingen,75 und mehr Jahre,293,102,191
False,8426067,Langenenslingen,Insgesamt,3568,1753,1815
False,8426070,"Laupheim, Stadt",unter 3 Jahre,578,303,275
False,8426070,"Laupheim, Stadt",3 -  6 Jahre,576,274,302
False,8426070,"Laupheim, Stadt",6 - 10 Jahre,832,443,389
False,8426070,"Laupheim, Stadt",10 - 15 Jahre,1155,601,554
False,8426070,"Laupheim, Stadt",15 - 18 Jahre,727,362,365
False,8426070,"Laupheim, Stadt",18 - 20 Jahre,499,276,223
False,8426070,"Laupheim, Stadt",20 - 25 Jahre,1216,628,588
False,8426070,"Laupheim, Stadt",25 - 30 Jahre,1186,617,569
False,8426070,"Laupheim, Stadt",30 - 35 Jahre,1297,674,623
False,8426070,"Laupheim, Stadt",35 - 40 Jahre,1574,817,757
False,8426070,"Laupheim, Stadt",40 - 45 Jahre,1647,875,772
False,8426070,"Laupheim, Stadt",45 - 50 Jahre,1463,729,734
False,8426070,"Laupheim, Stadt",50 - 55 Jahre,1268,660,608
False,8426070,"Laupheim, Stadt",55 - 60 Jahre,1095,570,525
False,8426070,"Laupheim, Stadt",60 - 65 Jahre,939,461,478
False,8426070,"Laupheim, Stadt",65 - 75 Jahre,1800,855,945
False,8426070,"Laupheim, Stadt",75 und mehr Jahre,1340,418,922
False,8426070,"Laupheim, Stadt",Insgesamt,19192,9563,9629
False,8426071,Maselheim,unter 3 Jahre,129,67,62
False,8426071,Maselheim,3 -  6 Jahre,131,58,73
False,8426071,Maselheim,6 - 10 Jahre,228,108,120
False,8426071,Maselheim,10 - 15 Jahre,310,167,143
False,8426071,Maselheim,15 - 18 Jahre,186,96,90
False,8426071,Maselheim,18 - 20 Jahre,148,69,79
False,8426071,Maselheim,20 - 25 Jahre,236,121,115
False,8426071,Maselheim,25 - 30 Jahre,221,115,106
False,8426071,Maselheim,30 - 35 Jahre,260,133,127
False,8426071,Maselheim,35 - 40 Jahre,412,208,204
False,8426071,Maselheim,40 - 45 Jahre,416,204,212
False,8426071,Maselheim,45 - 50 Jahre,369,201,168
False,8426071,Maselheim,50 - 55 Jahre,305,158,147
False,8426071,Maselheim,55 - 60 Jahre,263,144,119
False,8426071,Maselheim,60 - 65 Jahre,204,106,98
False,8426071,Maselheim,65 - 75 Jahre,436,196,240
False,8426071,Maselheim,75 und mehr Jahre,293,115,178
False,8426071,Maselheim,Insgesamt,4547,2266,2281
False,8426073,Mietingen,unter 3 Jahre,139,73,66
False,8426073,Mietingen,3 -  6 Jahre,136,64,72
False,8426073,Mietingen,6 - 10 Jahre,226,110,116
False,8426073,Mietingen,10 - 15 Jahre,300,160,140
False,8426073,Mietingen,15 - 18 Jahre,186,105,81
False,8426073,Mietingen,18 - 20 Jahre,97,42,55
False,8426073,Mietingen,20 - 25 Jahre,265,141,124
False,8426073,Mietingen,25 - 30 Jahre,266,142,124
False,8426073,Mietingen,30 - 35 Jahre,309,169,140
False,8426073,Mietingen,35 - 40 Jahre,350,184,166
False,8426073,Mietingen,40 - 45 Jahre,376,210,166
False,8426073,Mietingen,45 - 50 Jahre,323,164,159
False,8426073,Mietingen,50 - 55 Jahre,238,125,113
False,8426073,Mietingen,55 - 60 Jahre,212,111,101
False,8426073,Mietingen,60 - 65 Jahre,146,74,72
False,8426073,Mietingen,65 - 75 Jahre,267,134,133
False,8426073,Mietingen,75 und mehr Jahre,165,62,103
False,8426073,Mietingen,Insgesamt,4001,2070,1931
False,8426074,Mittelbiberach,unter 3 Jahre,127,60,67
False,8426074,Mittelbiberach,3 -  6 Jahre,155,90,65
False,8426074,Mittelbiberach,6 - 10 Jahre,205,91,114
False,8426074,Mittelbiberach,10 - 15 Jahre,304,146,158
False,8426074,Mittelbiberach,15 - 18 Jahre,179,100,79
False,8426074,Mittelbiberach,18 - 20 Jahre,99,47,52
False,8426074,Mittelbiberach,20 - 25 Jahre,229,114,115
False,8426074,Mittelbiberach,25 - 30 Jahre,213,111,102
False,8426074,Mittelbiberach,30 - 35 Jahre,220,108,112
False,8426074,Mittelbiberach,35 - 40 Jahre,308,134,174
False,8426074,Mittelbiberach,40 - 45 Jahre,383,201,182
False,8426074,Mittelbiberach,45 - 50 Jahre,324,160,164
False,8426074,Mittelbiberach,50 - 55 Jahre,261,132,129
False,8426074,Mittelbiberach,55 - 60 Jahre,245,128,117
False,8426074,Mittelbiberach,60 - 65 Jahre,176,92,84
False,8426074,Mittelbiberach,65 - 75 Jahre,301,138,163
False,8426074,Mittelbiberach,75 und mehr Jahre,184,66,118
False,8426074,Mittelbiberach,Insgesamt,3913,1918,1995
False,8426078,Moosburg,unter 3 Jahre,10,4,6
False,8426078,Moosburg,3 -  6 Jahre,3,0,3
False,8426078,Moosburg,6 - 10 Jahre,11,8,3
False,8426078,Moosburg,10 - 15 Jahre,19,9,10
False,8426078,Moosburg,15 - 18 Jahre,9,5,4
False,8426078,Moosburg,18 - 20 Jahre,7,6,1
False,8426078,Moosburg,20 - 25 Jahre,5,3,2
False,8426078,Moosburg,25 - 30 Jahre,7,1,6
False,8426078,Moosburg,30 - 35 Jahre,8,3,5
False,8426078,Moosburg,35 - 40 Jahre,15,5,10
False,8426078,Moosburg,40 - 45 Jahre,13,9,4
False,8426078,Moosburg,45 - 50 Jahre,7,4,3
False,8426078,Moosburg,50 - 55 Jahre,18,11,7
False,8426078,Moosburg,55 - 60 Jahre,7,3,4
False,8426078,Moosburg,60 - 65 Jahre,9,3,6
False,8426078,Moosburg,65 - 75 Jahre,33,15,18
False,8426078,Moosburg,75 und mehr Jahre,9,5,4
False,8426078,Moosburg,Insgesamt,190,94,96
False,8426087,"Ochsenhausen, Stadt",unter 3 Jahre,260,142,118
False,8426087,"Ochsenhausen, Stadt",3 -  6 Jahre,276,134,142
False,8426087,"Ochsenhausen, Stadt",6 - 10 Jahre,481,261,220
False,8426087,"Ochsenhausen, Stadt",10 - 15 Jahre,638,304,334
False,8426087,"Ochsenhausen, Stadt",15 - 18 Jahre,378,195,183
False,8426087,"Ochsenhausen, Stadt",18 - 20 Jahre,239,120,119
False,8426087,"Ochsenhausen, Stadt",20 - 25 Jahre,538,291,247
False,8426087,"Ochsenhausen, Stadt",25 - 30 Jahre,518,257,261
False,8426087,"Ochsenhausen, Stadt",30 - 35 Jahre,572,268,304
False,8426087,"Ochsenhausen, Stadt",35 - 40 Jahre,749,379,370
False,8426087,"Ochsenhausen, Stadt",40 - 45 Jahre,701,364,337
False,8426087,"Ochsenhausen, Stadt",45 - 50 Jahre,724,389,335
False,8426087,"Ochsenhausen, Stadt",50 - 55 Jahre,576,297,279
False,8426087,"Ochsenhausen, Stadt",55 - 60 Jahre,430,229,201
False,8426087,"Ochsenhausen, Stadt",60 - 65 Jahre,348,166,182
False,8426087,"Ochsenhausen, Stadt",65 - 75 Jahre,800,382,418
False,8426087,"Ochsenhausen, Stadt",75 und mehr Jahre,621,204,417
False,8426087,"Ochsenhausen, Stadt",Insgesamt,8849,4382,4467
False,8426090,Oggelshausen,unter 3 Jahre,38,21,17
False,8426090,Oggelshausen,3 -  6 Jahre,32,17,15
False,8426090,Oggelshausen,6 - 10 Jahre,57,25,32
False,8426090,Oggelshausen,10 - 15 Jahre,60,23,37
False,8426090,Oggelshausen,15 - 18 Jahre,38,21,17
False,8426090,Oggelshausen,18 - 20 Jahre,25,15,10
False,8426090,Oggelshausen,20 - 25 Jahre,31,16,15
False,8426090,Oggelshausen,25 - 30 Jahre,47,22,25
False,8426090,Oggelshausen,30 - 35 Jahre,63,37,26
False,8426090,Oggelshausen,35 - 40 Jahre,71,34,37
False,8426090,Oggelshausen,40 - 45 Jahre,103,53,50
False,8426090,Oggelshausen,45 - 50 Jahre,82,49,33
False,8426090,Oggelshausen,50 - 55 Jahre,63,36,27
False,8426090,Oggelshausen,55 - 60 Jahre,23,11,12
False,8426090,Oggelshausen,60 - 65 Jahre,48,16,32
False,8426090,Oggelshausen,65 - 75 Jahre,97,48,49
False,8426090,Oggelshausen,75 und mehr Jahre,75,29,46
False,8426090,Oggelshausen,Insgesamt,953,473,480
False,8426097,"Riedlingen, Stadt",unter 3 Jahre,269,130,139
False,8426097,"Riedlingen, Stadt",3 -  6 Jahre,314,166,148
False,8426097,"Riedlingen, Stadt",6 - 10 Jahre,487,232,255
False,8426097,"Riedlingen, Stadt",10 - 15 Jahre,641,328,313
False,8426097,"Riedlingen, Stadt",15 - 18 Jahre,423,212,211
False,8426097,"Riedlingen, Stadt",18 - 20 Jahre,310,172,138
False,8426097,"Riedlingen, Stadt",20 - 25 Jahre,619,316,303
False,8426097,"Riedlingen, Stadt",25 - 30 Jahre,574,292,282
False,8426097,"Riedlingen, Stadt",30 - 35 Jahre,637,310,327
False,8426097,"Riedlingen, Stadt",35 - 40 Jahre,740,374,366
False,8426097,"Riedlingen, Stadt",40 - 45 Jahre,795,397,398
False,8426097,"Riedlingen, Stadt",45 - 50 Jahre,809,381,428
False,8426097,"Riedlingen, Stadt",50 - 55 Jahre,671,343,328
False,8426097,"Riedlingen, Stadt",55 - 60 Jahre,546,271,275
False,8426097,"Riedlingen, Stadt",60 - 65 Jahre,462,233,229
False,8426097,"Riedlingen, Stadt",65 - 75 Jahre,1130,532,598
False,8426097,"Riedlingen, Stadt",75 und mehr Jahre,949,306,643
False,8426097,"Riedlingen, Stadt",Insgesamt,10376,4995,5381
False,8426100,Rot an der Rot,unter 3 Jahre,138,72,66
False,8426100,Rot an der Rot,3 -  6 Jahre,137,66,71
False,8426100,Rot an der Rot,6 - 10 Jahre,236,118,118
False,8426100,Rot an der Rot,10 - 15 Jahre,319,163,156
False,8426100,Rot an der Rot,15 - 18 Jahre,173,97,76
False,8426100,Rot an der Rot,18 - 20 Jahre,119,70,49
False,8426100,Rot an der Rot,20 - 25 Jahre,262,133,129
False,8426100,Rot an der Rot,25 - 30 Jahre,196,102,94
False,8426100,Rot an der Rot,30 - 35 Jahre,322,176,146
False,8426100,Rot an der Rot,35 - 40 Jahre,376,178,198
False,8426100,Rot an der Rot,40 - 45 Jahre,373,206,167
False,8426100,Rot an der Rot,45 - 50 Jahre,334,183,151
False,8426100,Rot an der Rot,50 - 55 Jahre,272,149,123
False,8426100,Rot an der Rot,55 - 60 Jahre,229,119,110
False,8426100,Rot an der Rot,60 - 65 Jahre,213,101,112
False,8426100,Rot an der Rot,65 - 75 Jahre,425,226,199
False,8426100,Rot an der Rot,75 und mehr Jahre,272,95,177
False,8426100,Rot an der Rot,Insgesamt,4396,2254,2142
False,8426108,Schwendi,unter 3 Jahre,184,95,89
False,8426108,Schwendi,3 -  6 Jahre,189,97,92
False,8426108,Schwendi,6 - 10 Jahre,336,147,189
False,8426108,Schwendi,10 - 15 Jahre,442,237,205
False,8426108,Schwendi,15 - 18 Jahre,270,137,133
False,8426108,Schwendi,18 - 20 Jahre,173,83,90
False,8426108,Schwendi,20 - 25 Jahre,378,206,172
False,8426108,Schwendi,25 - 30 Jahre,334,173,161
False,8426108,Schwendi,30 - 35 Jahre,394,204,190
False,8426108,Schwendi,35 - 40 Jahre,520,264,256
False,8426108,Schwendi,40 - 45 Jahre,596,301,295
False,8426108,Schwendi,45 - 50 Jahre,462,235,227
False,8426108,Schwendi,50 - 55 Jahre,390,189,201
False,8426108,Schwendi,55 - 60 Jahre,331,191,140
False,8426108,Schwendi,60 - 65 Jahre,290,151,139
False,8426108,Schwendi,65 - 75 Jahre,571,287,284
False,8426108,Schwendi,75 und mehr Jahre,428,134,294
False,8426108,Schwendi,Insgesamt,6288,3131,3157
False,8426109,Seekirch,unter 3 Jahre,13,9,4
False,8426109,Seekirch,3 -  6 Jahre,19,6,13
False,8426109,Seekirch,6 - 10 Jahre,23,9,14
False,8426109,Seekirch,10 - 15 Jahre,22,9,13
False,8426109,Seekirch,15 - 18 Jahre,11,5,6
False,8426109,Seekirch,18 - 20 Jahre,0,0,0
False,8426109,Seekirch,20 - 25 Jahre,8,6,2
False,8426109,Seekirch,25 - 30 Jahre,10,5,5
False,8426109,Seekirch,30 - 35 Jahre,18,8,10
False,8426109,Seekirch,35 - 40 Jahre,41,19,22
False,8426109,Seekirch,40 - 45 Jahre,32,20,12
False,8426109,Seekirch,45 - 50 Jahre,21,9,12
False,8426109,Seekirch,50 - 55 Jahre,13,6,7
False,8426109,Seekirch,55 - 60 Jahre,4,4,0
False,8426109,Seekirch,60 - 65 Jahre,9,3,6
False,8426109,Seekirch,65 - 75 Jahre,34,14,20
False,8426109,Seekirch,75 und mehr Jahre,9,3,6
False,8426109,Seekirch,Insgesamt,287,135,152
False,8426113,Steinhausen an der Rottum,unter 3 Jahre,63,40,23
False,8426113,Steinhausen an der Rottum,3 -  6 Jahre,54,35,19
False,8426113,Steinhausen an der Rottum,6 - 10 Jahre,93,45,48
False,8426113,Steinhausen an der Rottum,10 - 15 Jahre,151,71,80
False,8426113,Steinhausen an der Rottum,15 - 18 Jahre,89,41,48
False,8426113,Steinhausen an der Rottum,18 - 20 Jahre,60,30,30
False,8426113,Steinhausen an der Rottum,20 - 25 Jahre,111,65,46
False,8426113,Steinhausen an der Rottum,25 - 30 Jahre,99,49,50
False,8426113,Steinhausen an der Rottum,30 - 35 Jahre,125,67,58
False,8426113,Steinhausen an der Rottum,35 - 40 Jahre,167,87,80
False,8426113,Steinhausen an der Rottum,40 - 45 Jahre,186,104,82
False,8426113,Steinhausen an der Rottum,45 - 50 Jahre,165,91,74
False,8426113,Steinhausen an der Rottum,50 - 55 Jahre,115,60,55
False,8426113,Steinhausen an der Rottum,55 - 60 Jahre,87,47,40
False,8426113,Steinhausen an der Rottum,60 - 65 Jahre,61,33,28
False,8426113,Steinhausen an der Rottum,65 - 75 Jahre,175,88,87
False,8426113,Steinhausen an der Rottum,75 und mehr Jahre,124,38,86
False,8426113,Steinhausen an der Rottum,Insgesamt,1925,991,934
False,8426117,Tannheim,unter 3 Jahre,79,47,32
False,8426117,Tannheim,3 -  6 Jahre,85,45,40
False,8426117,Tannheim,6 - 10 Jahre,116,53,63
False,8426117,Tannheim,10 - 15 Jahre,141,64,77
False,8426117,Tannheim,15 - 18 Jahre,91,50,41
False,8426117,Tannheim,18 - 20 Jahre,53,29,24
False,8426117,Tannheim,20 - 25 Jahre,131,75,56
False,8426117,Tannheim,25 - 30 Jahre,119,54,65
False,8426117,Tannheim,30 - 35 Jahre,149,66,83
False,8426117,Tannheim,35 - 40 Jahre,193,102,91
False,8426117,Tannheim,40 - 45 Jahre,201,107,94
False,8426117,Tannheim,45 - 50 Jahre,189,98,91
False,8426117,Tannheim,50 - 55 Jahre,170,84,86
False,8426117,Tannheim,55 - 60 Jahre,114,61,53
False,8426117,Tannheim,60 - 65 Jahre,124,60,64
False,8426117,Tannheim,65 - 75 Jahre,246,114,132
False,8426117,Tannheim,75 und mehr Jahre,150,57,93
False,8426117,Tannheim,Insgesamt,2351,1166,1185
False,8426118,Tiefenbach,unter 3 Jahre,25,12,13
False,8426118,Tiefenbach,3 -  6 Jahre,24,10,14
False,8426118,Tiefenbach,6 - 10 Jahre,26,12,14
False,8426118,Tiefenbach,10 - 15 Jahre,32,12,20
False,8426118,Tiefenbach,15 - 18 Jahre,18,8,10
False,8426118,Tiefenbach,18 - 20 Jahre,12,4,8
False,8426118,Tiefenbach,20 - 25 Jahre,34,16,18
False,8426118,Tiefenbach,25 - 30 Jahre,28,18,10
False,8426118,Tiefenbach,30 - 35 Jahre,48,22,26
False,8426118,Tiefenbach,35 - 40 Jahre,60,30,30
False,8426118,Tiefenbach,40 - 45 Jahre,34,22,12
False,8426118,Tiefenbach,45 - 50 Jahre,24,12,12
False,8426118,Tiefenbach,50 - 55 Jahre,22,13,9
False,8426118,Tiefenbach,55 - 60 Jahre,14,8,6
False,8426118,Tiefenbach,60 - 65 Jahre,30,10,20
False,8426118,Tiefenbach,65 - 75 Jahre,53,28,25
False,8426118,Tiefenbach,75 und mehr Jahre,29,13,16
False,8426118,Tiefenbach,Insgesamt,513,250,263
False,8426120,Ummendorf,unter 3 Jahre,144,63,81
False,8426120,Ummendorf,3 -  6 Jahre,136,77,59
False,8426120,Ummendorf,6 - 10 Jahre,232,117,115
False,8426120,Ummendorf,10 - 15 Jahre,265,143,122
False,8426120,Ummendorf,15 - 18 Jahre,173,81,92
False,8426120,Ummendorf,18 - 20 Jahre,107,51,56
False,8426120,Ummendorf,20 - 25 Jahre,247,131,116
False,8426120,Ummendorf,25 - 30 Jahre,239,134,105
False,8426120,Ummendorf,30 - 35 Jahre,277,141,136
False,8426120,Ummendorf,35 - 40 Jahre,382,191,191
False,8426120,Ummendorf,40 - 45 Jahre,368,194,174
False,8426120,Ummendorf,45 - 50 Jahre,299,152,147
False,8426120,Ummendorf,50 - 55 Jahre,257,125,132
False,8426120,Ummendorf,55 - 60 Jahre,250,119,131
False,8426120,Ummendorf,60 - 65 Jahre,204,110,94
False,8426120,Ummendorf,65 - 75 Jahre,423,200,223
False,8426120,Ummendorf,75 und mehr Jahre,273,94,179
False,8426120,Ummendorf,Insgesamt,4276,2123,2153
False,8426121,Unlingen,unter 3 Jahre,69,33,36
False,8426121,Unlingen,3 -  6 Jahre,100,44,56
False,8426121,Unlingen,6 - 10 Jahre,148,69,79
False,8426121,Unlingen,10 - 15 Jahre,169,83,86
False,8426121,Unlingen,15 - 18 Jahre,112,61,51
False,8426121,Unlingen,18 - 20 Jahre,63,38,25
False,8426121,Unlingen,20 - 25 Jahre,141,75,66
False,8426121,Unlingen,25 - 30 Jahre,129,75,54
False,8426121,Unlingen,30 - 35 Jahre,165,79,86
False,8426121,Unlingen,35 - 40 Jahre,206,108,98
False,8426121,Unlingen,40 - 45 Jahre,214,107,107
False,8426121,Unlingen,45 - 50 Jahre,173,91,82
False,8426121,Unlingen,50 - 55 Jahre,142,79,63
False,8426121,Unlingen,55 - 60 Jahre,128,64,64
False,8426121,Unlingen,60 - 65 Jahre,109,50,59
False,8426121,Unlingen,65 - 75 Jahre,226,122,104
False,8426121,Unlingen,75 und mehr Jahre,142,54,88
False,8426121,Unlingen,Insgesamt,2436,1232,1204
False,8426124,Uttenweiler,unter 3 Jahre,126,67,59
False,8426124,Uttenweiler,3 -  6 Jahre,141,67,74
False,8426124,Uttenweiler,6 - 10 Jahre,199,107,92
False,8426124,Uttenweiler,10 - 15 Jahre,229,116,113
False,8426124,Uttenweiler,15 - 18 Jahre,186,106,80
False,8426124,Uttenweiler,18 - 20 Jahre,115,60,55
False,8426124,Uttenweiler,20 - 25 Jahre,263,143,120
False,8426124,Uttenweiler,25 - 30 Jahre,225,115,110
False,8426124,Uttenweiler,30 - 35 Jahre,226,103,123
False,8426124,Uttenweiler,35 - 40 Jahre,276,161,115
False,8426124,Uttenweiler,40 - 45 Jahre,312,164,148
False,8426124,Uttenweiler,45 - 50 Jahre,321,163,158
False,8426124,Uttenweiler,50 - 55 Jahre,247,136,111
False,8426124,Uttenweiler,55 - 60 Jahre,169,85,84
False,8426124,Uttenweiler,60 - 65 Jahre,132,74,58
False,8426124,Uttenweiler,65 - 75 Jahre,272,131,141
False,8426124,Uttenweiler,75 und mehr Jahre,238,85,153
False,8426124,Uttenweiler,Insgesamt,3677,1883,1794
False,8426125,Wain,unter 3 Jahre,52,25,27
False,8426125,Wain,3 -  6 Jahre,58,30,28
False,8426125,Wain,6 - 10 Jahre,77,42,35
False,8426125,Wain,10 - 15 Jahre,114,57,57
False,8426125,Wain,15 - 18 Jahre,66,39,27
False,8426125,Wain,18 - 20 Jahre,41,19,22
False,8426125,Wain,20 - 25 Jahre,108,62,46
False,8426125,Wain,25 - 30 Jahre,92,44,48
False,8426125,Wain,30 - 35 Jahre,80,44,36
False,8426125,Wain,35 - 40 Jahre,109,56,53
False,8426125,Wain,40 - 45 Jahre,129,73,56
False,8426125,Wain,45 - 50 Jahre,106,57,49
False,8426125,Wain,50 - 55 Jahre,113,55,58
False,8426125,Wain,55 - 60 Jahre,100,53,47
False,8426125,Wain,60 - 65 Jahre,66,44,22
False,8426125,Wain,65 - 75 Jahre,128,59,69
False,8426125,Wain,75 und mehr Jahre,101,29,72
False,8426125,Wain,Insgesamt,1540,788,752
False,8426128,Warthausen,unter 3 Jahre,116,57,59
False,8426128,Warthausen,3 -  6 Jahre,159,84,75
False,8426128,Warthausen,6 - 10 Jahre,232,117,115
False,8426128,Warthausen,10 - 15 Jahre,267,138,129
False,8426128,Warthausen,15 - 18 Jahre,220,114,106
False,8426128,Warthausen,18 - 20 Jahre,116,59,57
False,8426128,Warthausen,20 - 25 Jahre,269,134,135
False,8426128,Warthausen,25 - 30 Jahre,260,131,129
False,8426128,Warthausen,30 - 35 Jahre,254,138,116
False,8426128,Warthausen,35 - 40 Jahre,380,206,174
False,8426128,Warthausen,40 - 45 Jahre,401,194,207
False,8426128,Warthausen,45 - 50 Jahre,365,181,184
False,8426128,Warthausen,50 - 55 Jahre,316,157,159
False,8426128,Warthausen,55 - 60 Jahre,275,153,122
False,8426128,Warthausen,60 - 65 Jahre,280,127,153
False,8426128,Warthausen,65 - 75 Jahre,509,253,256
False,8426128,Warthausen,75 und mehr Jahre,356,124,232
False,8426128,Warthausen,Insgesamt,4775,2367,2408
False,8426134,Schemmerhofen,unter 3 Jahre,215,111,104
False,8426134,Schemmerhofen,3 -  6 Jahre,274,130,144
False,8426134,Schemmerhofen,6 - 10 Jahre,406,200,206
False,8426134,Schemmerhofen,10 - 15 Jahre,559,268,291
False,8426134,Schemmerhofen,15 - 18 Jahre,321,167,154
False,8426134,Schemmerhofen,18 - 20 Jahre,200,113,87
False,8426134,Schemmerhofen,20 - 25 Jahre,418,214,204
False,8426134,Schemmerhofen,25 - 30 Jahre,423,211,212
False,8426134,Schemmerhofen,30 - 35 Jahre,514,256,258
False,8426134,Schemmerhofen,35 - 40 Jahre,707,345,362
False,8426134,Schemmerhofen,40 - 45 Jahre,681,354,327
False,8426134,Schemmerhofen,45 - 50 Jahre,570,302,268
False,8426134,Schemmerhofen,50 - 55 Jahre,455,233,222
False,8426134,Schemmerhofen,55 - 60 Jahre,382,191,191
False,8426134,Schemmerhofen,60 - 65 Jahre,332,171,161
False,8426134,Schemmerhofen,65 - 75 Jahre,680,336,344
False,8426134,Schemmerhofen,75 und mehr Jahre,416,159,257
False,8426134,Schemmerhofen,Insgesamt,7553,3761,3792
False,8426135,Gutenzell-Hürbel,unter 3 Jahre,69,32,37
False,8426135,Gutenzell-Hürbel,3 -  6 Jahre,73,38,35
False,8426135,Gutenzell-Hürbel,6 - 10 Jahre,107,55,52
False,8426135,Gutenzell-Hürbel,10 - 15 Jahre,157,80,77
False,8426135,Gutenzell-Hürbel,15 - 18 Jahre,86,44,42
False,8426135,Gutenzell-Hürbel,18 - 20 Jahre,56,27,29
False,8426135,Gutenzell-Hürbel,20 - 25 Jahre,108,62,46
False,8426135,Gutenzell-Hürbel,25 - 30 Jahre,91,56,35
False,8426135,Gutenzell-Hürbel,30 - 35 Jahre,117,53,64
False,8426135,Gutenzell-Hürbel,35 - 40 Jahre,160,86,74
False,8426135,Gutenzell-Hürbel,40 - 45 Jahre,174,86,88
False,8426135,Gutenzell-Hürbel,45 - 50 Jahre,135,70,65
False,8426135,Gutenzell-Hürbel,50 - 55 Jahre,126,68,58
False,8426135,Gutenzell-Hürbel,55 - 60 Jahre,94,47,47
False,8426135,Gutenzell-Hürbel,60 - 65 Jahre,62,36,26
False,8426135,Gutenzell-Hürbel,65 - 75 Jahre,136,71,65
False,8426135,Gutenzell-Hürbel,75 und mehr Jahre,116,39,77
False,8426135,Gutenzell-Hürbel,Insgesamt,1867,950,917
False,8435,Landkreis Bodenseekreis,unter 3 Jahre,5354,2815,2539
False,8435,Landkreis Bodenseekreis,3 -  6 Jahre,5899,3007,2892
False,8435,Landkreis Bodenseekreis,6 - 10 Jahre,8859,4516,4343
False,8435,Landkreis Bodenseekreis,10 - 15 Jahre,11703,6082,5621
False,8435,Landkreis Bodenseekreis,15 - 18 Jahre,7613,3844,3769
False,8435,Landkreis Bodenseekreis,18 - 20 Jahre,5049,2567,2482
False,8435,Landkreis Bodenseekreis,20 - 25 Jahre,11395,5739,5656
False,8435,Landkreis Bodenseekreis,25 - 30 Jahre,11103,5637,5466
False,8435,Landkreis Bodenseekreis,30 - 35 Jahre,12238,6162,6076
False,8435,Landkreis Bodenseekreis,35 - 40 Jahre,16783,8509,8274
False,8435,Landkreis Bodenseekreis,40 - 45 Jahre,17321,8699,8622
False,8435,Landkreis Bodenseekreis,45 - 50 Jahre,15320,7713,7607
False,8435,Landkreis Bodenseekreis,50 - 55 Jahre,13311,6482,6829
False,8435,Landkreis Bodenseekreis,55 - 60 Jahre,12453,6045,6408
False,8435,Landkreis Bodenseekreis,60 - 65 Jahre,12572,6229,6343
False,8435,Landkreis Bodenseekreis,65 - 75 Jahre,22177,10801,11376
False,8435,Landkreis Bodenseekreis,75 und mehr Jahre,16296,5729,10567
False,8435,Landkreis Bodenseekreis,Insgesamt,205446,100576,104870
False,8435005,Bermatingen,unter 3 Jahre,93,49,44
False,8435005,Bermatingen,3 -  6 Jahre,111,58,53
False,8435005,Bermatingen,6 - 10 Jahre,173,91,82
False,8435005,Bermatingen,10 - 15 Jahre,273,129,144
False,8435005,Bermatingen,15 - 18 Jahre,136,65,71
False,8435005,Bermatingen,18 - 20 Jahre,105,59,46
False,8435005,Bermatingen,20 - 25 Jahre,183,87,96
False,8435005,Bermatingen,25 - 30 Jahre,158,84,74
False,8435005,Bermatingen,30 - 35 Jahre,212,101,111
False,8435005,Bermatingen,35 - 40 Jahre,320,153,167
False,8435005,Bermatingen,40 - 45 Jahre,374,182,192
False,8435005,Bermatingen,45 - 50 Jahre,323,168,155
False,8435005,Bermatingen,50 - 55 Jahre,259,136,123
False,8435005,Bermatingen,55 - 60 Jahre,227,125,102
False,8435005,Bermatingen,60 - 65 Jahre,222,113,109
False,8435005,Bermatingen,65 - 75 Jahre,361,184,177
False,8435005,Bermatingen,75 und mehr Jahre,230,100,130
False,8435005,Bermatingen,Insgesamt,3760,1884,1876
False,8435010,Daisendorf,unter 3 Jahre,34,18,16
False,8435010,Daisendorf,3 -  6 Jahre,38,20,18
False,8435010,Daisendorf,6 - 10 Jahre,47,24,23
False,8435010,Daisendorf,10 - 15 Jahre,80,40,40
False,8435010,Daisendorf,15 - 18 Jahre,36,17,19
False,8435010,Daisendorf,18 - 20 Jahre,36,15,21
False,8435010,Daisendorf,20 - 25 Jahre,81,40,41
False,8435010,Daisendorf,25 - 30 Jahre,73,33,40
False,8435010,Daisendorf,30 - 35 Jahre,62,42,20
False,8435010,Daisendorf,35 - 40 Jahre,126,58,68
False,8435010,Daisendorf,40 - 45 Jahre,150,74,76
False,8435010,Daisendorf,45 - 50 Jahre,112,53,59
False,8435010,Daisendorf,50 - 55 Jahre,90,48,42
False,8435010,Daisendorf,55 - 60 Jahre,125,65,60
False,8435010,Daisendorf,60 - 65 Jahre,122,58,64
False,8435010,Daisendorf,65 - 75 Jahre,182,96,86
False,8435010,Daisendorf,75 und mehr Jahre,117,48,69
False,8435010,Daisendorf,Insgesamt,1511,749,762
False,8435013,Eriskirch,unter 3 Jahre,154,85,69
False,8435013,Eriskirch,3 -  6 Jahre,133,64,69
False,8435013,Eriskirch,6 - 10 Jahre,206,112,94
False,8435013,Eriskirch,10 - 15 Jahre,248,123,125
False,8435013,Eriskirch,15 - 18 Jahre,200,109,91
False,8435013,Eriskirch,18 - 20 Jahre,94,50,44
False,8435013,Eriskirch,20 - 25 Jahre,218,109,109
False,8435013,Eriskirch,25 - 30 Jahre,211,105,106
False,8435013,Eriskirch,30 - 35 Jahre,258,127,131
False,8435013,Eriskirch,35 - 40 Jahre,385,205,180
False,8435013,Eriskirch,40 - 45 Jahre,430,221,209
False,8435013,Eriskirch,45 - 50 Jahre,351,189,162
False,8435013,Eriskirch,50 - 55 Jahre,322,158,164
False,8435013,Eriskirch,55 - 60 Jahre,301,144,157
False,8435013,Eriskirch,60 - 65 Jahre,254,128,126
False,8435013,Eriskirch,65 - 75 Jahre,393,193,200
False,8435013,Eriskirch,75 und mehr Jahre,286,108,178
False,8435013,Eriskirch,Insgesamt,4444,2230,2214
False,8435015,Frickingen,unter 3 Jahre,99,53,46
False,8435015,Frickingen,3 -  6 Jahre,104,49,55
False,8435015,Frickingen,6 - 10 Jahre,141,73,68
False,8435015,Frickingen,10 - 15 Jahre,210,110,100
False,8435015,Frickingen,15 - 18 Jahre,136,69,67
False,8435015,Frickingen,18 - 20 Jahre,84,51,33
False,8435015,Frickingen,20 - 25 Jahre,162,79,83
False,8435015,Frickingen,25 - 30 Jahre,123,66,57
False,8435015,Frickingen,30 - 35 Jahre,150,77,73
False,8435015,Frickingen,35 - 40 Jahre,211,96,115
False,8435015,Frickingen,40 - 45 Jahre,230,119,111
False,8435015,Frickingen,45 - 50 Jahre,204,117,87
False,8435015,Frickingen,50 - 55 Jahre,183,99,84
False,8435015,Frickingen,55 - 60 Jahre,161,82,79
False,8435015,Frickingen,60 - 65 Jahre,152,86,66
False,8435015,Frickingen,65 - 75 Jahre,254,124,130
False,8435015,Frickingen,75 und mehr Jahre,164,53,111
False,8435015,Frickingen,Insgesamt,2768,1403,1365
False,8435016,"Friedrichshafen, Stadt",unter 3 Jahre,1474,764,710
False,8435016,"Friedrichshafen, Stadt",3 -  6 Jahre,1510,763,747
False,8435016,"Friedrichshafen, Stadt",6 - 10 Jahre,2320,1195,1125
False,8435016,"Friedrichshafen, Stadt",10 - 15 Jahre,3042,1559,1483
False,8435016,"Friedrichshafen, Stadt",15 - 18 Jahre,2005,1020,985
False,8435016,"Friedrichshafen, Stadt",18 - 20 Jahre,1465,729,736
False,8435016,"Friedrichshafen, Stadt",20 - 25 Jahre,3470,1707,1763
False,8435016,"Friedrichshafen, Stadt",25 - 30 Jahre,3490,1827,1663
False,8435016,"Friedrichshafen, Stadt",30 - 35 Jahre,3622,1855,1767
False,8435016,"Friedrichshafen, Stadt",35 - 40 Jahre,4584,2370,2214
False,8435016,"Friedrichshafen, Stadt",40 - 45 Jahre,4578,2384,2194
False,8435016,"Friedrichshafen, Stadt",45 - 50 Jahre,4154,2073,2081
False,8435016,"Friedrichshafen, Stadt",50 - 55 Jahre,3697,1727,1970
False,8435016,"Friedrichshafen, Stadt",55 - 60 Jahre,3610,1813,1797
False,8435016,"Friedrichshafen, Stadt",60 - 65 Jahre,3641,1760,1881
False,8435016,"Friedrichshafen, Stadt",65 - 75 Jahre,6595,3203,3392
False,8435016,"Friedrichshafen, Stadt",75 und mehr Jahre,4811,1719,3092
False,8435016,"Friedrichshafen, Stadt",Insgesamt,58068,28468,29600
False,8435018,Hagnau am Bodensee,unter 3 Jahre,28,16,12
False,8435018,Hagnau am Bodensee,3 -  6 Jahre,42,22,20
False,8435018,Hagnau am Bodensee,6 - 10 Jahre,51,23,28
False,8435018,Hagnau am Bodensee,10 - 15 Jahre,75,42,33
False,8435018,Hagnau am Bodensee,15 - 18 Jahre,36,19,17
False,8435018,Hagnau am Bodensee,18 - 20 Jahre,20,5,15
False,8435018,Hagnau am Bodensee,20 - 25 Jahre,71,32,39
False,8435018,Hagnau am Bodensee,25 - 30 Jahre,62,29,33
False,8435018,Hagnau am Bodensee,30 - 35 Jahre,68,33,35
False,8435018,Hagnau am Bodensee,35 - 40 Jahre,86,39,47
False,8435018,Hagnau am Bodensee,40 - 45 Jahre,96,44,52
False,8435018,Hagnau am Bodensee,45 - 50 Jahre,104,54,50
False,8435018,Hagnau am Bodensee,50 - 55 Jahre,101,44,57
False,8435018,Hagnau am Bodensee,55 - 60 Jahre,92,42,50
False,8435018,Hagnau am Bodensee,60 - 65 Jahre,84,43,41
False,8435018,Hagnau am Bodensee,65 - 75 Jahre,183,86,97
False,8435018,Hagnau am Bodensee,75 und mehr Jahre,151,54,97
False,8435018,Hagnau am Bodensee,Insgesamt,1350,627,723
False,8435020,Heiligenberg,unter 3 Jahre,55,30,25
False,8435020,Heiligenberg,3 -  6 Jahre,72,40,32
False,8435020,Heiligenberg,6 - 10 Jahre,125,71,54
False,8435020,Heiligenberg,10 - 15 Jahre,212,127,85
False,8435020,Heiligenberg,15 - 18 Jahre,128,66,62
False,8435020,Heiligenberg,18 - 20 Jahre,87,38,49
False,8435020,Heiligenberg,20 - 25 Jahre,222,113,109
False,8435020,Heiligenberg,25 - 30 Jahre,158,76,82
False,8435020,Heiligenberg,30 - 35 Jahre,124,74,50
False,8435020,Heiligenberg,35 - 40 Jahre,200,109,91
False,8435020,Heiligenberg,40 - 45 Jahre,267,115,152
False,8435020,Heiligenberg,45 - 50 Jahre,250,127,123
False,8435020,Heiligenberg,50 - 55 Jahre,220,128,92
False,8435020,Heiligenberg,55 - 60 Jahre,134,58,76
False,8435020,Heiligenberg,60 - 65 Jahre,119,58,61
False,8435020,Heiligenberg,65 - 75 Jahre,274,130,144
False,8435020,Heiligenberg,75 und mehr Jahre,263,74,189
False,8435020,Heiligenberg,Insgesamt,2910,1434,1476
False,8435024,Immenstaad am Bodensee,unter 3 Jahre,175,96,79
False,8435024,Immenstaad am Bodensee,3 -  6 Jahre,179,92,87
False,8435024,Immenstaad am Bodensee,6 - 10 Jahre,223,92,131
False,8435024,Immenstaad am Bodensee,10 - 15 Jahre,266,139,127
False,8435024,Immenstaad am Bodensee,15 - 18 Jahre,186,93,93
False,8435024,Immenstaad am Bodensee,18 - 20 Jahre,112,54,58
False,8435024,Immenstaad am Bodensee,20 - 25 Jahre,274,144,130
False,8435024,Immenstaad am Bodensee,25 - 30 Jahre,327,148,179
False,8435024,Immenstaad am Bodensee,30 - 35 Jahre,307,152,155
False,8435024,Immenstaad am Bodensee,35 - 40 Jahre,439,232,207
False,8435024,Immenstaad am Bodensee,40 - 45 Jahre,496,252,244
False,8435024,Immenstaad am Bodensee,45 - 50 Jahre,486,255,231
False,8435024,Immenstaad am Bodensee,50 - 55 Jahre,434,209,225
False,8435024,Immenstaad am Bodensee,55 - 60 Jahre,415,196,219
False,8435024,Immenstaad am Bodensee,60 - 65 Jahre,488,241,247
False,8435024,Immenstaad am Bodensee,65 - 75 Jahre,758,395,363
False,8435024,Immenstaad am Bodensee,75 und mehr Jahre,440,150,290
False,8435024,Immenstaad am Bodensee,Insgesamt,6005,2940,3065
False,8435029,Kressbronn am Bodensee,unter 3 Jahre,257,128,129
False,8435029,Kressbronn am Bodensee,3 -  6 Jahre,266,136,130
False,8435029,Kressbronn am Bodensee,6 - 10 Jahre,409,207,202
False,8435029,Kressbronn am Bodensee,10 - 15 Jahre,474,248,226
False,8435029,Kressbronn am Bodensee,15 - 18 Jahre,297,141,156
False,8435029,Kressbronn am Bodensee,18 - 20 Jahre,181,105,76
False,8435029,Kressbronn am Bodensee,20 - 25 Jahre,421,206,215
False,8435029,Kressbronn am Bodensee,25 - 30 Jahre,422,211,211
False,8435029,Kressbronn am Bodensee,30 - 35 Jahre,510,242,268
False,8435029,Kressbronn am Bodensee,35 - 40 Jahre,601,314,287
False,8435029,Kressbronn am Bodensee,40 - 45 Jahre,660,328,332
False,8435029,Kressbronn am Bodensee,45 - 50 Jahre,549,277,272
False,8435029,Kressbronn am Bodensee,50 - 55 Jahre,488,248,240
False,8435029,Kressbronn am Bodensee,55 - 60 Jahre,473,222,251
False,8435029,Kressbronn am Bodensee,60 - 65 Jahre,508,238,270
False,8435029,Kressbronn am Bodensee,65 - 75 Jahre,896,417,479
False,8435029,Kressbronn am Bodensee,75 und mehr Jahre,643,227,416
False,8435029,Kressbronn am Bodensee,Insgesamt,8055,3895,4160
False,8435030,Langenargen,unter 3 Jahre,194,97,97
False,8435030,Langenargen,3 -  6 Jahre,200,108,92
False,8435030,Langenargen,6 - 10 Jahre,317,167,150
False,8435030,Langenargen,10 - 15 Jahre,355,186,169
False,8435030,Langenargen,15 - 18 Jahre,223,105,118
False,8435030,Langenargen,18 - 20 Jahre,145,80,65
False,8435030,Langenargen,20 - 25 Jahre,327,171,156
False,8435030,Langenargen,25 - 30 Jahre,334,195,139
False,8435030,Langenargen,30 - 35 Jahre,411,194,217
False,8435030,Langenargen,35 - 40 Jahre,654,335,319
False,8435030,Langenargen,40 - 45 Jahre,635,299,336
False,8435030,Langenargen,45 - 50 Jahre,543,263,280
False,8435030,Langenargen,50 - 55 Jahre,488,245,243
False,8435030,Langenargen,55 - 60 Jahre,516,245,271
False,8435030,Langenargen,60 - 65 Jahre,530,254,276
False,8435030,Langenargen,65 - 75 Jahre,957,457,500
False,8435030,Langenargen,75 und mehr Jahre,744,257,487
False,8435030,Langenargen,Insgesamt,7573,3658,3915
False,8435034,"Markdorf, Stadt",unter 3 Jahre,351,180,171
False,8435034,"Markdorf, Stadt",3 -  6 Jahre,375,182,193
False,8435034,"Markdorf, Stadt",6 - 10 Jahre,548,274,274
False,8435034,"Markdorf, Stadt",10 - 15 Jahre,707,349,358
False,8435034,"Markdorf, Stadt",15 - 18 Jahre,462,203,259
False,8435034,"Markdorf, Stadt",18 - 20 Jahre,277,144,133
False,8435034,"Markdorf, Stadt",20 - 25 Jahre,691,356,335
False,8435034,"Markdorf, Stadt",25 - 30 Jahre,756,366,390
False,8435034,"Markdorf, Stadt",30 - 35 Jahre,806,428,378
False,8435034,"Markdorf, Stadt",35 - 40 Jahre,1087,562,525
False,8435034,"Markdorf, Stadt",40 - 45 Jahre,1021,507,514
False,8435034,"Markdorf, Stadt",45 - 50 Jahre,927,463,464
False,8435034,"Markdorf, Stadt",50 - 55 Jahre,766,343,423
False,8435034,"Markdorf, Stadt",55 - 60 Jahre,795,383,412
False,8435034,"Markdorf, Stadt",60 - 65 Jahre,808,397,411
False,8435034,"Markdorf, Stadt",65 - 75 Jahre,1403,683,720
False,8435034,"Markdorf, Stadt",75 und mehr Jahre,906,327,579
False,8435034,"Markdorf, Stadt",Insgesamt,12686,6147,6539
False,8435035,Meckenbeuren,unter 3 Jahre,366,200,166
False,8435035,Meckenbeuren,3 -  6 Jahre,433,240,193
False,8435035,Meckenbeuren,6 - 10 Jahre,679,347,332
False,8435035,Meckenbeuren,10 - 15 Jahre,739,402,337
False,8435035,Meckenbeuren,15 - 18 Jahre,473,266,207
False,8435035,Meckenbeuren,18 - 20 Jahre,324,171,153
False,8435035,Meckenbeuren,20 - 25 Jahre,771,381,390
False,8435035,Meckenbeuren,25 - 30 Jahre,761,400,361
False,8435035,Meckenbeuren,30 - 35 Jahre,908,452,456
False,8435035,Meckenbeuren,35 - 40 Jahre,1261,663,598
False,8435035,Meckenbeuren,40 - 45 Jahre,1234,604,630
False,8435035,Meckenbeuren,45 - 50 Jahre,994,514,480
False,8435035,Meckenbeuren,50 - 55 Jahre,890,455,435
False,8435035,Meckenbeuren,55 - 60 Jahre,739,369,370
False,8435035,Meckenbeuren,60 - 65 Jahre,686,354,332
False,8435035,Meckenbeuren,65 - 75 Jahre,1253,618,635
False,8435035,Meckenbeuren,75 und mehr Jahre,784,271,513
False,8435035,Meckenbeuren,Insgesamt,13295,6707,6588
False,8435036,"Meersburg, Stadt",unter 3 Jahre,120,66,54
False,8435036,"Meersburg, Stadt",3 -  6 Jahre,122,63,59
False,8435036,"Meersburg, Stadt",6 - 10 Jahre,199,93,106
False,8435036,"Meersburg, Stadt",10 - 15 Jahre,257,121,136
False,8435036,"Meersburg, Stadt",15 - 18 Jahre,173,85,88
False,8435036,"Meersburg, Stadt",18 - 20 Jahre,98,57,41
False,8435036,"Meersburg, Stadt",20 - 25 Jahre,332,158,174
False,8435036,"Meersburg, Stadt",25 - 30 Jahre,285,133,152
False,8435036,"Meersburg, Stadt",30 - 35 Jahre,356,185,171
False,8435036,"Meersburg, Stadt",35 - 40 Jahre,517,260,257
False,8435036,"Meersburg, Stadt",40 - 45 Jahre,459,235,224
False,8435036,"Meersburg, Stadt",45 - 50 Jahre,387,199,188
False,8435036,"Meersburg, Stadt",50 - 55 Jahre,318,151,167
False,8435036,"Meersburg, Stadt",55 - 60 Jahre,369,156,213
False,8435036,"Meersburg, Stadt",60 - 65 Jahre,403,199,204
False,8435036,"Meersburg, Stadt",65 - 75 Jahre,677,313,364
False,8435036,"Meersburg, Stadt",75 und mehr Jahre,471,156,315
False,8435036,"Meersburg, Stadt",Insgesamt,5543,2630,2913
False,8435042,Neukirch,unter 3 Jahre,82,35,47
False,8435042,Neukirch,3 -  6 Jahre,100,52,48
False,8435042,Neukirch,6 - 10 Jahre,154,78,76
False,8435042,Neukirch,10 - 15 Jahre,174,92,82
False,8435042,Neukirch,15 - 18 Jahre,122,69,53
False,8435042,Neukirch,18 - 20 Jahre,66,38,28
False,8435042,Neukirch,20 - 25 Jahre,165,73,92
False,8435042,Neukirch,25 - 30 Jahre,166,83,83
False,8435042,Neukirch,30 - 35 Jahre,174,92,82
False,8435042,Neukirch,35 - 40 Jahre,253,124,129
False,8435042,Neukirch,40 - 45 Jahre,280,153,127
False,8435042,Neukirch,45 - 50 Jahre,212,106,106
False,8435042,Neukirch,50 - 55 Jahre,178,101,77
False,8435042,Neukirch,55 - 60 Jahre,134,69,65
False,8435042,Neukirch,60 - 65 Jahre,105,63,42
False,8435042,Neukirch,65 - 75 Jahre,199,101,98
False,8435042,Neukirch,75 und mehr Jahre,133,53,80
False,8435042,Neukirch,Insgesamt,2697,1382,1315
False,8435045,Oberteuringen,unter 3 Jahre,126,59,67
False,8435045,Oberteuringen,3 -  6 Jahre,150,66,84
False,8435045,Oberteuringen,6 - 10 Jahre,214,99,115
False,8435045,Oberteuringen,10 - 15 Jahre,283,149,134
False,8435045,Oberteuringen,15 - 18 Jahre,186,82,104
False,8435045,Oberteuringen,18 - 20 Jahre,111,56,55
False,8435045,Oberteuringen,20 - 25 Jahre,225,116,109
False,8435045,Oberteuringen,25 - 30 Jahre,227,113,114
False,8435045,Oberteuringen,30 - 35 Jahre,282,137,145
False,8435045,Oberteuringen,35 - 40 Jahre,420,219,201
False,8435045,Oberteuringen,40 - 45 Jahre,402,206,196
False,8435045,Oberteuringen,45 - 50 Jahre,362,181,181
False,8435045,Oberteuringen,50 - 55 Jahre,295,161,134
False,8435045,Oberteuringen,55 - 60 Jahre,242,129,113
False,8435045,Oberteuringen,60 - 65 Jahre,218,112,106
False,8435045,Oberteuringen,65 - 75 Jahre,366,187,179
False,8435045,Oberteuringen,75 und mehr Jahre,223,87,136
False,8435045,Oberteuringen,Insgesamt,4332,2159,2173
False,8435047,Owingen,unter 3 Jahre,110,59,51
False,8435047,Owingen,3 -  6 Jahre,138,77,61
False,8435047,Owingen,6 - 10 Jahre,209,108,101
False,8435047,Owingen,10 - 15 Jahre,300,166,134
False,8435047,Owingen,15 - 18 Jahre,223,107,116
False,8435047,Owingen,18 - 20 Jahre,113,53,60
False,8435047,Owingen,20 - 25 Jahre,207,108,99
False,8435047,Owingen,25 - 30 Jahre,183,81,102
False,8435047,Owingen,30 - 35 Jahre,266,110,156
False,8435047,Owingen,35 - 40 Jahre,356,166,190
False,8435047,Owingen,40 - 45 Jahre,383,200,183
False,8435047,Owingen,45 - 50 Jahre,359,195,164
False,8435047,Owingen,50 - 55 Jahre,294,147,147
False,8435047,Owingen,55 - 60 Jahre,250,136,114
False,8435047,Owingen,60 - 65 Jahre,190,105,85
False,8435047,Owingen,65 - 75 Jahre,411,215,196
False,8435047,Owingen,75 und mehr Jahre,235,92,143
False,8435047,Owingen,Insgesamt,4227,2125,2102
False,8435052,Salem,unter 3 Jahre,271,151,120
False,8435052,Salem,3 -  6 Jahre,322,180,142
False,8435052,Salem,6 - 10 Jahre,549,274,275
False,8435052,Salem,10 - 15 Jahre,815,428,387
False,8435052,Salem,15 - 18 Jahre,559,298,261
False,8435052,Salem,18 - 20 Jahre,347,176,171
False,8435052,Salem,20 - 25 Jahre,705,401,304
False,8435052,Salem,25 - 30 Jahre,637,326,311
False,8435052,Salem,30 - 35 Jahre,656,354,302
False,8435052,Salem,35 - 40 Jahre,847,431,416
False,8435052,Salem,40 - 45 Jahre,939,444,495
False,8435052,Salem,45 - 50 Jahre,866,418,448
False,8435052,Salem,50 - 55 Jahre,748,365,383
False,8435052,Salem,55 - 60 Jahre,618,304,314
False,8435052,Salem,60 - 65 Jahre,575,302,273
False,8435052,Salem,65 - 75 Jahre,940,476,464
False,8435052,Salem,75 und mehr Jahre,774,276,498
False,8435052,Salem,Insgesamt,11168,5604,5564
False,8435053,Sipplingen,unter 3 Jahre,48,29,19
False,8435053,Sipplingen,3 -  6 Jahre,53,26,27
False,8435053,Sipplingen,6 - 10 Jahre,69,33,36
False,8435053,Sipplingen,10 - 15 Jahre,106,49,57
False,8435053,Sipplingen,15 - 18 Jahre,71,38,33
False,8435053,Sipplingen,18 - 20 Jahre,42,18,24
False,8435053,Sipplingen,20 - 25 Jahre,107,62,45
False,8435053,Sipplingen,25 - 30 Jahre,101,50,51
False,8435053,Sipplingen,30 - 35 Jahre,116,61,55
False,8435053,Sipplingen,35 - 40 Jahre,164,85,79
False,8435053,Sipplingen,40 - 45 Jahre,177,94,83
False,8435053,Sipplingen,45 - 50 Jahre,167,79,88
False,8435053,Sipplingen,50 - 55 Jahre,146,77,69
False,8435053,Sipplingen,55 - 60 Jahre,134,67,67
False,8435053,Sipplingen,60 - 65 Jahre,132,65,67
False,8435053,Sipplingen,65 - 75 Jahre,289,145,144
False,8435053,Sipplingen,75 und mehr Jahre,236,93,143
False,8435053,Sipplingen,Insgesamt,2158,1071,1087
False,8435054,Stetten,unter 3 Jahre,25,15,10
False,8435054,Stetten,3 -  6 Jahre,25,12,13
False,8435054,Stetten,6 - 10 Jahre,27,8,19
False,8435054,Stetten,10 - 15 Jahre,36,15,21
False,8435054,Stetten,15 - 18 Jahre,39,23,16
False,8435054,Stetten,18 - 20 Jahre,29,14,15
False,8435054,Stetten,20 - 25 Jahre,60,35,25
False,8435054,Stetten,25 - 30 Jahre,50,27,23
False,8435054,Stetten,30 - 35 Jahre,41,22,19
False,8435054,Stetten,35 - 40 Jahre,66,19,47
False,8435054,Stetten,40 - 45 Jahre,101,47,54
False,8435054,Stetten,45 - 50 Jahre,87,45,42
False,8435054,Stetten,50 - 55 Jahre,80,38,42
False,8435054,Stetten,55 - 60 Jahre,44,20,24
False,8435054,Stetten,60 - 65 Jahre,59,26,33
False,8435054,Stetten,65 - 75 Jahre,119,55,64
False,8435054,Stetten,75 und mehr Jahre,89,33,56
False,8435054,Stetten,Insgesamt,977,454,523
False,8435057,"Tettnang, Stadt",unter 3 Jahre,501,278,223
False,8435057,"Tettnang, Stadt",3 -  6 Jahre,573,302,271
False,8435057,"Tettnang, Stadt",6 - 10 Jahre,851,443,408
False,8435057,"Tettnang, Stadt",10 - 15 Jahre,1175,609,566
False,8435057,"Tettnang, Stadt",15 - 18 Jahre,711,346,365
False,8435057,"Tettnang, Stadt",18 - 20 Jahre,410,194,216
False,8435057,"Tettnang, Stadt",20 - 25 Jahre,968,491,477
False,8435057,"Tettnang, Stadt",25 - 30 Jahre,993,500,493
False,8435057,"Tettnang, Stadt",30 - 35 Jahre,1076,539,537
False,8435057,"Tettnang, Stadt",35 - 40 Jahre,1637,868,769
False,8435057,"Tettnang, Stadt",40 - 45 Jahre,1692,869,823
False,8435057,"Tettnang, Stadt",45 - 50 Jahre,1450,785,665
False,8435057,"Tettnang, Stadt",50 - 55 Jahre,1186,574,612
False,8435057,"Tettnang, Stadt",55 - 60 Jahre,1059,529,530
False,8435057,"Tettnang, Stadt",60 - 65 Jahre,1058,563,495
False,8435057,"Tettnang, Stadt",65 - 75 Jahre,1762,868,894
False,8435057,"Tettnang, Stadt",75 und mehr Jahre,1221,430,791
False,8435057,"Tettnang, Stadt",Insgesamt,18323,9188,9135
False,8435059,"Überlingen, Stadt",unter 3 Jahre,448,233,215
False,8435059,"Überlingen, Stadt",3 -  6 Jahre,558,272,286
False,8435059,"Überlingen, Stadt",6 - 10 Jahre,777,407,370
False,8435059,"Überlingen, Stadt",10 - 15 Jahre,1112,581,531
False,8435059,"Überlingen, Stadt",15 - 18 Jahre,726,378,348
False,8435059,"Überlingen, Stadt",18 - 20 Jahre,637,327,310
False,8435059,"Überlingen, Stadt",20 - 25 Jahre,1105,551,554
False,8435059,"Überlingen, Stadt",25 - 30 Jahre,970,482,488
False,8435059,"Überlingen, Stadt",30 - 35 Jahre,1093,523,570
False,8435059,"Überlingen, Stadt",35 - 40 Jahre,1525,693,832
False,8435059,"Überlingen, Stadt",40 - 45 Jahre,1554,719,835
False,8435059,"Überlingen, Stadt",45 - 50 Jahre,1454,666,788
False,8435059,"Überlingen, Stadt",50 - 55 Jahre,1377,633,744
False,8435059,"Überlingen, Stadt",55 - 60 Jahre,1279,552,727
False,8435059,"Überlingen, Stadt",60 - 65 Jahre,1492,703,789
False,8435059,"Überlingen, Stadt",65 - 75 Jahre,2741,1273,1468
False,8435059,"Überlingen, Stadt",75 und mehr Jahre,2569,832,1737
False,8435059,"Überlingen, Stadt",Insgesamt,21417,9825,11592
False,8435066,Uhldingen-Mühlhofen,unter 3 Jahre,211,110,101
False,8435066,Uhldingen-Mühlhofen,3 -  6 Jahre,236,111,125
False,8435066,Uhldingen-Mühlhofen,6 - 10 Jahre,384,206,178
False,8435066,Uhldingen-Mühlhofen,10 - 15 Jahre,471,263,208
False,8435066,Uhldingen-Mühlhofen,15 - 18 Jahre,310,155,155
False,8435066,Uhldingen-Mühlhofen,18 - 20 Jahre,164,84,80
False,8435066,Uhldingen-Mühlhofen,20 - 25 Jahre,410,211,199
False,8435066,Uhldingen-Mühlhofen,25 - 30 Jahre,393,190,203
False,8435066,Uhldingen-Mühlhofen,30 - 35 Jahre,458,227,231
False,8435066,Uhldingen-Mühlhofen,35 - 40 Jahre,647,310,337
False,8435066,Uhldingen-Mühlhofen,40 - 45 Jahre,741,383,358
False,8435066,Uhldingen-Mühlhofen,45 - 50 Jahre,628,299,329
False,8435066,Uhldingen-Mühlhofen,50 - 55 Jahre,511,271,240
False,8435066,Uhldingen-Mühlhofen,55 - 60 Jahre,546,243,303
False,8435066,Uhldingen-Mühlhofen,60 - 65 Jahre,541,276,265
False,8435066,Uhldingen-Mühlhofen,65 - 75 Jahre,795,385,410
False,8435066,Uhldingen-Mühlhofen,75 und mehr Jahre,557,205,352
False,8435066,Uhldingen-Mühlhofen,Insgesamt,8003,3929,4074
False,8435067,Deggenhausertal,unter 3 Jahre,132,64,68
False,8435067,Deggenhausertal,3 -  6 Jahre,159,72,87
False,8435067,Deggenhausertal,6 - 10 Jahre,187,91,96
False,8435067,Deggenhausertal,10 - 15 Jahre,293,155,138
False,8435067,Deggenhausertal,15 - 18 Jahre,175,90,85
False,8435067,Deggenhausertal,18 - 20 Jahre,102,49,53
False,8435067,Deggenhausertal,20 - 25 Jahre,220,108,112
False,8435067,Deggenhausertal,25 - 30 Jahre,223,112,111
False,8435067,Deggenhausertal,30 - 35 Jahre,282,135,147
False,8435067,Deggenhausertal,35 - 40 Jahre,397,198,199
False,8435067,Deggenhausertal,40 - 45 Jahre,422,220,202
False,8435067,Deggenhausertal,45 - 50 Jahre,351,187,164
False,8435067,Deggenhausertal,50 - 55 Jahre,240,124,116
False,8435067,Deggenhausertal,55 - 60 Jahre,190,96,94
False,8435067,Deggenhausertal,60 - 65 Jahre,185,85,100
False,8435067,Deggenhausertal,65 - 75 Jahre,369,197,172
False,8435067,Deggenhausertal,75 und mehr Jahre,249,84,165
False,8435067,Deggenhausertal,Insgesamt,4176,2067,2109
False,8436,Landkreis Ravensburg,unter 3 Jahre,7729,3933,3796
False,8436,Landkreis Ravensburg,3 -  6 Jahre,8706,4473,4233
False,8436,Landkreis Ravensburg,6 - 10 Jahre,13080,6687,6393
False,8436,Landkreis Ravensburg,10 - 15 Jahre,16887,8769,8118
False,8436,Landkreis Ravensburg,15 - 18 Jahre,11084,5704,5380
False,8436,Landkreis Ravensburg,18 - 20 Jahre,7043,3615,3428
False,8436,Landkreis Ravensburg,20 - 25 Jahre,16098,8140,7958
False,8436,Landkreis Ravensburg,25 - 30 Jahre,15658,7853,7805
False,8436,Landkreis Ravensburg,30 - 35 Jahre,17336,8648,8688
False,8436,Landkreis Ravensburg,35 - 40 Jahre,23537,11896,11641
False,8436,Landkreis Ravensburg,40 - 45 Jahre,23684,12065,11619
False,8436,Landkreis Ravensburg,45 - 50 Jahre,20601,10335,10266
False,8436,Landkreis Ravensburg,50 - 55 Jahre,17489,8754,8735
False,8436,Landkreis Ravensburg,55 - 60 Jahre,15323,7805,7518
False,8436,Landkreis Ravensburg,60 - 65 Jahre,14062,7067,6995
False,8436,Landkreis Ravensburg,65 - 75 Jahre,26624,12861,13763
False,8436,Landkreis Ravensburg,75 und mehr Jahre,20736,7154,13582
False,8436,Landkreis Ravensburg,Insgesamt,275677,135759,139918
False,8436001,Achberg,unter 3 Jahre,51,30,21
False,8436001,Achberg,3 -  6 Jahre,74,34,40
False,8436001,Achberg,6 - 10 Jahre,100,47,53
False,8436001,Achberg,10 - 15 Jahre,124,73,51
False,8436001,Achberg,15 - 18 Jahre,74,35,39
False,8436001,Achberg,18 - 20 Jahre,39,21,18
False,8436001,Achberg,20 - 25 Jahre,82,41,41
False,8436001,Achberg,25 - 30 Jahre,83,38,45
False,8436001,Achberg,30 - 35 Jahre,98,43,55
False,8436001,Achberg,35 - 40 Jahre,164,91,73
False,8436001,Achberg,40 - 45 Jahre,135,68,67
False,8436001,Achberg,45 - 50 Jahre,105,57,48
False,8436001,Achberg,50 - 55 Jahre,93,40,53
False,8436001,Achberg,55 - 60 Jahre,69,40,29
False,8436001,Achberg,60 - 65 Jahre,72,39,33
False,8436001,Achberg,65 - 75 Jahre,114,53,61
False,8436001,Achberg,75 und mehr Jahre,122,42,80
False,8436001,Achberg,Insgesamt,1599,792,807
False,8436003,Aichstetten,unter 3 Jahre,91,50,41
False,8436003,Aichstetten,3 -  6 Jahre,110,53,57
False,8436003,Aichstetten,6 - 10 Jahre,154,79,75
False,8436003,Aichstetten,10 - 15 Jahre,168,85,83
False,8436003,Aichstetten,15 - 18 Jahre,122,59,63
False,8436003,Aichstetten,18 - 20 Jahre,69,42,27
False,8436003,Aichstetten,20 - 25 Jahre,159,75,84
False,8436003,Aichstetten,25 - 30 Jahre,145,69,76
False,8436003,Aichstetten,30 - 35 Jahre,208,103,105
False,8436003,Aichstetten,35 - 40 Jahre,248,141,107
False,8436003,Aichstetten,40 - 45 Jahre,223,119,104
False,8436003,Aichstetten,45 - 50 Jahre,213,115,98
False,8436003,Aichstetten,50 - 55 Jahre,143,73,70
False,8436003,Aichstetten,55 - 60 Jahre,148,75,73
False,8436003,Aichstetten,60 - 65 Jahre,132,77,55
False,8436003,Aichstetten,65 - 75 Jahre,253,122,131
False,8436003,Aichstetten,75 und mehr Jahre,153,60,93
False,8436003,Aichstetten,Insgesamt,2739,1397,1342
False,8436004,Aitrach,unter 3 Jahre,60,32,28
False,8436004,Aitrach,3 -  6 Jahre,86,42,44
False,8436004,Aitrach,6 - 10 Jahre,135,81,54
False,8436004,Aitrach,10 - 15 Jahre,169,92,77
False,8436004,Aitrach,15 - 18 Jahre,84,43,41
False,8436004,Aitrach,18 - 20 Jahre,60,30,30
False,8436004,Aitrach,20 - 25 Jahre,139,82,57
False,8436004,Aitrach,25 - 30 Jahre,136,69,67
False,8436004,Aitrach,30 - 35 Jahre,151,84,67
False,8436004,Aitrach,35 - 40 Jahre,208,111,97
False,8436004,Aitrach,40 - 45 Jahre,213,111,102
False,8436004,Aitrach,45 - 50 Jahre,176,94,82
False,8436004,Aitrach,50 - 55 Jahre,143,69,74
False,8436004,Aitrach,55 - 60 Jahre,171,81,90
False,8436004,Aitrach,60 - 65 Jahre,175,94,81
False,8436004,Aitrach,65 - 75 Jahre,289,145,144
False,8436004,Aitrach,75 und mehr Jahre,184,67,117
False,8436004,Aitrach,Insgesamt,2579,1327,1252
False,8436005,Altshausen,unter 3 Jahre,105,42,63
False,8436005,Altshausen,3 -  6 Jahre,125,64,61
False,8436005,Altshausen,6 - 10 Jahre,154,84,70
False,8436005,Altshausen,10 - 15 Jahre,255,138,117
False,8436005,Altshausen,15 - 18 Jahre,161,82,79
False,8436005,Altshausen,18 - 20 Jahre,101,58,43
False,8436005,Altshausen,20 - 25 Jahre,258,132,126
False,8436005,Altshausen,25 - 30 Jahre,230,130,100
False,8436005,Altshausen,30 - 35 Jahre,324,172,152
False,8436005,Altshausen,35 - 40 Jahre,315,168,147
False,8436005,Altshausen,40 - 45 Jahre,332,195,137
False,8436005,Altshausen,45 - 50 Jahre,382,224,158
False,8436005,Altshausen,50 - 55 Jahre,364,230,134
False,8436005,Altshausen,55 - 60 Jahre,326,222,104
False,8436005,Altshausen,60 - 65 Jahre,263,166,97
False,8436005,Altshausen,65 - 75 Jahre,580,357,223
False,8436005,Altshausen,75 und mehr Jahre,467,145,322
False,8436005,Altshausen,Insgesamt,4742,2609,2133
False,8436006,Amtzell,unter 3 Jahre,103,42,61
False,8436006,Amtzell,3 -  6 Jahre,130,68,62
False,8436006,Amtzell,6 - 10 Jahre,208,99,109
False,8436006,Amtzell,10 - 15 Jahre,248,128,120
False,8436006,Amtzell,15 - 18 Jahre,165,83,82
False,8436006,Amtzell,18 - 20 Jahre,89,48,41
False,8436006,Amtzell,20 - 25 Jahre,184,97,87
False,8436006,Amtzell,25 - 30 Jahre,183,87,96
False,8436006,Amtzell,30 - 35 Jahre,217,97,120
False,8436006,Amtzell,35 - 40 Jahre,303,156,147
False,8436006,Amtzell,40 - 45 Jahre,328,155,173
False,8436006,Amtzell,45 - 50 Jahre,280,131,149
False,8436006,Amtzell,50 - 55 Jahre,255,126,129
False,8436006,Amtzell,55 - 60 Jahre,201,111,90
False,8436006,Amtzell,60 - 65 Jahre,160,74,86
False,8436006,Amtzell,65 - 75 Jahre,257,139,118
False,8436006,Amtzell,75 und mehr Jahre,244,73,171
False,8436006,Amtzell,Insgesamt,3555,1714,1841
False,8436008,"Aulendorf, Stadt",unter 3 Jahre,307,159,148
False,8436008,"Aulendorf, Stadt",3 -  6 Jahre,331,175,156
False,8436008,"Aulendorf, Stadt",6 - 10 Jahre,504,251,253
False,8436008,"Aulendorf, Stadt",10 - 15 Jahre,624,318,306
False,8436008,"Aulendorf, Stadt",15 - 18 Jahre,459,240,219
False,8436008,"Aulendorf, Stadt",18 - 20 Jahre,303,156,147
False,8436008,"Aulendorf, Stadt",20 - 25 Jahre,658,352,306
False,8436008,"Aulendorf, Stadt",25 - 30 Jahre,544,271,273
False,8436008,"Aulendorf, Stadt",30 - 35 Jahre,603,314,289
False,8436008,"Aulendorf, Stadt",35 - 40 Jahre,731,367,364
False,8436008,"Aulendorf, Stadt",40 - 45 Jahre,844,376,468
False,8436008,"Aulendorf, Stadt",45 - 50 Jahre,774,389,385
False,8436008,"Aulendorf, Stadt",50 - 55 Jahre,643,336,307
False,8436008,"Aulendorf, Stadt",55 - 60 Jahre,572,292,280
False,8436008,"Aulendorf, Stadt",60 - 65 Jahre,424,225,199
False,8436008,"Aulendorf, Stadt",65 - 75 Jahre,901,409,492
False,8436008,"Aulendorf, Stadt",75 und mehr Jahre,764,244,520
False,8436008,"Aulendorf, Stadt",Insgesamt,9986,4874,5112
False,8436009,"Bad Waldsee, Stadt",unter 3 Jahre,609,323,286
False,8436009,"Bad Waldsee, Stadt",3 -  6 Jahre,609,316,293
False,8436009,"Bad Waldsee, Stadt",6 - 10 Jahre,951,472,479
False,8436009,"Bad Waldsee, Stadt",10 - 15 Jahre,1221,609,612
False,8436009,"Bad Waldsee, Stadt",15 - 18 Jahre,777,413,364
False,8436009,"Bad Waldsee, Stadt",18 - 20 Jahre,543,273,270
False,8436009,"Bad Waldsee, Stadt",20 - 25 Jahre,1134,553,581
False,8436009,"Bad Waldsee, Stadt",25 - 30 Jahre,1129,551,578
False,8436009,"Bad Waldsee, Stadt",30 - 35 Jahre,1232,589,643
False,8436009,"Bad Waldsee, Stadt",35 - 40 Jahre,1586,785,801
False,8436009,"Bad Waldsee, Stadt",40 - 45 Jahre,1620,809,811
False,8436009,"Bad Waldsee, Stadt",45 - 50 Jahre,1497,735,762
False,8436009,"Bad Waldsee, Stadt",50 - 55 Jahre,1301,628,673
False,8436009,"Bad Waldsee, Stadt",55 - 60 Jahre,1109,521,588
False,8436009,"Bad Waldsee, Stadt",60 - 65 Jahre,1017,482,535
False,8436009,"Bad Waldsee, Stadt",65 - 75 Jahre,1865,874,991
False,8436009,"Bad Waldsee, Stadt",75 und mehr Jahre,1564,493,1071
False,8436009,"Bad Waldsee, Stadt",Insgesamt,19764,9426,10338
False,8436010,"Bad Wurzach, Stadt",unter 3 Jahre,450,228,222
False,8436010,"Bad Wurzach, Stadt",3 -  6 Jahre,489,245,244
False,8436010,"Bad Wurzach, Stadt",6 - 10 Jahre,763,396,367
False,8436010,"Bad Wurzach, Stadt",10 - 15 Jahre,1009,544,465
False,8436010,"Bad Wurzach, Stadt",15 - 18 Jahre,655,312,343
False,8436010,"Bad Wurzach, Stadt",18 - 20 Jahre,385,195,190
False,8436010,"Bad Wurzach, Stadt",20 - 25 Jahre,880,451,429
False,8436010,"Bad Wurzach, Stadt",25 - 30 Jahre,844,442,402
False,8436010,"Bad Wurzach, Stadt",30 - 35 Jahre,962,503,459
False,8436010,"Bad Wurzach, Stadt",35 - 40 Jahre,1272,661,611
False,8436010,"Bad Wurzach, Stadt",40 - 45 Jahre,1228,651,577
False,8436010,"Bad Wurzach, Stadt",45 - 50 Jahre,1031,553,478
False,8436010,"Bad Wurzach, Stadt",50 - 55 Jahre,851,436,415
False,8436010,"Bad Wurzach, Stadt",55 - 60 Jahre,735,375,360
False,8436010,"Bad Wurzach, Stadt",60 - 65 Jahre,653,337,316
False,8436010,"Bad Wurzach, Stadt",65 - 75 Jahre,1345,681,664
False,8436010,"Bad Wurzach, Stadt",75 und mehr Jahre,864,296,568
False,8436010,"Bad Wurzach, Stadt",Insgesamt,14416,7306,7110
False,8436011,Baienfurt,unter 3 Jahre,192,104,88
False,8436011,Baienfurt,3 -  6 Jahre,210,112,98
False,8436011,Baienfurt,6 - 10 Jahre,334,184,150
False,8436011,Baienfurt,10 - 15 Jahre,451,223,228
False,8436011,Baienfurt,15 - 18 Jahre,290,160,130
False,8436011,Baienfurt,18 - 20 Jahre,184,85,99
False,8436011,Baienfurt,20 - 25 Jahre,428,206,222
False,8436011,Baienfurt,25 - 30 Jahre,378,192,186
False,8436011,Baienfurt,30 - 35 Jahre,420,206,214
False,8436011,Baienfurt,35 - 40 Jahre,629,320,309
False,8436011,Baienfurt,40 - 45 Jahre,609,312,297
False,8436011,Baienfurt,45 - 50 Jahre,558,283,275
False,8436011,Baienfurt,50 - 55 Jahre,499,235,264
False,8436011,Baienfurt,55 - 60 Jahre,395,204,191
False,8436011,Baienfurt,60 - 65 Jahre,420,212,208
False,8436011,Baienfurt,65 - 75 Jahre,788,369,419
False,8436011,Baienfurt,75 und mehr Jahre,508,179,329
False,8436011,Baienfurt,Insgesamt,7293,3586,3707
False,8436012,Baindt,unter 3 Jahre,129,58,71
False,8436012,Baindt,3 -  6 Jahre,142,79,63
False,8436012,Baindt,6 - 10 Jahre,221,118,103
False,8436012,Baindt,10 - 15 Jahre,267,149,118
False,8436012,Baindt,15 - 18 Jahre,183,101,82
False,8436012,Baindt,18 - 20 Jahre,127,75,52
False,8436012,Baindt,20 - 25 Jahre,285,135,150
False,8436012,Baindt,25 - 30 Jahre,249,129,120
False,8436012,Baindt,30 - 35 Jahre,278,144,134
False,8436012,Baindt,35 - 40 Jahre,412,183,229
False,8436012,Baindt,40 - 45 Jahre,389,206,183
False,8436012,Baindt,45 - 50 Jahre,350,160,190
False,8436012,Baindt,50 - 55 Jahre,350,172,178
False,8436012,Baindt,55 - 60 Jahre,282,145,137
False,8436012,Baindt,60 - 65 Jahre,288,139,149
False,8436012,Baindt,65 - 75 Jahre,476,234,242
False,8436012,Baindt,75 und mehr Jahre,273,113,160
False,8436012,Baindt,Insgesamt,4701,2340,2361
False,8436013,Berg,unter 3 Jahre,111,55,56
False,8436013,Berg,3 -  6 Jahre,109,60,49
False,8436013,Berg,6 - 10 Jahre,205,115,90
False,8436013,Berg,10 - 15 Jahre,217,128,89
False,8436013,Berg,15 - 18 Jahre,144,79,65
False,8436013,Berg,18 - 20 Jahre,105,58,47
False,8436013,Berg,20 - 25 Jahre,201,111,90
False,8436013,Berg,25 - 30 Jahre,209,109,100
False,8436013,Berg,30 - 35 Jahre,245,128,117
False,8436013,Berg,35 - 40 Jahre,319,180,139
False,8436013,Berg,40 - 45 Jahre,295,139,156
False,8436013,Berg,45 - 50 Jahre,288,135,153
False,8436013,Berg,50 - 55 Jahre,257,114,143
False,8436013,Berg,55 - 60 Jahre,230,121,109
False,8436013,Berg,60 - 65 Jahre,244,104,140
False,8436013,Berg,65 - 75 Jahre,379,193,186
False,8436013,Berg,75 und mehr Jahre,236,84,152
False,8436013,Berg,Insgesamt,3794,1913,1881
False,8436014,Bergatreute,unter 3 Jahre,108,56,52
False,8436014,Bergatreute,3 -  6 Jahre,112,63,49
False,8436014,Bergatreute,6 - 10 Jahre,177,92,85
False,8436014,Bergatreute,10 - 15 Jahre,260,156,104
False,8436014,Bergatreute,15 - 18 Jahre,170,81,89
False,8436014,Bergatreute,18 - 20 Jahre,105,54,51
False,8436014,Bergatreute,20 - 25 Jahre,186,92,94
False,8436014,Bergatreute,25 - 30 Jahre,149,78,71
False,8436014,Bergatreute,30 - 35 Jahre,190,100,90
False,8436014,Bergatreute,35 - 40 Jahre,290,158,132
False,8436014,Bergatreute,40 - 45 Jahre,307,160,147
False,8436014,Bergatreute,45 - 50 Jahre,241,128,113
False,8436014,Bergatreute,50 - 55 Jahre,203,99,104
False,8436014,Bergatreute,55 - 60 Jahre,150,83,67
False,8436014,Bergatreute,60 - 65 Jahre,114,53,61
False,8436014,Bergatreute,65 - 75 Jahre,282,134,148
False,8436014,Bergatreute,75 und mehr Jahre,142,49,93
False,8436014,Bergatreute,Insgesamt,3186,1636,1550
False,8436018,Bodnegg,unter 3 Jahre,87,48,39
False,8436018,Bodnegg,3 -  6 Jahre,95,47,48
False,8436018,Bodnegg,6 - 10 Jahre,166,78,88
False,8436018,Bodnegg,10 - 15 Jahre,189,93,96
False,8436018,Bodnegg,15 - 18 Jahre,116,61,55
False,8436018,Bodnegg,18 - 20 Jahre,80,44,36
False,8436018,Bodnegg,20 - 25 Jahre,147,65,82
False,8436018,Bodnegg,25 - 30 Jahre,152,81,71
False,8436018,Bodnegg,30 - 35 Jahre,172,91,81
False,8436018,Bodnegg,35 - 40 Jahre,279,132,147
False,8436018,Bodnegg,40 - 45 Jahre,291,166,125
False,8436018,Bodnegg,45 - 50 Jahre,233,111,122
False,8436018,Bodnegg,50 - 55 Jahre,211,106,105
False,8436018,Bodnegg,55 - 60 Jahre,194,111,83
False,8436018,Bodnegg,60 - 65 Jahre,163,81,82
False,8436018,Bodnegg,65 - 75 Jahre,326,159,167
False,8436018,Bodnegg,75 und mehr Jahre,208,81,127
False,8436018,Bodnegg,Insgesamt,3109,1555,1554
False,8436019,Boms,unter 3 Jahre,28,13,15
False,8436019,Boms,3 -  6 Jahre,29,11,18
False,8436019,Boms,6 - 10 Jahre,32,18,14
False,8436019,Boms,10 - 15 Jahre,44,32,12
False,8436019,Boms,15 - 18 Jahre,32,21,11
False,8436019,Boms,18 - 20 Jahre,22,14,8
False,8436019,Boms,20 - 25 Jahre,32,17,15
False,8436019,Boms,25 - 30 Jahre,27,16,11
False,8436019,Boms,30 - 35 Jahre,36,20,16
False,8436019,Boms,35 - 40 Jahre,66,29,37
False,8436019,Boms,40 - 45 Jahre,51,28,23
False,8436019,Boms,45 - 50 Jahre,49,26,23
False,8436019,Boms,50 - 55 Jahre,42,23,19
False,8436019,Boms,55 - 60 Jahre,25,16,9
False,8436019,Boms,60 - 65 Jahre,14,7,7
False,8436019,Boms,65 - 75 Jahre,38,19,19
False,8436019,Boms,75 und mehr Jahre,29,7,22
False,8436019,Boms,Insgesamt,596,317,279
False,8436024,Ebenweiler,unter 3 Jahre,45,23,22
False,8436024,Ebenweiler,3 -  6 Jahre,29,14,15
False,8436024,Ebenweiler,6 - 10 Jahre,68,38,30
False,8436024,Ebenweiler,10 - 15 Jahre,104,58,46
False,8436024,Ebenweiler,15 - 18 Jahre,65,32,33
False,8436024,Ebenweiler,18 - 20 Jahre,26,11,15
False,8436024,Ebenweiler,20 - 25 Jahre,64,33,31
False,8436024,Ebenweiler,25 - 30 Jahre,61,33,28
False,8436024,Ebenweiler,30 - 35 Jahre,75,40,35
False,8436024,Ebenweiler,35 - 40 Jahre,103,51,52
False,8436024,Ebenweiler,40 - 45 Jahre,107,51,56
False,8436024,Ebenweiler,45 - 50 Jahre,92,46,46
False,8436024,Ebenweiler,50 - 55 Jahre,63,36,27
False,8436024,Ebenweiler,55 - 60 Jahre,54,34,20
False,8436024,Ebenweiler,60 - 65 Jahre,44,19,25
False,8436024,Ebenweiler,65 - 75 Jahre,71,40,31
False,8436024,Ebenweiler,75 und mehr Jahre,57,21,36
False,8436024,Ebenweiler,Insgesamt,1128,580,548
False,8436027,Eichstegen,unter 3 Jahre,19,11,8
False,8436027,Eichstegen,3 -  6 Jahre,20,8,12
False,8436027,Eichstegen,6 - 10 Jahre,28,13,15
False,8436027,Eichstegen,10 - 15 Jahre,30,16,14
False,8436027,Eichstegen,15 - 18 Jahre,34,17,17
False,8436027,Eichstegen,18 - 20 Jahre,13,5,8
False,8436027,Eichstegen,20 - 25 Jahre,33,17,16
False,8436027,Eichstegen,25 - 30 Jahre,30,17,13
False,8436027,Eichstegen,30 - 35 Jahre,39,17,22
False,8436027,Eichstegen,35 - 40 Jahre,37,19,18
False,8436027,Eichstegen,40 - 45 Jahre,62,33,29
False,8436027,Eichstegen,45 - 50 Jahre,42,20,22
False,8436027,Eichstegen,50 - 55 Jahre,27,15,12
False,8436027,Eichstegen,55 - 60 Jahre,21,9,12
False,8436027,Eichstegen,60 - 65 Jahre,12,6,6
False,8436027,Eichstegen,65 - 75 Jahre,44,23,21
False,8436027,Eichstegen,75 und mehr Jahre,34,12,22
False,8436027,Eichstegen,Insgesamt,525,258,267
False,8436032,Fleischwangen,unter 3 Jahre,17,15,2
False,8436032,Fleischwangen,3 -  6 Jahre,26,12,14
False,8436032,Fleischwangen,6 - 10 Jahre,48,28,20
False,8436032,Fleischwangen,10 - 15 Jahre,58,36,22
False,8436032,Fleischwangen,15 - 18 Jahre,35,18,17
False,8436032,Fleischwangen,18 - 20 Jahre,17,4,13
False,8436032,Fleischwangen,20 - 25 Jahre,32,18,14
False,8436032,Fleischwangen,25 - 30 Jahre,47,22,25
False,8436032,Fleischwangen,30 - 35 Jahre,37,16,21
False,8436032,Fleischwangen,35 - 40 Jahre,53,27,26
False,8436032,Fleischwangen,40 - 45 Jahre,63,32,31
False,8436032,Fleischwangen,45 - 50 Jahre,53,28,25
False,8436032,Fleischwangen,50 - 55 Jahre,23,11,12
False,8436032,Fleischwangen,55 - 60 Jahre,32,16,16
False,8436032,Fleischwangen,60 - 65 Jahre,29,16,13
False,8436032,Fleischwangen,65 - 75 Jahre,41,23,18
False,8436032,Fleischwangen,75 und mehr Jahre,18,7,11
False,8436032,Fleischwangen,Insgesamt,629,329,300
False,8436039,Grünkraut,unter 3 Jahre,78,39,39
False,8436039,Grünkraut,3 -  6 Jahre,113,66,47
False,8436039,Grünkraut,6 - 10 Jahre,152,91,61
False,8436039,Grünkraut,10 - 15 Jahre,191,87,104
False,8436039,Grünkraut,15 - 18 Jahre,114,62,52
False,8436039,Grünkraut,18 - 20 Jahre,77,48,29
False,8436039,Grünkraut,20 - 25 Jahre,148,68,80
False,8436039,Grünkraut,25 - 30 Jahre,170,75,95
False,8436039,Grünkraut,30 - 35 Jahre,194,91,103
False,8436039,Grünkraut,35 - 40 Jahre,295,164,131
False,8436039,Grünkraut,40 - 45 Jahre,265,134,131
False,8436039,Grünkraut,45 - 50 Jahre,254,125,129
False,8436039,Grünkraut,50 - 55 Jahre,192,98,94
False,8436039,Grünkraut,55 - 60 Jahre,174,85,89
False,8436039,Grünkraut,60 - 65 Jahre,163,87,76
False,8436039,Grünkraut,65 - 75 Jahre,260,137,123
False,8436039,Grünkraut,75 und mehr Jahre,149,45,104
False,8436039,Grünkraut,Insgesamt,2989,1502,1487
False,8436040,Guggenhausen,unter 3 Jahre,3,1,2
False,8436040,Guggenhausen,3 -  6 Jahre,5,3,2
False,8436040,Guggenhausen,6 - 10 Jahre,12,6,6
False,8436040,Guggenhausen,10 - 15 Jahre,15,8,7
False,8436040,Guggenhausen,15 - 18 Jahre,9,3,6
False,8436040,Guggenhausen,18 - 20 Jahre,6,2,4
False,8436040,Guggenhausen,20 - 25 Jahre,9,7,2
False,8436040,Guggenhausen,25 - 30 Jahre,16,10,6
False,8436040,Guggenhausen,30 - 35 Jahre,21,14,7
False,8436040,Guggenhausen,35 - 40 Jahre,10,5,5
False,8436040,Guggenhausen,40 - 45 Jahre,17,9,8
False,8436040,Guggenhausen,45 - 50 Jahre,20,15,5
False,8436040,Guggenhausen,50 - 55 Jahre,13,7,6
False,8436040,Guggenhausen,55 - 60 Jahre,9,4,5
False,8436040,Guggenhausen,60 - 65 Jahre,7,4,3
False,8436040,Guggenhausen,65 - 75 Jahre,16,8,8
False,8436040,Guggenhausen,75 und mehr Jahre,12,4,8
False,8436040,Guggenhausen,Insgesamt,200,110,90
False,8436047,Hoßkirch,unter 3 Jahre,13,5,8
False,8436047,Hoßkirch,3 -  6 Jahre,25,12,13
False,8436047,Hoßkirch,6 - 10 Jahre,34,22,12
False,8436047,Hoßkirch,10 - 15 Jahre,52,29,23
False,8436047,Hoßkirch,15 - 18 Jahre,36,21,15
False,8436047,Hoßkirch,18 - 20 Jahre,18,11,7
False,8436047,Hoßkirch,20 - 25 Jahre,49,29,20
False,8436047,Hoßkirch,25 - 30 Jahre,34,12,22
False,8436047,Hoßkirch,30 - 35 Jahre,32,19,13
False,8436047,Hoßkirch,35 - 40 Jahre,51,24,27
False,8436047,Hoßkirch,40 - 45 Jahre,60,40,20
False,8436047,Hoßkirch,45 - 50 Jahre,68,28,40
False,8436047,Hoßkirch,50 - 55 Jahre,56,32,24
False,8436047,Hoßkirch,55 - 60 Jahre,56,32,24
False,8436047,Hoßkirch,60 - 65 Jahre,27,14,13
False,8436047,Hoßkirch,65 - 75 Jahre,66,32,34
False,8436047,Hoßkirch,75 und mehr Jahre,29,9,20
False,8436047,Hoßkirch,Insgesamt,706,371,335
False,8436049,"Isny im Allgäu, Stadt",unter 3 Jahre,382,200,182
False,8436049,"Isny im Allgäu, Stadt",3 -  6 Jahre,404,209,195
False,8436049,"Isny im Allgäu, Stadt",6 - 10 Jahre,603,329,274
False,8436049,"Isny im Allgäu, Stadt",10 - 15 Jahre,780,396,384
False,8436049,"Isny im Allgäu, Stadt",15 - 18 Jahre,511,271,240
False,8436049,"Isny im Allgäu, Stadt",18 - 20 Jahre,373,187,186
False,8436049,"Isny im Allgäu, Stadt",20 - 25 Jahre,1010,527,483
False,8436049,"Isny im Allgäu, Stadt",25 - 30 Jahre,886,440,446
False,8436049,"Isny im Allgäu, Stadt",30 - 35 Jahre,983,473,510
False,8436049,"Isny im Allgäu, Stadt",35 - 40 Jahre,1423,589,834
False,8436049,"Isny im Allgäu, Stadt",40 - 45 Jahre,1335,652,683
False,8436049,"Isny im Allgäu, Stadt",45 - 50 Jahre,1018,500,518
False,8436049,"Isny im Allgäu, Stadt",50 - 55 Jahre,856,433,423
False,8436049,"Isny im Allgäu, Stadt",55 - 60 Jahre,786,380,406
False,8436049,"Isny im Allgäu, Stadt",60 - 65 Jahre,736,377,359
False,8436049,"Isny im Allgäu, Stadt",65 - 75 Jahre,1302,612,690
False,8436049,"Isny im Allgäu, Stadt",75 und mehr Jahre,1164,385,779
False,8436049,"Isny im Allgäu, Stadt",Insgesamt,14552,6960,7592
False,8436052,Kißlegg,unter 3 Jahre,227,104,123
False,8436052,Kißlegg,3 -  6 Jahre,283,139,144
False,8436052,Kißlegg,6 - 10 Jahre,441,240,201
False,8436052,Kißlegg,10 - 15 Jahre,621,325,296
False,8436052,Kißlegg,15 - 18 Jahre,358,191,167
False,8436052,Kißlegg,18 - 20 Jahre,246,129,117
False,8436052,Kißlegg,20 - 25 Jahre,529,266,263
False,8436052,Kißlegg,25 - 30 Jahre,437,223,214
False,8436052,Kißlegg,30 - 35 Jahre,478,224,254
False,8436052,Kißlegg,35 - 40 Jahre,712,344,368
False,8436052,Kißlegg,40 - 45 Jahre,731,370,361
False,8436052,Kißlegg,45 - 50 Jahre,644,334,310
False,8436052,Kißlegg,50 - 55 Jahre,574,314,260
False,8436052,Kißlegg,55 - 60 Jahre,498,257,241
False,8436052,Kißlegg,60 - 65 Jahre,404,208,196
False,8436052,Kißlegg,65 - 75 Jahre,779,360,419
False,8436052,Kißlegg,75 und mehr Jahre,675,235,440
False,8436052,Kißlegg,Insgesamt,8637,4263,4374
False,8436053,Königseggwald,unter 3 Jahre,22,11,11
False,8436053,Königseggwald,3 -  6 Jahre,17,10,7
False,8436053,Königseggwald,6 - 10 Jahre,43,20,23
False,8436053,Königseggwald,10 - 15 Jahre,56,30,26
False,8436053,Königseggwald,15 - 18 Jahre,31,16,15
False,8436053,Königseggwald,18 - 20 Jahre,13,8,5
False,8436053,Königseggwald,20 - 25 Jahre,43,21,22
False,8436053,Königseggwald,25 - 30 Jahre,33,18,15
False,8436053,Königseggwald,30 - 35 Jahre,36,17,19
False,8436053,Königseggwald,35 - 40 Jahre,69,31,38
False,8436053,Königseggwald,40 - 45 Jahre,56,32,24
False,8436053,Königseggwald,45 - 50 Jahre,41,19,22
False,8436053,Königseggwald,50 - 55 Jahre,47,27,20
False,8436053,Königseggwald,55 - 60 Jahre,22,14,8
False,8436053,Königseggwald,60 - 65 Jahre,34,14,20
False,8436053,Königseggwald,65 - 75 Jahre,81,40,41
False,8436053,Königseggwald,75 und mehr Jahre,27,12,15
False,8436053,Königseggwald,Insgesamt,671,340,331
False,8436055,"Leutkirch im Allgäu, Stadt",unter 3 Jahre,643,321,322
False,8436055,"Leutkirch im Allgäu, Stadt",3 -  6 Jahre,735,375,360
False,8436055,"Leutkirch im Allgäu, Stadt",6 - 10 Jahre,1132,582,550
False,8436055,"Leutkirch im Allgäu, Stadt",10 - 15 Jahre,1559,811,748
False,8436055,"Leutkirch im Allgäu, Stadt",15 - 18 Jahre,998,521,477
False,8436055,"Leutkirch im Allgäu, Stadt",18 - 20 Jahre,572,294,278
False,8436055,"Leutkirch im Allgäu, Stadt",20 - 25 Jahre,1307,724,583
False,8436055,"Leutkirch im Allgäu, Stadt",25 - 30 Jahre,1184,619,565
False,8436055,"Leutkirch im Allgäu, Stadt",30 - 35 Jahre,1335,675,660
False,8436055,"Leutkirch im Allgäu, Stadt",35 - 40 Jahre,1760,918,842
False,8436055,"Leutkirch im Allgäu, Stadt",40 - 45 Jahre,1806,930,876
False,8436055,"Leutkirch im Allgäu, Stadt",45 - 50 Jahre,1646,826,820
False,8436055,"Leutkirch im Allgäu, Stadt",50 - 55 Jahre,1388,701,687
False,8436055,"Leutkirch im Allgäu, Stadt",55 - 60 Jahre,1282,649,633
False,8436055,"Leutkirch im Allgäu, Stadt",60 - 65 Jahre,1123,595,528
False,8436055,"Leutkirch im Allgäu, Stadt",65 - 75 Jahre,2166,1053,1113
False,8436055,"Leutkirch im Allgäu, Stadt",75 und mehr Jahre,1779,595,1184
False,8436055,"Leutkirch im Allgäu, Stadt",Insgesamt,22415,11189,11226
False,8436064,"Ravensburg, Stadt",unter 3 Jahre,1340,670,670
False,8436064,"Ravensburg, Stadt",3 -  6 Jahre,1407,728,679
False,8436064,"Ravensburg, Stadt",6 - 10 Jahre,2012,1015,997
False,8436064,"Ravensburg, Stadt",10 - 15 Jahre,2497,1281,1216
False,8436064,"Ravensburg, Stadt",15 - 18 Jahre,1705,858,847
False,8436064,"Ravensburg, Stadt",18 - 20 Jahre,1099,560,539
False,8436064,"Ravensburg, Stadt",20 - 25 Jahre,2748,1310,1438
False,8436064,"Ravensburg, Stadt",25 - 30 Jahre,3025,1472,1553
False,8436064,"Ravensburg, Stadt",30 - 35 Jahre,3345,1608,1737
False,8436064,"Ravensburg, Stadt",35 - 40 Jahre,4265,2156,2109
False,8436064,"Ravensburg, Stadt",40 - 45 Jahre,4217,2144,2073
False,8436064,"Ravensburg, Stadt",45 - 50 Jahre,3706,1857,1849
False,8436064,"Ravensburg, Stadt",50 - 55 Jahre,3010,1449,1561
False,8436064,"Ravensburg, Stadt",55 - 60 Jahre,2714,1345,1369
False,8436064,"Ravensburg, Stadt",60 - 65 Jahre,2720,1323,1397
False,8436064,"Ravensburg, Stadt",65 - 75 Jahre,4959,2329,2630
False,8436064,"Ravensburg, Stadt",75 und mehr Jahre,4225,1446,2779
False,8436064,"Ravensburg, Stadt",Insgesamt,48994,23551,25443
False,8436067,Riedhausen,unter 3 Jahre,20,12,8
False,8436067,Riedhausen,3 -  6 Jahre,30,15,15
False,8436067,Riedhausen,6 - 10 Jahre,42,12,30
False,8436067,Riedhausen,10 - 15 Jahre,71,42,29
False,8436067,Riedhausen,15 - 18 Jahre,37,19,18
False,8436067,Riedhausen,18 - 20 Jahre,15,9,6
False,8436067,Riedhausen,20 - 25 Jahre,45,20,25
False,8436067,Riedhausen,25 - 30 Jahre,34,14,20
False,8436067,Riedhausen,30 - 35 Jahre,43,23,20
False,8436067,Riedhausen,35 - 40 Jahre,57,24,33
False,8436067,Riedhausen,40 - 45 Jahre,50,24,26
False,8436067,Riedhausen,45 - 50 Jahre,48,26,22
False,8436067,Riedhausen,50 - 55 Jahre,25,15,10
False,8436067,Riedhausen,55 - 60 Jahre,22,13,9
False,8436067,Riedhausen,60 - 65 Jahre,16,8,8
False,8436067,Riedhausen,65 - 75 Jahre,47,21,26
False,8436067,Riedhausen,75 und mehr Jahre,27,15,12
False,8436067,Riedhausen,Insgesamt,629,312,317
False,8436069,Schlier,unter 3 Jahre,97,58,39
False,8436069,Schlier,3 -  6 Jahre,118,56,62
False,8436069,Schlier,6 - 10 Jahre,191,103,88
False,8436069,Schlier,10 - 15 Jahre,238,117,121
False,8436069,Schlier,15 - 18 Jahre,154,76,78
False,8436069,Schlier,18 - 20 Jahre,93,40,53
False,8436069,Schlier,20 - 25 Jahre,218,117,101
False,8436069,Schlier,25 - 30 Jahre,205,109,96
False,8436069,Schlier,30 - 35 Jahre,223,107,116
False,8436069,Schlier,35 - 40 Jahre,287,152,135
False,8436069,Schlier,40 - 45 Jahre,335,158,177
False,8436069,Schlier,45 - 50 Jahre,323,154,169
False,8436069,Schlier,50 - 55 Jahre,276,146,130
False,8436069,Schlier,55 - 60 Jahre,187,95,92
False,8436069,Schlier,60 - 65 Jahre,183,98,85
False,8436069,Schlier,65 - 75 Jahre,360,192,168
False,8436069,Schlier,75 und mehr Jahre,225,96,129
False,8436069,Schlier,Insgesamt,3713,1874,1839
False,8436077,Unterwaldhausen,unter 3 Jahre,7,4,3
False,8436077,Unterwaldhausen,3 -  6 Jahre,10,4,6
False,8436077,Unterwaldhausen,6 - 10 Jahre,12,4,8
False,8436077,Unterwaldhausen,10 - 15 Jahre,22,11,11
False,8436077,Unterwaldhausen,15 - 18 Jahre,18,7,11
False,8436077,Unterwaldhausen,18 - 20 Jahre,13,5,8
False,8436077,Unterwaldhausen,20 - 25 Jahre,21,10,11
False,8436077,Unterwaldhausen,25 - 30 Jahre,16,8,8
False,8436077,Unterwaldhausen,30 - 35 Jahre,19,10,9
False,8436077,Unterwaldhausen,35 - 40 Jahre,33,16,17
False,8436077,Unterwaldhausen,40 - 45 Jahre,31,17,14
False,8436077,Unterwaldhausen,45 - 50 Jahre,17,8,9
False,8436077,Unterwaldhausen,50 - 55 Jahre,23,14,9
False,8436077,Unterwaldhausen,55 - 60 Jahre,15,9,6
False,8436077,Unterwaldhausen,60 - 65 Jahre,10,5,5
False,8436077,Unterwaldhausen,65 - 75 Jahre,17,11,6
False,8436077,Unterwaldhausen,75 und mehr Jahre,20,5,15
False,8436077,Unterwaldhausen,Insgesamt,304,148,156
False,8436078,Vogt,unter 3 Jahre,104,67,37
False,8436078,Vogt,3 -  6 Jahre,160,86,74
False,8436078,Vogt,6 - 10 Jahre,244,126,118
False,8436078,Vogt,10 - 15 Jahre,327,171,156
False,8436078,Vogt,15 - 18 Jahre,213,102,111
False,8436078,Vogt,18 - 20 Jahre,115,54,61
False,8436078,Vogt,20 - 25 Jahre,266,146,120
False,8436078,Vogt,25 - 30 Jahre,211,112,99
False,8436078,Vogt,30 - 35 Jahre,263,133,130
False,8436078,Vogt,35 - 40 Jahre,384,195,189
False,8436078,Vogt,40 - 45 Jahre,379,198,181
False,8436078,Vogt,45 - 50 Jahre,399,187,212
False,8436078,Vogt,50 - 55 Jahre,315,155,160
False,8436078,Vogt,55 - 60 Jahre,260,143,117
False,8436078,Vogt,60 - 65 Jahre,261,123,138
False,8436078,Vogt,65 - 75 Jahre,404,201,203
False,8436078,Vogt,75 und mehr Jahre,272,109,163
False,8436078,Vogt,Insgesamt,4577,2308,2269
False,8436079,Waldburg,unter 3 Jahre,85,52,33
False,8436079,Waldburg,3 -  6 Jahre,115,55,60
False,8436079,Waldburg,6 - 10 Jahre,206,97,109
False,8436079,Waldburg,10 - 15 Jahre,210,99,111
False,8436079,Waldburg,15 - 18 Jahre,120,61,59
False,8436079,Waldburg,18 - 20 Jahre,77,39,38
False,8436079,Waldburg,20 - 25 Jahre,130,67,63
False,8436079,Waldburg,25 - 30 Jahre,168,75,93
False,8436079,Waldburg,30 - 35 Jahre,169,88,81
False,8436079,Waldburg,35 - 40 Jahre,263,128,135
False,8436079,Waldburg,40 - 45 Jahre,291,139,152
False,8436079,Waldburg,45 - 50 Jahre,229,133,96
False,8436079,Waldburg,50 - 55 Jahre,200,106,94
False,8436079,Waldburg,55 - 60 Jahre,159,82,77
False,8436079,Waldburg,60 - 65 Jahre,143,65,78
False,8436079,Waldburg,65 - 75 Jahre,261,135,126
False,8436079,Waldburg,75 und mehr Jahre,187,66,121
False,8436079,Waldburg,Insgesamt,3013,1487,1526
False,8436081,"Wangen im Allgäu, Stadt",unter 3 Jahre,738,358,380
False,8436081,"Wangen im Allgäu, Stadt",3 -  6 Jahre,888,425,463
False,8436081,"Wangen im Allgäu, Stadt",6 - 10 Jahre,1293,617,676
False,8436081,"Wangen im Allgäu, Stadt",10 - 15 Jahre,1658,817,841
False,8436081,"Wangen im Allgäu, Stadt",15 - 18 Jahre,1126,560,566
False,8436081,"Wangen im Allgäu, Stadt",18 - 20 Jahre,647,326,321
False,8436081,"Wangen im Allgäu, Stadt",20 - 25 Jahre,1388,707,681
False,8436081,"Wangen im Allgäu, Stadt",25 - 30 Jahre,1422,691,731
False,8436081,"Wangen im Allgäu, Stadt",30 - 35 Jahre,1605,809,796
False,8436081,"Wangen im Allgäu, Stadt",35 - 40 Jahre,2329,1207,1122
False,8436081,"Wangen im Allgäu, Stadt",40 - 45 Jahre,2343,1186,1157
False,8436081,"Wangen im Allgäu, Stadt",45 - 50 Jahre,1906,955,951
False,8436081,"Wangen im Allgäu, Stadt",50 - 55 Jahre,1636,778,858
False,8436081,"Wangen im Allgäu, Stadt",55 - 60 Jahre,1582,813,769
False,8436081,"Wangen im Allgäu, Stadt",60 - 65 Jahre,1484,755,729
False,8436081,"Wangen im Allgäu, Stadt",65 - 75 Jahre,2759,1284,1475
False,8436081,"Wangen im Allgäu, Stadt",75 und mehr Jahre,2304,823,1481
False,8436081,"Wangen im Allgäu, Stadt",Insgesamt,27108,13111,13997
False,8436082,"Weingarten, Stadt",unter 3 Jahre,576,289,287
False,8436082,"Weingarten, Stadt",3 -  6 Jahre,623,344,279
False,8436082,"Weingarten, Stadt",6 - 10 Jahre,839,420,419
False,8436082,"Weingarten, Stadt",10 - 15 Jahre,1105,608,497
False,8436082,"Weingarten, Stadt",15 - 18 Jahre,793,429,364
False,8436082,"Weingarten, Stadt",18 - 20 Jahre,567,280,287
False,8436082,"Weingarten, Stadt",20 - 25 Jahre,1530,765,765
False,8436082,"Weingarten, Stadt",25 - 30 Jahre,1552,791,761
False,8436082,"Weingarten, Stadt",30 - 35 Jahre,1473,772,701
False,8436082,"Weingarten, Stadt",35 - 40 Jahre,1968,1038,930
False,8436082,"Weingarten, Stadt",40 - 45 Jahre,2038,1066,972
False,8436082,"Weingarten, Stadt",45 - 50 Jahre,1714,837,877
False,8436082,"Weingarten, Stadt",50 - 55 Jahre,1573,770,803
False,8436082,"Weingarten, Stadt",55 - 60 Jahre,1307,607,700
False,8436082,"Weingarten, Stadt",60 - 65 Jahre,1282,614,668
False,8436082,"Weingarten, Stadt",65 - 75 Jahre,2621,1243,1378
False,8436082,"Weingarten, Stadt",75 und mehr Jahre,2035,689,1346
False,8436082,"Weingarten, Stadt",Insgesamt,23596,11562,12034
False,8436083,Wilhelmsdorf,unter 3 Jahre,118,52,66
False,8436083,Wilhelmsdorf,3 -  6 Jahre,151,77,74
False,8436083,Wilhelmsdorf,6 - 10 Jahre,246,126,120
False,8436083,Wilhelmsdorf,10 - 15 Jahre,392,204,188
False,8436083,Wilhelmsdorf,15 - 18 Jahre,236,117,119
False,8436083,Wilhelmsdorf,18 - 20 Jahre,190,96,94
False,8436083,Wilhelmsdorf,20 - 25 Jahre,321,150,171
False,8436083,Wilhelmsdorf,25 - 30 Jahre,255,134,121
False,8436083,Wilhelmsdorf,30 - 35 Jahre,255,139,116
False,8436083,Wilhelmsdorf,35 - 40 Jahre,414,214,200
False,8436083,Wilhelmsdorf,40 - 45 Jahre,463,234,229
False,8436083,Wilhelmsdorf,45 - 50 Jahre,360,167,193
False,8436083,Wilhelmsdorf,50 - 55 Jahre,296,161,135
False,8436083,Wilhelmsdorf,55 - 60 Jahre,239,115,124
False,8436083,Wilhelmsdorf,60 - 65 Jahre,224,103,121
False,8436083,Wilhelmsdorf,65 - 75 Jahre,418,199,219
False,8436083,Wilhelmsdorf,75 und mehr Jahre,301,120,181
False,8436083,Wilhelmsdorf,Insgesamt,4879,2408,2471
False,8436085,Wolfegg,unter 3 Jahre,113,61,52
False,8436085,Wolfegg,3 -  6 Jahre,147,73,74
False,8436085,Wolfegg,6 - 10 Jahre,166,81,85
False,8436085,Wolfegg,10 - 15 Jahre,226,121,105
False,8436085,Wolfegg,15 - 18 Jahre,133,63,70
False,8436085,Wolfegg,18 - 20 Jahre,80,44,36
False,8436085,Wolfegg,20 - 25 Jahre,175,91,84
False,8436085,Wolfegg,25 - 30 Jahre,183,94,89
False,8436085,Wolfegg,30 - 35 Jahre,214,101,113
False,8436085,Wolfegg,35 - 40 Jahre,308,172,136
False,8436085,Wolfegg,40 - 45 Jahre,267,136,131
False,8436085,Wolfegg,45 - 50 Jahre,254,124,130
False,8436085,Wolfegg,50 - 55 Jahre,222,121,101
False,8436085,Wolfegg,55 - 60 Jahre,184,90,94
False,8436085,Wolfegg,60 - 65 Jahre,150,75,75
False,8436085,Wolfegg,65 - 75 Jahre,336,168,168
False,8436085,Wolfegg,75 und mehr Jahre,281,102,179
False,8436085,Wolfegg,Insgesamt,3439,1717,1722
False,8436087,Wolpertswende,unter 3 Jahre,139,78,61
False,8436087,Wolpertswende,3 -  6 Jahre,136,74,62
False,8436087,Wolpertswende,6 - 10 Jahre,208,113,95
False,8436087,Wolpertswende,10 - 15 Jahre,266,130,136
False,8436087,Wolpertswende,15 - 18 Jahre,190,102,88
False,8436087,Wolpertswende,18 - 20 Jahre,91,48,43
False,8436087,Wolpertswende,20 - 25 Jahre,251,121,130
False,8436087,Wolpertswende,25 - 30 Jahre,244,126,118
False,8436087,Wolpertswende,30 - 35 Jahre,257,117,140
False,8436087,Wolpertswende,35 - 40 Jahre,368,176,192
False,8436087,Wolpertswende,40 - 45 Jahre,364,186,178
False,8436087,Wolpertswende,45 - 50 Jahre,324,157,167
False,8436087,Wolpertswende,50 - 55 Jahre,270,139,131
False,8436087,Wolpertswende,55 - 60 Jahre,232,134,98
False,8436087,Wolpertswende,60 - 65 Jahre,194,101,93
False,8436087,Wolpertswende,65 - 75 Jahre,411,205,206
False,8436087,Wolpertswende,75 und mehr Jahre,216,77,139
False,8436087,Wolpertswende,Insgesamt,4161,2084,2077
False,8436093,Ebersbach-Musbach,unter 3 Jahre,52,32,20
False,8436093,Ebersbach-Musbach,3 -  6 Jahre,52,26,26
False,8436093,Ebersbach-Musbach,6 - 10 Jahre,116,54,62
False,8436093,Ebersbach-Musbach,10 - 15 Jahre,126,65,61
False,8436093,Ebersbach-Musbach,15 - 18 Jahre,89,46,43
False,8436093,Ebersbach-Musbach,18 - 20 Jahre,48,24,24
False,8436093,Ebersbach-Musbach,20 - 25 Jahre,82,36,46
False,8436093,Ebersbach-Musbach,25 - 30 Jahre,103,61,42
False,8436093,Ebersbach-Musbach,30 - 35 Jahre,104,51,53
False,8436093,Ebersbach-Musbach,35 - 40 Jahre,144,80,64
False,8436093,Ebersbach-Musbach,40 - 45 Jahre,202,110,92
False,8436093,Ebersbach-Musbach,45 - 50 Jahre,179,106,73
False,8436093,Ebersbach-Musbach,50 - 55 Jahre,118,65,53
False,8436093,Ebersbach-Musbach,55 - 60 Jahre,69,36,33
False,8436093,Ebersbach-Musbach,60 - 65 Jahre,86,54,32
False,8436093,Ebersbach-Musbach,65 - 75 Jahre,139,77,62
False,8436093,Ebersbach-Musbach,75 und mehr Jahre,104,35,69
False,8436093,Ebersbach-Musbach,Insgesamt,1813,958,855
False,8436094,Argenbühl,unter 3 Jahre,175,82,93
False,8436094,Argenbühl,3 -  6 Jahre,206,118,88
False,8436094,Argenbühl,6 - 10 Jahre,318,163,155
False,8436094,Argenbühl,10 - 15 Jahre,431,217,214
False,8436094,Argenbühl,15 - 18 Jahre,256,131,125
False,8436094,Argenbühl,18 - 20 Jahre,180,98,82
False,8436094,Argenbühl,20 - 25 Jahre,364,194,170
False,8436094,Argenbühl,25 - 30 Jahre,328,167,161
False,8436094,Argenbühl,30 - 35 Jahre,366,179,187
False,8436094,Argenbühl,35 - 40 Jahre,514,264,250
False,8436094,Argenbühl,40 - 45 Jahre,515,256,259
False,8436094,Argenbühl,45 - 50 Jahre,425,209,216
False,8436094,Argenbühl,50 - 55 Jahre,373,194,179
False,8436094,Argenbühl,55 - 60 Jahre,344,192,152
False,8436094,Argenbühl,60 - 65 Jahre,245,123,122
False,8436094,Argenbühl,65 - 75 Jahre,476,238,238
False,8436094,Argenbühl,75 und mehr Jahre,350,120,230
False,8436094,Argenbühl,Insgesamt,5866,2945,2921
False,8436095,Horgenzell,unter 3 Jahre,166,82,84
False,8436095,Horgenzell,3 -  6 Jahre,194,103,91
False,8436095,Horgenzell,6 - 10 Jahre,272,133,139
False,8436095,Horgenzell,10 - 15 Jahre,305,164,141
False,8436095,Horgenzell,15 - 18 Jahre,210,119,91
False,8436095,Horgenzell,18 - 20 Jahre,138,73,65
False,8436095,Horgenzell,20 - 25 Jahre,310,161,149
False,8436095,Horgenzell,25 - 30 Jahre,309,146,163
False,8436095,Horgenzell,30 - 35 Jahre,354,184,170
False,8436095,Horgenzell,35 - 40 Jahre,483,234,249
False,8436095,Horgenzell,40 - 45 Jahre,416,222,194
False,8436095,Horgenzell,45 - 50 Jahre,332,165,167
False,8436095,Horgenzell,50 - 55 Jahre,253,131,122
False,8436095,Horgenzell,55 - 60 Jahre,226,120,106
False,8436095,Horgenzell,60 - 65 Jahre,163,85,78
False,8436095,Horgenzell,65 - 75 Jahre,347,170,177
False,8436095,Horgenzell,75 und mehr Jahre,257,105,152
False,8436095,Horgenzell,Insgesamt,4735,2397,2338
False,8436096,Fronreute,unter 3 Jahre,119,66,53
False,8436096,Fronreute,3 -  6 Jahre,161,72,89
False,8436096,Fronreute,6 - 10 Jahre,250,140,110
False,8436096,Fronreute,10 - 15 Jahre,301,158,143
False,8436096,Fronreute,15 - 18 Jahre,181,92,89
False,8436096,Fronreute,18 - 20 Jahre,117,67,50
False,8436096,Fronreute,20 - 25 Jahre,252,126,126
False,8436096,Fronreute,25 - 30 Jahre,247,122,125
False,8436096,Fronreute,30 - 35 Jahre,280,147,133
False,8436096,Fronreute,35 - 40 Jahre,385,186,199
False,8436096,Fronreute,40 - 45 Jahre,406,211,195
False,8436096,Fronreute,45 - 50 Jahre,330,168,162
False,8436096,Fronreute,50 - 55 Jahre,305,149,156
False,8436096,Fronreute,55 - 60 Jahre,242,134,108
False,8436096,Fronreute,60 - 65 Jahre,183,105,78
False,8436096,Fronreute,65 - 75 Jahre,350,172,178
False,8436096,Fronreute,75 und mehr Jahre,230,88,142
False,8436096,Fronreute,Insgesamt,4339,2203,2136
False,8437,Landkreis Sigmaringen,unter 3 Jahre,3692,1949,1743
False,8437,Landkreis Sigmaringen,3 -  6 Jahre,4216,2116,2100
False,8437,Landkreis Sigmaringen,6 - 10 Jahre,6472,3328,3144
False,8437,Landkreis Sigmaringen,10 - 15 Jahre,8521,4322,4199
False,8437,Landkreis Sigmaringen,15 - 18 Jahre,5527,2885,2642
False,8437,Landkreis Sigmaringen,18 - 20 Jahre,3623,1833,1790
False,8437,Landkreis Sigmaringen,20 - 25 Jahre,7941,4097,3844
False,8437,Landkreis Sigmaringen,25 - 30 Jahre,7304,3768,3536
False,8437,Landkreis Sigmaringen,30 - 35 Jahre,7773,3916,3857
False,8437,Landkreis Sigmaringen,35 - 40 Jahre,11134,5868,5266
False,8437,Landkreis Sigmaringen,40 - 45 Jahre,12151,6339,5812
False,8437,Landkreis Sigmaringen,45 - 50 Jahre,10060,5117,4943
False,8437,Landkreis Sigmaringen,50 - 55 Jahre,8380,4187,4193
False,8437,Landkreis Sigmaringen,55 - 60 Jahre,6973,3582,3391
False,8437,Landkreis Sigmaringen,60 - 65 Jahre,6227,3067,3160
False,8437,Landkreis Sigmaringen,65 - 75 Jahre,13438,6309,7129
False,8437,Landkreis Sigmaringen,75 und mehr Jahre,9953,3503,6450
False,8437,Landkreis Sigmaringen,Insgesamt,133385,66186,67199
False,8437005,Beuron,unter 3 Jahre,20,12,8
False,8437005,Beuron,3 -  6 Jahre,17,8,9
False,8437005,Beuron,6 - 10 Jahre,32,16,16
False,8437005,Beuron,10 - 15 Jahre,36,23,13
False,8437005,Beuron,15 - 18 Jahre,29,15,14
False,8437005,Beuron,18 - 20 Jahre,14,5,9
False,8437005,Beuron,20 - 25 Jahre,24,10,14
False,8437005,Beuron,25 - 30 Jahre,27,11,16
False,8437005,Beuron,30 - 35 Jahre,29,14,15
False,8437005,Beuron,35 - 40 Jahre,34,17,17
False,8437005,Beuron,40 - 45 Jahre,58,38,20
False,8437005,Beuron,45 - 50 Jahre,58,30,28
False,8437005,Beuron,50 - 55 Jahre,49,28,21
False,8437005,Beuron,55 - 60 Jahre,54,22,32
False,8437005,Beuron,60 - 65 Jahre,45,31,14
False,8437005,Beuron,65 - 75 Jahre,94,53,41
False,8437005,Beuron,75 und mehr Jahre,98,38,60
False,8437005,Beuron,Insgesamt,718,371,347
False,8437008,Bingen,unter 3 Jahre,83,50,33
False,8437008,Bingen,3 -  6 Jahre,120,65,55
False,8437008,Bingen,6 - 10 Jahre,156,74,82
False,8437008,Bingen,10 - 15 Jahre,183,83,100
False,8437008,Bingen,15 - 18 Jahre,117,62,55
False,8437008,Bingen,18 - 20 Jahre,79,40,39
False,8437008,Bingen,20 - 25 Jahre,139,69,70
False,8437008,Bingen,25 - 30 Jahre,149,77,72
False,8437008,Bingen,30 - 35 Jahre,164,75,89
False,8437008,Bingen,35 - 40 Jahre,255,118,137
False,8437008,Bingen,40 - 45 Jahre,286,154,132
False,8437008,Bingen,45 - 50 Jahre,214,106,108
False,8437008,Bingen,50 - 55 Jahre,195,99,96
False,8437008,Bingen,55 - 60 Jahre,171,94,77
False,8437008,Bingen,60 - 65 Jahre,141,69,72
False,8437008,Bingen,65 - 75 Jahre,290,146,144
False,8437008,Bingen,75 und mehr Jahre,182,65,117
False,8437008,Bingen,Insgesamt,2924,1446,1478
False,8437031,"Gammertingen, Stadt",unter 3 Jahre,179,90,89
False,8437031,"Gammertingen, Stadt",3 -  6 Jahre,201,103,98
False,8437031,"Gammertingen, Stadt",6 - 10 Jahre,335,181,154
False,8437031,"Gammertingen, Stadt",10 - 15 Jahre,423,210,213
False,8437031,"Gammertingen, Stadt",15 - 18 Jahre,281,163,118
False,8437031,"Gammertingen, Stadt",18 - 20 Jahre,224,109,115
False,8437031,"Gammertingen, Stadt",20 - 25 Jahre,397,210,187
False,8437031,"Gammertingen, Stadt",25 - 30 Jahre,338,158,180
False,8437031,"Gammertingen, Stadt",30 - 35 Jahre,416,223,193
False,8437031,"Gammertingen, Stadt",35 - 40 Jahre,525,284,241
False,8437031,"Gammertingen, Stadt",40 - 45 Jahre,610,302,308
False,8437031,"Gammertingen, Stadt",45 - 50 Jahre,513,251,262
False,8437031,"Gammertingen, Stadt",50 - 55 Jahre,460,218,242
False,8437031,"Gammertingen, Stadt",55 - 60 Jahre,381,196,185
False,8437031,"Gammertingen, Stadt",60 - 65 Jahre,357,167,190
False,8437031,"Gammertingen, Stadt",65 - 75 Jahre,716,331,385
False,8437031,"Gammertingen, Stadt",75 und mehr Jahre,472,171,301
False,8437031,"Gammertingen, Stadt",Insgesamt,6828,3367,3461
False,8437044,Herbertingen,unter 3 Jahre,155,87,68
False,8437044,Herbertingen,3 -  6 Jahre,187,105,82
False,8437044,Herbertingen,6 - 10 Jahre,275,148,127
False,8437044,Herbertingen,10 - 15 Jahre,350,176,174
False,8437044,Herbertingen,15 - 18 Jahre,222,109,113
False,8437044,Herbertingen,18 - 20 Jahre,132,71,61
False,8437044,Herbertingen,20 - 25 Jahre,288,146,142
False,8437044,Herbertingen,25 - 30 Jahre,248,129,119
False,8437044,Herbertingen,30 - 35 Jahre,326,175,151
False,8437044,Herbertingen,35 - 40 Jahre,433,212,221
False,8437044,Herbertingen,40 - 45 Jahre,429,234,195
False,8437044,Herbertingen,45 - 50 Jahre,342,176,166
False,8437044,Herbertingen,50 - 55 Jahre,319,167,152
False,8437044,Herbertingen,55 - 60 Jahre,244,123,121
False,8437044,Herbertingen,60 - 65 Jahre,228,111,117
False,8437044,Herbertingen,65 - 75 Jahre,446,206,240
False,8437044,Herbertingen,75 und mehr Jahre,314,114,200
False,8437044,Herbertingen,Insgesamt,4938,2489,2449
False,8437047,"Hettingen, Stadt",unter 3 Jahre,47,25,22
False,8437047,"Hettingen, Stadt",3 -  6 Jahre,63,28,35
False,8437047,"Hettingen, Stadt",6 - 10 Jahre,109,54,55
False,8437047,"Hettingen, Stadt",10 - 15 Jahre,139,60,79
False,8437047,"Hettingen, Stadt",15 - 18 Jahre,80,42,38
False,8437047,"Hettingen, Stadt",18 - 20 Jahre,53,31,22
False,8437047,"Hettingen, Stadt",20 - 25 Jahre,121,57,64
False,8437047,"Hettingen, Stadt",25 - 30 Jahre,96,58,38
False,8437047,"Hettingen, Stadt",30 - 35 Jahre,110,49,61
False,8437047,"Hettingen, Stadt",35 - 40 Jahre,163,91,72
False,8437047,"Hettingen, Stadt",40 - 45 Jahre,190,106,84
False,8437047,"Hettingen, Stadt",45 - 50 Jahre,165,83,82
False,8437047,"Hettingen, Stadt",50 - 55 Jahre,126,64,62
False,8437047,"Hettingen, Stadt",55 - 60 Jahre,101,55,46
False,8437047,"Hettingen, Stadt",60 - 65 Jahre,92,47,45
False,8437047,"Hettingen, Stadt",65 - 75 Jahre,232,102,130
False,8437047,"Hettingen, Stadt",75 und mehr Jahre,111,43,68
False,8437047,"Hettingen, Stadt",Insgesamt,1998,995,1003
False,8437053,Hohentengen,unter 3 Jahre,133,66,67
False,8437053,Hohentengen,3 -  6 Jahre,145,68,77
False,8437053,Hohentengen,6 - 10 Jahre,261,135,126
False,8437053,Hohentengen,10 - 15 Jahre,294,145,149
False,8437053,Hohentengen,15 - 18 Jahre,177,98,79
False,8437053,Hohentengen,18 - 20 Jahre,124,64,60
False,8437053,Hohentengen,20 - 25 Jahre,233,109,124
False,8437053,Hohentengen,25 - 30 Jahre,248,130,118
False,8437053,Hohentengen,30 - 35 Jahre,277,148,129
False,8437053,Hohentengen,35 - 40 Jahre,493,321,172
False,8437053,Hohentengen,40 - 45 Jahre,444,271,173
False,8437053,Hohentengen,45 - 50 Jahre,309,166,143
False,8437053,Hohentengen,50 - 55 Jahre,252,142,110
False,8437053,Hohentengen,55 - 60 Jahre,221,122,99
False,8437053,Hohentengen,60 - 65 Jahre,166,79,87
False,8437053,Hohentengen,65 - 75 Jahre,418,203,215
False,8437053,Hohentengen,75 und mehr Jahre,253,92,161
False,8437053,Hohentengen,Insgesamt,4448,2359,2089
False,8437056,Illmensee,unter 3 Jahre,63,37,26
False,8437056,Illmensee,3 -  6 Jahre,68,35,33
False,8437056,Illmensee,6 - 10 Jahre,97,55,42
False,8437056,Illmensee,10 - 15 Jahre,159,78,81
False,8437056,Illmensee,15 - 18 Jahre,85,43,42
False,8437056,Illmensee,18 - 20 Jahre,66,41,25
False,8437056,Illmensee,20 - 25 Jahre,110,63,47
False,8437056,Illmensee,25 - 30 Jahre,117,50,67
False,8437056,Illmensee,30 - 35 Jahre,135,71,64
False,8437056,Illmensee,35 - 40 Jahre,150,78,72
False,8437056,Illmensee,40 - 45 Jahre,172,91,81
False,8437056,Illmensee,45 - 50 Jahre,195,97,98
False,8437056,Illmensee,50 - 55 Jahre,154,79,75
False,8437056,Illmensee,55 - 60 Jahre,128,69,59
False,8437056,Illmensee,60 - 65 Jahre,68,33,35
False,8437056,Illmensee,65 - 75 Jahre,167,74,93
False,8437056,Illmensee,75 und mehr Jahre,123,45,78
False,8437056,Illmensee,Insgesamt,2057,1039,1018
False,8437059,Inzigkofen,unter 3 Jahre,99,45,54
False,8437059,Inzigkofen,3 -  6 Jahre,108,53,55
False,8437059,Inzigkofen,6 - 10 Jahre,143,73,70
False,8437059,Inzigkofen,10 - 15 Jahre,160,71,89
False,8437059,Inzigkofen,15 - 18 Jahre,135,62,73
False,8437059,Inzigkofen,18 - 20 Jahre,86,43,43
False,8437059,Inzigkofen,20 - 25 Jahre,156,77,79
False,8437059,Inzigkofen,25 - 30 Jahre,137,73,64
False,8437059,Inzigkofen,30 - 35 Jahre,169,76,93
False,8437059,Inzigkofen,35 - 40 Jahre,257,130,127
False,8437059,Inzigkofen,40 - 45 Jahre,287,149,138
False,8437059,Inzigkofen,45 - 50 Jahre,247,134,113
False,8437059,Inzigkofen,50 - 55 Jahre,182,82,100
False,8437059,Inzigkofen,55 - 60 Jahre,151,79,72
False,8437059,Inzigkofen,60 - 65 Jahre,124,63,61
False,8437059,Inzigkofen,65 - 75 Jahre,305,163,142
False,8437059,Inzigkofen,75 und mehr Jahre,201,73,128
False,8437059,Inzigkofen,Insgesamt,2947,1446,1501
False,8437065,Krauchenwies,unter 3 Jahre,156,72,84
False,8437065,Krauchenwies,3 -  6 Jahre,161,72,89
False,8437065,Krauchenwies,6 - 10 Jahre,255,130,125
False,8437065,Krauchenwies,10 - 15 Jahre,341,187,154
False,8437065,Krauchenwies,15 - 18 Jahre,201,99,102
False,8437065,Krauchenwies,18 - 20 Jahre,129,63,66
False,8437065,Krauchenwies,20 - 25 Jahre,315,162,153
False,8437065,Krauchenwies,25 - 30 Jahre,301,160,141
False,8437065,Krauchenwies,30 - 35 Jahre,315,162,153
False,8437065,Krauchenwies,35 - 40 Jahre,436,221,215
False,8437065,Krauchenwies,40 - 45 Jahre,422,210,212
False,8437065,Krauchenwies,45 - 50 Jahre,446,234,212
False,8437065,Krauchenwies,50 - 55 Jahre,357,184,173
False,8437065,Krauchenwies,55 - 60 Jahre,238,126,112
False,8437065,Krauchenwies,60 - 65 Jahre,218,114,104
False,8437065,Krauchenwies,65 - 75 Jahre,421,198,223
False,8437065,Krauchenwies,75 und mehr Jahre,350,116,234
False,8437065,Krauchenwies,Insgesamt,5062,2510,2552
False,8437072,Leibertingen,unter 3 Jahre,76,42,34
False,8437072,Leibertingen,3 -  6 Jahre,72,40,32
False,8437072,Leibertingen,6 - 10 Jahre,129,69,60
False,8437072,Leibertingen,10 - 15 Jahre,138,76,62
False,8437072,Leibertingen,15 - 18 Jahre,105,52,53
False,8437072,Leibertingen,18 - 20 Jahre,64,36,28
False,8437072,Leibertingen,20 - 25 Jahre,147,84,63
False,8437072,Leibertingen,25 - 30 Jahre,107,57,50
False,8437072,Leibertingen,30 - 35 Jahre,122,62,60
False,8437072,Leibertingen,35 - 40 Jahre,212,106,106
False,8437072,Leibertingen,40 - 45 Jahre,224,121,103
False,8437072,Leibertingen,45 - 50 Jahre,188,106,82
False,8437072,Leibertingen,50 - 55 Jahre,136,69,67
False,8437072,Leibertingen,55 - 60 Jahre,99,50,49
False,8437072,Leibertingen,60 - 65 Jahre,88,48,40
False,8437072,Leibertingen,65 - 75 Jahre,235,119,116
False,8437072,Leibertingen,75 und mehr Jahre,151,57,94
False,8437072,Leibertingen,Insgesamt,2293,1194,1099
False,8437076,"Mengen, Stadt",unter 3 Jahre,267,142,125
False,8437076,"Mengen, Stadt",3 -  6 Jahre,340,165,175
False,8437076,"Mengen, Stadt",6 - 10 Jahre,470,246,224
False,8437076,"Mengen, Stadt",10 - 15 Jahre,672,329,343
False,8437076,"Mengen, Stadt",15 - 18 Jahre,434,226,208
False,8437076,"Mengen, Stadt",18 - 20 Jahre,280,154,126
False,8437076,"Mengen, Stadt",20 - 25 Jahre,579,303,276
False,8437076,"Mengen, Stadt",25 - 30 Jahre,561,299,262
False,8437076,"Mengen, Stadt",30 - 35 Jahre,619,302,317
False,8437076,"Mengen, Stadt",35 - 40 Jahre,784,383,401
False,8437076,"Mengen, Stadt",40 - 45 Jahre,894,448,446
False,8437076,"Mengen, Stadt",45 - 50 Jahre,729,375,354
False,8437076,"Mengen, Stadt",50 - 55 Jahre,666,337,329
False,8437076,"Mengen, Stadt",55 - 60 Jahre,560,297,263
False,8437076,"Mengen, Stadt",60 - 65 Jahre,500,242,258
False,8437076,"Mengen, Stadt",65 - 75 Jahre,1077,517,560
False,8437076,"Mengen, Stadt",75 und mehr Jahre,773,251,522
False,8437076,"Mengen, Stadt",Insgesamt,10205,5016,5189
False,8437078,"Meßkirch, Stadt",unter 3 Jahre,234,123,111
False,8437078,"Meßkirch, Stadt",3 -  6 Jahre,264,140,124
False,8437078,"Meßkirch, Stadt",6 - 10 Jahre,395,203,192
False,8437078,"Meßkirch, Stadt",10 - 15 Jahre,586,298,288
False,8437078,"Meßkirch, Stadt",15 - 18 Jahre,405,220,185
False,8437078,"Meßkirch, Stadt",18 - 20 Jahre,285,158,127
False,8437078,"Meßkirch, Stadt",20 - 25 Jahre,515,268,247
False,8437078,"Meßkirch, Stadt",25 - 30 Jahre,500,232,268
False,8437078,"Meßkirch, Stadt",30 - 35 Jahre,470,240,230
False,8437078,"Meßkirch, Stadt",35 - 40 Jahre,594,290,304
False,8437078,"Meßkirch, Stadt",40 - 45 Jahre,750,375,375
False,8437078,"Meßkirch, Stadt",45 - 50 Jahre,641,339,302
False,8437078,"Meßkirch, Stadt",50 - 55 Jahre,529,275,254
False,8437078,"Meßkirch, Stadt",55 - 60 Jahre,433,224,209
False,8437078,"Meßkirch, Stadt",60 - 65 Jahre,361,176,185
False,8437078,"Meßkirch, Stadt",65 - 75 Jahre,899,415,484
False,8437078,"Meßkirch, Stadt",75 und mehr Jahre,722,264,458
False,8437078,"Meßkirch, Stadt",Insgesamt,8583,4240,4343
False,8437082,Neufra,unter 3 Jahre,52,29,23
False,8437082,Neufra,3 -  6 Jahre,54,30,24
False,8437082,Neufra,6 - 10 Jahre,86,41,45
False,8437082,Neufra,10 - 15 Jahre,117,56,61
False,8437082,Neufra,15 - 18 Jahre,78,32,46
False,8437082,Neufra,18 - 20 Jahre,40,22,18
False,8437082,Neufra,20 - 25 Jahre,120,53,67
False,8437082,Neufra,25 - 30 Jahre,86,39,47
False,8437082,Neufra,30 - 35 Jahre,111,57,54
False,8437082,Neufra,35 - 40 Jahre,149,77,72
False,8437082,Neufra,40 - 45 Jahre,178,83,95
False,8437082,Neufra,45 - 50 Jahre,175,84,91
False,8437082,Neufra,50 - 55 Jahre,130,70,60
False,8437082,Neufra,55 - 60 Jahre,100,42,58
False,8437082,Neufra,60 - 65 Jahre,107,57,50
False,8437082,Neufra,65 - 75 Jahre,191,93,98
False,8437082,Neufra,75 und mehr Jahre,152,55,97
False,8437082,Neufra,Insgesamt,1926,920,1006
False,8437086,Ostrach,unter 3 Jahre,187,100,87
False,8437086,Ostrach,3 -  6 Jahre,238,129,109
False,8437086,Ostrach,6 - 10 Jahre,372,204,168
False,8437086,Ostrach,10 - 15 Jahre,510,255,255
False,8437086,Ostrach,15 - 18 Jahre,332,172,160
False,8437086,Ostrach,18 - 20 Jahre,223,111,112
False,8437086,Ostrach,20 - 25 Jahre,430,230,200
False,8437086,Ostrach,25 - 30 Jahre,318,168,150
False,8437086,Ostrach,30 - 35 Jahre,377,175,202
False,8437086,Ostrach,35 - 40 Jahre,564,292,272
False,8437086,Ostrach,40 - 45 Jahre,631,292,339
False,8437086,Ostrach,45 - 50 Jahre,554,266,288
False,8437086,Ostrach,50 - 55 Jahre,427,234,193
False,8437086,Ostrach,55 - 60 Jahre,315,167,148
False,8437086,Ostrach,60 - 65 Jahre,278,125,153
False,8437086,Ostrach,65 - 75 Jahre,624,293,331
False,8437086,Ostrach,75 und mehr Jahre,463,148,315
False,8437086,Ostrach,Insgesamt,6843,3361,3482
False,8437088,"Pfullendorf, Stadt",unter 3 Jahre,420,225,195
False,8437088,"Pfullendorf, Stadt",3 -  6 Jahre,454,218,236
False,8437088,"Pfullendorf, Stadt",6 - 10 Jahre,679,358,321
False,8437088,"Pfullendorf, Stadt",10 - 15 Jahre,877,460,417
False,8437088,"Pfullendorf, Stadt",15 - 18 Jahre,541,294,247
False,8437088,"Pfullendorf, Stadt",18 - 20 Jahre,347,179,168
False,8437088,"Pfullendorf, Stadt",20 - 25 Jahre,838,459,379
False,8437088,"Pfullendorf, Stadt",25 - 30 Jahre,769,414,355
False,8437088,"Pfullendorf, Stadt",30 - 35 Jahre,847,436,411
False,8437088,"Pfullendorf, Stadt",35 - 40 Jahre,1016,531,485
False,8437088,"Pfullendorf, Stadt",40 - 45 Jahre,1232,673,559
False,8437088,"Pfullendorf, Stadt",45 - 50 Jahre,1007,527,480
False,8437088,"Pfullendorf, Stadt",50 - 55 Jahre,767,377,390
False,8437088,"Pfullendorf, Stadt",55 - 60 Jahre,678,340,338
False,8437088,"Pfullendorf, Stadt",60 - 65 Jahre,602,297,305
False,8437088,"Pfullendorf, Stadt",65 - 75 Jahre,1235,602,633
False,8437088,"Pfullendorf, Stadt",75 und mehr Jahre,801,309,492
False,8437088,"Pfullendorf, Stadt",Insgesamt,13110,6699,6411
False,8437100,"Bad Saulgau, Stadt",unter 3 Jahre,489,248,241
False,8437100,"Bad Saulgau, Stadt",3 -  6 Jahre,548,268,280
False,8437100,"Bad Saulgau, Stadt",6 - 10 Jahre,839,402,437
False,8437100,"Bad Saulgau, Stadt",10 - 15 Jahre,1067,565,502
False,8437100,"Bad Saulgau, Stadt",15 - 18 Jahre,727,380,347
False,8437100,"Bad Saulgau, Stadt",18 - 20 Jahre,437,213,224
False,8437100,"Bad Saulgau, Stadt",20 - 25 Jahre,1035,516,519
False,8437100,"Bad Saulgau, Stadt",25 - 30 Jahre,1027,500,527
False,8437100,"Bad Saulgau, Stadt",30 - 35 Jahre,1056,525,531
False,8437100,"Bad Saulgau, Stadt",35 - 40 Jahre,1409,694,715
False,8437100,"Bad Saulgau, Stadt",40 - 45 Jahre,1448,719,729
False,8437100,"Bad Saulgau, Stadt",45 - 50 Jahre,1232,588,644
False,8437100,"Bad Saulgau, Stadt",50 - 55 Jahre,1091,507,584
False,8437100,"Bad Saulgau, Stadt",55 - 60 Jahre,955,484,471
False,8437100,"Bad Saulgau, Stadt",60 - 65 Jahre,869,422,447
False,8437100,"Bad Saulgau, Stadt",65 - 75 Jahre,1905,852,1053
False,8437100,"Bad Saulgau, Stadt",75 und mehr Jahre,1556,518,1038
False,8437100,"Bad Saulgau, Stadt",Insgesamt,17690,8401,9289
False,8437101,"Scheer, Stadt",unter 3 Jahre,62,35,27
False,8437101,"Scheer, Stadt",3 -  6 Jahre,82,41,41
False,8437101,"Scheer, Stadt",6 - 10 Jahre,128,76,52
False,8437101,"Scheer, Stadt",10 - 15 Jahre,174,81,93
False,8437101,"Scheer, Stadt",15 - 18 Jahre,102,59,43
False,8437101,"Scheer, Stadt",18 - 20 Jahre,65,38,27
False,8437101,"Scheer, Stadt",20 - 25 Jahre,130,75,55
False,8437101,"Scheer, Stadt",25 - 30 Jahre,120,50,70
False,8437101,"Scheer, Stadt",30 - 35 Jahre,148,81,67
False,8437101,"Scheer, Stadt",35 - 40 Jahre,233,111,122
False,8437101,"Scheer, Stadt",40 - 45 Jahre,239,126,113
False,8437101,"Scheer, Stadt",45 - 50 Jahre,216,104,112
False,8437101,"Scheer, Stadt",50 - 55 Jahre,174,85,89
False,8437101,"Scheer, Stadt",55 - 60 Jahre,172,88,84
False,8437101,"Scheer, Stadt",60 - 65 Jahre,114,57,57
False,8437101,"Scheer, Stadt",65 - 75 Jahre,263,131,132
False,8437101,"Scheer, Stadt",75 und mehr Jahre,205,80,125
False,8437101,"Scheer, Stadt",Insgesamt,2627,1318,1309
False,8437102,Schwenningen,unter 3 Jahre,52,27,25
False,8437102,Schwenningen,3 -  6 Jahre,53,25,28
False,8437102,Schwenningen,6 - 10 Jahre,88,41,47
False,8437102,Schwenningen,10 - 15 Jahre,109,54,55
False,8437102,Schwenningen,15 - 18 Jahre,74,33,41
False,8437102,Schwenningen,18 - 20 Jahre,42,15,27
False,8437102,Schwenningen,20 - 25 Jahre,100,48,52
False,8437102,Schwenningen,25 - 30 Jahre,86,54,32
False,8437102,Schwenningen,30 - 35 Jahre,61,32,29
False,8437102,Schwenningen,35 - 40 Jahre,104,47,57
False,8437102,Schwenningen,40 - 45 Jahre,153,88,65
False,8437102,Schwenningen,45 - 50 Jahre,107,52,55
False,8437102,Schwenningen,50 - 55 Jahre,112,60,52
False,8437102,Schwenningen,55 - 60 Jahre,66,28,38
False,8437102,Schwenningen,60 - 65 Jahre,77,41,36
False,8437102,Schwenningen,65 - 75 Jahre,184,84,100
False,8437102,Schwenningen,75 und mehr Jahre,96,40,56
False,8437102,Schwenningen,Insgesamt,1564,769,795
False,8437104,"Sigmaringen, Stadt",unter 3 Jahre,413,228,185
False,8437104,"Sigmaringen, Stadt",3 -  6 Jahre,440,218,222
False,8437104,"Sigmaringen, Stadt",6 - 10 Jahre,646,326,320
False,8437104,"Sigmaringen, Stadt",10 - 15 Jahre,882,475,407
False,8437104,"Sigmaringen, Stadt",15 - 18 Jahre,574,307,267
False,8437104,"Sigmaringen, Stadt",18 - 20 Jahre,390,174,216
False,8437104,"Sigmaringen, Stadt",20 - 25 Jahre,1076,519,557
False,8437104,"Sigmaringen, Stadt",25 - 30 Jahre,1052,579,473
False,8437104,"Sigmaringen, Stadt",30 - 35 Jahre,907,452,455
False,8437104,"Sigmaringen, Stadt",35 - 40 Jahre,1537,940,597
False,8437104,"Sigmaringen, Stadt",40 - 45 Jahre,1721,1003,718
False,8437104,"Sigmaringen, Stadt",45 - 50 Jahre,1139,555,584
False,8437104,"Sigmaringen, Stadt",50 - 55 Jahre,991,485,506
False,8437104,"Sigmaringen, Stadt",55 - 60 Jahre,855,446,409
False,8437104,"Sigmaringen, Stadt",60 - 65 Jahre,856,405,451
False,8437104,"Sigmaringen, Stadt",65 - 75 Jahre,1682,740,942
False,8437104,"Sigmaringen, Stadt",75 und mehr Jahre,1497,526,971
False,8437104,"Sigmaringen, Stadt",Insgesamt,16658,8378,8280
False,8437105,Sigmaringendorf,unter 3 Jahre,88,46,42
False,8437105,Sigmaringendorf,3 -  6 Jahre,122,76,46
False,8437105,Sigmaringendorf,6 - 10 Jahre,157,77,80
False,8437105,Sigmaringendorf,10 - 15 Jahre,241,119,122
False,8437105,Sigmaringendorf,15 - 18 Jahre,119,59,60
False,8437105,Sigmaringendorf,18 - 20 Jahre,98,50,48
False,8437105,Sigmaringendorf,20 - 25 Jahre,220,116,104
False,8437105,Sigmaringendorf,25 - 30 Jahre,174,92,82
False,8437105,Sigmaringendorf,30 - 35 Jahre,189,98,91
False,8437105,Sigmaringendorf,35 - 40 Jahre,281,147,134
False,8437105,Sigmaringendorf,40 - 45 Jahre,320,163,157
False,8437105,Sigmaringendorf,45 - 50 Jahre,257,130,127
False,8437105,Sigmaringendorf,50 - 55 Jahre,244,118,126
False,8437105,Sigmaringendorf,55 - 60 Jahre,240,112,128
False,8437105,Sigmaringendorf,60 - 65 Jahre,246,126,120
False,8437105,Sigmaringendorf,65 - 75 Jahre,458,229,229
False,8437105,Sigmaringendorf,75 und mehr Jahre,306,100,206
False,8437105,Sigmaringendorf,Insgesamt,3760,1858,1902
False,8437107,Stetten am kalten Markt,unter 3 Jahre,127,66,61
False,8437107,Stetten am kalten Markt,3 -  6 Jahre,159,83,76
False,8437107,Stetten am kalten Markt,6 - 10 Jahre,271,127,144
False,8437107,Stetten am kalten Markt,10 - 15 Jahre,325,151,174
False,8437107,Stetten am kalten Markt,15 - 18 Jahre,237,119,118
False,8437107,Stetten am kalten Markt,18 - 20 Jahre,131,66,65
False,8437107,Stetten am kalten Markt,20 - 25 Jahre,340,208,132
False,8437107,Stetten am kalten Markt,25 - 30 Jahre,298,172,126
False,8437107,Stetten am kalten Markt,30 - 35 Jahre,292,170,122
False,8437107,Stetten am kalten Markt,35 - 40 Jahre,524,333,191
False,8437107,Stetten am kalten Markt,40 - 45 Jahre,442,204,238
False,8437107,Stetten am kalten Markt,45 - 50 Jahre,367,191,176
False,8437107,Stetten am kalten Markt,50 - 55 Jahre,340,178,162
False,8437107,Stetten am kalten Markt,55 - 60 Jahre,263,128,135
False,8437107,Stetten am kalten Markt,60 - 65 Jahre,260,136,124
False,8437107,Stetten am kalten Markt,65 - 75 Jahre,534,258,276
False,8437107,Stetten am kalten Markt,75 und mehr Jahre,435,139,296
False,8437107,Stetten am kalten Markt,Insgesamt,5345,2729,2616
False,8437114,"Veringenstadt, Stadt",unter 3 Jahre,65,33,32
False,8437114,"Veringenstadt, Stadt",3 -  6 Jahre,61,33,28
False,8437114,"Veringenstadt, Stadt",6 - 10 Jahre,127,73,54
False,8437114,"Veringenstadt, Stadt",10 - 15 Jahre,170,94,76
False,8437114,"Veringenstadt, Stadt",15 - 18 Jahre,97,50,47
False,8437114,"Veringenstadt, Stadt",18 - 20 Jahre,57,32,25
False,8437114,"Veringenstadt, Stadt",20 - 25 Jahre,146,84,62
False,8437114,"Veringenstadt, Stadt",25 - 30 Jahre,115,60,55
False,8437114,"Veringenstadt, Stadt",30 - 35 Jahre,131,66,65
False,8437114,"Veringenstadt, Stadt",35 - 40 Jahre,176,87,89
False,8437114,"Veringenstadt, Stadt",40 - 45 Jahre,172,85,87
False,8437114,"Veringenstadt, Stadt",45 - 50 Jahre,188,98,90
False,8437114,"Veringenstadt, Stadt",50 - 55 Jahre,154,71,83
False,8437114,"Veringenstadt, Stadt",55 - 60 Jahre,141,72,69
False,8437114,"Veringenstadt, Stadt",60 - 65 Jahre,106,53,53
False,8437114,"Veringenstadt, Stadt",65 - 75 Jahre,244,114,130
False,8437114,"Veringenstadt, Stadt",75 und mehr Jahre,168,65,103
False,8437114,"Veringenstadt, Stadt",Insgesamt,2318,1170,1148
False,8437118,Wald,unter 3 Jahre,83,40,43
False,8437118,Wald,3 -  6 Jahre,88,39,49
False,8437118,Wald,6 - 10 Jahre,110,55,55
False,8437118,Wald,10 - 15 Jahre,170,79,91
False,8437118,Wald,15 - 18 Jahre,125,61,64
False,8437118,Wald,18 - 20 Jahre,109,45,64
False,8437118,Wald,20 - 25 Jahre,152,56,96
False,8437118,Wald,25 - 30 Jahre,168,70,98
False,8437118,Wald,30 - 35 Jahre,179,69,110
False,8437118,Wald,35 - 40 Jahre,286,106,180
False,8437118,Wald,40 - 45 Jahre,229,116,113
False,8437118,Wald,45 - 50 Jahre,228,120,108
False,8437118,Wald,50 - 55 Jahre,178,89,89
False,8437118,Wald,55 - 60 Jahre,122,62,60
False,8437118,Wald,60 - 65 Jahre,85,53,32
False,8437118,Wald,65 - 75 Jahre,292,127,165
False,8437118,Wald,75 und mehr Jahre,174,48,126
False,8437118,Wald,Insgesamt,2778,1235,1543
False,8437123,Sauldorf,unter 3 Jahre,70,44,26
False,8437123,Sauldorf,3 -  6 Jahre,81,33,48
False,8437123,Sauldorf,6 - 10 Jahre,148,79,69
False,8437123,Sauldorf,10 - 15 Jahre,179,92,87
False,8437123,Sauldorf,15 - 18 Jahre,113,58,55
False,8437123,Sauldorf,18 - 20 Jahre,61,36,25
False,8437123,Sauldorf,20 - 25 Jahre,131,62,69
False,8437123,Sauldorf,25 - 30 Jahre,108,52,56
False,8437123,Sauldorf,30 - 35 Jahre,139,65,74
False,8437123,Sauldorf,35 - 40 Jahre,230,120,110
False,8437123,Sauldorf,40 - 45 Jahre,250,118,132
False,8437123,Sauldorf,45 - 50 Jahre,219,123,96
False,8437123,Sauldorf,50 - 55 Jahre,125,63,62
False,8437123,Sauldorf,55 - 60 Jahre,108,59,49
False,8437123,Sauldorf,60 - 65 Jahre,87,37,50
False,8437123,Sauldorf,65 - 75 Jahre,271,133,138
False,8437123,Sauldorf,75 und mehr Jahre,169,70,99
False,8437123,Sauldorf,Insgesamt,2489,1244,1245
False,8437124,Herdwangen-Schönach,unter 3 Jahre,72,37,35
False,8437124,Herdwangen-Schönach,3 -  6 Jahre,90,41,49
False,8437124,Herdwangen-Schönach,6 - 10 Jahre,164,85,79
False,8437124,Herdwangen-Schönach,10 - 15 Jahre,219,105,114
False,8437124,Herdwangen-Schönach,15 - 18 Jahre,137,70,67
False,8437124,Herdwangen-Schönach,18 - 20 Jahre,87,37,50
False,8437124,Herdwangen-Schönach,20 - 25 Jahre,199,113,86
False,8437124,Herdwangen-Schönach,25 - 30 Jahre,154,84,70
False,8437124,Herdwangen-Schönach,30 - 35 Jahre,184,93,91
False,8437124,Herdwangen-Schönach,35 - 40 Jahre,289,132,157
False,8437124,Herdwangen-Schönach,40 - 45 Jahre,370,170,200
False,8437124,Herdwangen-Schönach,45 - 50 Jahre,324,182,142
False,8437124,Herdwangen-Schönach,50 - 55 Jahre,222,106,116
False,8437124,Herdwangen-Schönach,55 - 60 Jahre,177,97,80
False,8437124,Herdwangen-Schönach,60 - 65 Jahre,152,78,74
False,8437124,Herdwangen-Schönach,65 - 75 Jahre,255,126,129
False,8437124,Herdwangen-Schönach,75 und mehr Jahre,181,76,105
False,8437124,Herdwangen-Schönach,Insgesamt,3276,1632,1644
