Anlagen,AGS,Ort,Alter von bis unter,Bevölkerung insgesamt,Bevölkerung männlich,Bevölkerung weiblich
False,8,Land Baden-Württemberg,unter 3 Jahre,327544,168313,159231
False,8,Land Baden-Württemberg,3 -  6 Jahre,345268,177335,167933
False,8,Land Baden-Württemberg,6 - 10 Jahre,474708,243971,230737
False,8,Land Baden-Württemberg,10 - 15 Jahre,611750,313503,298247
False,8,Land Baden-Württemberg,15 - 18 Jahre,339934,174287,165647
False,8,Land Baden-Württemberg,18 - 20 Jahre,237327,120193,117134
False,8,Land Baden-Württemberg,20 - 25 Jahre,595788,299179,296609
False,8,Land Baden-Württemberg,25 - 30 Jahre,661176,334105,327071
False,8,Land Baden-Württemberg,30 - 35 Jahre,885965,454913,431052
False,8,Land Baden-Württemberg,35 - 40 Jahre,938633,485423,453210
False,8,Land Baden-Württemberg,40 - 45 Jahre,818979,420274,398705
False,8,Land Baden-Württemberg,45 - 50 Jahre,702059,352292,349767
False,8,Land Baden-Württemberg,50 - 55 Jahre,624671,314334,310337
False,8,Land Baden-Württemberg,55 - 60 Jahre,596729,299222,297507
False,8,Land Baden-Württemberg,60 - 65 Jahre,694931,342837,352094
False,8,Land Baden-Württemberg,65 - 75 Jahre,937993,432733,505260
False,8,Land Baden-Württemberg,75 und mehr Jahre,730960,224494,506466
False,8,Land Baden-Württemberg,Insgesamt,10524415,5157408,5367007
False,81,Regierungsbezirk Stuttgart,unter 3 Jahre,124044,63715,60329
False,81,Regierungsbezirk Stuttgart,3 -  6 Jahre,129826,66707,63119
False,81,Regierungsbezirk Stuttgart,6 - 10 Jahre,176711,90617,86094
False,81,Regierungsbezirk Stuttgart,10 - 15 Jahre,225346,115674,109672
False,81,Regierungsbezirk Stuttgart,15 - 18 Jahre,125312,64209,61103
False,81,Regierungsbezirk Stuttgart,18 - 20 Jahre,87365,44298,43067
False,81,Regierungsbezirk Stuttgart,20 - 25 Jahre,221723,111518,110205
False,81,Regierungsbezirk Stuttgart,25 - 30 Jahre,252945,128402,124543
False,81,Regierungsbezirk Stuttgart,30 - 35 Jahre,334836,173198,161638
False,81,Regierungsbezirk Stuttgart,35 - 40 Jahre,347050,181457,165593
False,81,Regierungsbezirk Stuttgart,40 - 45 Jahre,301878,155724,146154
False,81,Regierungsbezirk Stuttgart,45 - 50 Jahre,258474,129136,129338
False,81,Regierungsbezirk Stuttgart,50 - 55 Jahre,236484,118667,117817
False,81,Regierungsbezirk Stuttgart,55 - 60 Jahre,233985,117722,116263
False,81,Regierungsbezirk Stuttgart,60 - 65 Jahre,263585,130751,132834
False,81,Regierungsbezirk Stuttgart,65 - 75 Jahre,348796,162467,186329
False,81,Regierungsbezirk Stuttgart,75 und mehr Jahre,266992,82899,184093
False,81,Regierungsbezirk Stuttgart,Insgesamt,3935352,1937161,1998191
False,8111,Stadtkreis Stuttgart,unter 3 Jahre,15917,8223,7694
False,8111,Stadtkreis Stuttgart,3 -  6 Jahre,15443,7986,7457
False,8111,Stadtkreis Stuttgart,6 - 10 Jahre,19992,10334,9658
False,8111,Stadtkreis Stuttgart,10 - 15 Jahre,25332,12937,12395
False,8111,Stadtkreis Stuttgart,15 - 18 Jahre,14291,7258,7033
False,8111,Stadtkreis Stuttgart,18 - 20 Jahre,11050,5322,5728
False,8111,Stadtkreis Stuttgart,20 - 25 Jahre,36551,17705,18846
False,8111,Stadtkreis Stuttgart,25 - 30 Jahre,46006,23355,22651
False,8111,Stadtkreis Stuttgart,30 - 35 Jahre,56097,29902,26195
False,8111,Stadtkreis Stuttgart,35 - 40 Jahre,53575,29159,24416
False,8111,Stadtkreis Stuttgart,40 - 45 Jahre,43439,22906,20533
False,8111,Stadtkreis Stuttgart,45 - 50 Jahre,36853,18425,18428
False,8111,Stadtkreis Stuttgart,50 - 55 Jahre,36322,18272,18050
False,8111,Stadtkreis Stuttgart,55 - 60 Jahre,37242,18662,18580
False,8111,Stadtkreis Stuttgart,60 - 65 Jahre,39510,19638,19872
False,8111,Stadtkreis Stuttgart,65 - 75 Jahre,50639,22970,27669
False,8111,Stadtkreis Stuttgart,75 und mehr Jahre,45615,12971,32644
False,8111,Stadtkreis Stuttgart,Insgesamt,583874,286025,297849
False,8111000,"Stuttgart, Landeshauptstadt",unter 3 Jahre,15917,8223,7694
False,8111000,"Stuttgart, Landeshauptstadt",3 -  6 Jahre,15443,7986,7457
False,8111000,"Stuttgart, Landeshauptstadt",6 - 10 Jahre,19992,10334,9658
False,8111000,"Stuttgart, Landeshauptstadt",10 - 15 Jahre,25332,12937,12395
False,8111000,"Stuttgart, Landeshauptstadt",15 - 18 Jahre,14291,7258,7033
False,8111000,"Stuttgart, Landeshauptstadt",18 - 20 Jahre,11050,5322,5728
False,8111000,"Stuttgart, Landeshauptstadt",20 - 25 Jahre,36551,17705,18846
False,8111000,"Stuttgart, Landeshauptstadt",25 - 30 Jahre,46006,23355,22651
False,8111000,"Stuttgart, Landeshauptstadt",30 - 35 Jahre,56097,29902,26195
False,8111000,"Stuttgart, Landeshauptstadt",35 - 40 Jahre,53575,29159,24416
False,8111000,"Stuttgart, Landeshauptstadt",40 - 45 Jahre,43439,22906,20533
False,8111000,"Stuttgart, Landeshauptstadt",45 - 50 Jahre,36853,18425,18428
False,8111000,"Stuttgart, Landeshauptstadt",50 - 55 Jahre,36322,18272,18050
False,8111000,"Stuttgart, Landeshauptstadt",55 - 60 Jahre,37242,18662,18580
False,8111000,"Stuttgart, Landeshauptstadt",60 - 65 Jahre,39510,19638,19872
False,8111000,"Stuttgart, Landeshauptstadt",65 - 75 Jahre,50639,22970,27669
False,8111000,"Stuttgart, Landeshauptstadt",75 und mehr Jahre,45615,12971,32644
False,8111000,"Stuttgart, Landeshauptstadt",Insgesamt,583874,286025,297849
False,8115,Landkreis Böblingen,unter 3 Jahre,12342,6360,5982
False,8115,Landkreis Böblingen,3 -  6 Jahre,12697,6511,6186
False,8115,Landkreis Böblingen,6 - 10 Jahre,16895,8576,8319
False,8115,Landkreis Böblingen,10 - 15 Jahre,21022,10778,10244
False,8115,Landkreis Böblingen,15 - 18 Jahre,11577,5878,5699
False,8115,Landkreis Böblingen,18 - 20 Jahre,8097,4122,3975
False,8115,Landkreis Böblingen,20 - 25 Jahre,20527,10325,10202
False,8115,Landkreis Böblingen,25 - 30 Jahre,23329,11805,11524
False,8115,Landkreis Böblingen,30 - 35 Jahre,31976,16497,15479
False,8115,Landkreis Böblingen,35 - 40 Jahre,32883,17064,15819
False,8115,Landkreis Böblingen,40 - 45 Jahre,28552,14587,13965
False,8115,Landkreis Böblingen,45 - 50 Jahre,24197,12061,12136
False,8115,Landkreis Böblingen,50 - 55 Jahre,21914,10817,11097
False,8115,Landkreis Böblingen,55 - 60 Jahre,23240,11858,11382
False,8115,Landkreis Böblingen,60 - 65 Jahre,24833,12479,12354
False,8115,Landkreis Böblingen,65 - 75 Jahre,30568,14586,15982
False,8115,Landkreis Böblingen,75 und mehr Jahre,20338,6465,13873
False,8115,Landkreis Böblingen,Insgesamt,364987,180769,184218
False,8115001,Aidlingen,unter 3 Jahre,319,172,147
False,8115001,Aidlingen,3 -  6 Jahre,345,178,167
False,8115001,Aidlingen,6 - 10 Jahre,440,224,216
False,8115001,Aidlingen,10 - 15 Jahre,479,258,221
False,8115001,Aidlingen,15 - 18 Jahre,262,123,139
False,8115001,Aidlingen,18 - 20 Jahre,231,124,107
False,8115001,Aidlingen,20 - 25 Jahre,530,246,284
False,8115001,Aidlingen,25 - 30 Jahre,639,309,330
False,8115001,Aidlingen,30 - 35 Jahre,899,433,466
False,8115001,Aidlingen,35 - 40 Jahre,932,476,456
False,8115001,Aidlingen,40 - 45 Jahre,688,355,333
False,8115001,Aidlingen,45 - 50 Jahre,555,280,275
False,8115001,Aidlingen,50 - 55 Jahre,546,255,291
False,8115001,Aidlingen,55 - 60 Jahre,547,274,273
False,8115001,Aidlingen,60 - 65 Jahre,579,314,265
False,8115001,Aidlingen,65 - 75 Jahre,727,359,368
False,8115001,Aidlingen,75 und mehr Jahre,418,131,287
False,8115001,Aidlingen,Insgesamt,9136,4511,4625
False,8115002,Altdorf,unter 3 Jahre,190,92,98
False,8115002,Altdorf,3 -  6 Jahre,215,110,105
False,8115002,Altdorf,6 - 10 Jahre,256,129,127
False,8115002,Altdorf,10 - 15 Jahre,238,114,124
False,8115002,Altdorf,15 - 18 Jahre,126,62,64
False,8115002,Altdorf,18 - 20 Jahre,81,43,38
False,8115002,Altdorf,20 - 25 Jahre,189,106,83
False,8115002,Altdorf,25 - 30 Jahre,271,113,158
False,8115002,Altdorf,30 - 35 Jahre,484,241,243
False,8115002,Altdorf,35 - 40 Jahre,420,213,207
False,8115002,Altdorf,40 - 45 Jahre,330,163,167
False,8115002,Altdorf,45 - 50 Jahre,244,124,120
False,8115002,Altdorf,50 - 55 Jahre,198,95,103
False,8115002,Altdorf,55 - 60 Jahre,235,119,116
False,8115002,Altdorf,60 - 65 Jahre,244,123,121
False,8115002,Altdorf,65 - 75 Jahre,249,120,129
False,8115002,Altdorf,75 und mehr Jahre,130,43,87
False,8115002,Altdorf,Insgesamt,4100,2010,2090
False,8115003,"Böblingen, Stadt",unter 3 Jahre,1374,674,700
False,8115003,"Böblingen, Stadt",3 -  6 Jahre,1288,665,623
False,8115003,"Böblingen, Stadt",6 - 10 Jahre,1783,946,837
False,8115003,"Böblingen, Stadt",10 - 15 Jahre,2254,1143,1111
False,8115003,"Böblingen, Stadt",15 - 18 Jahre,1292,647,645
False,8115003,"Böblingen, Stadt",18 - 20 Jahre,960,489,471
False,8115003,"Böblingen, Stadt",20 - 25 Jahre,2850,1464,1386
False,8115003,"Böblingen, Stadt",25 - 30 Jahre,3166,1627,1539
False,8115003,"Böblingen, Stadt",30 - 35 Jahre,3739,2039,1700
False,8115003,"Böblingen, Stadt",35 - 40 Jahre,3683,1954,1729
False,8115003,"Böblingen, Stadt",40 - 45 Jahre,3398,1745,1653
False,8115003,"Böblingen, Stadt",45 - 50 Jahre,2958,1408,1550
False,8115003,"Böblingen, Stadt",50 - 55 Jahre,2917,1398,1519
False,8115003,"Böblingen, Stadt",55 - 60 Jahre,3150,1585,1565
False,8115003,"Böblingen, Stadt",60 - 65 Jahre,3400,1623,1777
False,8115003,"Böblingen, Stadt",65 - 75 Jahre,4483,2095,2388
False,8115003,"Böblingen, Stadt",75 und mehr Jahre,2942,954,1988
False,8115003,"Böblingen, Stadt",Insgesamt,45637,22456,23181
False,8115004,Bondorf,unter 3 Jahre,238,120,118
False,8115004,Bondorf,3 -  6 Jahre,268,141,127
False,8115004,Bondorf,6 - 10 Jahre,337,159,178
False,8115004,Bondorf,10 - 15 Jahre,344,185,159
False,8115004,Bondorf,15 - 18 Jahre,186,88,98
False,8115004,Bondorf,18 - 20 Jahre,137,70,67
False,8115004,Bondorf,20 - 25 Jahre,275,143,132
False,8115004,Bondorf,25 - 30 Jahre,356,180,176
False,8115004,Bondorf,30 - 35 Jahre,494,242,252
False,8115004,Bondorf,35 - 40 Jahre,531,255,276
False,8115004,Bondorf,40 - 45 Jahre,445,238,207
False,8115004,Bondorf,45 - 50 Jahre,362,194,168
False,8115004,Bondorf,50 - 55 Jahre,250,121,129
False,8115004,Bondorf,55 - 60 Jahre,241,128,113
False,8115004,Bondorf,60 - 65 Jahre,240,127,113
False,8115004,Bondorf,65 - 75 Jahre,345,155,190
False,8115004,Bondorf,75 und mehr Jahre,174,66,108
False,8115004,Bondorf,Insgesamt,5223,2612,2611
False,8115010,Deckenpfronn,unter 3 Jahre,109,50,59
False,8115010,Deckenpfronn,3 -  6 Jahre,135,52,83
False,8115010,Deckenpfronn,6 - 10 Jahre,165,84,81
False,8115010,Deckenpfronn,10 - 15 Jahre,175,88,87
False,8115010,Deckenpfronn,15 - 18 Jahre,85,39,46
False,8115010,Deckenpfronn,18 - 20 Jahre,54,21,33
False,8115010,Deckenpfronn,20 - 25 Jahre,159,73,86
False,8115010,Deckenpfronn,25 - 30 Jahre,188,109,79
False,8115010,Deckenpfronn,30 - 35 Jahre,267,131,136
False,8115010,Deckenpfronn,35 - 40 Jahre,323,170,153
False,8115010,Deckenpfronn,40 - 45 Jahre,207,106,101
False,8115010,Deckenpfronn,45 - 50 Jahre,169,93,76
False,8115010,Deckenpfronn,50 - 55 Jahre,160,82,78
False,8115010,Deckenpfronn,55 - 60 Jahre,133,73,60
False,8115010,Deckenpfronn,60 - 65 Jahre,147,69,78
False,8115010,Deckenpfronn,65 - 75 Jahre,189,91,98
False,8115010,Deckenpfronn,75 und mehr Jahre,113,33,80
False,8115010,Deckenpfronn,Insgesamt,2778,1364,1414
False,8115013,Ehningen,unter 3 Jahre,255,133,122
False,8115013,Ehningen,3 -  6 Jahre,289,149,140
False,8115013,Ehningen,6 - 10 Jahre,327,162,165
False,8115013,Ehningen,10 - 15 Jahre,425,236,189
False,8115013,Ehningen,15 - 18 Jahre,264,137,127
False,8115013,Ehningen,18 - 20 Jahre,176,94,82
False,8115013,Ehningen,20 - 25 Jahre,416,211,205
False,8115013,Ehningen,25 - 30 Jahre,484,251,233
False,8115013,Ehningen,30 - 35 Jahre,713,353,360
False,8115013,Ehningen,35 - 40 Jahre,726,375,351
False,8115013,Ehningen,40 - 45 Jahre,561,286,275
False,8115013,Ehningen,45 - 50 Jahre,485,239,246
False,8115013,Ehningen,50 - 55 Jahre,439,217,222
False,8115013,Ehningen,55 - 60 Jahre,494,237,257
False,8115013,Ehningen,60 - 65 Jahre,511,255,256
False,8115013,Ehningen,65 - 75 Jahre,619,296,323
False,8115013,Ehningen,75 und mehr Jahre,346,113,233
False,8115013,Ehningen,Insgesamt,7530,3744,3786
False,8115015,Gärtringen,unter 3 Jahre,382,202,180
False,8115015,Gärtringen,3 -  6 Jahre,384,197,187
False,8115015,Gärtringen,6 - 10 Jahre,503,229,274
False,8115015,Gärtringen,10 - 15 Jahre,689,343,346
False,8115015,Gärtringen,15 - 18 Jahre,363,201,162
False,8115015,Gärtringen,18 - 20 Jahre,283,132,151
False,8115015,Gärtringen,20 - 25 Jahre,638,322,316
False,8115015,Gärtringen,25 - 30 Jahre,744,346,398
False,8115015,Gärtringen,30 - 35 Jahre,1064,555,509
False,8115015,Gärtringen,35 - 40 Jahre,1047,533,514
False,8115015,Gärtringen,40 - 45 Jahre,888,452,436
False,8115015,Gärtringen,45 - 50 Jahre,808,413,395
False,8115015,Gärtringen,50 - 55 Jahre,648,316,332
False,8115015,Gärtringen,55 - 60 Jahre,773,394,379
False,8115015,Gärtringen,60 - 65 Jahre,698,359,339
False,8115015,Gärtringen,65 - 75 Jahre,856,416,440
False,8115015,Gärtringen,75 und mehr Jahre,573,174,399
False,8115015,Gärtringen,Insgesamt,11341,5584,5757
False,8115016,Gäufelden,unter 3 Jahre,386,191,195
False,8115016,Gäufelden,3 -  6 Jahre,382,187,195
False,8115016,Gäufelden,6 - 10 Jahre,555,271,284
False,8115016,Gäufelden,10 - 15 Jahre,658,342,316
False,8115016,Gäufelden,15 - 18 Jahre,367,181,186
False,8115016,Gäufelden,18 - 20 Jahre,219,103,116
False,8115016,Gäufelden,20 - 25 Jahre,507,238,269
False,8115016,Gäufelden,25 - 30 Jahre,618,323,295
False,8115016,Gäufelden,30 - 35 Jahre,835,443,392
False,8115016,Gäufelden,35 - 40 Jahre,914,475,439
False,8115016,Gäufelden,40 - 45 Jahre,800,412,388
False,8115016,Gäufelden,45 - 50 Jahre,599,303,296
False,8115016,Gäufelden,50 - 55 Jahre,490,247,243
False,8115016,Gäufelden,55 - 60 Jahre,468,248,220
False,8115016,Gäufelden,60 - 65 Jahre,436,225,211
False,8115016,Gäufelden,65 - 75 Jahre,568,266,302
False,8115016,Gäufelden,75 und mehr Jahre,295,101,194
False,8115016,Gäufelden,Insgesamt,9097,4556,4541
False,8115021,"Herrenberg, Stadt",unter 3 Jahre,1012,535,477
False,8115021,"Herrenberg, Stadt",3 -  6 Jahre,1072,560,512
False,8115021,"Herrenberg, Stadt",6 - 10 Jahre,1451,742,709
False,8115021,"Herrenberg, Stadt",10 - 15 Jahre,1770,918,852
False,8115021,"Herrenberg, Stadt",15 - 18 Jahre,1054,552,502
False,8115021,"Herrenberg, Stadt",18 - 20 Jahre,706,345,361
False,8115021,"Herrenberg, Stadt",20 - 25 Jahre,1760,874,886
False,8115021,"Herrenberg, Stadt",25 - 30 Jahre,2051,1045,1006
False,8115021,"Herrenberg, Stadt",30 - 35 Jahre,2585,1355,1230
False,8115021,"Herrenberg, Stadt",35 - 40 Jahre,2655,1377,1278
False,8115021,"Herrenberg, Stadt",40 - 45 Jahre,2375,1184,1191
False,8115021,"Herrenberg, Stadt",45 - 50 Jahre,2016,1042,974
False,8115021,"Herrenberg, Stadt",50 - 55 Jahre,1689,830,859
False,8115021,"Herrenberg, Stadt",55 - 60 Jahre,1816,916,900
False,8115021,"Herrenberg, Stadt",60 - 65 Jahre,2098,1040,1058
False,8115021,"Herrenberg, Stadt",65 - 75 Jahre,2533,1191,1342
False,8115021,"Herrenberg, Stadt",75 und mehr Jahre,1734,528,1206
False,8115021,"Herrenberg, Stadt",Insgesamt,30377,15034,15343
False,8115022,Hildrizhausen,unter 3 Jahre,148,87,61
False,8115022,Hildrizhausen,3 -  6 Jahre,124,66,58
False,8115022,Hildrizhausen,6 - 10 Jahre,181,102,79
False,8115022,Hildrizhausen,10 - 15 Jahre,210,113,97
False,8115022,Hildrizhausen,15 - 18 Jahre,103,71,32
False,8115022,Hildrizhausen,18 - 20 Jahre,76,39,37
False,8115022,Hildrizhausen,20 - 25 Jahre,184,83,101
False,8115022,Hildrizhausen,25 - 30 Jahre,224,115,109
False,8115022,Hildrizhausen,30 - 35 Jahre,337,180,157
False,8115022,Hildrizhausen,35 - 40 Jahre,363,180,183
False,8115022,Hildrizhausen,40 - 45 Jahre,292,158,134
False,8115022,Hildrizhausen,45 - 50 Jahre,225,116,109
False,8115022,Hildrizhausen,50 - 55 Jahre,203,99,104
False,8115022,Hildrizhausen,55 - 60 Jahre,216,117,99
False,8115022,Hildrizhausen,60 - 65 Jahre,206,106,100
False,8115022,Hildrizhausen,65 - 75 Jahre,228,119,109
False,8115022,Hildrizhausen,75 und mehr Jahre,137,43,94
False,8115022,Hildrizhausen,Insgesamt,3457,1794,1663
False,8115024,"Holzgerlingen, Stadt",unter 3 Jahre,402,185,217
False,8115024,"Holzgerlingen, Stadt",3 -  6 Jahre,415,214,201
False,8115024,"Holzgerlingen, Stadt",6 - 10 Jahre,536,303,233
False,8115024,"Holzgerlingen, Stadt",10 - 15 Jahre,726,367,359
False,8115024,"Holzgerlingen, Stadt",15 - 18 Jahre,382,188,194
False,8115024,"Holzgerlingen, Stadt",18 - 20 Jahre,256,127,129
False,8115024,"Holzgerlingen, Stadt",20 - 25 Jahre,578,295,283
False,8115024,"Holzgerlingen, Stadt",25 - 30 Jahre,767,389,378
False,8115024,"Holzgerlingen, Stadt",30 - 35 Jahre,1037,524,513
False,8115024,"Holzgerlingen, Stadt",35 - 40 Jahre,1141,567,574
False,8115024,"Holzgerlingen, Stadt",40 - 45 Jahre,923,491,432
False,8115024,"Holzgerlingen, Stadt",45 - 50 Jahre,712,357,355
False,8115024,"Holzgerlingen, Stadt",50 - 55 Jahre,653,310,343
False,8115024,"Holzgerlingen, Stadt",55 - 60 Jahre,700,354,346
False,8115024,"Holzgerlingen, Stadt",60 - 65 Jahre,755,392,363
False,8115024,"Holzgerlingen, Stadt",65 - 75 Jahre,888,430,458
False,8115024,"Holzgerlingen, Stadt",75 und mehr Jahre,595,211,384
False,8115024,"Holzgerlingen, Stadt",Insgesamt,11466,5704,5762
False,8115028,"Leonberg, Stadt",unter 3 Jahre,1382,721,661
False,8115028,"Leonberg, Stadt",3 -  6 Jahre,1400,699,701
False,8115028,"Leonberg, Stadt",6 - 10 Jahre,1824,900,924
False,8115028,"Leonberg, Stadt",10 - 15 Jahre,2214,1154,1060
False,8115028,"Leonberg, Stadt",15 - 18 Jahre,1257,641,616
False,8115028,"Leonberg, Stadt",18 - 20 Jahre,881,454,427
False,8115028,"Leonberg, Stadt",20 - 25 Jahre,2400,1164,1236
False,8115028,"Leonberg, Stadt",25 - 30 Jahre,2682,1380,1302
False,8115028,"Leonberg, Stadt",30 - 35 Jahre,3829,1957,1872
False,8115028,"Leonberg, Stadt",35 - 40 Jahre,3797,2005,1792
False,8115028,"Leonberg, Stadt",40 - 45 Jahre,3351,1672,1679
False,8115028,"Leonberg, Stadt",45 - 50 Jahre,2981,1465,1516
False,8115028,"Leonberg, Stadt",50 - 55 Jahre,2892,1415,1477
False,8115028,"Leonberg, Stadt",55 - 60 Jahre,3181,1553,1628
False,8115028,"Leonberg, Stadt",60 - 65 Jahre,3204,1598,1606
False,8115028,"Leonberg, Stadt",65 - 75 Jahre,3903,1834,2069
False,8115028,"Leonberg, Stadt",75 und mehr Jahre,3176,993,2183
False,8115028,"Leonberg, Stadt",Insgesamt,44354,21605,22749
False,8115029,Magstadt,unter 3 Jahre,304,161,143
False,8115029,Magstadt,3 -  6 Jahre,300,147,153
False,8115029,Magstadt,6 - 10 Jahre,397,194,203
False,8115029,Magstadt,10 - 15 Jahre,514,264,250
False,8115029,Magstadt,15 - 18 Jahre,313,157,156
False,8115029,Magstadt,18 - 20 Jahre,194,85,109
False,8115029,Magstadt,20 - 25 Jahre,571,300,271
False,8115029,Magstadt,25 - 30 Jahre,631,332,299
False,8115029,Magstadt,30 - 35 Jahre,824,439,385
False,8115029,Magstadt,35 - 40 Jahre,826,439,387
False,8115029,Magstadt,40 - 45 Jahre,661,339,322
False,8115029,Magstadt,45 - 50 Jahre,597,292,305
False,8115029,Magstadt,50 - 55 Jahre,544,285,259
False,8115029,Magstadt,55 - 60 Jahre,580,304,276
False,8115029,Magstadt,60 - 65 Jahre,564,283,281
False,8115029,Magstadt,65 - 75 Jahre,698,321,377
False,8115029,Magstadt,75 und mehr Jahre,471,165,306
False,8115029,Magstadt,Insgesamt,8989,4507,4482
False,8115034,Mötzingen,unter 3 Jahre,143,62,81
False,8115034,Mötzingen,3 -  6 Jahre,155,76,79
False,8115034,Mötzingen,6 - 10 Jahre,213,116,97
False,8115034,Mötzingen,10 - 15 Jahre,267,126,141
False,8115034,Mötzingen,15 - 18 Jahre,140,75,65
False,8115034,Mötzingen,18 - 20 Jahre,103,55,48
False,8115034,Mötzingen,20 - 25 Jahre,179,106,73
False,8115034,Mötzingen,25 - 30 Jahre,183,83,100
False,8115034,Mötzingen,30 - 35 Jahre,307,145,162
False,8115034,Mötzingen,35 - 40 Jahre,350,172,178
False,8115034,Mötzingen,40 - 45 Jahre,305,157,148
False,8115034,Mötzingen,45 - 50 Jahre,234,126,108
False,8115034,Mötzingen,50 - 55 Jahre,189,90,99
False,8115034,Mötzingen,55 - 60 Jahre,156,86,70
False,8115034,Mötzingen,60 - 65 Jahre,204,104,100
False,8115034,Mötzingen,65 - 75 Jahre,240,112,128
False,8115034,Mötzingen,75 und mehr Jahre,134,48,86
False,8115034,Mötzingen,Insgesamt,3502,1739,1763
False,8115037,Nufringen,unter 3 Jahre,192,107,85
False,8115037,Nufringen,3 -  6 Jahre,171,87,84
False,8115037,Nufringen,6 - 10 Jahre,217,100,117
False,8115037,Nufringen,10 - 15 Jahre,278,166,112
False,8115037,Nufringen,15 - 18 Jahre,158,87,71
False,8115037,Nufringen,18 - 20 Jahre,109,64,45
False,8115037,Nufringen,20 - 25 Jahre,264,124,140
False,8115037,Nufringen,25 - 30 Jahre,321,163,158
False,8115037,Nufringen,30 - 35 Jahre,424,211,213
False,8115037,Nufringen,35 - 40 Jahre,488,246,242
False,8115037,Nufringen,40 - 45 Jahre,378,187,191
False,8115037,Nufringen,45 - 50 Jahre,315,160,155
False,8115037,Nufringen,50 - 55 Jahre,272,142,130
False,8115037,Nufringen,55 - 60 Jahre,274,144,130
False,8115037,Nufringen,60 - 65 Jahre,322,173,149
False,8115037,Nufringen,65 - 75 Jahre,403,190,213
False,8115037,Nufringen,75 und mehr Jahre,219,70,149
False,8115037,Nufringen,Insgesamt,4805,2421,2384
False,8115041,"Renningen, Stadt",unter 3 Jahre,604,319,285
False,8115041,"Renningen, Stadt",3 -  6 Jahre,609,326,283
False,8115041,"Renningen, Stadt",6 - 10 Jahre,835,417,418
False,8115041,"Renningen, Stadt",10 - 15 Jahre,1062,529,533
False,8115041,"Renningen, Stadt",15 - 18 Jahre,604,286,318
False,8115041,"Renningen, Stadt",18 - 20 Jahre,399,216,183
False,8115041,"Renningen, Stadt",20 - 25 Jahre,934,451,483
False,8115041,"Renningen, Stadt",25 - 30 Jahre,1028,527,501
False,8115041,"Renningen, Stadt",30 - 35 Jahre,1565,798,767
False,8115041,"Renningen, Stadt",35 - 40 Jahre,1629,821,808
False,8115041,"Renningen, Stadt",40 - 45 Jahre,1471,699,772
False,8115041,"Renningen, Stadt",45 - 50 Jahre,1156,573,583
False,8115041,"Renningen, Stadt",50 - 55 Jahre,973,491,482
False,8115041,"Renningen, Stadt",55 - 60 Jahre,991,503,488
False,8115041,"Renningen, Stadt",60 - 65 Jahre,1078,538,540
False,8115041,"Renningen, Stadt",65 - 75 Jahre,1350,661,689
False,8115041,"Renningen, Stadt",75 und mehr Jahre,854,271,583
False,8115041,"Renningen, Stadt",Insgesamt,17142,8426,8716
False,8115042,"Rutesheim, Stadt",unter 3 Jahre,344,192,152
False,8115042,"Rutesheim, Stadt",3 -  6 Jahre,372,176,196
False,8115042,"Rutesheim, Stadt",6 - 10 Jahre,462,230,232
False,8115042,"Rutesheim, Stadt",10 - 15 Jahre,635,308,327
False,8115042,"Rutesheim, Stadt",15 - 18 Jahre,306,151,155
False,8115042,"Rutesheim, Stadt",18 - 20 Jahre,239,131,108
False,8115042,"Rutesheim, Stadt",20 - 25 Jahre,540,282,258
False,8115042,"Rutesheim, Stadt",25 - 30 Jahre,586,298,288
False,8115042,"Rutesheim, Stadt",30 - 35 Jahre,899,446,453
False,8115042,"Rutesheim, Stadt",35 - 40 Jahre,943,472,471
False,8115042,"Rutesheim, Stadt",40 - 45 Jahre,821,426,395
False,8115042,"Rutesheim, Stadt",45 - 50 Jahre,632,315,317
False,8115042,"Rutesheim, Stadt",50 - 55 Jahre,614,310,304
False,8115042,"Rutesheim, Stadt",55 - 60 Jahre,587,303,284
False,8115042,"Rutesheim, Stadt",60 - 65 Jahre,668,335,333
False,8115042,"Rutesheim, Stadt",65 - 75 Jahre,817,383,434
False,8115042,"Rutesheim, Stadt",75 und mehr Jahre,505,182,323
False,8115042,"Rutesheim, Stadt",Insgesamt,9970,4940,5030
False,8115044,Schönaich,unter 3 Jahre,347,173,174
False,8115044,Schönaich,3 -  6 Jahre,338,187,151
False,8115044,Schönaich,6 - 10 Jahre,436,212,224
False,8115044,Schönaich,10 - 15 Jahre,571,306,265
False,8115044,Schönaich,15 - 18 Jahre,321,158,163
False,8115044,Schönaich,18 - 20 Jahre,213,100,113
False,8115044,Schönaich,20 - 25 Jahre,552,249,303
False,8115044,Schönaich,25 - 30 Jahre,607,323,284
False,8115044,Schönaich,30 - 35 Jahre,892,433,459
False,8115044,Schönaich,35 - 40 Jahre,909,485,424
False,8115044,Schönaich,40 - 45 Jahre,742,405,337
False,8115044,Schönaich,45 - 50 Jahre,693,342,351
False,8115044,Schönaich,50 - 55 Jahre,606,301,305
False,8115044,Schönaich,55 - 60 Jahre,683,337,346
False,8115044,Schönaich,60 - 65 Jahre,728,381,347
False,8115044,Schönaich,65 - 75 Jahre,887,445,442
False,8115044,Schönaich,75 und mehr Jahre,536,162,374
False,8115044,Schönaich,Insgesamt,10061,4999,5062
False,8115045,"Sindelfingen, Stadt",unter 3 Jahre,1868,974,894
False,8115045,"Sindelfingen, Stadt",3 -  6 Jahre,1904,1003,901
False,8115045,"Sindelfingen, Stadt",6 - 10 Jahre,2580,1285,1295
False,8115045,"Sindelfingen, Stadt",10 - 15 Jahre,3387,1687,1700
False,8115045,"Sindelfingen, Stadt",15 - 18 Jahre,1867,964,903
False,8115045,"Sindelfingen, Stadt",18 - 20 Jahre,1431,761,670
False,8115045,"Sindelfingen, Stadt",20 - 25 Jahre,3452,1830,1622
False,8115045,"Sindelfingen, Stadt",25 - 30 Jahre,3991,2036,1955
False,8115045,"Sindelfingen, Stadt",30 - 35 Jahre,5016,2623,2393
False,8115045,"Sindelfingen, Stadt",35 - 40 Jahre,5049,2704,2345
False,8115045,"Sindelfingen, Stadt",40 - 45 Jahre,4574,2304,2270
False,8115045,"Sindelfingen, Stadt",45 - 50 Jahre,3930,1994,1936
False,8115045,"Sindelfingen, Stadt",50 - 55 Jahre,3806,1894,1912
False,8115045,"Sindelfingen, Stadt",55 - 60 Jahre,4065,2099,1966
False,8115045,"Sindelfingen, Stadt",60 - 65 Jahre,4608,2364,2244
False,8115045,"Sindelfingen, Stadt",65 - 75 Jahre,5519,2718,2801
False,8115045,"Sindelfingen, Stadt",75 und mehr Jahre,3796,1125,2671
False,8115045,"Sindelfingen, Stadt",Insgesamt,60843,30365,30478
False,8115046,Steinenbronn,unter 3 Jahre,214,107,107
False,8115046,Steinenbronn,3 -  6 Jahre,226,113,113
False,8115046,Steinenbronn,6 - 10 Jahre,344,181,163
False,8115046,Steinenbronn,10 - 15 Jahre,382,206,176
False,8115046,Steinenbronn,15 - 18 Jahre,224,110,114
False,8115046,Steinenbronn,18 - 20 Jahre,126,68,58
False,8115046,Steinenbronn,20 - 25 Jahre,332,154,178
False,8115046,Steinenbronn,25 - 30 Jahre,345,161,184
False,8115046,Steinenbronn,30 - 35 Jahre,483,246,237
False,8115046,Steinenbronn,35 - 40 Jahre,603,304,299
False,8115046,Steinenbronn,40 - 45 Jahre,527,283,244
False,8115046,Steinenbronn,45 - 50 Jahre,430,233,197
False,8115046,Steinenbronn,50 - 55 Jahre,320,145,175
False,8115046,Steinenbronn,55 - 60 Jahre,340,177,163
False,8115046,Steinenbronn,60 - 65 Jahre,369,169,200
False,8115046,Steinenbronn,65 - 75 Jahre,461,223,238
False,8115046,Steinenbronn,75 und mehr Jahre,292,94,198
False,8115046,Steinenbronn,Insgesamt,6018,2974,3044
False,8115048,"Waldenbuch, Stadt",unter 3 Jahre,296,159,137
False,8115048,"Waldenbuch, Stadt",3 -  6 Jahre,341,190,151
False,8115048,"Waldenbuch, Stadt",6 - 10 Jahre,407,212,195
False,8115048,"Waldenbuch, Stadt",10 - 15 Jahre,486,260,226
False,8115048,"Waldenbuch, Stadt",15 - 18 Jahre,281,130,151
False,8115048,"Waldenbuch, Stadt",18 - 20 Jahre,167,72,95
False,8115048,"Waldenbuch, Stadt",20 - 25 Jahre,518,249,269
False,8115048,"Waldenbuch, Stadt",25 - 30 Jahre,485,251,234
False,8115048,"Waldenbuch, Stadt",30 - 35 Jahre,751,388,363
False,8115048,"Waldenbuch, Stadt",35 - 40 Jahre,814,399,415
False,8115048,"Waldenbuch, Stadt",40 - 45 Jahre,728,385,343
False,8115048,"Waldenbuch, Stadt",45 - 50 Jahre,676,310,366
False,8115048,"Waldenbuch, Stadt",50 - 55 Jahre,578,306,272
False,8115048,"Waldenbuch, Stadt",55 - 60 Jahre,548,286,262
False,8115048,"Waldenbuch, Stadt",60 - 65 Jahre,538,259,279
False,8115048,"Waldenbuch, Stadt",65 - 75 Jahre,660,307,353
False,8115048,"Waldenbuch, Stadt",75 und mehr Jahre,453,154,299
False,8115048,"Waldenbuch, Stadt",Insgesamt,8727,4317,4410
False,8115050,"Weil der Stadt, Stadt",unter 3 Jahre,643,338,305
False,8115050,"Weil der Stadt, Stadt",3 -  6 Jahre,655,333,322
False,8115050,"Weil der Stadt, Stadt",6 - 10 Jahre,986,511,475
False,8115050,"Weil der Stadt, Stadt",10 - 15 Jahre,1275,647,628
False,8115050,"Weil der Stadt, Stadt",15 - 18 Jahre,648,318,330
False,8115050,"Weil der Stadt, Stadt",18 - 20 Jahre,393,205,188
False,8115050,"Weil der Stadt, Stadt",20 - 25 Jahre,1046,536,510
False,8115050,"Weil der Stadt, Stadt",25 - 30 Jahre,1074,538,536
False,8115050,"Weil der Stadt, Stadt",30 - 35 Jahre,1657,876,781
False,8115050,"Weil der Stadt, Stadt",35 - 40 Jahre,1665,879,786
False,8115050,"Weil der Stadt, Stadt",40 - 45 Jahre,1536,779,757
False,8115050,"Weil der Stadt, Stadt",45 - 50 Jahre,1330,658,672
False,8115050,"Weil der Stadt, Stadt",50 - 55 Jahre,1135,566,569
False,8115050,"Weil der Stadt, Stadt",55 - 60 Jahre,1141,619,522
False,8115050,"Weil der Stadt, Stadt",60 - 65 Jahre,1244,612,632
False,8115050,"Weil der Stadt, Stadt",65 - 75 Jahre,1646,774,872
False,8115050,"Weil der Stadt, Stadt",75 und mehr Jahre,1011,315,696
False,8115050,"Weil der Stadt, Stadt",Insgesamt,19085,9504,9581
False,8115051,Weil im Schönbuch,unter 3 Jahre,398,196,202
False,8115051,Weil im Schönbuch,3 -  6 Jahre,426,215,211
False,8115051,Weil im Schönbuch,6 - 10 Jahre,477,245,232
False,8115051,Weil im Schönbuch,10 - 15 Jahre,556,311,245
False,8115051,Weil im Schönbuch,15 - 18 Jahre,291,156,135
False,8115051,Weil im Schönbuch,18 - 20 Jahre,191,96,95
False,8115051,Weil im Schönbuch,20 - 25 Jahre,511,242,269
False,8115051,Weil im Schönbuch,25 - 30 Jahre,563,257,306
False,8115051,Weil im Schönbuch,30 - 35 Jahre,940,506,434
False,8115051,Weil im Schönbuch,35 - 40 Jahre,969,490,479
False,8115051,Weil im Schönbuch,40 - 45 Jahre,796,436,360
False,8115051,Weil im Schönbuch,45 - 50 Jahre,600,281,319
False,8115051,Weil im Schönbuch,50 - 55 Jahre,556,279,277
False,8115051,Weil im Schönbuch,55 - 60 Jahre,633,337,296
False,8115051,Weil im Schönbuch,60 - 65 Jahre,645,332,313
False,8115051,Weil im Schönbuch,65 - 75 Jahre,752,352,400
False,8115051,Weil im Schönbuch,75 und mehr Jahre,430,144,286
False,8115051,Weil im Schönbuch,Insgesamt,9734,4875,4859
False,8115052,Weissach,unter 3 Jahre,262,137,125
False,8115052,Weissach,3 -  6 Jahre,276,150,126
False,8115052,Weissach,6 - 10 Jahre,457,244,213
False,8115052,Weissach,10 - 15 Jahre,482,248,234
False,8115052,Weissach,15 - 18 Jahre,256,134,122
False,8115052,Weissach,18 - 20 Jahre,159,76,83
False,8115052,Weissach,20 - 25 Jahre,381,198,183
False,8115052,Weissach,25 - 30 Jahre,446,222,224
False,8115052,Weissach,30 - 35 Jahre,639,314,325
False,8115052,Weissach,35 - 40 Jahre,719,360,359
False,8115052,Weissach,40 - 45 Jahre,641,333,308
False,8115052,Weissach,45 - 50 Jahre,556,279,277
False,8115052,Weissach,50 - 55 Jahre,434,212,222
False,8115052,Weissach,55 - 60 Jahre,472,249,223
False,8115052,Weissach,60 - 65 Jahre,497,258,239
False,8115052,Weissach,65 - 75 Jahre,534,249,285
False,8115052,Weissach,75 und mehr Jahre,333,118,215
False,8115052,Weissach,Insgesamt,7544,3781,3763
False,8115053,Jettingen,unter 3 Jahre,288,145,143
False,8115053,Jettingen,3 -  6 Jahre,334,155,179
False,8115053,Jettingen,6 - 10 Jahre,417,208,209
False,8115053,Jettingen,10 - 15 Jahre,587,288,299
False,8115053,Jettingen,15 - 18 Jahre,268,133,135
False,8115053,Jettingen,18 - 20 Jahre,193,101,92
False,8115053,Jettingen,20 - 25 Jahre,428,205,223
False,8115053,Jettingen,25 - 30 Jahre,451,213,238
False,8115053,Jettingen,30 - 35 Jahre,617,286,331
False,8115053,Jettingen,35 - 40 Jahre,739,361,378
False,8115053,Jettingen,40 - 45 Jahre,630,326,304
False,8115053,Jettingen,45 - 50 Jahre,492,246,246
False,8115053,Jettingen,50 - 55 Jahre,410,221,189
False,8115053,Jettingen,55 - 60 Jahre,388,197,191
False,8115053,Jettingen,60 - 65 Jahre,431,219,212
False,8115053,Jettingen,65 - 75 Jahre,503,235,268
False,8115053,Jettingen,75 und mehr Jahre,330,104,226
False,8115053,Jettingen,Insgesamt,7506,3643,3863
False,8115054,Grafenau,unter 3 Jahre,242,128,114
False,8115054,Grafenau,3 -  6 Jahre,273,135,138
False,8115054,Grafenau,6 - 10 Jahre,309,170,139
False,8115054,Grafenau,10 - 15 Jahre,358,171,187
False,8115054,Grafenau,15 - 18 Jahre,159,89,70
False,8115054,Grafenau,18 - 20 Jahre,120,51,69
False,8115054,Grafenau,20 - 25 Jahre,333,180,153
False,8115054,Grafenau,25 - 30 Jahre,428,214,214
False,8115054,Grafenau,30 - 35 Jahre,679,333,346
False,8115054,Grafenau,35 - 40 Jahre,648,352,296
False,8115054,Grafenau,40 - 45 Jahre,484,266,218
False,8115054,Grafenau,45 - 50 Jahre,442,218,224
False,8115054,Grafenau,50 - 55 Jahre,392,190,202
False,8115054,Grafenau,55 - 60 Jahre,428,219,209
False,8115054,Grafenau,60 - 65 Jahre,419,221,198
False,8115054,Grafenau,65 - 75 Jahre,510,244,266
False,8115054,Grafenau,75 und mehr Jahre,341,123,218
False,8115054,Grafenau,Insgesamt,6565,3304,3261
False,8116,Landkreis Esslingen,unter 3 Jahre,15810,8072,7738
False,8116,Landkreis Esslingen,3 -  6 Jahre,16597,8553,8044
False,8116,Landkreis Esslingen,6 - 10 Jahre,22031,11275,10756
False,8116,Landkreis Esslingen,10 - 15 Jahre,27739,14358,13381
False,8116,Landkreis Esslingen,15 - 18 Jahre,15067,7754,7313
False,8116,Landkreis Esslingen,18 - 20 Jahre,10653,5379,5274
False,8116,Landkreis Esslingen,20 - 25 Jahre,27281,13619,13662
False,8116,Landkreis Esslingen,25 - 30 Jahre,31586,15963,15623
False,8116,Landkreis Esslingen,30 - 35 Jahre,42548,21607,20941
False,8116,Landkreis Esslingen,35 - 40 Jahre,44631,23115,21516
False,8116,Landkreis Esslingen,40 - 45 Jahre,38664,19853,18811
False,8116,Landkreis Esslingen,45 - 50 Jahre,32639,16095,16544
False,8116,Landkreis Esslingen,50 - 55 Jahre,31219,15433,15786
False,8116,Landkreis Esslingen,55 - 60 Jahre,31932,16131,15801
False,8116,Landkreis Esslingen,60 - 65 Jahre,35041,17329,17712
False,8116,Landkreis Esslingen,65 - 75 Jahre,44899,21305,23594
False,8116,Landkreis Esslingen,75 und mehr Jahre,32329,10315,22014
False,8116,Landkreis Esslingen,Insgesamt,500666,246156,254510
False,8116004,Altbach,unter 3 Jahre,162,94,68
False,8116004,Altbach,3 -  6 Jahre,157,76,81
False,8116004,Altbach,6 - 10 Jahre,192,100,92
False,8116004,Altbach,10 - 15 Jahre,251,130,121
False,8116004,Altbach,15 - 18 Jahre,128,64,64
False,8116004,Altbach,18 - 20 Jahre,112,68,44
False,8116004,Altbach,20 - 25 Jahre,283,137,146
False,8116004,Altbach,25 - 30 Jahre,381,187,194
False,8116004,Altbach,30 - 35 Jahre,518,262,256
False,8116004,Altbach,35 - 40 Jahre,475,241,234
False,8116004,Altbach,40 - 45 Jahre,390,213,177
False,8116004,Altbach,45 - 50 Jahre,320,151,169
False,8116004,Altbach,50 - 55 Jahre,375,184,191
False,8116004,Altbach,55 - 60 Jahre,407,208,199
False,8116004,Altbach,60 - 65 Jahre,460,231,229
False,8116004,Altbach,65 - 75 Jahre,550,254,296
False,8116004,Altbach,75 und mehr Jahre,390,130,260
False,8116004,Altbach,Insgesamt,5551,2730,2821
False,8116005,Altdorf,unter 3 Jahre,67,29,38
False,8116005,Altdorf,3 -  6 Jahre,60,40,20
False,8116005,Altdorf,6 - 10 Jahre,76,38,38
False,8116005,Altdorf,10 - 15 Jahre,83,40,43
False,8116005,Altdorf,15 - 18 Jahre,45,20,25
False,8116005,Altdorf,18 - 20 Jahre,37,20,17
False,8116005,Altdorf,20 - 25 Jahre,70,32,38
False,8116005,Altdorf,25 - 30 Jahre,98,39,59
False,8116005,Altdorf,30 - 35 Jahre,136,71,65
False,8116005,Altdorf,35 - 40 Jahre,147,86,61
False,8116005,Altdorf,40 - 45 Jahre,107,58,49
False,8116005,Altdorf,45 - 50 Jahre,83,49,34
False,8116005,Altdorf,50 - 55 Jahre,78,43,35
False,8116005,Altdorf,55 - 60 Jahre,58,36,22
False,8116005,Altdorf,60 - 65 Jahre,67,33,34
False,8116005,Altdorf,65 - 75 Jahre,68,29,39
False,8116005,Altdorf,75 und mehr Jahre,41,15,26
False,8116005,Altdorf,Insgesamt,1321,678,643
False,8116006,Altenriet,unter 3 Jahre,63,36,27
False,8116006,Altenriet,3 -  6 Jahre,86,41,45
False,8116006,Altenriet,6 - 10 Jahre,88,53,35
False,8116006,Altenriet,10 - 15 Jahre,129,59,70
False,8116006,Altenriet,15 - 18 Jahre,55,25,30
False,8116006,Altenriet,18 - 20 Jahre,34,20,14
False,8116006,Altenriet,20 - 25 Jahre,92,45,47
False,8116006,Altenriet,25 - 30 Jahre,86,31,55
False,8116006,Altenriet,30 - 35 Jahre,153,65,88
False,8116006,Altenriet,35 - 40 Jahre,183,104,79
False,8116006,Altenriet,40 - 45 Jahre,149,71,78
False,8116006,Altenriet,45 - 50 Jahre,110,55,55
False,8116006,Altenriet,50 - 55 Jahre,115,58,57
False,8116006,Altenriet,55 - 60 Jahre,99,55,44
False,8116006,Altenriet,60 - 65 Jahre,114,60,54
False,8116006,Altenriet,65 - 75 Jahre,124,52,72
False,8116006,Altenriet,75 und mehr Jahre,71,30,41
False,8116006,Altenriet,Insgesamt,1751,860,891
False,8116007,Baltmannsweiler,unter 3 Jahre,217,117,100
False,8116007,Baltmannsweiler,3 -  6 Jahre,229,124,105
False,8116007,Baltmannsweiler,6 - 10 Jahre,278,140,138
False,8116007,Baltmannsweiler,10 - 15 Jahre,346,195,151
False,8116007,Baltmannsweiler,15 - 18 Jahre,139,82,57
False,8116007,Baltmannsweiler,18 - 20 Jahre,106,56,50
False,8116007,Baltmannsweiler,20 - 25 Jahre,248,124,124
False,8116007,Baltmannsweiler,25 - 30 Jahre,292,135,157
False,8116007,Baltmannsweiler,30 - 35 Jahre,459,226,233
False,8116007,Baltmannsweiler,35 - 40 Jahre,523,279,244
False,8116007,Baltmannsweiler,40 - 45 Jahre,380,201,179
False,8116007,Baltmannsweiler,45 - 50 Jahre,356,169,187
False,8116007,Baltmannsweiler,50 - 55 Jahre,341,172,169
False,8116007,Baltmannsweiler,55 - 60 Jahre,397,184,213
False,8116007,Baltmannsweiler,60 - 65 Jahre,392,196,196
False,8116007,Baltmannsweiler,65 - 75 Jahre,504,263,241
False,8116007,Baltmannsweiler,75 und mehr Jahre,313,97,216
False,8116007,Baltmannsweiler,Insgesamt,5520,2760,2760
False,8116008,Bempflingen,unter 3 Jahre,122,53,69
False,8116008,Bempflingen,3 -  6 Jahre,129,69,60
False,8116008,Bempflingen,6 - 10 Jahre,148,83,65
False,8116008,Bempflingen,10 - 15 Jahre,187,99,88
False,8116008,Bempflingen,15 - 18 Jahre,112,58,54
False,8116008,Bempflingen,18 - 20 Jahre,70,34,36
False,8116008,Bempflingen,20 - 25 Jahre,174,84,90
False,8116008,Bempflingen,25 - 30 Jahre,218,117,101
False,8116008,Bempflingen,30 - 35 Jahre,243,115,128
False,8116008,Bempflingen,35 - 40 Jahre,265,137,128
False,8116008,Bempflingen,40 - 45 Jahre,235,108,127
False,8116008,Bempflingen,45 - 50 Jahre,217,113,104
False,8116008,Bempflingen,50 - 55 Jahre,184,88,96
False,8116008,Bempflingen,55 - 60 Jahre,220,116,104
False,8116008,Bempflingen,60 - 65 Jahre,227,112,115
False,8116008,Bempflingen,65 - 75 Jahre,269,130,139
False,8116008,Bempflingen,75 und mehr Jahre,200,67,133
False,8116008,Bempflingen,Insgesamt,3220,1583,1637
False,8116011,Beuren,unter 3 Jahre,95,48,47
False,8116011,Beuren,3 -  6 Jahre,106,58,48
False,8116011,Beuren,6 - 10 Jahre,155,76,79
False,8116011,Beuren,10 - 15 Jahre,253,155,98
False,8116011,Beuren,15 - 18 Jahre,100,59,41
False,8116011,Beuren,18 - 20 Jahre,68,34,34
False,8116011,Beuren,20 - 25 Jahre,184,95,89
False,8116011,Beuren,25 - 30 Jahre,175,100,75
False,8116011,Beuren,30 - 35 Jahre,236,127,109
False,8116011,Beuren,35 - 40 Jahre,256,133,123
False,8116011,Beuren,40 - 45 Jahre,274,137,137
False,8116011,Beuren,45 - 50 Jahre,229,121,108
False,8116011,Beuren,50 - 55 Jahre,166,87,79
False,8116011,Beuren,55 - 60 Jahre,206,98,108
False,8116011,Beuren,60 - 65 Jahre,260,116,144
False,8116011,Beuren,65 - 75 Jahre,324,151,173
False,8116011,Beuren,75 und mehr Jahre,244,74,170
False,8116011,Beuren,Insgesamt,3331,1669,1662
False,8116012,Bissingen an der Teck,unter 3 Jahre,125,71,54
False,8116012,Bissingen an der Teck,3 -  6 Jahre,142,83,59
False,8116012,Bissingen an der Teck,6 - 10 Jahre,207,107,100
False,8116012,Bissingen an der Teck,10 - 15 Jahre,227,108,119
False,8116012,Bissingen an der Teck,15 - 18 Jahre,115,62,53
False,8116012,Bissingen an der Teck,18 - 20 Jahre,112,66,46
False,8116012,Bissingen an der Teck,20 - 25 Jahre,209,115,94
False,8116012,Bissingen an der Teck,25 - 30 Jahre,247,115,132
False,8116012,Bissingen an der Teck,30 - 35 Jahre,280,129,151
False,8116012,Bissingen an der Teck,35 - 40 Jahre,356,181,175
False,8116012,Bissingen an der Teck,40 - 45 Jahre,278,145,133
False,8116012,Bissingen an der Teck,45 - 50 Jahre,250,128,122
False,8116012,Bissingen an der Teck,50 - 55 Jahre,211,102,109
False,8116012,Bissingen an der Teck,55 - 60 Jahre,188,101,87
False,8116012,Bissingen an der Teck,60 - 65 Jahre,233,115,118
False,8116012,Bissingen an der Teck,65 - 75 Jahre,327,157,170
False,8116012,Bissingen an der Teck,75 und mehr Jahre,184,52,132
False,8116012,Bissingen an der Teck,Insgesamt,3691,1837,1854
False,8116014,Deizisau,unter 3 Jahre,225,130,95
False,8116014,Deizisau,3 -  6 Jahre,231,133,98
False,8116014,Deizisau,6 - 10 Jahre,283,147,136
False,8116014,Deizisau,10 - 15 Jahre,306,155,151
False,8116014,Deizisau,15 - 18 Jahre,188,106,82
False,8116014,Deizisau,18 - 20 Jahre,112,64,48
False,8116014,Deizisau,20 - 25 Jahre,329,176,153
False,8116014,Deizisau,25 - 30 Jahre,411,213,198
False,8116014,Deizisau,30 - 35 Jahre,604,307,297
False,8116014,Deizisau,35 - 40 Jahre,599,308,291
False,8116014,Deizisau,40 - 45 Jahre,431,226,205
False,8116014,Deizisau,45 - 50 Jahre,399,204,195
False,8116014,Deizisau,50 - 55 Jahre,386,170,216
False,8116014,Deizisau,55 - 60 Jahre,457,218,239
False,8116014,Deizisau,60 - 65 Jahre,476,250,226
False,8116014,Deizisau,65 - 75 Jahre,618,293,325
False,8116014,Deizisau,75 und mehr Jahre,332,125,207
False,8116014,Deizisau,Insgesamt,6387,3225,3162
False,8116015,Denkendorf,unter 3 Jahre,355,163,192
False,8116015,Denkendorf,3 -  6 Jahre,348,205,143
False,8116015,Denkendorf,6 - 10 Jahre,459,238,221
False,8116015,Denkendorf,10 - 15 Jahre,595,296,299
False,8116015,Denkendorf,15 - 18 Jahre,316,151,165
False,8116015,Denkendorf,18 - 20 Jahre,222,120,102
False,8116015,Denkendorf,20 - 25 Jahre,596,279,317
False,8116015,Denkendorf,25 - 30 Jahre,652,334,318
False,8116015,Denkendorf,30 - 35 Jahre,862,446,416
False,8116015,Denkendorf,35 - 40 Jahre,886,468,418
False,8116015,Denkendorf,40 - 45 Jahre,763,372,391
False,8116015,Denkendorf,45 - 50 Jahre,668,321,347
False,8116015,Denkendorf,50 - 55 Jahre,649,337,312
False,8116015,Denkendorf,55 - 60 Jahre,672,341,331
False,8116015,Denkendorf,60 - 65 Jahre,731,381,350
False,8116015,Denkendorf,65 - 75 Jahre,941,471,470
False,8116015,Denkendorf,75 und mehr Jahre,528,157,371
False,8116015,Denkendorf,Insgesamt,10243,5080,5163
False,8116016,Dettingen unter Teck,unter 3 Jahre,171,86,85
False,8116016,Dettingen unter Teck,3 -  6 Jahre,164,83,81
False,8116016,Dettingen unter Teck,6 - 10 Jahre,235,123,112
False,8116016,Dettingen unter Teck,10 - 15 Jahre,304,150,154
False,8116016,Dettingen unter Teck,15 - 18 Jahre,150,71,79
False,8116016,Dettingen unter Teck,18 - 20 Jahre,136,76,60
False,8116016,Dettingen unter Teck,20 - 25 Jahre,290,164,126
False,8116016,Dettingen unter Teck,25 - 30 Jahre,309,158,151
False,8116016,Dettingen unter Teck,30 - 35 Jahre,415,215,200
False,8116016,Dettingen unter Teck,35 - 40 Jahre,420,229,191
False,8116016,Dettingen unter Teck,40 - 45 Jahre,381,186,195
False,8116016,Dettingen unter Teck,45 - 50 Jahre,385,175,210
False,8116016,Dettingen unter Teck,50 - 55 Jahre,357,178,179
False,8116016,Dettingen unter Teck,55 - 60 Jahre,372,191,181
False,8116016,Dettingen unter Teck,60 - 65 Jahre,395,205,190
False,8116016,Dettingen unter Teck,65 - 75 Jahre,477,231,246
False,8116016,Dettingen unter Teck,75 und mehr Jahre,477,132,345
False,8116016,Dettingen unter Teck,Insgesamt,5438,2653,2785
False,8116018,Erkenbrechtsweiler,unter 3 Jahre,83,51,32
False,8116018,Erkenbrechtsweiler,3 -  6 Jahre,87,39,48
False,8116018,Erkenbrechtsweiler,6 - 10 Jahre,157,80,77
False,8116018,Erkenbrechtsweiler,10 - 15 Jahre,162,67,95
False,8116018,Erkenbrechtsweiler,15 - 18 Jahre,78,40,38
False,8116018,Erkenbrechtsweiler,18 - 20 Jahre,42,21,21
False,8116018,Erkenbrechtsweiler,20 - 25 Jahre,97,44,53
False,8116018,Erkenbrechtsweiler,25 - 30 Jahre,118,66,52
False,8116018,Erkenbrechtsweiler,30 - 35 Jahre,162,78,84
False,8116018,Erkenbrechtsweiler,35 - 40 Jahre,193,89,104
False,8116018,Erkenbrechtsweiler,40 - 45 Jahre,191,101,90
False,8116018,Erkenbrechtsweiler,45 - 50 Jahre,155,81,74
False,8116018,Erkenbrechtsweiler,50 - 55 Jahre,121,68,53
False,8116018,Erkenbrechtsweiler,55 - 60 Jahre,112,57,55
False,8116018,Erkenbrechtsweiler,60 - 65 Jahre,137,64,73
False,8116018,Erkenbrechtsweiler,65 - 75 Jahre,167,75,92
False,8116018,Erkenbrechtsweiler,75 und mehr Jahre,111,30,81
False,8116018,Erkenbrechtsweiler,Insgesamt,2173,1051,1122
False,8116019,"Esslingen am Neckar, Stadt",unter 3 Jahre,2615,1315,1300
False,8116019,"Esslingen am Neckar, Stadt",3 -  6 Jahre,2689,1374,1315
False,8116019,"Esslingen am Neckar, Stadt",6 - 10 Jahre,3356,1721,1635
False,8116019,"Esslingen am Neckar, Stadt",10 - 15 Jahre,4210,2248,1962
False,8116019,"Esslingen am Neckar, Stadt",15 - 18 Jahre,2364,1220,1144
False,8116019,"Esslingen am Neckar, Stadt",18 - 20 Jahre,1818,905,913
False,8116019,"Esslingen am Neckar, Stadt",20 - 25 Jahre,5213,2597,2616
False,8116019,"Esslingen am Neckar, Stadt",25 - 30 Jahre,6107,3156,2951
False,8116019,"Esslingen am Neckar, Stadt",30 - 35 Jahre,7463,3904,3559
False,8116019,"Esslingen am Neckar, Stadt",35 - 40 Jahre,7757,4120,3637
False,8116019,"Esslingen am Neckar, Stadt",40 - 45 Jahre,6580,3403,3177
False,8116019,"Esslingen am Neckar, Stadt",45 - 50 Jahre,5544,2711,2833
False,8116019,"Esslingen am Neckar, Stadt",50 - 55 Jahre,5614,2728,2886
False,8116019,"Esslingen am Neckar, Stadt",55 - 60 Jahre,6077,3082,2995
False,8116019,"Esslingen am Neckar, Stadt",60 - 65 Jahre,6718,3282,3436
False,8116019,"Esslingen am Neckar, Stadt",65 - 75 Jahre,8602,4046,4556
False,8116019,"Esslingen am Neckar, Stadt",75 und mehr Jahre,7280,2305,4975
False,8116019,"Esslingen am Neckar, Stadt",Insgesamt,90007,44117,45890
False,8116020,Frickenhausen,unter 3 Jahre,285,146,139
False,8116020,Frickenhausen,3 -  6 Jahre,282,131,151
False,8116020,Frickenhausen,6 - 10 Jahre,450,229,221
False,8116020,Frickenhausen,10 - 15 Jahre,524,271,253
False,8116020,Frickenhausen,15 - 18 Jahre,278,166,112
False,8116020,Frickenhausen,18 - 20 Jahre,200,95,105
False,8116020,Frickenhausen,20 - 25 Jahre,446,236,210
False,8116020,Frickenhausen,25 - 30 Jahre,465,253,212
False,8116020,Frickenhausen,30 - 35 Jahre,696,353,343
False,8116020,Frickenhausen,35 - 40 Jahre,771,390,381
False,8116020,Frickenhausen,40 - 45 Jahre,677,356,321
False,8116020,Frickenhausen,45 - 50 Jahre,567,283,284
False,8116020,Frickenhausen,50 - 55 Jahre,563,280,283
False,8116020,Frickenhausen,55 - 60 Jahre,579,304,275
False,8116020,Frickenhausen,60 - 65 Jahre,654,331,323
False,8116020,Frickenhausen,65 - 75 Jahre,866,431,435
False,8116020,Frickenhausen,75 und mehr Jahre,524,183,341
False,8116020,Frickenhausen,Insgesamt,8827,4438,4389
False,8116022,Großbettlingen,unter 3 Jahre,131,69,62
False,8116022,Großbettlingen,3 -  6 Jahre,151,79,72
False,8116022,Großbettlingen,6 - 10 Jahre,216,106,110
False,8116022,Großbettlingen,10 - 15 Jahre,225,99,126
False,8116022,Großbettlingen,15 - 18 Jahre,128,59,69
False,8116022,Großbettlingen,18 - 20 Jahre,99,39,60
False,8116022,Großbettlingen,20 - 25 Jahre,194,101,93
False,8116022,Großbettlingen,25 - 30 Jahre,273,136,137
False,8116022,Großbettlingen,30 - 35 Jahre,371,192,179
False,8116022,Großbettlingen,35 - 40 Jahre,399,203,196
False,8116022,Großbettlingen,40 - 45 Jahre,285,143,142
False,8116022,Großbettlingen,45 - 50 Jahre,269,122,147
False,8116022,Großbettlingen,50 - 55 Jahre,268,140,128
False,8116022,Großbettlingen,55 - 60 Jahre,236,108,128
False,8116022,Großbettlingen,60 - 65 Jahre,279,150,129
False,8116022,Großbettlingen,65 - 75 Jahre,291,134,157
False,8116022,Großbettlingen,75 und mehr Jahre,276,79,197
False,8116022,Großbettlingen,Insgesamt,4091,1959,2132
False,8116027,Hochdorf,unter 3 Jahre,143,62,81
False,8116027,Hochdorf,3 -  6 Jahre,163,87,76
False,8116027,Hochdorf,6 - 10 Jahre,234,113,121
False,8116027,Hochdorf,10 - 15 Jahre,230,108,122
False,8116027,Hochdorf,15 - 18 Jahre,138,64,74
False,8116027,Hochdorf,18 - 20 Jahre,97,55,42
False,8116027,Hochdorf,20 - 25 Jahre,247,126,121
False,8116027,Hochdorf,25 - 30 Jahre,255,138,117
False,8116027,Hochdorf,30 - 35 Jahre,435,224,211
False,8116027,Hochdorf,35 - 40 Jahre,384,177,207
False,8116027,Hochdorf,40 - 45 Jahre,379,207,172
False,8116027,Hochdorf,45 - 50 Jahre,330,166,164
False,8116027,Hochdorf,50 - 55 Jahre,294,151,143
False,8116027,Hochdorf,55 - 60 Jahre,303,146,157
False,8116027,Hochdorf,60 - 65 Jahre,347,175,172
False,8116027,Hochdorf,65 - 75 Jahre,469,219,250
False,8116027,Hochdorf,75 und mehr Jahre,272,97,175
False,8116027,Hochdorf,Insgesamt,4720,2315,2405
False,8116029,Holzmaden,unter 3 Jahre,77,37,40
False,8116029,Holzmaden,3 -  6 Jahre,82,39,43
False,8116029,Holzmaden,6 - 10 Jahre,131,66,65
False,8116029,Holzmaden,10 - 15 Jahre,135,75,60
False,8116029,Holzmaden,15 - 18 Jahre,76,36,40
False,8116029,Holzmaden,18 - 20 Jahre,52,25,27
False,8116029,Holzmaden,20 - 25 Jahre,124,75,49
False,8116029,Holzmaden,25 - 30 Jahre,97,46,51
False,8116029,Holzmaden,30 - 35 Jahre,171,83,88
False,8116029,Holzmaden,35 - 40 Jahre,226,115,111
False,8116029,Holzmaden,40 - 45 Jahre,186,91,95
False,8116029,Holzmaden,45 - 50 Jahre,134,77,57
False,8116029,Holzmaden,50 - 55 Jahre,111,53,58
False,8116029,Holzmaden,55 - 60 Jahre,87,42,45
False,8116029,Holzmaden,60 - 65 Jahre,107,59,48
False,8116029,Holzmaden,65 - 75 Jahre,155,69,86
False,8116029,Holzmaden,75 und mehr Jahre,117,37,80
False,8116029,Holzmaden,Insgesamt,2068,1025,1043
False,8116033,"Kirchheim unter Teck, Stadt",unter 3 Jahre,1196,619,577
False,8116033,"Kirchheim unter Teck, Stadt",3 -  6 Jahre,1306,665,641
False,8116033,"Kirchheim unter Teck, Stadt",6 - 10 Jahre,1670,864,806
False,8116033,"Kirchheim unter Teck, Stadt",10 - 15 Jahre,2325,1211,1114
False,8116033,"Kirchheim unter Teck, Stadt",15 - 18 Jahre,1336,679,657
False,8116033,"Kirchheim unter Teck, Stadt",18 - 20 Jahre,945,469,476
False,8116033,"Kirchheim unter Teck, Stadt",20 - 25 Jahre,2162,1099,1063
False,8116033,"Kirchheim unter Teck, Stadt",25 - 30 Jahre,2365,1217,1148
False,8116033,"Kirchheim unter Teck, Stadt",30 - 35 Jahre,3123,1534,1589
False,8116033,"Kirchheim unter Teck, Stadt",35 - 40 Jahre,3264,1640,1624
False,8116033,"Kirchheim unter Teck, Stadt",40 - 45 Jahre,3087,1572,1515
False,8116033,"Kirchheim unter Teck, Stadt",45 - 50 Jahre,2718,1328,1390
False,8116033,"Kirchheim unter Teck, Stadt",50 - 55 Jahre,2258,1163,1095
False,8116033,"Kirchheim unter Teck, Stadt",55 - 60 Jahre,2186,1072,1114
False,8116033,"Kirchheim unter Teck, Stadt",60 - 65 Jahre,2506,1244,1262
False,8116033,"Kirchheim unter Teck, Stadt",65 - 75 Jahre,3517,1652,1865
False,8116033,"Kirchheim unter Teck, Stadt",75 und mehr Jahre,2870,869,2001
False,8116033,"Kirchheim unter Teck, Stadt",Insgesamt,38834,18897,19937
False,8116035,Köngen,unter 3 Jahre,323,174,149
False,8116035,Köngen,3 -  6 Jahre,340,180,160
False,8116035,Köngen,6 - 10 Jahre,495,266,229
False,8116035,Köngen,10 - 15 Jahre,530,268,262
False,8116035,Köngen,15 - 18 Jahre,255,129,126
False,8116035,Köngen,18 - 20 Jahre,157,71,86
False,8116035,Köngen,20 - 25 Jahre,453,206,247
False,8116035,Köngen,25 - 30 Jahre,579,281,298
False,8116035,Köngen,30 - 35 Jahre,876,445,431
False,8116035,Köngen,35 - 40 Jahre,913,474,439
False,8116035,Köngen,40 - 45 Jahre,735,388,347
False,8116035,Köngen,45 - 50 Jahre,552,281,271
False,8116035,Köngen,50 - 55 Jahre,564,282,282
False,8116035,Köngen,55 - 60 Jahre,560,290,270
False,8116035,Köngen,60 - 65 Jahre,625,315,310
False,8116035,Köngen,65 - 75 Jahre,795,374,421
False,8116035,Köngen,75 und mehr Jahre,656,189,467
False,8116035,Köngen,Insgesamt,9408,4613,4795
False,8116036,Kohlberg,unter 3 Jahre,79,39,40
False,8116036,Kohlberg,3 -  6 Jahre,70,36,34
False,8116036,Kohlberg,6 - 10 Jahre,111,68,43
False,8116036,Kohlberg,10 - 15 Jahre,141,72,69
False,8116036,Kohlberg,15 - 18 Jahre,85,46,39
False,8116036,Kohlberg,18 - 20 Jahre,56,29,27
False,8116036,Kohlberg,20 - 25 Jahre,117,53,64
False,8116036,Kohlberg,25 - 30 Jahre,155,85,70
False,8116036,Kohlberg,30 - 35 Jahre,175,93,82
False,8116036,Kohlberg,35 - 40 Jahre,198,99,99
False,8116036,Kohlberg,40 - 45 Jahre,173,91,82
False,8116036,Kohlberg,45 - 50 Jahre,137,67,70
False,8116036,Kohlberg,50 - 55 Jahre,154,71,83
False,8116036,Kohlberg,55 - 60 Jahre,143,76,67
False,8116036,Kohlberg,60 - 65 Jahre,158,83,75
False,8116036,Kohlberg,65 - 75 Jahre,190,81,109
False,8116036,Kohlberg,75 und mehr Jahre,149,41,108
False,8116036,Kohlberg,Insgesamt,2291,1130,1161
False,8116037,Lichtenwald,unter 3 Jahre,65,33,32
False,8116037,Lichtenwald,3 -  6 Jahre,91,40,51
False,8116037,Lichtenwald,6 - 10 Jahre,134,61,73
False,8116037,Lichtenwald,10 - 15 Jahre,149,79,70
False,8116037,Lichtenwald,15 - 18 Jahre,87,40,47
False,8116037,Lichtenwald,18 - 20 Jahre,75,34,41
False,8116037,Lichtenwald,20 - 25 Jahre,134,76,58
False,8116037,Lichtenwald,25 - 30 Jahre,94,51,43
False,8116037,Lichtenwald,30 - 35 Jahre,180,88,92
False,8116037,Lichtenwald,35 - 40 Jahre,225,106,119
False,8116037,Lichtenwald,40 - 45 Jahre,185,103,82
False,8116037,Lichtenwald,45 - 50 Jahre,175,84,91
False,8116037,Lichtenwald,50 - 55 Jahre,187,91,96
False,8116037,Lichtenwald,55 - 60 Jahre,171,90,81
False,8116037,Lichtenwald,60 - 65 Jahre,196,94,102
False,8116037,Lichtenwald,65 - 75 Jahre,260,124,136
False,8116037,Lichtenwald,75 und mehr Jahre,116,46,70
False,8116037,Lichtenwald,Insgesamt,2524,1240,1284
False,8116041,Neckartailfingen,unter 3 Jahre,142,69,73
False,8116041,Neckartailfingen,3 -  6 Jahre,151,83,68
False,8116041,Neckartailfingen,6 - 10 Jahre,192,92,100
False,8116041,Neckartailfingen,10 - 15 Jahre,244,137,107
False,8116041,Neckartailfingen,15 - 18 Jahre,112,71,41
False,8116041,Neckartailfingen,18 - 20 Jahre,81,42,39
False,8116041,Neckartailfingen,20 - 25 Jahre,209,96,113
False,8116041,Neckartailfingen,25 - 30 Jahre,275,127,148
False,8116041,Neckartailfingen,30 - 35 Jahre,358,182,176
False,8116041,Neckartailfingen,35 - 40 Jahre,352,184,168
False,8116041,Neckartailfingen,40 - 45 Jahre,328,166,162
False,8116041,Neckartailfingen,45 - 50 Jahre,229,110,119
False,8116041,Neckartailfingen,50 - 55 Jahre,207,104,103
False,8116041,Neckartailfingen,55 - 60 Jahre,223,119,104
False,8116041,Neckartailfingen,60 - 65 Jahre,224,106,118
False,8116041,Neckartailfingen,65 - 75 Jahre,333,164,169
False,8116041,Neckartailfingen,75 und mehr Jahre,141,43,98
False,8116041,Neckartailfingen,Insgesamt,3801,1895,1906
False,8116042,Neckartenzlingen,unter 3 Jahre,191,94,97
False,8116042,Neckartenzlingen,3 -  6 Jahre,234,113,121
False,8116042,Neckartenzlingen,6 - 10 Jahre,305,141,164
False,8116042,Neckartenzlingen,10 - 15 Jahre,399,205,194
False,8116042,Neckartenzlingen,15 - 18 Jahre,235,120,115
False,8116042,Neckartenzlingen,18 - 20 Jahre,148,75,73
False,8116042,Neckartenzlingen,20 - 25 Jahre,369,178,191
False,8116042,Neckartenzlingen,25 - 30 Jahre,442,222,220
False,8116042,Neckartenzlingen,30 - 35 Jahre,505,280,225
False,8116042,Neckartenzlingen,35 - 40 Jahre,501,239,262
False,8116042,Neckartenzlingen,40 - 45 Jahre,520,266,254
False,8116042,Neckartenzlingen,45 - 50 Jahre,426,212,214
False,8116042,Neckartenzlingen,50 - 55 Jahre,439,221,218
False,8116042,Neckartenzlingen,55 - 60 Jahre,382,192,190
False,8116042,Neckartenzlingen,60 - 65 Jahre,403,213,190
False,8116042,Neckartenzlingen,65 - 75 Jahre,449,217,232
False,8116042,Neckartenzlingen,75 und mehr Jahre,293,80,213
False,8116042,Neckartenzlingen,Insgesamt,6241,3068,3173
False,8116043,Neidlingen,unter 3 Jahre,73,34,39
False,8116043,Neidlingen,3 -  6 Jahre,74,54,20
False,8116043,Neidlingen,6 - 10 Jahre,97,42,55
False,8116043,Neidlingen,10 - 15 Jahre,101,55,46
False,8116043,Neidlingen,15 - 18 Jahre,72,35,37
False,8116043,Neidlingen,18 - 20 Jahre,38,15,23
False,8116043,Neidlingen,20 - 25 Jahre,93,36,57
False,8116043,Neidlingen,25 - 30 Jahre,126,70,56
False,8116043,Neidlingen,30 - 35 Jahre,177,97,80
False,8116043,Neidlingen,35 - 40 Jahre,193,106,87
False,8116043,Neidlingen,40 - 45 Jahre,149,77,72
False,8116043,Neidlingen,45 - 50 Jahre,114,62,52
False,8116043,Neidlingen,50 - 55 Jahre,122,59,63
False,8116043,Neidlingen,55 - 60 Jahre,79,43,36
False,8116043,Neidlingen,60 - 65 Jahre,130,61,69
False,8116043,Neidlingen,65 - 75 Jahre,158,77,81
False,8116043,Neidlingen,75 und mehr Jahre,113,42,71
False,8116043,Neidlingen,Insgesamt,1909,965,944
False,8116046,"Neuffen, Stadt",unter 3 Jahre,179,83,96
False,8116046,"Neuffen, Stadt",3 -  6 Jahre,200,101,99
False,8116046,"Neuffen, Stadt",6 - 10 Jahre,284,148,136
False,8116046,"Neuffen, Stadt",10 - 15 Jahre,392,194,198
False,8116046,"Neuffen, Stadt",15 - 18 Jahre,192,101,91
False,8116046,"Neuffen, Stadt",18 - 20 Jahre,135,68,67
False,8116046,"Neuffen, Stadt",20 - 25 Jahre,333,171,162
False,8116046,"Neuffen, Stadt",25 - 30 Jahre,369,182,187
False,8116046,"Neuffen, Stadt",30 - 35 Jahre,494,245,249
False,8116046,"Neuffen, Stadt",35 - 40 Jahre,491,253,238
False,8116046,"Neuffen, Stadt",40 - 45 Jahre,483,254,229
False,8116046,"Neuffen, Stadt",45 - 50 Jahre,416,203,213
False,8116046,"Neuffen, Stadt",50 - 55 Jahre,347,164,183
False,8116046,"Neuffen, Stadt",55 - 60 Jahre,369,202,167
False,8116046,"Neuffen, Stadt",60 - 65 Jahre,365,165,200
False,8116046,"Neuffen, Stadt",65 - 75 Jahre,513,250,263
False,8116046,"Neuffen, Stadt",75 und mehr Jahre,467,147,320
False,8116046,"Neuffen, Stadt",Insgesamt,6029,2931,3098
False,8116047,Neuhausen auf den Fildern,unter 3 Jahre,345,163,182
False,8116047,Neuhausen auf den Fildern,3 -  6 Jahre,348,177,171
False,8116047,Neuhausen auf den Fildern,6 - 10 Jahre,500,250,250
False,8116047,Neuhausen auf den Fildern,10 - 15 Jahre,627,310,317
False,8116047,Neuhausen auf den Fildern,15 - 18 Jahre,383,194,189
False,8116047,Neuhausen auf den Fildern,18 - 20 Jahre,231,111,120
False,8116047,Neuhausen auf den Fildern,20 - 25 Jahre,586,278,308
False,8116047,Neuhausen auf den Fildern,25 - 30 Jahre,670,321,349
False,8116047,Neuhausen auf den Fildern,30 - 35 Jahre,876,424,452
False,8116047,Neuhausen auf den Fildern,35 - 40 Jahre,983,524,459
False,8116047,Neuhausen auf den Fildern,40 - 45 Jahre,839,437,402
False,8116047,Neuhausen auf den Fildern,45 - 50 Jahre,674,308,366
False,8116047,Neuhausen auf den Fildern,50 - 55 Jahre,734,363,371
False,8116047,Neuhausen auf den Fildern,55 - 60 Jahre,681,337,344
False,8116047,Neuhausen auf den Fildern,60 - 65 Jahre,758,379,379
False,8116047,Neuhausen auf den Fildern,65 - 75 Jahre,989,472,517
False,8116047,Neuhausen auf den Fildern,75 und mehr Jahre,646,212,434
False,8116047,Neuhausen auf den Fildern,Insgesamt,10870,5260,5610
False,8116048,Notzingen,unter 3 Jahre,111,56,55
False,8116048,Notzingen,3 -  6 Jahre,115,62,53
False,8116048,Notzingen,6 - 10 Jahre,179,111,68
False,8116048,Notzingen,10 - 15 Jahre,245,134,111
False,8116048,Notzingen,15 - 18 Jahre,117,62,55
False,8116048,Notzingen,18 - 20 Jahre,83,46,37
False,8116048,Notzingen,20 - 25 Jahre,175,94,81
False,8116048,Notzingen,25 - 30 Jahre,141,69,72
False,8116048,Notzingen,30 - 35 Jahre,262,140,122
False,8116048,Notzingen,35 - 40 Jahre,334,180,154
False,8116048,Notzingen,40 - 45 Jahre,314,148,166
False,8116048,Notzingen,45 - 50 Jahre,277,137,140
False,8116048,Notzingen,50 - 55 Jahre,236,119,117
False,8116048,Notzingen,55 - 60 Jahre,203,98,105
False,8116048,Notzingen,60 - 65 Jahre,259,136,123
False,8116048,Notzingen,65 - 75 Jahre,314,148,166
False,8116048,Notzingen,75 und mehr Jahre,160,49,111
False,8116048,Notzingen,Insgesamt,3525,1789,1736
False,8116049,"Nürtingen, Stadt",unter 3 Jahre,1158,607,551
False,8116049,"Nürtingen, Stadt",3 -  6 Jahre,1230,605,625
False,8116049,"Nürtingen, Stadt",6 - 10 Jahre,1643,827,816
False,8116049,"Nürtingen, Stadt",10 - 15 Jahre,2259,1166,1093
False,8116049,"Nürtingen, Stadt",15 - 18 Jahre,1234,639,595
False,8116049,"Nürtingen, Stadt",18 - 20 Jahre,931,493,438
False,8116049,"Nürtingen, Stadt",20 - 25 Jahre,2356,1154,1202
False,8116049,"Nürtingen, Stadt",25 - 30 Jahre,2537,1272,1265
False,8116049,"Nürtingen, Stadt",30 - 35 Jahre,3130,1621,1509
False,8116049,"Nürtingen, Stadt",35 - 40 Jahre,3342,1696,1646
False,8116049,"Nürtingen, Stadt",40 - 45 Jahre,2921,1450,1471
False,8116049,"Nürtingen, Stadt",45 - 50 Jahre,2554,1241,1313
False,8116049,"Nürtingen, Stadt",50 - 55 Jahre,2455,1240,1215
False,8116049,"Nürtingen, Stadt",55 - 60 Jahre,2506,1259,1247
False,8116049,"Nürtingen, Stadt",60 - 65 Jahre,2723,1336,1387
False,8116049,"Nürtingen, Stadt",65 - 75 Jahre,3561,1678,1883
False,8116049,"Nürtingen, Stadt",75 und mehr Jahre,2759,871,1888
False,8116049,"Nürtingen, Stadt",Insgesamt,39299,19155,20144
False,8116050,Oberboihingen,unter 3 Jahre,164,83,81
False,8116050,Oberboihingen,3 -  6 Jahre,205,100,105
False,8116050,Oberboihingen,6 - 10 Jahre,234,114,120
False,8116050,Oberboihingen,10 - 15 Jahre,318,163,155
False,8116050,Oberboihingen,15 - 18 Jahre,212,103,109
False,8116050,Oberboihingen,18 - 20 Jahre,124,57,67
False,8116050,Oberboihingen,20 - 25 Jahre,295,154,141
False,8116050,Oberboihingen,25 - 30 Jahre,319,169,150
False,8116050,Oberboihingen,30 - 35 Jahre,469,247,222
False,8116050,Oberboihingen,35 - 40 Jahre,470,246,224
False,8116050,Oberboihingen,40 - 45 Jahre,496,262,234
False,8116050,Oberboihingen,45 - 50 Jahre,371,187,184
False,8116050,Oberboihingen,50 - 55 Jahre,343,159,184
False,8116050,Oberboihingen,55 - 60 Jahre,347,188,159
False,8116050,Oberboihingen,60 - 65 Jahre,328,177,151
False,8116050,Oberboihingen,65 - 75 Jahre,448,208,240
False,8116050,Oberboihingen,75 und mehr Jahre,242,84,158
False,8116050,Oberboihingen,Insgesamt,5385,2701,2684
False,8116053,Ohmden,unter 3 Jahre,56,33,23
False,8116053,Ohmden,3 -  6 Jahre,58,31,27
False,8116053,Ohmden,6 - 10 Jahre,70,34,36
False,8116053,Ohmden,10 - 15 Jahre,111,61,50
False,8116053,Ohmden,15 - 18 Jahre,66,29,37
False,8116053,Ohmden,18 - 20 Jahre,45,23,22
False,8116053,Ohmden,20 - 25 Jahre,85,45,40
False,8116053,Ohmden,25 - 30 Jahre,107,53,54
False,8116053,Ohmden,30 - 35 Jahre,142,76,66
False,8116053,Ohmden,35 - 40 Jahre,147,83,64
False,8116053,Ohmden,40 - 45 Jahre,131,72,59
False,8116053,Ohmden,45 - 50 Jahre,125,61,64
False,8116053,Ohmden,50 - 55 Jahre,100,56,44
False,8116053,Ohmden,55 - 60 Jahre,120,51,69
False,8116053,Ohmden,60 - 65 Jahre,114,61,53
False,8116053,Ohmden,65 - 75 Jahre,144,75,69
False,8116053,Ohmden,75 und mehr Jahre,83,30,53
False,8116053,Ohmden,Insgesamt,1704,874,830
False,8116054,"Owen, Stadt",unter 3 Jahre,134,59,75
False,8116054,"Owen, Stadt",3 -  6 Jahre,130,75,55
False,8116054,"Owen, Stadt",6 - 10 Jahre,179,102,77
False,8116054,"Owen, Stadt",10 - 15 Jahre,242,139,103
False,8116054,"Owen, Stadt",15 - 18 Jahre,126,73,53
False,8116054,"Owen, Stadt",18 - 20 Jahre,71,37,34
False,8116054,"Owen, Stadt",20 - 25 Jahre,183,76,107
False,8116054,"Owen, Stadt",25 - 30 Jahre,208,113,95
False,8116054,"Owen, Stadt",30 - 35 Jahre,274,138,136
False,8116054,"Owen, Stadt",35 - 40 Jahre,324,161,163
False,8116054,"Owen, Stadt",40 - 45 Jahre,273,137,136
False,8116054,"Owen, Stadt",45 - 50 Jahre,226,105,121
False,8116054,"Owen, Stadt",50 - 55 Jahre,206,118,88
False,8116054,"Owen, Stadt",55 - 60 Jahre,172,97,75
False,8116054,"Owen, Stadt",60 - 65 Jahre,202,102,100
False,8116054,"Owen, Stadt",65 - 75 Jahre,333,158,175
False,8116054,"Owen, Stadt",75 und mehr Jahre,202,61,141
False,8116054,"Owen, Stadt",Insgesamt,3485,1751,1734
False,8116056,"Plochingen, Stadt",unter 3 Jahre,497,272,225
False,8116056,"Plochingen, Stadt",3 -  6 Jahre,454,221,233
False,8116056,"Plochingen, Stadt",6 - 10 Jahre,604,302,302
False,8116056,"Plochingen, Stadt",10 - 15 Jahre,740,383,357
False,8116056,"Plochingen, Stadt",15 - 18 Jahre,407,214,193
False,8116056,"Plochingen, Stadt",18 - 20 Jahre,304,139,165
False,8116056,"Plochingen, Stadt",20 - 25 Jahre,806,391,415
False,8116056,"Plochingen, Stadt",25 - 30 Jahre,963,500,463
False,8116056,"Plochingen, Stadt",30 - 35 Jahre,1238,643,595
False,8116056,"Plochingen, Stadt",35 - 40 Jahre,1291,672,619
False,8116056,"Plochingen, Stadt",40 - 45 Jahre,1037,560,477
False,8116056,"Plochingen, Stadt",45 - 50 Jahre,920,494,426
False,8116056,"Plochingen, Stadt",50 - 55 Jahre,854,441,413
False,8116056,"Plochingen, Stadt",55 - 60 Jahre,872,445,427
False,8116056,"Plochingen, Stadt",60 - 65 Jahre,1036,515,521
False,8116056,"Plochingen, Stadt",65 - 75 Jahre,1207,575,632
False,8116056,"Plochingen, Stadt",75 und mehr Jahre,961,287,674
False,8116056,"Plochingen, Stadt",Insgesamt,14191,7054,7137
False,8116058,Reichenbach an der Fils,unter 3 Jahre,287,142,145
False,8116058,Reichenbach an der Fils,3 -  6 Jahre,298,169,129
False,8116058,Reichenbach an der Fils,6 - 10 Jahre,402,180,222
False,8116058,Reichenbach an der Fils,10 - 15 Jahre,429,227,202
False,8116058,Reichenbach an der Fils,15 - 18 Jahre,213,112,101
False,8116058,Reichenbach an der Fils,18 - 20 Jahre,157,87,70
False,8116058,Reichenbach an der Fils,20 - 25 Jahre,404,192,212
False,8116058,Reichenbach an der Fils,25 - 30 Jahre,512,240,272
False,8116058,Reichenbach an der Fils,30 - 35 Jahre,653,326,327
False,8116058,Reichenbach an der Fils,35 - 40 Jahre,737,393,344
False,8116058,Reichenbach an der Fils,40 - 45 Jahre,593,320,273
False,8116058,Reichenbach an der Fils,45 - 50 Jahre,490,248,242
False,8116058,Reichenbach an der Fils,50 - 55 Jahre,427,196,231
False,8116058,Reichenbach an der Fils,55 - 60 Jahre,512,234,278
False,8116058,Reichenbach an der Fils,60 - 65 Jahre,563,274,289
False,8116058,Reichenbach an der Fils,65 - 75 Jahre,776,385,391
False,8116058,Reichenbach an der Fils,75 und mehr Jahre,569,178,391
False,8116058,Reichenbach an der Fils,Insgesamt,8022,3903,4119
False,8116063,Schlaitdorf,unter 3 Jahre,66,32,34
False,8116063,Schlaitdorf,3 -  6 Jahre,57,25,32
False,8116063,Schlaitdorf,6 - 10 Jahre,105,49,56
False,8116063,Schlaitdorf,10 - 15 Jahre,108,50,58
False,8116063,Schlaitdorf,15 - 18 Jahre,51,34,17
False,8116063,Schlaitdorf,18 - 20 Jahre,34,19,15
False,8116063,Schlaitdorf,20 - 25 Jahre,80,37,43
False,8116063,Schlaitdorf,25 - 30 Jahre,85,40,45
False,8116063,Schlaitdorf,30 - 35 Jahre,138,73,65
False,8116063,Schlaitdorf,35 - 40 Jahre,148,75,73
False,8116063,Schlaitdorf,40 - 45 Jahre,160,70,90
False,8116063,Schlaitdorf,45 - 50 Jahre,125,63,62
False,8116063,Schlaitdorf,50 - 55 Jahre,98,53,45
False,8116063,Schlaitdorf,55 - 60 Jahre,83,50,33
False,8116063,Schlaitdorf,60 - 65 Jahre,89,40,49
False,8116063,Schlaitdorf,65 - 75 Jahre,123,61,62
False,8116063,Schlaitdorf,75 und mehr Jahre,85,26,59
False,8116063,Schlaitdorf,Insgesamt,1635,797,838
False,8116068,Unterensingen,unter 3 Jahre,176,99,77
False,8116068,Unterensingen,3 -  6 Jahre,176,89,87
False,8116068,Unterensingen,6 - 10 Jahre,239,122,117
False,8116068,Unterensingen,10 - 15 Jahre,266,133,133
False,8116068,Unterensingen,15 - 18 Jahre,115,48,67
False,8116068,Unterensingen,18 - 20 Jahre,95,52,43
False,8116068,Unterensingen,20 - 25 Jahre,221,110,111
False,8116068,Unterensingen,25 - 30 Jahre,248,121,127
False,8116068,Unterensingen,30 - 35 Jahre,441,203,238
False,8116068,Unterensingen,35 - 40 Jahre,455,252,203
False,8116068,Unterensingen,40 - 45 Jahre,330,185,145
False,8116068,Unterensingen,45 - 50 Jahre,281,128,153
False,8116068,Unterensingen,50 - 55 Jahre,264,121,143
False,8116068,Unterensingen,55 - 60 Jahre,299,148,151
False,8116068,Unterensingen,60 - 65 Jahre,291,146,145
False,8116068,Unterensingen,65 - 75 Jahre,384,185,199
False,8116068,Unterensingen,75 und mehr Jahre,198,77,121
False,8116068,Unterensingen,Insgesamt,4479,2219,2260
False,8116070,"Weilheim an der Teck, Stadt",unter 3 Jahre,295,142,153
False,8116070,"Weilheim an der Teck, Stadt",3 -  6 Jahre,368,200,168
False,8116070,"Weilheim an der Teck, Stadt",6 - 10 Jahre,487,245,242
False,8116070,"Weilheim an der Teck, Stadt",10 - 15 Jahre,597,305,292
False,8116070,"Weilheim an der Teck, Stadt",15 - 18 Jahre,360,168,192
False,8116070,"Weilheim an der Teck, Stadt",18 - 20 Jahre,229,121,108
False,8116070,"Weilheim an der Teck, Stadt",20 - 25 Jahre,505,247,258
False,8116070,"Weilheim an der Teck, Stadt",25 - 30 Jahre,514,263,251
False,8116070,"Weilheim an der Teck, Stadt",30 - 35 Jahre,733,359,374
False,8116070,"Weilheim an der Teck, Stadt",35 - 40 Jahre,871,443,428
False,8116070,"Weilheim an der Teck, Stadt",40 - 45 Jahre,798,420,378
False,8116070,"Weilheim an der Teck, Stadt",45 - 50 Jahre,630,328,302
False,8116070,"Weilheim an der Teck, Stadt",50 - 55 Jahre,538,279,259
False,8116070,"Weilheim an der Teck, Stadt",55 - 60 Jahre,533,272,261
False,8116070,"Weilheim an der Teck, Stadt",60 - 65 Jahre,567,282,285
False,8116070,"Weilheim an der Teck, Stadt",65 - 75 Jahre,818,374,444
False,8116070,"Weilheim an der Teck, Stadt",75 und mehr Jahre,630,202,428
False,8116070,"Weilheim an der Teck, Stadt",Insgesamt,9473,4650,4823
False,8116071,"Wendlingen am Neckar, Stadt",unter 3 Jahre,484,249,235
False,8116071,"Wendlingen am Neckar, Stadt",3 -  6 Jahre,528,256,272
False,8116071,"Wendlingen am Neckar, Stadt",6 - 10 Jahre,732,384,348
False,8116071,"Wendlingen am Neckar, Stadt",10 - 15 Jahre,922,475,447
False,8116071,"Wendlingen am Neckar, Stadt",15 - 18 Jahre,477,225,252
False,8116071,"Wendlingen am Neckar, Stadt",18 - 20 Jahre,327,157,170
False,8116071,"Wendlingen am Neckar, Stadt",20 - 25 Jahre,872,438,434
False,8116071,"Wendlingen am Neckar, Stadt",25 - 30 Jahre,952,466,486
False,8116071,"Wendlingen am Neckar, Stadt",30 - 35 Jahre,1318,667,651
False,8116071,"Wendlingen am Neckar, Stadt",35 - 40 Jahre,1393,747,646
False,8116071,"Wendlingen am Neckar, Stadt",40 - 45 Jahre,1243,613,630
False,8116071,"Wendlingen am Neckar, Stadt",45 - 50 Jahre,948,464,484
False,8116071,"Wendlingen am Neckar, Stadt",50 - 55 Jahre,979,468,511
False,8116071,"Wendlingen am Neckar, Stadt",55 - 60 Jahre,988,494,494
False,8116071,"Wendlingen am Neckar, Stadt",60 - 65 Jahre,1131,562,569
False,8116071,"Wendlingen am Neckar, Stadt",65 - 75 Jahre,1404,680,724
False,8116071,"Wendlingen am Neckar, Stadt",75 und mehr Jahre,871,267,604
False,8116071,"Wendlingen am Neckar, Stadt",Insgesamt,15569,7612,7957
False,8116072,"Wernau (Neckar), Stadt",unter 3 Jahre,413,221,192
False,8116072,"Wernau (Neckar), Stadt",3 -  6 Jahre,412,206,206
False,8116072,"Wernau (Neckar), Stadt",6 - 10 Jahre,489,241,248
False,8116072,"Wernau (Neckar), Stadt",10 - 15 Jahre,664,347,317
False,8116072,"Wernau (Neckar), Stadt",15 - 18 Jahre,371,182,189
False,8116072,"Wernau (Neckar), Stadt",18 - 20 Jahre,226,111,115
False,8116072,"Wernau (Neckar), Stadt",20 - 25 Jahre,675,336,339
False,8116072,"Wernau (Neckar), Stadt",25 - 30 Jahre,825,418,407
False,8116072,"Wernau (Neckar), Stadt",30 - 35 Jahre,1063,545,518
False,8116072,"Wernau (Neckar), Stadt",35 - 40 Jahre,1100,570,530
False,8116072,"Wernau (Neckar), Stadt",40 - 45 Jahre,864,489,375
False,8116072,"Wernau (Neckar), Stadt",45 - 50 Jahre,786,379,407
False,8116072,"Wernau (Neckar), Stadt",50 - 55 Jahre,739,386,353
False,8116072,"Wernau (Neckar), Stadt",55 - 60 Jahre,691,313,378
False,8116072,"Wernau (Neckar), Stadt",60 - 65 Jahre,932,461,471
False,8116072,"Wernau (Neckar), Stadt",65 - 75 Jahre,1300,620,680
False,8116072,"Wernau (Neckar), Stadt",75 und mehr Jahre,909,303,606
False,8116072,"Wernau (Neckar), Stadt",Insgesamt,12459,6128,6331
False,8116073,Wolfschlugen,unter 3 Jahre,203,104,99
False,8116073,Wolfschlugen,3 -  6 Jahre,207,100,107
False,8116073,Wolfschlugen,6 - 10 Jahre,267,144,123
False,8116073,Wolfschlugen,10 - 15 Jahre,356,174,182
False,8116073,Wolfschlugen,15 - 18 Jahre,172,90,82
False,8116073,Wolfschlugen,18 - 20 Jahre,124,66,58
False,8116073,Wolfschlugen,20 - 25 Jahre,375,192,183
False,8116073,Wolfschlugen,25 - 30 Jahre,390,196,194
False,8116073,Wolfschlugen,30 - 35 Jahre,552,280,272
False,8116073,Wolfschlugen,35 - 40 Jahre,529,278,251
False,8116073,Wolfschlugen,40 - 45 Jahre,519,269,250
False,8116073,Wolfschlugen,45 - 50 Jahre,436,215,221
False,8116073,Wolfschlugen,50 - 55 Jahre,384,191,193
False,8116073,Wolfschlugen,55 - 60 Jahre,412,215,197
False,8116073,Wolfschlugen,60 - 65 Jahre,401,207,194
False,8116073,Wolfschlugen,65 - 75 Jahre,454,216,238
False,8116073,Wolfschlugen,75 und mehr Jahre,301,106,195
False,8116073,Wolfschlugen,Insgesamt,6082,3043,3039
False,8116076,Aichwald,unter 3 Jahre,222,116,106
False,8116076,Aichwald,3 -  6 Jahre,243,118,125
False,8116076,Aichwald,6 - 10 Jahre,339,176,163
False,8116076,Aichwald,10 - 15 Jahre,413,225,188
False,8116076,Aichwald,15 - 18 Jahre,252,120,132
False,8116076,Aichwald,18 - 20 Jahre,168,88,80
False,8116076,Aichwald,20 - 25 Jahre,415,212,203
False,8116076,Aichwald,25 - 30 Jahre,384,198,186
False,8116076,Aichwald,30 - 35 Jahre,579,283,296
False,8116076,Aichwald,35 - 40 Jahre,632,327,305
False,8116076,Aichwald,40 - 45 Jahre,585,282,303
False,8116076,Aichwald,45 - 50 Jahre,518,250,268
False,8116076,Aichwald,50 - 55 Jahre,542,253,289
False,8116076,Aichwald,55 - 60 Jahre,654,322,332
False,8116076,Aichwald,60 - 65 Jahre,651,339,312
False,8116076,Aichwald,65 - 75 Jahre,764,373,391
False,8116076,Aichwald,75 und mehr Jahre,405,152,253
False,8116076,Aichwald,Insgesamt,7766,3834,3932
False,8116077,"Filderstadt, Stadt",unter 3 Jahre,1413,695,718
False,8116077,"Filderstadt, Stadt",3 -  6 Jahre,1535,782,753
False,8116077,"Filderstadt, Stadt",6 - 10 Jahre,1987,1012,975
False,8116077,"Filderstadt, Stadt",10 - 15 Jahre,2342,1240,1102
False,8116077,"Filderstadt, Stadt",15 - 18 Jahre,1227,608,619
False,8116077,"Filderstadt, Stadt",18 - 20 Jahre,856,405,451
False,8116077,"Filderstadt, Stadt",20 - 25 Jahre,2262,1141,1121
False,8116077,"Filderstadt, Stadt",25 - 30 Jahre,2822,1371,1451
False,8116077,"Filderstadt, Stadt",30 - 35 Jahre,4166,2079,2087
False,8116077,"Filderstadt, Stadt",35 - 40 Jahre,4172,2168,2004
False,8116077,"Filderstadt, Stadt",40 - 45 Jahre,3526,1765,1761
False,8116077,"Filderstadt, Stadt",45 - 50 Jahre,2821,1414,1407
False,8116077,"Filderstadt, Stadt",50 - 55 Jahre,2709,1341,1368
False,8116077,"Filderstadt, Stadt",55 - 60 Jahre,2550,1324,1226
False,8116077,"Filderstadt, Stadt",60 - 65 Jahre,2701,1317,1384
False,8116077,"Filderstadt, Stadt",65 - 75 Jahre,3135,1492,1643
False,8116077,"Filderstadt, Stadt",75 und mehr Jahre,2010,637,1373
False,8116077,"Filderstadt, Stadt",Insgesamt,42234,20791,21443
False,8116078,"Leinfelden-Echterdingen, Stadt",unter 3 Jahre,1078,550,528
False,8116078,"Leinfelden-Echterdingen, Stadt",3 -  6 Jahre,1017,523,494
False,8116078,"Leinfelden-Echterdingen, Stadt",6 - 10 Jahre,1407,737,670
False,8116078,"Leinfelden-Echterdingen, Stadt",10 - 15 Jahre,1775,900,875
False,8116078,"Leinfelden-Echterdingen, Stadt",15 - 18 Jahre,986,531,455
False,8116078,"Leinfelden-Echterdingen, Stadt",18 - 20 Jahre,657,328,329
False,8116078,"Leinfelden-Echterdingen, Stadt",20 - 25 Jahre,1783,896,887
False,8116078,"Leinfelden-Echterdingen, Stadt",25 - 30 Jahre,2379,1207,1172
False,8116078,"Leinfelden-Echterdingen, Stadt",30 - 35 Jahre,3331,1673,1658
False,8116078,"Leinfelden-Echterdingen, Stadt",35 - 40 Jahre,3336,1721,1615
False,8116078,"Leinfelden-Echterdingen, Stadt",40 - 45 Jahre,2787,1441,1346
False,8116078,"Leinfelden-Echterdingen, Stadt",45 - 50 Jahre,2340,1150,1190
False,8116078,"Leinfelden-Echterdingen, Stadt",50 - 55 Jahre,2322,1096,1226
False,8116078,"Leinfelden-Echterdingen, Stadt",55 - 60 Jahre,2561,1271,1290
False,8116078,"Leinfelden-Echterdingen, Stadt",60 - 65 Jahre,2646,1238,1408
False,8116078,"Leinfelden-Echterdingen, Stadt",65 - 75 Jahre,3368,1581,1787
False,8116078,"Leinfelden-Echterdingen, Stadt",75 und mehr Jahre,2253,759,1494
False,8116078,"Leinfelden-Echterdingen, Stadt",Insgesamt,36026,17602,18424
False,8116079,Lenningen,unter 3 Jahre,264,134,130
False,8116079,Lenningen,3 -  6 Jahre,284,156,128
False,8116079,Lenningen,6 - 10 Jahre,427,237,190
False,8116079,Lenningen,10 - 15 Jahre,607,319,288
False,8116079,Lenningen,15 - 18 Jahre,321,165,156
False,8116079,Lenningen,18 - 20 Jahre,196,98,98
False,8116079,Lenningen,20 - 25 Jahre,427,224,203
False,8116079,Lenningen,25 - 30 Jahre,432,224,208
False,8116079,Lenningen,30 - 35 Jahre,674,355,319
False,8116079,Lenningen,35 - 40 Jahre,792,415,377
False,8116079,Lenningen,40 - 45 Jahre,706,377,329
False,8116079,Lenningen,45 - 50 Jahre,553,275,278
False,8116079,Lenningen,50 - 55 Jahre,530,274,256
False,8116079,Lenningen,55 - 60 Jahre,504,262,242
False,8116079,Lenningen,60 - 65 Jahre,639,344,295
False,8116079,Lenningen,65 - 75 Jahre,831,381,450
False,8116079,Lenningen,75 und mehr Jahre,510,151,359
False,8116079,Lenningen,Insgesamt,8697,4391,4306
False,8116080,"Ostfildern, Stadt",unter 3 Jahre,969,509,460
False,8116080,"Ostfildern, Stadt",3 -  6 Jahre,1020,545,475
False,8116080,"Ostfildern, Stadt",6 - 10 Jahre,1305,639,666
False,8116080,"Ostfildern, Stadt",10 - 15 Jahre,1667,838,829
False,8116080,"Ostfildern, Stadt",15 - 18 Jahre,903,485,418
False,8116080,"Ostfildern, Stadt",18 - 20 Jahre,645,348,297
False,8116080,"Ostfildern, Stadt",20 - 25 Jahre,1635,817,818
False,8116080,"Ostfildern, Stadt",25 - 30 Jahre,1974,1000,974
False,8116080,"Ostfildern, Stadt",30 - 35 Jahre,2563,1287,1276
False,8116080,"Ostfildern, Stadt",35 - 40 Jahre,2704,1359,1345
False,8116080,"Ostfildern, Stadt",40 - 45 Jahre,2349,1168,1181
False,8116080,"Ostfildern, Stadt",45 - 50 Jahre,2088,1020,1068
False,8116080,"Ostfildern, Stadt",50 - 55 Jahre,1991,952,1039
False,8116080,"Ostfildern, Stadt",55 - 60 Jahre,2069,1052,1017
False,8116080,"Ostfildern, Stadt",60 - 65 Jahre,2235,1103,1132
False,8116080,"Ostfildern, Stadt",65 - 75 Jahre,2822,1340,1482
False,8116080,"Ostfildern, Stadt",75 und mehr Jahre,1919,654,1265
False,8116080,"Ostfildern, Stadt",Insgesamt,30858,15116,15742
False,8116081,"Aichtal, Stadt",unter 3 Jahre,291,154,137
False,8116081,"Aichtal, Stadt",3 -  6 Jahre,340,180,160
False,8116081,"Aichtal, Stadt",6 - 10 Jahre,483,267,216
False,8116081,"Aichtal, Stadt",10 - 15 Jahre,603,293,310
False,8116081,"Aichtal, Stadt",15 - 18 Jahre,290,168,122
False,8116081,"Aichtal, Stadt",18 - 20 Jahre,198,92,106
False,8116081,"Aichtal, Stadt",20 - 25 Jahre,475,240,235
False,8116081,"Aichtal, Stadt",25 - 30 Jahre,535,263,272
False,8116081,"Aichtal, Stadt",30 - 35 Jahre,854,427,427
False,8116081,"Aichtal, Stadt",35 - 40 Jahre,894,444,450
False,8116081,"Aichtal, Stadt",40 - 45 Jahre,847,453,394
False,8116081,"Aichtal, Stadt",45 - 50 Jahre,693,355,338
False,8116081,"Aichtal, Stadt",50 - 55 Jahre,657,333,324
False,8116081,"Aichtal, Stadt",55 - 60 Jahre,592,328,264
False,8116081,"Aichtal, Stadt",60 - 65 Jahre,571,269,302
False,8116081,"Aichtal, Stadt",65 - 75 Jahre,757,359,398
False,8116081,"Aichtal, Stadt",75 und mehr Jahre,451,142,309
False,8116081,"Aichtal, Stadt",Insgesamt,9531,4767,4764
False,8117,Landkreis Göppingen,unter 3 Jahre,7968,4104,3864
False,8117,Landkreis Göppingen,3 -  6 Jahre,8534,4426,4108
False,8117,Landkreis Göppingen,6 - 10 Jahre,12020,6243,5777
False,8117,Landkreis Göppingen,10 - 15 Jahre,15330,7841,7489
False,8117,Landkreis Göppingen,15 - 18 Jahre,8699,4504,4195
False,8117,Landkreis Göppingen,18 - 20 Jahre,6000,3100,2900
False,8117,Landkreis Göppingen,20 - 25 Jahre,14017,7072,6945
False,8117,Landkreis Göppingen,25 - 30 Jahre,15385,7802,7583
False,8117,Landkreis Göppingen,30 - 35 Jahre,20554,10522,10032
False,8117,Landkreis Göppingen,35 - 40 Jahre,21490,11201,10289
False,8117,Landkreis Göppingen,40 - 45 Jahre,19193,9807,9386
False,8117,Landkreis Göppingen,45 - 50 Jahre,16909,8497,8412
False,8117,Landkreis Göppingen,50 - 55 Jahre,15421,7771,7650
False,8117,Landkreis Göppingen,55 - 60 Jahre,15077,7593,7484
False,8117,Landkreis Göppingen,60 - 65 Jahre,17537,8613,8924
False,8117,Landkreis Göppingen,65 - 75 Jahre,23731,11099,12632
False,8117,Landkreis Göppingen,75 und mehr Jahre,18927,5977,12950
False,8117,Landkreis Göppingen,Insgesamt,256792,126172,130620
False,8117001,Adelberg,unter 3 Jahre,51,26,25
False,8117001,Adelberg,3 -  6 Jahre,64,34,30
False,8117001,Adelberg,6 - 10 Jahre,102,54,48
False,8117001,Adelberg,10 - 15 Jahre,122,63,59
False,8117001,Adelberg,15 - 18 Jahre,73,46,27
False,8117001,Adelberg,18 - 20 Jahre,44,25,19
False,8117001,Adelberg,20 - 25 Jahre,88,44,44
False,8117001,Adelberg,25 - 30 Jahre,112,53,59
False,8117001,Adelberg,30 - 35 Jahre,171,96,75
False,8117001,Adelberg,35 - 40 Jahre,199,108,91
False,8117001,Adelberg,40 - 45 Jahre,145,81,64
False,8117001,Adelberg,45 - 50 Jahre,167,76,91
False,8117001,Adelberg,50 - 55 Jahre,150,81,69
False,8117001,Adelberg,55 - 60 Jahre,121,60,61
False,8117001,Adelberg,60 - 65 Jahre,131,70,61
False,8117001,Adelberg,65 - 75 Jahre,171,83,88
False,8117001,Adelberg,75 und mehr Jahre,130,51,79
False,8117001,Adelberg,Insgesamt,2041,1051,990
False,8117002,Aichelberg,unter 3 Jahre,48,25,23
False,8117002,Aichelberg,3 -  6 Jahre,51,35,16
False,8117002,Aichelberg,6 - 10 Jahre,59,35,24
False,8117002,Aichelberg,10 - 15 Jahre,65,35,30
False,8117002,Aichelberg,15 - 18 Jahre,31,19,12
False,8117002,Aichelberg,18 - 20 Jahre,21,12,9
False,8117002,Aichelberg,20 - 25 Jahre,58,24,34
False,8117002,Aichelberg,25 - 30 Jahre,75,33,42
False,8117002,Aichelberg,30 - 35 Jahre,128,73,55
False,8117002,Aichelberg,35 - 40 Jahre,122,68,54
False,8117002,Aichelberg,40 - 45 Jahre,91,44,47
False,8117002,Aichelberg,45 - 50 Jahre,81,42,39
False,8117002,Aichelberg,50 - 55 Jahre,81,49,32
False,8117002,Aichelberg,55 - 60 Jahre,66,32,34
False,8117002,Aichelberg,60 - 65 Jahre,66,31,35
False,8117002,Aichelberg,65 - 75 Jahre,87,40,47
False,8117002,Aichelberg,75 und mehr Jahre,64,23,41
False,8117002,Aichelberg,Insgesamt,1194,620,574
False,8117003,Albershausen,unter 3 Jahre,140,75,65
False,8117003,Albershausen,3 -  6 Jahre,195,100,95
False,8117003,Albershausen,6 - 10 Jahre,222,127,95
False,8117003,Albershausen,10 - 15 Jahre,254,122,132
False,8117003,Albershausen,15 - 18 Jahre,161,87,74
False,8117003,Albershausen,18 - 20 Jahre,106,51,55
False,8117003,Albershausen,20 - 25 Jahre,237,122,115
False,8117003,Albershausen,25 - 30 Jahre,253,130,123
False,8117003,Albershausen,30 - 35 Jahre,381,178,203
False,8117003,Albershausen,35 - 40 Jahre,434,236,198
False,8117003,Albershausen,40 - 45 Jahre,324,152,172
False,8117003,Albershausen,45 - 50 Jahre,281,146,135
False,8117003,Albershausen,50 - 55 Jahre,247,134,113
False,8117003,Albershausen,55 - 60 Jahre,264,137,127
False,8117003,Albershausen,60 - 65 Jahre,273,130,143
False,8117003,Albershausen,65 - 75 Jahre,408,196,212
False,8117003,Albershausen,75 und mehr Jahre,256,93,163
False,8117003,Albershausen,Insgesamt,4436,2216,2220
False,8117006,Bad Ditzenbach,unter 3 Jahre,118,62,56
False,8117006,Bad Ditzenbach,3 -  6 Jahre,122,60,62
False,8117006,Bad Ditzenbach,6 - 10 Jahre,207,106,101
False,8117006,Bad Ditzenbach,10 - 15 Jahre,226,109,117
False,8117006,Bad Ditzenbach,15 - 18 Jahre,123,59,64
False,8117006,Bad Ditzenbach,18 - 20 Jahre,71,35,36
False,8117006,Bad Ditzenbach,20 - 25 Jahre,172,96,76
False,8117006,Bad Ditzenbach,25 - 30 Jahre,199,89,110
False,8117006,Bad Ditzenbach,30 - 35 Jahre,309,155,154
False,8117006,Bad Ditzenbach,35 - 40 Jahre,361,185,176
False,8117006,Bad Ditzenbach,40 - 45 Jahre,291,154,137
False,8117006,Bad Ditzenbach,45 - 50 Jahre,227,121,106
False,8117006,Bad Ditzenbach,50 - 55 Jahre,187,97,90
False,8117006,Bad Ditzenbach,55 - 60 Jahre,196,101,95
False,8117006,Bad Ditzenbach,60 - 65 Jahre,250,127,123
False,8117006,Bad Ditzenbach,65 - 75 Jahre,331,147,184
False,8117006,Bad Ditzenbach,75 und mehr Jahre,276,89,187
False,8117006,Bad Ditzenbach,Insgesamt,3666,1792,1874
False,8117007,Bad Überkingen,unter 3 Jahre,131,72,59
False,8117007,Bad Überkingen,3 -  6 Jahre,127,58,69
False,8117007,Bad Überkingen,6 - 10 Jahre,198,104,94
False,8117007,Bad Überkingen,10 - 15 Jahre,225,108,117
False,8117007,Bad Überkingen,15 - 18 Jahre,113,49,64
False,8117007,Bad Überkingen,18 - 20 Jahre,97,46,51
False,8117007,Bad Überkingen,20 - 25 Jahre,210,106,104
False,8117007,Bad Überkingen,25 - 30 Jahre,198,88,110
False,8117007,Bad Überkingen,30 - 35 Jahre,288,135,153
False,8117007,Bad Überkingen,35 - 40 Jahre,297,158,139
False,8117007,Bad Überkingen,40 - 45 Jahre,241,120,121
False,8117007,Bad Überkingen,45 - 50 Jahre,249,112,137
False,8117007,Bad Überkingen,50 - 55 Jahre,203,108,95
False,8117007,Bad Überkingen,55 - 60 Jahre,267,113,154
False,8117007,Bad Überkingen,60 - 65 Jahre,307,147,160
False,8117007,Bad Überkingen,65 - 75 Jahre,372,179,193
False,8117007,Bad Überkingen,75 und mehr Jahre,372,126,246
False,8117007,Bad Überkingen,Insgesamt,3895,1829,2066
False,8117009,Birenbach,unter 3 Jahre,70,35,35
False,8117009,Birenbach,3 -  6 Jahre,57,29,28
False,8117009,Birenbach,6 - 10 Jahre,103,48,55
False,8117009,Birenbach,10 - 15 Jahre,114,61,53
False,8117009,Birenbach,15 - 18 Jahre,72,35,37
False,8117009,Birenbach,18 - 20 Jahre,34,19,15
False,8117009,Birenbach,20 - 25 Jahre,97,39,58
False,8117009,Birenbach,25 - 30 Jahre,96,48,48
False,8117009,Birenbach,30 - 35 Jahre,152,64,88
False,8117009,Birenbach,35 - 40 Jahre,173,101,72
False,8117009,Birenbach,40 - 45 Jahre,160,84,76
False,8117009,Birenbach,45 - 50 Jahre,135,68,67
False,8117009,Birenbach,50 - 55 Jahre,121,60,61
False,8117009,Birenbach,55 - 60 Jahre,127,56,71
False,8117009,Birenbach,60 - 65 Jahre,133,69,64
False,8117009,Birenbach,65 - 75 Jahre,176,85,91
False,8117009,Birenbach,75 und mehr Jahre,95,31,64
False,8117009,Birenbach,Insgesamt,1915,932,983
False,8117010,Böhmenkirch,unter 3 Jahre,184,98,86
False,8117010,Böhmenkirch,3 -  6 Jahre,259,128,131
False,8117010,Böhmenkirch,6 - 10 Jahre,309,163,146
False,8117010,Böhmenkirch,10 - 15 Jahre,390,214,176
False,8117010,Böhmenkirch,15 - 18 Jahre,206,106,100
False,8117010,Böhmenkirch,18 - 20 Jahre,128,68,60
False,8117010,Böhmenkirch,20 - 25 Jahre,304,152,152
False,8117010,Böhmenkirch,25 - 30 Jahre,355,212,143
False,8117010,Böhmenkirch,30 - 35 Jahre,498,233,265
False,8117010,Böhmenkirch,35 - 40 Jahre,561,285,276
False,8117010,Böhmenkirch,40 - 45 Jahre,399,215,184
False,8117010,Böhmenkirch,45 - 50 Jahre,356,193,163
False,8117010,Böhmenkirch,50 - 55 Jahre,312,150,162
False,8117010,Böhmenkirch,55 - 60 Jahre,282,138,144
False,8117010,Böhmenkirch,60 - 65 Jahre,351,175,176
False,8117010,Böhmenkirch,65 - 75 Jahre,418,209,209
False,8117010,Böhmenkirch,75 und mehr Jahre,308,102,206
False,8117010,Böhmenkirch,Insgesamt,5620,2841,2779
False,8117011,Börtlingen,unter 3 Jahre,52,26,26
False,8117011,Börtlingen,3 -  6 Jahre,49,27,22
False,8117011,Börtlingen,6 - 10 Jahre,90,46,44
False,8117011,Börtlingen,10 - 15 Jahre,100,56,44
False,8117011,Börtlingen,15 - 18 Jahre,61,33,28
False,8117011,Börtlingen,18 - 20 Jahre,42,23,19
False,8117011,Börtlingen,20 - 25 Jahre,93,45,48
False,8117011,Börtlingen,25 - 30 Jahre,91,51,40
False,8117011,Börtlingen,30 - 35 Jahre,138,71,67
False,8117011,Börtlingen,35 - 40 Jahre,122,71,51
False,8117011,Börtlingen,40 - 45 Jahre,142,65,77
False,8117011,Börtlingen,45 - 50 Jahre,147,80,67
False,8117011,Börtlingen,50 - 55 Jahre,120,61,59
False,8117011,Börtlingen,55 - 60 Jahre,105,53,52
False,8117011,Börtlingen,60 - 65 Jahre,135,65,70
False,8117011,Börtlingen,65 - 75 Jahre,151,72,79
False,8117011,Börtlingen,75 und mehr Jahre,129,42,87
False,8117011,Börtlingen,Insgesamt,1767,887,880
False,8117012,Bad Boll,unter 3 Jahre,137,72,65
False,8117012,Bad Boll,3 -  6 Jahre,164,83,81
False,8117012,Bad Boll,6 - 10 Jahre,250,140,110
False,8117012,Bad Boll,10 - 15 Jahre,350,185,165
False,8117012,Bad Boll,15 - 18 Jahre,175,102,73
False,8117012,Bad Boll,18 - 20 Jahre,101,55,46
False,8117012,Bad Boll,20 - 25 Jahre,219,118,101
False,8117012,Bad Boll,25 - 30 Jahre,327,167,160
False,8117012,Bad Boll,30 - 35 Jahre,426,190,236
False,8117012,Bad Boll,35 - 40 Jahre,430,200,230
False,8117012,Bad Boll,40 - 45 Jahre,396,188,208
False,8117012,Bad Boll,45 - 50 Jahre,331,165,166
False,8117012,Bad Boll,50 - 55 Jahre,324,158,166
False,8117012,Bad Boll,55 - 60 Jahre,277,122,155
False,8117012,Bad Boll,60 - 65 Jahre,345,153,192
False,8117012,Bad Boll,65 - 75 Jahre,458,222,236
False,8117012,Bad Boll,75 und mehr Jahre,439,117,322
False,8117012,Bad Boll,Insgesamt,5149,2437,2712
False,8117014,Deggingen,unter 3 Jahre,174,91,83
False,8117014,Deggingen,3 -  6 Jahre,153,77,76
False,8117014,Deggingen,6 - 10 Jahre,231,126,105
False,8117014,Deggingen,10 - 15 Jahre,358,174,184
False,8117014,Deggingen,15 - 18 Jahre,229,119,110
False,8117014,Deggingen,18 - 20 Jahre,123,60,63
False,8117014,Deggingen,20 - 25 Jahre,270,137,133
False,8117014,Deggingen,25 - 30 Jahre,304,153,151
False,8117014,Deggingen,30 - 35 Jahre,465,236,229
False,8117014,Deggingen,35 - 40 Jahre,496,263,233
False,8117014,Deggingen,40 - 45 Jahre,391,205,186
False,8117014,Deggingen,45 - 50 Jahre,388,185,203
False,8117014,Deggingen,50 - 55 Jahre,337,174,163
False,8117014,Deggingen,55 - 60 Jahre,342,161,181
False,8117014,Deggingen,60 - 65 Jahre,413,205,208
False,8117014,Deggingen,65 - 75 Jahre,550,265,285
False,8117014,Deggingen,75 und mehr Jahre,444,122,322
False,8117014,Deggingen,Insgesamt,5668,2753,2915
False,8117015,"Donzdorf, Stadt",unter 3 Jahre,353,183,170
False,8117015,"Donzdorf, Stadt",3 -  6 Jahre,372,194,178
False,8117015,"Donzdorf, Stadt",6 - 10 Jahre,529,276,253
False,8117015,"Donzdorf, Stadt",10 - 15 Jahre,677,349,328
False,8117015,"Donzdorf, Stadt",15 - 18 Jahre,409,212,197
False,8117015,"Donzdorf, Stadt",18 - 20 Jahre,276,134,142
False,8117015,"Donzdorf, Stadt",20 - 25 Jahre,621,333,288
False,8117015,"Donzdorf, Stadt",25 - 30 Jahre,661,339,322
False,8117015,"Donzdorf, Stadt",30 - 35 Jahre,865,436,429
False,8117015,"Donzdorf, Stadt",35 - 40 Jahre,906,480,426
False,8117015,"Donzdorf, Stadt",40 - 45 Jahre,807,418,389
False,8117015,"Donzdorf, Stadt",45 - 50 Jahre,704,342,362
False,8117015,"Donzdorf, Stadt",50 - 55 Jahre,735,362,373
False,8117015,"Donzdorf, Stadt",55 - 60 Jahre,682,341,341
False,8117015,"Donzdorf, Stadt",60 - 65 Jahre,759,386,373
False,8117015,"Donzdorf, Stadt",65 - 75 Jahre,1015,482,533
False,8117015,"Donzdorf, Stadt",75 und mehr Jahre,714,233,481
False,8117015,"Donzdorf, Stadt",Insgesamt,11085,5500,5585
False,8117016,Drackenstein,unter 3 Jahre,27,10,17
False,8117016,Drackenstein,3 -  6 Jahre,17,7,10
False,8117016,Drackenstein,6 - 10 Jahre,26,13,13
False,8117016,Drackenstein,10 - 15 Jahre,25,17,8
False,8117016,Drackenstein,15 - 18 Jahre,14,7,7
False,8117016,Drackenstein,18 - 20 Jahre,10,8,2
False,8117016,Drackenstein,20 - 25 Jahre,27,13,14
False,8117016,Drackenstein,25 - 30 Jahre,34,17,17
False,8117016,Drackenstein,30 - 35 Jahre,40,15,25
False,8117016,Drackenstein,35 - 40 Jahre,42,23,19
False,8117016,Drackenstein,40 - 45 Jahre,30,15,15
False,8117016,Drackenstein,45 - 50 Jahre,29,17,12
False,8117016,Drackenstein,50 - 55 Jahre,25,13,12
False,8117016,Drackenstein,55 - 60 Jahre,16,11,5
False,8117016,Drackenstein,60 - 65 Jahre,22,14,8
False,8117016,Drackenstein,65 - 75 Jahre,30,15,15
False,8117016,Drackenstein,75 und mehr Jahre,18,5,13
False,8117016,Drackenstein,Insgesamt,432,220,212
False,8117017,Dürnau,unter 3 Jahre,51,30,21
False,8117017,Dürnau,3 -  6 Jahre,111,51,60
False,8117017,Dürnau,6 - 10 Jahre,131,66,65
False,8117017,Dürnau,10 - 15 Jahre,136,70,66
False,8117017,Dürnau,15 - 18 Jahre,65,31,34
False,8117017,Dürnau,18 - 20 Jahre,40,21,19
False,8117017,Dürnau,20 - 25 Jahre,92,47,45
False,8117017,Dürnau,25 - 30 Jahre,99,45,54
False,8117017,Dürnau,30 - 35 Jahre,188,96,92
False,8117017,Dürnau,35 - 40 Jahre,206,111,95
False,8117017,Dürnau,40 - 45 Jahre,152,80,72
False,8117017,Dürnau,45 - 50 Jahre,135,70,65
False,8117017,Dürnau,50 - 55 Jahre,133,71,62
False,8117017,Dürnau,55 - 60 Jahre,92,44,48
False,8117017,Dürnau,60 - 65 Jahre,138,69,69
False,8117017,Dürnau,65 - 75 Jahre,156,75,81
False,8117017,Dürnau,75 und mehr Jahre,108,39,69
False,8117017,Dürnau,Insgesamt,2033,1016,1017
False,8117018,"Ebersbach an der Fils, Stadt",unter 3 Jahre,450,242,208
False,8117018,"Ebersbach an der Fils, Stadt",3 -  6 Jahre,540,280,260
False,8117018,"Ebersbach an der Fils, Stadt",6 - 10 Jahre,763,389,374
False,8117018,"Ebersbach an der Fils, Stadt",10 - 15 Jahre,965,477,488
False,8117018,"Ebersbach an der Fils, Stadt",15 - 18 Jahre,555,296,259
False,8117018,"Ebersbach an der Fils, Stadt",18 - 20 Jahre,375,191,184
False,8117018,"Ebersbach an der Fils, Stadt",20 - 25 Jahre,833,397,436
False,8117018,"Ebersbach an der Fils, Stadt",25 - 30 Jahre,999,483,516
False,8117018,"Ebersbach an der Fils, Stadt",30 - 35 Jahre,1228,621,607
False,8117018,"Ebersbach an der Fils, Stadt",35 - 40 Jahre,1410,739,671
False,8117018,"Ebersbach an der Fils, Stadt",40 - 45 Jahre,1220,627,593
False,8117018,"Ebersbach an der Fils, Stadt",45 - 50 Jahre,1041,513,528
False,8117018,"Ebersbach an der Fils, Stadt",50 - 55 Jahre,933,494,439
False,8117018,"Ebersbach an der Fils, Stadt",55 - 60 Jahre,1009,495,514
False,8117018,"Ebersbach an der Fils, Stadt",60 - 65 Jahre,1125,575,550
False,8117018,"Ebersbach an der Fils, Stadt",65 - 75 Jahre,1490,735,755
False,8117018,"Ebersbach an der Fils, Stadt",75 und mehr Jahre,980,326,654
False,8117018,"Ebersbach an der Fils, Stadt",Insgesamt,15916,7880,8036
False,8117019,"Eislingen/Fils, Stadt",unter 3 Jahre,612,295,317
False,8117019,"Eislingen/Fils, Stadt",3 -  6 Jahre,625,316,309
False,8117019,"Eislingen/Fils, Stadt",6 - 10 Jahre,885,433,452
False,8117019,"Eislingen/Fils, Stadt",10 - 15 Jahre,1114,582,532
False,8117019,"Eislingen/Fils, Stadt",15 - 18 Jahre,683,375,308
False,8117019,"Eislingen/Fils, Stadt",18 - 20 Jahre,463,230,233
False,8117019,"Eislingen/Fils, Stadt",20 - 25 Jahre,1169,583,586
False,8117019,"Eislingen/Fils, Stadt",25 - 30 Jahre,1272,647,625
False,8117019,"Eislingen/Fils, Stadt",30 - 35 Jahre,1638,841,797
False,8117019,"Eislingen/Fils, Stadt",35 - 40 Jahre,1595,851,744
False,8117019,"Eislingen/Fils, Stadt",40 - 45 Jahre,1500,760,740
False,8117019,"Eislingen/Fils, Stadt",45 - 50 Jahre,1338,662,676
False,8117019,"Eislingen/Fils, Stadt",50 - 55 Jahre,1242,623,619
False,8117019,"Eislingen/Fils, Stadt",55 - 60 Jahre,1142,582,560
False,8117019,"Eislingen/Fils, Stadt",60 - 65 Jahre,1309,684,625
False,8117019,"Eislingen/Fils, Stadt",65 - 75 Jahre,1781,825,956
False,8117019,"Eislingen/Fils, Stadt",75 und mehr Jahre,1518,465,1053
False,8117019,"Eislingen/Fils, Stadt",Insgesamt,19886,9754,10132
False,8117020,Eschenbach,unter 3 Jahre,77,39,38
False,8117020,Eschenbach,3 -  6 Jahre,74,39,35
False,8117020,Eschenbach,6 - 10 Jahre,87,50,37
False,8117020,Eschenbach,10 - 15 Jahre,125,66,59
False,8117020,Eschenbach,15 - 18 Jahre,77,43,34
False,8117020,Eschenbach,18 - 20 Jahre,53,28,25
False,8117020,Eschenbach,20 - 25 Jahre,126,74,52
False,8117020,Eschenbach,25 - 30 Jahre,163,79,84
False,8117020,Eschenbach,30 - 35 Jahre,190,95,95
False,8117020,Eschenbach,35 - 40 Jahre,184,99,85
False,8117020,Eschenbach,40 - 45 Jahre,185,94,91
False,8117020,Eschenbach,45 - 50 Jahre,191,89,102
False,8117020,Eschenbach,50 - 55 Jahre,141,77,64
False,8117020,Eschenbach,55 - 60 Jahre,117,62,55
False,8117020,Eschenbach,60 - 65 Jahre,132,65,67
False,8117020,Eschenbach,65 - 75 Jahre,182,76,106
False,8117020,Eschenbach,75 und mehr Jahre,133,53,80
False,8117020,Eschenbach,Insgesamt,2237,1128,1109
False,8117023,Gammelshausen,unter 3 Jahre,46,26,20
False,8117023,Gammelshausen,3 -  6 Jahre,42,25,17
False,8117023,Gammelshausen,6 - 10 Jahre,68,37,31
False,8117023,Gammelshausen,10 - 15 Jahre,93,57,36
False,8117023,Gammelshausen,15 - 18 Jahre,46,25,21
False,8117023,Gammelshausen,18 - 20 Jahre,33,14,19
False,8117023,Gammelshausen,20 - 25 Jahre,86,41,45
False,8117023,Gammelshausen,25 - 30 Jahre,88,46,42
False,8117023,Gammelshausen,30 - 35 Jahre,118,69,49
False,8117023,Gammelshausen,35 - 40 Jahre,118,56,62
False,8117023,Gammelshausen,40 - 45 Jahre,113,65,48
False,8117023,Gammelshausen,45 - 50 Jahre,99,40,59
False,8117023,Gammelshausen,50 - 55 Jahre,111,59,52
False,8117023,Gammelshausen,55 - 60 Jahre,81,38,43
False,8117023,Gammelshausen,60 - 65 Jahre,118,56,62
False,8117023,Gammelshausen,65 - 75 Jahre,143,76,67
False,8117023,Gammelshausen,75 und mehr Jahre,66,27,39
False,8117023,Gammelshausen,Insgesamt,1469,757,712
False,8117024,"Geislingen an der Steige, Stadt",unter 3 Jahre,903,484,419
False,8117024,"Geislingen an der Steige, Stadt",3 -  6 Jahre,885,455,430
False,8117024,"Geislingen an der Steige, Stadt",6 - 10 Jahre,1316,670,646
False,8117024,"Geislingen an der Steige, Stadt",10 - 15 Jahre,1704,864,840
False,8117024,"Geislingen an der Steige, Stadt",15 - 18 Jahre,951,474,477
False,8117024,"Geislingen an der Steige, Stadt",18 - 20 Jahre,661,349,312
False,8117024,"Geislingen an der Steige, Stadt",20 - 25 Jahre,1662,834,828
False,8117024,"Geislingen an der Steige, Stadt",25 - 30 Jahre,1653,834,819
False,8117024,"Geislingen an der Steige, Stadt",30 - 35 Jahre,2112,1099,1013
False,8117024,"Geislingen an der Steige, Stadt",35 - 40 Jahre,2252,1174,1078
False,8117024,"Geislingen an der Steige, Stadt",40 - 45 Jahre,2041,1062,979
False,8117024,"Geislingen an der Steige, Stadt",45 - 50 Jahre,1704,851,853
False,8117024,"Geislingen an der Steige, Stadt",50 - 55 Jahre,1584,812,772
False,8117024,"Geislingen an der Steige, Stadt",55 - 60 Jahre,1540,769,771
False,8117024,"Geislingen an der Steige, Stadt",60 - 65 Jahre,1817,870,947
False,8117024,"Geislingen an der Steige, Stadt",65 - 75 Jahre,2823,1289,1534
False,8117024,"Geislingen an der Steige, Stadt",75 und mehr Jahre,2339,708,1631
False,8117024,"Geislingen an der Steige, Stadt",Insgesamt,27947,13598,14349
False,8117025,Gingen an der Fils,unter 3 Jahre,149,73,76
False,8117025,Gingen an der Fils,3 -  6 Jahre,156,75,81
False,8117025,Gingen an der Fils,6 - 10 Jahre,192,93,99
False,8117025,Gingen an der Fils,10 - 15 Jahre,268,140,128
False,8117025,Gingen an der Fils,15 - 18 Jahre,129,63,66
False,8117025,Gingen an der Fils,18 - 20 Jahre,76,38,38
False,8117025,Gingen an der Fils,20 - 25 Jahre,230,109,121
False,8117025,Gingen an der Fils,25 - 30 Jahre,268,139,129
False,8117025,Gingen an der Fils,30 - 35 Jahre,358,176,182
False,8117025,Gingen an der Fils,35 - 40 Jahre,368,200,168
False,8117025,Gingen an der Fils,40 - 45 Jahre,306,166,140
False,8117025,Gingen an der Fils,45 - 50 Jahre,271,133,138
False,8117025,Gingen an der Fils,50 - 55 Jahre,237,105,132
False,8117025,Gingen an der Fils,55 - 60 Jahre,262,134,128
False,8117025,Gingen an der Fils,60 - 65 Jahre,326,167,159
False,8117025,Gingen an der Fils,65 - 75 Jahre,433,203,230
False,8117025,Gingen an der Fils,75 und mehr Jahre,303,93,210
False,8117025,Gingen an der Fils,Insgesamt,4332,2107,2225
False,8117026,"Göppingen, Stadt",unter 3 Jahre,1683,836,847
False,8117026,"Göppingen, Stadt",3 -  6 Jahre,1722,895,827
False,8117026,"Göppingen, Stadt",6 - 10 Jahre,2465,1296,1169
False,8117026,"Göppingen, Stadt",10 - 15 Jahre,3248,1624,1624
False,8117026,"Göppingen, Stadt",15 - 18 Jahre,1894,937,957
False,8117026,"Göppingen, Stadt",18 - 20 Jahre,1382,735,647
False,8117026,"Göppingen, Stadt",20 - 25 Jahre,3242,1644,1598
False,8117026,"Göppingen, Stadt",25 - 30 Jahre,3489,1813,1676
False,8117026,"Göppingen, Stadt",30 - 35 Jahre,4578,2370,2208
False,8117026,"Göppingen, Stadt",35 - 40 Jahre,4570,2351,2219
False,8117026,"Göppingen, Stadt",40 - 45 Jahre,4092,2044,2048
False,8117026,"Göppingen, Stadt",45 - 50 Jahre,3779,1901,1878
False,8117026,"Göppingen, Stadt",50 - 55 Jahre,3418,1680,1738
False,8117026,"Göppingen, Stadt",55 - 60 Jahre,3473,1767,1706
False,8117026,"Göppingen, Stadt",60 - 65 Jahre,3899,1863,2036
False,8117026,"Göppingen, Stadt",65 - 75 Jahre,5515,2480,3035
False,8117026,"Göppingen, Stadt",75 und mehr Jahre,4990,1545,3445
False,8117026,"Göppingen, Stadt",Insgesamt,57439,27781,29658
False,8117028,Gruibingen,unter 3 Jahre,84,40,44
False,8117028,Gruibingen,3 -  6 Jahre,78,43,35
False,8117028,Gruibingen,6 - 10 Jahre,108,63,45
False,8117028,Gruibingen,10 - 15 Jahre,174,97,77
False,8117028,Gruibingen,15 - 18 Jahre,92,49,43
False,8117028,Gruibingen,18 - 20 Jahre,51,26,25
False,8117028,Gruibingen,20 - 25 Jahre,118,66,52
False,8117028,Gruibingen,25 - 30 Jahre,118,61,57
False,8117028,Gruibingen,30 - 35 Jahre,216,113,103
False,8117028,Gruibingen,35 - 40 Jahre,185,100,85
False,8117028,Gruibingen,40 - 45 Jahre,209,107,102
False,8117028,Gruibingen,45 - 50 Jahre,179,86,93
False,8117028,Gruibingen,50 - 55 Jahre,146,77,69
False,8117028,Gruibingen,55 - 60 Jahre,108,62,46
False,8117028,Gruibingen,60 - 65 Jahre,122,69,53
False,8117028,Gruibingen,65 - 75 Jahre,179,85,94
False,8117028,Gruibingen,75 und mehr Jahre,128,49,79
False,8117028,Gruibingen,Insgesamt,2295,1193,1102
False,8117029,Hattenhofen,unter 3 Jahre,88,44,44
False,8117029,Hattenhofen,3 -  6 Jahre,92,41,51
False,8117029,Hattenhofen,6 - 10 Jahre,162,74,88
False,8117029,Hattenhofen,10 - 15 Jahre,181,96,85
False,8117029,Hattenhofen,15 - 18 Jahre,109,57,52
False,8117029,Hattenhofen,18 - 20 Jahre,70,34,36
False,8117029,Hattenhofen,20 - 25 Jahre,186,107,79
False,8117029,Hattenhofen,25 - 30 Jahre,169,83,86
False,8117029,Hattenhofen,30 - 35 Jahre,219,110,109
False,8117029,Hattenhofen,35 - 40 Jahre,265,139,126
False,8117029,Hattenhofen,40 - 45 Jahre,245,114,131
False,8117029,Hattenhofen,45 - 50 Jahre,231,126,105
False,8117029,Hattenhofen,50 - 55 Jahre,219,106,113
False,8117029,Hattenhofen,55 - 60 Jahre,205,111,94
False,8117029,Hattenhofen,60 - 65 Jahre,176,90,86
False,8117029,Hattenhofen,65 - 75 Jahre,235,106,129
False,8117029,Hattenhofen,75 und mehr Jahre,180,74,106
False,8117029,Hattenhofen,Insgesamt,3032,1512,1520
False,8117030,Heiningen,unter 3 Jahre,163,77,86
False,8117030,Heiningen,3 -  6 Jahre,166,89,77
False,8117030,Heiningen,6 - 10 Jahre,237,120,117
False,8117030,Heiningen,10 - 15 Jahre,309,161,148
False,8117030,Heiningen,15 - 18 Jahre,183,100,83
False,8117030,Heiningen,18 - 20 Jahre,135,68,67
False,8117030,Heiningen,20 - 25 Jahre,281,132,149
False,8117030,Heiningen,25 - 30 Jahre,319,175,144
False,8117030,Heiningen,30 - 35 Jahre,408,222,186
False,8117030,Heiningen,35 - 40 Jahre,440,228,212
False,8117030,Heiningen,40 - 45 Jahre,465,236,229
False,8117030,Heiningen,45 - 50 Jahre,386,205,181
False,8117030,Heiningen,50 - 55 Jahre,371,192,179
False,8117030,Heiningen,55 - 60 Jahre,323,163,160
False,8117030,Heiningen,60 - 65 Jahre,421,204,217
False,8117030,Heiningen,65 - 75 Jahre,465,227,238
False,8117030,Heiningen,75 und mehr Jahre,336,104,232
False,8117030,Heiningen,Insgesamt,5408,2703,2705
False,8117031,Hohenstadt,unter 3 Jahre,31,15,16
False,8117031,Hohenstadt,3 -  6 Jahre,27,13,14
False,8117031,Hohenstadt,6 - 10 Jahre,41,19,22
False,8117031,Hohenstadt,10 - 15 Jahre,46,16,30
False,8117031,Hohenstadt,15 - 18 Jahre,26,13,13
False,8117031,Hohenstadt,18 - 20 Jahre,20,8,12
False,8117031,Hohenstadt,20 - 25 Jahre,42,22,20
False,8117031,Hohenstadt,25 - 30 Jahre,38,26,12
False,8117031,Hohenstadt,30 - 35 Jahre,50,27,23
False,8117031,Hohenstadt,35 - 40 Jahre,49,29,20
False,8117031,Hohenstadt,40 - 45 Jahre,61,26,35
False,8117031,Hohenstadt,45 - 50 Jahre,59,27,32
False,8117031,Hohenstadt,50 - 55 Jahre,49,30,19
False,8117031,Hohenstadt,55 - 60 Jahre,33,17,16
False,8117031,Hohenstadt,60 - 65 Jahre,40,16,24
False,8117031,Hohenstadt,65 - 75 Jahre,68,34,34
False,8117031,Hohenstadt,75 und mehr Jahre,27,8,19
False,8117031,Hohenstadt,Insgesamt,707,346,361
False,8117033,Kuchen,unter 3 Jahre,184,102,82
False,8117033,Kuchen,3 -  6 Jahre,195,102,93
False,8117033,Kuchen,6 - 10 Jahre,241,137,104
False,8117033,Kuchen,10 - 15 Jahre,329,175,154
False,8117033,Kuchen,15 - 18 Jahre,178,101,77
False,8117033,Kuchen,18 - 20 Jahre,126,70,56
False,8117033,Kuchen,20 - 25 Jahre,303,156,147
False,8117033,Kuchen,25 - 30 Jahre,344,187,157
False,8117033,Kuchen,30 - 35 Jahre,480,265,215
False,8117033,Kuchen,35 - 40 Jahre,435,213,222
False,8117033,Kuchen,40 - 45 Jahre,378,186,192
False,8117033,Kuchen,45 - 50 Jahre,368,188,180
False,8117033,Kuchen,50 - 55 Jahre,385,191,194
False,8117033,Kuchen,55 - 60 Jahre,371,184,187
False,8117033,Kuchen,60 - 65 Jahre,471,219,252
False,8117033,Kuchen,65 - 75 Jahre,533,270,263
False,8117033,Kuchen,75 und mehr Jahre,408,143,265
False,8117033,Kuchen,Insgesamt,5729,2889,2840
False,8117035,Mühlhausen im Täle,unter 3 Jahre,20,8,12
False,8117035,Mühlhausen im Täle,3 -  6 Jahre,34,17,17
False,8117035,Mühlhausen im Täle,6 - 10 Jahre,70,34,36
False,8117035,Mühlhausen im Täle,10 - 15 Jahre,73,36,37
False,8117035,Mühlhausen im Täle,15 - 18 Jahre,44,26,18
False,8117035,Mühlhausen im Täle,18 - 20 Jahre,30,18,12
False,8117035,Mühlhausen im Täle,20 - 25 Jahre,46,21,25
False,8117035,Mühlhausen im Täle,25 - 30 Jahre,47,24,23
False,8117035,Mühlhausen im Täle,30 - 35 Jahre,71,35,36
False,8117035,Mühlhausen im Täle,35 - 40 Jahre,96,49,47
False,8117035,Mühlhausen im Täle,40 - 45 Jahre,96,60,36
False,8117035,Mühlhausen im Täle,45 - 50 Jahre,80,35,45
False,8117035,Mühlhausen im Täle,50 - 55 Jahre,70,46,24
False,8117035,Mühlhausen im Täle,55 - 60 Jahre,45,21,24
False,8117035,Mühlhausen im Täle,60 - 65 Jahre,54,28,26
False,8117035,Mühlhausen im Täle,65 - 75 Jahre,86,40,46
False,8117035,Mühlhausen im Täle,75 und mehr Jahre,62,21,41
False,8117035,Mühlhausen im Täle,Insgesamt,1024,519,505
False,8117037,Ottenbach,unter 3 Jahre,76,41,35
False,8117037,Ottenbach,3 -  6 Jahre,87,49,38
False,8117037,Ottenbach,6 - 10 Jahre,125,64,61
False,8117037,Ottenbach,10 - 15 Jahre,137,67,70
False,8117037,Ottenbach,15 - 18 Jahre,84,38,46
False,8117037,Ottenbach,18 - 20 Jahre,60,30,30
False,8117037,Ottenbach,20 - 25 Jahre,155,78,77
False,8117037,Ottenbach,25 - 30 Jahre,148,76,72
False,8117037,Ottenbach,30 - 35 Jahre,214,102,112
False,8117037,Ottenbach,35 - 40 Jahre,210,105,105
False,8117037,Ottenbach,40 - 45 Jahre,187,104,83
False,8117037,Ottenbach,45 - 50 Jahre,176,88,88
False,8117037,Ottenbach,50 - 55 Jahre,130,63,67
False,8117037,Ottenbach,55 - 60 Jahre,130,71,59
False,8117037,Ottenbach,60 - 65 Jahre,162,79,83
False,8117037,Ottenbach,65 - 75 Jahre,193,84,109
False,8117037,Ottenbach,75 und mehr Jahre,151,48,103
False,8117037,Ottenbach,Insgesamt,2425,1187,1238
False,8117038,Rechberghausen,unter 3 Jahre,173,77,96
False,8117038,Rechberghausen,3 -  6 Jahre,166,90,76
False,8117038,Rechberghausen,6 - 10 Jahre,229,123,106
False,8117038,Rechberghausen,10 - 15 Jahre,303,152,151
False,8117038,Rechberghausen,15 - 18 Jahre,191,94,97
False,8117038,Rechberghausen,18 - 20 Jahre,111,48,63
False,8117038,Rechberghausen,20 - 25 Jahre,244,116,128
False,8117038,Rechberghausen,25 - 30 Jahre,362,162,200
False,8117038,Rechberghausen,30 - 35 Jahre,449,239,210
False,8117038,Rechberghausen,35 - 40 Jahre,422,211,211
False,8117038,Rechberghausen,40 - 45 Jahre,430,212,218
False,8117038,Rechberghausen,45 - 50 Jahre,328,156,172
False,8117038,Rechberghausen,50 - 55 Jahre,351,169,182
False,8117038,Rechberghausen,55 - 60 Jahre,361,168,193
False,8117038,Rechberghausen,60 - 65 Jahre,408,204,204
False,8117038,Rechberghausen,65 - 75 Jahre,578,274,304
False,8117038,Rechberghausen,75 und mehr Jahre,384,140,244
False,8117038,Rechberghausen,Insgesamt,5490,2635,2855
False,8117042,Salach,unter 3 Jahre,255,141,114
False,8117042,Salach,3 -  6 Jahre,272,140,132
False,8117042,Salach,6 - 10 Jahre,333,178,155
False,8117042,Salach,10 - 15 Jahre,472,255,217
False,8117042,Salach,15 - 18 Jahre,252,120,132
False,8117042,Salach,18 - 20 Jahre,173,96,77
False,8117042,Salach,20 - 25 Jahre,448,216,232
False,8117042,Salach,25 - 30 Jahre,483,232,251
False,8117042,Salach,30 - 35 Jahre,619,323,296
False,8117042,Salach,35 - 40 Jahre,647,346,301
False,8117042,Salach,40 - 45 Jahre,541,278,263
False,8117042,Salach,45 - 50 Jahre,521,262,259
False,8117042,Salach,50 - 55 Jahre,468,236,232
False,8117042,Salach,55 - 60 Jahre,450,231,219
False,8117042,Salach,60 - 65 Jahre,523,254,269
False,8117042,Salach,65 - 75 Jahre,649,284,365
False,8117042,Salach,75 und mehr Jahre,583,175,408
False,8117042,Salach,Insgesamt,7689,3767,3922
False,8117043,Schlat,unter 3 Jahre,64,35,29
False,8117043,Schlat,3 -  6 Jahre,63,32,31
False,8117043,Schlat,6 - 10 Jahre,83,47,36
False,8117043,Schlat,10 - 15 Jahre,100,51,49
False,8117043,Schlat,15 - 18 Jahre,55,34,21
False,8117043,Schlat,18 - 20 Jahre,38,19,19
False,8117043,Schlat,20 - 25 Jahre,86,40,46
False,8117043,Schlat,25 - 30 Jahre,100,58,42
False,8117043,Schlat,30 - 35 Jahre,156,91,65
False,8117043,Schlat,35 - 40 Jahre,152,84,68
False,8117043,Schlat,40 - 45 Jahre,159,84,75
False,8117043,Schlat,45 - 50 Jahre,149,96,53
False,8117043,Schlat,50 - 55 Jahre,94,40,54
False,8117043,Schlat,55 - 60 Jahre,128,72,56
False,8117043,Schlat,60 - 65 Jahre,119,67,52
False,8117043,Schlat,65 - 75 Jahre,164,64,100
False,8117043,Schlat,75 und mehr Jahre,119,43,76
False,8117043,Schlat,Insgesamt,1829,957,872
False,8117044,Schlierbach,unter 3 Jahre,128,71,57
False,8117044,Schlierbach,3 -  6 Jahre,166,89,77
False,8117044,Schlierbach,6 - 10 Jahre,217,109,108
False,8117044,Schlierbach,10 - 15 Jahre,225,100,125
False,8117044,Schlierbach,15 - 18 Jahre,129,74,55
False,8117044,Schlierbach,18 - 20 Jahre,84,43,41
False,8117044,Schlierbach,20 - 25 Jahre,180,93,87
False,8117044,Schlierbach,25 - 30 Jahre,229,122,107
False,8117044,Schlierbach,30 - 35 Jahre,292,143,149
False,8117044,Schlierbach,35 - 40 Jahre,379,192,187
False,8117044,Schlierbach,40 - 45 Jahre,268,148,120
False,8117044,Schlierbach,45 - 50 Jahre,236,125,111
False,8117044,Schlierbach,50 - 55 Jahre,249,115,134
False,8117044,Schlierbach,55 - 60 Jahre,230,128,102
False,8117044,Schlierbach,60 - 65 Jahre,266,134,132
False,8117044,Schlierbach,65 - 75 Jahre,340,168,172
False,8117044,Schlierbach,75 und mehr Jahre,219,81,138
False,8117044,Schlierbach,Insgesamt,3837,1935,1902
False,8117049,"Süßen, Stadt",unter 3 Jahre,319,154,165
False,8117049,"Süßen, Stadt",3 -  6 Jahre,335,166,169
False,8117049,"Süßen, Stadt",6 - 10 Jahre,492,261,231
False,8117049,"Süßen, Stadt",10 - 15 Jahre,623,315,308
False,8117049,"Süßen, Stadt",15 - 18 Jahre,351,187,164
False,8117049,"Süßen, Stadt",18 - 20 Jahre,254,127,127
False,8117049,"Süßen, Stadt",20 - 25 Jahre,590,307,283
False,8117049,"Süßen, Stadt",25 - 30 Jahre,639,311,328
False,8117049,"Süßen, Stadt",30 - 35 Jahre,809,422,387
False,8117049,"Süßen, Stadt",35 - 40 Jahre,860,452,408
False,8117049,"Süßen, Stadt",40 - 45 Jahre,845,456,389
False,8117049,"Süßen, Stadt",45 - 50 Jahre,702,350,352
False,8117049,"Süßen, Stadt",50 - 55 Jahre,604,309,295
False,8117049,"Süßen, Stadt",55 - 60 Jahre,548,290,258
False,8117049,"Süßen, Stadt",60 - 65 Jahre,686,330,356
False,8117049,"Süßen, Stadt",65 - 75 Jahre,887,422,465
False,8117049,"Süßen, Stadt",75 und mehr Jahre,732,211,521
False,8117049,"Süßen, Stadt",Insgesamt,10276,5070,5206
False,8117051,"Uhingen, Stadt",unter 3 Jahre,465,252,213
False,8117051,"Uhingen, Stadt",3 -  6 Jahre,523,302,221
False,8117051,"Uhingen, Stadt",6 - 10 Jahre,703,360,343
False,8117051,"Uhingen, Stadt",10 - 15 Jahre,868,438,430
False,8117051,"Uhingen, Stadt",15 - 18 Jahre,423,243,180
False,8117051,"Uhingen, Stadt",18 - 20 Jahre,317,154,163
False,8117051,"Uhingen, Stadt",20 - 25 Jahre,746,380,366
False,8117051,"Uhingen, Stadt",25 - 30 Jahre,794,395,399
False,8117051,"Uhingen, Stadt",30 - 35 Jahre,1030,529,501
False,8117051,"Uhingen, Stadt",35 - 40 Jahre,1138,579,559
False,8117051,"Uhingen, Stadt",40 - 45 Jahre,1067,548,519
False,8117051,"Uhingen, Stadt",45 - 50 Jahre,879,449,430
False,8117051,"Uhingen, Stadt",50 - 55 Jahre,771,380,391
False,8117051,"Uhingen, Stadt",55 - 60 Jahre,823,414,409
False,8117051,"Uhingen, Stadt",60 - 65 Jahre,974,479,495
False,8117051,"Uhingen, Stadt",65 - 75 Jahre,1367,666,701
False,8117051,"Uhingen, Stadt",75 und mehr Jahre,980,299,681
False,8117051,"Uhingen, Stadt",Insgesamt,13868,6867,7001
False,8117053,Wäschenbeuren,unter 3 Jahre,144,79,65
False,8117053,Wäschenbeuren,3 -  6 Jahre,153,85,68
False,8117053,Wäschenbeuren,6 - 10 Jahre,199,89,110
False,8117053,Wäschenbeuren,10 - 15 Jahre,275,146,129
False,8117053,Wäschenbeuren,15 - 18 Jahre,134,57,77
False,8117053,Wäschenbeuren,18 - 20 Jahre,87,54,33
False,8117053,Wäschenbeuren,20 - 25 Jahre,171,84,87
False,8117053,Wäschenbeuren,25 - 30 Jahre,237,108,129
False,8117053,Wäschenbeuren,30 - 35 Jahre,337,172,165
False,8117053,Wäschenbeuren,35 - 40 Jahre,387,199,188
False,8117053,Wäschenbeuren,40 - 45 Jahre,341,169,172
False,8117053,Wäschenbeuren,45 - 50 Jahre,208,107,101
False,8117053,Wäschenbeuren,50 - 55 Jahre,193,99,94
False,8117053,Wäschenbeuren,55 - 60 Jahre,220,110,110
False,8117053,Wäschenbeuren,60 - 65 Jahre,246,119,127
False,8117053,Wäschenbeuren,65 - 75 Jahre,293,158,135
False,8117053,Wäschenbeuren,75 und mehr Jahre,176,51,125
False,8117053,Wäschenbeuren,Insgesamt,3801,1886,1915
False,8117055,Wangen,unter 3 Jahre,85,45,40
False,8117055,Wangen,3 -  6 Jahre,109,51,58
False,8117055,Wangen,6 - 10 Jahre,153,77,76
False,8117055,Wangen,10 - 15 Jahre,182,89,93
False,8117055,Wangen,15 - 18 Jahre,100,47,53
False,8117055,Wangen,18 - 20 Jahre,74,38,36
False,8117055,Wangen,20 - 25 Jahre,157,90,67
False,8117055,Wangen,25 - 30 Jahre,184,87,97
False,8117055,Wangen,30 - 35 Jahre,268,143,125
False,8117055,Wangen,35 - 40 Jahre,279,148,131
False,8117055,Wangen,40 - 45 Jahre,238,108,130
False,8117055,Wangen,45 - 50 Jahre,223,110,113
False,8117055,Wangen,50 - 55 Jahre,195,104,91
False,8117055,Wangen,55 - 60 Jahre,205,103,102
False,8117055,Wangen,60 - 65 Jahre,253,124,129
False,8117055,Wangen,65 - 75 Jahre,298,143,155
False,8117055,Wangen,75 und mehr Jahre,218,71,147
False,8117055,Wangen,Insgesamt,3221,1578,1643
False,8117058,"Wiesensteig, Stadt",unter 3 Jahre,60,35,25
False,8117058,"Wiesensteig, Stadt",3 -  6 Jahre,79,36,43
False,8117058,"Wiesensteig, Stadt",6 - 10 Jahre,103,63,40
False,8117058,"Wiesensteig, Stadt",10 - 15 Jahre,142,80,62
False,8117058,"Wiesensteig, Stadt",15 - 18 Jahre,87,44,43
False,8117058,"Wiesensteig, Stadt",18 - 20 Jahre,86,49,37
False,8117058,"Wiesensteig, Stadt",20 - 25 Jahre,123,57,66
False,8117058,"Wiesensteig, Stadt",25 - 30 Jahre,128,66,62
False,8117058,"Wiesensteig, Stadt",30 - 35 Jahre,190,104,86
False,8117058,"Wiesensteig, Stadt",35 - 40 Jahre,200,112,88
False,8117058,"Wiesensteig, Stadt",40 - 45 Jahre,166,92,74
False,8117058,"Wiesensteig, Stadt",45 - 50 Jahre,134,78,56
False,8117058,"Wiesensteig, Stadt",50 - 55 Jahre,117,57,60
False,8117058,"Wiesensteig, Stadt",55 - 60 Jahre,114,58,56
False,8117058,"Wiesensteig, Stadt",60 - 65 Jahre,182,82,100
False,8117058,"Wiesensteig, Stadt",65 - 75 Jahre,258,124,134
False,8117058,"Wiesensteig, Stadt",75 und mehr Jahre,181,55,126
False,8117058,"Wiesensteig, Stadt",Insgesamt,2350,1192,1158
False,8117060,Zell unter Aichelberg,unter 3 Jahre,83,45,38
False,8117060,Zell unter Aichelberg,3 -  6 Jahre,98,56,42
False,8117060,Zell unter Aichelberg,6 - 10 Jahre,140,84,56
False,8117060,Zell unter Aichelberg,10 - 15 Jahre,162,94,68
False,8117060,Zell unter Aichelberg,15 - 18 Jahre,94,52,42
False,8117060,Zell unter Aichelberg,18 - 20 Jahre,82,43,39
False,8117060,Zell unter Aichelberg,20 - 25 Jahre,160,81,79
False,8117060,Zell unter Aichelberg,25 - 30 Jahre,138,73,65
False,8117060,Zell unter Aichelberg,30 - 35 Jahre,248,123,125
False,8117060,Zell unter Aichelberg,35 - 40 Jahre,241,119,122
False,8117060,Zell unter Aichelberg,40 - 45 Jahre,253,129,124
False,8117060,Zell unter Aichelberg,45 - 50 Jahre,209,106,103
False,8117060,Zell unter Aichelberg,50 - 55 Jahre,207,104,103
False,8117060,Zell unter Aichelberg,55 - 60 Jahre,188,94,94
False,8117060,Zell unter Aichelberg,60 - 65 Jahre,177,96,81
False,8117060,Zell unter Aichelberg,65 - 75 Jahre,209,87,122
False,8117060,Zell unter Aichelberg,75 und mehr Jahre,144,46,98
False,8117060,Zell unter Aichelberg,Insgesamt,2833,1432,1401
False,8117061,"Lauterstein, Stadt",unter 3 Jahre,90,43,47
False,8117061,"Lauterstein, Stadt",3 -  6 Jahre,106,57,49
False,8117061,"Lauterstein, Stadt",6 - 10 Jahre,151,69,82
False,8117061,"Lauterstein, Stadt",10 - 15 Jahre,170,100,70
False,8117061,"Lauterstein, Stadt",15 - 18 Jahre,100,50,50
False,8117061,"Lauterstein, Stadt",18 - 20 Jahre,66,33,33
False,8117061,"Lauterstein, Stadt",20 - 25 Jahre,145,68,77
False,8117061,"Lauterstein, Stadt",25 - 30 Jahre,172,90,82
False,8117061,"Lauterstein, Stadt",30 - 35 Jahre,227,110,117
False,8117061,"Lauterstein, Stadt",35 - 40 Jahre,259,137,122
False,8117061,"Lauterstein, Stadt",40 - 45 Jahre,218,111,107
False,8117061,"Lauterstein, Stadt",45 - 50 Jahre,188,97,91
False,8117061,"Lauterstein, Stadt",50 - 55 Jahre,161,85,76
False,8117061,"Lauterstein, Stadt",55 - 60 Jahre,134,80,54
False,8117061,"Lauterstein, Stadt",60 - 65 Jahre,208,98,110
False,8117061,"Lauterstein, Stadt",65 - 75 Jahre,239,109,130
False,8117061,"Lauterstein, Stadt",75 und mehr Jahre,217,68,149
False,8117061,"Lauterstein, Stadt",Insgesamt,2851,1405,1446
False,8118,Landkreis Ludwigsburg,unter 3 Jahre,16062,8355,7707
False,8118,Landkreis Ludwigsburg,3 -  6 Jahre,16843,8629,8214
False,8118,Landkreis Ludwigsburg,6 - 10 Jahre,22775,11617,11158
False,8118,Landkreis Ludwigsburg,10 - 15 Jahre,28456,14620,13836
False,8118,Landkreis Ludwigsburg,15 - 18 Jahre,15502,7907,7595
False,8118,Landkreis Ludwigsburg,18 - 20 Jahre,10664,5391,5273
False,8118,Landkreis Ludwigsburg,20 - 25 Jahre,26963,13641,13322
False,8118,Landkreis Ludwigsburg,25 - 30 Jahre,30918,15572,15346
False,8118,Landkreis Ludwigsburg,30 - 35 Jahre,42921,22100,20821
False,8118,Landkreis Ludwigsburg,35 - 40 Jahre,44364,23107,21257
False,8118,Landkreis Ludwigsburg,40 - 45 Jahre,38723,19866,18857
False,8118,Landkreis Ludwigsburg,45 - 50 Jahre,32833,16201,16632
False,8118,Landkreis Ludwigsburg,50 - 55 Jahre,30421,15191,15230
False,8118,Landkreis Ludwigsburg,55 - 60 Jahre,31573,15808,15765
False,8118,Landkreis Ludwigsburg,60 - 65 Jahre,34417,17159,17258
False,8118,Landkreis Ludwigsburg,65 - 75 Jahre,43587,20549,23038
False,8118,Landkreis Ludwigsburg,75 und mehr Jahre,30742,9753,20989
False,8118,Landkreis Ludwigsburg,Insgesamt,497764,245466,252298
False,8118001,Affalterbach,unter 3 Jahre,125,68,57
False,8118001,Affalterbach,3 -  6 Jahre,171,86,85
False,8118001,Affalterbach,6 - 10 Jahre,231,122,109
False,8118001,Affalterbach,10 - 15 Jahre,316,182,134
False,8118001,Affalterbach,15 - 18 Jahre,146,80,66
False,8118001,Affalterbach,18 - 20 Jahre,91,40,51
False,8118001,Affalterbach,20 - 25 Jahre,229,127,102
False,8118001,Affalterbach,25 - 30 Jahre,211,107,104
False,8118001,Affalterbach,30 - 35 Jahre,343,167,176
False,8118001,Affalterbach,35 - 40 Jahre,404,199,205
False,8118001,Affalterbach,40 - 45 Jahre,341,166,175
False,8118001,Affalterbach,45 - 50 Jahre,327,153,174
False,8118001,Affalterbach,50 - 55 Jahre,343,177,166
False,8118001,Affalterbach,55 - 60 Jahre,301,149,152
False,8118001,Affalterbach,60 - 65 Jahre,323,170,153
False,8118001,Affalterbach,65 - 75 Jahre,394,197,197
False,8118001,Affalterbach,75 und mehr Jahre,226,77,149
False,8118001,Affalterbach,Insgesamt,4522,2267,2255
False,8118003,"Asperg, Stadt",unter 3 Jahre,334,165,169
False,8118003,"Asperg, Stadt",3 -  6 Jahre,369,197,172
False,8118003,"Asperg, Stadt",6 - 10 Jahre,453,231,222
False,8118003,"Asperg, Stadt",10 - 15 Jahre,632,319,313
False,8118003,"Asperg, Stadt",15 - 18 Jahre,364,178,186
False,8118003,"Asperg, Stadt",18 - 20 Jahre,254,125,129
False,8118003,"Asperg, Stadt",20 - 25 Jahre,672,353,319
False,8118003,"Asperg, Stadt",25 - 30 Jahre,675,331,344
False,8118003,"Asperg, Stadt",30 - 35 Jahre,972,499,473
False,8118003,"Asperg, Stadt",35 - 40 Jahre,1021,513,508
False,8118003,"Asperg, Stadt",40 - 45 Jahre,940,484,456
False,8118003,"Asperg, Stadt",45 - 50 Jahre,804,422,382
False,8118003,"Asperg, Stadt",50 - 55 Jahre,734,382,352
False,8118003,"Asperg, Stadt",55 - 60 Jahre,851,417,434
False,8118003,"Asperg, Stadt",60 - 65 Jahre,829,397,432
False,8118003,"Asperg, Stadt",65 - 75 Jahre,1198,575,623
False,8118003,"Asperg, Stadt",75 und mehr Jahre,877,286,591
False,8118003,"Asperg, Stadt",Insgesamt,11979,5874,6105
False,8118006,Benningen am Neckar,unter 3 Jahre,184,101,83
False,8118006,Benningen am Neckar,3 -  6 Jahre,202,117,85
False,8118006,Benningen am Neckar,6 - 10 Jahre,270,138,132
False,8118006,Benningen am Neckar,10 - 15 Jahre,345,185,160
False,8118006,Benningen am Neckar,15 - 18 Jahre,192,88,104
False,8118006,Benningen am Neckar,18 - 20 Jahre,101,45,56
False,8118006,Benningen am Neckar,20 - 25 Jahre,290,144,146
False,8118006,Benningen am Neckar,25 - 30 Jahre,314,164,150
False,8118006,Benningen am Neckar,30 - 35 Jahre,418,210,208
False,8118006,Benningen am Neckar,35 - 40 Jahre,494,252,242
False,8118006,Benningen am Neckar,40 - 45 Jahre,431,206,225
False,8118006,Benningen am Neckar,45 - 50 Jahre,415,214,201
False,8118006,Benningen am Neckar,50 - 55 Jahre,375,182,193
False,8118006,Benningen am Neckar,55 - 60 Jahre,324,177,147
False,8118006,Benningen am Neckar,60 - 65 Jahre,363,169,194
False,8118006,Benningen am Neckar,65 - 75 Jahre,427,211,216
False,8118006,Benningen am Neckar,75 und mehr Jahre,267,91,176
False,8118006,Benningen am Neckar,Insgesamt,5412,2694,2718
False,8118007,"Besigheim, Stadt",unter 3 Jahre,391,209,182
False,8118007,"Besigheim, Stadt",3 -  6 Jahre,416,201,215
False,8118007,"Besigheim, Stadt",6 - 10 Jahre,521,272,249
False,8118007,"Besigheim, Stadt",10 - 15 Jahre,629,327,302
False,8118007,"Besigheim, Stadt",15 - 18 Jahre,387,182,205
False,8118007,"Besigheim, Stadt",18 - 20 Jahre,237,123,114
False,8118007,"Besigheim, Stadt",20 - 25 Jahre,535,257,278
False,8118007,"Besigheim, Stadt",25 - 30 Jahre,744,366,378
False,8118007,"Besigheim, Stadt",30 - 35 Jahre,972,491,481
False,8118007,"Besigheim, Stadt",35 - 40 Jahre,1004,492,512
False,8118007,"Besigheim, Stadt",40 - 45 Jahre,905,466,439
False,8118007,"Besigheim, Stadt",45 - 50 Jahre,715,355,360
False,8118007,"Besigheim, Stadt",50 - 55 Jahre,631,331,300
False,8118007,"Besigheim, Stadt",55 - 60 Jahre,634,331,303
False,8118007,"Besigheim, Stadt",60 - 65 Jahre,717,349,368
False,8118007,"Besigheim, Stadt",65 - 75 Jahre,956,432,524
False,8118007,"Besigheim, Stadt",75 und mehr Jahre,769,210,559
False,8118007,"Besigheim, Stadt",Insgesamt,11163,5394,5769
False,8118010,"Bönnigheim, Stadt",unter 3 Jahre,226,114,112
False,8118010,"Bönnigheim, Stadt",3 -  6 Jahre,266,142,124
False,8118010,"Bönnigheim, Stadt",6 - 10 Jahre,397,204,193
False,8118010,"Bönnigheim, Stadt",10 - 15 Jahre,511,258,253
False,8118010,"Bönnigheim, Stadt",15 - 18 Jahre,260,123,137
False,8118010,"Bönnigheim, Stadt",18 - 20 Jahre,148,68,80
False,8118010,"Bönnigheim, Stadt",20 - 25 Jahre,367,203,164
False,8118010,"Bönnigheim, Stadt",25 - 30 Jahre,516,289,227
False,8118010,"Bönnigheim, Stadt",30 - 35 Jahre,671,341,330
False,8118010,"Bönnigheim, Stadt",35 - 40 Jahre,696,360,336
False,8118010,"Bönnigheim, Stadt",40 - 45 Jahre,558,286,272
False,8118010,"Bönnigheim, Stadt",45 - 50 Jahre,410,215,195
False,8118010,"Bönnigheim, Stadt",50 - 55 Jahre,444,220,224
False,8118010,"Bönnigheim, Stadt",55 - 60 Jahre,360,182,178
False,8118010,"Bönnigheim, Stadt",60 - 65 Jahre,465,227,238
False,8118010,"Bönnigheim, Stadt",65 - 75 Jahre,615,288,327
False,8118010,"Bönnigheim, Stadt",75 und mehr Jahre,407,127,280
False,8118010,"Bönnigheim, Stadt",Insgesamt,7317,3647,3670
False,8118011,"Ditzingen, Stadt",unter 3 Jahre,753,383,370
False,8118011,"Ditzingen, Stadt",3 -  6 Jahre,868,453,415
False,8118011,"Ditzingen, Stadt",6 - 10 Jahre,1073,552,521
False,8118011,"Ditzingen, Stadt",10 - 15 Jahre,1307,649,658
False,8118011,"Ditzingen, Stadt",15 - 18 Jahre,725,371,354
False,8118011,"Ditzingen, Stadt",18 - 20 Jahre,459,247,212
False,8118011,"Ditzingen, Stadt",20 - 25 Jahre,1251,644,607
False,8118011,"Ditzingen, Stadt",25 - 30 Jahre,1414,713,701
False,8118011,"Ditzingen, Stadt",30 - 35 Jahre,2068,1052,1016
False,8118011,"Ditzingen, Stadt",35 - 40 Jahre,2122,1091,1031
False,8118011,"Ditzingen, Stadt",40 - 45 Jahre,1923,1001,922
False,8118011,"Ditzingen, Stadt",45 - 50 Jahre,1596,806,790
False,8118011,"Ditzingen, Stadt",50 - 55 Jahre,1557,773,784
False,8118011,"Ditzingen, Stadt",55 - 60 Jahre,1654,837,817
False,8118011,"Ditzingen, Stadt",60 - 65 Jahre,1673,859,814
False,8118011,"Ditzingen, Stadt",65 - 75 Jahre,2018,932,1086
False,8118011,"Ditzingen, Stadt",75 und mehr Jahre,1353,453,900
False,8118011,"Ditzingen, Stadt",Insgesamt,23814,11816,11998
False,8118012,Eberdingen,unter 3 Jahre,211,118,93
False,8118012,Eberdingen,3 -  6 Jahre,272,143,129
False,8118012,Eberdingen,6 - 10 Jahre,363,198,165
False,8118012,Eberdingen,10 - 15 Jahre,381,175,206
False,8118012,Eberdingen,15 - 18 Jahre,199,94,105
False,8118012,Eberdingen,18 - 20 Jahre,158,85,73
False,8118012,Eberdingen,20 - 25 Jahre,363,189,174
False,8118012,Eberdingen,25 - 30 Jahre,380,188,192
False,8118012,Eberdingen,30 - 35 Jahre,517,255,262
False,8118012,Eberdingen,35 - 40 Jahre,562,298,264
False,8118012,Eberdingen,40 - 45 Jahre,482,258,224
False,8118012,Eberdingen,45 - 50 Jahre,480,254,226
False,8118012,Eberdingen,50 - 55 Jahre,426,215,211
False,8118012,Eberdingen,55 - 60 Jahre,453,217,236
False,8118012,Eberdingen,60 - 65 Jahre,430,218,212
False,8118012,Eberdingen,65 - 75 Jahre,488,240,248
False,8118012,Eberdingen,75 und mehr Jahre,273,103,170
False,8118012,Eberdingen,Insgesamt,6438,3248,3190
False,8118014,Erdmannhausen,unter 3 Jahre,150,86,64
False,8118014,Erdmannhausen,3 -  6 Jahre,181,90,91
False,8118014,Erdmannhausen,6 - 10 Jahre,247,124,123
False,8118014,Erdmannhausen,10 - 15 Jahre,310,153,157
False,8118014,Erdmannhausen,15 - 18 Jahre,166,95,71
False,8118014,Erdmannhausen,18 - 20 Jahre,105,50,55
False,8118014,Erdmannhausen,20 - 25 Jahre,240,111,129
False,8118014,Erdmannhausen,25 - 30 Jahre,263,137,126
False,8118014,Erdmannhausen,30 - 35 Jahre,375,183,192
False,8118014,Erdmannhausen,35 - 40 Jahre,421,218,203
False,8118014,Erdmannhausen,40 - 45 Jahre,414,213,201
False,8118014,Erdmannhausen,45 - 50 Jahre,376,171,205
False,8118014,Erdmannhausen,50 - 55 Jahre,292,170,122
False,8118014,Erdmannhausen,55 - 60 Jahre,270,133,137
False,8118014,Erdmannhausen,60 - 65 Jahre,309,165,144
False,8118014,Erdmannhausen,65 - 75 Jahre,406,188,218
False,8118014,Erdmannhausen,75 und mehr Jahre,289,93,196
False,8118014,Erdmannhausen,Insgesamt,4814,2380,2434
False,8118015,Erligheim,unter 3 Jahre,90,50,40
False,8118015,Erligheim,3 -  6 Jahre,107,61,46
False,8118015,Erligheim,6 - 10 Jahre,141,78,63
False,8118015,Erligheim,10 - 15 Jahre,206,122,84
False,8118015,Erligheim,15 - 18 Jahre,90,51,39
False,8118015,Erligheim,18 - 20 Jahre,51,21,30
False,8118015,Erligheim,20 - 25 Jahre,151,75,76
False,8118015,Erligheim,25 - 30 Jahre,170,75,95
False,8118015,Erligheim,30 - 35 Jahre,236,131,105
False,8118015,Erligheim,35 - 40 Jahre,263,126,137
False,8118015,Erligheim,40 - 45 Jahre,237,129,108
False,8118015,Erligheim,45 - 50 Jahre,197,103,94
False,8118015,Erligheim,50 - 55 Jahre,129,63,66
False,8118015,Erligheim,55 - 60 Jahre,137,70,67
False,8118015,Erligheim,60 - 65 Jahre,153,71,82
False,8118015,Erligheim,65 - 75 Jahre,198,100,98
False,8118015,Erligheim,75 und mehr Jahre,101,30,71
False,8118015,Erligheim,Insgesamt,2657,1356,1301
False,8118016,Freudental,unter 3 Jahre,71,42,29
False,8118016,Freudental,3 -  6 Jahre,81,49,32
False,8118016,Freudental,6 - 10 Jahre,127,68,59
False,8118016,Freudental,10 - 15 Jahre,159,84,75
False,8118016,Freudental,15 - 18 Jahre,65,29,36
False,8118016,Freudental,18 - 20 Jahre,45,25,20
False,8118016,Freudental,20 - 25 Jahre,123,73,50
False,8118016,Freudental,25 - 30 Jahre,118,65,53
False,8118016,Freudental,30 - 35 Jahre,211,105,106
False,8118016,Freudental,35 - 40 Jahre,230,122,108
False,8118016,Freudental,40 - 45 Jahre,190,100,90
False,8118016,Freudental,45 - 50 Jahre,156,80,76
False,8118016,Freudental,50 - 55 Jahre,136,62,74
False,8118016,Freudental,55 - 60 Jahre,156,77,79
False,8118016,Freudental,60 - 65 Jahre,158,80,78
False,8118016,Freudental,65 - 75 Jahre,185,95,90
False,8118016,Freudental,75 und mehr Jahre,179,59,120
False,8118016,Freudental,Insgesamt,2390,1215,1175
False,8118018,Gemmrigheim,unter 3 Jahre,127,63,64
False,8118018,Gemmrigheim,3 -  6 Jahre,137,72,65
False,8118018,Gemmrigheim,6 - 10 Jahre,192,106,86
False,8118018,Gemmrigheim,10 - 15 Jahre,243,119,124
False,8118018,Gemmrigheim,15 - 18 Jahre,111,54,57
False,8118018,Gemmrigheim,18 - 20 Jahre,83,44,39
False,8118018,Gemmrigheim,20 - 25 Jahre,200,106,94
False,8118018,Gemmrigheim,25 - 30 Jahre,237,108,129
False,8118018,Gemmrigheim,30 - 35 Jahre,349,184,165
False,8118018,Gemmrigheim,35 - 40 Jahre,334,185,149
False,8118018,Gemmrigheim,40 - 45 Jahre,279,145,134
False,8118018,Gemmrigheim,45 - 50 Jahre,239,116,123
False,8118018,Gemmrigheim,50 - 55 Jahre,219,112,107
False,8118018,Gemmrigheim,55 - 60 Jahre,215,115,100
False,8118018,Gemmrigheim,60 - 65 Jahre,235,116,119
False,8118018,Gemmrigheim,65 - 75 Jahre,317,144,173
False,8118018,Gemmrigheim,75 und mehr Jahre,220,78,142
False,8118018,Gemmrigheim,Insgesamt,3737,1867,1870
False,8118019,"Gerlingen, Stadt",unter 3 Jahre,573,308,265
False,8118019,"Gerlingen, Stadt",3 -  6 Jahre,548,272,276
False,8118019,"Gerlingen, Stadt",6 - 10 Jahre,681,354,327
False,8118019,"Gerlingen, Stadt",10 - 15 Jahre,842,442,400
False,8118019,"Gerlingen, Stadt",15 - 18 Jahre,449,238,211
False,8118019,"Gerlingen, Stadt",18 - 20 Jahre,323,153,170
False,8118019,"Gerlingen, Stadt",20 - 25 Jahre,850,460,390
False,8118019,"Gerlingen, Stadt",25 - 30 Jahre,1099,544,555
False,8118019,"Gerlingen, Stadt",30 - 35 Jahre,1668,891,777
False,8118019,"Gerlingen, Stadt",35 - 40 Jahre,1693,883,810
False,8118019,"Gerlingen, Stadt",40 - 45 Jahre,1374,717,657
False,8118019,"Gerlingen, Stadt",45 - 50 Jahre,1109,544,565
False,8118019,"Gerlingen, Stadt",50 - 55 Jahre,1088,526,562
False,8118019,"Gerlingen, Stadt",55 - 60 Jahre,1309,639,670
False,8118019,"Gerlingen, Stadt",60 - 65 Jahre,1513,717,796
False,8118019,"Gerlingen, Stadt",65 - 75 Jahre,1925,936,989
False,8118019,"Gerlingen, Stadt",75 und mehr Jahre,1413,465,948
False,8118019,"Gerlingen, Stadt",Insgesamt,18457,9089,9368
False,8118021,"Großbottwar, Stadt",unter 3 Jahre,255,140,115
False,8118021,"Großbottwar, Stadt",3 -  6 Jahre,303,161,142
False,8118021,"Großbottwar, Stadt",6 - 10 Jahre,455,223,232
False,8118021,"Großbottwar, Stadt",10 - 15 Jahre,536,276,260
False,8118021,"Großbottwar, Stadt",15 - 18 Jahre,248,133,115
False,8118021,"Großbottwar, Stadt",18 - 20 Jahre,197,110,87
False,8118021,"Großbottwar, Stadt",20 - 25 Jahre,417,226,191
False,8118021,"Großbottwar, Stadt",25 - 30 Jahre,431,212,219
False,8118021,"Großbottwar, Stadt",30 - 35 Jahre,709,373,336
False,8118021,"Großbottwar, Stadt",35 - 40 Jahre,779,403,376
False,8118021,"Großbottwar, Stadt",40 - 45 Jahre,585,309,276
False,8118021,"Großbottwar, Stadt",45 - 50 Jahre,534,263,271
False,8118021,"Großbottwar, Stadt",50 - 55 Jahre,474,242,232
False,8118021,"Großbottwar, Stadt",55 - 60 Jahre,468,244,224
False,8118021,"Großbottwar, Stadt",60 - 65 Jahre,532,275,257
False,8118021,"Großbottwar, Stadt",65 - 75 Jahre,651,319,332
False,8118021,"Großbottwar, Stadt",75 und mehr Jahre,446,142,304
False,8118021,"Großbottwar, Stadt",Insgesamt,8020,4051,3969
False,8118027,Hemmingen,unter 3 Jahre,255,124,131
False,8118027,Hemmingen,3 -  6 Jahre,246,128,118
False,8118027,Hemmingen,6 - 10 Jahre,377,189,188
False,8118027,Hemmingen,10 - 15 Jahre,409,219,190
False,8118027,Hemmingen,15 - 18 Jahre,227,124,103
False,8118027,Hemmingen,18 - 20 Jahre,177,90,87
False,8118027,Hemmingen,20 - 25 Jahre,415,213,202
False,8118027,Hemmingen,25 - 30 Jahre,476,234,242
False,8118027,Hemmingen,30 - 35 Jahre,641,334,307
False,8118027,Hemmingen,35 - 40 Jahre,701,368,333
False,8118027,Hemmingen,40 - 45 Jahre,571,309,262
False,8118027,Hemmingen,45 - 50 Jahre,572,265,307
False,8118027,Hemmingen,50 - 55 Jahre,509,249,260
False,8118027,Hemmingen,55 - 60 Jahre,560,267,293
False,8118027,Hemmingen,60 - 65 Jahre,558,294,264
False,8118027,Hemmingen,65 - 75 Jahre,607,317,290
False,8118027,Hemmingen,75 und mehr Jahre,376,129,247
False,8118027,Hemmingen,Insgesamt,7677,3853,3824
False,8118028,Hessigheim,unter 3 Jahre,83,40,43
False,8118028,Hessigheim,3 -  6 Jahre,86,50,36
False,8118028,Hessigheim,6 - 10 Jahre,113,53,60
False,8118028,Hessigheim,10 - 15 Jahre,173,82,91
False,8118028,Hessigheim,15 - 18 Jahre,101,60,41
False,8118028,Hessigheim,18 - 20 Jahre,48,29,19
False,8118028,Hessigheim,20 - 25 Jahre,105,63,42
False,8118028,Hessigheim,25 - 30 Jahre,123,64,59
False,8118028,Hessigheim,30 - 35 Jahre,185,91,94
False,8118028,Hessigheim,35 - 40 Jahre,194,101,93
False,8118028,Hessigheim,40 - 45 Jahre,154,75,79
False,8118028,Hessigheim,45 - 50 Jahre,165,85,80
False,8118028,Hessigheim,50 - 55 Jahre,114,58,56
False,8118028,Hessigheim,55 - 60 Jahre,100,43,57
False,8118028,Hessigheim,60 - 65 Jahre,136,67,69
False,8118028,Hessigheim,65 - 75 Jahre,202,94,108
False,8118028,Hessigheim,75 und mehr Jahre,109,37,72
False,8118028,Hessigheim,Insgesamt,2191,1092,1099
False,8118040,Kirchheim am Neckar,unter 3 Jahre,185,92,93
False,8118040,Kirchheim am Neckar,3 -  6 Jahre,209,103,106
False,8118040,Kirchheim am Neckar,6 - 10 Jahre,278,144,134
False,8118040,Kirchheim am Neckar,10 - 15 Jahre,332,174,158
False,8118040,Kirchheim am Neckar,15 - 18 Jahre,166,79,87
False,8118040,Kirchheim am Neckar,18 - 20 Jahre,113,59,54
False,8118040,Kirchheim am Neckar,20 - 25 Jahre,286,141,145
False,8118040,Kirchheim am Neckar,25 - 30 Jahre,352,163,189
False,8118040,Kirchheim am Neckar,30 - 35 Jahre,425,210,215
False,8118040,Kirchheim am Neckar,35 - 40 Jahre,453,249,204
False,8118040,Kirchheim am Neckar,40 - 45 Jahre,388,193,195
False,8118040,Kirchheim am Neckar,45 - 50 Jahre,317,168,149
False,8118040,Kirchheim am Neckar,50 - 55 Jahre,282,149,133
False,8118040,Kirchheim am Neckar,55 - 60 Jahre,237,116,121
False,8118040,Kirchheim am Neckar,60 - 65 Jahre,289,136,153
False,8118040,Kirchheim am Neckar,65 - 75 Jahre,414,193,221
False,8118040,Kirchheim am Neckar,75 und mehr Jahre,285,86,199
False,8118040,Kirchheim am Neckar,Insgesamt,5011,2455,2556
False,8118046,"Kornwestheim, Stadt",unter 3 Jahre,940,455,485
False,8118046,"Kornwestheim, Stadt",3 -  6 Jahre,968,512,456
False,8118046,"Kornwestheim, Stadt",6 - 10 Jahre,1261,667,594
False,8118046,"Kornwestheim, Stadt",10 - 15 Jahre,1563,819,744
False,8118046,"Kornwestheim, Stadt",15 - 18 Jahre,922,480,442
False,8118046,"Kornwestheim, Stadt",18 - 20 Jahre,592,312,280
False,8118046,"Kornwestheim, Stadt",20 - 25 Jahre,1612,792,820
False,8118046,"Kornwestheim, Stadt",25 - 30 Jahre,1944,980,964
False,8118046,"Kornwestheim, Stadt",30 - 35 Jahre,2523,1353,1170
False,8118046,"Kornwestheim, Stadt",35 - 40 Jahre,2541,1349,1192
False,8118046,"Kornwestheim, Stadt",40 - 45 Jahre,2330,1187,1143
False,8118046,"Kornwestheim, Stadt",45 - 50 Jahre,1787,909,878
False,8118046,"Kornwestheim, Stadt",50 - 55 Jahre,1787,872,915
False,8118046,"Kornwestheim, Stadt",55 - 60 Jahre,1893,941,952
False,8118046,"Kornwestheim, Stadt",60 - 65 Jahre,2133,1075,1058
False,8118046,"Kornwestheim, Stadt",65 - 75 Jahre,2900,1337,1563
False,8118046,"Kornwestheim, Stadt",75 und mehr Jahre,2167,685,1482
False,8118046,"Kornwestheim, Stadt",Insgesamt,29863,14725,15138
False,8118047,Löchgau,unter 3 Jahre,161,75,86
False,8118047,Löchgau,3 -  6 Jahre,200,96,104
False,8118047,Löchgau,6 - 10 Jahre,272,139,133
False,8118047,Löchgau,10 - 15 Jahre,352,191,161
False,8118047,Löchgau,15 - 18 Jahre,179,85,94
False,8118047,Löchgau,18 - 20 Jahre,121,64,57
False,8118047,Löchgau,20 - 25 Jahre,229,109,120
False,8118047,Löchgau,25 - 30 Jahre,284,137,147
False,8118047,Löchgau,30 - 35 Jahre,419,221,198
False,8118047,Löchgau,35 - 40 Jahre,467,252,215
False,8118047,Löchgau,40 - 45 Jahre,468,221,247
False,8118047,Löchgau,45 - 50 Jahre,379,208,171
False,8118047,Löchgau,50 - 55 Jahre,308,150,158
False,8118047,Löchgau,55 - 60 Jahre,328,165,163
False,8118047,Löchgau,60 - 65 Jahre,353,186,167
False,8118047,Löchgau,65 - 75 Jahre,475,231,244
False,8118047,Löchgau,75 und mehr Jahre,267,83,184
False,8118047,Löchgau,Insgesamt,5262,2613,2649
False,8118048,"Ludwigsburg, Stadt",unter 3 Jahre,2823,1479,1344
False,8118048,"Ludwigsburg, Stadt",3 -  6 Jahre,2530,1282,1248
False,8118048,"Ludwigsburg, Stadt",6 - 10 Jahre,3453,1726,1727
False,8118048,"Ludwigsburg, Stadt",10 - 15 Jahre,4385,2246,2139
False,8118048,"Ludwigsburg, Stadt",15 - 18 Jahre,2531,1270,1261
False,8118048,"Ludwigsburg, Stadt",18 - 20 Jahre,1894,925,969
False,8118048,"Ludwigsburg, Stadt",20 - 25 Jahre,5194,2593,2601
False,8118048,"Ludwigsburg, Stadt",25 - 30 Jahre,6228,3162,3066
False,8118048,"Ludwigsburg, Stadt",30 - 35 Jahre,8000,4222,3778
False,8118048,"Ludwigsburg, Stadt",35 - 40 Jahre,7454,3928,3526
False,8118048,"Ludwigsburg, Stadt",40 - 45 Jahre,6265,3212,3053
False,8118048,"Ludwigsburg, Stadt",45 - 50 Jahre,5398,2594,2804
False,8118048,"Ludwigsburg, Stadt",50 - 55 Jahre,5235,2540,2695
False,8118048,"Ludwigsburg, Stadt",55 - 60 Jahre,5322,2629,2693
False,8118048,"Ludwigsburg, Stadt",60 - 65 Jahre,5975,2965,3010
False,8118048,"Ludwigsburg, Stadt",65 - 75 Jahre,7820,3522,4298
False,8118048,"Ludwigsburg, Stadt",75 und mehr Jahre,6390,1905,4485
False,8118048,"Ludwigsburg, Stadt",Insgesamt,86897,42200,44697
False,8118049,"Marbach am Neckar, Stadt",unter 3 Jahre,490,250,240
False,8118049,"Marbach am Neckar, Stadt",3 -  6 Jahre,523,278,245
False,8118049,"Marbach am Neckar, Stadt",6 - 10 Jahre,744,393,351
False,8118049,"Marbach am Neckar, Stadt",10 - 15 Jahre,863,468,395
False,8118049,"Marbach am Neckar, Stadt",15 - 18 Jahre,413,207,206
False,8118049,"Marbach am Neckar, Stadt",18 - 20 Jahre,314,145,169
False,8118049,"Marbach am Neckar, Stadt",20 - 25 Jahre,834,430,404
False,8118049,"Marbach am Neckar, Stadt",25 - 30 Jahre,915,472,443
False,8118049,"Marbach am Neckar, Stadt",30 - 35 Jahre,1286,644,642
False,8118049,"Marbach am Neckar, Stadt",35 - 40 Jahre,1401,725,676
False,8118049,"Marbach am Neckar, Stadt",40 - 45 Jahre,1142,604,538
False,8118049,"Marbach am Neckar, Stadt",45 - 50 Jahre,926,432,494
False,8118049,"Marbach am Neckar, Stadt",50 - 55 Jahre,786,402,384
False,8118049,"Marbach am Neckar, Stadt",55 - 60 Jahre,878,434,444
False,8118049,"Marbach am Neckar, Stadt",60 - 65 Jahre,978,470,508
False,8118049,"Marbach am Neckar, Stadt",65 - 75 Jahre,1285,578,707
False,8118049,"Marbach am Neckar, Stadt",75 und mehr Jahre,979,307,672
False,8118049,"Marbach am Neckar, Stadt",Insgesamt,14757,7239,7518
False,8118050,"Markgröningen, Stadt",unter 3 Jahre,448,241,207
False,8118050,"Markgröningen, Stadt",3 -  6 Jahre,494,279,215
False,8118050,"Markgröningen, Stadt",6 - 10 Jahre,706,353,353
False,8118050,"Markgröningen, Stadt",10 - 15 Jahre,912,468,444
False,8118050,"Markgröningen, Stadt",15 - 18 Jahre,508,266,242
False,8118050,"Markgröningen, Stadt",18 - 20 Jahre,279,141,138
False,8118050,"Markgröningen, Stadt",20 - 25 Jahre,807,405,402
False,8118050,"Markgröningen, Stadt",25 - 30 Jahre,971,478,493
False,8118050,"Markgröningen, Stadt",30 - 35 Jahre,1306,682,624
False,8118050,"Markgröningen, Stadt",35 - 40 Jahre,1305,682,623
False,8118050,"Markgröningen, Stadt",40 - 45 Jahre,1222,615,607
False,8118050,"Markgröningen, Stadt",45 - 50 Jahre,990,511,479
False,8118050,"Markgröningen, Stadt",50 - 55 Jahre,882,455,427
False,8118050,"Markgröningen, Stadt",55 - 60 Jahre,863,455,408
False,8118050,"Markgröningen, Stadt",60 - 65 Jahre,895,455,440
False,8118050,"Markgröningen, Stadt",65 - 75 Jahre,1085,490,595
False,8118050,"Markgröningen, Stadt",75 und mehr Jahre,727,252,475
False,8118050,"Markgröningen, Stadt",Insgesamt,14400,7228,7172
False,8118051,Möglingen,unter 3 Jahre,328,174,154
False,8118051,Möglingen,3 -  6 Jahre,345,181,164
False,8118051,Möglingen,6 - 10 Jahre,462,252,210
False,8118051,Möglingen,10 - 15 Jahre,617,318,299
False,8118051,Möglingen,15 - 18 Jahre,272,129,143
False,8118051,Möglingen,18 - 20 Jahre,193,99,94
False,8118051,Möglingen,20 - 25 Jahre,491,260,231
False,8118051,Möglingen,25 - 30 Jahre,705,341,364
False,8118051,Möglingen,30 - 35 Jahre,924,490,434
False,8118051,Möglingen,35 - 40 Jahre,936,504,432
False,8118051,Möglingen,40 - 45 Jahre,823,402,421
False,8118051,Möglingen,45 - 50 Jahre,606,309,297
False,8118051,Möglingen,50 - 55 Jahre,629,304,325
False,8118051,Möglingen,55 - 60 Jahre,731,364,367
False,8118051,Möglingen,60 - 65 Jahre,828,408,420
False,8118051,Möglingen,65 - 75 Jahre,938,461,477
False,8118051,Möglingen,75 und mehr Jahre,560,191,369
False,8118051,Möglingen,Insgesamt,10388,5187,5201
False,8118053,Mundelsheim,unter 3 Jahre,117,58,59
False,8118053,Mundelsheim,3 -  6 Jahre,123,71,52
False,8118053,Mundelsheim,6 - 10 Jahre,180,93,87
False,8118053,Mundelsheim,10 - 15 Jahre,213,98,115
False,8118053,Mundelsheim,15 - 18 Jahre,105,57,48
False,8118053,Mundelsheim,18 - 20 Jahre,79,44,35
False,8118053,Mundelsheim,20 - 25 Jahre,157,78,79
False,8118053,Mundelsheim,25 - 30 Jahre,163,81,82
False,8118053,Mundelsheim,30 - 35 Jahre,243,121,122
False,8118053,Mundelsheim,35 - 40 Jahre,284,144,140
False,8118053,Mundelsheim,40 - 45 Jahre,278,145,133
False,8118053,Mundelsheim,45 - 50 Jahre,203,102,101
False,8118053,Mundelsheim,50 - 55 Jahre,190,92,98
False,8118053,Mundelsheim,55 - 60 Jahre,175,98,77
False,8118053,Mundelsheim,60 - 65 Jahre,228,104,124
False,8118053,Mundelsheim,65 - 75 Jahre,275,141,134
False,8118053,Mundelsheim,75 und mehr Jahre,155,49,106
False,8118053,Mundelsheim,Insgesamt,3168,1576,1592
False,8118054,Murr,unter 3 Jahre,203,95,108
False,8118054,Murr,3 -  6 Jahre,221,104,117
False,8118054,Murr,6 - 10 Jahre,284,129,155
False,8118054,Murr,10 - 15 Jahre,312,171,141
False,8118054,Murr,15 - 18 Jahre,162,71,91
False,8118054,Murr,18 - 20 Jahre,115,59,56
False,8118054,Murr,20 - 25 Jahre,297,135,162
False,8118054,Murr,25 - 30 Jahre,386,201,185
False,8118054,Murr,30 - 35 Jahre,582,300,282
False,8118054,Murr,35 - 40 Jahre,558,292,266
False,8118054,Murr,40 - 45 Jahre,440,228,212
False,8118054,Murr,45 - 50 Jahre,393,198,195
False,8118054,Murr,50 - 55 Jahre,360,171,189
False,8118054,Murr,55 - 60 Jahre,363,189,174
False,8118054,Murr,60 - 65 Jahre,389,196,193
False,8118054,Murr,65 - 75 Jahre,436,211,225
False,8118054,Murr,75 und mehr Jahre,322,99,223
False,8118054,Murr,Insgesamt,5823,2849,2974
False,8118059,"Oberriexingen, Stadt",unter 3 Jahre,122,68,54
False,8118059,"Oberriexingen, Stadt",3 -  6 Jahre,112,57,55
False,8118059,"Oberriexingen, Stadt",6 - 10 Jahre,184,107,77
False,8118059,"Oberriexingen, Stadt",10 - 15 Jahre,176,84,92
False,8118059,"Oberriexingen, Stadt",15 - 18 Jahre,103,54,49
False,8118059,"Oberriexingen, Stadt",18 - 20 Jahre,62,34,28
False,8118059,"Oberriexingen, Stadt",20 - 25 Jahre,153,84,69
False,8118059,"Oberriexingen, Stadt",25 - 30 Jahre,159,92,67
False,8118059,"Oberriexingen, Stadt",30 - 35 Jahre,245,114,131
False,8118059,"Oberriexingen, Stadt",35 - 40 Jahre,279,143,136
False,8118059,"Oberriexingen, Stadt",40 - 45 Jahre,256,134,122
False,8118059,"Oberriexingen, Stadt",45 - 50 Jahre,196,101,95
False,8118059,"Oberriexingen, Stadt",50 - 55 Jahre,173,89,84
False,8118059,"Oberriexingen, Stadt",55 - 60 Jahre,194,91,103
False,8118059,"Oberriexingen, Stadt",60 - 65 Jahre,173,86,87
False,8118059,"Oberriexingen, Stadt",65 - 75 Jahre,222,107,115
False,8118059,"Oberriexingen, Stadt",75 und mehr Jahre,110,36,74
False,8118059,"Oberriexingen, Stadt",Insgesamt,2919,1481,1438
False,8118060,Oberstenfeld,unter 3 Jahre,235,127,108
False,8118060,Oberstenfeld,3 -  6 Jahre,259,126,133
False,8118060,Oberstenfeld,6 - 10 Jahre,424,236,188
False,8118060,Oberstenfeld,10 - 15 Jahre,544,299,245
False,8118060,Oberstenfeld,15 - 18 Jahre,315,181,134
False,8118060,Oberstenfeld,18 - 20 Jahre,192,108,84
False,8118060,Oberstenfeld,20 - 25 Jahre,444,221,223
False,8118060,Oberstenfeld,25 - 30 Jahre,399,199,200
False,8118060,Oberstenfeld,30 - 35 Jahre,593,288,305
False,8118060,Oberstenfeld,35 - 40 Jahre,685,338,347
False,8118060,Oberstenfeld,40 - 45 Jahre,625,319,306
False,8118060,Oberstenfeld,45 - 50 Jahre,471,236,235
False,8118060,Oberstenfeld,50 - 55 Jahre,526,248,278
False,8118060,Oberstenfeld,55 - 60 Jahre,557,275,282
False,8118060,Oberstenfeld,60 - 65 Jahre,595,319,276
False,8118060,Oberstenfeld,65 - 75 Jahre,630,305,325
False,8118060,Oberstenfeld,75 und mehr Jahre,439,134,305
False,8118060,Oberstenfeld,Insgesamt,7933,3959,3974
False,8118063,Pleidelsheim,unter 3 Jahre,236,114,122
False,8118063,Pleidelsheim,3 -  6 Jahre,283,157,126
False,8118063,Pleidelsheim,6 - 10 Jahre,331,182,149
False,8118063,Pleidelsheim,10 - 15 Jahre,366,170,196
False,8118063,Pleidelsheim,15 - 18 Jahre,174,93,81
False,8118063,Pleidelsheim,18 - 20 Jahre,114,42,72
False,8118063,Pleidelsheim,20 - 25 Jahre,342,163,179
False,8118063,Pleidelsheim,25 - 30 Jahre,364,173,191
False,8118063,Pleidelsheim,30 - 35 Jahre,592,289,303
False,8118063,Pleidelsheim,35 - 40 Jahre,658,342,316
False,8118063,Pleidelsheim,40 - 45 Jahre,483,251,232
False,8118063,Pleidelsheim,45 - 50 Jahre,433,196,237
False,8118063,Pleidelsheim,50 - 55 Jahre,326,183,143
False,8118063,Pleidelsheim,55 - 60 Jahre,338,164,174
False,8118063,Pleidelsheim,60 - 65 Jahre,356,175,181
False,8118063,Pleidelsheim,65 - 75 Jahre,406,188,218
False,8118063,Pleidelsheim,75 und mehr Jahre,346,105,241
False,8118063,Pleidelsheim,Insgesamt,6148,2987,3161
False,8118067,Schwieberdingen,unter 3 Jahre,266,140,126
False,8118067,Schwieberdingen,3 -  6 Jahre,307,159,148
False,8118067,Schwieberdingen,6 - 10 Jahre,394,202,192
False,8118067,Schwieberdingen,10 - 15 Jahre,476,224,252
False,8118067,Schwieberdingen,15 - 18 Jahre,250,126,124
False,8118067,Schwieberdingen,18 - 20 Jahre,212,101,111
False,8118067,Schwieberdingen,20 - 25 Jahre,500,246,254
False,8118067,Schwieberdingen,25 - 30 Jahre,625,365,260
False,8118067,Schwieberdingen,30 - 35 Jahre,839,453,386
False,8118067,Schwieberdingen,35 - 40 Jahre,775,426,349
False,8118067,Schwieberdingen,40 - 45 Jahre,735,391,344
False,8118067,Schwieberdingen,45 - 50 Jahre,655,307,348
False,8118067,Schwieberdingen,50 - 55 Jahre,648,330,318
False,8118067,Schwieberdingen,55 - 60 Jahre,743,391,352
False,8118067,Schwieberdingen,60 - 65 Jahre,736,367,369
False,8118067,Schwieberdingen,65 - 75 Jahre,874,432,442
False,8118067,Schwieberdingen,75 und mehr Jahre,498,175,323
False,8118067,Schwieberdingen,Insgesamt,9533,4835,4698
False,8118068,Sersheim,unter 3 Jahre,191,95,96
False,8118068,Sersheim,3 -  6 Jahre,201,94,107
False,8118068,Sersheim,6 - 10 Jahre,268,135,133
False,8118068,Sersheim,10 - 15 Jahre,322,175,147
False,8118068,Sersheim,15 - 18 Jahre,153,86,67
False,8118068,Sersheim,18 - 20 Jahre,133,69,64
False,8118068,Sersheim,20 - 25 Jahre,267,131,136
False,8118068,Sersheim,25 - 30 Jahre,289,146,143
False,8118068,Sersheim,30 - 35 Jahre,484,229,255
False,8118068,Sersheim,35 - 40 Jahre,471,249,222
False,8118068,Sersheim,40 - 45 Jahre,374,201,173
False,8118068,Sersheim,45 - 50 Jahre,316,164,152
False,8118068,Sersheim,50 - 55 Jahre,291,146,145
False,8118068,Sersheim,55 - 60 Jahre,266,128,138
False,8118068,Sersheim,60 - 65 Jahre,316,156,160
False,8118068,Sersheim,65 - 75 Jahre,398,197,201
False,8118068,Sersheim,75 und mehr Jahre,228,70,158
False,8118068,Sersheim,Insgesamt,4968,2471,2497
False,8118070,"Steinheim an der Murr, Stadt",unter 3 Jahre,360,194,166
False,8118070,"Steinheim an der Murr, Stadt",3 -  6 Jahre,412,209,203
False,8118070,"Steinheim an der Murr, Stadt",6 - 10 Jahre,615,288,327
False,8118070,"Steinheim an der Murr, Stadt",10 - 15 Jahre,824,419,405
False,8118070,"Steinheim an der Murr, Stadt",15 - 18 Jahre,413,215,198
False,8118070,"Steinheim an der Murr, Stadt",18 - 20 Jahre,247,127,120
False,8118070,"Steinheim an der Murr, Stadt",20 - 25 Jahre,539,276,263
False,8118070,"Steinheim an der Murr, Stadt",25 - 30 Jahre,497,252,245
False,8118070,"Steinheim an der Murr, Stadt",30 - 35 Jahre,859,424,435
False,8118070,"Steinheim an der Murr, Stadt",35 - 40 Jahre,1069,542,527
False,8118070,"Steinheim an der Murr, Stadt",40 - 45 Jahre,987,489,498
False,8118070,"Steinheim an der Murr, Stadt",45 - 50 Jahre,840,426,414
False,8118070,"Steinheim an der Murr, Stadt",50 - 55 Jahre,675,359,316
False,8118070,"Steinheim an der Murr, Stadt",55 - 60 Jahre,622,314,308
False,8118070,"Steinheim an der Murr, Stadt",60 - 65 Jahre,735,372,363
False,8118070,"Steinheim an der Murr, Stadt",65 - 75 Jahre,855,391,464
False,8118070,"Steinheim an der Murr, Stadt",75 und mehr Jahre,603,191,412
False,8118070,"Steinheim an der Murr, Stadt",Insgesamt,11152,5488,5664
False,8118071,Tamm,unter 3 Jahre,305,159,146
False,8118071,Tamm,3 -  6 Jahre,339,170,169
False,8118071,Tamm,6 - 10 Jahre,510,252,258
False,8118071,Tamm,10 - 15 Jahre,679,351,328
False,8118071,Tamm,15 - 18 Jahre,388,190,198
False,8118071,Tamm,18 - 20 Jahre,271,153,118
False,8118071,Tamm,20 - 25 Jahre,647,342,305
False,8118071,Tamm,25 - 30 Jahre,655,354,301
False,8118071,Tamm,30 - 35 Jahre,830,430,400
False,8118071,Tamm,35 - 40 Jahre,974,491,483
False,8118071,Tamm,40 - 45 Jahre,999,465,534
False,8118071,Tamm,45 - 50 Jahre,995,469,526
False,8118071,Tamm,50 - 55 Jahre,934,486,448
False,8118071,Tamm,55 - 60 Jahre,835,446,389
False,8118071,Tamm,60 - 65 Jahre,802,393,409
False,8118071,Tamm,65 - 75 Jahre,884,432,452
False,8118071,Tamm,75 und mehr Jahre,592,218,374
False,8118071,Tamm,Insgesamt,11639,5801,5838
False,8118073,"Vaihingen an der Enz, Stadt",unter 3 Jahre,988,551,437
False,8118073,"Vaihingen an der Enz, Stadt",3 -  6 Jahre,1025,470,555
False,8118073,"Vaihingen an der Enz, Stadt",6 - 10 Jahre,1420,677,743
False,8118073,"Vaihingen an der Enz, Stadt",10 - 15 Jahre,1714,929,785
False,8118073,"Vaihingen an der Enz, Stadt",15 - 18 Jahre,942,478,464
False,8118073,"Vaihingen an der Enz, Stadt",18 - 20 Jahre,663,364,299
False,8118073,"Vaihingen an der Enz, Stadt",20 - 25 Jahre,1631,852,779
False,8118073,"Vaihingen an der Enz, Stadt",25 - 30 Jahre,1635,820,815
False,8118073,"Vaihingen an der Enz, Stadt",30 - 35 Jahre,2299,1181,1118
False,8118073,"Vaihingen an der Enz, Stadt",35 - 40 Jahre,2486,1318,1168
False,8118073,"Vaihingen an der Enz, Stadt",40 - 45 Jahre,2182,1121,1061
False,8118073,"Vaihingen an der Enz, Stadt",45 - 50 Jahre,1777,914,863
False,8118073,"Vaihingen an der Enz, Stadt",50 - 55 Jahre,1637,832,805
False,8118073,"Vaihingen an der Enz, Stadt",55 - 60 Jahre,1683,853,830
False,8118073,"Vaihingen an der Enz, Stadt",60 - 65 Jahre,1790,913,877
False,8118073,"Vaihingen an der Enz, Stadt",65 - 75 Jahre,2352,1127,1225
False,8118073,"Vaihingen an der Enz, Stadt",75 und mehr Jahre,1580,471,1109
False,8118073,"Vaihingen an der Enz, Stadt",Insgesamt,27804,13871,13933
False,8118074,Walheim,unter 3 Jahre,100,45,55
False,8118074,Walheim,3 -  6 Jahre,104,59,45
False,8118074,Walheim,6 - 10 Jahre,141,78,63
False,8118074,Walheim,10 - 15 Jahre,171,82,89
False,8118074,Walheim,15 - 18 Jahre,94,50,44
False,8118074,Walheim,18 - 20 Jahre,58,31,27
False,8118074,Walheim,20 - 25 Jahre,147,70,77
False,8118074,Walheim,25 - 30 Jahre,165,90,75
False,8118074,Walheim,30 - 35 Jahre,216,106,110
False,8118074,Walheim,35 - 40 Jahre,249,133,116
False,8118074,Walheim,40 - 45 Jahre,211,114,97
False,8118074,Walheim,45 - 50 Jahre,200,97,103
False,8118074,Walheim,50 - 55 Jahre,160,87,73
False,8118074,Walheim,55 - 60 Jahre,178,93,85
False,8118074,Walheim,60 - 65 Jahre,194,86,108
False,8118074,Walheim,65 - 75 Jahre,295,148,147
False,8118074,Walheim,75 und mehr Jahre,181,56,125
False,8118074,Walheim,Insgesamt,2864,1425,1439
False,8118076,"Sachsenheim, Stadt",unter 3 Jahre,514,252,262
False,8118076,"Sachsenheim, Stadt",3 -  6 Jahre,592,288,304
False,8118076,"Sachsenheim, Stadt",6 - 10 Jahre,786,408,378
False,8118076,"Sachsenheim, Stadt",10 - 15 Jahre,1103,562,541
False,8118076,"Sachsenheim, Stadt",15 - 18 Jahre,604,298,306
False,8118076,"Sachsenheim, Stadt",18 - 20 Jahre,409,208,201
False,8118076,"Sachsenheim, Stadt",20 - 25 Jahre,873,446,427
False,8118076,"Sachsenheim, Stadt",25 - 30 Jahre,996,510,486
False,8118076,"Sachsenheim, Stadt",30 - 35 Jahre,1326,668,658
False,8118076,"Sachsenheim, Stadt",35 - 40 Jahre,1481,776,705
False,8118076,"Sachsenheim, Stadt",40 - 45 Jahre,1352,703,649
False,8118076,"Sachsenheim, Stadt",45 - 50 Jahre,1187,610,577
False,8118076,"Sachsenheim, Stadt",50 - 55 Jahre,1003,523,480
False,8118076,"Sachsenheim, Stadt",55 - 60 Jahre,1026,509,517
False,8118076,"Sachsenheim, Stadt",60 - 65 Jahre,1131,587,544
False,8118076,"Sachsenheim, Stadt",65 - 75 Jahre,1518,699,819
False,8118076,"Sachsenheim, Stadt",75 und mehr Jahre,1013,347,666
False,8118076,"Sachsenheim, Stadt",Insgesamt,16914,8394,8520
False,8118077,Ingersheim,unter 3 Jahre,235,125,110
False,8118077,Ingersheim,3 -  6 Jahre,224,95,129
False,8118077,Ingersheim,6 - 10 Jahre,252,123,129
False,8118077,Ingersheim,10 - 15 Jahre,329,156,173
False,8118077,Ingersheim,15 - 18 Jahre,178,90,88
False,8118077,Ingersheim,18 - 20 Jahre,132,59,73
False,8118077,Ingersheim,20 - 25 Jahre,364,180,184
False,8118077,Ingersheim,25 - 30 Jahre,388,193,195
False,8118077,Ingersheim,30 - 35 Jahre,605,308,297
False,8118077,Ingersheim,35 - 40 Jahre,509,280,229
False,8118077,Ingersheim,40 - 45 Jahre,421,211,210
False,8118077,Ingersheim,45 - 50 Jahre,391,191,200
False,8118077,Ingersheim,50 - 55 Jahre,371,177,194
False,8118077,Ingersheim,55 - 60 Jahre,379,197,182
False,8118077,Ingersheim,60 - 65 Jahre,317,162,155
False,8118077,Ingersheim,65 - 75 Jahre,487,232,255
False,8118077,Ingersheim,75 und mehr Jahre,317,102,215
False,8118077,Ingersheim,Insgesamt,5899,2881,3018
False,8118078,"Freiberg am Neckar, Stadt",unter 3 Jahre,466,231,235
False,8118078,"Freiberg am Neckar, Stadt",3 -  6 Jahre,514,262,252
False,8118078,"Freiberg am Neckar, Stadt",6 - 10 Jahre,669,315,354
False,8118078,"Freiberg am Neckar, Stadt",10 - 15 Jahre,842,444,398
False,8118078,"Freiberg am Neckar, Stadt",15 - 18 Jahre,438,221,217
False,8118078,"Freiberg am Neckar, Stadt",18 - 20 Jahre,310,152,158
False,8118078,"Freiberg am Neckar, Stadt",20 - 25 Jahre,731,359,372
False,8118078,"Freiberg am Neckar, Stadt",25 - 30 Jahre,859,407,452
False,8118078,"Freiberg am Neckar, Stadt",30 - 35 Jahre,1454,717,737
False,8118078,"Freiberg am Neckar, Stadt",35 - 40 Jahre,1462,725,737
False,8118078,"Freiberg am Neckar, Stadt",40 - 45 Jahre,1186,624,562
False,8118078,"Freiberg am Neckar, Stadt",45 - 50 Jahre,1033,501,532
False,8118078,"Freiberg am Neckar, Stadt",50 - 55 Jahre,990,481,509
False,8118078,"Freiberg am Neckar, Stadt",55 - 60 Jahre,971,492,479
False,8118078,"Freiberg am Neckar, Stadt",60 - 65 Jahre,1113,561,552
False,8118078,"Freiberg am Neckar, Stadt",65 - 75 Jahre,1398,665,733
False,8118078,"Freiberg am Neckar, Stadt",75 und mehr Jahre,828,272,556
False,8118078,"Freiberg am Neckar, Stadt",Insgesamt,15264,7429,7835
False,8118079,"Bietigheim-Bissingen, Stadt",unter 3 Jahre,1255,638,617
False,8118079,"Bietigheim-Bissingen, Stadt",3 -  6 Jahre,1315,684,631
False,8118079,"Bietigheim-Bissingen, Stadt",6 - 10 Jahre,1700,892,808
False,8118079,"Bietigheim-Bissingen, Stadt",10 - 15 Jahre,2250,1121,1129
False,8118079,"Bietigheim-Bissingen, Stadt",15 - 18 Jahre,1346,712,634
False,8118079,"Bietigheim-Bissingen, Stadt",18 - 20 Jahre,890,441,449
False,8118079,"Bietigheim-Bissingen, Stadt",20 - 25 Jahre,2285,1138,1147
False,8118079,"Bietigheim-Bissingen, Stadt",25 - 30 Jahre,2382,1176,1206
False,8118079,"Bietigheim-Bissingen, Stadt",30 - 35 Jahre,3224,1628,1596
False,8118079,"Bietigheim-Bissingen, Stadt",35 - 40 Jahre,3347,1737,1610
False,8118079,"Bietigheim-Bissingen, Stadt",40 - 45 Jahre,3243,1629,1614
False,8118079,"Bietigheim-Bissingen, Stadt",45 - 50 Jahre,2732,1324,1408
False,8118079,"Bietigheim-Bissingen, Stadt",50 - 55 Jahre,2392,1180,1212
False,8118079,"Bietigheim-Bissingen, Stadt",55 - 60 Jahre,2663,1304,1359
False,8118079,"Bietigheim-Bissingen, Stadt",60 - 65 Jahre,3025,1493,1532
False,8118079,"Bietigheim-Bissingen, Stadt",65 - 75 Jahre,3917,1865,2052
False,8118079,"Bietigheim-Bissingen, Stadt",75 und mehr Jahre,2665,842,1823
False,8118079,"Bietigheim-Bissingen, Stadt",Insgesamt,40631,19804,20827
False,8118080,"Korntal-Münchingen, Stadt",unter 3 Jahre,559,292,267
False,8118080,"Korntal-Münchingen, Stadt",3 -  6 Jahre,561,294,267
False,8118080,"Korntal-Münchingen, Stadt",6 - 10 Jahre,771,415,356
False,8118080,"Korntal-Münchingen, Stadt",10 - 15 Jahre,919,461,458
False,8118080,"Korntal-Münchingen, Stadt",15 - 18 Jahre,495,259,236
False,8118080,"Korntal-Münchingen, Stadt",18 - 20 Jahre,373,178,195
False,8118080,"Korntal-Münchingen, Stadt",20 - 25 Jahre,892,438,454
False,8118080,"Korntal-Münchingen, Stadt",25 - 30 Jahre,1114,555,559
False,8118080,"Korntal-Münchingen, Stadt",30 - 35 Jahre,1505,786,719
False,8118080,"Korntal-Münchingen, Stadt",35 - 40 Jahre,1606,867,739
False,8118080,"Korntal-Münchingen, Stadt",40 - 45 Jahre,1267,656,611
False,8118080,"Korntal-Münchingen, Stadt",45 - 50 Jahre,1113,532,581
False,8118080,"Korntal-Münchingen, Stadt",50 - 55 Jahre,1036,481,555
False,8118080,"Korntal-Münchingen, Stadt",55 - 60 Jahre,1181,592,589
False,8118080,"Korntal-Münchingen, Stadt",60 - 65 Jahre,1281,635,646
False,8118080,"Korntal-Münchingen, Stadt",65 - 75 Jahre,1522,718,804
False,8118080,"Korntal-Münchingen, Stadt",75 und mehr Jahre,1225,361,864
False,8118080,"Korntal-Münchingen, Stadt",Insgesamt,17420,8520,8900
False,8118081,"Remseck am Neckar, Stadt",unter 3 Jahre,707,394,313
False,8118081,"Remseck am Neckar, Stadt",3 -  6 Jahre,729,377,352
False,8118081,"Remseck am Neckar, Stadt",6 - 10 Jahre,1029,499,530
False,8118081,"Remseck am Neckar, Stadt",10 - 15 Jahre,1193,598,595
False,8118081,"Remseck am Neckar, Stadt",15 - 18 Jahre,621,310,311
False,8118081,"Remseck am Neckar, Stadt",18 - 20 Jahre,421,221,200
False,8118081,"Remseck am Neckar, Stadt",20 - 25 Jahre,1033,508,525
False,8118081,"Remseck am Neckar, Stadt",25 - 30 Jahre,1272,628,644
False,8118081,"Remseck am Neckar, Stadt",30 - 35 Jahre,1807,929,878
False,8118081,"Remseck am Neckar, Stadt",35 - 40 Jahre,1996,1004,992
False,8118081,"Remseck am Neckar, Stadt",40 - 45 Jahre,1662,887,775
False,8118081,"Remseck am Neckar, Stadt",45 - 50 Jahre,1400,656,744
False,8118081,"Remseck am Neckar, Stadt",50 - 55 Jahre,1329,692,637
False,8118081,"Remseck am Neckar, Stadt",55 - 60 Jahre,1355,670,685
False,8118081,"Remseck am Neckar, Stadt",60 - 65 Jahre,1391,685,706
False,8118081,"Remseck am Neckar, Stadt",65 - 75 Jahre,1614,811,803
False,8118081,"Remseck am Neckar, Stadt",75 und mehr Jahre,960,336,624
False,8118081,"Remseck am Neckar, Stadt",Insgesamt,20519,10205,10314
False,8119,Landkreis Rems-Murr-Kreis,unter 3 Jahre,13239,6633,6606
False,8119,Landkreis Rems-Murr-Kreis,3 -  6 Jahre,13980,7177,6803
False,8119,Landkreis Rems-Murr-Kreis,6 - 10 Jahre,19205,9778,9427
False,8119,Landkreis Rems-Murr-Kreis,10 - 15 Jahre,23481,12122,11359
False,8119,Landkreis Rems-Murr-Kreis,15 - 18 Jahre,12949,6736,6213
False,8119,Landkreis Rems-Murr-Kreis,18 - 20 Jahre,8896,4541,4355
False,8119,Landkreis Rems-Murr-Kreis,20 - 25 Jahre,21426,10792,10634
False,8119,Landkreis Rems-Murr-Kreis,25 - 30 Jahre,24590,12334,12256
False,8119,Landkreis Rems-Murr-Kreis,30 - 35 Jahre,34666,17690,16976
False,8119,Landkreis Rems-Murr-Kreis,35 - 40 Jahre,36801,19001,17800
False,8119,Landkreis Rems-Murr-Kreis,40 - 45 Jahre,31470,16165,15305
False,8119,Landkreis Rems-Murr-Kreis,45 - 50 Jahre,26883,13310,13573
False,8119,Landkreis Rems-Murr-Kreis,50 - 55 Jahre,24763,12339,12424
False,8119,Landkreis Rems-Murr-Kreis,55 - 60 Jahre,25085,12583,12502
False,8119,Landkreis Rems-Murr-Kreis,60 - 65 Jahre,28625,14221,14404
False,8119,Landkreis Rems-Murr-Kreis,65 - 75 Jahre,36938,17385,19553
False,8119,Landkreis Rems-Murr-Kreis,75 und mehr Jahre,26299,8308,17991
False,8119,Landkreis Rems-Murr-Kreis,Insgesamt,409296,201115,208181
False,8119001,Alfdorf,unter 3 Jahre,260,136,124
False,8119001,Alfdorf,3 -  6 Jahre,289,138,151
False,8119001,Alfdorf,6 - 10 Jahre,429,218,211
False,8119001,Alfdorf,10 - 15 Jahre,551,294,257
False,8119001,Alfdorf,15 - 18 Jahre,244,130,114
False,8119001,Alfdorf,18 - 20 Jahre,180,86,94
False,8119001,Alfdorf,20 - 25 Jahre,351,180,171
False,8119001,Alfdorf,25 - 30 Jahre,380,197,183
False,8119001,Alfdorf,30 - 35 Jahre,583,288,295
False,8119001,Alfdorf,35 - 40 Jahre,592,301,291
False,8119001,Alfdorf,40 - 45 Jahre,570,289,281
False,8119001,Alfdorf,45 - 50 Jahre,454,244,210
False,8119001,Alfdorf,50 - 55 Jahre,363,200,163
False,8119001,Alfdorf,55 - 60 Jahre,338,169,169
False,8119001,Alfdorf,60 - 65 Jahre,412,198,214
False,8119001,Alfdorf,65 - 75 Jahre,617,290,327
False,8119001,Alfdorf,75 und mehr Jahre,394,140,254
False,8119001,Alfdorf,Insgesamt,7007,3498,3509
False,8119003,Allmersbach im Tal,unter 3 Jahre,126,63,63
False,8119003,Allmersbach im Tal,3 -  6 Jahre,156,68,88
False,8119003,Allmersbach im Tal,6 - 10 Jahre,237,129,108
False,8119003,Allmersbach im Tal,10 - 15 Jahre,303,155,148
False,8119003,Allmersbach im Tal,15 - 18 Jahre,184,94,90
False,8119003,Allmersbach im Tal,18 - 20 Jahre,94,39,55
False,8119003,Allmersbach im Tal,20 - 25 Jahre,212,110,102
False,8119003,Allmersbach im Tal,25 - 30 Jahre,251,127,124
False,8119003,Allmersbach im Tal,30 - 35 Jahre,401,192,209
False,8119003,Allmersbach im Tal,35 - 40 Jahre,451,221,230
False,8119003,Allmersbach im Tal,40 - 45 Jahre,367,191,176
False,8119003,Allmersbach im Tal,45 - 50 Jahre,290,139,151
False,8119003,Allmersbach im Tal,50 - 55 Jahre,273,135,138
False,8119003,Allmersbach im Tal,55 - 60 Jahre,320,161,159
False,8119003,Allmersbach im Tal,60 - 65 Jahre,368,191,177
False,8119003,Allmersbach im Tal,65 - 75 Jahre,405,213,192
False,8119003,Allmersbach im Tal,75 und mehr Jahre,207,64,143
False,8119003,Allmersbach im Tal,Insgesamt,4645,2292,2353
False,8119004,Althütte,unter 3 Jahre,147,70,77
False,8119004,Althütte,3 -  6 Jahre,164,85,79
False,8119004,Althütte,6 - 10 Jahre,213,103,110
False,8119004,Althütte,10 - 15 Jahre,244,129,115
False,8119004,Althütte,15 - 18 Jahre,143,66,77
False,8119004,Althütte,18 - 20 Jahre,82,41,41
False,8119004,Althütte,20 - 25 Jahre,207,99,108
False,8119004,Althütte,25 - 30 Jahre,191,103,88
False,8119004,Althütte,30 - 35 Jahre,340,154,186
False,8119004,Althütte,35 - 40 Jahre,371,196,175
False,8119004,Althütte,40 - 45 Jahre,310,169,141
False,8119004,Althütte,45 - 50 Jahre,259,133,126
False,8119004,Althütte,50 - 55 Jahre,247,117,130
False,8119004,Althütte,55 - 60 Jahre,256,130,126
False,8119004,Althütte,60 - 65 Jahre,270,139,131
False,8119004,Althütte,65 - 75 Jahre,355,167,188
False,8119004,Althütte,75 und mehr Jahre,249,89,160
False,8119004,Althütte,Insgesamt,4048,1990,2058
False,8119006,Auenwald,unter 3 Jahre,248,122,126
False,8119006,Auenwald,3 -  6 Jahre,255,123,132
False,8119006,Auenwald,6 - 10 Jahre,387,199,188
False,8119006,Auenwald,10 - 15 Jahre,422,212,210
False,8119006,Auenwald,15 - 18 Jahre,235,110,125
False,8119006,Auenwald,18 - 20 Jahre,132,57,75
False,8119006,Auenwald,20 - 25 Jahre,319,169,150
False,8119006,Auenwald,25 - 30 Jahre,413,204,209
False,8119006,Auenwald,30 - 35 Jahre,601,296,305
False,8119006,Auenwald,35 - 40 Jahre,653,331,322
False,8119006,Auenwald,40 - 45 Jahre,546,270,276
False,8119006,Auenwald,45 - 50 Jahre,445,222,223
False,8119006,Auenwald,50 - 55 Jahre,453,230,223
False,8119006,Auenwald,55 - 60 Jahre,415,203,212
False,8119006,Auenwald,60 - 65 Jahre,470,248,222
False,8119006,Auenwald,65 - 75 Jahre,484,232,252
False,8119006,Auenwald,75 und mehr Jahre,316,98,218
False,8119006,Auenwald,Insgesamt,6794,3326,3468
False,8119008,"Backnang, Stadt",unter 3 Jahre,1079,551,528
False,8119008,"Backnang, Stadt",3 -  6 Jahre,1181,609,572
False,8119008,"Backnang, Stadt",6 - 10 Jahre,1587,815,772
False,8119008,"Backnang, Stadt",10 - 15 Jahre,2025,994,1031
False,8119008,"Backnang, Stadt",15 - 18 Jahre,1145,608,537
False,8119008,"Backnang, Stadt",18 - 20 Jahre,759,405,354
False,8119008,"Backnang, Stadt",20 - 25 Jahre,1804,902,902
False,8119008,"Backnang, Stadt",25 - 30 Jahre,2030,1050,980
False,8119008,"Backnang, Stadt",30 - 35 Jahre,2697,1456,1241
False,8119008,"Backnang, Stadt",35 - 40 Jahre,3033,1615,1418
False,8119008,"Backnang, Stadt",40 - 45 Jahre,2714,1456,1258
False,8119008,"Backnang, Stadt",45 - 50 Jahre,2257,1107,1150
False,8119008,"Backnang, Stadt",50 - 55 Jahre,2060,1009,1051
False,8119008,"Backnang, Stadt",55 - 60 Jahre,2010,1034,976
False,8119008,"Backnang, Stadt",60 - 65 Jahre,2341,1179,1162
False,8119008,"Backnang, Stadt",65 - 75 Jahre,3348,1551,1797
False,8119008,"Backnang, Stadt",75 und mehr Jahre,2492,762,1730
False,8119008,"Backnang, Stadt",Insgesamt,34562,17103,17459
False,8119018,Burgstetten,unter 3 Jahre,121,66,55
False,8119018,Burgstetten,3 -  6 Jahre,144,76,68
False,8119018,Burgstetten,6 - 10 Jahre,197,102,95
False,8119018,Burgstetten,10 - 15 Jahre,217,122,95
False,8119018,Burgstetten,15 - 18 Jahre,109,53,56
False,8119018,Burgstetten,18 - 20 Jahre,88,45,43
False,8119018,Burgstetten,20 - 25 Jahre,176,89,87
False,8119018,Burgstetten,25 - 30 Jahre,179,94,85
False,8119018,Burgstetten,30 - 35 Jahre,274,132,142
False,8119018,Burgstetten,35 - 40 Jahre,322,159,163
False,8119018,Burgstetten,40 - 45 Jahre,273,132,141
False,8119018,Burgstetten,45 - 50 Jahre,230,124,106
False,8119018,Burgstetten,50 - 55 Jahre,198,102,96
False,8119018,Burgstetten,55 - 60 Jahre,173,96,77
False,8119018,Burgstetten,60 - 65 Jahre,199,97,102
False,8119018,Burgstetten,65 - 75 Jahre,295,148,147
False,8119018,Burgstetten,75 und mehr Jahre,163,53,110
False,8119018,Burgstetten,Insgesamt,3358,1690,1668
False,8119020,"Fellbach, Stadt",unter 3 Jahre,1348,680,668
False,8119020,"Fellbach, Stadt",3 -  6 Jahre,1324,673,651
False,8119020,"Fellbach, Stadt",6 - 10 Jahre,1692,865,827
False,8119020,"Fellbach, Stadt",10 - 15 Jahre,2215,1177,1038
False,8119020,"Fellbach, Stadt",15 - 18 Jahre,1174,602,572
False,8119020,"Fellbach, Stadt",18 - 20 Jahre,828,429,399
False,8119020,"Fellbach, Stadt",20 - 25 Jahre,2335,1123,1212
False,8119020,"Fellbach, Stadt",25 - 30 Jahre,2884,1427,1457
False,8119020,"Fellbach, Stadt",30 - 35 Jahre,3971,2105,1866
False,8119020,"Fellbach, Stadt",35 - 40 Jahre,3981,2100,1881
False,8119020,"Fellbach, Stadt",40 - 45 Jahre,3200,1640,1560
False,8119020,"Fellbach, Stadt",45 - 50 Jahre,2703,1316,1387
False,8119020,"Fellbach, Stadt",50 - 55 Jahre,2572,1283,1289
False,8119020,"Fellbach, Stadt",55 - 60 Jahre,2670,1320,1350
False,8119020,"Fellbach, Stadt",60 - 65 Jahre,3070,1497,1573
False,8119020,"Fellbach, Stadt",65 - 75 Jahre,3946,1805,2141
False,8119020,"Fellbach, Stadt",75 und mehr Jahre,3033,922,2111
False,8119020,"Fellbach, Stadt",Insgesamt,42946,20964,21982
False,8119024,Großerlach,unter 3 Jahre,70,37,33
False,8119024,Großerlach,3 -  6 Jahre,63,30,33
False,8119024,Großerlach,6 - 10 Jahre,137,74,63
False,8119024,Großerlach,10 - 15 Jahre,154,69,85
False,8119024,Großerlach,15 - 18 Jahre,76,33,43
False,8119024,Großerlach,18 - 20 Jahre,37,23,14
False,8119024,Großerlach,20 - 25 Jahre,84,49,35
False,8119024,Großerlach,25 - 30 Jahre,98,52,46
False,8119024,Großerlach,30 - 35 Jahre,178,97,81
False,8119024,Großerlach,35 - 40 Jahre,226,134,92
False,8119024,Großerlach,40 - 45 Jahre,232,143,89
False,8119024,Großerlach,45 - 50 Jahre,197,128,69
False,8119024,Großerlach,50 - 55 Jahre,190,116,74
False,8119024,Großerlach,55 - 60 Jahre,149,94,55
False,8119024,Großerlach,60 - 65 Jahre,168,110,58
False,8119024,Großerlach,65 - 75 Jahre,279,139,140
False,8119024,Großerlach,75 und mehr Jahre,292,79,213
False,8119024,Großerlach,Insgesamt,2630,1407,1223
False,8119037,Kaisersbach,unter 3 Jahre,95,50,45
False,8119037,Kaisersbach,3 -  6 Jahre,109,60,49
False,8119037,Kaisersbach,6 - 10 Jahre,153,77,76
False,8119037,Kaisersbach,10 - 15 Jahre,203,107,96
False,8119037,Kaisersbach,15 - 18 Jahre,101,56,45
False,8119037,Kaisersbach,18 - 20 Jahre,69,30,39
False,8119037,Kaisersbach,20 - 25 Jahre,149,72,77
False,8119037,Kaisersbach,25 - 30 Jahre,118,69,49
False,8119037,Kaisersbach,30 - 35 Jahre,233,103,130
False,8119037,Kaisersbach,35 - 40 Jahre,247,128,119
False,8119037,Kaisersbach,40 - 45 Jahre,217,116,101
False,8119037,Kaisersbach,45 - 50 Jahre,205,104,101
False,8119037,Kaisersbach,50 - 55 Jahre,135,72,63
False,8119037,Kaisersbach,55 - 60 Jahre,122,66,56
False,8119037,Kaisersbach,60 - 65 Jahre,152,71,81
False,8119037,Kaisersbach,65 - 75 Jahre,228,115,113
False,8119037,Kaisersbach,75 und mehr Jahre,176,60,116
False,8119037,Kaisersbach,Insgesamt,2712,1356,1356
False,8119038,Kirchberg an der Murr,unter 3 Jahre,125,57,68
False,8119038,Kirchberg an der Murr,3 -  6 Jahre,145,82,63
False,8119038,Kirchberg an der Murr,6 - 10 Jahre,174,92,82
False,8119038,Kirchberg an der Murr,10 - 15 Jahre,205,108,97
False,8119038,Kirchberg an der Murr,15 - 18 Jahre,120,77,43
False,8119038,Kirchberg an der Murr,18 - 20 Jahre,74,40,34
False,8119038,Kirchberg an der Murr,20 - 25 Jahre,199,99,100
False,8119038,Kirchberg an der Murr,25 - 30 Jahre,228,117,111
False,8119038,Kirchberg an der Murr,30 - 35 Jahre,319,161,158
False,8119038,Kirchberg an der Murr,35 - 40 Jahre,320,165,155
False,8119038,Kirchberg an der Murr,40 - 45 Jahre,266,142,124
False,8119038,Kirchberg an der Murr,45 - 50 Jahre,252,122,130
False,8119038,Kirchberg an der Murr,50 - 55 Jahre,191,100,91
False,8119038,Kirchberg an der Murr,55 - 60 Jahre,236,134,102
False,8119038,Kirchberg an der Murr,60 - 65 Jahre,221,110,111
False,8119038,Kirchberg an der Murr,65 - 75 Jahre,313,156,157
False,8119038,Kirchberg an der Murr,75 und mehr Jahre,240,86,154
False,8119038,Kirchberg an der Murr,Insgesamt,3628,1848,1780
False,8119041,Korb,unter 3 Jahre,301,148,153
False,8119041,Korb,3 -  6 Jahre,323,176,147
False,8119041,Korb,6 - 10 Jahre,459,237,222
False,8119041,Korb,10 - 15 Jahre,535,256,279
False,8119041,Korb,15 - 18 Jahre,265,157,108
False,8119041,Korb,18 - 20 Jahre,191,89,102
False,8119041,Korb,20 - 25 Jahre,505,277,228
False,8119041,Korb,25 - 30 Jahre,634,311,323
False,8119041,Korb,30 - 35 Jahre,933,487,446
False,8119041,Korb,35 - 40 Jahre,1032,535,497
False,8119041,Korb,40 - 45 Jahre,764,397,367
False,8119041,Korb,45 - 50 Jahre,667,341,326
False,8119041,Korb,50 - 55 Jahre,605,282,323
False,8119041,Korb,55 - 60 Jahre,626,297,329
False,8119041,Korb,60 - 65 Jahre,762,366,396
False,8119041,Korb,65 - 75 Jahre,911,439,472
False,8119041,Korb,75 und mehr Jahre,605,209,396
False,8119041,Korb,Insgesamt,10118,5004,5114
False,8119042,Leutenbach,unter 3 Jahre,381,185,196
False,8119042,Leutenbach,3 -  6 Jahre,349,160,189
False,8119042,Leutenbach,6 - 10 Jahre,551,261,290
False,8119042,Leutenbach,10 - 15 Jahre,637,326,311
False,8119042,Leutenbach,15 - 18 Jahre,325,168,157
False,8119042,Leutenbach,18 - 20 Jahre,240,120,120
False,8119042,Leutenbach,20 - 25 Jahre,538,267,271
False,8119042,Leutenbach,25 - 30 Jahre,570,271,299
False,8119042,Leutenbach,30 - 35 Jahre,975,467,508
False,8119042,Leutenbach,35 - 40 Jahre,1037,507,530
False,8119042,Leutenbach,40 - 45 Jahre,909,465,444
False,8119042,Leutenbach,45 - 50 Jahre,711,346,365
False,8119042,Leutenbach,50 - 55 Jahre,692,341,351
False,8119042,Leutenbach,55 - 60 Jahre,722,364,358
False,8119042,Leutenbach,60 - 65 Jahre,724,370,354
False,8119042,Leutenbach,65 - 75 Jahre,834,391,443
False,8119042,Leutenbach,75 und mehr Jahre,540,177,363
False,8119042,Leutenbach,Insgesamt,10735,5186,5549
False,8119044,"Murrhardt, Stadt",unter 3 Jahre,453,221,232
False,8119044,"Murrhardt, Stadt",3 -  6 Jahre,453,237,216
False,8119044,"Murrhardt, Stadt",6 - 10 Jahre,647,311,336
False,8119044,"Murrhardt, Stadt",10 - 15 Jahre,819,448,371
False,8119044,"Murrhardt, Stadt",15 - 18 Jahre,525,266,259
False,8119044,"Murrhardt, Stadt",18 - 20 Jahre,317,145,172
False,8119044,"Murrhardt, Stadt",20 - 25 Jahre,693,369,324
False,8119044,"Murrhardt, Stadt",25 - 30 Jahre,801,386,415
False,8119044,"Murrhardt, Stadt",30 - 35 Jahre,1011,546,465
False,8119044,"Murrhardt, Stadt",35 - 40 Jahre,1184,583,601
False,8119044,"Murrhardt, Stadt",40 - 45 Jahre,1066,561,505
False,8119044,"Murrhardt, Stadt",45 - 50 Jahre,984,503,481
False,8119044,"Murrhardt, Stadt",50 - 55 Jahre,832,426,406
False,8119044,"Murrhardt, Stadt",55 - 60 Jahre,834,430,404
False,8119044,"Murrhardt, Stadt",60 - 65 Jahre,1062,525,537
False,8119044,"Murrhardt, Stadt",65 - 75 Jahre,1386,613,773
False,8119044,"Murrhardt, Stadt",75 und mehr Jahre,1225,387,838
False,8119044,"Murrhardt, Stadt",Insgesamt,14292,6957,7335
False,8119053,Oppenweiler,unter 3 Jahre,132,81,51
False,8119053,Oppenweiler,3 -  6 Jahre,143,61,82
False,8119053,Oppenweiler,6 - 10 Jahre,199,108,91
False,8119053,Oppenweiler,10 - 15 Jahre,265,152,113
False,8119053,Oppenweiler,15 - 18 Jahre,150,83,67
False,8119053,Oppenweiler,18 - 20 Jahre,94,37,57
False,8119053,Oppenweiler,20 - 25 Jahre,239,117,122
False,8119053,Oppenweiler,25 - 30 Jahre,217,114,103
False,8119053,Oppenweiler,30 - 35 Jahre,305,158,147
False,8119053,Oppenweiler,35 - 40 Jahre,355,173,182
False,8119053,Oppenweiler,40 - 45 Jahre,369,182,187
False,8119053,Oppenweiler,45 - 50 Jahre,274,136,138
False,8119053,Oppenweiler,50 - 55 Jahre,264,139,125
False,8119053,Oppenweiler,55 - 60 Jahre,233,123,110
False,8119053,Oppenweiler,60 - 65 Jahre,296,139,157
False,8119053,Oppenweiler,65 - 75 Jahre,390,188,202
False,8119053,Oppenweiler,75 und mehr Jahre,271,92,179
False,8119053,Oppenweiler,Insgesamt,4196,2083,2113
False,8119055,Plüderhausen,unter 3 Jahre,324,161,163
False,8119055,Plüderhausen,3 -  6 Jahre,339,190,149
False,8119055,Plüderhausen,6 - 10 Jahre,451,237,214
False,8119055,Plüderhausen,10 - 15 Jahre,581,300,281
False,8119055,Plüderhausen,15 - 18 Jahre,318,168,150
False,8119055,Plüderhausen,18 - 20 Jahre,214,116,98
False,8119055,Plüderhausen,20 - 25 Jahre,513,259,254
False,8119055,Plüderhausen,25 - 30 Jahre,584,288,296
False,8119055,Plüderhausen,30 - 35 Jahre,798,413,385
False,8119055,Plüderhausen,35 - 40 Jahre,830,407,423
False,8119055,Plüderhausen,40 - 45 Jahre,729,380,349
False,8119055,Plüderhausen,45 - 50 Jahre,617,319,298
False,8119055,Plüderhausen,50 - 55 Jahre,580,273,307
False,8119055,Plüderhausen,55 - 60 Jahre,583,293,290
False,8119055,Plüderhausen,60 - 65 Jahre,664,342,322
False,8119055,Plüderhausen,65 - 75 Jahre,876,409,467
False,8119055,Plüderhausen,75 und mehr Jahre,548,160,388
False,8119055,Plüderhausen,Insgesamt,9549,4715,4834
False,8119061,Rudersberg,unter 3 Jahre,388,201,187
False,8119061,Rudersberg,3 -  6 Jahre,418,209,209
False,8119061,Rudersberg,6 - 10 Jahre,566,287,279
False,8119061,Rudersberg,10 - 15 Jahre,775,406,369
False,8119061,Rudersberg,15 - 18 Jahre,436,238,198
False,8119061,Rudersberg,18 - 20 Jahre,283,153,130
False,8119061,Rudersberg,20 - 25 Jahre,598,321,277
False,8119061,Rudersberg,25 - 30 Jahre,591,317,274
False,8119061,Rudersberg,30 - 35 Jahre,863,436,427
False,8119061,Rudersberg,35 - 40 Jahre,1074,557,517
False,8119061,Rudersberg,40 - 45 Jahre,865,435,430
False,8119061,Rudersberg,45 - 50 Jahre,825,406,419
False,8119061,Rudersberg,50 - 55 Jahre,674,351,323
False,8119061,Rudersberg,55 - 60 Jahre,640,317,323
False,8119061,Rudersberg,60 - 65 Jahre,752,391,361
False,8119061,Rudersberg,65 - 75 Jahre,1029,496,533
False,8119061,Rudersberg,75 und mehr Jahre,649,209,440
False,8119061,Rudersberg,Insgesamt,11426,5730,5696
False,8119067,"Schorndorf, Stadt",unter 3 Jahre,1190,590,600
False,8119067,"Schorndorf, Stadt",3 -  6 Jahre,1253,641,612
False,8119067,"Schorndorf, Stadt",6 - 10 Jahre,1760,866,894
False,8119067,"Schorndorf, Stadt",10 - 15 Jahre,2253,1174,1079
False,8119067,"Schorndorf, Stadt",15 - 18 Jahre,1222,639,583
False,8119067,"Schorndorf, Stadt",18 - 20 Jahre,838,425,413
False,8119067,"Schorndorf, Stadt",20 - 25 Jahre,2061,1079,982
False,8119067,"Schorndorf, Stadt",25 - 30 Jahre,2214,1108,1106
False,8119067,"Schorndorf, Stadt",30 - 35 Jahre,3084,1551,1533
False,8119067,"Schorndorf, Stadt",35 - 40 Jahre,3272,1708,1564
False,8119067,"Schorndorf, Stadt",40 - 45 Jahre,2868,1440,1428
False,8119067,"Schorndorf, Stadt",45 - 50 Jahre,2618,1281,1337
False,8119067,"Schorndorf, Stadt",50 - 55 Jahre,2469,1227,1242
False,8119067,"Schorndorf, Stadt",55 - 60 Jahre,2423,1163,1260
False,8119067,"Schorndorf, Stadt",60 - 65 Jahre,2732,1376,1356
False,8119067,"Schorndorf, Stadt",65 - 75 Jahre,3728,1755,1973
False,8119067,"Schorndorf, Stadt",75 und mehr Jahre,2867,885,1982
False,8119067,"Schorndorf, Stadt",Insgesamt,38852,18908,19944
False,8119068,Schwaikheim,unter 3 Jahre,346,160,186
False,8119068,Schwaikheim,3 -  6 Jahre,342,169,173
False,8119068,Schwaikheim,6 - 10 Jahre,434,227,207
False,8119068,Schwaikheim,10 - 15 Jahre,456,236,220
False,8119068,Schwaikheim,15 - 18 Jahre,273,148,125
False,8119068,Schwaikheim,18 - 20 Jahre,165,91,74
False,8119068,Schwaikheim,20 - 25 Jahre,495,240,255
False,8119068,Schwaikheim,25 - 30 Jahre,603,297,306
False,8119068,Schwaikheim,30 - 35 Jahre,815,409,406
False,8119068,Schwaikheim,35 - 40 Jahre,899,459,440
False,8119068,Schwaikheim,40 - 45 Jahre,676,353,323
False,8119068,Schwaikheim,45 - 50 Jahre,596,287,309
False,8119068,Schwaikheim,50 - 55 Jahre,587,306,281
False,8119068,Schwaikheim,55 - 60 Jahre,544,268,276
False,8119068,Schwaikheim,60 - 65 Jahre,645,316,329
False,8119068,Schwaikheim,65 - 75 Jahre,805,398,407
False,8119068,Schwaikheim,75 und mehr Jahre,451,147,304
False,8119068,Schwaikheim,Insgesamt,9132,4511,4621
False,8119069,Spiegelberg,unter 3 Jahre,62,39,23
False,8119069,Spiegelberg,3 -  6 Jahre,71,38,33
False,8119069,Spiegelberg,6 - 10 Jahre,133,76,57
False,8119069,Spiegelberg,10 - 15 Jahre,148,80,68
False,8119069,Spiegelberg,15 - 18 Jahre,84,47,37
False,8119069,Spiegelberg,18 - 20 Jahre,49,24,25
False,8119069,Spiegelberg,20 - 25 Jahre,108,57,51
False,8119069,Spiegelberg,25 - 30 Jahre,104,56,48
False,8119069,Spiegelberg,30 - 35 Jahre,166,94,72
False,8119069,Spiegelberg,35 - 40 Jahre,205,101,104
False,8119069,Spiegelberg,40 - 45 Jahre,188,101,87
False,8119069,Spiegelberg,45 - 50 Jahre,162,95,67
False,8119069,Spiegelberg,50 - 55 Jahre,106,63,43
False,8119069,Spiegelberg,55 - 60 Jahre,75,41,34
False,8119069,Spiegelberg,60 - 65 Jahre,147,64,83
False,8119069,Spiegelberg,65 - 75 Jahre,198,94,104
False,8119069,Spiegelberg,75 und mehr Jahre,152,53,99
False,8119069,Spiegelberg,Insgesamt,2158,1123,1035
False,8119075,Sulzbach an der Murr,unter 3 Jahre,180,83,97
False,8119075,Sulzbach an der Murr,3 -  6 Jahre,178,88,90
False,8119075,Sulzbach an der Murr,6 - 10 Jahre,283,140,143
False,8119075,Sulzbach an der Murr,10 - 15 Jahre,368,194,174
False,8119075,Sulzbach an der Murr,15 - 18 Jahre,178,92,86
False,8119075,Sulzbach an der Murr,18 - 20 Jahre,120,62,58
False,8119075,Sulzbach an der Murr,20 - 25 Jahre,285,155,130
False,8119075,Sulzbach an der Murr,25 - 30 Jahre,317,154,163
False,8119075,Sulzbach an der Murr,30 - 35 Jahre,447,226,221
False,8119075,Sulzbach an der Murr,35 - 40 Jahre,459,223,236
False,8119075,Sulzbach an der Murr,40 - 45 Jahre,418,213,205
False,8119075,Sulzbach an der Murr,45 - 50 Jahre,339,173,166
False,8119075,Sulzbach an der Murr,50 - 55 Jahre,314,157,157
False,8119075,Sulzbach an der Murr,55 - 60 Jahre,287,152,135
False,8119075,Sulzbach an der Murr,60 - 65 Jahre,375,177,198
False,8119075,Sulzbach an der Murr,65 - 75 Jahre,435,203,232
False,8119075,Sulzbach an der Murr,75 und mehr Jahre,392,114,278
False,8119075,Sulzbach an der Murr,Insgesamt,5375,2606,2769
False,8119076,Urbach,unter 3 Jahre,272,138,134
False,8119076,Urbach,3 -  6 Jahre,293,163,130
False,8119076,Urbach,6 - 10 Jahre,420,206,214
False,8119076,Urbach,10 - 15 Jahre,492,261,231
False,8119076,Urbach,15 - 18 Jahre,284,153,131
False,8119076,Urbach,18 - 20 Jahre,182,91,91
False,8119076,Urbach,20 - 25 Jahre,361,194,167
False,8119076,Urbach,25 - 30 Jahre,499,252,247
False,8119076,Urbach,30 - 35 Jahre,722,362,360
False,8119076,Urbach,35 - 40 Jahre,757,396,361
False,8119076,Urbach,40 - 45 Jahre,664,334,330
False,8119076,Urbach,45 - 50 Jahre,474,239,235
False,8119076,Urbach,50 - 55 Jahre,458,220,238
False,8119076,Urbach,55 - 60 Jahre,438,222,216
False,8119076,Urbach,60 - 65 Jahre,558,276,282
False,8119076,Urbach,65 - 75 Jahre,736,342,394
False,8119076,Urbach,75 und mehr Jahre,520,161,359
False,8119076,Urbach,Insgesamt,8130,4010,4120
False,8119079,"Waiblingen, Stadt",unter 3 Jahre,1655,868,787
False,8119079,"Waiblingen, Stadt",3 -  6 Jahre,1782,909,873
False,8119079,"Waiblingen, Stadt",6 - 10 Jahre,2299,1168,1131
False,8119079,"Waiblingen, Stadt",10 - 15 Jahre,2688,1388,1300
False,8119079,"Waiblingen, Stadt",15 - 18 Jahre,1524,766,758
False,8119079,"Waiblingen, Stadt",18 - 20 Jahre,1155,613,542
False,8119079,"Waiblingen, Stadt",20 - 25 Jahre,2817,1362,1455
False,8119079,"Waiblingen, Stadt",25 - 30 Jahre,3439,1747,1692
False,8119079,"Waiblingen, Stadt",30 - 35 Jahre,4506,2300,2206
False,8119079,"Waiblingen, Stadt",35 - 40 Jahre,4645,2407,2238
False,8119079,"Waiblingen, Stadt",40 - 45 Jahre,3932,2003,1929
False,8119079,"Waiblingen, Stadt",45 - 50 Jahre,3335,1610,1725
False,8119079,"Waiblingen, Stadt",50 - 55 Jahre,3171,1532,1639
False,8119079,"Waiblingen, Stadt",55 - 60 Jahre,3347,1662,1685
False,8119079,"Waiblingen, Stadt",60 - 65 Jahre,3733,1820,1913
False,8119079,"Waiblingen, Stadt",65 - 75 Jahre,4604,2145,2459
False,8119079,"Waiblingen, Stadt",75 und mehr Jahre,3034,950,2084
False,8119079,"Waiblingen, Stadt",Insgesamt,51666,25250,26416
False,8119083,Weissach im Tal,unter 3 Jahre,234,114,120
False,8119083,Weissach im Tal,3 -  6 Jahre,271,149,122
False,8119083,Weissach im Tal,6 - 10 Jahre,365,198,167
False,8119083,Weissach im Tal,10 - 15 Jahre,453,227,226
False,8119083,Weissach im Tal,15 - 18 Jahre,269,128,141
False,8119083,Weissach im Tal,18 - 20 Jahre,205,105,100
False,8119083,Weissach im Tal,20 - 25 Jahre,389,211,178
False,8119083,Weissach im Tal,25 - 30 Jahre,404,202,202
False,8119083,Weissach im Tal,30 - 35 Jahre,558,286,272
False,8119083,Weissach im Tal,35 - 40 Jahre,632,323,309
False,8119083,Weissach im Tal,40 - 45 Jahre,572,289,283
False,8119083,Weissach im Tal,45 - 50 Jahre,537,264,273
False,8119083,Weissach im Tal,50 - 55 Jahre,441,232,209
False,8119083,Weissach im Tal,55 - 60 Jahre,439,225,214
False,8119083,Weissach im Tal,60 - 65 Jahre,470,237,233
False,8119083,Weissach im Tal,65 - 75 Jahre,603,288,315
False,8119083,Weissach im Tal,75 und mehr Jahre,386,139,247
False,8119083,Weissach im Tal,Insgesamt,7228,3617,3611
False,8119084,"Welzheim, Stadt",unter 3 Jahre,340,182,158
False,8119084,"Welzheim, Stadt",3 -  6 Jahre,362,190,172
False,8119084,"Welzheim, Stadt",6 - 10 Jahre,592,320,272
False,8119084,"Welzheim, Stadt",10 - 15 Jahre,767,371,396
False,8119084,"Welzheim, Stadt",15 - 18 Jahre,456,241,215
False,8119084,"Welzheim, Stadt",18 - 20 Jahre,283,148,135
False,8119084,"Welzheim, Stadt",20 - 25 Jahre,660,330,330
False,8119084,"Welzheim, Stadt",25 - 30 Jahre,629,334,295
False,8119084,"Welzheim, Stadt",30 - 35 Jahre,810,399,411
False,8119084,"Welzheim, Stadt",35 - 40 Jahre,967,496,471
False,8119084,"Welzheim, Stadt",40 - 45 Jahre,885,467,418
False,8119084,"Welzheim, Stadt",45 - 50 Jahre,716,353,363
False,8119084,"Welzheim, Stadt",50 - 55 Jahre,618,326,292
False,8119084,"Welzheim, Stadt",55 - 60 Jahre,590,288,302
False,8119084,"Welzheim, Stadt",60 - 65 Jahre,689,331,358
False,8119084,"Welzheim, Stadt",65 - 75 Jahre,995,436,559
False,8119084,"Welzheim, Stadt",75 und mehr Jahre,735,229,506
False,8119084,"Welzheim, Stadt",Insgesamt,11094,5441,5653
False,8119085,"Winnenden, Stadt",unter 3 Jahre,920,451,469
False,8119085,"Winnenden, Stadt",3 -  6 Jahre,953,488,465
False,8119085,"Winnenden, Stadt",6 - 10 Jahre,1352,704,648
False,8119085,"Winnenden, Stadt",10 - 15 Jahre,1516,758,758
False,8119085,"Winnenden, Stadt",15 - 18 Jahre,867,468,399
False,8119085,"Winnenden, Stadt",18 - 20 Jahre,615,290,325
False,8119085,"Winnenden, Stadt",20 - 25 Jahre,1468,724,744
False,8119085,"Winnenden, Stadt",25 - 30 Jahre,1755,853,902
False,8119085,"Winnenden, Stadt",30 - 35 Jahre,2446,1249,1197
False,8119085,"Winnenden, Stadt",35 - 40 Jahre,2467,1278,1189
False,8119085,"Winnenden, Stadt",40 - 45 Jahre,2106,1103,1003
False,8119085,"Winnenden, Stadt",45 - 50 Jahre,1702,859,843
False,8119085,"Winnenden, Stadt",50 - 55 Jahre,1562,751,811
False,8119085,"Winnenden, Stadt",55 - 60 Jahre,1656,827,829
False,8119085,"Winnenden, Stadt",60 - 65 Jahre,1831,909,922
False,8119085,"Winnenden, Stadt",65 - 75 Jahre,2387,1173,1214
False,8119085,"Winnenden, Stadt",75 und mehr Jahre,1666,545,1121
False,8119085,"Winnenden, Stadt",Insgesamt,27269,13430,13839
False,8119086,Winterbach,unter 3 Jahre,238,106,132
False,8119086,Winterbach,3 -  6 Jahre,241,130,111
False,8119086,Winterbach,6 - 10 Jahre,373,171,202
False,8119086,Winterbach,10 - 15 Jahre,463,252,211
False,8119086,Winterbach,15 - 18 Jahre,266,140,126
False,8119086,Winterbach,18 - 20 Jahre,177,81,96
False,8119086,Winterbach,20 - 25 Jahre,393,198,195
False,8119086,Winterbach,25 - 30 Jahre,491,255,236
False,8119086,Winterbach,30 - 35 Jahre,641,301,340
False,8119086,Winterbach,35 - 40 Jahre,661,335,326
False,8119086,Winterbach,40 - 45 Jahre,552,276,276
False,8119086,Winterbach,45 - 50 Jahre,553,250,303
False,8119086,Winterbach,50 - 55 Jahre,492,243,249
False,8119086,Winterbach,55 - 60 Jahre,457,242,215
False,8119086,Winterbach,60 - 65 Jahre,498,233,265
False,8119086,Winterbach,65 - 75 Jahre,679,324,355
False,8119086,Winterbach,75 und mehr Jahre,513,147,366
False,8119086,Winterbach,Insgesamt,7688,3684,4004
False,8119087,Aspach,unter 3 Jahre,277,128,149
False,8119087,Aspach,3 -  6 Jahre,317,156,161
False,8119087,Aspach,6 - 10 Jahre,392,191,201
False,8119087,Aspach,10 - 15 Jahre,511,263,248
False,8119087,Aspach,15 - 18 Jahre,262,127,135
False,8119087,Aspach,18 - 20 Jahre,192,103,89
False,8119087,Aspach,20 - 25 Jahre,415,203,212
False,8119087,Aspach,25 - 30 Jahre,473,241,232
False,8119087,Aspach,30 - 35 Jahre,662,320,342
False,8119087,Aspach,35 - 40 Jahre,735,368,367
False,8119087,Aspach,40 - 45 Jahre,650,340,310
False,8119087,Aspach,45 - 50 Jahre,560,280,280
False,8119087,Aspach,50 - 55 Jahre,472,249,223
False,8119087,Aspach,55 - 60 Jahre,456,246,210
False,8119087,Aspach,60 - 65 Jahre,527,253,274
False,8119087,Aspach,65 - 75 Jahre,728,344,384
False,8119087,Aspach,75 und mehr Jahre,478,159,319
False,8119087,Aspach,Insgesamt,8107,3971,4136
False,8119089,Berglen,unter 3 Jahre,202,104,98
False,8119089,Berglen,3 -  6 Jahre,244,113,131
False,8119089,Berglen,6 - 10 Jahre,327,168,159
False,8119089,Berglen,10 - 15 Jahre,362,190,172
False,8119089,Berglen,15 - 18 Jahre,184,102,82
False,8119089,Berglen,18 - 20 Jahre,112,62,50
False,8119089,Berglen,20 - 25 Jahre,286,159,127
False,8119089,Berglen,25 - 30 Jahre,327,186,141
False,8119089,Berglen,30 - 35 Jahre,554,284,270
False,8119089,Berglen,35 - 40 Jahre,556,269,287
False,8119089,Berglen,40 - 45 Jahre,511,255,256
False,8119089,Berglen,45 - 50 Jahre,405,208,197
False,8119089,Berglen,50 - 55 Jahre,374,211,163
False,8119089,Berglen,55 - 60 Jahre,363,185,178
False,8119089,Berglen,60 - 65 Jahre,423,218,205
False,8119089,Berglen,65 - 75 Jahre,497,247,250
False,8119089,Berglen,75 und mehr Jahre,332,103,229
False,8119089,Berglen,Insgesamt,6059,3064,2995
False,8119090,Remshalden,unter 3 Jahre,397,185,212
False,8119090,Remshalden,3 -  6 Jahre,490,238,252
False,8119090,Remshalden,6 - 10 Jahre,610,320,290
False,8119090,Remshalden,10 - 15 Jahre,797,417,380
False,8119090,Remshalden,15 - 18 Jahre,402,201,201
False,8119090,Remshalden,18 - 20 Jahre,291,155,136
False,8119090,Remshalden,20 - 25 Jahre,654,319,335
False,8119090,Remshalden,25 - 30 Jahre,774,379,395
False,8119090,Remshalden,30 - 35 Jahre,1127,569,558
False,8119090,Remshalden,35 - 40 Jahre,1225,631,594
False,8119090,Remshalden,40 - 45 Jahre,962,481,481
False,8119090,Remshalden,45 - 50 Jahre,850,415,435
False,8119090,Remshalden,50 - 55 Jahre,885,423,462
False,8119090,Remshalden,55 - 60 Jahre,911,467,444
False,8119090,Remshalden,60 - 65 Jahre,1017,505,512
False,8119090,Remshalden,65 - 75 Jahre,1275,611,664
False,8119090,Remshalden,75 und mehr Jahre,825,291,534
False,8119090,Remshalden,Insgesamt,13492,6607,6885
False,8119091,"Weinstadt, Stadt",unter 3 Jahre,871,421,450
False,8119091,"Weinstadt, Stadt",3 -  6 Jahre,876,470,406
False,8119091,"Weinstadt, Stadt",6 - 10 Jahre,1180,584,596
False,8119091,"Weinstadt, Stadt",10 - 15 Jahre,1352,672,680
False,8119091,"Weinstadt, Stadt",15 - 18 Jahre,730,362,368
False,8119091,"Weinstadt, Stadt",18 - 20 Jahre,517,274,243
False,8119091,"Weinstadt, Stadt",20 - 25 Jahre,1340,681,659
False,8119091,"Weinstadt, Stadt",25 - 30 Jahre,1518,739,779
False,8119091,"Weinstadt, Stadt",30 - 35 Jahre,2266,1146,1120
False,8119091,"Weinstadt, Stadt",35 - 40 Jahre,2238,1181,1057
False,8119091,"Weinstadt, Stadt",40 - 45 Jahre,1911,964,947
False,8119091,"Weinstadt, Stadt",45 - 50 Jahre,1698,825,873
False,8119091,"Weinstadt, Stadt",50 - 55 Jahre,1610,783,827
False,8119091,"Weinstadt, Stadt",55 - 60 Jahre,1813,897,916
False,8119091,"Weinstadt, Stadt",60 - 65 Jahre,1932,965,967
False,8119091,"Weinstadt, Stadt",65 - 75 Jahre,2245,1072,1173
False,8119091,"Weinstadt, Stadt",75 und mehr Jahre,1546,465,1081
False,8119091,"Weinstadt, Stadt",Insgesamt,25643,12501,13142
False,8119093,Kernen im Remstal,unter 3 Jahre,457,235,222
False,8119093,Kernen im Remstal,3 -  6 Jahre,452,258,194
False,8119093,Kernen im Remstal,6 - 10 Jahre,606,324,282
False,8119093,Kernen im Remstal,10 - 15 Jahre,704,384,320
False,8119093,Kernen im Remstal,15 - 18 Jahre,398,213,185
False,8119093,Kernen im Remstal,18 - 20 Jahre,313,162,151
False,8119093,Kernen im Remstal,20 - 25 Jahre,772,378,394
False,8119093,Kernen im Remstal,25 - 30 Jahre,874,404,470
False,8119093,Kernen im Remstal,30 - 35 Jahre,1380,703,677
False,8119093,Kernen im Remstal,35 - 40 Jahre,1375,714,661
False,8119093,Kernen im Remstal,40 - 45 Jahre,1178,578,600
False,8119093,Kernen im Remstal,45 - 50 Jahre,968,481,487
False,8119093,Kernen im Remstal,50 - 55 Jahre,875,440,435
False,8119093,Kernen im Remstal,55 - 60 Jahre,959,467,492
False,8119093,Kernen im Remstal,60 - 65 Jahre,1117,568,549
False,8119093,Kernen im Remstal,65 - 75 Jahre,1327,601,726
False,8119093,Kernen im Remstal,75 und mehr Jahre,1002,333,669
False,8119093,Kernen im Remstal,Insgesamt,14757,7243,7514
False,8121,Stadtkreis Heilbronn,unter 3 Jahre,3449,1787,1662
False,8121,Stadtkreis Heilbronn,3 -  6 Jahre,3447,1767,1680
False,8121,Stadtkreis Heilbronn,6 - 10 Jahre,4644,2332,2312
False,8121,Stadtkreis Heilbronn,10 - 15 Jahre,6255,3175,3080
False,8121,Stadtkreis Heilbronn,15 - 18 Jahre,3751,1907,1844
False,8121,Stadtkreis Heilbronn,18 - 20 Jahre,2658,1294,1364
False,8121,Stadtkreis Heilbronn,20 - 25 Jahre,7067,3629,3438
False,8121,Stadtkreis Heilbronn,25 - 30 Jahre,8277,4411,3866
False,8121,Stadtkreis Heilbronn,30 - 35 Jahre,9644,5144,4500
False,8121,Stadtkreis Heilbronn,35 - 40 Jahre,9952,5334,4618
False,8121,Stadtkreis Heilbronn,40 - 45 Jahre,8738,4567,4171
False,8121,Stadtkreis Heilbronn,45 - 50 Jahre,7657,3782,3875
False,8121,Stadtkreis Heilbronn,50 - 55 Jahre,7140,3505,3635
False,8121,Stadtkreis Heilbronn,55 - 60 Jahre,7244,3603,3641
False,8121,Stadtkreis Heilbronn,60 - 65 Jahre,8421,4122,4299
False,8121,Stadtkreis Heilbronn,65 - 75 Jahre,11450,5159,6291
False,8121,Stadtkreis Heilbronn,75 und mehr Jahre,9511,2822,6689
False,8121,Stadtkreis Heilbronn,Insgesamt,119305,58340,60965
False,8121000,"Heilbronn, Stadt",unter 3 Jahre,3449,1787,1662
False,8121000,"Heilbronn, Stadt",3 -  6 Jahre,3447,1767,1680
False,8121000,"Heilbronn, Stadt",6 - 10 Jahre,4644,2332,2312
False,8121000,"Heilbronn, Stadt",10 - 15 Jahre,6255,3175,3080
False,8121000,"Heilbronn, Stadt",15 - 18 Jahre,3751,1907,1844
False,8121000,"Heilbronn, Stadt",18 - 20 Jahre,2658,1294,1364
False,8121000,"Heilbronn, Stadt",20 - 25 Jahre,7067,3629,3438
False,8121000,"Heilbronn, Stadt",25 - 30 Jahre,8277,4411,3866
False,8121000,"Heilbronn, Stadt",30 - 35 Jahre,9644,5144,4500
False,8121000,"Heilbronn, Stadt",35 - 40 Jahre,9952,5334,4618
False,8121000,"Heilbronn, Stadt",40 - 45 Jahre,8738,4567,4171
False,8121000,"Heilbronn, Stadt",45 - 50 Jahre,7657,3782,3875
False,8121000,"Heilbronn, Stadt",50 - 55 Jahre,7140,3505,3635
False,8121000,"Heilbronn, Stadt",55 - 60 Jahre,7244,3603,3641
False,8121000,"Heilbronn, Stadt",60 - 65 Jahre,8421,4122,4299
False,8121000,"Heilbronn, Stadt",65 - 75 Jahre,11450,5159,6291
False,8121000,"Heilbronn, Stadt",75 und mehr Jahre,9511,2822,6689
False,8121000,"Heilbronn, Stadt",Insgesamt,119305,58340,60965
False,8125,Landkreis Heilbronn,unter 3 Jahre,10812,5530,5282
False,8125,Landkreis Heilbronn,3 -  6 Jahre,11820,6030,5790
False,8125,Landkreis Heilbronn,6 - 10 Jahre,16190,8435,7755
False,8125,Landkreis Heilbronn,10 - 15 Jahre,21172,10878,10294
False,8125,Landkreis Heilbronn,15 - 18 Jahre,11239,5693,5546
False,8125,Landkreis Heilbronn,18 - 20 Jahre,7423,3783,3640
False,8125,Landkreis Heilbronn,20 - 25 Jahre,17594,8982,8612
False,8125,Landkreis Heilbronn,25 - 30 Jahre,19579,9872,9707
False,8125,Landkreis Heilbronn,30 - 35 Jahre,26924,13814,13110
False,8125,Landkreis Heilbronn,35 - 40 Jahre,29111,14935,14176
False,8125,Landkreis Heilbronn,40 - 45 Jahre,25445,13295,12150
False,8125,Landkreis Heilbronn,45 - 50 Jahre,21582,10926,10656
False,8125,Landkreis Heilbronn,50 - 55 Jahre,18693,9435,9258
False,8125,Landkreis Heilbronn,55 - 60 Jahre,17012,8601,8411
False,8125,Landkreis Heilbronn,60 - 65 Jahre,19816,9889,9927
False,8125,Landkreis Heilbronn,65 - 75 Jahre,26872,12584,14288
False,8125,Landkreis Heilbronn,75 und mehr Jahre,19671,6279,13392
False,8125,Landkreis Heilbronn,Insgesamt,320955,158961,161994
False,8125001,Abstatt,unter 3 Jahre,147,79,68
False,8125001,Abstatt,3 -  6 Jahre,174,98,76
False,8125001,Abstatt,6 - 10 Jahre,256,130,126
False,8125001,Abstatt,10 - 15 Jahre,298,153,145
False,8125001,Abstatt,15 - 18 Jahre,154,83,71
False,8125001,Abstatt,18 - 20 Jahre,97,57,40
False,8125001,Abstatt,20 - 25 Jahre,220,112,108
False,8125001,Abstatt,25 - 30 Jahre,266,137,129
False,8125001,Abstatt,30 - 35 Jahre,397,192,205
False,8125001,Abstatt,35 - 40 Jahre,422,210,212
False,8125001,Abstatt,40 - 45 Jahre,367,192,175
False,8125001,Abstatt,45 - 50 Jahre,339,169,170
False,8125001,Abstatt,50 - 55 Jahre,272,134,138
False,8125001,Abstatt,55 - 60 Jahre,250,133,117
False,8125001,Abstatt,60 - 65 Jahre,231,108,123
False,8125001,Abstatt,65 - 75 Jahre,275,137,138
False,8125001,Abstatt,75 und mehr Jahre,161,51,110
False,8125001,Abstatt,Insgesamt,4326,2175,2151
False,8125005,"Bad Friedrichshall, Stadt",unter 3 Jahre,664,350,314
False,8125005,"Bad Friedrichshall, Stadt",3 -  6 Jahre,687,351,336
False,8125005,"Bad Friedrichshall, Stadt",6 - 10 Jahre,933,474,459
False,8125005,"Bad Friedrichshall, Stadt",10 - 15 Jahre,1191,659,532
False,8125005,"Bad Friedrichshall, Stadt",15 - 18 Jahre,623,312,311
False,8125005,"Bad Friedrichshall, Stadt",18 - 20 Jahre,435,232,203
False,8125005,"Bad Friedrichshall, Stadt",20 - 25 Jahre,1089,524,565
False,8125005,"Bad Friedrichshall, Stadt",25 - 30 Jahre,1222,599,623
False,8125005,"Bad Friedrichshall, Stadt",30 - 35 Jahre,1565,824,741
False,8125005,"Bad Friedrichshall, Stadt",35 - 40 Jahre,1674,822,852
False,8125005,"Bad Friedrichshall, Stadt",40 - 45 Jahre,1422,755,667
False,8125005,"Bad Friedrichshall, Stadt",45 - 50 Jahre,1190,630,560
False,8125005,"Bad Friedrichshall, Stadt",50 - 55 Jahre,948,483,465
False,8125005,"Bad Friedrichshall, Stadt",55 - 60 Jahre,788,415,373
False,8125005,"Bad Friedrichshall, Stadt",60 - 65 Jahre,966,442,524
False,8125005,"Bad Friedrichshall, Stadt",65 - 75 Jahre,1402,668,734
False,8125005,"Bad Friedrichshall, Stadt",75 und mehr Jahre,1048,336,712
False,8125005,"Bad Friedrichshall, Stadt",Insgesamt,17847,8876,8971
False,8125006,"Bad Rappenau, Stadt",unter 3 Jahre,659,338,321
False,8125006,"Bad Rappenau, Stadt",3 -  6 Jahre,715,366,349
False,8125006,"Bad Rappenau, Stadt",6 - 10 Jahre,860,445,415
False,8125006,"Bad Rappenau, Stadt",10 - 15 Jahre,1186,614,572
False,8125006,"Bad Rappenau, Stadt",15 - 18 Jahre,686,336,350
False,8125006,"Bad Rappenau, Stadt",18 - 20 Jahre,450,221,229
False,8125006,"Bad Rappenau, Stadt",20 - 25 Jahre,1065,560,505
False,8125006,"Bad Rappenau, Stadt",25 - 30 Jahre,1196,603,593
False,8125006,"Bad Rappenau, Stadt",30 - 35 Jahre,1555,793,762
False,8125006,"Bad Rappenau, Stadt",35 - 40 Jahre,1863,923,940
False,8125006,"Bad Rappenau, Stadt",40 - 45 Jahre,1644,849,795
False,8125006,"Bad Rappenau, Stadt",45 - 50 Jahre,1332,687,645
False,8125006,"Bad Rappenau, Stadt",50 - 55 Jahre,1123,536,587
False,8125006,"Bad Rappenau, Stadt",55 - 60 Jahre,1053,545,508
False,8125006,"Bad Rappenau, Stadt",60 - 65 Jahre,1211,579,632
False,8125006,"Bad Rappenau, Stadt",65 - 75 Jahre,1810,807,1003
False,8125006,"Bad Rappenau, Stadt",75 und mehr Jahre,1476,493,983
False,8125006,"Bad Rappenau, Stadt",Insgesamt,19884,9695,10189
False,8125007,"Bad Wimpfen, Stadt",unter 3 Jahre,203,112,91
False,8125007,"Bad Wimpfen, Stadt",3 -  6 Jahre,175,82,93
False,8125007,"Bad Wimpfen, Stadt",6 - 10 Jahre,259,129,130
False,8125007,"Bad Wimpfen, Stadt",10 - 15 Jahre,372,196,176
False,8125007,"Bad Wimpfen, Stadt",15 - 18 Jahre,218,108,110
False,8125007,"Bad Wimpfen, Stadt",18 - 20 Jahre,149,75,74
False,8125007,"Bad Wimpfen, Stadt",20 - 25 Jahre,389,186,203
False,8125007,"Bad Wimpfen, Stadt",25 - 30 Jahre,415,212,203
False,8125007,"Bad Wimpfen, Stadt",30 - 35 Jahre,486,243,243
False,8125007,"Bad Wimpfen, Stadt",35 - 40 Jahre,519,280,239
False,8125007,"Bad Wimpfen, Stadt",40 - 45 Jahre,480,236,244
False,8125007,"Bad Wimpfen, Stadt",45 - 50 Jahre,480,231,249
False,8125007,"Bad Wimpfen, Stadt",50 - 55 Jahre,443,224,219
False,8125007,"Bad Wimpfen, Stadt",55 - 60 Jahre,414,206,208
False,8125007,"Bad Wimpfen, Stadt",60 - 65 Jahre,479,239,240
False,8125007,"Bad Wimpfen, Stadt",65 - 75 Jahre,648,308,340
False,8125007,"Bad Wimpfen, Stadt",75 und mehr Jahre,603,192,411
False,8125007,"Bad Wimpfen, Stadt",Insgesamt,6732,3259,3473
False,8125008,"Beilstein, Stadt",unter 3 Jahre,149,76,73
False,8125008,"Beilstein, Stadt",3 -  6 Jahre,185,96,89
False,8125008,"Beilstein, Stadt",6 - 10 Jahre,284,142,142
False,8125008,"Beilstein, Stadt",10 - 15 Jahre,417,200,217
False,8125008,"Beilstein, Stadt",15 - 18 Jahre,232,108,124
False,8125008,"Beilstein, Stadt",18 - 20 Jahre,147,72,75
False,8125008,"Beilstein, Stadt",20 - 25 Jahre,315,159,156
False,8125008,"Beilstein, Stadt",25 - 30 Jahre,318,159,159
False,8125008,"Beilstein, Stadt",30 - 35 Jahre,474,234,240
False,8125008,"Beilstein, Stadt",35 - 40 Jahre,445,239,206
False,8125008,"Beilstein, Stadt",40 - 45 Jahre,436,220,216
False,8125008,"Beilstein, Stadt",45 - 50 Jahre,397,185,212
False,8125008,"Beilstein, Stadt",50 - 55 Jahre,464,231,233
False,8125008,"Beilstein, Stadt",55 - 60 Jahre,441,215,226
False,8125008,"Beilstein, Stadt",60 - 65 Jahre,469,242,227
False,8125008,"Beilstein, Stadt",65 - 75 Jahre,509,243,266
False,8125008,"Beilstein, Stadt",75 und mehr Jahre,419,130,289
False,8125008,"Beilstein, Stadt",Insgesamt,6101,2951,3150
False,8125013,"Brackenheim, Stadt",unter 3 Jahre,557,319,238
False,8125013,"Brackenheim, Stadt",3 -  6 Jahre,596,301,295
False,8125013,"Brackenheim, Stadt",6 - 10 Jahre,760,413,347
False,8125013,"Brackenheim, Stadt",10 - 15 Jahre,1109,509,600
False,8125013,"Brackenheim, Stadt",15 - 18 Jahre,518,254,264
False,8125013,"Brackenheim, Stadt",18 - 20 Jahre,347,187,160
False,8125013,"Brackenheim, Stadt",20 - 25 Jahre,746,412,334
False,8125013,"Brackenheim, Stadt",25 - 30 Jahre,859,415,444
False,8125013,"Brackenheim, Stadt",30 - 35 Jahre,1235,600,635
False,8125013,"Brackenheim, Stadt",35 - 40 Jahre,1382,726,656
False,8125013,"Brackenheim, Stadt",40 - 45 Jahre,1136,582,554
False,8125013,"Brackenheim, Stadt",45 - 50 Jahre,994,487,507
False,8125013,"Brackenheim, Stadt",50 - 55 Jahre,774,423,351
False,8125013,"Brackenheim, Stadt",55 - 60 Jahre,709,352,357
False,8125013,"Brackenheim, Stadt",60 - 65 Jahre,782,394,388
False,8125013,"Brackenheim, Stadt",65 - 75 Jahre,1144,523,621
False,8125013,"Brackenheim, Stadt",75 und mehr Jahre,774,242,532
False,8125013,"Brackenheim, Stadt",Insgesamt,14422,7139,7283
False,8125017,Cleebronn,unter 3 Jahre,86,43,43
False,8125017,Cleebronn,3 -  6 Jahre,106,53,53
False,8125017,Cleebronn,6 - 10 Jahre,178,96,82
False,8125017,Cleebronn,10 - 15 Jahre,187,107,80
False,8125017,Cleebronn,15 - 18 Jahre,107,60,47
False,8125017,Cleebronn,18 - 20 Jahre,69,35,34
False,8125017,Cleebronn,20 - 25 Jahre,139,78,61
False,8125017,Cleebronn,25 - 30 Jahre,160,78,82
False,8125017,Cleebronn,30 - 35 Jahre,253,131,122
False,8125017,Cleebronn,35 - 40 Jahre,265,149,116
False,8125017,Cleebronn,40 - 45 Jahre,223,111,112
False,8125017,Cleebronn,45 - 50 Jahre,175,89,86
False,8125017,Cleebronn,50 - 55 Jahre,141,72,69
False,8125017,Cleebronn,55 - 60 Jahre,143,74,69
False,8125017,Cleebronn,60 - 65 Jahre,159,82,77
False,8125017,Cleebronn,65 - 75 Jahre,178,77,101
False,8125017,Cleebronn,75 und mehr Jahre,133,43,90
False,8125017,Cleebronn,Insgesamt,2702,1378,1324
False,8125021,Eberstadt,unter 3 Jahre,131,61,70
False,8125021,Eberstadt,3 -  6 Jahre,99,48,51
False,8125021,Eberstadt,6 - 10 Jahre,154,71,83
False,8125021,Eberstadt,10 - 15 Jahre,210,107,103
False,8125021,Eberstadt,15 - 18 Jahre,101,56,45
False,8125021,Eberstadt,18 - 20 Jahre,66,31,35
False,8125021,Eberstadt,20 - 25 Jahre,153,90,63
False,8125021,Eberstadt,25 - 30 Jahre,207,94,113
False,8125021,Eberstadt,30 - 35 Jahre,257,130,127
False,8125021,Eberstadt,35 - 40 Jahre,272,129,143
False,8125021,Eberstadt,40 - 45 Jahre,250,138,112
False,8125021,Eberstadt,45 - 50 Jahre,209,101,108
False,8125021,Eberstadt,50 - 55 Jahre,172,88,84
False,8125021,Eberstadt,55 - 60 Jahre,175,84,91
False,8125021,Eberstadt,60 - 65 Jahre,207,102,105
False,8125021,Eberstadt,65 - 75 Jahre,283,143,140
False,8125021,Eberstadt,75 und mehr Jahre,152,44,108
False,8125021,Eberstadt,Insgesamt,3098,1517,1581
False,8125024,Ellhofen,unter 3 Jahre,95,54,41
False,8125024,Ellhofen,3 -  6 Jahre,119,58,61
False,8125024,Ellhofen,6 - 10 Jahre,179,95,84
False,8125024,Ellhofen,10 - 15 Jahre,229,112,117
False,8125024,Ellhofen,15 - 18 Jahre,121,61,60
False,8125024,Ellhofen,18 - 20 Jahre,65,37,28
False,8125024,Ellhofen,20 - 25 Jahre,166,86,80
False,8125024,Ellhofen,25 - 30 Jahre,197,101,96
False,8125024,Ellhofen,30 - 35 Jahre,251,129,122
False,8125024,Ellhofen,35 - 40 Jahre,295,147,148
False,8125024,Ellhofen,40 - 45 Jahre,286,144,142
False,8125024,Ellhofen,45 - 50 Jahre,257,130,127
False,8125024,Ellhofen,50 - 55 Jahre,189,101,88
False,8125024,Ellhofen,55 - 60 Jahre,186,90,96
False,8125024,Ellhofen,60 - 65 Jahre,211,106,105
False,8125024,Ellhofen,65 - 75 Jahre,267,121,146
False,8125024,Ellhofen,75 und mehr Jahre,147,47,100
False,8125024,Ellhofen,Insgesamt,3260,1619,1641
False,8125026,"Eppingen, Stadt",unter 3 Jahre,733,355,378
False,8125026,"Eppingen, Stadt",3 -  6 Jahre,797,412,385
False,8125026,"Eppingen, Stadt",6 - 10 Jahre,1122,605,517
False,8125026,"Eppingen, Stadt",10 - 15 Jahre,1426,719,707
False,8125026,"Eppingen, Stadt",15 - 18 Jahre,712,349,363
False,8125026,"Eppingen, Stadt",18 - 20 Jahre,556,293,263
False,8125026,"Eppingen, Stadt",20 - 25 Jahre,1123,576,547
False,8125026,"Eppingen, Stadt",25 - 30 Jahre,1146,586,560
False,8125026,"Eppingen, Stadt",30 - 35 Jahre,1695,810,885
False,8125026,"Eppingen, Stadt",35 - 40 Jahre,1809,915,894
False,8125026,"Eppingen, Stadt",40 - 45 Jahre,1611,844,767
False,8125026,"Eppingen, Stadt",45 - 50 Jahre,1308,654,654
False,8125026,"Eppingen, Stadt",50 - 55 Jahre,1130,594,536
False,8125026,"Eppingen, Stadt",55 - 60 Jahre,846,442,404
False,8125026,"Eppingen, Stadt",60 - 65 Jahre,1230,580,650
False,8125026,"Eppingen, Stadt",65 - 75 Jahre,1688,767,921
False,8125026,"Eppingen, Stadt",75 und mehr Jahre,1325,371,954
False,8125026,"Eppingen, Stadt",Insgesamt,20257,9872,10385
False,8125027,Erlenbach,unter 3 Jahre,158,82,76
False,8125027,Erlenbach,3 -  6 Jahre,166,89,77
False,8125027,Erlenbach,6 - 10 Jahre,225,126,99
False,8125027,Erlenbach,10 - 15 Jahre,302,169,133
False,8125027,Erlenbach,15 - 18 Jahre,138,72,66
False,8125027,Erlenbach,18 - 20 Jahre,82,40,42
False,8125027,Erlenbach,20 - 25 Jahre,246,123,123
False,8125027,Erlenbach,25 - 30 Jahre,309,142,167
False,8125027,Erlenbach,30 - 35 Jahre,466,249,217
False,8125027,Erlenbach,35 - 40 Jahre,439,206,233
False,8125027,Erlenbach,40 - 45 Jahre,384,202,182
False,8125027,Erlenbach,45 - 50 Jahre,294,146,148
False,8125027,Erlenbach,50 - 55 Jahre,275,136,139
False,8125027,Erlenbach,55 - 60 Jahre,295,139,156
False,8125027,Erlenbach,60 - 65 Jahre,316,171,145
False,8125027,Erlenbach,65 - 75 Jahre,397,191,206
False,8125027,Erlenbach,75 und mehr Jahre,253,97,156
False,8125027,Erlenbach,Insgesamt,4745,2380,2365
False,8125030,Flein,unter 3 Jahre,178,85,93
False,8125030,Flein,3 -  6 Jahre,171,92,79
False,8125030,Flein,6 - 10 Jahre,234,104,130
False,8125030,Flein,10 - 15 Jahre,317,144,173
False,8125030,Flein,15 - 18 Jahre,164,71,93
False,8125030,Flein,18 - 20 Jahre,117,60,57
False,8125030,Flein,20 - 25 Jahre,273,116,157
False,8125030,Flein,25 - 30 Jahre,359,184,175
False,8125030,Flein,30 - 35 Jahre,523,235,288
False,8125030,Flein,35 - 40 Jahre,553,273,280
False,8125030,Flein,40 - 45 Jahre,453,230,223
False,8125030,Flein,45 - 50 Jahre,373,183,190
False,8125030,Flein,50 - 55 Jahre,410,185,225
False,8125030,Flein,55 - 60 Jahre,418,183,235
False,8125030,Flein,60 - 65 Jahre,516,256,260
False,8125030,Flein,65 - 75 Jahre,725,389,336
False,8125030,Flein,75 und mehr Jahre,464,173,291
False,8125030,Flein,Insgesamt,6248,2963,3285
False,8125034,Gemmingen,unter 3 Jahre,165,88,77
False,8125034,Gemmingen,3 -  6 Jahre,217,107,110
False,8125034,Gemmingen,6 - 10 Jahre,295,170,125
False,8125034,Gemmingen,10 - 15 Jahre,349,183,166
False,8125034,Gemmingen,15 - 18 Jahre,156,76,80
False,8125034,Gemmingen,18 - 20 Jahre,120,60,60
False,8125034,Gemmingen,20 - 25 Jahre,287,148,139
False,8125034,Gemmingen,25 - 30 Jahre,276,139,137
False,8125034,Gemmingen,30 - 35 Jahre,443,230,213
False,8125034,Gemmingen,35 - 40 Jahre,429,218,211
False,8125034,Gemmingen,40 - 45 Jahre,364,181,183
False,8125034,Gemmingen,45 - 50 Jahre,347,174,173
False,8125034,Gemmingen,50 - 55 Jahre,293,153,140
False,8125034,Gemmingen,55 - 60 Jahre,265,141,124
False,8125034,Gemmingen,60 - 65 Jahre,331,169,162
False,8125034,Gemmingen,65 - 75 Jahre,417,201,216
False,8125034,Gemmingen,75 und mehr Jahre,247,89,158
False,8125034,Gemmingen,Insgesamt,5001,2527,2474
False,8125038,"Güglingen, Stadt",unter 3 Jahre,226,116,110
False,8125038,"Güglingen, Stadt",3 -  6 Jahre,255,123,132
False,8125038,"Güglingen, Stadt",6 - 10 Jahre,328,167,161
False,8125038,"Güglingen, Stadt",10 - 15 Jahre,447,218,229
False,8125038,"Güglingen, Stadt",15 - 18 Jahre,260,119,141
False,8125038,"Güglingen, Stadt",18 - 20 Jahre,156,73,83
False,8125038,"Güglingen, Stadt",20 - 25 Jahre,345,181,164
False,8125038,"Güglingen, Stadt",25 - 30 Jahre,414,203,211
False,8125038,"Güglingen, Stadt",30 - 35 Jahre,515,288,227
False,8125038,"Güglingen, Stadt",35 - 40 Jahre,580,301,279
False,8125038,"Güglingen, Stadt",40 - 45 Jahre,440,231,209
False,8125038,"Güglingen, Stadt",45 - 50 Jahre,354,174,180
False,8125038,"Güglingen, Stadt",50 - 55 Jahre,357,179,178
False,8125038,"Güglingen, Stadt",55 - 60 Jahre,354,184,170
False,8125038,"Güglingen, Stadt",60 - 65 Jahre,320,154,166
False,8125038,"Güglingen, Stadt",65 - 75 Jahre,414,189,225
False,8125038,"Güglingen, Stadt",75 und mehr Jahre,305,109,196
False,8125038,"Güglingen, Stadt",Insgesamt,6070,3009,3061
False,8125039,"Gundelsheim, Stadt",unter 3 Jahre,260,136,124
False,8125039,"Gundelsheim, Stadt",3 -  6 Jahre,250,120,130
False,8125039,"Gundelsheim, Stadt",6 - 10 Jahre,356,177,179
False,8125039,"Gundelsheim, Stadt",10 - 15 Jahre,503,268,235
False,8125039,"Gundelsheim, Stadt",15 - 18 Jahre,239,122,117
False,8125039,"Gundelsheim, Stadt",18 - 20 Jahre,163,90,73
False,8125039,"Gundelsheim, Stadt",20 - 25 Jahre,409,208,201
False,8125039,"Gundelsheim, Stadt",25 - 30 Jahre,448,237,211
False,8125039,"Gundelsheim, Stadt",30 - 35 Jahre,615,315,300
False,8125039,"Gundelsheim, Stadt",35 - 40 Jahre,693,362,331
False,8125039,"Gundelsheim, Stadt",40 - 45 Jahre,581,324,257
False,8125039,"Gundelsheim, Stadt",45 - 50 Jahre,503,258,245
False,8125039,"Gundelsheim, Stadt",50 - 55 Jahre,454,239,215
False,8125039,"Gundelsheim, Stadt",55 - 60 Jahre,412,208,204
False,8125039,"Gundelsheim, Stadt",60 - 65 Jahre,467,246,221
False,8125039,"Gundelsheim, Stadt",65 - 75 Jahre,652,292,360
False,8125039,"Gundelsheim, Stadt",75 und mehr Jahre,579,140,439
False,8125039,"Gundelsheim, Stadt",Insgesamt,7584,3742,3842
False,8125046,Ilsfeld,unter 3 Jahre,255,120,135
False,8125046,Ilsfeld,3 -  6 Jahre,273,133,140
False,8125046,Ilsfeld,6 - 10 Jahre,396,199,197
False,8125046,Ilsfeld,10 - 15 Jahre,504,239,265
False,8125046,Ilsfeld,15 - 18 Jahre,263,134,129
False,8125046,Ilsfeld,18 - 20 Jahre,169,88,81
False,8125046,Ilsfeld,20 - 25 Jahre,410,206,204
False,8125046,Ilsfeld,25 - 30 Jahre,495,241,254
False,8125046,Ilsfeld,30 - 35 Jahre,682,349,333
False,8125046,Ilsfeld,35 - 40 Jahre,697,357,340
False,8125046,Ilsfeld,40 - 45 Jahre,618,339,279
False,8125046,Ilsfeld,45 - 50 Jahre,551,266,285
False,8125046,Ilsfeld,50 - 55 Jahre,523,268,255
False,8125046,Ilsfeld,55 - 60 Jahre,511,259,252
False,8125046,Ilsfeld,60 - 65 Jahre,538,263,275
False,8125046,Ilsfeld,65 - 75 Jahre,561,292,269
False,8125046,Ilsfeld,75 und mehr Jahre,411,132,279
False,8125046,Ilsfeld,Insgesamt,7857,3885,3972
False,8125047,Ittlingen,unter 3 Jahre,95,49,46
False,8125047,Ittlingen,3 -  6 Jahre,130,69,61
False,8125047,Ittlingen,6 - 10 Jahre,142,77,65
False,8125047,Ittlingen,10 - 15 Jahre,172,81,91
False,8125047,Ittlingen,15 - 18 Jahre,86,49,37
False,8125047,Ittlingen,18 - 20 Jahre,47,24,23
False,8125047,Ittlingen,20 - 25 Jahre,119,69,50
False,8125047,Ittlingen,25 - 30 Jahre,153,80,73
False,8125047,Ittlingen,30 - 35 Jahre,211,114,97
False,8125047,Ittlingen,35 - 40 Jahre,222,107,115
False,8125047,Ittlingen,40 - 45 Jahre,199,104,95
False,8125047,Ittlingen,45 - 50 Jahre,150,84,66
False,8125047,Ittlingen,50 - 55 Jahre,119,58,61
False,8125047,Ittlingen,55 - 60 Jahre,95,47,48
False,8125047,Ittlingen,60 - 65 Jahre,135,78,57
False,8125047,Ittlingen,65 - 75 Jahre,173,83,90
False,8125047,Ittlingen,75 und mehr Jahre,107,27,80
False,8125047,Ittlingen,Insgesamt,2355,1200,1155
False,8125048,Jagsthausen,unter 3 Jahre,63,34,29
False,8125048,Jagsthausen,3 -  6 Jahre,59,31,28
False,8125048,Jagsthausen,6 - 10 Jahre,83,47,36
False,8125048,Jagsthausen,10 - 15 Jahre,79,43,36
False,8125048,Jagsthausen,15 - 18 Jahre,54,27,27
False,8125048,Jagsthausen,18 - 20 Jahre,35,16,19
False,8125048,Jagsthausen,20 - 25 Jahre,78,46,32
False,8125048,Jagsthausen,25 - 30 Jahre,80,45,35
False,8125048,Jagsthausen,30 - 35 Jahre,93,58,35
False,8125048,Jagsthausen,35 - 40 Jahre,129,57,72
False,8125048,Jagsthausen,40 - 45 Jahre,121,68,53
False,8125048,Jagsthausen,45 - 50 Jahre,88,42,46
False,8125048,Jagsthausen,50 - 55 Jahre,89,38,51
False,8125048,Jagsthausen,55 - 60 Jahre,87,46,41
False,8125048,Jagsthausen,60 - 65 Jahre,110,58,52
False,8125048,Jagsthausen,65 - 75 Jahre,146,78,68
False,8125048,Jagsthausen,75 und mehr Jahre,106,31,75
False,8125048,Jagsthausen,Insgesamt,1500,765,735
False,8125049,Kirchardt,unter 3 Jahre,229,110,119
False,8125049,Kirchardt,3 -  6 Jahre,236,119,117
False,8125049,Kirchardt,6 - 10 Jahre,332,181,151
False,8125049,Kirchardt,10 - 15 Jahre,446,252,194
False,8125049,Kirchardt,15 - 18 Jahre,215,125,90
False,8125049,Kirchardt,18 - 20 Jahre,160,82,78
False,8125049,Kirchardt,20 - 25 Jahre,313,168,145
False,8125049,Kirchardt,25 - 30 Jahre,366,193,173
False,8125049,Kirchardt,30 - 35 Jahre,447,240,207
False,8125049,Kirchardt,35 - 40 Jahre,436,215,221
False,8125049,Kirchardt,40 - 45 Jahre,401,218,183
False,8125049,Kirchardt,45 - 50 Jahre,356,181,175
False,8125049,Kirchardt,50 - 55 Jahre,288,136,152
False,8125049,Kirchardt,55 - 60 Jahre,256,124,132
False,8125049,Kirchardt,60 - 65 Jahre,317,173,144
False,8125049,Kirchardt,65 - 75 Jahre,399,182,217
False,8125049,Kirchardt,75 und mehr Jahre,219,77,142
False,8125049,Kirchardt,Insgesamt,5416,2776,2640
False,8125056,"Lauffen am Neckar, Stadt",unter 3 Jahre,367,189,178
False,8125056,"Lauffen am Neckar, Stadt",3 -  6 Jahre,397,225,172
False,8125056,"Lauffen am Neckar, Stadt",6 - 10 Jahre,521,263,258
False,8125056,"Lauffen am Neckar, Stadt",10 - 15 Jahre,742,379,363
False,8125056,"Lauffen am Neckar, Stadt",15 - 18 Jahre,352,173,179
False,8125056,"Lauffen am Neckar, Stadt",18 - 20 Jahre,240,134,106
False,8125056,"Lauffen am Neckar, Stadt",20 - 25 Jahre,587,300,287
False,8125056,"Lauffen am Neckar, Stadt",25 - 30 Jahre,611,269,342
False,8125056,"Lauffen am Neckar, Stadt",30 - 35 Jahre,869,412,457
False,8125056,"Lauffen am Neckar, Stadt",35 - 40 Jahre,1055,571,484
False,8125056,"Lauffen am Neckar, Stadt",40 - 45 Jahre,870,464,406
False,8125056,"Lauffen am Neckar, Stadt",45 - 50 Jahre,729,359,370
False,8125056,"Lauffen am Neckar, Stadt",50 - 55 Jahre,666,325,341
False,8125056,"Lauffen am Neckar, Stadt",55 - 60 Jahre,564,291,273
False,8125056,"Lauffen am Neckar, Stadt",60 - 65 Jahre,690,359,331
False,8125056,"Lauffen am Neckar, Stadt",65 - 75 Jahre,936,416,520
False,8125056,"Lauffen am Neckar, Stadt",75 und mehr Jahre,772,219,553
False,8125056,"Lauffen am Neckar, Stadt",Insgesamt,10968,5348,5620
False,8125057,Lehrensteinsfeld,unter 3 Jahre,56,35,21
False,8125057,Lehrensteinsfeld,3 -  6 Jahre,70,37,33
False,8125057,Lehrensteinsfeld,6 - 10 Jahre,100,56,44
False,8125057,Lehrensteinsfeld,10 - 15 Jahre,105,60,45
False,8125057,Lehrensteinsfeld,15 - 18 Jahre,56,27,29
False,8125057,Lehrensteinsfeld,18 - 20 Jahre,48,28,20
False,8125057,Lehrensteinsfeld,20 - 25 Jahre,94,55,39
False,8125057,Lehrensteinsfeld,25 - 30 Jahre,75,40,35
False,8125057,Lehrensteinsfeld,30 - 35 Jahre,149,73,76
False,8125057,Lehrensteinsfeld,35 - 40 Jahre,168,86,82
False,8125057,Lehrensteinsfeld,40 - 45 Jahre,128,71,57
False,8125057,Lehrensteinsfeld,45 - 50 Jahre,138,61,77
False,8125057,Lehrensteinsfeld,50 - 55 Jahre,147,70,77
False,8125057,Lehrensteinsfeld,55 - 60 Jahre,121,61,60
False,8125057,Lehrensteinsfeld,60 - 65 Jahre,124,78,46
False,8125057,Lehrensteinsfeld,65 - 75 Jahre,144,61,83
False,8125057,Lehrensteinsfeld,75 und mehr Jahre,103,37,66
False,8125057,Lehrensteinsfeld,Insgesamt,1826,936,890
False,8125058,Leingarten,unter 3 Jahre,373,184,189
False,8125058,Leingarten,3 -  6 Jahre,400,208,192
False,8125058,Leingarten,6 - 10 Jahre,501,250,251
False,8125058,Leingarten,10 - 15 Jahre,634,341,293
False,8125058,Leingarten,15 - 18 Jahre,340,175,165
False,8125058,Leingarten,18 - 20 Jahre,219,108,111
False,8125058,Leingarten,20 - 25 Jahre,520,262,258
False,8125058,Leingarten,25 - 30 Jahre,649,320,329
False,8125058,Leingarten,30 - 35 Jahre,889,497,392
False,8125058,Leingarten,35 - 40 Jahre,967,468,499
False,8125058,Leingarten,40 - 45 Jahre,780,386,394
False,8125058,Leingarten,45 - 50 Jahre,707,357,350
False,8125058,Leingarten,50 - 55 Jahre,604,288,316
False,8125058,Leingarten,55 - 60 Jahre,588,296,292
False,8125058,Leingarten,60 - 65 Jahre,603,306,297
False,8125058,Leingarten,65 - 75 Jahre,808,373,435
False,8125058,Leingarten,75 und mehr Jahre,540,179,361
False,8125058,Leingarten,Insgesamt,10122,4998,5124
False,8125059,"Löwenstein, Stadt",unter 3 Jahre,82,44,38
False,8125059,"Löwenstein, Stadt",3 -  6 Jahre,97,44,53
False,8125059,"Löwenstein, Stadt",6 - 10 Jahre,153,80,73
False,8125059,"Löwenstein, Stadt",10 - 15 Jahre,167,81,86
False,8125059,"Löwenstein, Stadt",15 - 18 Jahre,90,42,48
False,8125059,"Löwenstein, Stadt",18 - 20 Jahre,62,26,36
False,8125059,"Löwenstein, Stadt",20 - 25 Jahre,171,81,90
False,8125059,"Löwenstein, Stadt",25 - 30 Jahre,145,68,77
False,8125059,"Löwenstein, Stadt",30 - 35 Jahre,255,142,113
False,8125059,"Löwenstein, Stadt",35 - 40 Jahre,313,162,151
False,8125059,"Löwenstein, Stadt",40 - 45 Jahre,285,138,147
False,8125059,"Löwenstein, Stadt",45 - 50 Jahre,267,136,131
False,8125059,"Löwenstein, Stadt",50 - 55 Jahre,199,112,87
False,8125059,"Löwenstein, Stadt",55 - 60 Jahre,145,69,76
False,8125059,"Löwenstein, Stadt",60 - 65 Jahre,185,87,98
False,8125059,"Löwenstein, Stadt",65 - 75 Jahre,243,105,138
False,8125059,"Löwenstein, Stadt",75 und mehr Jahre,166,54,112
False,8125059,"Löwenstein, Stadt",Insgesamt,3025,1471,1554
False,8125061,Massenbachhausen,unter 3 Jahre,130,68,62
False,8125061,Massenbachhausen,3 -  6 Jahre,131,55,76
False,8125061,Massenbachhausen,6 - 10 Jahre,202,114,88
False,8125061,Massenbachhausen,10 - 15 Jahre,287,161,126
False,8125061,Massenbachhausen,15 - 18 Jahre,154,74,80
False,8125061,Massenbachhausen,18 - 20 Jahre,76,32,44
False,8125061,Massenbachhausen,20 - 25 Jahre,209,107,102
False,8125061,Massenbachhausen,25 - 30 Jahre,219,107,112
False,8125061,Massenbachhausen,30 - 35 Jahre,334,172,162
False,8125061,Massenbachhausen,35 - 40 Jahre,377,205,172
False,8125061,Massenbachhausen,40 - 45 Jahre,308,153,155
False,8125061,Massenbachhausen,45 - 50 Jahre,261,133,128
False,8125061,Massenbachhausen,50 - 55 Jahre,186,98,88
False,8125061,Massenbachhausen,55 - 60 Jahre,191,98,93
False,8125061,Massenbachhausen,60 - 65 Jahre,220,108,112
False,8125061,Massenbachhausen,65 - 75 Jahre,294,146,148
False,8125061,Massenbachhausen,75 und mehr Jahre,158,43,115
False,8125061,Massenbachhausen,Insgesamt,3737,1874,1863
False,8125063,"Möckmühl, Stadt",unter 3 Jahre,249,115,134
False,8125063,"Möckmühl, Stadt",3 -  6 Jahre,294,160,134
False,8125063,"Möckmühl, Stadt",6 - 10 Jahre,456,234,222
False,8125063,"Möckmühl, Stadt",10 - 15 Jahre,587,298,289
False,8125063,"Möckmühl, Stadt",15 - 18 Jahre,321,172,149
False,8125063,"Möckmühl, Stadt",18 - 20 Jahre,220,123,97
False,8125063,"Möckmühl, Stadt",20 - 25 Jahre,471,252,219
False,8125063,"Möckmühl, Stadt",25 - 30 Jahre,529,291,238
False,8125063,"Möckmühl, Stadt",30 - 35 Jahre,654,372,282
False,8125063,"Möckmühl, Stadt",35 - 40 Jahre,735,408,327
False,8125063,"Möckmühl, Stadt",40 - 45 Jahre,706,380,326
False,8125063,"Möckmühl, Stadt",45 - 50 Jahre,601,328,273
False,8125063,"Möckmühl, Stadt",50 - 55 Jahre,454,220,234
False,8125063,"Möckmühl, Stadt",55 - 60 Jahre,372,184,188
False,8125063,"Möckmühl, Stadt",60 - 65 Jahre,481,239,242
False,8125063,"Möckmühl, Stadt",65 - 75 Jahre,715,328,387
False,8125063,"Möckmühl, Stadt",75 und mehr Jahre,536,174,362
False,8125063,"Möckmühl, Stadt",Insgesamt,8381,4278,4103
False,8125065,"Neckarsulm, Stadt",unter 3 Jahre,898,452,446
False,8125065,"Neckarsulm, Stadt",3 -  6 Jahre,943,463,480
False,8125065,"Neckarsulm, Stadt",6 - 10 Jahre,1258,665,593
False,8125065,"Neckarsulm, Stadt",10 - 15 Jahre,1690,891,799
False,8125065,"Neckarsulm, Stadt",15 - 18 Jahre,1026,521,505
False,8125065,"Neckarsulm, Stadt",18 - 20 Jahre,668,332,336
False,8125065,"Neckarsulm, Stadt",20 - 25 Jahre,1741,922,819
False,8125065,"Neckarsulm, Stadt",25 - 30 Jahre,1922,1028,894
False,8125065,"Neckarsulm, Stadt",30 - 35 Jahre,2311,1266,1045
False,8125065,"Neckarsulm, Stadt",35 - 40 Jahre,2291,1164,1127
False,8125065,"Neckarsulm, Stadt",40 - 45 Jahre,2105,1121,984
False,8125065,"Neckarsulm, Stadt",45 - 50 Jahre,1852,960,892
False,8125065,"Neckarsulm, Stadt",50 - 55 Jahre,1568,797,771
False,8125065,"Neckarsulm, Stadt",55 - 60 Jahre,1460,744,716
False,8125065,"Neckarsulm, Stadt",60 - 65 Jahre,1658,823,835
False,8125065,"Neckarsulm, Stadt",65 - 75 Jahre,2348,1082,1266
False,8125065,"Neckarsulm, Stadt",75 und mehr Jahre,1669,541,1128
False,8125065,"Neckarsulm, Stadt",Insgesamt,27408,13772,13636
False,8125066,Neckarwestheim,unter 3 Jahre,123,58,65
False,8125066,Neckarwestheim,3 -  6 Jahre,133,68,65
False,8125066,Neckarwestheim,6 - 10 Jahre,183,83,100
False,8125066,Neckarwestheim,10 - 15 Jahre,242,126,116
False,8125066,Neckarwestheim,15 - 18 Jahre,114,52,62
False,8125066,Neckarwestheim,18 - 20 Jahre,68,31,37
False,8125066,Neckarwestheim,20 - 25 Jahre,188,89,99
False,8125066,Neckarwestheim,25 - 30 Jahre,219,100,119
False,8125066,Neckarwestheim,30 - 35 Jahre,348,180,168
False,8125066,Neckarwestheim,35 - 40 Jahre,363,192,171
False,8125066,Neckarwestheim,40 - 45 Jahre,276,147,129
False,8125066,Neckarwestheim,45 - 50 Jahre,229,124,105
False,8125066,Neckarwestheim,50 - 55 Jahre,219,109,110
False,8125066,Neckarwestheim,55 - 60 Jahre,213,108,105
False,8125066,Neckarwestheim,60 - 65 Jahre,202,110,92
False,8125066,Neckarwestheim,65 - 75 Jahre,230,108,122
False,8125066,Neckarwestheim,75 und mehr Jahre,120,42,78
False,8125066,Neckarwestheim,Insgesamt,3470,1727,1743
False,8125068,"Neudenau, Stadt",unter 3 Jahre,156,77,79
False,8125068,"Neudenau, Stadt",3 -  6 Jahre,184,98,86
False,8125068,"Neudenau, Stadt",6 - 10 Jahre,238,120,118
False,8125068,"Neudenau, Stadt",10 - 15 Jahre,306,149,157
False,8125068,"Neudenau, Stadt",15 - 18 Jahre,166,93,73
False,8125068,"Neudenau, Stadt",18 - 20 Jahre,112,58,54
False,8125068,"Neudenau, Stadt",20 - 25 Jahre,277,150,127
False,8125068,"Neudenau, Stadt",25 - 30 Jahre,346,162,184
False,8125068,"Neudenau, Stadt",30 - 35 Jahre,442,229,213
False,8125068,"Neudenau, Stadt",35 - 40 Jahre,417,223,194
False,8125068,"Neudenau, Stadt",40 - 45 Jahre,395,216,179
False,8125068,"Neudenau, Stadt",45 - 50 Jahre,339,168,171
False,8125068,"Neudenau, Stadt",50 - 55 Jahre,288,159,129
False,8125068,"Neudenau, Stadt",55 - 60 Jahre,238,110,128
False,8125068,"Neudenau, Stadt",60 - 65 Jahre,314,161,153
False,8125068,"Neudenau, Stadt",65 - 75 Jahre,446,193,253
False,8125068,"Neudenau, Stadt",75 und mehr Jahre,342,110,232
False,8125068,"Neudenau, Stadt",Insgesamt,5006,2476,2530
False,8125069,"Neuenstadt am Kocher, Stadt",unter 3 Jahre,303,164,139
False,8125069,"Neuenstadt am Kocher, Stadt",3 -  6 Jahre,346,173,173
False,8125069,"Neuenstadt am Kocher, Stadt",6 - 10 Jahre,469,255,214
False,8125069,"Neuenstadt am Kocher, Stadt",10 - 15 Jahre,586,294,292
False,8125069,"Neuenstadt am Kocher, Stadt",15 - 18 Jahre,358,197,161
False,8125069,"Neuenstadt am Kocher, Stadt",18 - 20 Jahre,215,128,87
False,8125069,"Neuenstadt am Kocher, Stadt",20 - 25 Jahre,557,279,278
False,8125069,"Neuenstadt am Kocher, Stadt",25 - 30 Jahre,591,313,278
False,8125069,"Neuenstadt am Kocher, Stadt",30 - 35 Jahre,755,382,373
False,8125069,"Neuenstadt am Kocher, Stadt",35 - 40 Jahre,811,427,384
False,8125069,"Neuenstadt am Kocher, Stadt",40 - 45 Jahre,712,388,324
False,8125069,"Neuenstadt am Kocher, Stadt",45 - 50 Jahre,682,334,348
False,8125069,"Neuenstadt am Kocher, Stadt",50 - 55 Jahre,531,265,266
False,8125069,"Neuenstadt am Kocher, Stadt",55 - 60 Jahre,449,244,205
False,8125069,"Neuenstadt am Kocher, Stadt",60 - 65 Jahre,548,265,283
False,8125069,"Neuenstadt am Kocher, Stadt",65 - 75 Jahre,673,324,349
False,8125069,"Neuenstadt am Kocher, Stadt",75 und mehr Jahre,541,164,377
False,8125069,"Neuenstadt am Kocher, Stadt",Insgesamt,9127,4596,4531
False,8125074,Nordheim,unter 3 Jahre,253,130,123
False,8125074,Nordheim,3 -  6 Jahre,294,146,148
False,8125074,Nordheim,6 - 10 Jahre,383,207,176
False,8125074,Nordheim,10 - 15 Jahre,476,247,229
False,8125074,Nordheim,15 - 18 Jahre,256,134,122
False,8125074,Nordheim,18 - 20 Jahre,141,76,65
False,8125074,Nordheim,20 - 25 Jahre,386,200,186
False,8125074,Nordheim,25 - 30 Jahre,433,202,231
False,8125074,Nordheim,30 - 35 Jahre,641,324,317
False,8125074,Nordheim,35 - 40 Jahre,692,349,343
False,8125074,Nordheim,40 - 45 Jahre,511,254,257
False,8125074,Nordheim,45 - 50 Jahre,485,230,255
False,8125074,Nordheim,50 - 55 Jahre,438,220,218
False,8125074,Nordheim,55 - 60 Jahre,406,197,209
False,8125074,Nordheim,60 - 65 Jahre,435,225,210
False,8125074,Nordheim,65 - 75 Jahre,602,275,327
False,8125074,Nordheim,75 und mehr Jahre,426,144,282
False,8125074,Nordheim,Insgesamt,7258,3560,3698
False,8125078,Oedheim,unter 3 Jahre,204,90,114
False,8125078,Oedheim,3 -  6 Jahre,220,107,113
False,8125078,Oedheim,6 - 10 Jahre,310,170,140
False,8125078,Oedheim,10 - 15 Jahre,394,209,185
False,8125078,Oedheim,15 - 18 Jahre,178,92,86
False,8125078,Oedheim,18 - 20 Jahre,137,68,69
False,8125078,Oedheim,20 - 25 Jahre,284,148,136
False,8125078,Oedheim,25 - 30 Jahre,354,198,156
False,8125078,Oedheim,30 - 35 Jahre,560,279,281
False,8125078,Oedheim,35 - 40 Jahre,566,307,259
False,8125078,Oedheim,40 - 45 Jahre,472,240,232
False,8125078,Oedheim,45 - 50 Jahre,358,197,161
False,8125078,Oedheim,50 - 55 Jahre,331,166,165
False,8125078,Oedheim,55 - 60 Jahre,314,155,159
False,8125078,Oedheim,60 - 65 Jahre,367,179,188
False,8125078,Oedheim,65 - 75 Jahre,469,231,238
False,8125078,Oedheim,75 und mehr Jahre,308,106,202
False,8125078,Oedheim,Insgesamt,5826,2942,2884
False,8125079,Offenau,unter 3 Jahre,94,47,47
False,8125079,Offenau,3 -  6 Jahre,103,38,65
False,8125079,Offenau,6 - 10 Jahre,143,78,65
False,8125079,Offenau,10 - 15 Jahre,157,82,75
False,8125079,Offenau,15 - 18 Jahre,107,57,50
False,8125079,Offenau,18 - 20 Jahre,55,31,24
False,8125079,Offenau,20 - 25 Jahre,120,66,54
False,8125079,Offenau,25 - 30 Jahre,163,79,84
False,8125079,Offenau,30 - 35 Jahre,241,130,111
False,8125079,Offenau,35 - 40 Jahre,243,117,126
False,8125079,Offenau,40 - 45 Jahre,217,120,97
False,8125079,Offenau,45 - 50 Jahre,169,92,77
False,8125079,Offenau,50 - 55 Jahre,139,72,67
False,8125079,Offenau,55 - 60 Jahre,148,77,71
False,8125079,Offenau,60 - 65 Jahre,183,95,88
False,8125079,Offenau,65 - 75 Jahre,234,115,119
False,8125079,Offenau,75 und mehr Jahre,141,42,99
False,8125079,Offenau,Insgesamt,2657,1338,1319
False,8125081,Pfaffenhofen,unter 3 Jahre,53,27,26
False,8125081,Pfaffenhofen,3 -  6 Jahre,83,50,33
False,8125081,Pfaffenhofen,6 - 10 Jahre,110,60,50
False,8125081,Pfaffenhofen,10 - 15 Jahre,212,102,110
False,8125081,Pfaffenhofen,15 - 18 Jahre,109,51,58
False,8125081,Pfaffenhofen,18 - 20 Jahre,69,32,37
False,8125081,Pfaffenhofen,20 - 25 Jahre,110,53,57
False,8125081,Pfaffenhofen,25 - 30 Jahre,101,59,42
False,8125081,Pfaffenhofen,30 - 35 Jahre,139,70,69
False,8125081,Pfaffenhofen,35 - 40 Jahre,182,88,94
False,8125081,Pfaffenhofen,40 - 45 Jahre,236,123,113
False,8125081,Pfaffenhofen,45 - 50 Jahre,158,84,74
False,8125081,Pfaffenhofen,50 - 55 Jahre,146,75,71
False,8125081,Pfaffenhofen,55 - 60 Jahre,119,64,55
False,8125081,Pfaffenhofen,60 - 65 Jahre,130,66,64
False,8125081,Pfaffenhofen,65 - 75 Jahre,203,97,106
False,8125081,Pfaffenhofen,75 und mehr Jahre,157,47,110
False,8125081,Pfaffenhofen,Insgesamt,2317,1148,1169
False,8125084,Roigheim,unter 3 Jahre,52,26,26
False,8125084,Roigheim,3 -  6 Jahre,59,35,24
False,8125084,Roigheim,6 - 10 Jahre,74,31,43
False,8125084,Roigheim,10 - 15 Jahre,74,36,38
False,8125084,Roigheim,15 - 18 Jahre,42,21,21
False,8125084,Roigheim,18 - 20 Jahre,30,17,13
False,8125084,Roigheim,20 - 25 Jahre,84,39,45
False,8125084,Roigheim,25 - 30 Jahre,87,45,42
False,8125084,Roigheim,30 - 35 Jahre,94,50,44
False,8125084,Roigheim,35 - 40 Jahre,128,64,64
False,8125084,Roigheim,40 - 45 Jahre,118,51,67
False,8125084,Roigheim,45 - 50 Jahre,81,42,39
False,8125084,Roigheim,50 - 55 Jahre,83,45,38
False,8125084,Roigheim,55 - 60 Jahre,64,33,31
False,8125084,Roigheim,60 - 65 Jahre,110,53,57
False,8125084,Roigheim,65 - 75 Jahre,138,65,73
False,8125084,Roigheim,75 und mehr Jahre,103,36,67
False,8125084,Roigheim,Insgesamt,1421,689,732
False,8125086,"Schwaigern, Stadt",unter 3 Jahre,360,189,171
False,8125086,"Schwaigern, Stadt",3 -  6 Jahre,419,216,203
False,8125086,"Schwaigern, Stadt",6 - 10 Jahre,618,339,279
False,8125086,"Schwaigern, Stadt",10 - 15 Jahre,782,421,361
False,8125086,"Schwaigern, Stadt",15 - 18 Jahre,395,186,209
False,8125086,"Schwaigern, Stadt",18 - 20 Jahre,265,129,136
False,8125086,"Schwaigern, Stadt",20 - 25 Jahre,558,263,295
False,8125086,"Schwaigern, Stadt",25 - 30 Jahre,649,329,320
False,8125086,"Schwaigern, Stadt",30 - 35 Jahre,901,449,452
False,8125086,"Schwaigern, Stadt",35 - 40 Jahre,976,497,479
False,8125086,"Schwaigern, Stadt",40 - 45 Jahre,884,461,423
False,8125086,"Schwaigern, Stadt",45 - 50 Jahre,697,374,323
False,8125086,"Schwaigern, Stadt",50 - 55 Jahre,576,292,284
False,8125086,"Schwaigern, Stadt",55 - 60 Jahre,553,277,276
False,8125086,"Schwaigern, Stadt",60 - 65 Jahre,655,324,331
False,8125086,"Schwaigern, Stadt",65 - 75 Jahre,884,404,480
False,8125086,"Schwaigern, Stadt",75 und mehr Jahre,591,199,392
False,8125086,"Schwaigern, Stadt",Insgesamt,10763,5349,5414
False,8125087,Siegelsbach,unter 3 Jahre,67,38,29
False,8125087,Siegelsbach,3 -  6 Jahre,74,43,31
False,8125087,Siegelsbach,6 - 10 Jahre,80,36,44
False,8125087,Siegelsbach,10 - 15 Jahre,122,66,56
False,8125087,Siegelsbach,15 - 18 Jahre,44,21,23
False,8125087,Siegelsbach,18 - 20 Jahre,29,16,13
False,8125087,Siegelsbach,20 - 25 Jahre,94,40,54
False,8125087,Siegelsbach,25 - 30 Jahre,121,64,57
False,8125087,Siegelsbach,30 - 35 Jahre,157,83,74
False,8125087,Siegelsbach,35 - 40 Jahre,164,81,83
False,8125087,Siegelsbach,40 - 45 Jahre,113,59,54
False,8125087,Siegelsbach,45 - 50 Jahre,100,50,50
False,8125087,Siegelsbach,50 - 55 Jahre,99,54,45
False,8125087,Siegelsbach,55 - 60 Jahre,68,32,36
False,8125087,Siegelsbach,60 - 65 Jahre,102,50,52
False,8125087,Siegelsbach,65 - 75 Jahre,133,65,68
False,8125087,Siegelsbach,75 und mehr Jahre,97,32,65
False,8125087,Siegelsbach,Insgesamt,1664,830,834
False,8125094,Talheim,unter 3 Jahre,151,77,74
False,8125094,Talheim,3 -  6 Jahre,162,70,92
False,8125094,Talheim,6 - 10 Jahre,223,124,99
False,8125094,Talheim,10 - 15 Jahre,288,160,128
False,8125094,Talheim,15 - 18 Jahre,135,74,61
False,8125094,Talheim,18 - 20 Jahre,89,41,48
False,8125094,Talheim,20 - 25 Jahre,221,110,111
False,8125094,Talheim,25 - 30 Jahre,256,118,138
False,8125094,Talheim,30 - 35 Jahre,403,203,200
False,8125094,Talheim,35 - 40 Jahre,454,225,229
False,8125094,Talheim,40 - 45 Jahre,402,221,181
False,8125094,Talheim,45 - 50 Jahre,318,165,153
False,8125094,Talheim,50 - 55 Jahre,309,147,162
False,8125094,Talheim,55 - 60 Jahre,290,155,135
False,8125094,Talheim,60 - 65 Jahre,316,162,154
False,8125094,Talheim,65 - 75 Jahre,376,181,195
False,8125094,Talheim,75 und mehr Jahre,270,92,178
False,8125094,Talheim,Insgesamt,4663,2325,2338
False,8125096,Untereisesheim,unter 3 Jahre,116,62,54
False,8125096,Untereisesheim,3 -  6 Jahre,149,80,69
False,8125096,Untereisesheim,6 - 10 Jahre,189,96,93
False,8125096,Untereisesheim,10 - 15 Jahre,236,120,116
False,8125096,Untereisesheim,15 - 18 Jahre,134,68,66
False,8125096,Untereisesheim,18 - 20 Jahre,120,46,74
False,8125096,Untereisesheim,20 - 25 Jahre,252,127,125
False,8125096,Untereisesheim,25 - 30 Jahre,237,109,128
False,8125096,Untereisesheim,30 - 35 Jahre,360,205,155
False,8125096,Untereisesheim,35 - 40 Jahre,317,155,162
False,8125096,Untereisesheim,40 - 45 Jahre,319,171,148
False,8125096,Untereisesheim,45 - 50 Jahre,292,137,155
False,8125096,Untereisesheim,50 - 55 Jahre,292,146,146
False,8125096,Untereisesheim,55 - 60 Jahre,212,108,104
False,8125096,Untereisesheim,60 - 65 Jahre,203,100,103
False,8125096,Untereisesheim,65 - 75 Jahre,266,129,137
False,8125096,Untereisesheim,75 und mehr Jahre,164,53,111
False,8125096,Untereisesheim,Insgesamt,3858,1912,1946
False,8125098,Untergruppenbach,unter 3 Jahre,247,138,109
False,8125098,Untergruppenbach,3 -  6 Jahre,271,151,120
False,8125098,Untergruppenbach,6 - 10 Jahre,345,156,189
False,8125098,Untergruppenbach,10 - 15 Jahre,412,218,194
False,8125098,Untergruppenbach,15 - 18 Jahre,244,110,134
False,8125098,Untergruppenbach,18 - 20 Jahre,176,91,85
False,8125098,Untergruppenbach,20 - 25 Jahre,380,183,197
False,8125098,Untergruppenbach,25 - 30 Jahre,424,209,215
False,8125098,Untergruppenbach,30 - 35 Jahre,631,294,337
False,8125098,Untergruppenbach,35 - 40 Jahre,675,372,303
False,8125098,Untergruppenbach,40 - 45 Jahre,591,313,278
False,8125098,Untergruppenbach,45 - 50 Jahre,521,238,283
False,8125098,Untergruppenbach,50 - 55 Jahre,469,235,234
False,8125098,Untergruppenbach,55 - 60 Jahre,509,246,263
False,8125098,Untergruppenbach,60 - 65 Jahre,526,275,251
False,8125098,Untergruppenbach,65 - 75 Jahre,684,333,351
False,8125098,Untergruppenbach,75 und mehr Jahre,438,161,277
False,8125098,Untergruppenbach,Insgesamt,7543,3723,3820
False,8125102,"Weinsberg, Stadt",unter 3 Jahre,330,158,172
False,8125102,"Weinsberg, Stadt",3 -  6 Jahre,350,182,168
False,8125102,"Weinsberg, Stadt",6 - 10 Jahre,523,267,256
False,8125102,"Weinsberg, Stadt",10 - 15 Jahre,710,358,352
False,8125102,"Weinsberg, Stadt",15 - 18 Jahre,432,235,197
False,8125102,"Weinsberg, Stadt",18 - 20 Jahre,261,120,141
False,8125102,"Weinsberg, Stadt",20 - 25 Jahre,631,301,330
False,8125102,"Weinsberg, Stadt",25 - 30 Jahre,684,356,328
False,8125102,"Weinsberg, Stadt",30 - 35 Jahre,975,497,478
False,8125102,"Weinsberg, Stadt",35 - 40 Jahre,1036,548,488
False,8125102,"Weinsberg, Stadt",40 - 45 Jahre,913,484,429
False,8125102,"Weinsberg, Stadt",45 - 50 Jahre,780,361,419
False,8125102,"Weinsberg, Stadt",50 - 55 Jahre,668,331,337
False,8125102,"Weinsberg, Stadt",55 - 60 Jahre,634,316,318
False,8125102,"Weinsberg, Stadt",60 - 65 Jahre,759,371,388
False,8125102,"Weinsberg, Stadt",65 - 75 Jahre,1062,497,565
False,8125102,"Weinsberg, Stadt",75 und mehr Jahre,811,264,547
False,8125102,"Weinsberg, Stadt",Insgesamt,11559,5646,5913
False,8125103,"Widdern, Stadt",unter 3 Jahre,70,36,34
False,8125103,"Widdern, Stadt",3 -  6 Jahre,100,55,45
False,8125103,"Widdern, Stadt",6 - 10 Jahre,100,41,59
False,8125103,"Widdern, Stadt",10 - 15 Jahre,122,64,58
False,8125103,"Widdern, Stadt",15 - 18 Jahre,72,41,31
False,8125103,"Widdern, Stadt",18 - 20 Jahre,42,17,25
False,8125103,"Widdern, Stadt",20 - 25 Jahre,85,43,42
False,8125103,"Widdern, Stadt",25 - 30 Jahre,92,43,49
False,8125103,"Widdern, Stadt",30 - 35 Jahre,164,76,88
False,8125103,"Widdern, Stadt",35 - 40 Jahre,163,85,78
False,8125103,"Widdern, Stadt",40 - 45 Jahre,154,82,72
False,8125103,"Widdern, Stadt",45 - 50 Jahre,116,70,46
False,8125103,"Widdern, Stadt",50 - 55 Jahre,101,48,53
False,8125103,"Widdern, Stadt",55 - 60 Jahre,78,42,36
False,8125103,"Widdern, Stadt",60 - 65 Jahre,109,53,56
False,8125103,"Widdern, Stadt",65 - 75 Jahre,163,87,76
False,8125103,"Widdern, Stadt",75 und mehr Jahre,140,46,94
False,8125103,"Widdern, Stadt",Insgesamt,1871,929,942
False,8125107,Wüstenrot,unter 3 Jahre,218,107,111
False,8125107,Wüstenrot,3 -  6 Jahre,249,125,124
False,8125107,Wüstenrot,6 - 10 Jahre,355,190,165
False,8125107,Wüstenrot,10 - 15 Jahre,462,222,240
False,8125107,Wüstenrot,15 - 18 Jahre,216,109,107
False,8125107,Wüstenrot,18 - 20 Jahre,139,70,69
False,8125107,Wüstenrot,20 - 25 Jahre,302,160,142
False,8125107,Wüstenrot,25 - 30 Jahre,329,174,155
False,8125107,Wüstenrot,30 - 35 Jahre,496,243,253
False,8125107,Wüstenrot,35 - 40 Jahre,590,294,296
False,8125107,Wüstenrot,40 - 45 Jahre,506,264,242
False,8125107,Wüstenrot,45 - 50 Jahre,438,233,205
False,8125107,Wüstenrot,50 - 55 Jahre,369,189,180
False,8125107,Wüstenrot,55 - 60 Jahre,306,162,144
False,8125107,Wüstenrot,60 - 65 Jahre,396,207,189
False,8125107,Wüstenrot,65 - 75 Jahre,673,299,374
False,8125107,Wüstenrot,75 und mehr Jahre,738,206,532
False,8125107,Wüstenrot,Insgesamt,6782,3254,3528
False,8125108,Zaberfeld,unter 3 Jahre,120,55,65
False,8125108,Zaberfeld,3 -  6 Jahre,146,77,69
False,8125108,Zaberfeld,6 - 10 Jahre,230,117,113
False,8125108,Zaberfeld,10 - 15 Jahre,286,146,140
False,8125108,Zaberfeld,15 - 18 Jahre,134,67,67
False,8125108,Zaberfeld,18 - 20 Jahre,81,41,40
False,8125108,Zaberfeld,20 - 25 Jahre,218,111,107
False,8125108,Zaberfeld,25 - 30 Jahre,197,99,98
False,8125108,Zaberfeld,30 - 35 Jahre,287,142,145
False,8125108,Zaberfeld,35 - 40 Jahre,363,179,184
False,8125108,Zaberfeld,40 - 45 Jahre,340,165,175
False,8125108,Zaberfeld,45 - 50 Jahre,267,145,122
False,8125108,Zaberfeld,50 - 55 Jahre,221,125,96
False,8125108,Zaberfeld,55 - 60 Jahre,189,100,89
False,8125108,Zaberfeld,60 - 65 Jahre,240,110,130
False,8125108,Zaberfeld,65 - 75 Jahre,316,154,162
False,8125108,Zaberfeld,75 und mehr Jahre,215,67,148
False,8125108,Zaberfeld,Insgesamt,3850,1900,1950
False,8125110,Obersulm,unter 3 Jahre,411,217,194
False,8125110,Obersulm,3 -  6 Jahre,472,235,237
False,8125110,Obersulm,6 - 10 Jahre,621,327,294
False,8125110,Obersulm,10 - 15 Jahre,822,418,404
False,8125110,Obersulm,15 - 18 Jahre,433,223,210
False,8125110,Obersulm,18 - 20 Jahre,281,146,135
False,8125110,Obersulm,20 - 25 Jahre,776,394,382
False,8125110,Obersulm,25 - 30 Jahre,819,420,399
False,8125110,Obersulm,30 - 35 Jahre,1065,563,502
False,8125110,Obersulm,35 - 40 Jahre,1224,652,572
False,8125110,Obersulm,40 - 45 Jahre,1098,567,531
False,8125110,Obersulm,45 - 50 Jahre,820,430,390
False,8125110,Obersulm,50 - 55 Jahre,771,376,395
False,8125110,Obersulm,55 - 60 Jahre,782,401,381
False,8125110,Obersulm,60 - 65 Jahre,871,439,432
False,8125110,Obersulm,65 - 75 Jahre,1200,554,646
False,8125110,Obersulm,75 und mehr Jahre,847,284,563
False,8125110,Obersulm,Insgesamt,13313,6646,6667
False,8125111,Hardthausen am Kocher,unter 3 Jahre,152,79,73
False,8125111,Hardthausen am Kocher,3 -  6 Jahre,142,76,66
False,8125111,Hardthausen am Kocher,6 - 10 Jahre,232,126,106
False,8125111,Hardthausen am Kocher,10 - 15 Jahre,287,144,143
False,8125111,Hardthausen am Kocher,15 - 18 Jahre,147,78,69
False,8125111,Hardthausen am Kocher,18 - 20 Jahre,80,34,46
False,8125111,Hardthausen am Kocher,20 - 25 Jahre,195,104,91
False,8125111,Hardthausen am Kocher,25 - 30 Jahre,237,120,117
False,8125111,Hardthausen am Kocher,30 - 35 Jahre,339,169,170
False,8125111,Hardthausen am Kocher,35 - 40 Jahre,399,215,184
False,8125111,Hardthausen am Kocher,40 - 45 Jahre,317,156,161
False,8125111,Hardthausen am Kocher,45 - 50 Jahre,257,135,122
False,8125111,Hardthausen am Kocher,50 - 55 Jahre,178,103,75
False,8125111,Hardthausen am Kocher,55 - 60 Jahre,147,68,79
False,8125111,Hardthausen am Kocher,60 - 65 Jahre,233,107,126
False,8125111,Hardthausen am Kocher,65 - 75 Jahre,298,153,145
False,8125111,Hardthausen am Kocher,75 und mehr Jahre,186,55,131
False,8125111,Hardthausen am Kocher,Insgesamt,3826,1922,1904
False,8125113,Langenbrettach,unter 3 Jahre,124,61,63
False,8125113,Langenbrettach,3 -  6 Jahre,122,65,57
False,8125113,Langenbrettach,6 - 10 Jahre,197,102,95
False,8125113,Langenbrettach,10 - 15 Jahre,240,112,128
False,8125113,Langenbrettach,15 - 18 Jahre,137,78,59
False,8125113,Langenbrettach,18 - 20 Jahre,70,35,35
False,8125113,Langenbrettach,20 - 25 Jahre,198,95,103
False,8125113,Langenbrettach,25 - 30 Jahre,204,102,102
False,8125113,Langenbrettach,30 - 35 Jahre,302,148,154
False,8125113,Langenbrettach,35 - 40 Jahre,318,165,153
False,8125113,Langenbrettach,40 - 45 Jahre,273,132,141
False,8125113,Langenbrettach,45 - 50 Jahre,223,112,111
False,8125113,Langenbrettach,50 - 55 Jahre,177,90,87
False,8125113,Langenbrettach,55 - 60 Jahre,154,76,78
False,8125113,Langenbrettach,60 - 65 Jahre,161,95,66
False,8125113,Langenbrettach,65 - 75 Jahre,246,118,128
False,8125113,Langenbrettach,75 und mehr Jahre,163,58,105
False,8125113,Langenbrettach,Insgesamt,3309,1644,1665
False,8126,Landkreis Hohenlohekreis,unter 3 Jahre,3509,1839,1670
False,8126,Landkreis Hohenlohekreis,3 -  6 Jahre,3802,1959,1843
False,8126,Landkreis Hohenlohekreis,6 - 10 Jahre,5407,2690,2717
False,8126,Landkreis Hohenlohekreis,10 - 15 Jahre,7040,3561,3479
False,8126,Landkreis Hohenlohekreis,15 - 18 Jahre,3950,2080,1870
False,8126,Landkreis Hohenlohekreis,18 - 20 Jahre,2680,1431,1249
False,8126,Landkreis Hohenlohekreis,20 - 25 Jahre,6344,3201,3143
False,8126,Landkreis Hohenlohekreis,25 - 30 Jahre,6701,3467,3234
False,8126,Landkreis Hohenlohekreis,30 - 35 Jahre,8690,4464,4226
False,8126,Landkreis Hohenlohekreis,35 - 40 Jahre,9441,4936,4505
False,8126,Landkreis Hohenlohekreis,40 - 45 Jahre,8494,4406,4088
False,8126,Landkreis Hohenlohekreis,45 - 50 Jahre,7298,3753,3545
False,8126,Landkreis Hohenlohekreis,50 - 55 Jahre,5986,3157,2829
False,8126,Landkreis Hohenlohekreis,55 - 60 Jahre,5200,2615,2585
False,8126,Landkreis Hohenlohekreis,60 - 65 Jahre,6429,3168,3261
False,8126,Landkreis Hohenlohekreis,65 - 75 Jahre,9483,4425,5058
False,8126,Landkreis Hohenlohekreis,75 und mehr Jahre,7300,2365,4935
False,8126,Landkreis Hohenlohekreis,Insgesamt,107754,53517,54237
False,8126011,Bretzfeld,unter 3 Jahre,404,201,203
False,8126011,Bretzfeld,3 -  6 Jahre,448,238,210
False,8126011,Bretzfeld,6 - 10 Jahre,679,349,330
False,8126011,Bretzfeld,10 - 15 Jahre,809,415,394
False,8126011,Bretzfeld,15 - 18 Jahre,438,217,221
False,8126011,Bretzfeld,18 - 20 Jahre,271,148,123
False,8126011,Bretzfeld,20 - 25 Jahre,638,313,325
False,8126011,Bretzfeld,25 - 30 Jahre,736,365,371
False,8126011,Bretzfeld,30 - 35 Jahre,993,512,481
False,8126011,Bretzfeld,35 - 40 Jahre,1101,543,558
False,8126011,Bretzfeld,40 - 45 Jahre,976,489,487
False,8126011,Bretzfeld,45 - 50 Jahre,853,436,417
False,8126011,Bretzfeld,50 - 55 Jahre,690,369,321
False,8126011,Bretzfeld,55 - 60 Jahre,511,261,250
False,8126011,Bretzfeld,60 - 65 Jahre,584,282,302
False,8126011,Bretzfeld,65 - 75 Jahre,941,446,495
False,8126011,Bretzfeld,75 und mehr Jahre,681,216,465
False,8126011,Bretzfeld,Insgesamt,11753,5800,5953
False,8126020,Dörzbach,unter 3 Jahre,94,51,43
False,8126020,Dörzbach,3 -  6 Jahre,82,44,38
False,8126020,Dörzbach,6 - 10 Jahre,127,62,65
False,8126020,Dörzbach,10 - 15 Jahre,169,89,80
False,8126020,Dörzbach,15 - 18 Jahre,80,42,38
False,8126020,Dörzbach,18 - 20 Jahre,63,36,27
False,8126020,Dörzbach,20 - 25 Jahre,134,61,73
False,8126020,Dörzbach,25 - 30 Jahre,153,76,77
False,8126020,Dörzbach,30 - 35 Jahre,204,108,96
False,8126020,Dörzbach,35 - 40 Jahre,225,118,107
False,8126020,Dörzbach,40 - 45 Jahre,171,93,78
False,8126020,Dörzbach,45 - 50 Jahre,161,85,76
False,8126020,Dörzbach,50 - 55 Jahre,121,63,58
False,8126020,Dörzbach,55 - 60 Jahre,95,52,43
False,8126020,Dörzbach,60 - 65 Jahre,139,72,67
False,8126020,Dörzbach,65 - 75 Jahre,205,93,112
False,8126020,Dörzbach,75 und mehr Jahre,154,56,98
False,8126020,Dörzbach,Insgesamt,2377,1201,1176
False,8126028,"Forchtenberg, Stadt",unter 3 Jahre,152,78,74
False,8126028,"Forchtenberg, Stadt",3 -  6 Jahre,190,98,92
False,8126028,"Forchtenberg, Stadt",6 - 10 Jahre,298,145,153
False,8126028,"Forchtenberg, Stadt",10 - 15 Jahre,363,181,182
False,8126028,"Forchtenberg, Stadt",15 - 18 Jahre,186,104,82
False,8126028,"Forchtenberg, Stadt",18 - 20 Jahre,113,66,47
False,8126028,"Forchtenberg, Stadt",20 - 25 Jahre,275,132,143
False,8126028,"Forchtenberg, Stadt",25 - 30 Jahre,296,158,138
False,8126028,"Forchtenberg, Stadt",30 - 35 Jahre,411,210,201
False,8126028,"Forchtenberg, Stadt",35 - 40 Jahre,454,237,217
False,8126028,"Forchtenberg, Stadt",40 - 45 Jahre,371,186,185
False,8126028,"Forchtenberg, Stadt",45 - 50 Jahre,336,178,158
False,8126028,"Forchtenberg, Stadt",50 - 55 Jahre,289,161,128
False,8126028,"Forchtenberg, Stadt",55 - 60 Jahre,227,119,108
False,8126028,"Forchtenberg, Stadt",60 - 65 Jahre,288,146,142
False,8126028,"Forchtenberg, Stadt",65 - 75 Jahre,459,220,239
False,8126028,"Forchtenberg, Stadt",75 und mehr Jahre,320,97,223
False,8126028,"Forchtenberg, Stadt",Insgesamt,5028,2516,2512
False,8126039,"Ingelfingen, Stadt",unter 3 Jahre,211,122,89
False,8126039,"Ingelfingen, Stadt",3 -  6 Jahre,206,101,105
False,8126039,"Ingelfingen, Stadt",6 - 10 Jahre,287,138,149
False,8126039,"Ingelfingen, Stadt",10 - 15 Jahre,353,168,185
False,8126039,"Ingelfingen, Stadt",15 - 18 Jahre,210,114,96
False,8126039,"Ingelfingen, Stadt",18 - 20 Jahre,134,68,66
False,8126039,"Ingelfingen, Stadt",20 - 25 Jahre,337,163,174
False,8126039,"Ingelfingen, Stadt",25 - 30 Jahre,349,168,181
False,8126039,"Ingelfingen, Stadt",30 - 35 Jahre,511,263,248
False,8126039,"Ingelfingen, Stadt",35 - 40 Jahre,478,256,222
False,8126039,"Ingelfingen, Stadt",40 - 45 Jahre,423,218,205
False,8126039,"Ingelfingen, Stadt",45 - 50 Jahre,389,196,193
False,8126039,"Ingelfingen, Stadt",50 - 55 Jahre,316,161,155
False,8126039,"Ingelfingen, Stadt",55 - 60 Jahre,296,155,141
False,8126039,"Ingelfingen, Stadt",60 - 65 Jahre,368,187,181
False,8126039,"Ingelfingen, Stadt",65 - 75 Jahre,527,235,292
False,8126039,"Ingelfingen, Stadt",75 und mehr Jahre,472,145,327
False,8126039,"Ingelfingen, Stadt",Insgesamt,5867,2858,3009
False,8126045,"Krautheim, Stadt",unter 3 Jahre,161,99,62
False,8126045,"Krautheim, Stadt",3 -  6 Jahre,187,101,86
False,8126045,"Krautheim, Stadt",6 - 10 Jahre,226,127,99
False,8126045,"Krautheim, Stadt",10 - 15 Jahre,308,143,165
False,8126045,"Krautheim, Stadt",15 - 18 Jahre,175,95,80
False,8126045,"Krautheim, Stadt",18 - 20 Jahre,99,51,48
False,8126045,"Krautheim, Stadt",20 - 25 Jahre,258,136,122
False,8126045,"Krautheim, Stadt",25 - 30 Jahre,296,149,147
False,8126045,"Krautheim, Stadt",30 - 35 Jahre,398,207,191
False,8126045,"Krautheim, Stadt",35 - 40 Jahre,477,260,217
False,8126045,"Krautheim, Stadt",40 - 45 Jahre,388,201,187
False,8126045,"Krautheim, Stadt",45 - 50 Jahre,297,167,130
False,8126045,"Krautheim, Stadt",50 - 55 Jahre,246,120,126
False,8126045,"Krautheim, Stadt",55 - 60 Jahre,193,103,90
False,8126045,"Krautheim, Stadt",60 - 65 Jahre,304,151,153
False,8126045,"Krautheim, Stadt",65 - 75 Jahre,454,216,238
False,8126045,"Krautheim, Stadt",75 und mehr Jahre,315,101,214
False,8126045,"Krautheim, Stadt",Insgesamt,4782,2427,2355
False,8126046,"Künzelsau, Stadt",unter 3 Jahre,437,226,211
False,8126046,"Künzelsau, Stadt",3 -  6 Jahre,461,206,255
False,8126046,"Künzelsau, Stadt",6 - 10 Jahre,648,322,326
False,8126046,"Künzelsau, Stadt",10 - 15 Jahre,911,465,446
False,8126046,"Künzelsau, Stadt",15 - 18 Jahre,548,297,251
False,8126046,"Künzelsau, Stadt",18 - 20 Jahre,390,197,193
False,8126046,"Künzelsau, Stadt",20 - 25 Jahre,898,479,419
False,8126046,"Künzelsau, Stadt",25 - 30 Jahre,964,516,448
False,8126046,"Künzelsau, Stadt",30 - 35 Jahre,1131,580,551
False,8126046,"Künzelsau, Stadt",35 - 40 Jahre,1170,611,559
False,8126046,"Künzelsau, Stadt",40 - 45 Jahre,1181,606,575
False,8126046,"Künzelsau, Stadt",45 - 50 Jahre,997,502,495
False,8126046,"Künzelsau, Stadt",50 - 55 Jahre,806,411,395
False,8126046,"Künzelsau, Stadt",55 - 60 Jahre,746,381,365
False,8126046,"Künzelsau, Stadt",60 - 65 Jahre,911,447,464
False,8126046,"Künzelsau, Stadt",65 - 75 Jahre,1388,622,766
False,8126046,"Künzelsau, Stadt",75 und mehr Jahre,1232,386,846
False,8126046,"Künzelsau, Stadt",Insgesamt,14819,7254,7565
False,8126047,Kupferzell,unter 3 Jahre,196,96,100
False,8126047,Kupferzell,3 -  6 Jahre,217,115,102
False,8126047,Kupferzell,6 - 10 Jahre,326,162,164
False,8126047,Kupferzell,10 - 15 Jahre,407,201,206
False,8126047,Kupferzell,15 - 18 Jahre,234,128,106
False,8126047,Kupferzell,18 - 20 Jahre,137,75,62
False,8126047,Kupferzell,20 - 25 Jahre,320,170,150
False,8126047,Kupferzell,25 - 30 Jahre,387,182,205
False,8126047,Kupferzell,30 - 35 Jahre,508,272,236
False,8126047,Kupferzell,35 - 40 Jahre,523,251,272
False,8126047,Kupferzell,40 - 45 Jahre,475,239,236
False,8126047,Kupferzell,45 - 50 Jahre,378,191,187
False,8126047,Kupferzell,50 - 55 Jahre,295,160,135
False,8126047,Kupferzell,55 - 60 Jahre,224,118,106
False,8126047,Kupferzell,60 - 65 Jahre,288,134,154
False,8126047,Kupferzell,65 - 75 Jahre,423,214,209
False,8126047,Kupferzell,75 und mehr Jahre,275,87,188
False,8126047,Kupferzell,Insgesamt,5613,2795,2818
False,8126056,Mulfingen,unter 3 Jahre,141,74,67
False,8126056,Mulfingen,3 -  6 Jahre,139,71,68
False,8126056,Mulfingen,6 - 10 Jahre,208,107,101
False,8126056,Mulfingen,10 - 15 Jahre,317,173,144
False,8126056,Mulfingen,15 - 18 Jahre,167,85,82
False,8126056,Mulfingen,18 - 20 Jahre,112,61,51
False,8126056,Mulfingen,20 - 25 Jahre,195,99,96
False,8126056,Mulfingen,25 - 30 Jahre,224,126,98
False,8126056,Mulfingen,30 - 35 Jahre,277,158,119
False,8126056,Mulfingen,35 - 40 Jahre,344,174,170
False,8126056,Mulfingen,40 - 45 Jahre,315,165,150
False,8126056,Mulfingen,45 - 50 Jahre,241,132,109
False,8126056,Mulfingen,50 - 55 Jahre,211,125,86
False,8126056,Mulfingen,55 - 60 Jahre,142,65,77
False,8126056,Mulfingen,60 - 65 Jahre,195,106,89
False,8126056,Mulfingen,65 - 75 Jahre,345,166,179
False,8126056,Mulfingen,75 und mehr Jahre,275,91,184
False,8126056,Mulfingen,Insgesamt,3848,1978,1870
False,8126058,"Neuenstein, Stadt",unter 3 Jahre,191,99,92
False,8126058,"Neuenstein, Stadt",3 -  6 Jahre,266,151,115
False,8126058,"Neuenstein, Stadt",6 - 10 Jahre,315,164,151
False,8126058,"Neuenstein, Stadt",10 - 15 Jahre,413,214,199
False,8126058,"Neuenstein, Stadt",15 - 18 Jahre,253,135,118
False,8126058,"Neuenstein, Stadt",18 - 20 Jahre,152,82,70
False,8126058,"Neuenstein, Stadt",20 - 25 Jahre,361,195,166
False,8126058,"Neuenstein, Stadt",25 - 30 Jahre,345,167,178
False,8126058,"Neuenstein, Stadt",30 - 35 Jahre,506,269,237
False,8126058,"Neuenstein, Stadt",35 - 40 Jahre,560,290,270
False,8126058,"Neuenstein, Stadt",40 - 45 Jahre,494,264,230
False,8126058,"Neuenstein, Stadt",45 - 50 Jahre,417,218,199
False,8126058,"Neuenstein, Stadt",50 - 55 Jahre,363,197,166
False,8126058,"Neuenstein, Stadt",55 - 60 Jahre,252,132,120
False,8126058,"Neuenstein, Stadt",60 - 65 Jahre,364,174,190
False,8126058,"Neuenstein, Stadt",65 - 75 Jahre,514,238,276
False,8126058,"Neuenstein, Stadt",75 und mehr Jahre,398,144,254
False,8126058,"Neuenstein, Stadt",Insgesamt,6164,3133,3031
False,8126060,"Niedernhall, Stadt",unter 3 Jahre,141,81,60
False,8126060,"Niedernhall, Stadt",3 -  6 Jahre,127,62,65
False,8126060,"Niedernhall, Stadt",6 - 10 Jahre,182,92,90
False,8126060,"Niedernhall, Stadt",10 - 15 Jahre,229,105,124
False,8126060,"Niedernhall, Stadt",15 - 18 Jahre,134,79,55
False,8126060,"Niedernhall, Stadt",18 - 20 Jahre,84,46,38
False,8126060,"Niedernhall, Stadt",20 - 25 Jahre,271,140,131
False,8126060,"Niedernhall, Stadt",25 - 30 Jahre,284,161,123
False,8126060,"Niedernhall, Stadt",30 - 35 Jahre,318,163,155
False,8126060,"Niedernhall, Stadt",35 - 40 Jahre,326,169,157
False,8126060,"Niedernhall, Stadt",40 - 45 Jahre,303,169,134
False,8126060,"Niedernhall, Stadt",45 - 50 Jahre,277,138,139
False,8126060,"Niedernhall, Stadt",50 - 55 Jahre,267,128,139
False,8126060,"Niedernhall, Stadt",55 - 60 Jahre,203,109,94
False,8126060,"Niedernhall, Stadt",60 - 65 Jahre,265,130,135
False,8126060,"Niedernhall, Stadt",65 - 75 Jahre,328,158,170
False,8126060,"Niedernhall, Stadt",75 und mehr Jahre,232,78,154
False,8126060,"Niedernhall, Stadt",Insgesamt,3971,2008,1963
False,8126066,"Öhringen, Stadt",unter 3 Jahre,675,341,334
False,8126066,"Öhringen, Stadt",3 -  6 Jahre,719,389,330
False,8126066,"Öhringen, Stadt",6 - 10 Jahre,1011,502,509
False,8126066,"Öhringen, Stadt",10 - 15 Jahre,1381,707,674
False,8126066,"Öhringen, Stadt",15 - 18 Jahre,790,405,385
False,8126066,"Öhringen, Stadt",18 - 20 Jahre,601,321,280
False,8126066,"Öhringen, Stadt",20 - 25 Jahre,1348,670,678
False,8126066,"Öhringen, Stadt",25 - 30 Jahre,1349,693,656
False,8126066,"Öhringen, Stadt",30 - 35 Jahre,1599,803,796
False,8126066,"Öhringen, Stadt",35 - 40 Jahre,1879,1002,877
False,8126066,"Öhringen, Stadt",40 - 45 Jahre,1828,934,894
False,8126066,"Öhringen, Stadt",45 - 50 Jahre,1578,779,799
False,8126066,"Öhringen, Stadt",50 - 55 Jahre,1227,664,563
False,8126066,"Öhringen, Stadt",55 - 60 Jahre,1164,555,609
False,8126066,"Öhringen, Stadt",60 - 65 Jahre,1366,655,711
False,8126066,"Öhringen, Stadt",65 - 75 Jahre,2076,953,1123
False,8126066,"Öhringen, Stadt",75 und mehr Jahre,1617,522,1095
False,8126066,"Öhringen, Stadt",Insgesamt,22208,10895,11313
False,8126069,Pfedelbach,unter 3 Jahre,303,164,139
False,8126069,Pfedelbach,3 -  6 Jahre,328,166,162
False,8126069,Pfedelbach,6 - 10 Jahre,441,213,228
False,8126069,Pfedelbach,10 - 15 Jahre,526,255,271
False,8126069,Pfedelbach,15 - 18 Jahre,300,148,152
False,8126069,Pfedelbach,18 - 20 Jahre,194,108,86
False,8126069,Pfedelbach,20 - 25 Jahre,440,227,213
False,8126069,Pfedelbach,25 - 30 Jahre,547,299,248
False,8126069,Pfedelbach,30 - 35 Jahre,741,364,377
False,8126069,Pfedelbach,35 - 40 Jahre,764,410,354
False,8126069,Pfedelbach,40 - 45 Jahre,650,353,297
False,8126069,Pfedelbach,45 - 50 Jahre,553,280,273
False,8126069,Pfedelbach,50 - 55 Jahre,508,246,262
False,8126069,Pfedelbach,55 - 60 Jahre,508,255,253
False,8126069,Pfedelbach,60 - 65 Jahre,552,274,278
False,8126069,Pfedelbach,65 - 75 Jahre,732,358,374
False,8126069,Pfedelbach,75 und mehr Jahre,494,168,326
False,8126069,Pfedelbach,Insgesamt,8581,4288,4293
False,8126072,Schöntal,unter 3 Jahre,196,101,95
False,8126072,Schöntal,3 -  6 Jahre,201,111,90
False,8126072,Schöntal,6 - 10 Jahre,304,136,168
False,8126072,Schöntal,10 - 15 Jahre,400,213,187
False,8126072,Schöntal,15 - 18 Jahre,193,109,84
False,8126072,Schöntal,18 - 20 Jahre,120,70,50
False,8126072,Schöntal,20 - 25 Jahre,282,161,121
False,8126072,Schöntal,25 - 30 Jahre,346,181,165
False,8126072,Schöntal,30 - 35 Jahre,493,261,232
False,8126072,Schöntal,35 - 40 Jahre,519,279,240
False,8126072,Schöntal,40 - 45 Jahre,445,242,203
False,8126072,Schöntal,45 - 50 Jahre,385,205,180
False,8126072,Schöntal,50 - 55 Jahre,306,169,137
False,8126072,Schöntal,55 - 60 Jahre,281,135,146
False,8126072,Schöntal,60 - 65 Jahre,419,212,207
False,8126072,Schöntal,65 - 75 Jahre,561,266,295
False,8126072,Schöntal,75 und mehr Jahre,415,132,283
False,8126072,Schöntal,Insgesamt,5866,2983,2883
False,8126085,"Waldenburg, Stadt",unter 3 Jahre,84,47,37
False,8126085,"Waldenburg, Stadt",3 -  6 Jahre,84,34,50
False,8126085,"Waldenburg, Stadt",6 - 10 Jahre,151,67,84
False,8126085,"Waldenburg, Stadt",10 - 15 Jahre,195,107,88
False,8126085,"Waldenburg, Stadt",15 - 18 Jahre,126,68,58
False,8126085,"Waldenburg, Stadt",18 - 20 Jahre,121,48,73
False,8126085,"Waldenburg, Stadt",20 - 25 Jahre,353,138,215
False,8126085,"Waldenburg, Stadt",25 - 30 Jahre,191,93,98
False,8126085,"Waldenburg, Stadt",30 - 35 Jahre,272,123,149
False,8126085,"Waldenburg, Stadt",35 - 40 Jahre,277,145,132
False,8126085,"Waldenburg, Stadt",40 - 45 Jahre,199,103,96
False,8126085,"Waldenburg, Stadt",45 - 50 Jahre,191,108,83
False,8126085,"Waldenburg, Stadt",50 - 55 Jahre,137,77,60
False,8126085,"Waldenburg, Stadt",55 - 60 Jahre,170,86,84
False,8126085,"Waldenburg, Stadt",60 - 65 Jahre,162,83,79
False,8126085,"Waldenburg, Stadt",65 - 75 Jahre,220,100,120
False,8126085,"Waldenburg, Stadt",75 und mehr Jahre,146,44,102
False,8126085,"Waldenburg, Stadt",Insgesamt,3079,1471,1608
False,8126086,Weißbach,unter 3 Jahre,71,35,36
False,8126086,Weißbach,3 -  6 Jahre,78,41,37
False,8126086,Weißbach,6 - 10 Jahre,123,59,64
False,8126086,Weißbach,10 - 15 Jahre,158,76,82
False,8126086,Weißbach,15 - 18 Jahre,72,36,36
False,8126086,Weißbach,18 - 20 Jahre,54,31,23
False,8126086,Weißbach,20 - 25 Jahre,126,59,67
False,8126086,Weißbach,25 - 30 Jahre,138,75,63
False,8126086,Weißbach,30 - 35 Jahre,185,87,98
False,8126086,Weißbach,35 - 40 Jahre,186,98,88
False,8126086,Weißbach,40 - 45 Jahre,156,83,73
False,8126086,Weißbach,45 - 50 Jahre,141,83,58
False,8126086,Weißbach,50 - 55 Jahre,114,54,60
False,8126086,Weißbach,55 - 60 Jahre,124,57,67
False,8126086,Weißbach,60 - 65 Jahre,133,67,66
False,8126086,Weißbach,65 - 75 Jahre,156,71,85
False,8126086,Weißbach,75 und mehr Jahre,111,44,67
False,8126086,Weißbach,Insgesamt,2126,1056,1070
False,8126094,Zweiflingen,unter 3 Jahre,52,24,28
False,8126094,Zweiflingen,3 -  6 Jahre,69,31,38
False,8126094,Zweiflingen,6 - 10 Jahre,81,45,36
False,8126094,Zweiflingen,10 - 15 Jahre,101,49,52
False,8126094,Zweiflingen,15 - 18 Jahre,44,18,26
False,8126094,Zweiflingen,18 - 20 Jahre,35,23,12
False,8126094,Zweiflingen,20 - 25 Jahre,108,58,50
False,8126094,Zweiflingen,25 - 30 Jahre,96,58,38
False,8126094,Zweiflingen,30 - 35 Jahre,143,84,59
False,8126094,Zweiflingen,35 - 40 Jahre,158,93,65
False,8126094,Zweiflingen,40 - 45 Jahre,119,61,58
False,8126094,Zweiflingen,45 - 50 Jahre,104,55,49
False,8126094,Zweiflingen,50 - 55 Jahre,90,52,38
False,8126094,Zweiflingen,55 - 60 Jahre,64,32,32
False,8126094,Zweiflingen,60 - 65 Jahre,91,48,43
False,8126094,Zweiflingen,65 - 75 Jahre,154,69,85
False,8126094,Zweiflingen,75 und mehr Jahre,163,54,109
False,8126094,Zweiflingen,Insgesamt,1672,854,818
False,8127,Landkreis Schwäbisch Hall,unter 3 Jahre,6163,3174,2989
False,8127,Landkreis Schwäbisch Hall,3 -  6 Jahre,6781,3445,3336
False,8127,Landkreis Schwäbisch Hall,6 - 10 Jahre,9419,4846,4573
False,8127,Landkreis Schwäbisch Hall,10 - 15 Jahre,12393,6332,6061
False,8127,Landkreis Schwäbisch Hall,15 - 18 Jahre,7201,3797,3404
False,8127,Landkreis Schwäbisch Hall,18 - 20 Jahre,4753,2473,2280
False,8127,Landkreis Schwäbisch Hall,20 - 25 Jahre,10573,5467,5106
False,8127,Landkreis Schwäbisch Hall,25 - 30 Jahre,10866,5439,5427
False,8127,Landkreis Schwäbisch Hall,30 - 35 Jahre,14727,7548,7179
False,8127,Landkreis Schwäbisch Hall,35 - 40 Jahre,15784,8111,7673
False,8127,Landkreis Schwäbisch Hall,40 - 45 Jahre,14592,7438,7154
False,8127,Landkreis Schwäbisch Hall,45 - 50 Jahre,12808,6451,6357
False,8127,Landkreis Schwäbisch Hall,50 - 55 Jahre,10592,5463,5129
False,8127,Landkreis Schwäbisch Hall,55 - 60 Jahre,9052,4535,4517
False,8127,Landkreis Schwäbisch Hall,60 - 65 Jahre,10986,5404,5582
False,8127,Landkreis Schwäbisch Hall,65 - 75 Jahre,15918,7314,8604
False,8127,Landkreis Schwäbisch Hall,75 und mehr Jahre,13120,4120,9000
False,8127,Landkreis Schwäbisch Hall,Insgesamt,185728,91357,94371
False,8127008,Blaufelden,unter 3 Jahre,189,106,83
False,8127008,Blaufelden,3 -  6 Jahre,215,111,104
False,8127008,Blaufelden,6 - 10 Jahre,294,149,145
False,8127008,Blaufelden,10 - 15 Jahre,352,172,180
False,8127008,Blaufelden,15 - 18 Jahre,216,122,94
False,8127008,Blaufelden,18 - 20 Jahre,128,77,51
False,8127008,Blaufelden,20 - 25 Jahre,307,153,154
False,8127008,Blaufelden,25 - 30 Jahre,302,143,159
False,8127008,Blaufelden,30 - 35 Jahre,393,200,193
False,8127008,Blaufelden,35 - 40 Jahre,418,228,190
False,8127008,Blaufelden,40 - 45 Jahre,392,207,185
False,8127008,Blaufelden,45 - 50 Jahre,347,186,161
False,8127008,Blaufelden,50 - 55 Jahre,292,150,142
False,8127008,Blaufelden,55 - 60 Jahre,215,115,100
False,8127008,Blaufelden,60 - 65 Jahre,339,161,178
False,8127008,Blaufelden,65 - 75 Jahre,452,224,228
False,8127008,Blaufelden,75 und mehr Jahre,432,140,292
False,8127008,Blaufelden,Insgesamt,5283,2644,2639
False,8127009,Braunsbach,unter 3 Jahre,89,32,57
False,8127009,Braunsbach,3 -  6 Jahre,93,51,42
False,8127009,Braunsbach,6 - 10 Jahre,131,65,66
False,8127009,Braunsbach,10 - 15 Jahre,198,110,88
False,8127009,Braunsbach,15 - 18 Jahre,97,59,38
False,8127009,Braunsbach,18 - 20 Jahre,45,25,20
False,8127009,Braunsbach,20 - 25 Jahre,117,66,51
False,8127009,Braunsbach,25 - 30 Jahre,120,57,63
False,8127009,Braunsbach,30 - 35 Jahre,156,80,76
False,8127009,Braunsbach,35 - 40 Jahre,226,106,120
False,8127009,Braunsbach,40 - 45 Jahre,219,123,96
False,8127009,Braunsbach,45 - 50 Jahre,151,80,71
False,8127009,Braunsbach,50 - 55 Jahre,130,71,59
False,8127009,Braunsbach,55 - 60 Jahre,139,68,71
False,8127009,Braunsbach,60 - 65 Jahre,152,73,79
False,8127009,Braunsbach,65 - 75 Jahre,226,100,126
False,8127009,Braunsbach,75 und mehr Jahre,171,61,110
False,8127009,Braunsbach,Insgesamt,2460,1227,1233
False,8127012,Bühlertann,unter 3 Jahre,118,61,57
False,8127012,Bühlertann,3 -  6 Jahre,143,58,85
False,8127012,Bühlertann,6 - 10 Jahre,186,89,97
False,8127012,Bühlertann,10 - 15 Jahre,221,124,97
False,8127012,Bühlertann,15 - 18 Jahre,133,75,58
False,8127012,Bühlertann,18 - 20 Jahre,69,37,32
False,8127012,Bühlertann,20 - 25 Jahre,162,89,73
False,8127012,Bühlertann,25 - 30 Jahre,189,99,90
False,8127012,Bühlertann,30 - 35 Jahre,271,149,122
False,8127012,Bühlertann,35 - 40 Jahre,268,140,128
False,8127012,Bühlertann,40 - 45 Jahre,233,119,114
False,8127012,Bühlertann,45 - 50 Jahre,189,99,90
False,8127012,Bühlertann,50 - 55 Jahre,153,84,69
False,8127012,Bühlertann,55 - 60 Jahre,112,52,60
False,8127012,Bühlertann,60 - 65 Jahre,171,83,88
False,8127012,Bühlertann,65 - 75 Jahre,229,109,120
False,8127012,Bühlertann,75 und mehr Jahre,137,45,92
False,8127012,Bühlertann,Insgesamt,2984,1512,1472
False,8127013,Bühlerzell,unter 3 Jahre,83,39,44
False,8127013,Bühlerzell,3 -  6 Jahre,80,33,47
False,8127013,Bühlerzell,6 - 10 Jahre,105,48,57
False,8127013,Bühlerzell,10 - 15 Jahre,119,71,48
False,8127013,Bühlerzell,15 - 18 Jahre,72,46,26
False,8127013,Bühlerzell,18 - 20 Jahre,45,29,16
False,8127013,Bühlerzell,20 - 25 Jahre,119,59,60
False,8127013,Bühlerzell,25 - 30 Jahre,120,54,66
False,8127013,Bühlerzell,30 - 35 Jahre,145,74,71
False,8127013,Bühlerzell,35 - 40 Jahre,184,88,96
False,8127013,Bühlerzell,40 - 45 Jahre,152,86,66
False,8127013,Bühlerzell,45 - 50 Jahre,130,71,59
False,8127013,Bühlerzell,50 - 55 Jahre,88,53,35
False,8127013,Bühlerzell,55 - 60 Jahre,98,41,57
False,8127013,Bühlerzell,60 - 65 Jahre,125,63,62
False,8127013,Bühlerzell,65 - 75 Jahre,172,81,91
False,8127013,Bühlerzell,75 und mehr Jahre,157,47,110
False,8127013,Bühlerzell,Insgesamt,1994,983,1011
False,8127014,"Crailsheim, Stadt",unter 3 Jahre,963,469,494
False,8127014,"Crailsheim, Stadt",3 -  6 Jahre,1038,523,515
False,8127014,"Crailsheim, Stadt",6 - 10 Jahre,1383,675,708
False,8127014,"Crailsheim, Stadt",10 - 15 Jahre,1980,1050,930
False,8127014,"Crailsheim, Stadt",15 - 18 Jahre,1263,652,611
False,8127014,"Crailsheim, Stadt",18 - 20 Jahre,814,421,393
False,8127014,"Crailsheim, Stadt",20 - 25 Jahre,1974,998,976
False,8127014,"Crailsheim, Stadt",25 - 30 Jahre,1987,1022,965
False,8127014,"Crailsheim, Stadt",30 - 35 Jahre,2465,1338,1127
False,8127014,"Crailsheim, Stadt",35 - 40 Jahre,2569,1332,1237
False,8127014,"Crailsheim, Stadt",40 - 45 Jahre,2490,1289,1201
False,8127014,"Crailsheim, Stadt",45 - 50 Jahre,2273,1117,1156
False,8127014,"Crailsheim, Stadt",50 - 55 Jahre,1822,935,887
False,8127014,"Crailsheim, Stadt",55 - 60 Jahre,1664,802,862
False,8127014,"Crailsheim, Stadt",60 - 65 Jahre,1965,978,987
False,8127014,"Crailsheim, Stadt",65 - 75 Jahre,2969,1354,1615
False,8127014,"Crailsheim, Stadt",75 und mehr Jahre,2444,719,1725
False,8127014,"Crailsheim, Stadt",Insgesamt,32063,15674,16389
False,8127023,Fichtenberg,unter 3 Jahre,95,48,47
False,8127023,Fichtenberg,3 -  6 Jahre,90,48,42
False,8127023,Fichtenberg,6 - 10 Jahre,147,84,63
False,8127023,Fichtenberg,10 - 15 Jahre,200,107,93
False,8127023,Fichtenberg,15 - 18 Jahre,106,62,44
False,8127023,Fichtenberg,18 - 20 Jahre,62,35,27
False,8127023,Fichtenberg,20 - 25 Jahre,131,64,67
False,8127023,Fichtenberg,25 - 30 Jahre,147,73,74
False,8127023,Fichtenberg,30 - 35 Jahre,215,113,102
False,8127023,Fichtenberg,35 - 40 Jahre,235,118,117
False,8127023,Fichtenberg,40 - 45 Jahre,248,128,120
False,8127023,Fichtenberg,45 - 50 Jahre,203,98,105
False,8127023,Fichtenberg,50 - 55 Jahre,176,97,79
False,8127023,Fichtenberg,55 - 60 Jahre,139,73,66
False,8127023,Fichtenberg,60 - 65 Jahre,183,100,83
False,8127023,Fichtenberg,65 - 75 Jahre,250,113,137
False,8127023,Fichtenberg,75 und mehr Jahre,190,67,123
False,8127023,Fichtenberg,Insgesamt,2817,1428,1389
False,8127025,"Gaildorf, Stadt",unter 3 Jahre,433,222,211
False,8127025,"Gaildorf, Stadt",3 -  6 Jahre,451,228,223
False,8127025,"Gaildorf, Stadt",6 - 10 Jahre,591,324,267
False,8127025,"Gaildorf, Stadt",10 - 15 Jahre,758,393,365
False,8127025,"Gaildorf, Stadt",15 - 18 Jahre,460,229,231
False,8127025,"Gaildorf, Stadt",18 - 20 Jahre,323,181,142
False,8127025,"Gaildorf, Stadt",20 - 25 Jahre,783,416,367
False,8127025,"Gaildorf, Stadt",25 - 30 Jahre,730,375,355
False,8127025,"Gaildorf, Stadt",30 - 35 Jahre,940,488,452
False,8127025,"Gaildorf, Stadt",35 - 40 Jahre,1037,545,492
False,8127025,"Gaildorf, Stadt",40 - 45 Jahre,946,459,487
False,8127025,"Gaildorf, Stadt",45 - 50 Jahre,849,433,416
False,8127025,"Gaildorf, Stadt",50 - 55 Jahre,705,354,351
False,8127025,"Gaildorf, Stadt",55 - 60 Jahre,630,319,311
False,8127025,"Gaildorf, Stadt",60 - 65 Jahre,761,377,384
False,8127025,"Gaildorf, Stadt",65 - 75 Jahre,1158,535,623
False,8127025,"Gaildorf, Stadt",75 und mehr Jahre,836,273,563
False,8127025,"Gaildorf, Stadt",Insgesamt,12391,6151,6240
False,8127032,"Gerabronn, Stadt",unter 3 Jahre,138,70,68
False,8127032,"Gerabronn, Stadt",3 -  6 Jahre,161,85,76
False,8127032,"Gerabronn, Stadt",6 - 10 Jahre,244,120,124
False,8127032,"Gerabronn, Stadt",10 - 15 Jahre,292,147,145
False,8127032,"Gerabronn, Stadt",15 - 18 Jahre,175,87,88
False,8127032,"Gerabronn, Stadt",18 - 20 Jahre,123,75,48
False,8127032,"Gerabronn, Stadt",20 - 25 Jahre,256,133,123
False,8127032,"Gerabronn, Stadt",25 - 30 Jahre,227,128,99
False,8127032,"Gerabronn, Stadt",30 - 35 Jahre,314,172,142
False,8127032,"Gerabronn, Stadt",35 - 40 Jahre,367,194,173
False,8127032,"Gerabronn, Stadt",40 - 45 Jahre,368,193,175
False,8127032,"Gerabronn, Stadt",45 - 50 Jahre,324,186,138
False,8127032,"Gerabronn, Stadt",50 - 55 Jahre,239,130,109
False,8127032,"Gerabronn, Stadt",55 - 60 Jahre,243,123,120
False,8127032,"Gerabronn, Stadt",60 - 65 Jahre,266,133,133
False,8127032,"Gerabronn, Stadt",65 - 75 Jahre,433,194,239
False,8127032,"Gerabronn, Stadt",75 und mehr Jahre,375,112,263
False,8127032,"Gerabronn, Stadt",Insgesamt,4545,2282,2263
False,8127043,"Ilshofen, Stadt",unter 3 Jahre,237,118,119
False,8127043,"Ilshofen, Stadt",3 -  6 Jahre,260,134,126
False,8127043,"Ilshofen, Stadt",6 - 10 Jahre,344,181,163
False,8127043,"Ilshofen, Stadt",10 - 15 Jahre,458,217,241
False,8127043,"Ilshofen, Stadt",15 - 18 Jahre,240,119,121
False,8127043,"Ilshofen, Stadt",18 - 20 Jahre,152,78,74
False,8127043,"Ilshofen, Stadt",20 - 25 Jahre,342,184,158
False,8127043,"Ilshofen, Stadt",25 - 30 Jahre,393,184,209
False,8127043,"Ilshofen, Stadt",30 - 35 Jahre,530,269,261
False,8127043,"Ilshofen, Stadt",35 - 40 Jahre,585,317,268
False,8127043,"Ilshofen, Stadt",40 - 45 Jahre,425,238,187
False,8127043,"Ilshofen, Stadt",45 - 50 Jahre,366,183,183
False,8127043,"Ilshofen, Stadt",50 - 55 Jahre,257,136,121
False,8127043,"Ilshofen, Stadt",55 - 60 Jahre,258,123,135
False,8127043,"Ilshofen, Stadt",60 - 65 Jahre,325,161,164
False,8127043,"Ilshofen, Stadt",65 - 75 Jahre,461,211,250
False,8127043,"Ilshofen, Stadt",75 und mehr Jahre,304,97,207
False,8127043,"Ilshofen, Stadt",Insgesamt,5937,2950,2987
False,8127046,"Kirchberg an der Jagst, Stadt",unter 3 Jahre,120,78,42
False,8127046,"Kirchberg an der Jagst, Stadt",3 -  6 Jahre,154,74,80
False,8127046,"Kirchberg an der Jagst, Stadt",6 - 10 Jahre,235,119,116
False,8127046,"Kirchberg an der Jagst, Stadt",10 - 15 Jahre,286,144,142
False,8127046,"Kirchberg an der Jagst, Stadt",15 - 18 Jahre,213,119,94
False,8127046,"Kirchberg an der Jagst, Stadt",18 - 20 Jahre,142,90,52
False,8127046,"Kirchberg an der Jagst, Stadt",20 - 25 Jahre,302,175,127
False,8127046,"Kirchberg an der Jagst, Stadt",25 - 30 Jahre,274,152,122
False,8127046,"Kirchberg an der Jagst, Stadt",30 - 35 Jahre,421,240,181
False,8127046,"Kirchberg an der Jagst, Stadt",35 - 40 Jahre,367,182,185
False,8127046,"Kirchberg an der Jagst, Stadt",40 - 45 Jahre,340,166,174
False,8127046,"Kirchberg an der Jagst, Stadt",45 - 50 Jahre,311,175,136
False,8127046,"Kirchberg an der Jagst, Stadt",50 - 55 Jahre,224,121,103
False,8127046,"Kirchberg an der Jagst, Stadt",55 - 60 Jahre,177,89,88
False,8127046,"Kirchberg an der Jagst, Stadt",60 - 65 Jahre,249,129,120
False,8127046,"Kirchberg an der Jagst, Stadt",65 - 75 Jahre,320,160,160
False,8127046,"Kirchberg an der Jagst, Stadt",75 und mehr Jahre,394,123,271
False,8127046,"Kirchberg an der Jagst, Stadt",Insgesamt,4529,2336,2193
False,8127047,"Langenburg, Stadt",unter 3 Jahre,60,42,18
False,8127047,"Langenburg, Stadt",3 -  6 Jahre,62,34,28
False,8127047,"Langenburg, Stadt",6 - 10 Jahre,99,51,48
False,8127047,"Langenburg, Stadt",10 - 15 Jahre,121,62,59
False,8127047,"Langenburg, Stadt",15 - 18 Jahre,64,32,32
False,8127047,"Langenburg, Stadt",18 - 20 Jahre,43,19,24
False,8127047,"Langenburg, Stadt",20 - 25 Jahre,73,40,33
False,8127047,"Langenburg, Stadt",25 - 30 Jahre,97,55,42
False,8127047,"Langenburg, Stadt",30 - 35 Jahre,111,55,56
False,8127047,"Langenburg, Stadt",35 - 40 Jahre,156,67,89
False,8127047,"Langenburg, Stadt",40 - 45 Jahre,140,80,60
False,8127047,"Langenburg, Stadt",45 - 50 Jahre,108,56,52
False,8127047,"Langenburg, Stadt",50 - 55 Jahre,126,62,64
False,8127047,"Langenburg, Stadt",55 - 60 Jahre,90,45,45
False,8127047,"Langenburg, Stadt",60 - 65 Jahre,160,77,83
False,8127047,"Langenburg, Stadt",65 - 75 Jahre,200,112,88
False,8127047,"Langenburg, Stadt",75 und mehr Jahre,160,49,111
False,8127047,"Langenburg, Stadt",Insgesamt,1870,938,932
False,8127052,Mainhardt,unter 3 Jahre,219,93,126
False,8127052,Mainhardt,3 -  6 Jahre,214,107,107
False,8127052,Mainhardt,6 - 10 Jahre,295,138,157
False,8127052,Mainhardt,10 - 15 Jahre,374,188,186
False,8127052,Mainhardt,15 - 18 Jahre,228,121,107
False,8127052,Mainhardt,18 - 20 Jahre,114,61,53
False,8127052,Mainhardt,20 - 25 Jahre,303,163,140
False,8127052,Mainhardt,25 - 30 Jahre,265,142,123
False,8127052,Mainhardt,30 - 35 Jahre,410,203,207
False,8127052,Mainhardt,35 - 40 Jahre,482,237,245
False,8127052,Mainhardt,40 - 45 Jahre,432,221,211
False,8127052,Mainhardt,45 - 50 Jahre,376,198,178
False,8127052,Mainhardt,50 - 55 Jahre,283,143,140
False,8127052,Mainhardt,55 - 60 Jahre,276,140,136
False,8127052,Mainhardt,60 - 65 Jahre,303,157,146
False,8127052,Mainhardt,65 - 75 Jahre,467,225,242
False,8127052,Mainhardt,75 und mehr Jahre,387,129,258
False,8127052,Mainhardt,Insgesamt,5428,2666,2762
False,8127056,Michelbach an der Bilz,unter 3 Jahre,116,62,54
False,8127056,Michelbach an der Bilz,3 -  6 Jahre,108,60,48
False,8127056,Michelbach an der Bilz,6 - 10 Jahre,166,84,82
False,8127056,Michelbach an der Bilz,10 - 15 Jahre,219,104,115
False,8127056,Michelbach an der Bilz,15 - 18 Jahre,117,60,57
False,8127056,Michelbach an der Bilz,18 - 20 Jahre,134,71,63
False,8127056,Michelbach an der Bilz,20 - 25 Jahre,162,74,88
False,8127056,Michelbach an der Bilz,25 - 30 Jahre,154,75,79
False,8127056,Michelbach an der Bilz,30 - 35 Jahre,309,158,151
False,8127056,Michelbach an der Bilz,35 - 40 Jahre,276,135,141
False,8127056,Michelbach an der Bilz,40 - 45 Jahre,267,140,127
False,8127056,Michelbach an der Bilz,45 - 50 Jahre,263,122,141
False,8127056,Michelbach an der Bilz,50 - 55 Jahre,200,105,95
False,8127056,Michelbach an der Bilz,55 - 60 Jahre,194,107,87
False,8127056,Michelbach an der Bilz,60 - 65 Jahre,211,103,108
False,8127056,Michelbach an der Bilz,65 - 75 Jahre,255,131,124
False,8127056,Michelbach an der Bilz,75 und mehr Jahre,176,60,116
False,8127056,Michelbach an der Bilz,Insgesamt,3327,1651,1676
False,8127059,Michelfeld,unter 3 Jahre,110,52,58
False,8127059,Michelfeld,3 -  6 Jahre,133,66,67
False,8127059,Michelfeld,6 - 10 Jahre,178,95,83
False,8127059,Michelfeld,10 - 15 Jahre,226,115,111
False,8127059,Michelfeld,15 - 18 Jahre,139,81,58
False,8127059,Michelfeld,18 - 20 Jahre,81,38,43
False,8127059,Michelfeld,20 - 25 Jahre,202,98,104
False,8127059,Michelfeld,25 - 30 Jahre,228,110,118
False,8127059,Michelfeld,30 - 35 Jahre,336,161,175
False,8127059,Michelfeld,35 - 40 Jahre,320,157,163
False,8127059,Michelfeld,40 - 45 Jahre,284,145,139
False,8127059,Michelfeld,45 - 50 Jahre,282,137,145
False,8127059,Michelfeld,50 - 55 Jahre,204,108,96
False,8127059,Michelfeld,55 - 60 Jahre,136,77,59
False,8127059,Michelfeld,60 - 65 Jahre,191,97,94
False,8127059,Michelfeld,65 - 75 Jahre,265,117,148
False,8127059,Michelfeld,75 und mehr Jahre,173,50,123
False,8127059,Michelfeld,Insgesamt,3488,1704,1784
False,8127062,Oberrot,unter 3 Jahre,127,67,60
False,8127062,Oberrot,3 -  6 Jahre,157,82,75
False,8127062,Oberrot,6 - 10 Jahre,212,116,96
False,8127062,Oberrot,10 - 15 Jahre,270,129,141
False,8127062,Oberrot,15 - 18 Jahre,150,75,75
False,8127062,Oberrot,18 - 20 Jahre,88,37,51
False,8127062,Oberrot,20 - 25 Jahre,177,94,83
False,8127062,Oberrot,25 - 30 Jahre,203,117,86
False,8127062,Oberrot,30 - 35 Jahre,273,139,134
False,8127062,Oberrot,35 - 40 Jahre,312,158,154
False,8127062,Oberrot,40 - 45 Jahre,294,141,153
False,8127062,Oberrot,45 - 50 Jahre,254,137,117
False,8127062,Oberrot,50 - 55 Jahre,214,125,89
False,8127062,Oberrot,55 - 60 Jahre,149,75,74
False,8127062,Oberrot,60 - 65 Jahre,210,106,104
False,8127062,Oberrot,65 - 75 Jahre,291,142,149
False,8127062,Oberrot,75 und mehr Jahre,290,86,204
False,8127062,Oberrot,Insgesamt,3671,1826,1845
False,8127063,Obersontheim,unter 3 Jahre,143,75,68
False,8127063,Obersontheim,3 -  6 Jahre,160,88,72
False,8127063,Obersontheim,6 - 10 Jahre,279,126,153
False,8127063,Obersontheim,10 - 15 Jahre,374,190,184
False,8127063,Obersontheim,15 - 18 Jahre,168,76,92
False,8127063,Obersontheim,18 - 20 Jahre,123,57,66
False,8127063,Obersontheim,20 - 25 Jahre,227,122,105
False,8127063,Obersontheim,25 - 30 Jahre,266,127,139
False,8127063,Obersontheim,30 - 35 Jahre,377,182,195
False,8127063,Obersontheim,35 - 40 Jahre,401,217,184
False,8127063,Obersontheim,40 - 45 Jahre,426,221,205
False,8127063,Obersontheim,45 - 50 Jahre,305,152,153
False,8127063,Obersontheim,50 - 55 Jahre,233,120,113
False,8127063,Obersontheim,55 - 60 Jahre,173,86,87
False,8127063,Obersontheim,60 - 65 Jahre,268,115,153
False,8127063,Obersontheim,65 - 75 Jahre,438,207,231
False,8127063,Obersontheim,75 und mehr Jahre,288,87,201
False,8127063,Obersontheim,Insgesamt,4649,2248,2401
False,8127071,Rot am See,unter 3 Jahre,169,86,83
False,8127071,Rot am See,3 -  6 Jahre,175,79,96
False,8127071,Rot am See,6 - 10 Jahre,286,154,132
False,8127071,Rot am See,10 - 15 Jahre,387,184,203
False,8127071,Rot am See,15 - 18 Jahre,199,102,97
False,8127071,Rot am See,18 - 20 Jahre,116,58,58
False,8127071,Rot am See,20 - 25 Jahre,296,157,139
False,8127071,Rot am See,25 - 30 Jahre,277,135,142
False,8127071,Rot am See,30 - 35 Jahre,408,207,201
False,8127071,Rot am See,35 - 40 Jahre,425,222,203
False,8127071,Rot am See,40 - 45 Jahre,418,213,205
False,8127071,Rot am See,45 - 50 Jahre,346,184,162
False,8127071,Rot am See,50 - 55 Jahre,285,156,129
False,8127071,Rot am See,55 - 60 Jahre,239,123,116
False,8127071,Rot am See,60 - 65 Jahre,289,150,139
False,8127071,Rot am See,65 - 75 Jahre,478,218,260
False,8127071,Rot am See,75 und mehr Jahre,346,131,215
False,8127071,Rot am See,Insgesamt,5139,2559,2580
False,8127073,Satteldorf,unter 3 Jahre,184,99,85
False,8127073,Satteldorf,3 -  6 Jahre,173,98,75
False,8127073,Satteldorf,6 - 10 Jahre,282,145,137
False,8127073,Satteldorf,10 - 15 Jahre,355,186,169
False,8127073,Satteldorf,15 - 18 Jahre,229,111,118
False,8127073,Satteldorf,18 - 20 Jahre,123,61,62
False,8127073,Satteldorf,20 - 25 Jahre,255,128,127
False,8127073,Satteldorf,25 - 30 Jahre,294,147,147
False,8127073,Satteldorf,30 - 35 Jahre,396,209,187
False,8127073,Satteldorf,35 - 40 Jahre,423,208,215
False,8127073,Satteldorf,40 - 45 Jahre,423,220,203
False,8127073,Satteldorf,45 - 50 Jahre,359,184,175
False,8127073,Satteldorf,50 - 55 Jahre,310,154,156
False,8127073,Satteldorf,55 - 60 Jahre,221,122,99
False,8127073,Satteldorf,60 - 65 Jahre,236,120,116
False,8127073,Satteldorf,65 - 75 Jahre,389,165,224
False,8127073,Satteldorf,75 und mehr Jahre,301,87,214
False,8127073,Satteldorf,Insgesamt,4953,2444,2509
False,8127075,"Schrozberg, Stadt",unter 3 Jahre,190,110,80
False,8127075,"Schrozberg, Stadt",3 -  6 Jahre,231,121,110
False,8127075,"Schrozberg, Stadt",6 - 10 Jahre,324,161,163
False,8127075,"Schrozberg, Stadt",10 - 15 Jahre,426,214,212
False,8127075,"Schrozberg, Stadt",15 - 18 Jahre,220,125,95
False,8127075,"Schrozberg, Stadt",18 - 20 Jahre,167,85,82
False,8127075,"Schrozberg, Stadt",20 - 25 Jahre,349,195,154
False,8127075,"Schrozberg, Stadt",25 - 30 Jahre,343,188,155
False,8127075,"Schrozberg, Stadt",30 - 35 Jahre,437,218,219
False,8127075,"Schrozberg, Stadt",35 - 40 Jahre,500,247,253
False,8127075,"Schrozberg, Stadt",40 - 45 Jahre,426,232,194
False,8127075,"Schrozberg, Stadt",45 - 50 Jahre,402,211,191
False,8127075,"Schrozberg, Stadt",50 - 55 Jahre,369,187,182
False,8127075,"Schrozberg, Stadt",55 - 60 Jahre,300,156,144
False,8127075,"Schrozberg, Stadt",60 - 65 Jahre,413,190,223
False,8127075,"Schrozberg, Stadt",65 - 75 Jahre,604,288,316
False,8127075,"Schrozberg, Stadt",75 und mehr Jahre,557,183,374
False,8127075,"Schrozberg, Stadt",Insgesamt,6258,3111,3147
False,8127076,"Schwäbisch Hall, Stadt",unter 3 Jahre,1074,564,510
False,8127076,"Schwäbisch Hall, Stadt",3 -  6 Jahre,1122,567,555
False,8127076,"Schwäbisch Hall, Stadt",6 - 10 Jahre,1548,816,732
False,8127076,"Schwäbisch Hall, Stadt",10 - 15 Jahre,2111,1027,1084
False,8127076,"Schwäbisch Hall, Stadt",15 - 18 Jahre,1315,709,606
False,8127076,"Schwäbisch Hall, Stadt",18 - 20 Jahre,954,454,500
False,8127076,"Schwäbisch Hall, Stadt",20 - 25 Jahre,2012,975,1037
False,8127076,"Schwäbisch Hall, Stadt",25 - 30 Jahre,2134,994,1140
False,8127076,"Schwäbisch Hall, Stadt",30 - 35 Jahre,2947,1454,1493
False,8127076,"Schwäbisch Hall, Stadt",35 - 40 Jahre,2890,1471,1419
False,8127076,"Schwäbisch Hall, Stadt",40 - 45 Jahre,2686,1288,1398
False,8127076,"Schwäbisch Hall, Stadt",45 - 50 Jahre,2447,1132,1315
False,8127076,"Schwäbisch Hall, Stadt",50 - 55 Jahre,2211,1076,1135
False,8127076,"Schwäbisch Hall, Stadt",55 - 60 Jahre,1990,971,1019
False,8127076,"Schwäbisch Hall, Stadt",60 - 65 Jahre,2202,1050,1152
False,8127076,"Schwäbisch Hall, Stadt",65 - 75 Jahre,2980,1294,1686
False,8127076,"Schwäbisch Hall, Stadt",75 und mehr Jahre,2805,836,1969
False,8127076,"Schwäbisch Hall, Stadt",Insgesamt,35428,16678,18750
False,8127079,Sulzbach-Laufen,unter 3 Jahre,92,45,47
False,8127079,Sulzbach-Laufen,3 -  6 Jahre,83,47,36
False,8127079,Sulzbach-Laufen,6 - 10 Jahre,136,75,61
False,8127079,Sulzbach-Laufen,10 - 15 Jahre,192,102,90
False,8127079,Sulzbach-Laufen,15 - 18 Jahre,82,42,40
False,8127079,Sulzbach-Laufen,18 - 20 Jahre,54,32,22
False,8127079,Sulzbach-Laufen,20 - 25 Jahre,168,94,74
False,8127079,Sulzbach-Laufen,25 - 30 Jahre,140,75,65
False,8127079,Sulzbach-Laufen,30 - 35 Jahre,219,116,103
False,8127079,Sulzbach-Laufen,35 - 40 Jahre,227,116,111
False,8127079,Sulzbach-Laufen,40 - 45 Jahre,204,100,104
False,8127079,Sulzbach-Laufen,45 - 50 Jahre,160,88,72
False,8127079,Sulzbach-Laufen,50 - 55 Jahre,136,71,65
False,8127079,Sulzbach-Laufen,55 - 60 Jahre,123,65,58
False,8127079,Sulzbach-Laufen,60 - 65 Jahre,172,88,84
False,8127079,Sulzbach-Laufen,65 - 75 Jahre,233,107,126
False,8127079,Sulzbach-Laufen,75 und mehr Jahre,144,55,89
False,8127079,Sulzbach-Laufen,Insgesamt,2565,1318,1247
False,8127086,Untermünkheim,unter 3 Jahre,115,68,47
False,8127086,Untermünkheim,3 -  6 Jahre,140,64,76
False,8127086,Untermünkheim,6 - 10 Jahre,174,95,79
False,8127086,Untermünkheim,10 - 15 Jahre,203,110,93
False,8127086,Untermünkheim,15 - 18 Jahre,105,54,51
False,8127086,Untermünkheim,18 - 20 Jahre,75,42,33
False,8127086,Untermünkheim,20 - 25 Jahre,161,92,69
False,8127086,Untermünkheim,25 - 30 Jahre,180,78,102
False,8127086,Untermünkheim,30 - 35 Jahre,249,133,116
False,8127086,Untermünkheim,35 - 40 Jahre,246,133,113
False,8127086,Untermünkheim,40 - 45 Jahre,241,114,127
False,8127086,Untermünkheim,45 - 50 Jahre,191,97,94
False,8127086,Untermünkheim,50 - 55 Jahre,195,108,87
False,8127086,Untermünkheim,55 - 60 Jahre,137,67,70
False,8127086,Untermünkheim,60 - 65 Jahre,148,84,64
False,8127086,Untermünkheim,65 - 75 Jahre,258,116,142
False,8127086,Untermünkheim,75 und mehr Jahre,133,41,92
False,8127086,Untermünkheim,Insgesamt,2951,1496,1455
False,8127089,"Vellberg, Stadt",unter 3 Jahre,148,82,66
False,8127089,"Vellberg, Stadt",3 -  6 Jahre,189,94,95
False,8127089,"Vellberg, Stadt",6 - 10 Jahre,222,120,102
False,8127089,"Vellberg, Stadt",10 - 15 Jahre,308,156,152
False,8127089,"Vellberg, Stadt",15 - 18 Jahre,168,81,87
False,8127089,"Vellberg, Stadt",18 - 20 Jahre,101,54,47
False,8127089,"Vellberg, Stadt",20 - 25 Jahre,203,117,86
False,8127089,"Vellberg, Stadt",25 - 30 Jahre,253,132,121
False,8127089,"Vellberg, Stadt",30 - 35 Jahre,333,158,175
False,8127089,"Vellberg, Stadt",35 - 40 Jahre,385,211,174
False,8127089,"Vellberg, Stadt",40 - 45 Jahre,360,174,186
False,8127089,"Vellberg, Stadt",45 - 50 Jahre,314,183,131
False,8127089,"Vellberg, Stadt",50 - 55 Jahre,285,129,156
False,8127089,"Vellberg, Stadt",55 - 60 Jahre,223,115,108
False,8127089,"Vellberg, Stadt",60 - 65 Jahre,235,117,118
False,8127089,"Vellberg, Stadt",65 - 75 Jahre,315,156,159
False,8127089,"Vellberg, Stadt",75 und mehr Jahre,305,106,199
False,8127089,"Vellberg, Stadt",Insgesamt,4347,2185,2162
False,8127091,Wallhausen,unter 3 Jahre,159,77,82
False,8127091,Wallhausen,3 -  6 Jahre,177,92,85
False,8127091,Wallhausen,6 - 10 Jahre,201,100,101
False,8127091,Wallhausen,10 - 15 Jahre,256,137,119
False,8127091,Wallhausen,15 - 18 Jahre,153,80,73
False,8127091,Wallhausen,18 - 20 Jahre,77,41,36
False,8127091,Wallhausen,20 - 25 Jahre,178,86,92
False,8127091,Wallhausen,25 - 30 Jahre,229,116,113
False,8127091,Wallhausen,30 - 35 Jahre,276,137,139
False,8127091,Wallhausen,35 - 40 Jahre,335,159,176
False,8127091,Wallhausen,40 - 45 Jahre,300,161,139
False,8127091,Wallhausen,45 - 50 Jahre,234,134,100
False,8127091,Wallhausen,50 - 55 Jahre,144,73,71
False,8127091,Wallhausen,55 - 60 Jahre,128,61,67
False,8127091,Wallhausen,60 - 65 Jahre,152,82,70
False,8127091,Wallhausen,65 - 75 Jahre,243,114,129
False,8127091,Wallhausen,75 und mehr Jahre,166,52,114
False,8127091,Wallhausen,Insgesamt,3408,1702,1706
False,8127099,Wolpertshausen,unter 3 Jahre,70,40,30
False,8127099,Wolpertshausen,3 -  6 Jahre,87,42,45
False,8127099,Wolpertshausen,6 - 10 Jahre,127,63,64
False,8127099,Wolpertshausen,10 - 15 Jahre,143,74,69
False,8127099,Wolpertshausen,15 - 18 Jahre,76,40,36
False,8127099,Wolpertshausen,18 - 20 Jahre,47,27,20
False,8127099,Wolpertshausen,20 - 25 Jahre,97,60,37
False,8127099,Wolpertshausen,25 - 30 Jahre,100,51,49
False,8127099,Wolpertshausen,30 - 35 Jahre,164,87,77
False,8127099,Wolpertshausen,35 - 40 Jahre,160,81,79
False,8127099,Wolpertshausen,40 - 45 Jahre,144,78,66
False,8127099,Wolpertshausen,45 - 50 Jahre,124,64,60
False,8127099,Wolpertshausen,50 - 55 Jahre,97,54,43
False,8127099,Wolpertshausen,55 - 60 Jahre,56,32,24
False,8127099,Wolpertshausen,60 - 65 Jahre,73,32,41
False,8127099,Wolpertshausen,65 - 75 Jahre,139,65,74
False,8127099,Wolpertshausen,75 und mehr Jahre,113,43,70
False,8127099,Wolpertshausen,Insgesamt,1817,933,884
False,8127100,Rosengarten,unter 3 Jahre,188,96,92
False,8127100,Rosengarten,3 -  6 Jahre,231,123,108
False,8127100,Rosengarten,6 - 10 Jahre,295,156,139
False,8127100,Rosengarten,10 - 15 Jahre,366,194,172
False,8127100,Rosengarten,15 - 18 Jahre,162,89,73
False,8127100,Rosengarten,18 - 20 Jahre,118,55,63
False,8127100,Rosengarten,20 - 25 Jahre,281,127,154
False,8127100,Rosengarten,25 - 30 Jahre,277,127,150
False,8127100,Rosengarten,30 - 35 Jahre,432,214,218
False,8127100,Rosengarten,35 - 40 Jahre,518,253,265
False,8127100,Rosengarten,40 - 45 Jahre,415,222,193
False,8127100,Rosengarten,45 - 50 Jahre,346,164,182
False,8127100,Rosengarten,50 - 55 Jahre,279,146,133
False,8127100,Rosengarten,55 - 60 Jahre,254,128,126
False,8127100,Rosengarten,60 - 65 Jahre,290,154,136
False,8127100,Rosengarten,65 - 75 Jahre,369,161,208
False,8127100,Rosengarten,75 und mehr Jahre,341,106,235
False,8127100,Rosengarten,Insgesamt,5162,2515,2647
False,8127101,Kreßberg,unter 3 Jahre,134,63,71
False,8127101,Kreßberg,3 -  6 Jahre,151,73,78
False,8127101,Kreßberg,6 - 10 Jahre,213,112,101
False,8127101,Kreßberg,10 - 15 Jahre,305,162,143
False,8127101,Kreßberg,15 - 18 Jahre,165,80,85
False,8127101,Kreßberg,18 - 20 Jahre,86,52,34
False,8127101,Kreßberg,20 - 25 Jahre,191,100,91
False,8127101,Kreßberg,25 - 30 Jahre,191,98,93
False,8127101,Kreßberg,30 - 35 Jahre,302,140,162
False,8127101,Kreßberg,35 - 40 Jahre,357,186,171
False,8127101,Kreßberg,40 - 45 Jahre,316,166,150
False,8127101,Kreßberg,45 - 50 Jahre,273,133,140
False,8127101,Kreßberg,50 - 55 Jahre,249,139,110
False,8127101,Kreßberg,55 - 60 Jahre,163,88,75
False,8127101,Kreßberg,60 - 65 Jahre,223,115,108
False,8127101,Kreßberg,65 - 75 Jahre,318,146,172
False,8127101,Kreßberg,75 und mehr Jahre,246,88,158
False,8127101,Kreßberg,Insgesamt,3883,1941,1942
False,8127102,Fichtenau,unter 3 Jahre,155,75,80
False,8127102,Fichtenau,3 -  6 Jahre,178,92,86
False,8127102,Fichtenau,6 - 10 Jahre,278,156,122
False,8127102,Fichtenau,10 - 15 Jahre,314,158,156
False,8127102,Fichtenau,15 - 18 Jahre,181,101,80
False,8127102,Fichtenau,18 - 20 Jahre,114,57,57
False,8127102,Fichtenau,20 - 25 Jahre,311,160,151
False,8127102,Fichtenau,25 - 30 Jahre,312,151,161
False,8127102,Fichtenau,30 - 35 Jahre,376,189,187
False,8127102,Fichtenau,35 - 40 Jahre,422,243,179
False,8127102,Fichtenau,40 - 45 Jahre,367,185,182
False,8127102,Fichtenau,45 - 50 Jahre,305,152,153
False,8127102,Fichtenau,50 - 55 Jahre,267,139,128
False,8127102,Fichtenau,55 - 60 Jahre,208,108,100
False,8127102,Fichtenau,60 - 65 Jahre,262,118,144
False,8127102,Fichtenau,65 - 75 Jahre,388,173,215
False,8127102,Fichtenau,75 und mehr Jahre,264,83,181
False,8127102,Fichtenau,Insgesamt,4702,2340,2362
False,8127103,Frankenhardt,unter 3 Jahre,144,82,62
False,8127103,Frankenhardt,3 -  6 Jahre,198,106,92
False,8127103,Frankenhardt,6 - 10 Jahre,289,140,149
False,8127103,Frankenhardt,10 - 15 Jahre,332,175,157
False,8127103,Frankenhardt,15 - 18 Jahre,174,104,70
False,8127103,Frankenhardt,18 - 20 Jahre,132,73,59
False,8127103,Frankenhardt,20 - 25 Jahre,256,148,108
False,8127103,Frankenhardt,25 - 30 Jahre,250,139,111
False,8127103,Frankenhardt,30 - 35 Jahre,294,148,146
False,8127103,Frankenhardt,35 - 40 Jahre,411,209,202
False,8127103,Frankenhardt,40 - 45 Jahre,387,204,183
False,8127103,Frankenhardt,45 - 50 Jahre,361,184,177
False,8127103,Frankenhardt,50 - 55 Jahre,236,136,100
False,8127103,Frankenhardt,55 - 60 Jahre,193,97,96
False,8127103,Frankenhardt,60 - 65 Jahre,243,113,130
False,8127103,Frankenhardt,65 - 75 Jahre,382,187,195
False,8127103,Frankenhardt,75 und mehr Jahre,306,104,202
False,8127103,Frankenhardt,Insgesamt,4588,2349,2239
False,8127104,Stimpfach,unter 3 Jahre,101,53,48
False,8127104,Stimpfach,3 -  6 Jahre,127,65,62
False,8127104,Stimpfach,6 - 10 Jahre,155,89,66
False,8127104,Stimpfach,10 - 15 Jahre,247,130,117
False,8127104,Stimpfach,15 - 18 Jahre,131,64,67
False,8127104,Stimpfach,18 - 20 Jahre,103,51,52
False,8127104,Stimpfach,20 - 25 Jahre,178,100,78
False,8127104,Stimpfach,25 - 30 Jahre,184,95,89
False,8127104,Stimpfach,30 - 35 Jahre,228,117,111
False,8127104,Stimpfach,35 - 40 Jahre,282,151,131
False,8127104,Stimpfach,40 - 45 Jahre,249,125,124
False,8127104,Stimpfach,45 - 50 Jahre,215,111,104
False,8127104,Stimpfach,50 - 55 Jahre,183,101,82
False,8127104,Stimpfach,55 - 60 Jahre,124,67,57
False,8127104,Stimpfach,60 - 65 Jahre,169,78,91
False,8127104,Stimpfach,65 - 75 Jahre,236,109,127
False,8127104,Stimpfach,75 und mehr Jahre,179,60,119
False,8127104,Stimpfach,Insgesamt,3091,1566,1525
False,8128,Landkreis Main-Tauber-Kreis,unter 3 Jahre,4103,2141,1962
False,8128,Landkreis Main-Tauber-Kreis,3 -  6 Jahre,4425,2256,2169
False,8128,Landkreis Main-Tauber-Kreis,6 - 10 Jahre,6305,3319,2986
False,8128,Landkreis Main-Tauber-Kreis,10 - 15 Jahre,8581,4336,4245
False,8128,Landkreis Main-Tauber-Kreis,15 - 18 Jahre,5014,2589,2425
False,8128,Landkreis Main-Tauber-Kreis,18 - 20 Jahre,3369,1772,1597
False,8128,Landkreis Main-Tauber-Kreis,20 - 25 Jahre,7642,3907,3735
False,8128,Landkreis Main-Tauber-Kreis,25 - 30 Jahre,8050,4139,3911
False,8128,Landkreis Main-Tauber-Kreis,30 - 35 Jahre,10554,5581,4973
False,8128,Landkreis Main-Tauber-Kreis,35 - 40 Jahre,11544,5995,5549
False,8128,Landkreis Main-Tauber-Kreis,40 - 45 Jahre,10469,5336,5133
False,8128,Landkreis Main-Tauber-Kreis,45 - 50 Jahre,9431,4735,4696
False,8128,Landkreis Main-Tauber-Kreis,50 - 55 Jahre,8093,4162,3931
False,8128,Landkreis Main-Tauber-Kreis,55 - 60 Jahre,6819,3423,3396
False,8128,Landkreis Main-Tauber-Kreis,60 - 65 Jahre,8845,4427,4418
False,8128,Landkreis Main-Tauber-Kreis,65 - 75 Jahre,12758,5839,6919
False,8128,Landkreis Main-Tauber-Kreis,75 und mehr Jahre,11055,3468,7587
False,8128,Landkreis Main-Tauber-Kreis,Insgesamt,137057,67425,69632
False,8128006,Assamstadt,unter 3 Jahre,96,50,46
False,8128006,Assamstadt,3 -  6 Jahre,76,37,39
False,8128006,Assamstadt,6 - 10 Jahre,133,74,59
False,8128006,Assamstadt,10 - 15 Jahre,152,76,76
False,8128006,Assamstadt,15 - 18 Jahre,107,59,48
False,8128006,Assamstadt,18 - 20 Jahre,54,33,21
False,8128006,Assamstadt,20 - 25 Jahre,138,66,72
False,8128006,Assamstadt,25 - 30 Jahre,143,70,73
False,8128006,Assamstadt,30 - 35 Jahre,150,81,69
False,8128006,Assamstadt,35 - 40 Jahre,185,86,99
False,8128006,Assamstadt,40 - 45 Jahre,172,93,79
False,8128006,Assamstadt,45 - 50 Jahre,134,70,64
False,8128006,Assamstadt,50 - 55 Jahre,110,59,51
False,8128006,Assamstadt,55 - 60 Jahre,76,37,39
False,8128006,Assamstadt,60 - 65 Jahre,99,47,52
False,8128006,Assamstadt,65 - 75 Jahre,171,76,95
False,8128006,Assamstadt,75 und mehr Jahre,113,42,71
False,8128006,Assamstadt,Insgesamt,2109,1056,1053
False,8128007,"Bad Mergentheim, Stadt",unter 3 Jahre,608,304,304
False,8128007,"Bad Mergentheim, Stadt",3 -  6 Jahre,653,324,329
False,8128007,"Bad Mergentheim, Stadt",6 - 10 Jahre,857,441,416
False,8128007,"Bad Mergentheim, Stadt",10 - 15 Jahre,1291,640,651
False,8128007,"Bad Mergentheim, Stadt",15 - 18 Jahre,735,369,366
False,8128007,"Bad Mergentheim, Stadt",18 - 20 Jahre,541,280,261
False,8128007,"Bad Mergentheim, Stadt",20 - 25 Jahre,1239,615,624
False,8128007,"Bad Mergentheim, Stadt",25 - 30 Jahre,1335,685,650
False,8128007,"Bad Mergentheim, Stadt",30 - 35 Jahre,1584,812,772
False,8128007,"Bad Mergentheim, Stadt",35 - 40 Jahre,1676,867,809
False,8128007,"Bad Mergentheim, Stadt",40 - 45 Jahre,1581,724,857
False,8128007,"Bad Mergentheim, Stadt",45 - 50 Jahre,1561,768,793
False,8128007,"Bad Mergentheim, Stadt",50 - 55 Jahre,1310,617,693
False,8128007,"Bad Mergentheim, Stadt",55 - 60 Jahre,1197,563,634
False,8128007,"Bad Mergentheim, Stadt",60 - 65 Jahre,1501,703,798
False,8128007,"Bad Mergentheim, Stadt",65 - 75 Jahre,2127,925,1202
False,8128007,"Bad Mergentheim, Stadt",75 und mehr Jahre,2376,682,1694
False,8128007,"Bad Mergentheim, Stadt",Insgesamt,22172,10319,11853
False,8128014,"Boxberg, Stadt",unter 3 Jahre,221,114,107
False,8128014,"Boxberg, Stadt",3 -  6 Jahre,225,115,110
False,8128014,"Boxberg, Stadt",6 - 10 Jahre,359,188,171
False,8128014,"Boxberg, Stadt",10 - 15 Jahre,521,269,252
False,8128014,"Boxberg, Stadt",15 - 18 Jahre,284,144,140
False,8128014,"Boxberg, Stadt",18 - 20 Jahre,174,98,76
False,8128014,"Boxberg, Stadt",20 - 25 Jahre,426,210,216
False,8128014,"Boxberg, Stadt",25 - 30 Jahre,443,239,204
False,8128014,"Boxberg, Stadt",30 - 35 Jahre,565,301,264
False,8128014,"Boxberg, Stadt",35 - 40 Jahre,616,317,299
False,8128014,"Boxberg, Stadt",40 - 45 Jahre,567,303,264
False,8128014,"Boxberg, Stadt",45 - 50 Jahre,548,263,285
False,8128014,"Boxberg, Stadt",50 - 55 Jahre,430,231,199
False,8128014,"Boxberg, Stadt",55 - 60 Jahre,325,174,151
False,8128014,"Boxberg, Stadt",60 - 65 Jahre,442,231,211
False,8128014,"Boxberg, Stadt",65 - 75 Jahre,604,290,314
False,8128014,"Boxberg, Stadt",75 und mehr Jahre,573,168,405
False,8128014,"Boxberg, Stadt",Insgesamt,7323,3655,3668
False,8128020,"Creglingen, Stadt",unter 3 Jahre,163,94,69
False,8128020,"Creglingen, Stadt",3 -  6 Jahre,196,96,100
False,8128020,"Creglingen, Stadt",6 - 10 Jahre,262,140,122
False,8128020,"Creglingen, Stadt",10 - 15 Jahre,284,129,155
False,8128020,"Creglingen, Stadt",15 - 18 Jahre,174,81,93
False,8128020,"Creglingen, Stadt",18 - 20 Jahre,110,60,50
False,8128020,"Creglingen, Stadt",20 - 25 Jahre,257,146,111
False,8128020,"Creglingen, Stadt",25 - 30 Jahre,320,162,158
False,8128020,"Creglingen, Stadt",30 - 35 Jahre,383,230,153
False,8128020,"Creglingen, Stadt",35 - 40 Jahre,354,182,172
False,8128020,"Creglingen, Stadt",40 - 45 Jahre,353,173,180
False,8128020,"Creglingen, Stadt",45 - 50 Jahre,310,170,140
False,8128020,"Creglingen, Stadt",50 - 55 Jahre,282,163,119
False,8128020,"Creglingen, Stadt",55 - 60 Jahre,208,96,112
False,8128020,"Creglingen, Stadt",60 - 65 Jahre,343,175,168
False,8128020,"Creglingen, Stadt",65 - 75 Jahre,575,274,301
False,8128020,"Creglingen, Stadt",75 und mehr Jahre,413,148,265
False,8128020,"Creglingen, Stadt",Insgesamt,4987,2519,2468
False,8128039,"Freudenberg, Stadt",unter 3 Jahre,139,75,64
False,8128039,"Freudenberg, Stadt",3 -  6 Jahre,129,63,66
False,8128039,"Freudenberg, Stadt",6 - 10 Jahre,180,84,96
False,8128039,"Freudenberg, Stadt",10 - 15 Jahre,223,116,107
False,8128039,"Freudenberg, Stadt",15 - 18 Jahre,149,79,70
False,8128039,"Freudenberg, Stadt",18 - 20 Jahre,114,57,57
False,8128039,"Freudenberg, Stadt",20 - 25 Jahre,250,128,122
False,8128039,"Freudenberg, Stadt",25 - 30 Jahre,240,119,121
False,8128039,"Freudenberg, Stadt",30 - 35 Jahre,298,162,136
False,8128039,"Freudenberg, Stadt",35 - 40 Jahre,340,178,162
False,8128039,"Freudenberg, Stadt",40 - 45 Jahre,285,148,137
False,8128039,"Freudenberg, Stadt",45 - 50 Jahre,307,154,153
False,8128039,"Freudenberg, Stadt",50 - 55 Jahre,212,120,92
False,8128039,"Freudenberg, Stadt",55 - 60 Jahre,194,95,99
False,8128039,"Freudenberg, Stadt",60 - 65 Jahre,288,139,149
False,8128039,"Freudenberg, Stadt",65 - 75 Jahre,432,205,227
False,8128039,"Freudenberg, Stadt",75 und mehr Jahre,328,116,212
False,8128039,"Freudenberg, Stadt",Insgesamt,4108,2038,2070
False,8128045,Großrinderfeld,unter 3 Jahre,134,74,60
False,8128045,Großrinderfeld,3 -  6 Jahre,138,77,61
False,8128045,Großrinderfeld,6 - 10 Jahre,242,127,115
False,8128045,Großrinderfeld,10 - 15 Jahre,289,149,140
False,8128045,Großrinderfeld,15 - 18 Jahre,143,71,72
False,8128045,Großrinderfeld,18 - 20 Jahre,100,49,51
False,8128045,Großrinderfeld,20 - 25 Jahre,236,113,123
False,8128045,Großrinderfeld,25 - 30 Jahre,248,134,114
False,8128045,Großrinderfeld,30 - 35 Jahre,395,209,186
False,8128045,Großrinderfeld,35 - 40 Jahre,394,203,191
False,8128045,Großrinderfeld,40 - 45 Jahre,337,169,168
False,8128045,Großrinderfeld,45 - 50 Jahre,283,149,134
False,8128045,Großrinderfeld,50 - 55 Jahre,253,139,114
False,8128045,Großrinderfeld,55 - 60 Jahre,142,69,73
False,8128045,Großrinderfeld,60 - 65 Jahre,229,119,110
False,8128045,Großrinderfeld,65 - 75 Jahre,292,129,163
False,8128045,Großrinderfeld,75 und mehr Jahre,248,76,172
False,8128045,Großrinderfeld,Insgesamt,4103,2056,2047
False,8128047,"Grünsfeld, Stadt",unter 3 Jahre,124,66,58
False,8128047,"Grünsfeld, Stadt",3 -  6 Jahre,132,67,65
False,8128047,"Grünsfeld, Stadt",6 - 10 Jahre,210,118,92
False,8128047,"Grünsfeld, Stadt",10 - 15 Jahre,244,139,105
False,8128047,"Grünsfeld, Stadt",15 - 18 Jahre,138,75,63
False,8128047,"Grünsfeld, Stadt",18 - 20 Jahre,84,46,38
False,8128047,"Grünsfeld, Stadt",20 - 25 Jahre,185,85,100
False,8128047,"Grünsfeld, Stadt",25 - 30 Jahre,224,109,115
False,8128047,"Grünsfeld, Stadt",30 - 35 Jahre,306,152,154
False,8128047,"Grünsfeld, Stadt",35 - 40 Jahre,398,212,186
False,8128047,"Grünsfeld, Stadt",40 - 45 Jahre,322,183,139
False,8128047,"Grünsfeld, Stadt",45 - 50 Jahre,244,129,115
False,8128047,"Grünsfeld, Stadt",50 - 55 Jahre,211,107,104
False,8128047,"Grünsfeld, Stadt",55 - 60 Jahre,166,90,76
False,8128047,"Grünsfeld, Stadt",60 - 65 Jahre,244,117,127
False,8128047,"Grünsfeld, Stadt",65 - 75 Jahre,371,169,202
False,8128047,"Grünsfeld, Stadt",75 und mehr Jahre,259,95,164
False,8128047,"Grünsfeld, Stadt",Insgesamt,3862,1959,1903
False,8128058,Igersheim,unter 3 Jahre,206,105,101
False,8128058,Igersheim,3 -  6 Jahre,181,95,86
False,8128058,Igersheim,6 - 10 Jahre,241,118,123
False,8128058,Igersheim,10 - 15 Jahre,373,180,193
False,8128058,Igersheim,15 - 18 Jahre,212,107,105
False,8128058,Igersheim,18 - 20 Jahre,127,67,60
False,8128058,Igersheim,20 - 25 Jahre,325,178,147
False,8128058,Igersheim,25 - 30 Jahre,358,184,174
False,8128058,Igersheim,30 - 35 Jahre,440,229,211
False,8128058,Igersheim,35 - 40 Jahre,458,221,237
False,8128058,Igersheim,40 - 45 Jahre,419,193,226
False,8128058,Igersheim,45 - 50 Jahre,427,207,220
False,8128058,Igersheim,50 - 55 Jahre,341,181,160
False,8128058,Igersheim,55 - 60 Jahre,270,144,126
False,8128058,Igersheim,60 - 65 Jahre,371,192,179
False,8128058,Igersheim,65 - 75 Jahre,457,217,240
False,8128058,Igersheim,75 und mehr Jahre,359,121,238
False,8128058,Igersheim,Insgesamt,5565,2739,2826
False,8128061,Königheim,unter 3 Jahre,93,52,41
False,8128061,Königheim,3 -  6 Jahre,111,60,51
False,8128061,Königheim,6 - 10 Jahre,165,83,82
False,8128061,Königheim,10 - 15 Jahre,218,113,105
False,8128061,Königheim,15 - 18 Jahre,116,56,60
False,8128061,Königheim,18 - 20 Jahre,75,32,43
False,8128061,Königheim,20 - 25 Jahre,177,98,79
False,8128061,Königheim,25 - 30 Jahre,204,107,97
False,8128061,Königheim,30 - 35 Jahre,249,135,114
False,8128061,Königheim,35 - 40 Jahre,292,169,123
False,8128061,Königheim,40 - 45 Jahre,259,136,123
False,8128061,Königheim,45 - 50 Jahre,208,115,93
False,8128061,Königheim,50 - 55 Jahre,210,100,110
False,8128061,Königheim,55 - 60 Jahre,171,96,75
False,8128061,Königheim,60 - 65 Jahre,230,119,111
False,8128061,Königheim,65 - 75 Jahre,317,143,174
False,8128061,Königheim,75 und mehr Jahre,267,84,183
False,8128061,Königheim,Insgesamt,3362,1698,1664
False,8128064,"Külsheim, Stadt",unter 3 Jahre,186,107,79
False,8128064,"Külsheim, Stadt",3 -  6 Jahre,204,112,92
False,8128064,"Külsheim, Stadt",6 - 10 Jahre,298,149,149
False,8128064,"Külsheim, Stadt",10 - 15 Jahre,417,230,187
False,8128064,"Külsheim, Stadt",15 - 18 Jahre,214,107,107
False,8128064,"Külsheim, Stadt",18 - 20 Jahre,151,86,65
False,8128064,"Külsheim, Stadt",20 - 25 Jahre,346,178,168
False,8128064,"Külsheim, Stadt",25 - 30 Jahre,324,175,149
False,8128064,"Külsheim, Stadt",30 - 35 Jahre,490,277,213
False,8128064,"Külsheim, Stadt",35 - 40 Jahre,546,301,245
False,8128064,"Külsheim, Stadt",40 - 45 Jahre,458,231,227
False,8128064,"Külsheim, Stadt",45 - 50 Jahre,403,207,196
False,8128064,"Külsheim, Stadt",50 - 55 Jahre,345,184,161
False,8128064,"Külsheim, Stadt",55 - 60 Jahre,259,138,121
False,8128064,"Külsheim, Stadt",60 - 65 Jahre,382,201,181
False,8128064,"Külsheim, Stadt",65 - 75 Jahre,502,231,271
False,8128064,"Külsheim, Stadt",75 und mehr Jahre,382,131,251
False,8128064,"Külsheim, Stadt",Insgesamt,5907,3045,2862
False,8128082,"Niederstetten, Stadt",unter 3 Jahre,169,90,79
False,8128082,"Niederstetten, Stadt",3 -  6 Jahre,170,83,87
False,8128082,"Niederstetten, Stadt",6 - 10 Jahre,263,128,135
False,8128082,"Niederstetten, Stadt",10 - 15 Jahre,333,177,156
False,8128082,"Niederstetten, Stadt",15 - 18 Jahre,224,114,110
False,8128082,"Niederstetten, Stadt",18 - 20 Jahre,133,72,61
False,8128082,"Niederstetten, Stadt",20 - 25 Jahre,312,151,161
False,8128082,"Niederstetten, Stadt",25 - 30 Jahre,346,191,155
False,8128082,"Niederstetten, Stadt",30 - 35 Jahre,441,254,187
False,8128082,"Niederstetten, Stadt",35 - 40 Jahre,588,358,230
False,8128082,"Niederstetten, Stadt",40 - 45 Jahre,423,209,214
False,8128082,"Niederstetten, Stadt",45 - 50 Jahre,372,196,176
False,8128082,"Niederstetten, Stadt",50 - 55 Jahre,313,163,150
False,8128082,"Niederstetten, Stadt",55 - 60 Jahre,267,151,116
False,8128082,"Niederstetten, Stadt",60 - 65 Jahre,321,156,165
False,8128082,"Niederstetten, Stadt",65 - 75 Jahre,469,240,229
False,8128082,"Niederstetten, Stadt",75 und mehr Jahre,382,120,262
False,8128082,"Niederstetten, Stadt",Insgesamt,5526,2853,2673
False,8128115,"Tauberbischofsheim, Stadt",unter 3 Jahre,379,208,171
False,8128115,"Tauberbischofsheim, Stadt",3 -  6 Jahre,406,206,200
False,8128115,"Tauberbischofsheim, Stadt",6 - 10 Jahre,559,309,250
False,8128115,"Tauberbischofsheim, Stadt",10 - 15 Jahre,828,381,447
False,8128115,"Tauberbischofsheim, Stadt",15 - 18 Jahre,443,252,191
False,8128115,"Tauberbischofsheim, Stadt",18 - 20 Jahre,362,182,180
False,8128115,"Tauberbischofsheim, Stadt",20 - 25 Jahre,755,376,379
False,8128115,"Tauberbischofsheim, Stadt",25 - 30 Jahre,858,422,436
False,8128115,"Tauberbischofsheim, Stadt",30 - 35 Jahre,1050,563,487
False,8128115,"Tauberbischofsheim, Stadt",35 - 40 Jahre,1090,585,505
False,8128115,"Tauberbischofsheim, Stadt",40 - 45 Jahre,1001,505,496
False,8128115,"Tauberbischofsheim, Stadt",45 - 50 Jahre,938,481,457
False,8128115,"Tauberbischofsheim, Stadt",50 - 55 Jahre,827,414,413
False,8128115,"Tauberbischofsheim, Stadt",55 - 60 Jahre,723,367,356
False,8128115,"Tauberbischofsheim, Stadt",60 - 65 Jahre,829,417,412
False,8128115,"Tauberbischofsheim, Stadt",65 - 75 Jahre,1175,517,658
False,8128115,"Tauberbischofsheim, Stadt",75 und mehr Jahre,1043,317,726
False,8128115,"Tauberbischofsheim, Stadt",Insgesamt,13266,6502,6764
False,8128126,"Weikersheim, Stadt",unter 3 Jahre,241,118,123
False,8128126,"Weikersheim, Stadt",3 -  6 Jahre,248,127,121
False,8128126,"Weikersheim, Stadt",6 - 10 Jahre,332,185,147
False,8128126,"Weikersheim, Stadt",10 - 15 Jahre,469,240,229
False,8128126,"Weikersheim, Stadt",15 - 18 Jahre,272,134,138
False,8128126,"Weikersheim, Stadt",18 - 20 Jahre,168,95,73
False,8128126,"Weikersheim, Stadt",20 - 25 Jahre,402,195,207
False,8128126,"Weikersheim, Stadt",25 - 30 Jahre,410,205,205
False,8128126,"Weikersheim, Stadt",30 - 35 Jahre,628,311,317
False,8128126,"Weikersheim, Stadt",35 - 40 Jahre,595,315,280
False,8128126,"Weikersheim, Stadt",40 - 45 Jahre,563,294,269
False,8128126,"Weikersheim, Stadt",45 - 50 Jahre,484,246,238
False,8128126,"Weikersheim, Stadt",50 - 55 Jahre,429,229,200
False,8128126,"Weikersheim, Stadt",55 - 60 Jahre,445,219,226
False,8128126,"Weikersheim, Stadt",60 - 65 Jahre,512,264,248
False,8128126,"Weikersheim, Stadt",65 - 75 Jahre,711,333,378
False,8128126,"Weikersheim, Stadt",75 und mehr Jahre,583,191,392
False,8128126,"Weikersheim, Stadt",Insgesamt,7492,3701,3791
False,8128128,Werbach,unter 3 Jahre,105,54,51
False,8128128,Werbach,3 -  6 Jahre,135,62,73
False,8128128,Werbach,6 - 10 Jahre,184,91,93
False,8128128,Werbach,10 - 15 Jahre,259,133,126
False,8128128,Werbach,15 - 18 Jahre,141,61,80
False,8128128,Werbach,18 - 20 Jahre,92,53,39
False,8128128,Werbach,20 - 25 Jahre,152,80,72
False,8128128,Werbach,25 - 30 Jahre,189,89,100
False,8128128,Werbach,30 - 35 Jahre,308,169,139
False,8128128,Werbach,35 - 40 Jahre,320,165,155
False,8128128,Werbach,40 - 45 Jahre,333,184,149
False,8128128,Werbach,45 - 50 Jahre,242,126,116
False,8128128,Werbach,50 - 55 Jahre,203,113,90
False,8128128,Werbach,55 - 60 Jahre,168,93,75
False,8128128,Werbach,60 - 65 Jahre,206,100,106
False,8128128,Werbach,65 - 75 Jahre,353,167,186
False,8128128,Werbach,75 und mehr Jahre,269,90,179
False,8128128,Werbach,Insgesamt,3659,1830,1829
False,8128131,"Wertheim, Stadt",unter 3 Jahre,698,354,344
False,8128131,"Wertheim, Stadt",3 -  6 Jahre,763,393,370
False,8128131,"Wertheim, Stadt",6 - 10 Jahre,1093,574,519
False,8128131,"Wertheim, Stadt",10 - 15 Jahre,1501,761,740
False,8128131,"Wertheim, Stadt",15 - 18 Jahre,932,484,448
False,8128131,"Wertheim, Stadt",18 - 20 Jahre,611,312,299
False,8128131,"Wertheim, Stadt",20 - 25 Jahre,1392,733,659
False,8128131,"Wertheim, Stadt",25 - 30 Jahre,1342,684,658
False,8128131,"Wertheim, Stadt",30 - 35 Jahre,1834,929,905
False,8128131,"Wertheim, Stadt",35 - 40 Jahre,2076,1039,1037
False,8128131,"Wertheim, Stadt",40 - 45 Jahre,1886,1020,866
False,8128131,"Wertheim, Stadt",45 - 50 Jahre,1631,771,860
False,8128131,"Wertheim, Stadt",50 - 55 Jahre,1436,741,695
False,8128131,"Wertheim, Stadt",55 - 60 Jahre,1178,589,589
False,8128131,"Wertheim, Stadt",60 - 65 Jahre,1522,744,778
False,8128131,"Wertheim, Stadt",65 - 75 Jahre,2454,1119,1335
False,8128131,"Wertheim, Stadt",75 und mehr Jahre,1983,608,1375
False,8128131,"Wertheim, Stadt",Insgesamt,24332,11855,12477
False,8128137,Wittighausen,unter 3 Jahre,53,24,29
False,8128137,Wittighausen,3 -  6 Jahre,51,32,19
False,8128137,Wittighausen,6 - 10 Jahre,95,42,53
False,8128137,Wittighausen,10 - 15 Jahre,112,50,62
False,8128137,Wittighausen,15 - 18 Jahre,60,36,24
False,8128137,Wittighausen,18 - 20 Jahre,56,27,29
False,8128137,Wittighausen,20 - 25 Jahre,95,48,47
False,8128137,Wittighausen,25 - 30 Jahre,94,48,46
False,8128137,Wittighausen,30 - 35 Jahre,151,90,61
False,8128137,Wittighausen,35 - 40 Jahre,133,62,71
False,8128137,Wittighausen,40 - 45 Jahre,155,89,66
False,8128137,Wittighausen,45 - 50 Jahre,116,66,50
False,8128137,Wittighausen,50 - 55 Jahre,102,49,53
False,8128137,Wittighausen,55 - 60 Jahre,78,39,39
False,8128137,Wittighausen,60 - 65 Jahre,116,65,51
False,8128137,Wittighausen,65 - 75 Jahre,154,65,89
False,8128137,Wittighausen,75 und mehr Jahre,111,38,73
False,8128137,Wittighausen,Insgesamt,1732,870,862
False,8128138,Ahorn,unter 3 Jahre,73,39,34
False,8128138,Ahorn,3 -  6 Jahre,93,50,43
False,8128138,Ahorn,6 - 10 Jahre,130,76,54
False,8128138,Ahorn,10 - 15 Jahre,148,76,72
False,8128138,Ahorn,15 - 18 Jahre,76,42,34
False,8128138,Ahorn,18 - 20 Jahre,43,27,16
False,8128138,Ahorn,20 - 25 Jahre,90,51,39
False,8128138,Ahorn,25 - 30 Jahre,101,46,55
False,8128138,Ahorn,30 - 35 Jahre,172,94,78
False,8128138,Ahorn,35 - 40 Jahre,236,120,116
False,8128138,Ahorn,40 - 45 Jahre,186,106,80
False,8128138,Ahorn,45 - 50 Jahre,143,76,67
False,8128138,Ahorn,50 - 55 Jahre,144,80,64
False,8128138,Ahorn,55 - 60 Jahre,86,43,43
False,8128138,Ahorn,60 - 65 Jahre,145,74,71
False,8128138,Ahorn,65 - 75 Jahre,228,106,122
False,8128138,Ahorn,75 und mehr Jahre,204,58,146
False,8128138,Ahorn,Insgesamt,2298,1164,1134
False,8128139,"Lauda-Königshofen, Stadt",unter 3 Jahre,415,213,202
False,8128139,"Lauda-Königshofen, Stadt",3 -  6 Jahre,514,257,257
False,8128139,"Lauda-Königshofen, Stadt",6 - 10 Jahre,702,392,310
False,8128139,"Lauda-Königshofen, Stadt",10 - 15 Jahre,919,477,442
False,8128139,"Lauda-Königshofen, Stadt",15 - 18 Jahre,594,318,276
False,8128139,"Lauda-Königshofen, Stadt",18 - 20 Jahre,374,196,178
False,8128139,"Lauda-Königshofen, Stadt",20 - 25 Jahre,865,456,409
False,8128139,"Lauda-Königshofen, Stadt",25 - 30 Jahre,871,470,401
False,8128139,"Lauda-Königshofen, Stadt",30 - 35 Jahre,1110,583,527
False,8128139,"Lauda-Königshofen, Stadt",35 - 40 Jahre,1247,615,632
False,8128139,"Lauda-Königshofen, Stadt",40 - 45 Jahre,1169,576,593
False,8128139,"Lauda-Königshofen, Stadt",45 - 50 Jahre,1080,541,539
False,8128139,"Lauda-Königshofen, Stadt",50 - 55 Jahre,935,472,463
False,8128139,"Lauda-Königshofen, Stadt",55 - 60 Jahre,866,420,446
False,8128139,"Lauda-Königshofen, Stadt",60 - 65 Jahre,1065,564,501
False,8128139,"Lauda-Königshofen, Stadt",65 - 75 Jahre,1366,633,733
False,8128139,"Lauda-Königshofen, Stadt",75 und mehr Jahre,1162,383,779
False,8128139,"Lauda-Königshofen, Stadt",Insgesamt,15254,7566,7688
False,8135,Landkreis Heidenheim,unter 3 Jahre,4149,2167,1982
False,8135,Landkreis Heidenheim,3 -  6 Jahre,4444,2280,2164
False,8135,Landkreis Heidenheim,6 - 10 Jahre,6428,3265,3163
False,8135,Landkreis Heidenheim,10 - 15 Jahre,8612,4533,4079
False,8135,Landkreis Heidenheim,15 - 18 Jahre,4922,2512,2410
False,8135,Landkreis Heidenheim,18 - 20 Jahre,3354,1696,1658
False,8135,Landkreis Heidenheim,20 - 25 Jahre,7399,3828,3571
False,8135,Landkreis Heidenheim,25 - 30 Jahre,8010,4073,3937
False,8135,Landkreis Heidenheim,30 - 35 Jahre,10532,5389,5143
False,8135,Landkreis Heidenheim,35 - 40 Jahre,11121,5782,5339
False,8135,Landkreis Heidenheim,40 - 45 Jahre,10252,5212,5040
False,8135,Landkreis Heidenheim,45 - 50 Jahre,8871,4544,4327
False,8135,Landkreis Heidenheim,50 - 55 Jahre,8000,4020,3980
False,8135,Landkreis Heidenheim,55 - 60 Jahre,7547,3749,3798
False,8135,Landkreis Heidenheim,60 - 65 Jahre,9275,4497,4778
False,8135,Landkreis Heidenheim,65 - 75 Jahre,13704,6236,7468
False,8135,Landkreis Heidenheim,75 und mehr Jahre,10356,3351,7005
False,8135,Landkreis Heidenheim,Insgesamt,136976,67134,69842
False,8135010,Dischingen,unter 3 Jahre,129,61,68
False,8135010,Dischingen,3 -  6 Jahre,168,93,75
False,8135010,Dischingen,6 - 10 Jahre,247,151,96
False,8135010,Dischingen,10 - 15 Jahre,329,179,150
False,8135010,Dischingen,15 - 18 Jahre,171,92,79
False,8135010,Dischingen,18 - 20 Jahre,107,73,34
False,8135010,Dischingen,20 - 25 Jahre,236,119,117
False,8135010,Dischingen,25 - 30 Jahre,265,141,124
False,8135010,Dischingen,30 - 35 Jahre,366,191,175
False,8135010,Dischingen,35 - 40 Jahre,391,209,182
False,8135010,Dischingen,40 - 45 Jahre,394,218,176
False,8135010,Dischingen,45 - 50 Jahre,315,172,143
False,8135010,Dischingen,50 - 55 Jahre,265,142,123
False,8135010,Dischingen,55 - 60 Jahre,198,107,91
False,8135010,Dischingen,60 - 65 Jahre,269,132,137
False,8135010,Dischingen,65 - 75 Jahre,450,210,240
False,8135010,Dischingen,75 und mehr Jahre,321,106,215
False,8135010,Dischingen,Insgesamt,4621,2396,2225
False,8135015,Gerstetten,unter 3 Jahre,399,197,202
False,8135015,Gerstetten,3 -  6 Jahre,460,225,235
False,8135015,Gerstetten,6 - 10 Jahre,635,330,305
False,8135015,Gerstetten,10 - 15 Jahre,862,426,436
False,8135015,Gerstetten,15 - 18 Jahre,459,229,230
False,8135015,Gerstetten,18 - 20 Jahre,273,128,145
False,8135015,Gerstetten,20 - 25 Jahre,591,301,290
False,8135015,Gerstetten,25 - 30 Jahre,690,350,340
False,8135015,Gerstetten,30 - 35 Jahre,949,473,476
False,8135015,Gerstetten,35 - 40 Jahre,1036,558,478
False,8135015,Gerstetten,40 - 45 Jahre,960,493,467
False,8135015,Gerstetten,45 - 50 Jahre,760,397,363
False,8135015,Gerstetten,50 - 55 Jahre,689,371,318
False,8135015,Gerstetten,55 - 60 Jahre,556,275,281
False,8135015,Gerstetten,60 - 65 Jahre,815,398,417
False,8135015,Gerstetten,65 - 75 Jahre,1097,498,599
False,8135015,Gerstetten,75 und mehr Jahre,832,258,574
False,8135015,Gerstetten,Insgesamt,12063,5907,6156
False,8135016,"Giengen an der Brenz, Stadt",unter 3 Jahre,628,343,285
False,8135016,"Giengen an der Brenz, Stadt",3 -  6 Jahre,634,344,290
False,8135016,"Giengen an der Brenz, Stadt",6 - 10 Jahre,990,520,470
False,8135016,"Giengen an der Brenz, Stadt",10 - 15 Jahre,1274,692,582
False,8135016,"Giengen an der Brenz, Stadt",15 - 18 Jahre,706,356,350
False,8135016,"Giengen an der Brenz, Stadt",18 - 20 Jahre,502,246,256
False,8135016,"Giengen an der Brenz, Stadt",20 - 25 Jahre,1141,585,556
False,8135016,"Giengen an der Brenz, Stadt",25 - 30 Jahre,1212,589,623
False,8135016,"Giengen an der Brenz, Stadt",30 - 35 Jahre,1669,845,824
False,8135016,"Giengen an der Brenz, Stadt",35 - 40 Jahre,1615,865,750
False,8135016,"Giengen an der Brenz, Stadt",40 - 45 Jahre,1409,727,682
False,8135016,"Giengen an der Brenz, Stadt",45 - 50 Jahre,1319,687,632
False,8135016,"Giengen an der Brenz, Stadt",50 - 55 Jahre,1138,560,578
False,8135016,"Giengen an der Brenz, Stadt",55 - 60 Jahre,1120,547,573
False,8135016,"Giengen an der Brenz, Stadt",60 - 65 Jahre,1368,659,709
False,8135016,"Giengen an der Brenz, Stadt",65 - 75 Jahre,2037,945,1092
False,8135016,"Giengen an der Brenz, Stadt",75 und mehr Jahre,1556,491,1065
False,8135016,"Giengen an der Brenz, Stadt",Insgesamt,20318,10001,10317
False,8135019,"Heidenheim an der Brenz, Stadt",unter 3 Jahre,1431,746,685
False,8135019,"Heidenheim an der Brenz, Stadt",3 -  6 Jahre,1510,807,703
False,8135019,"Heidenheim an der Brenz, Stadt",6 - 10 Jahre,2180,1075,1105
False,8135019,"Heidenheim an der Brenz, Stadt",10 - 15 Jahre,2999,1585,1414
False,8135019,"Heidenheim an der Brenz, Stadt",15 - 18 Jahre,1808,934,874
False,8135019,"Heidenheim an der Brenz, Stadt",18 - 20 Jahre,1287,659,628
False,8135019,"Heidenheim an der Brenz, Stadt",20 - 25 Jahre,2884,1462,1422
False,8135019,"Heidenheim an der Brenz, Stadt",25 - 30 Jahre,3117,1605,1512
False,8135019,"Heidenheim an der Brenz, Stadt",30 - 35 Jahre,3709,1908,1801
False,8135019,"Heidenheim an der Brenz, Stadt",35 - 40 Jahre,3959,2030,1929
False,8135019,"Heidenheim an der Brenz, Stadt",40 - 45 Jahre,3674,1882,1792
False,8135019,"Heidenheim an der Brenz, Stadt",45 - 50 Jahre,3299,1650,1649
False,8135019,"Heidenheim an der Brenz, Stadt",50 - 55 Jahre,3029,1484,1545
False,8135019,"Heidenheim an der Brenz, Stadt",55 - 60 Jahre,2976,1462,1514
False,8135019,"Heidenheim an der Brenz, Stadt",60 - 65 Jahre,3556,1709,1847
False,8135019,"Heidenheim an der Brenz, Stadt",65 - 75 Jahre,5369,2366,3003
False,8135019,"Heidenheim an der Brenz, Stadt",75 und mehr Jahre,4394,1431,2963
False,8135019,"Heidenheim an der Brenz, Stadt",Insgesamt,51181,24795,26386
False,8135020,"Herbrechtingen, Stadt",unter 3 Jahre,416,215,201
False,8135020,"Herbrechtingen, Stadt",3 -  6 Jahre,455,217,238
False,8135020,"Herbrechtingen, Stadt",6 - 10 Jahre,603,313,290
False,8135020,"Herbrechtingen, Stadt",10 - 15 Jahre,784,409,375
False,8135020,"Herbrechtingen, Stadt",15 - 18 Jahre,455,243,212
False,8135020,"Herbrechtingen, Stadt",18 - 20 Jahre,279,122,157
False,8135020,"Herbrechtingen, Stadt",20 - 25 Jahre,713,378,335
False,8135020,"Herbrechtingen, Stadt",25 - 30 Jahre,744,360,384
False,8135020,"Herbrechtingen, Stadt",30 - 35 Jahre,1056,536,520
False,8135020,"Herbrechtingen, Stadt",35 - 40 Jahre,1100,580,520
False,8135020,"Herbrechtingen, Stadt",40 - 45 Jahre,1031,522,509
False,8135020,"Herbrechtingen, Stadt",45 - 50 Jahre,861,438,423
False,8135020,"Herbrechtingen, Stadt",50 - 55 Jahre,784,396,388
False,8135020,"Herbrechtingen, Stadt",55 - 60 Jahre,718,359,359
False,8135020,"Herbrechtingen, Stadt",60 - 65 Jahre,846,393,453
False,8135020,"Herbrechtingen, Stadt",65 - 75 Jahre,1403,662,741
False,8135020,"Herbrechtingen, Stadt",75 und mehr Jahre,988,332,656
False,8135020,"Herbrechtingen, Stadt",Insgesamt,13236,6475,6761
False,8135021,Hermaringen,unter 3 Jahre,65,37,28
False,8135021,Hermaringen,3 -  6 Jahre,67,31,36
False,8135021,Hermaringen,6 - 10 Jahre,138,62,76
False,8135021,Hermaringen,10 - 15 Jahre,154,75,79
False,8135021,Hermaringen,15 - 18 Jahre,69,38,31
False,8135021,Hermaringen,18 - 20 Jahre,53,24,29
False,8135021,Hermaringen,20 - 25 Jahre,105,63,42
False,8135021,Hermaringen,25 - 30 Jahre,127,66,61
False,8135021,Hermaringen,30 - 35 Jahre,166,89,77
False,8135021,Hermaringen,35 - 40 Jahre,197,107,90
False,8135021,Hermaringen,40 - 45 Jahre,195,98,97
False,8135021,Hermaringen,45 - 50 Jahre,128,70,58
False,8135021,Hermaringen,50 - 55 Jahre,123,65,58
False,8135021,Hermaringen,55 - 60 Jahre,108,47,61
False,8135021,Hermaringen,60 - 65 Jahre,164,85,79
False,8135021,Hermaringen,65 - 75 Jahre,243,114,129
False,8135021,Hermaringen,75 und mehr Jahre,141,49,92
False,8135021,Hermaringen,Insgesamt,2243,1120,1123
False,8135025,Königsbronn,unter 3 Jahre,209,107,102
False,8135025,Königsbronn,3 -  6 Jahre,255,122,133
False,8135025,Königsbronn,6 - 10 Jahre,362,189,173
False,8135025,Königsbronn,10 - 15 Jahre,474,248,226
False,8135025,Königsbronn,15 - 18 Jahre,268,123,145
False,8135025,Königsbronn,18 - 20 Jahre,177,84,93
False,8135025,Königsbronn,20 - 25 Jahre,332,174,158
False,8135025,Königsbronn,25 - 30 Jahre,375,203,172
False,8135025,Königsbronn,30 - 35 Jahre,530,279,251
False,8135025,Königsbronn,35 - 40 Jahre,612,325,287
False,8135025,Königsbronn,40 - 45 Jahre,544,258,286
False,8135025,Königsbronn,45 - 50 Jahre,539,284,255
False,8135025,Königsbronn,50 - 55 Jahre,461,225,236
False,8135025,Königsbronn,55 - 60 Jahre,497,246,251
False,8135025,Königsbronn,60 - 65 Jahre,557,276,281
False,8135025,Königsbronn,65 - 75 Jahre,784,367,417
False,8135025,Königsbronn,75 und mehr Jahre,492,157,335
False,8135025,Königsbronn,Insgesamt,7468,3667,3801
False,8135026,Nattheim,unter 3 Jahre,217,115,102
False,8135026,Nattheim,3 -  6 Jahre,228,118,110
False,8135026,Nattheim,6 - 10 Jahre,298,138,160
False,8135026,Nattheim,10 - 15 Jahre,406,230,176
False,8135026,Nattheim,15 - 18 Jahre,228,110,118
False,8135026,Nattheim,18 - 20 Jahre,156,75,81
False,8135026,Nattheim,20 - 25 Jahre,322,157,165
False,8135026,Nattheim,25 - 30 Jahre,369,187,182
False,8135026,Nattheim,30 - 35 Jahre,563,287,276
False,8135026,Nattheim,35 - 40 Jahre,577,302,275
False,8135026,Nattheim,40 - 45 Jahre,482,236,246
False,8135026,Nattheim,45 - 50 Jahre,404,205,199
False,8135026,Nattheim,50 - 55 Jahre,363,177,186
False,8135026,Nattheim,55 - 60 Jahre,364,191,173
False,8135026,Nattheim,60 - 65 Jahre,465,239,226
False,8135026,Nattheim,65 - 75 Jahre,536,246,290
False,8135026,Nattheim,75 und mehr Jahre,337,108,229
False,8135026,Nattheim,Insgesamt,6315,3121,3194
False,8135027,"Niederstotzingen, Stadt",unter 3 Jahre,179,95,84
False,8135027,"Niederstotzingen, Stadt",3 -  6 Jahre,171,82,89
False,8135027,"Niederstotzingen, Stadt",6 - 10 Jahre,243,123,120
False,8135027,"Niederstotzingen, Stadt",10 - 15 Jahre,356,182,174
False,8135027,"Niederstotzingen, Stadt",15 - 18 Jahre,180,85,95
False,8135027,"Niederstotzingen, Stadt",18 - 20 Jahre,130,71,59
False,8135027,"Niederstotzingen, Stadt",20 - 25 Jahre,268,141,127
False,8135027,"Niederstotzingen, Stadt",25 - 30 Jahre,298,158,140
False,8135027,"Niederstotzingen, Stadt",30 - 35 Jahre,401,198,203
False,8135027,"Niederstotzingen, Stadt",35 - 40 Jahre,419,200,219
False,8135027,"Niederstotzingen, Stadt",40 - 45 Jahre,423,225,198
False,8135027,"Niederstotzingen, Stadt",45 - 50 Jahre,301,146,155
False,8135027,"Niederstotzingen, Stadt",50 - 55 Jahre,289,156,133
False,8135027,"Niederstotzingen, Stadt",55 - 60 Jahre,254,135,119
False,8135027,"Niederstotzingen, Stadt",60 - 65 Jahre,282,136,146
False,8135027,"Niederstotzingen, Stadt",65 - 75 Jahre,421,193,228
False,8135027,"Niederstotzingen, Stadt",75 und mehr Jahre,298,88,210
False,8135027,"Niederstotzingen, Stadt",Insgesamt,4913,2414,2499
False,8135031,Sontheim an der Brenz,unter 3 Jahre,188,96,92
False,8135031,Sontheim an der Brenz,3 -  6 Jahre,193,92,101
False,8135031,Sontheim an der Brenz,6 - 10 Jahre,267,134,133
False,8135031,Sontheim an der Brenz,10 - 15 Jahre,358,200,158
False,8135031,Sontheim an der Brenz,15 - 18 Jahre,217,121,96
False,8135031,Sontheim an der Brenz,18 - 20 Jahre,163,84,79
False,8135031,Sontheim an der Brenz,20 - 25 Jahre,312,163,149
False,8135031,Sontheim an der Brenz,25 - 30 Jahre,321,170,151
False,8135031,Sontheim an der Brenz,30 - 35 Jahre,454,242,212
False,8135031,Sontheim an der Brenz,35 - 40 Jahre,509,251,258
False,8135031,Sontheim an der Brenz,40 - 45 Jahre,470,247,223
False,8135031,Sontheim an der Brenz,45 - 50 Jahre,346,181,165
False,8135031,Sontheim an der Brenz,50 - 55 Jahre,350,186,164
False,8135031,Sontheim an der Brenz,55 - 60 Jahre,278,141,137
False,8135031,Sontheim an der Brenz,60 - 65 Jahre,352,181,171
False,8135031,Sontheim an der Brenz,65 - 75 Jahre,511,242,269
False,8135031,Sontheim an der Brenz,75 und mehr Jahre,405,142,263
False,8135031,Sontheim an der Brenz,Insgesamt,5694,2873,2821
False,8135032,Steinheim am Albuch,unter 3 Jahre,288,155,133
False,8135032,Steinheim am Albuch,3 -  6 Jahre,303,149,154
False,8135032,Steinheim am Albuch,6 - 10 Jahre,465,230,235
False,8135032,Steinheim am Albuch,10 - 15 Jahre,616,307,309
False,8135032,Steinheim am Albuch,15 - 18 Jahre,361,181,180
False,8135032,Steinheim am Albuch,18 - 20 Jahre,227,130,97
False,8135032,Steinheim am Albuch,20 - 25 Jahre,495,285,210
False,8135032,Steinheim am Albuch,25 - 30 Jahre,492,244,248
False,8135032,Steinheim am Albuch,30 - 35 Jahre,669,341,328
False,8135032,Steinheim am Albuch,35 - 40 Jahre,706,355,351
False,8135032,Steinheim am Albuch,40 - 45 Jahre,670,306,364
False,8135032,Steinheim am Albuch,45 - 50 Jahre,599,314,285
False,8135032,Steinheim am Albuch,50 - 55 Jahre,509,258,251
False,8135032,Steinheim am Albuch,55 - 60 Jahre,478,239,239
False,8135032,Steinheim am Albuch,60 - 65 Jahre,601,289,312
False,8135032,Steinheim am Albuch,65 - 75 Jahre,853,393,460
False,8135032,Steinheim am Albuch,75 und mehr Jahre,592,189,403
False,8135032,Steinheim am Albuch,Insgesamt,8924,4365,4559
False,8136,Landkreis Ostalbkreis,unter 3 Jahre,10521,5330,5191
False,8136,Landkreis Ostalbkreis,3 -  6 Jahre,11013,5688,5325
False,8136,Landkreis Ostalbkreis,6 - 10 Jahre,15400,7907,7493
False,8136,Landkreis Ostalbkreis,10 - 15 Jahre,19933,10203,9730
False,8136,Landkreis Ostalbkreis,15 - 18 Jahre,11150,5594,5556
False,8136,Landkreis Ostalbkreis,18 - 20 Jahre,7768,3994,3774
False,8136,Landkreis Ostalbkreis,20 - 25 Jahre,18339,9350,8989
False,8136,Landkreis Ostalbkreis,25 - 30 Jahre,19648,10170,9478
False,8136,Landkreis Ostalbkreis,30 - 35 Jahre,25003,12940,12063
False,8136,Landkreis Ostalbkreis,35 - 40 Jahre,26353,13717,12636
False,8136,Landkreis Ostalbkreis,40 - 45 Jahre,23847,12286,11561
False,8136,Landkreis Ostalbkreis,45 - 50 Jahre,20513,10356,10157
False,8136,Landkreis Ostalbkreis,50 - 55 Jahre,17920,9102,8818
False,8136,Landkreis Ostalbkreis,55 - 60 Jahre,16962,8561,8401
False,8136,Landkreis Ostalbkreis,60 - 65 Jahre,19850,9805,10045
False,8136,Landkreis Ostalbkreis,65 - 75 Jahre,28249,13016,15233
False,8136,Landkreis Ostalbkreis,75 und mehr Jahre,21729,6705,15024
False,8136,Landkreis Ostalbkreis,Insgesamt,314198,154724,159474
False,8136002,Abtsgmünd,unter 3 Jahre,262,139,123
False,8136002,Abtsgmünd,3 -  6 Jahre,261,129,132
False,8136002,Abtsgmünd,6 - 10 Jahre,392,215,177
False,8136002,Abtsgmünd,10 - 15 Jahre,503,228,275
False,8136002,Abtsgmünd,15 - 18 Jahre,258,144,114
False,8136002,Abtsgmünd,18 - 20 Jahre,165,84,81
False,8136002,Abtsgmünd,20 - 25 Jahre,386,204,182
False,8136002,Abtsgmünd,25 - 30 Jahre,435,249,186
False,8136002,Abtsgmünd,30 - 35 Jahre,655,352,303
False,8136002,Abtsgmünd,35 - 40 Jahre,630,319,311
False,8136002,Abtsgmünd,40 - 45 Jahre,594,312,282
False,8136002,Abtsgmünd,45 - 50 Jahre,468,238,230
False,8136002,Abtsgmünd,50 - 55 Jahre,350,203,147
False,8136002,Abtsgmünd,55 - 60 Jahre,347,162,185
False,8136002,Abtsgmünd,60 - 65 Jahre,464,229,235
False,8136002,Abtsgmünd,65 - 75 Jahre,643,296,347
False,8136002,Abtsgmünd,75 und mehr Jahre,476,149,327
False,8136002,Abtsgmünd,Insgesamt,7289,3652,3637
False,8136003,Adelmannsfelden,unter 3 Jahre,70,26,44
False,8136003,Adelmannsfelden,3 -  6 Jahre,99,51,48
False,8136003,Adelmannsfelden,6 - 10 Jahre,110,57,53
False,8136003,Adelmannsfelden,10 - 15 Jahre,126,66,60
False,8136003,Adelmannsfelden,15 - 18 Jahre,54,25,29
False,8136003,Adelmannsfelden,18 - 20 Jahre,27,13,14
False,8136003,Adelmannsfelden,20 - 25 Jahre,89,42,47
False,8136003,Adelmannsfelden,25 - 30 Jahre,98,50,48
False,8136003,Adelmannsfelden,30 - 35 Jahre,143,79,64
False,8136003,Adelmannsfelden,35 - 40 Jahre,177,91,86
False,8136003,Adelmannsfelden,40 - 45 Jahre,155,84,71
False,8136003,Adelmannsfelden,45 - 50 Jahre,111,65,46
False,8136003,Adelmannsfelden,50 - 55 Jahre,83,44,39
False,8136003,Adelmannsfelden,55 - 60 Jahre,85,41,44
False,8136003,Adelmannsfelden,60 - 65 Jahre,114,58,56
False,8136003,Adelmannsfelden,65 - 75 Jahre,137,58,79
False,8136003,Adelmannsfelden,75 und mehr Jahre,116,35,81
False,8136003,Adelmannsfelden,Insgesamt,1794,885,909
False,8136007,Bartholomä,unter 3 Jahre,61,29,32
False,8136007,Bartholomä,3 -  6 Jahre,83,34,49
False,8136007,Bartholomä,6 - 10 Jahre,123,61,62
False,8136007,Bartholomä,10 - 15 Jahre,162,78,84
False,8136007,Bartholomä,15 - 18 Jahre,72,40,32
False,8136007,Bartholomä,18 - 20 Jahre,64,30,34
False,8136007,Bartholomä,20 - 25 Jahre,110,55,55
False,8136007,Bartholomä,25 - 30 Jahre,124,57,67
False,8136007,Bartholomä,30 - 35 Jahre,167,74,93
False,8136007,Bartholomä,35 - 40 Jahre,205,107,98
False,8136007,Bartholomä,40 - 45 Jahre,175,94,81
False,8136007,Bartholomä,45 - 50 Jahre,151,79,72
False,8136007,Bartholomä,50 - 55 Jahre,134,73,61
False,8136007,Bartholomä,55 - 60 Jahre,93,50,43
False,8136007,Bartholomä,60 - 65 Jahre,125,59,66
False,8136007,Bartholomä,65 - 75 Jahre,190,93,97
False,8136007,Bartholomä,75 und mehr Jahre,120,31,89
False,8136007,Bartholomä,Insgesamt,2159,1044,1115
False,8136009,Böbingen an der Rems,unter 3 Jahre,165,90,75
False,8136009,Böbingen an der Rems,3 -  6 Jahre,169,94,75
False,8136009,Böbingen an der Rems,6 - 10 Jahre,238,126,112
False,8136009,Böbingen an der Rems,10 - 15 Jahre,291,142,149
False,8136009,Böbingen an der Rems,15 - 18 Jahre,163,77,86
False,8136009,Böbingen an der Rems,18 - 20 Jahre,108,51,57
False,8136009,Böbingen an der Rems,20 - 25 Jahre,288,146,142
False,8136009,Böbingen an der Rems,25 - 30 Jahre,285,145,140
False,8136009,Böbingen an der Rems,30 - 35 Jahre,430,214,216
False,8136009,Böbingen an der Rems,35 - 40 Jahre,369,189,180
False,8136009,Böbingen an der Rems,40 - 45 Jahre,315,167,148
False,8136009,Böbingen an der Rems,45 - 50 Jahre,289,138,151
False,8136009,Böbingen an der Rems,50 - 55 Jahre,272,125,147
False,8136009,Böbingen an der Rems,55 - 60 Jahre,265,129,136
False,8136009,Böbingen an der Rems,60 - 65 Jahre,301,150,151
False,8136009,Böbingen an der Rems,65 - 75 Jahre,374,183,191
False,8136009,Böbingen an der Rems,75 und mehr Jahre,248,71,177
False,8136009,Böbingen an der Rems,Insgesamt,4570,2237,2333
False,8136010,"Bopfingen, Stadt",unter 3 Jahre,421,212,209
False,8136010,"Bopfingen, Stadt",3 -  6 Jahre,435,211,224
False,8136010,"Bopfingen, Stadt",6 - 10 Jahre,578,302,276
False,8136010,"Bopfingen, Stadt",10 - 15 Jahre,873,436,437
False,8136010,"Bopfingen, Stadt",15 - 18 Jahre,486,253,233
False,8136010,"Bopfingen, Stadt",18 - 20 Jahre,342,174,168
False,8136010,"Bopfingen, Stadt",20 - 25 Jahre,751,389,362
False,8136010,"Bopfingen, Stadt",25 - 30 Jahre,735,374,361
False,8136010,"Bopfingen, Stadt",30 - 35 Jahre,908,492,416
False,8136010,"Bopfingen, Stadt",35 - 40 Jahre,972,506,466
False,8136010,"Bopfingen, Stadt",40 - 45 Jahre,951,503,448
False,8136010,"Bopfingen, Stadt",45 - 50 Jahre,869,445,424
False,8136010,"Bopfingen, Stadt",50 - 55 Jahre,768,402,366
False,8136010,"Bopfingen, Stadt",55 - 60 Jahre,617,327,290
False,8136010,"Bopfingen, Stadt",60 - 65 Jahre,781,373,408
False,8136010,"Bopfingen, Stadt",65 - 75 Jahre,1141,502,639
False,8136010,"Bopfingen, Stadt",75 und mehr Jahre,895,273,622
False,8136010,"Bopfingen, Stadt",Insgesamt,12523,6174,6349
False,8136015,Durlangen,unter 3 Jahre,101,50,51
False,8136015,Durlangen,3 -  6 Jahre,122,73,49
False,8136015,Durlangen,6 - 10 Jahre,168,85,83
False,8136015,Durlangen,10 - 15 Jahre,192,96,96
False,8136015,Durlangen,15 - 18 Jahre,114,52,62
False,8136015,Durlangen,18 - 20 Jahre,79,42,37
False,8136015,Durlangen,20 - 25 Jahre,156,81,75
False,8136015,Durlangen,25 - 30 Jahre,186,89,97
False,8136015,Durlangen,30 - 35 Jahre,238,134,104
False,8136015,Durlangen,35 - 40 Jahre,238,116,122
False,8136015,Durlangen,40 - 45 Jahre,223,116,107
False,8136015,Durlangen,45 - 50 Jahre,216,110,106
False,8136015,Durlangen,50 - 55 Jahre,166,85,81
False,8136015,Durlangen,55 - 60 Jahre,156,78,78
False,8136015,Durlangen,60 - 65 Jahre,196,97,99
False,8136015,Durlangen,65 - 75 Jahre,247,123,124
False,8136015,Durlangen,75 und mehr Jahre,143,45,98
False,8136015,Durlangen,Insgesamt,2941,1472,1469
False,8136018,Ellenberg,unter 3 Jahre,57,27,30
False,8136018,Ellenberg,3 -  6 Jahre,76,26,50
False,8136018,Ellenberg,6 - 10 Jahre,99,56,43
False,8136018,Ellenberg,10 - 15 Jahre,136,67,69
False,8136018,Ellenberg,15 - 18 Jahre,61,33,28
False,8136018,Ellenberg,18 - 20 Jahre,49,25,24
False,8136018,Ellenberg,20 - 25 Jahre,115,65,50
False,8136018,Ellenberg,25 - 30 Jahre,100,56,44
False,8136018,Ellenberg,30 - 35 Jahre,132,63,69
False,8136018,Ellenberg,35 - 40 Jahre,169,93,76
False,8136018,Ellenberg,40 - 45 Jahre,153,83,70
False,8136018,Ellenberg,45 - 50 Jahre,126,72,54
False,8136018,Ellenberg,50 - 55 Jahre,80,50,30
False,8136018,Ellenberg,55 - 60 Jahre,59,24,35
False,8136018,Ellenberg,60 - 65 Jahre,90,46,44
False,8136018,Ellenberg,65 - 75 Jahre,155,67,88
False,8136018,Ellenberg,75 und mehr Jahre,78,26,52
False,8136018,Ellenberg,Insgesamt,1735,879,856
False,8136019,"Ellwangen (Jagst), Stadt",unter 3 Jahre,879,442,437
False,8136019,"Ellwangen (Jagst), Stadt",3 -  6 Jahre,915,434,481
False,8136019,"Ellwangen (Jagst), Stadt",6 - 10 Jahre,1165,600,565
False,8136019,"Ellwangen (Jagst), Stadt",10 - 15 Jahre,1599,865,734
False,8136019,"Ellwangen (Jagst), Stadt",15 - 18 Jahre,915,459,456
False,8136019,"Ellwangen (Jagst), Stadt",18 - 20 Jahre,602,289,313
False,8136019,"Ellwangen (Jagst), Stadt",20 - 25 Jahre,1481,728,753
False,8136019,"Ellwangen (Jagst), Stadt",25 - 30 Jahre,1610,818,792
False,8136019,"Ellwangen (Jagst), Stadt",30 - 35 Jahre,2004,1044,960
False,8136019,"Ellwangen (Jagst), Stadt",35 - 40 Jahre,2061,1097,964
False,8136019,"Ellwangen (Jagst), Stadt",40 - 45 Jahre,1873,992,881
False,8136019,"Ellwangen (Jagst), Stadt",45 - 50 Jahre,1585,826,759
False,8136019,"Ellwangen (Jagst), Stadt",50 - 55 Jahre,1295,648,647
False,8136019,"Ellwangen (Jagst), Stadt",55 - 60 Jahre,1215,640,575
False,8136019,"Ellwangen (Jagst), Stadt",60 - 65 Jahre,1485,725,760
False,8136019,"Ellwangen (Jagst), Stadt",65 - 75 Jahre,2262,1005,1257
False,8136019,"Ellwangen (Jagst), Stadt",75 und mehr Jahre,1890,590,1300
False,8136019,"Ellwangen (Jagst), Stadt",Insgesamt,24836,12202,12634
False,8136020,Eschach,unter 3 Jahre,53,28,25
False,8136020,Eschach,3 -  6 Jahre,65,30,35
False,8136020,Eschach,6 - 10 Jahre,122,70,52
False,8136020,Eschach,10 - 15 Jahre,133,80,53
False,8136020,Eschach,15 - 18 Jahre,54,25,29
False,8136020,Eschach,18 - 20 Jahre,43,20,23
False,8136020,Eschach,20 - 25 Jahre,91,42,49
False,8136020,Eschach,25 - 30 Jahre,91,44,47
False,8136020,Eschach,30 - 35 Jahre,146,81,65
False,8136020,Eschach,35 - 40 Jahre,175,88,87
False,8136020,Eschach,40 - 45 Jahre,137,70,67
False,8136020,Eschach,45 - 50 Jahre,117,63,54
False,8136020,Eschach,50 - 55 Jahre,89,53,36
False,8136020,Eschach,55 - 60 Jahre,75,29,46
False,8136020,Eschach,60 - 65 Jahre,93,49,44
False,8136020,Eschach,65 - 75 Jahre,167,77,90
False,8136020,Eschach,75 und mehr Jahre,94,34,60
False,8136020,Eschach,Insgesamt,1745,883,862
False,8136021,Essingen,unter 3 Jahre,217,115,102
False,8136021,Essingen,3 -  6 Jahre,227,109,118
False,8136021,Essingen,6 - 10 Jahre,343,173,170
False,8136021,Essingen,10 - 15 Jahre,443,239,204
False,8136021,Essingen,15 - 18 Jahre,230,117,113
False,8136021,Essingen,18 - 20 Jahre,151,75,76
False,8136021,Essingen,20 - 25 Jahre,391,196,195
False,8136021,Essingen,25 - 30 Jahre,386,204,182
False,8136021,Essingen,30 - 35 Jahre,535,279,256
False,8136021,Essingen,35 - 40 Jahre,613,299,314
False,8136021,Essingen,40 - 45 Jahre,539,271,268
False,8136021,Essingen,45 - 50 Jahre,434,220,214
False,8136021,Essingen,50 - 55 Jahre,378,189,189
False,8136021,Essingen,55 - 60 Jahre,351,185,166
False,8136021,Essingen,60 - 65 Jahre,373,190,183
False,8136021,Essingen,65 - 75 Jahre,501,243,258
False,8136021,Essingen,75 und mehr Jahre,314,109,205
False,8136021,Essingen,Insgesamt,6426,3213,3213
False,8136024,Göggingen,unter 3 Jahre,88,45,43
False,8136024,Göggingen,3 -  6 Jahre,109,62,47
False,8136024,Göggingen,6 - 10 Jahre,145,72,73
False,8136024,Göggingen,10 - 15 Jahre,212,111,101
False,8136024,Göggingen,15 - 18 Jahre,107,51,56
False,8136024,Göggingen,18 - 20 Jahre,68,32,36
False,8136024,Göggingen,20 - 25 Jahre,120,51,69
False,8136024,Göggingen,25 - 30 Jahre,148,62,86
False,8136024,Göggingen,30 - 35 Jahre,194,98,96
False,8136024,Göggingen,35 - 40 Jahre,267,121,146
False,8136024,Göggingen,40 - 45 Jahre,229,122,107
False,8136024,Göggingen,45 - 50 Jahre,168,81,87
False,8136024,Göggingen,50 - 55 Jahre,129,69,60
False,8136024,Göggingen,55 - 60 Jahre,106,55,51
False,8136024,Göggingen,60 - 65 Jahre,146,75,71
False,8136024,Göggingen,65 - 75 Jahre,141,65,76
False,8136024,Göggingen,75 und mehr Jahre,83,25,58
False,8136024,Göggingen,Insgesamt,2460,1197,1263
False,8136027,Gschwend,unter 3 Jahre,155,89,66
False,8136027,Gschwend,3 -  6 Jahre,178,102,76
False,8136027,Gschwend,6 - 10 Jahre,280,169,111
False,8136027,Gschwend,10 - 15 Jahre,346,179,167
False,8136027,Gschwend,15 - 18 Jahre,176,94,82
False,8136027,Gschwend,18 - 20 Jahre,108,49,59
False,8136027,Gschwend,20 - 25 Jahre,244,124,120
False,8136027,Gschwend,25 - 30 Jahre,260,129,131
False,8136027,Gschwend,30 - 35 Jahre,396,203,193
False,8136027,Gschwend,35 - 40 Jahre,435,215,220
False,8136027,Gschwend,40 - 45 Jahre,437,211,226
False,8136027,Gschwend,45 - 50 Jahre,336,176,160
False,8136027,Gschwend,50 - 55 Jahre,270,155,115
False,8136027,Gschwend,55 - 60 Jahre,229,118,111
False,8136027,Gschwend,60 - 65 Jahre,334,158,176
False,8136027,Gschwend,65 - 75 Jahre,469,206,263
False,8136027,Gschwend,75 und mehr Jahre,349,118,231
False,8136027,Gschwend,Insgesamt,5002,2495,2507
False,8136028,"Heubach, Stadt",unter 3 Jahre,298,165,133
False,8136028,"Heubach, Stadt",3 -  6 Jahre,380,195,185
False,8136028,"Heubach, Stadt",6 - 10 Jahre,461,253,208
False,8136028,"Heubach, Stadt",10 - 15 Jahre,662,349,313
False,8136028,"Heubach, Stadt",15 - 18 Jahre,404,221,183
False,8136028,"Heubach, Stadt",18 - 20 Jahre,310,160,150
False,8136028,"Heubach, Stadt",20 - 25 Jahre,620,326,294
False,8136028,"Heubach, Stadt",25 - 30 Jahre,593,314,279
False,8136028,"Heubach, Stadt",30 - 35 Jahre,718,348,370
False,8136028,"Heubach, Stadt",35 - 40 Jahre,849,449,400
False,8136028,"Heubach, Stadt",40 - 45 Jahre,841,410,431
False,8136028,"Heubach, Stadt",45 - 50 Jahre,693,329,364
False,8136028,"Heubach, Stadt",50 - 55 Jahre,619,302,317
False,8136028,"Heubach, Stadt",55 - 60 Jahre,590,295,295
False,8136028,"Heubach, Stadt",60 - 65 Jahre,643,331,312
False,8136028,"Heubach, Stadt",65 - 75 Jahre,865,395,470
False,8136028,"Heubach, Stadt",75 und mehr Jahre,665,189,476
False,8136028,"Heubach, Stadt",Insgesamt,10211,5031,5180
False,8136029,Heuchlingen,unter 3 Jahre,65,37,28
False,8136029,Heuchlingen,3 -  6 Jahre,60,28,32
False,8136029,Heuchlingen,6 - 10 Jahre,106,56,50
False,8136029,Heuchlingen,10 - 15 Jahre,148,74,74
False,8136029,Heuchlingen,15 - 18 Jahre,66,37,29
False,8136029,Heuchlingen,18 - 20 Jahre,36,19,17
False,8136029,Heuchlingen,20 - 25 Jahre,103,50,53
False,8136029,Heuchlingen,25 - 30 Jahre,123,61,62
False,8136029,Heuchlingen,30 - 35 Jahre,173,97,76
False,8136029,Heuchlingen,35 - 40 Jahre,172,86,86
False,8136029,Heuchlingen,40 - 45 Jahre,133,74,59
False,8136029,Heuchlingen,45 - 50 Jahre,96,49,47
False,8136029,Heuchlingen,50 - 55 Jahre,80,46,34
False,8136029,Heuchlingen,55 - 60 Jahre,77,32,45
False,8136029,Heuchlingen,60 - 65 Jahre,133,64,69
False,8136029,Heuchlingen,65 - 75 Jahre,180,83,97
False,8136029,Heuchlingen,75 und mehr Jahre,77,29,48
False,8136029,Heuchlingen,Insgesamt,1828,922,906
False,8136033,Hüttlingen,unter 3 Jahre,178,93,85
False,8136033,Hüttlingen,3 -  6 Jahre,215,113,102
False,8136033,Hüttlingen,6 - 10 Jahre,303,152,151
False,8136033,Hüttlingen,10 - 15 Jahre,383,198,185
False,8136033,Hüttlingen,15 - 18 Jahre,227,119,108
False,8136033,Hüttlingen,18 - 20 Jahre,136,76,60
False,8136033,Hüttlingen,20 - 25 Jahre,349,172,177
False,8136033,Hüttlingen,25 - 30 Jahre,341,173,168
False,8136033,Hüttlingen,30 - 35 Jahre,450,220,230
False,8136033,Hüttlingen,35 - 40 Jahre,552,283,269
False,8136033,Hüttlingen,40 - 45 Jahre,468,246,222
False,8136033,Hüttlingen,45 - 50 Jahre,367,191,176
False,8136033,Hüttlingen,50 - 55 Jahre,302,153,149
False,8136033,Hüttlingen,55 - 60 Jahre,320,156,164
False,8136033,Hüttlingen,60 - 65 Jahre,374,178,196
False,8136033,Hüttlingen,65 - 75 Jahre,452,211,241
False,8136033,Hüttlingen,75 und mehr Jahre,296,99,197
False,8136033,Hüttlingen,Insgesamt,5713,2833,2880
False,8136034,Iggingen,unter 3 Jahre,102,54,48
False,8136034,Iggingen,3 -  6 Jahre,117,63,54
False,8136034,Iggingen,6 - 10 Jahre,152,78,74
False,8136034,Iggingen,10 - 15 Jahre,171,85,86
False,8136034,Iggingen,15 - 18 Jahre,93,54,39
False,8136034,Iggingen,18 - 20 Jahre,54,29,25
False,8136034,Iggingen,20 - 25 Jahre,136,81,55
False,8136034,Iggingen,25 - 30 Jahre,137,65,72
False,8136034,Iggingen,30 - 35 Jahre,256,139,117
False,8136034,Iggingen,35 - 40 Jahre,247,125,122
False,8136034,Iggingen,40 - 45 Jahre,195,96,99
False,8136034,Iggingen,45 - 50 Jahre,148,80,68
False,8136034,Iggingen,50 - 55 Jahre,135,65,70
False,8136034,Iggingen,55 - 60 Jahre,136,70,66
False,8136034,Iggingen,60 - 65 Jahre,141,76,65
False,8136034,Iggingen,65 - 75 Jahre,180,82,98
False,8136034,Iggingen,75 und mehr Jahre,131,50,81
False,8136034,Iggingen,Insgesamt,2531,1292,1239
False,8136035,Jagstzell,unter 3 Jahre,83,50,33
False,8136035,Jagstzell,3 -  6 Jahre,90,44,46
False,8136035,Jagstzell,6 - 10 Jahre,132,64,68
False,8136035,Jagstzell,10 - 15 Jahre,196,100,96
False,8136035,Jagstzell,15 - 18 Jahre,92,42,50
False,8136035,Jagstzell,18 - 20 Jahre,68,29,39
False,8136035,Jagstzell,20 - 25 Jahre,163,89,74
False,8136035,Jagstzell,25 - 30 Jahre,149,83,66
False,8136035,Jagstzell,30 - 35 Jahre,208,117,91
False,8136035,Jagstzell,35 - 40 Jahre,210,107,103
False,8136035,Jagstzell,40 - 45 Jahre,192,106,86
False,8136035,Jagstzell,45 - 50 Jahre,168,87,81
False,8136035,Jagstzell,50 - 55 Jahre,114,56,58
False,8136035,Jagstzell,55 - 60 Jahre,80,37,43
False,8136035,Jagstzell,60 - 65 Jahre,127,71,56
False,8136035,Jagstzell,65 - 75 Jahre,207,97,110
False,8136035,Jagstzell,75 und mehr Jahre,144,51,93
False,8136035,Jagstzell,Insgesamt,2423,1230,1193
False,8136037,Kirchheim am Ries,unter 3 Jahre,75,35,40
False,8136037,Kirchheim am Ries,3 -  6 Jahre,83,39,44
False,8136037,Kirchheim am Ries,6 - 10 Jahre,127,66,61
False,8136037,Kirchheim am Ries,10 - 15 Jahre,142,65,77
False,8136037,Kirchheim am Ries,15 - 18 Jahre,79,46,33
False,8136037,Kirchheim am Ries,18 - 20 Jahre,65,36,29
False,8136037,Kirchheim am Ries,20 - 25 Jahre,108,53,55
False,8136037,Kirchheim am Ries,25 - 30 Jahre,139,79,60
False,8136037,Kirchheim am Ries,30 - 35 Jahre,155,93,62
False,8136037,Kirchheim am Ries,35 - 40 Jahre,169,87,82
False,8136037,Kirchheim am Ries,40 - 45 Jahre,144,74,70
False,8136037,Kirchheim am Ries,45 - 50 Jahre,118,63,55
False,8136037,Kirchheim am Ries,50 - 55 Jahre,115,58,57
False,8136037,Kirchheim am Ries,55 - 60 Jahre,94,47,47
False,8136037,Kirchheim am Ries,60 - 65 Jahre,126,67,59
False,8136037,Kirchheim am Ries,65 - 75 Jahre,140,64,76
False,8136037,Kirchheim am Ries,75 und mehr Jahre,155,45,110
False,8136037,Kirchheim am Ries,Insgesamt,2034,1017,1017
False,8136038,"Lauchheim, Stadt",unter 3 Jahre,169,79,90
False,8136038,"Lauchheim, Stadt",3 -  6 Jahre,171,99,72
False,8136038,"Lauchheim, Stadt",6 - 10 Jahre,251,124,127
False,8136038,"Lauchheim, Stadt",10 - 15 Jahre,320,148,172
False,8136038,"Lauchheim, Stadt",15 - 18 Jahre,172,83,89
False,8136038,"Lauchheim, Stadt",18 - 20 Jahre,106,58,48
False,8136038,"Lauchheim, Stadt",20 - 25 Jahre,256,116,140
False,8136038,"Lauchheim, Stadt",25 - 30 Jahre,301,146,155
False,8136038,"Lauchheim, Stadt",30 - 35 Jahre,374,203,171
False,8136038,"Lauchheim, Stadt",35 - 40 Jahre,396,198,198
False,8136038,"Lauchheim, Stadt",40 - 45 Jahre,385,200,185
False,8136038,"Lauchheim, Stadt",45 - 50 Jahre,327,171,156
False,8136038,"Lauchheim, Stadt",50 - 55 Jahre,253,144,109
False,8136038,"Lauchheim, Stadt",55 - 60 Jahre,209,108,101
False,8136038,"Lauchheim, Stadt",60 - 65 Jahre,221,105,116
False,8136038,"Lauchheim, Stadt",65 - 75 Jahre,315,155,160
False,8136038,"Lauchheim, Stadt",75 und mehr Jahre,243,78,165
False,8136038,"Lauchheim, Stadt",Insgesamt,4469,2215,2254
False,8136040,Leinzell,unter 3 Jahre,80,35,45
False,8136040,Leinzell,3 -  6 Jahre,77,36,41
False,8136040,Leinzell,6 - 10 Jahre,113,55,58
False,8136040,Leinzell,10 - 15 Jahre,153,74,79
False,8136040,Leinzell,15 - 18 Jahre,81,43,38
False,8136040,Leinzell,18 - 20 Jahre,55,32,23
False,8136040,Leinzell,20 - 25 Jahre,119,68,51
False,8136040,Leinzell,25 - 30 Jahre,130,72,58
False,8136040,Leinzell,30 - 35 Jahre,177,86,91
False,8136040,Leinzell,35 - 40 Jahre,205,104,101
False,8136040,Leinzell,40 - 45 Jahre,191,90,101
False,8136040,Leinzell,45 - 50 Jahre,156,77,79
False,8136040,Leinzell,50 - 55 Jahre,148,78,70
False,8136040,Leinzell,55 - 60 Jahre,122,70,52
False,8136040,Leinzell,60 - 65 Jahre,139,62,77
False,8136040,Leinzell,65 - 75 Jahre,237,109,128
False,8136040,Leinzell,75 und mehr Jahre,155,54,101
False,8136040,Leinzell,Insgesamt,2338,1145,1193
False,8136042,"Lorch, Stadt",unter 3 Jahre,375,185,190
False,8136042,"Lorch, Stadt",3 -  6 Jahre,389,210,179
False,8136042,"Lorch, Stadt",6 - 10 Jahre,527,254,273
False,8136042,"Lorch, Stadt",10 - 15 Jahre,688,331,357
False,8136042,"Lorch, Stadt",15 - 18 Jahre,369,197,172
False,8136042,"Lorch, Stadt",18 - 20 Jahre,250,117,133
False,8136042,"Lorch, Stadt",20 - 25 Jahre,562,321,241
False,8136042,"Lorch, Stadt",25 - 30 Jahre,627,311,316
False,8136042,"Lorch, Stadt",30 - 35 Jahre,889,451,438
False,8136042,"Lorch, Stadt",35 - 40 Jahre,1037,561,476
False,8136042,"Lorch, Stadt",40 - 45 Jahre,906,459,447
False,8136042,"Lorch, Stadt",45 - 50 Jahre,741,373,368
False,8136042,"Lorch, Stadt",50 - 55 Jahre,704,361,343
False,8136042,"Lorch, Stadt",55 - 60 Jahre,631,319,312
False,8136042,"Lorch, Stadt",60 - 65 Jahre,748,380,368
False,8136042,"Lorch, Stadt",65 - 75 Jahre,988,463,525
False,8136042,"Lorch, Stadt",75 und mehr Jahre,771,228,543
False,8136042,"Lorch, Stadt",Insgesamt,11202,5521,5681
False,8136043,Mögglingen,unter 3 Jahre,133,73,60
False,8136043,Mögglingen,3 -  6 Jahre,137,76,61
False,8136043,Mögglingen,6 - 10 Jahre,204,94,110
False,8136043,Mögglingen,10 - 15 Jahre,238,120,118
False,8136043,Mögglingen,15 - 18 Jahre,147,67,80
False,8136043,Mögglingen,18 - 20 Jahre,92,46,46
False,8136043,Mögglingen,20 - 25 Jahre,214,107,107
False,8136043,Mögglingen,25 - 30 Jahre,253,132,121
False,8136043,Mögglingen,30 - 35 Jahre,325,182,143
False,8136043,Mögglingen,35 - 40 Jahre,328,154,174
False,8136043,Mögglingen,40 - 45 Jahre,327,178,149
False,8136043,Mögglingen,45 - 50 Jahre,243,117,126
False,8136043,Mögglingen,50 - 55 Jahre,246,124,122
False,8136043,Mögglingen,55 - 60 Jahre,237,125,112
False,8136043,Mögglingen,60 - 65 Jahre,242,118,124
False,8136043,Mögglingen,65 - 75 Jahre,308,143,165
False,8136043,Mögglingen,75 und mehr Jahre,215,70,145
False,8136043,Mögglingen,Insgesamt,3889,1926,1963
False,8136044,Mutlangen,unter 3 Jahre,189,99,90
False,8136044,Mutlangen,3 -  6 Jahre,215,124,91
False,8136044,Mutlangen,6 - 10 Jahre,294,148,146
False,8136044,Mutlangen,10 - 15 Jahre,390,178,212
False,8136044,Mutlangen,15 - 18 Jahre,206,104,102
False,8136044,Mutlangen,18 - 20 Jahre,138,69,69
False,8136044,Mutlangen,20 - 25 Jahre,348,161,187
False,8136044,Mutlangen,25 - 30 Jahre,308,172,136
False,8136044,Mutlangen,30 - 35 Jahre,425,200,225
False,8136044,Mutlangen,35 - 40 Jahre,474,210,264
False,8136044,Mutlangen,40 - 45 Jahre,524,288,236
False,8136044,Mutlangen,45 - 50 Jahre,423,212,211
False,8136044,Mutlangen,50 - 55 Jahre,346,174,172
False,8136044,Mutlangen,55 - 60 Jahre,330,154,176
False,8136044,Mutlangen,60 - 65 Jahre,335,157,178
False,8136044,Mutlangen,65 - 75 Jahre,512,239,273
False,8136044,Mutlangen,75 und mehr Jahre,364,120,244
False,8136044,Mutlangen,Insgesamt,5821,2809,3012
False,8136045,"Neresheim, Stadt",unter 3 Jahre,305,153,152
False,8136045,"Neresheim, Stadt",3 -  6 Jahre,304,151,153
False,8136045,"Neresheim, Stadt",6 - 10 Jahre,440,227,213
False,8136045,"Neresheim, Stadt",10 - 15 Jahre,550,278,272
False,8136045,"Neresheim, Stadt",15 - 18 Jahre,293,145,148
False,8136045,"Neresheim, Stadt",18 - 20 Jahre,218,112,106
False,8136045,"Neresheim, Stadt",20 - 25 Jahre,525,277,248
False,8136045,"Neresheim, Stadt",25 - 30 Jahre,542,292,250
False,8136045,"Neresheim, Stadt",30 - 35 Jahre,652,348,304
False,8136045,"Neresheim, Stadt",35 - 40 Jahre,704,380,324
False,8136045,"Neresheim, Stadt",40 - 45 Jahre,662,352,310
False,8136045,"Neresheim, Stadt",45 - 50 Jahre,591,303,288
False,8136045,"Neresheim, Stadt",50 - 55 Jahre,456,257,199
False,8136045,"Neresheim, Stadt",55 - 60 Jahre,377,213,164
False,8136045,"Neresheim, Stadt",60 - 65 Jahre,439,226,213
False,8136045,"Neresheim, Stadt",65 - 75 Jahre,688,328,360
False,8136045,"Neresheim, Stadt",75 und mehr Jahre,487,151,336
False,8136045,"Neresheim, Stadt",Insgesamt,8233,4193,4040
False,8136046,Neuler,unter 3 Jahre,104,50,54
False,8136046,Neuler,3 -  6 Jahre,116,59,57
False,8136046,Neuler,6 - 10 Jahre,188,98,90
False,8136046,Neuler,10 - 15 Jahre,231,128,103
False,8136046,Neuler,15 - 18 Jahre,111,63,48
False,8136046,Neuler,18 - 20 Jahre,105,62,43
False,8136046,Neuler,20 - 25 Jahre,213,121,92
False,8136046,Neuler,25 - 30 Jahre,214,114,100
False,8136046,Neuler,30 - 35 Jahre,222,112,110
False,8136046,Neuler,35 - 40 Jahre,268,136,132
False,8136046,Neuler,40 - 45 Jahre,244,127,117
False,8136046,Neuler,45 - 50 Jahre,197,99,98
False,8136046,Neuler,50 - 55 Jahre,176,97,79
False,8136046,Neuler,55 - 60 Jahre,134,70,64
False,8136046,Neuler,60 - 65 Jahre,169,86,83
False,8136046,Neuler,65 - 75 Jahre,193,100,93
False,8136046,Neuler,75 und mehr Jahre,153,61,92
False,8136046,Neuler,Insgesamt,3038,1583,1455
False,8136049,Obergröningen,unter 3 Jahre,17,9,8
False,8136049,Obergröningen,3 -  6 Jahre,15,6,9
False,8136049,Obergröningen,6 - 10 Jahre,19,12,7
False,8136049,Obergröningen,10 - 15 Jahre,26,11,15
False,8136049,Obergröningen,15 - 18 Jahre,7,2,5
False,8136049,Obergröningen,18 - 20 Jahre,8,0,8
False,8136049,Obergröningen,20 - 25 Jahre,30,14,16
False,8136049,Obergröningen,25 - 30 Jahre,31,17,14
False,8136049,Obergröningen,30 - 35 Jahre,33,17,16
False,8136049,Obergröningen,35 - 40 Jahre,41,27,14
False,8136049,Obergröningen,40 - 45 Jahre,36,20,16
False,8136049,Obergröningen,45 - 50 Jahre,21,10,11
False,8136049,Obergröningen,50 - 55 Jahre,41,20,21
False,8136049,Obergröningen,55 - 60 Jahre,25,16,9
False,8136049,Obergröningen,60 - 65 Jahre,35,18,17
False,8136049,Obergröningen,65 - 75 Jahre,40,22,18
False,8136049,Obergröningen,75 und mehr Jahre,28,4,24
False,8136049,Obergröningen,Insgesamt,453,225,228
False,8136050,"Oberkochen, Stadt",unter 3 Jahre,227,106,121
False,8136050,"Oberkochen, Stadt",3 -  6 Jahre,252,123,129
False,8136050,"Oberkochen, Stadt",6 - 10 Jahre,323,170,153
False,8136050,"Oberkochen, Stadt",10 - 15 Jahre,509,266,243
False,8136050,"Oberkochen, Stadt",15 - 18 Jahre,268,147,121
False,8136050,"Oberkochen, Stadt",18 - 20 Jahre,188,96,92
False,8136050,"Oberkochen, Stadt",20 - 25 Jahre,406,199,207
False,8136050,"Oberkochen, Stadt",25 - 30 Jahre,383,205,178
False,8136050,"Oberkochen, Stadt",30 - 35 Jahre,582,305,277
False,8136050,"Oberkochen, Stadt",35 - 40 Jahre,636,323,313
False,8136050,"Oberkochen, Stadt",40 - 45 Jahre,592,319,273
False,8136050,"Oberkochen, Stadt",45 - 50 Jahre,529,264,265
False,8136050,"Oberkochen, Stadt",50 - 55 Jahre,443,212,231
False,8136050,"Oberkochen, Stadt",55 - 60 Jahre,514,248,266
False,8136050,"Oberkochen, Stadt",60 - 65 Jahre,659,316,343
False,8136050,"Oberkochen, Stadt",65 - 75 Jahre,1050,482,568
False,8136050,"Oberkochen, Stadt",75 und mehr Jahre,710,233,477
False,8136050,"Oberkochen, Stadt",Insgesamt,8271,4014,4257
False,8136060,Rosenberg,unter 3 Jahre,85,50,35
False,8136060,Rosenberg,3 -  6 Jahre,110,54,56
False,8136060,Rosenberg,6 - 10 Jahre,173,84,89
False,8136060,Rosenberg,10 - 15 Jahre,188,97,91
False,8136060,Rosenberg,15 - 18 Jahre,115,47,68
False,8136060,Rosenberg,18 - 20 Jahre,80,50,30
False,8136060,Rosenberg,20 - 25 Jahre,156,76,80
False,8136060,Rosenberg,25 - 30 Jahre,136,85,51
False,8136060,Rosenberg,30 - 35 Jahre,184,89,95
False,8136060,Rosenberg,35 - 40 Jahre,255,138,117
False,8136060,Rosenberg,40 - 45 Jahre,210,112,98
False,8136060,Rosenberg,45 - 50 Jahre,184,98,86
False,8136060,Rosenberg,50 - 55 Jahre,127,73,54
False,8136060,Rosenberg,55 - 60 Jahre,109,59,50
False,8136060,Rosenberg,60 - 65 Jahre,129,70,59
False,8136060,Rosenberg,65 - 75 Jahre,217,92,125
False,8136060,Rosenberg,75 und mehr Jahre,175,58,117
False,8136060,Rosenberg,Insgesamt,2633,1332,1301
False,8136061,Ruppertshofen,unter 3 Jahre,68,42,26
False,8136061,Ruppertshofen,3 -  6 Jahre,97,48,49
False,8136061,Ruppertshofen,6 - 10 Jahre,131,82,49
False,8136061,Ruppertshofen,10 - 15 Jahre,147,65,82
False,8136061,Ruppertshofen,15 - 18 Jahre,85,34,51
False,8136061,Ruppertshofen,18 - 20 Jahre,70,28,42
False,8136061,Ruppertshofen,20 - 25 Jahre,100,51,49
False,8136061,Ruppertshofen,25 - 30 Jahre,107,48,59
False,8136061,Ruppertshofen,30 - 35 Jahre,146,63,83
False,8136061,Ruppertshofen,35 - 40 Jahre,175,92,83
False,8136061,Ruppertshofen,40 - 45 Jahre,167,91,76
False,8136061,Ruppertshofen,45 - 50 Jahre,134,73,61
False,8136061,Ruppertshofen,50 - 55 Jahre,85,50,35
False,8136061,Ruppertshofen,55 - 60 Jahre,64,25,39
False,8136061,Ruppertshofen,60 - 65 Jahre,88,45,43
False,8136061,Ruppertshofen,65 - 75 Jahre,124,59,65
False,8136061,Ruppertshofen,75 und mehr Jahre,83,33,50
False,8136061,Ruppertshofen,Insgesamt,1871,929,942
False,8136062,Schechingen,unter 3 Jahre,104,50,54
False,8136062,Schechingen,3 -  6 Jahre,95,48,47
False,8136062,Schechingen,6 - 10 Jahre,177,86,91
False,8136062,Schechingen,10 - 15 Jahre,174,85,89
False,8136062,Schechingen,15 - 18 Jahre,108,58,50
False,8136062,Schechingen,18 - 20 Jahre,75,45,30
False,8136062,Schechingen,20 - 25 Jahre,126,53,73
False,8136062,Schechingen,25 - 30 Jahre,141,69,72
False,8136062,Schechingen,30 - 35 Jahre,204,93,111
False,8136062,Schechingen,35 - 40 Jahre,237,114,123
False,8136062,Schechingen,40 - 45 Jahre,216,112,104
False,8136062,Schechingen,45 - 50 Jahre,169,89,80
False,8136062,Schechingen,50 - 55 Jahre,132,72,60
False,8136062,Schechingen,55 - 60 Jahre,89,51,38
False,8136062,Schechingen,60 - 65 Jahre,112,53,59
False,8136062,Schechingen,65 - 75 Jahre,168,66,102
False,8136062,Schechingen,75 und mehr Jahre,120,30,90
False,8136062,Schechingen,Insgesamt,2447,1174,1273
False,8136065,"Schwäbisch Gmünd, Stadt",unter 3 Jahre,1913,987,926
False,8136065,"Schwäbisch Gmünd, Stadt",3 -  6 Jahre,1895,1000,895
False,8136065,"Schwäbisch Gmünd, Stadt",6 - 10 Jahre,2706,1348,1358
False,8136065,"Schwäbisch Gmünd, Stadt",10 - 15 Jahre,3624,1861,1763
False,8136065,"Schwäbisch Gmünd, Stadt",15 - 18 Jahre,2182,1077,1105
False,8136065,"Schwäbisch Gmünd, Stadt",18 - 20 Jahre,1561,829,732
False,8136065,"Schwäbisch Gmünd, Stadt",20 - 25 Jahre,3727,1913,1814
False,8136065,"Schwäbisch Gmünd, Stadt",25 - 30 Jahre,3967,2111,1856
False,8136065,"Schwäbisch Gmünd, Stadt",30 - 35 Jahre,4676,2432,2244
False,8136065,"Schwäbisch Gmünd, Stadt",35 - 40 Jahre,4854,2545,2309
False,8136065,"Schwäbisch Gmünd, Stadt",40 - 45 Jahre,4487,2239,2248
False,8136065,"Schwäbisch Gmünd, Stadt",45 - 50 Jahre,3901,1903,1998
False,8136065,"Schwäbisch Gmünd, Stadt",50 - 55 Jahre,3692,1832,1860
False,8136065,"Schwäbisch Gmünd, Stadt",55 - 60 Jahre,3721,1860,1861
False,8136065,"Schwäbisch Gmünd, Stadt",60 - 65 Jahre,4058,1956,2102
False,8136065,"Schwäbisch Gmünd, Stadt",65 - 75 Jahre,5890,2684,3206
False,8136065,"Schwäbisch Gmünd, Stadt",75 und mehr Jahre,5092,1454,3638
False,8136065,"Schwäbisch Gmünd, Stadt",Insgesamt,61946,30031,31915
False,8136066,Spraitbach,unter 3 Jahre,117,49,68
False,8136066,Spraitbach,3 -  6 Jahre,125,62,63
False,8136066,Spraitbach,6 - 10 Jahre,190,100,90
False,8136066,Spraitbach,10 - 15 Jahre,249,120,129
False,8136066,Spraitbach,15 - 18 Jahre,128,67,61
False,8136066,Spraitbach,18 - 20 Jahre,88,50,38
False,8136066,Spraitbach,20 - 25 Jahre,175,92,83
False,8136066,Spraitbach,25 - 30 Jahre,193,107,86
False,8136066,Spraitbach,30 - 35 Jahre,303,145,158
False,8136066,Spraitbach,35 - 40 Jahre,314,171,143
False,8136066,Spraitbach,40 - 45 Jahre,313,150,163
False,8136066,Spraitbach,45 - 50 Jahre,223,115,108
False,8136066,Spraitbach,50 - 55 Jahre,222,109,113
False,8136066,Spraitbach,55 - 60 Jahre,202,101,101
False,8136066,Spraitbach,60 - 65 Jahre,222,114,108
False,8136066,Spraitbach,65 - 75 Jahre,313,150,163
False,8136066,Spraitbach,75 und mehr Jahre,165,46,119
False,8136066,Spraitbach,Insgesamt,3542,1748,1794
False,8136068,Stödtlen,unter 3 Jahre,82,27,55
False,8136068,Stödtlen,3 -  6 Jahre,95,54,41
False,8136068,Stödtlen,6 - 10 Jahre,119,60,59
False,8136068,Stödtlen,10 - 15 Jahre,138,66,72
False,8136068,Stödtlen,15 - 18 Jahre,68,31,37
False,8136068,Stödtlen,18 - 20 Jahre,39,21,18
False,8136068,Stödtlen,20 - 25 Jahre,127,66,61
False,8136068,Stödtlen,25 - 30 Jahre,145,71,74
False,8136068,Stödtlen,30 - 35 Jahre,189,93,96
False,8136068,Stödtlen,35 - 40 Jahre,189,98,91
False,8136068,Stödtlen,40 - 45 Jahre,144,81,63
False,8136068,Stödtlen,45 - 50 Jahre,112,55,57
False,8136068,Stödtlen,50 - 55 Jahre,115,62,53
False,8136068,Stödtlen,55 - 60 Jahre,75,39,36
False,8136068,Stödtlen,60 - 65 Jahre,99,62,37
False,8136068,Stödtlen,65 - 75 Jahre,158,75,83
False,8136068,Stödtlen,75 und mehr Jahre,140,46,94
False,8136068,Stödtlen,Insgesamt,2034,1007,1027
False,8136070,Täferrot,unter 3 Jahre,40,15,25
False,8136070,Täferrot,3 -  6 Jahre,38,21,17
False,8136070,Täferrot,6 - 10 Jahre,53,28,25
False,8136070,Täferrot,10 - 15 Jahre,50,24,26
False,8136070,Täferrot,15 - 18 Jahre,31,13,18
False,8136070,Täferrot,18 - 20 Jahre,27,12,15
False,8136070,Täferrot,20 - 25 Jahre,58,30,28
False,8136070,Täferrot,25 - 30 Jahre,73,26,47
False,8136070,Täferrot,30 - 35 Jahre,92,52,40
False,8136070,Täferrot,35 - 40 Jahre,99,47,52
False,8136070,Täferrot,40 - 45 Jahre,68,36,32
False,8136070,Täferrot,45 - 50 Jahre,57,26,31
False,8136070,Täferrot,50 - 55 Jahre,57,30,27
False,8136070,Täferrot,55 - 60 Jahre,66,35,31
False,8136070,Täferrot,60 - 65 Jahre,54,33,21
False,8136070,Täferrot,65 - 75 Jahre,86,40,46
False,8136070,Täferrot,75 und mehr Jahre,50,14,36
False,8136070,Täferrot,Insgesamt,999,482,517
False,8136071,Tannhausen,unter 3 Jahre,68,34,34
False,8136071,Tannhausen,3 -  6 Jahre,79,45,34
False,8136071,Tannhausen,6 - 10 Jahre,106,49,57
False,8136071,Tannhausen,10 - 15 Jahre,133,69,64
False,8136071,Tannhausen,15 - 18 Jahre,78,45,33
False,8136071,Tannhausen,18 - 20 Jahre,49,26,23
False,8136071,Tannhausen,20 - 25 Jahre,114,59,55
False,8136071,Tannhausen,25 - 30 Jahre,99,54,45
False,8136071,Tannhausen,30 - 35 Jahre,131,66,65
False,8136071,Tannhausen,35 - 40 Jahre,170,97,73
False,8136071,Tannhausen,40 - 45 Jahre,116,58,58
False,8136071,Tannhausen,45 - 50 Jahre,115,60,55
False,8136071,Tannhausen,50 - 55 Jahre,99,56,43
False,8136071,Tannhausen,55 - 60 Jahre,88,49,39
False,8136071,Tannhausen,60 - 65 Jahre,122,66,56
False,8136071,Tannhausen,65 - 75 Jahre,158,71,87
False,8136071,Tannhausen,75 und mehr Jahre,158,39,119
False,8136071,Tannhausen,Insgesamt,1883,943,940
False,8136075,Unterschneidheim,unter 3 Jahre,153,88,65
False,8136075,Unterschneidheim,3 -  6 Jahre,151,80,71
False,8136075,Unterschneidheim,6 - 10 Jahre,262,137,125
False,8136075,Unterschneidheim,10 - 15 Jahre,363,191,172
False,8136075,Unterschneidheim,15 - 18 Jahre,191,104,87
False,8136075,Unterschneidheim,18 - 20 Jahre,122,56,66
False,8136075,Unterschneidheim,20 - 25 Jahre,325,165,160
False,8136075,Unterschneidheim,25 - 30 Jahre,322,163,159
False,8136075,Unterschneidheim,30 - 35 Jahre,342,188,154
False,8136075,Unterschneidheim,35 - 40 Jahre,377,190,187
False,8136075,Unterschneidheim,40 - 45 Jahre,354,190,164
False,8136075,Unterschneidheim,45 - 50 Jahre,324,181,143
False,8136075,Unterschneidheim,50 - 55 Jahre,227,115,112
False,8136075,Unterschneidheim,55 - 60 Jahre,204,104,100
False,8136075,Unterschneidheim,60 - 65 Jahre,249,130,119
False,8136075,Unterschneidheim,65 - 75 Jahre,354,172,182
False,8136075,Unterschneidheim,75 und mehr Jahre,231,79,152
False,8136075,Unterschneidheim,Insgesamt,4551,2333,2218
False,8136079,Waldstetten,unter 3 Jahre,265,124,141
False,8136079,Waldstetten,3 -  6 Jahre,257,132,125
False,8136079,Waldstetten,6 - 10 Jahre,357,183,174
False,8136079,Waldstetten,10 - 15 Jahre,443,237,206
False,8136079,Waldstetten,15 - 18 Jahre,271,136,135
False,8136079,Waldstetten,18 - 20 Jahre,174,87,87
False,8136079,Waldstetten,20 - 25 Jahre,349,161,188
False,8136079,Waldstetten,25 - 30 Jahre,443,223,220
False,8136079,Waldstetten,30 - 35 Jahre,635,331,304
False,8136079,Waldstetten,35 - 40 Jahre,614,309,305
False,8136079,Waldstetten,40 - 45 Jahre,518,247,271
False,8136079,Waldstetten,45 - 50 Jahre,514,265,249
False,8136079,Waldstetten,50 - 55 Jahre,449,217,232
False,8136079,Waldstetten,55 - 60 Jahre,414,197,217
False,8136079,Waldstetten,60 - 65 Jahre,495,234,261
False,8136079,Waldstetten,65 - 75 Jahre,591,302,289
False,8136079,Waldstetten,75 und mehr Jahre,458,147,311
False,8136079,Waldstetten,Insgesamt,7247,3532,3715
False,8136082,Westhausen,unter 3 Jahre,210,98,112
False,8136082,Westhausen,3 -  6 Jahre,229,122,107
False,8136082,Westhausen,6 - 10 Jahre,309,158,151
False,8136082,Westhausen,10 - 15 Jahre,361,197,164
False,8136082,Westhausen,15 - 18 Jahre,188,86,102
False,8136082,Westhausen,18 - 20 Jahre,150,84,66
False,8136082,Westhausen,20 - 25 Jahre,361,182,179
False,8136082,Westhausen,25 - 30 Jahre,387,184,203
False,8136082,Westhausen,30 - 35 Jahre,530,268,262
False,8136082,Westhausen,35 - 40 Jahre,483,245,238
False,8136082,Westhausen,40 - 45 Jahre,408,216,192
False,8136082,Westhausen,45 - 50 Jahre,385,195,190
False,8136082,Westhausen,50 - 55 Jahre,328,149,179
False,8136082,Westhausen,55 - 60 Jahre,330,176,154
False,8136082,Westhausen,60 - 65 Jahre,384,206,178
False,8136082,Westhausen,65 - 75 Jahre,436,209,227
False,8136082,Westhausen,75 und mehr Jahre,302,98,204
False,8136082,Westhausen,Insgesamt,5781,2873,2908
False,8136084,Wört,unter 3 Jahre,51,21,30
False,8136084,Wört,3 -  6 Jahre,51,26,25
False,8136084,Wört,6 - 10 Jahre,78,36,42
False,8136084,Wört,10 - 15 Jahre,113,65,48
False,8136084,Wört,15 - 18 Jahre,86,41,45
False,8136084,Wört,18 - 20 Jahre,43,19,24
False,8136084,Wört,20 - 25 Jahre,98,43,55
False,8136084,Wört,25 - 30 Jahre,133,69,64
False,8136084,Wört,30 - 35 Jahre,103,52,51
False,8136084,Wört,35 - 40 Jahre,120,62,58
False,8136084,Wört,40 - 45 Jahre,124,72,52
False,8136084,Wört,45 - 50 Jahre,96,49,47
False,8136084,Wört,50 - 55 Jahre,79,44,35
False,8136084,Wört,55 - 60 Jahre,55,23,32
False,8136084,Wört,60 - 65 Jahre,73,33,40
False,8136084,Wört,65 - 75 Jahre,112,62,50
False,8136084,Wört,75 und mehr Jahre,74,26,48
False,8136084,Wört,Insgesamt,1489,743,746
False,8136087,Riesbürg,unter 3 Jahre,84,43,41
False,8136087,Riesbürg,3 -  6 Jahre,82,40,42
False,8136087,Riesbürg,6 - 10 Jahre,119,59,60
False,8136087,Riesbürg,10 - 15 Jahre,161,79,82
False,8136087,Riesbürg,15 - 18 Jahre,88,40,48
False,8136087,Riesbürg,18 - 20 Jahre,61,34,27
False,8136087,Riesbürg,20 - 25 Jahre,145,72,73
False,8136087,Riesbürg,25 - 30 Jahre,119,57,62
False,8136087,Riesbürg,30 - 35 Jahre,178,97,81
False,8136087,Riesbürg,35 - 40 Jahre,184,98,86
False,8136087,Riesbürg,40 - 45 Jahre,173,90,83
False,8136087,Riesbürg,45 - 50 Jahre,157,85,72
False,8136087,Riesbürg,50 - 55 Jahre,136,76,60
False,8136087,Riesbürg,55 - 60 Jahre,123,59,64
False,8136087,Riesbürg,60 - 65 Jahre,120,57,63
False,8136087,Riesbürg,65 - 75 Jahre,222,100,122
False,8136087,Riesbürg,75 und mehr Jahre,159,50,109
False,8136087,Riesbürg,Insgesamt,2311,1136,1175
False,8136088,"Aalen, Stadt",unter 3 Jahre,2231,1120,1111
False,8136088,"Aalen, Stadt",3 -  6 Jahre,2232,1171,1061
False,8136088,"Aalen, Stadt",6 - 10 Jahre,3011,1562,1449
False,8136088,"Aalen, Stadt",10 - 15 Jahre,3738,1949,1789
False,8136088,"Aalen, Stadt",15 - 18 Jahre,2094,1016,1078
False,8136088,"Aalen, Stadt",18 - 20 Jahre,1516,787,729
False,8136088,"Aalen, Stadt",20 - 25 Jahre,3904,1994,1910
False,8136088,"Aalen, Stadt",25 - 30 Jahre,4438,2266,2172
False,8136088,"Aalen, Stadt",30 - 35 Jahre,5446,2813,2633
False,8136088,"Aalen, Stadt",35 - 40 Jahre,5362,2875,2487
False,8136088,"Aalen, Stadt",40 - 45 Jahre,4703,2407,2296
False,8136088,"Aalen, Stadt",45 - 50 Jahre,4227,2105,2122
False,8136088,"Aalen, Stadt",50 - 55 Jahre,3809,1887,1922
False,8136088,"Aalen, Stadt",55 - 60 Jahre,3828,1919,1909
False,8136088,"Aalen, Stadt",60 - 65 Jahre,4440,2200,2240
False,8136088,"Aalen, Stadt",65 - 75 Jahre,6417,2927,3490
False,8136088,"Aalen, Stadt",75 und mehr Jahre,4977,1575,3402
False,8136088,"Aalen, Stadt",Insgesamt,66373,32573,33800
False,8136089,Rainau,unter 3 Jahre,121,67,54
False,8136089,Rainau,3 -  6 Jahre,117,64,53
False,8136089,Rainau,6 - 10 Jahre,206,98,108
False,8136089,Rainau,10 - 15 Jahre,228,106,122
False,8136089,Rainau,15 - 18 Jahre,132,59,73
False,8136089,Rainau,18 - 20 Jahre,78,41,37
False,8136089,Rainau,20 - 25 Jahre,200,115,85
False,8136089,Rainau,25 - 30 Jahre,216,124,92
False,8136089,Rainau,30 - 35 Jahre,257,127,130
False,8136089,Rainau,35 - 40 Jahre,321,165,156
False,8136089,Rainau,40 - 45 Jahre,225,121,104
False,8136089,Rainau,45 - 50 Jahre,227,119,108
False,8136089,Rainau,50 - 55 Jahre,171,87,84
False,8136089,Rainau,55 - 60 Jahre,120,66,54
False,8136089,Rainau,60 - 65 Jahre,172,82,90
False,8136089,Rainau,65 - 75 Jahre,221,116,105
False,8136089,Rainau,75 und mehr Jahre,145,42,103
False,8136089,Rainau,Insgesamt,3157,1599,1558
False,82,Regierungsbezirk Karlsruhe,unter 3 Jahre,79100,40717,38383
False,82,Regierungsbezirk Karlsruhe,3 -  6 Jahre,83381,42825,40556
False,82,Regierungsbezirk Karlsruhe,6 - 10 Jahre,114818,59075,55743
False,82,Regierungsbezirk Karlsruhe,10 - 15 Jahre,147452,75776,71676
False,82,Regierungsbezirk Karlsruhe,15 - 18 Jahre,82126,41851,40275
False,82,Regierungsbezirk Karlsruhe,18 - 20 Jahre,58422,29557,28865
False,82,Regierungsbezirk Karlsruhe,20 - 25 Jahre,150471,75140,75331
False,82,Regierungsbezirk Karlsruhe,25 - 30 Jahre,167327,83983,83344
False,82,Regierungsbezirk Karlsruhe,30 - 35 Jahre,226642,116106,110536
False,82,Regierungsbezirk Karlsruhe,35 - 40 Jahre,243538,125556,117982
False,82,Regierungsbezirk Karlsruhe,40 - 45 Jahre,211548,108536,103012
False,82,Regierungsbezirk Karlsruhe,45 - 50 Jahre,182625,91853,90772
False,82,Regierungsbezirk Karlsruhe,50 - 55 Jahre,164663,82512,82151
False,82,Regierungsbezirk Karlsruhe,55 - 60 Jahre,153518,77199,76319
False,82,Regierungsbezirk Karlsruhe,60 - 65 Jahre,179237,88305,90932
False,82,Regierungsbezirk Karlsruhe,65 - 75 Jahre,246364,112327,134037
False,82,Regierungsbezirk Karlsruhe,75 und mehr Jahre,193193,59278,133915
False,82,Regierungsbezirk Karlsruhe,Insgesamt,2684425,1310596,1373829
False,8211,Stadtkreis Baden-Baden,unter 3 Jahre,1236,630,606
False,8211,Stadtkreis Baden-Baden,3 -  6 Jahre,1345,667,678
False,8211,Stadtkreis Baden-Baden,6 - 10 Jahre,1801,931,870
False,8211,Stadtkreis Baden-Baden,10 - 15 Jahre,2338,1190,1148
False,8211,Stadtkreis Baden-Baden,15 - 18 Jahre,1301,660,641
False,8211,Stadtkreis Baden-Baden,18 - 20 Jahre,967,511,456
False,8211,Stadtkreis Baden-Baden,20 - 25 Jahre,2377,1144,1233
False,8211,Stadtkreis Baden-Baden,25 - 30 Jahre,2640,1217,1423
False,8211,Stadtkreis Baden-Baden,30 - 35 Jahre,4096,1988,2108
False,8211,Stadtkreis Baden-Baden,35 - 40 Jahre,4170,2053,2117
False,8211,Stadtkreis Baden-Baden,40 - 45 Jahre,3812,1868,1944
False,8211,Stadtkreis Baden-Baden,45 - 50 Jahre,3467,1651,1816
False,8211,Stadtkreis Baden-Baden,50 - 55 Jahre,3484,1664,1820
False,8211,Stadtkreis Baden-Baden,55 - 60 Jahre,3320,1542,1778
False,8211,Stadtkreis Baden-Baden,60 - 65 Jahre,4141,1908,2233
False,8211,Stadtkreis Baden-Baden,65 - 75 Jahre,6066,2668,3398
False,8211,Stadtkreis Baden-Baden,75 und mehr Jahre,6168,1771,4397
False,8211,Stadtkreis Baden-Baden,Insgesamt,52729,24063,28666
False,8211000,"Baden-Baden, Stadt",unter 3 Jahre,1236,630,606
False,8211000,"Baden-Baden, Stadt",3 -  6 Jahre,1345,667,678
False,8211000,"Baden-Baden, Stadt",6 - 10 Jahre,1801,931,870
False,8211000,"Baden-Baden, Stadt",10 - 15 Jahre,2338,1190,1148
False,8211000,"Baden-Baden, Stadt",15 - 18 Jahre,1301,660,641
False,8211000,"Baden-Baden, Stadt",18 - 20 Jahre,967,511,456
False,8211000,"Baden-Baden, Stadt",20 - 25 Jahre,2377,1144,1233
False,8211000,"Baden-Baden, Stadt",25 - 30 Jahre,2640,1217,1423
False,8211000,"Baden-Baden, Stadt",30 - 35 Jahre,4096,1988,2108
False,8211000,"Baden-Baden, Stadt",35 - 40 Jahre,4170,2053,2117
False,8211000,"Baden-Baden, Stadt",40 - 45 Jahre,3812,1868,1944
False,8211000,"Baden-Baden, Stadt",45 - 50 Jahre,3467,1651,1816
False,8211000,"Baden-Baden, Stadt",50 - 55 Jahre,3484,1664,1820
False,8211000,"Baden-Baden, Stadt",55 - 60 Jahre,3320,1542,1778
False,8211000,"Baden-Baden, Stadt",60 - 65 Jahre,4141,1908,2233
False,8211000,"Baden-Baden, Stadt",65 - 75 Jahre,6066,2668,3398
False,8211000,"Baden-Baden, Stadt",75 und mehr Jahre,6168,1771,4397
False,8211000,"Baden-Baden, Stadt",Insgesamt,52729,24063,28666
False,8212,Stadtkreis Karlsruhe,unter 3 Jahre,7646,3943,3703
False,8212,Stadtkreis Karlsruhe,3 -  6 Jahre,7205,3676,3529
False,8212,Stadtkreis Karlsruhe,6 - 10 Jahre,9902,5184,4718
False,8212,Stadtkreis Karlsruhe,10 - 15 Jahre,12318,6294,6024
False,8212,Stadtkreis Karlsruhe,15 - 18 Jahre,6874,3493,3381
False,8212,Stadtkreis Karlsruhe,18 - 20 Jahre,5404,2722,2682
False,8212,Stadtkreis Karlsruhe,20 - 25 Jahre,17035,8727,8308
False,8212,Stadtkreis Karlsruhe,25 - 30 Jahre,20927,10915,10012
False,8212,Stadtkreis Karlsruhe,30 - 35 Jahre,26204,13879,12325
False,8212,Stadtkreis Karlsruhe,35 - 40 Jahre,24915,13206,11709
False,8212,Stadtkreis Karlsruhe,40 - 45 Jahre,21223,11191,10032
False,8212,Stadtkreis Karlsruhe,45 - 50 Jahre,18084,9101,8983
False,8212,Stadtkreis Karlsruhe,50 - 55 Jahre,16605,8188,8417
False,8212,Stadtkreis Karlsruhe,55 - 60 Jahre,16419,8099,8320
False,8212,Stadtkreis Karlsruhe,60 - 65 Jahre,18344,8742,9602
False,8212,Stadtkreis Karlsruhe,65 - 75 Jahre,25898,11390,14508
False,8212,Stadtkreis Karlsruhe,75 und mehr Jahre,23555,6962,16593
False,8212,Stadtkreis Karlsruhe,Insgesamt,278558,135712,142846
False,8212000,"Karlsruhe, Stadt",unter 3 Jahre,7646,3943,3703
False,8212000,"Karlsruhe, Stadt",3 -  6 Jahre,7205,3676,3529
False,8212000,"Karlsruhe, Stadt",6 - 10 Jahre,9902,5184,4718
False,8212000,"Karlsruhe, Stadt",10 - 15 Jahre,12318,6294,6024
False,8212000,"Karlsruhe, Stadt",15 - 18 Jahre,6874,3493,3381
False,8212000,"Karlsruhe, Stadt",18 - 20 Jahre,5404,2722,2682
False,8212000,"Karlsruhe, Stadt",20 - 25 Jahre,17035,8727,8308
False,8212000,"Karlsruhe, Stadt",25 - 30 Jahre,20927,10915,10012
False,8212000,"Karlsruhe, Stadt",30 - 35 Jahre,26204,13879,12325
False,8212000,"Karlsruhe, Stadt",35 - 40 Jahre,24915,13206,11709
False,8212000,"Karlsruhe, Stadt",40 - 45 Jahre,21223,11191,10032
False,8212000,"Karlsruhe, Stadt",45 - 50 Jahre,18084,9101,8983
False,8212000,"Karlsruhe, Stadt",50 - 55 Jahre,16605,8188,8417
False,8212000,"Karlsruhe, Stadt",55 - 60 Jahre,16419,8099,8320
False,8212000,"Karlsruhe, Stadt",60 - 65 Jahre,18344,8742,9602
False,8212000,"Karlsruhe, Stadt",65 - 75 Jahre,25898,11390,14508
False,8212000,"Karlsruhe, Stadt",75 und mehr Jahre,23555,6962,16593
False,8212000,"Karlsruhe, Stadt",Insgesamt,278558,135712,142846
False,8215,Landkreis Karlsruhe,unter 3 Jahre,12957,6697,6260
False,8215,Landkreis Karlsruhe,3 -  6 Jahre,13972,7260,6712
False,8215,Landkreis Karlsruhe,6 - 10 Jahre,19321,10022,9299
False,8215,Landkreis Karlsruhe,10 - 15 Jahre,24504,12637,11867
False,8215,Landkreis Karlsruhe,15 - 18 Jahre,13519,7010,6509
False,8215,Landkreis Karlsruhe,18 - 20 Jahre,9434,4840,4594
False,8215,Landkreis Karlsruhe,20 - 25 Jahre,21516,10804,10712
False,8215,Landkreis Karlsruhe,25 - 30 Jahre,23992,12075,11917
False,8215,Landkreis Karlsruhe,30 - 35 Jahre,33782,17003,16779
False,8215,Landkreis Karlsruhe,35 - 40 Jahre,38277,19641,18636
False,8215,Landkreis Karlsruhe,40 - 45 Jahre,34043,17403,16640
False,8215,Landkreis Karlsruhe,45 - 50 Jahre,30061,15164,14897
False,8215,Landkreis Karlsruhe,50 - 55 Jahre,26843,13548,13295
False,8215,Landkreis Karlsruhe,55 - 60 Jahre,23937,12110,11827
False,8215,Landkreis Karlsruhe,60 - 65 Jahre,28544,14174,14370
False,8215,Landkreis Karlsruhe,65 - 75 Jahre,38198,17714,20484
False,8215,Landkreis Karlsruhe,75 und mehr Jahre,26655,8335,18320
False,8215,Landkreis Karlsruhe,Insgesamt,419555,206437,213118
False,8215007,"Bretten, Stadt",unter 3 Jahre,933,512,421
False,8215007,"Bretten, Stadt",3 -  6 Jahre,986,517,469
False,8215007,"Bretten, Stadt",6 - 10 Jahre,1234,676,558
False,8215007,"Bretten, Stadt",10 - 15 Jahre,1606,835,771
False,8215007,"Bretten, Stadt",15 - 18 Jahre,880,462,418
False,8215007,"Bretten, Stadt",18 - 20 Jahre,656,348,308
False,8215007,"Bretten, Stadt",20 - 25 Jahre,1541,755,786
False,8215007,"Bretten, Stadt",25 - 30 Jahre,1726,839,887
False,8215007,"Bretten, Stadt",30 - 35 Jahre,2121,1113,1008
False,8215007,"Bretten, Stadt",35 - 40 Jahre,2292,1185,1107
False,8215007,"Bretten, Stadt",40 - 45 Jahre,2048,1005,1043
False,8215007,"Bretten, Stadt",45 - 50 Jahre,2045,1040,1005
False,8215007,"Bretten, Stadt",50 - 55 Jahre,1721,866,855
False,8215007,"Bretten, Stadt",55 - 60 Jahre,1519,790,729
False,8215007,"Bretten, Stadt",60 - 65 Jahre,1762,848,914
False,8215007,"Bretten, Stadt",65 - 75 Jahre,2429,1140,1289
False,8215007,"Bretten, Stadt",75 und mehr Jahre,1853,572,1281
False,8215007,"Bretten, Stadt",Insgesamt,27352,13503,13849
False,8215009,"Bruchsal, Stadt",unter 3 Jahre,1314,673,641
False,8215009,"Bruchsal, Stadt",3 -  6 Jahre,1278,657,621
False,8215009,"Bruchsal, Stadt",6 - 10 Jahre,1760,918,842
False,8215009,"Bruchsal, Stadt",10 - 15 Jahre,2239,1177,1062
False,8215009,"Bruchsal, Stadt",15 - 18 Jahre,1208,634,574
False,8215009,"Bruchsal, Stadt",18 - 20 Jahre,895,421,474
False,8215009,"Bruchsal, Stadt",20 - 25 Jahre,2437,1195,1242
False,8215009,"Bruchsal, Stadt",25 - 30 Jahre,2738,1391,1347
False,8215009,"Bruchsal, Stadt",30 - 35 Jahre,3625,1854,1771
False,8215009,"Bruchsal, Stadt",35 - 40 Jahre,3593,1928,1665
False,8215009,"Bruchsal, Stadt",40 - 45 Jahre,3293,1747,1546
False,8215009,"Bruchsal, Stadt",45 - 50 Jahre,2959,1507,1452
False,8215009,"Bruchsal, Stadt",50 - 55 Jahre,2626,1345,1281
False,8215009,"Bruchsal, Stadt",55 - 60 Jahre,2324,1205,1119
False,8215009,"Bruchsal, Stadt",60 - 65 Jahre,2752,1317,1435
False,8215009,"Bruchsal, Stadt",65 - 75 Jahre,3821,1676,2145
False,8215009,"Bruchsal, Stadt",75 und mehr Jahre,2915,876,2039
False,8215009,"Bruchsal, Stadt",Insgesamt,41777,20521,21256
False,8215017,"Ettlingen, Stadt",unter 3 Jahre,989,508,481
False,8215017,"Ettlingen, Stadt",3 -  6 Jahre,1137,603,534
False,8215017,"Ettlingen, Stadt",6 - 10 Jahre,1568,817,751
False,8215017,"Ettlingen, Stadt",10 - 15 Jahre,1947,971,976
False,8215017,"Ettlingen, Stadt",15 - 18 Jahre,1059,536,523
False,8215017,"Ettlingen, Stadt",18 - 20 Jahre,790,409,381
False,8215017,"Ettlingen, Stadt",20 - 25 Jahre,1738,922,816
False,8215017,"Ettlingen, Stadt",25 - 30 Jahre,1976,995,981
False,8215017,"Ettlingen, Stadt",30 - 35 Jahre,2875,1478,1397
False,8215017,"Ettlingen, Stadt",35 - 40 Jahre,3285,1641,1644
False,8215017,"Ettlingen, Stadt",40 - 45 Jahre,2910,1473,1437
False,8215017,"Ettlingen, Stadt",45 - 50 Jahre,2703,1282,1421
False,8215017,"Ettlingen, Stadt",50 - 55 Jahre,2601,1264,1337
False,8215017,"Ettlingen, Stadt",55 - 60 Jahre,2747,1305,1442
False,8215017,"Ettlingen, Stadt",60 - 65 Jahre,3044,1512,1532
False,8215017,"Ettlingen, Stadt",65 - 75 Jahre,4064,1912,2152
False,8215017,"Ettlingen, Stadt",75 und mehr Jahre,2987,941,2046
False,8215017,"Ettlingen, Stadt",Insgesamt,38420,18569,19851
False,8215021,Forst,unter 3 Jahre,221,119,102
False,8215021,Forst,3 -  6 Jahre,210,122,88
False,8215021,Forst,6 - 10 Jahre,319,162,157
False,8215021,Forst,10 - 15 Jahre,380,211,169
False,8215021,Forst,15 - 18 Jahre,222,124,98
False,8215021,Forst,18 - 20 Jahre,146,76,70
False,8215021,Forst,20 - 25 Jahre,377,190,187
False,8215021,Forst,25 - 30 Jahre,457,218,239
False,8215021,Forst,30 - 35 Jahre,647,328,319
False,8215021,Forst,35 - 40 Jahre,728,377,351
False,8215021,Forst,40 - 45 Jahre,588,293,295
False,8215021,Forst,45 - 50 Jahre,534,270,264
False,8215021,Forst,50 - 55 Jahre,527,275,252
False,8215021,Forst,55 - 60 Jahre,415,198,217
False,8215021,Forst,60 - 65 Jahre,494,259,235
False,8215021,Forst,65 - 75 Jahre,615,287,328
False,8215021,Forst,75 und mehr Jahre,427,153,274
False,8215021,Forst,Insgesamt,7307,3662,3645
False,8215025,Gondelsheim,unter 3 Jahre,106,61,45
False,8215025,Gondelsheim,3 -  6 Jahre,126,72,54
False,8215025,Gondelsheim,6 - 10 Jahre,162,74,88
False,8215025,Gondelsheim,10 - 15 Jahre,199,102,97
False,8215025,Gondelsheim,15 - 18 Jahre,118,61,57
False,8215025,Gondelsheim,18 - 20 Jahre,62,32,30
False,8215025,Gondelsheim,20 - 25 Jahre,159,82,77
False,8215025,Gondelsheim,25 - 30 Jahre,179,87,92
False,8215025,Gondelsheim,30 - 35 Jahre,253,129,124
False,8215025,Gondelsheim,35 - 40 Jahre,305,158,147
False,8215025,Gondelsheim,40 - 45 Jahre,263,141,122
False,8215025,Gondelsheim,45 - 50 Jahre,229,118,111
False,8215025,Gondelsheim,50 - 55 Jahre,186,97,89
False,8215025,Gondelsheim,55 - 60 Jahre,174,84,90
False,8215025,Gondelsheim,60 - 65 Jahre,190,91,99
False,8215025,Gondelsheim,65 - 75 Jahre,201,91,110
False,8215025,Gondelsheim,75 und mehr Jahre,168,56,112
False,8215025,Gondelsheim,Insgesamt,3080,1536,1544
False,8215029,Hambrücken,unter 3 Jahre,191,94,97
False,8215029,Hambrücken,3 -  6 Jahre,186,94,92
False,8215029,Hambrücken,6 - 10 Jahre,277,142,135
False,8215029,Hambrücken,10 - 15 Jahre,351,193,158
False,8215029,Hambrücken,15 - 18 Jahre,161,81,80
False,8215029,Hambrücken,18 - 20 Jahre,120,63,57
False,8215029,Hambrücken,20 - 25 Jahre,276,133,143
False,8215029,Hambrücken,25 - 30 Jahre,328,162,166
False,8215029,Hambrücken,30 - 35 Jahre,435,199,236
False,8215029,Hambrücken,35 - 40 Jahre,520,272,248
False,8215029,Hambrücken,40 - 45 Jahre,484,258,226
False,8215029,Hambrücken,45 - 50 Jahre,349,179,170
False,8215029,Hambrücken,50 - 55 Jahre,302,163,139
False,8215029,Hambrücken,55 - 60 Jahre,202,110,92
False,8215029,Hambrücken,60 - 65 Jahre,314,154,160
False,8215029,Hambrücken,65 - 75 Jahre,389,190,199
False,8215029,Hambrücken,75 und mehr Jahre,199,70,129
False,8215029,Hambrücken,Insgesamt,5084,2557,2527
False,8215039,Kronau,unter 3 Jahre,178,81,97
False,8215039,Kronau,3 -  6 Jahre,202,100,102
False,8215039,Kronau,6 - 10 Jahre,296,136,160
False,8215039,Kronau,10 - 15 Jahre,377,214,163
False,8215039,Kronau,15 - 18 Jahre,192,91,101
False,8215039,Kronau,18 - 20 Jahre,159,82,77
False,8215039,Kronau,20 - 25 Jahre,310,160,150
False,8215039,Kronau,25 - 30 Jahre,339,159,180
False,8215039,Kronau,30 - 35 Jahre,486,239,247
False,8215039,Kronau,35 - 40 Jahre,514,275,239
False,8215039,Kronau,40 - 45 Jahre,465,229,236
False,8215039,Kronau,45 - 50 Jahre,427,209,218
False,8215039,Kronau,50 - 55 Jahre,348,187,161
False,8215039,Kronau,55 - 60 Jahre,226,111,115
False,8215039,Kronau,60 - 65 Jahre,350,175,175
False,8215039,Kronau,65 - 75 Jahre,440,201,239
False,8215039,Kronau,75 und mehr Jahre,250,73,177
False,8215039,Kronau,Insgesamt,5559,2722,2837
False,8215040,Kürnbach,unter 3 Jahre,59,31,28
False,8215040,Kürnbach,3 -  6 Jahre,66,40,26
False,8215040,Kürnbach,6 - 10 Jahre,120,65,55
False,8215040,Kürnbach,10 - 15 Jahre,134,77,57
False,8215040,Kürnbach,15 - 18 Jahre,113,68,45
False,8215040,Kürnbach,18 - 20 Jahre,63,35,28
False,8215040,Kürnbach,20 - 25 Jahre,119,63,56
False,8215040,Kürnbach,25 - 30 Jahre,118,53,65
False,8215040,Kürnbach,30 - 35 Jahre,182,103,79
False,8215040,Kürnbach,35 - 40 Jahre,206,102,104
False,8215040,Kürnbach,40 - 45 Jahre,180,97,83
False,8215040,Kürnbach,45 - 50 Jahre,161,75,86
False,8215040,Kürnbach,50 - 55 Jahre,143,79,64
False,8215040,Kürnbach,55 - 60 Jahre,125,66,59
False,8215040,Kürnbach,60 - 65 Jahre,153,73,80
False,8215040,Kürnbach,65 - 75 Jahre,279,128,151
False,8215040,Kürnbach,75 und mehr Jahre,172,53,119
False,8215040,Kürnbach,Insgesamt,2393,1208,1185
False,8215046,Malsch,unter 3 Jahre,447,249,198
False,8215046,Malsch,3 -  6 Jahre,473,236,237
False,8215046,Malsch,6 - 10 Jahre,662,364,298
False,8215046,Malsch,10 - 15 Jahre,801,396,405
False,8215046,Malsch,15 - 18 Jahre,436,226,210
False,8215046,Malsch,18 - 20 Jahre,273,141,132
False,8215046,Malsch,20 - 25 Jahre,596,312,284
False,8215046,Malsch,25 - 30 Jahre,725,352,373
False,8215046,Malsch,30 - 35 Jahre,1202,578,624
False,8215046,Malsch,35 - 40 Jahre,1383,722,661
False,8215046,Malsch,40 - 45 Jahre,1154,597,557
False,8215046,Malsch,45 - 50 Jahre,959,472,487
False,8215046,Malsch,50 - 55 Jahre,898,455,443
False,8215046,Malsch,55 - 60 Jahre,734,363,371
False,8215046,Malsch,60 - 65 Jahre,938,474,464
False,8215046,Malsch,65 - 75 Jahre,1261,566,695
False,8215046,Malsch,75 und mehr Jahre,896,302,594
False,8215046,Malsch,Insgesamt,13838,6805,7033
False,8215047,Marxzell,unter 3 Jahre,135,79,56
False,8215047,Marxzell,3 -  6 Jahre,179,95,84
False,8215047,Marxzell,6 - 10 Jahre,258,137,121
False,8215047,Marxzell,10 - 15 Jahre,330,166,164
False,8215047,Marxzell,15 - 18 Jahre,159,81,78
False,8215047,Marxzell,18 - 20 Jahre,109,56,53
False,8215047,Marxzell,20 - 25 Jahre,243,118,125
False,8215047,Marxzell,25 - 30 Jahre,265,150,115
False,8215047,Marxzell,30 - 35 Jahre,403,204,199
False,8215047,Marxzell,35 - 40 Jahre,485,226,259
False,8215047,Marxzell,40 - 45 Jahre,455,233,222
False,8215047,Marxzell,45 - 50 Jahre,368,197,171
False,8215047,Marxzell,50 - 55 Jahre,308,166,142
False,8215047,Marxzell,55 - 60 Jahre,280,165,115
False,8215047,Marxzell,60 - 65 Jahre,401,185,216
False,8215047,Marxzell,65 - 75 Jahre,541,262,279
False,8215047,Marxzell,75 und mehr Jahre,533,155,378
False,8215047,Marxzell,Insgesamt,5452,2675,2777
False,8215059,Oberderdingen,unter 3 Jahre,373,198,175
False,8215059,Oberderdingen,3 -  6 Jahre,430,229,201
False,8215059,Oberderdingen,6 - 10 Jahre,533,283,250
False,8215059,Oberderdingen,10 - 15 Jahre,699,349,350
False,8215059,Oberderdingen,15 - 18 Jahre,407,199,208
False,8215059,Oberderdingen,18 - 20 Jahre,253,134,119
False,8215059,Oberderdingen,20 - 25 Jahre,605,309,296
False,8215059,Oberderdingen,25 - 30 Jahre,643,346,297
False,8215059,Oberderdingen,30 - 35 Jahre,916,435,481
False,8215059,Oberderdingen,35 - 40 Jahre,899,479,420
False,8215059,Oberderdingen,40 - 45 Jahre,788,413,375
False,8215059,Oberderdingen,45 - 50 Jahre,677,347,330
False,8215059,Oberderdingen,50 - 55 Jahre,553,266,287
False,8215059,Oberderdingen,55 - 60 Jahre,491,250,241
False,8215059,Oberderdingen,60 - 65 Jahre,573,291,282
False,8215059,Oberderdingen,65 - 75 Jahre,867,395,472
False,8215059,Oberderdingen,75 und mehr Jahre,539,169,370
False,8215059,Oberderdingen,Insgesamt,10246,5092,5154
False,8215064,"Östringen, Stadt",unter 3 Jahre,409,205,204
False,8215064,"Östringen, Stadt",3 -  6 Jahre,432,204,228
False,8215064,"Östringen, Stadt",6 - 10 Jahre,605,329,276
False,8215064,"Östringen, Stadt",10 - 15 Jahre,799,425,374
False,8215064,"Östringen, Stadt",15 - 18 Jahre,471,256,215
False,8215064,"Östringen, Stadt",18 - 20 Jahre,292,143,149
False,8215064,"Östringen, Stadt",20 - 25 Jahre,691,353,338
False,8215064,"Östringen, Stadt",25 - 30 Jahre,751,407,344
False,8215064,"Östringen, Stadt",30 - 35 Jahre,1012,510,502
False,8215064,"Östringen, Stadt",35 - 40 Jahre,1159,583,576
False,8215064,"Östringen, Stadt",40 - 45 Jahre,1001,503,498
False,8215064,"Östringen, Stadt",45 - 50 Jahre,844,428,416
False,8215064,"Östringen, Stadt",50 - 55 Jahre,808,425,383
False,8215064,"Östringen, Stadt",55 - 60 Jahre,610,305,305
False,8215064,"Östringen, Stadt",60 - 65 Jahre,782,411,371
False,8215064,"Östringen, Stadt",65 - 75 Jahre,1157,535,622
False,8215064,"Östringen, Stadt",75 und mehr Jahre,706,214,492
False,8215064,"Östringen, Stadt",Insgesamt,12529,6236,6293
False,8215066,"Philippsburg, Stadt",unter 3 Jahre,389,203,186
False,8215066,"Philippsburg, Stadt",3 -  6 Jahre,416,229,187
False,8215066,"Philippsburg, Stadt",6 - 10 Jahre,589,327,262
False,8215066,"Philippsburg, Stadt",10 - 15 Jahre,738,369,369
False,8215066,"Philippsburg, Stadt",15 - 18 Jahre,436,209,227
False,8215066,"Philippsburg, Stadt",18 - 20 Jahre,340,188,152
False,8215066,"Philippsburg, Stadt",20 - 25 Jahre,766,389,377
False,8215066,"Philippsburg, Stadt",25 - 30 Jahre,749,372,377
False,8215066,"Philippsburg, Stadt",30 - 35 Jahre,890,451,439
False,8215066,"Philippsburg, Stadt",35 - 40 Jahre,1023,525,498
False,8215066,"Philippsburg, Stadt",40 - 45 Jahre,940,470,470
False,8215066,"Philippsburg, Stadt",45 - 50 Jahre,936,455,481
False,8215066,"Philippsburg, Stadt",50 - 55 Jahre,801,431,370
False,8215066,"Philippsburg, Stadt",55 - 60 Jahre,686,338,348
False,8215066,"Philippsburg, Stadt",60 - 65 Jahre,782,407,375
False,8215066,"Philippsburg, Stadt",65 - 75 Jahre,1061,481,580
False,8215066,"Philippsburg, Stadt",75 und mehr Jahre,713,203,510
False,8215066,"Philippsburg, Stadt",Insgesamt,12255,6047,6208
False,8215082,Sulzfeld,unter 3 Jahre,156,85,71
False,8215082,Sulzfeld,3 -  6 Jahre,153,91,62
False,8215082,Sulzfeld,6 - 10 Jahre,241,120,121
False,8215082,Sulzfeld,10 - 15 Jahre,281,141,140
False,8215082,Sulzfeld,15 - 18 Jahre,159,88,71
False,8215082,Sulzfeld,18 - 20 Jahre,103,57,46
False,8215082,Sulzfeld,20 - 25 Jahre,237,126,111
False,8215082,Sulzfeld,25 - 30 Jahre,239,135,104
False,8215082,Sulzfeld,30 - 35 Jahre,363,194,169
False,8215082,Sulzfeld,35 - 40 Jahre,417,203,214
False,8215082,Sulzfeld,40 - 45 Jahre,364,206,158
False,8215082,Sulzfeld,45 - 50 Jahre,280,148,132
False,8215082,Sulzfeld,50 - 55 Jahre,252,118,134
False,8215082,Sulzfeld,55 - 60 Jahre,268,130,138
False,8215082,Sulzfeld,60 - 65 Jahre,320,158,162
False,8215082,Sulzfeld,65 - 75 Jahre,478,234,244
False,8215082,Sulzfeld,75 und mehr Jahre,222,69,153
False,8215082,Sulzfeld,Insgesamt,4533,2303,2230
False,8215084,Ubstadt-Weiher,unter 3 Jahre,407,220,187
False,8215084,Ubstadt-Weiher,3 -  6 Jahre,431,225,206
False,8215084,Ubstadt-Weiher,6 - 10 Jahre,616,321,295
False,8215084,Ubstadt-Weiher,10 - 15 Jahre,838,451,387
False,8215084,Ubstadt-Weiher,15 - 18 Jahre,413,211,202
False,8215084,Ubstadt-Weiher,18 - 20 Jahre,300,142,158
False,8215084,Ubstadt-Weiher,20 - 25 Jahre,662,348,314
False,8215084,Ubstadt-Weiher,25 - 30 Jahre,712,369,343
False,8215084,Ubstadt-Weiher,30 - 35 Jahre,1021,507,514
False,8215084,Ubstadt-Weiher,35 - 40 Jahre,1229,629,600
False,8215084,Ubstadt-Weiher,40 - 45 Jahre,1090,553,537
False,8215084,Ubstadt-Weiher,45 - 50 Jahre,894,470,424
False,8215084,Ubstadt-Weiher,50 - 55 Jahre,679,349,330
False,8215084,Ubstadt-Weiher,55 - 60 Jahre,643,317,326
False,8215084,Ubstadt-Weiher,60 - 65 Jahre,732,354,378
False,8215084,Ubstadt-Weiher,65 - 75 Jahre,1143,523,620
False,8215084,Ubstadt-Weiher,75 und mehr Jahre,647,213,434
False,8215084,Ubstadt-Weiher,Insgesamt,12457,6202,6255
False,8215089,Walzbachtal,unter 3 Jahre,307,145,162
False,8215089,Walzbachtal,3 -  6 Jahre,345,187,158
False,8215089,Walzbachtal,6 - 10 Jahre,482,237,245
False,8215089,Walzbachtal,10 - 15 Jahre,516,267,249
False,8215089,Walzbachtal,15 - 18 Jahre,284,148,136
False,8215089,Walzbachtal,18 - 20 Jahre,159,89,70
False,8215089,Walzbachtal,20 - 25 Jahre,409,207,202
False,8215089,Walzbachtal,25 - 30 Jahre,435,218,217
False,8215089,Walzbachtal,30 - 35 Jahre,740,338,402
False,8215089,Walzbachtal,35 - 40 Jahre,825,420,405
False,8215089,Walzbachtal,40 - 45 Jahre,750,368,382
False,8215089,Walzbachtal,45 - 50 Jahre,641,337,304
False,8215089,Walzbachtal,50 - 55 Jahre,526,255,271
False,8215089,Walzbachtal,55 - 60 Jahre,488,249,239
False,8215089,Walzbachtal,60 - 65 Jahre,595,306,289
False,8215089,Walzbachtal,65 - 75 Jahre,843,391,452
False,8215089,Walzbachtal,75 und mehr Jahre,530,172,358
False,8215089,Walzbachtal,Insgesamt,8875,4334,4541
False,8215090,Weingarten (Baden),unter 3 Jahre,261,135,126
False,8215090,Weingarten (Baden),3 -  6 Jahre,333,177,156
False,8215090,Weingarten (Baden),6 - 10 Jahre,408,201,207
False,8215090,Weingarten (Baden),10 - 15 Jahre,482,267,215
False,8215090,Weingarten (Baden),15 - 18 Jahre,288,157,131
False,8215090,Weingarten (Baden),18 - 20 Jahre,181,95,86
False,8215090,Weingarten (Baden),20 - 25 Jahre,404,186,218
False,8215090,Weingarten (Baden),25 - 30 Jahre,503,230,273
False,8215090,Weingarten (Baden),30 - 35 Jahre,760,370,390
False,8215090,Weingarten (Baden),35 - 40 Jahre,944,487,457
False,8215090,Weingarten (Baden),40 - 45 Jahre,674,343,331
False,8215090,Weingarten (Baden),45 - 50 Jahre,654,328,326
False,8215090,Weingarten (Baden),50 - 55 Jahre,563,280,283
False,8215090,Weingarten (Baden),55 - 60 Jahre,557,279,278
False,8215090,Weingarten (Baden),60 - 65 Jahre,631,313,318
False,8215090,Weingarten (Baden),65 - 75 Jahre,906,404,502
False,8215090,Weingarten (Baden),75 und mehr Jahre,787,248,539
False,8215090,Weingarten (Baden),Insgesamt,9336,4500,4836
False,8215094,Zaisenhausen,unter 3 Jahre,62,38,24
False,8215094,Zaisenhausen,3 -  6 Jahre,72,48,24
False,8215094,Zaisenhausen,6 - 10 Jahre,79,51,28
False,8215094,Zaisenhausen,10 - 15 Jahre,118,59,59
False,8215094,Zaisenhausen,15 - 18 Jahre,55,26,29
False,8215094,Zaisenhausen,18 - 20 Jahre,41,22,19
False,8215094,Zaisenhausen,20 - 25 Jahre,67,40,27
False,8215094,Zaisenhausen,25 - 30 Jahre,88,48,40
False,8215094,Zaisenhausen,30 - 35 Jahre,146,81,65
False,8215094,Zaisenhausen,35 - 40 Jahre,164,77,87
False,8215094,Zaisenhausen,40 - 45 Jahre,133,67,66
False,8215094,Zaisenhausen,45 - 50 Jahre,87,45,42
False,8215094,Zaisenhausen,50 - 55 Jahre,86,46,40
False,8215094,Zaisenhausen,55 - 60 Jahre,99,52,47
False,8215094,Zaisenhausen,60 - 65 Jahre,130,60,70
False,8215094,Zaisenhausen,65 - 75 Jahre,146,67,79
False,8215094,Zaisenhausen,75 und mehr Jahre,95,27,68
False,8215094,Zaisenhausen,Insgesamt,1668,854,814
False,8215096,Karlsbad,unter 3 Jahre,491,233,258
False,8215096,Karlsbad,3 -  6 Jahre,533,267,266
False,8215096,Karlsbad,6 - 10 Jahre,785,408,377
False,8215096,Karlsbad,10 - 15 Jahre,994,526,468
False,8215096,Karlsbad,15 - 18 Jahre,578,280,298
False,8215096,Karlsbad,18 - 20 Jahre,419,214,205
False,8215096,Karlsbad,20 - 25 Jahre,860,398,462
False,8215096,Karlsbad,25 - 30 Jahre,867,422,445
False,8215096,Karlsbad,30 - 35 Jahre,1252,618,634
False,8215096,Karlsbad,35 - 40 Jahre,1477,720,757
False,8215096,Karlsbad,40 - 45 Jahre,1352,673,679
False,8215096,Karlsbad,45 - 50 Jahre,1235,610,625
False,8215096,Karlsbad,50 - 55 Jahre,1059,572,487
False,8215096,Karlsbad,55 - 60 Jahre,884,437,447
False,8215096,Karlsbad,60 - 65 Jahre,1056,541,515
False,8215096,Karlsbad,65 - 75 Jahre,1358,625,733
False,8215096,Karlsbad,75 und mehr Jahre,986,310,676
False,8215096,Karlsbad,Insgesamt,16186,7854,8332
False,8215097,"Kraichtal, Stadt",unter 3 Jahre,478,266,212
False,8215097,"Kraichtal, Stadt",3 -  6 Jahre,550,281,269
False,8215097,"Kraichtal, Stadt",6 - 10 Jahre,759,398,361
False,8215097,"Kraichtal, Stadt",10 - 15 Jahre,962,462,500
False,8215097,"Kraichtal, Stadt",15 - 18 Jahre,506,273,233
False,8215097,"Kraichtal, Stadt",18 - 20 Jahre,387,200,187
False,8215097,"Kraichtal, Stadt",20 - 25 Jahre,804,421,383
False,8215097,"Kraichtal, Stadt",25 - 30 Jahre,901,474,427
False,8215097,"Kraichtal, Stadt",30 - 35 Jahre,1172,599,573
False,8215097,"Kraichtal, Stadt",35 - 40 Jahre,1404,736,668
False,8215097,"Kraichtal, Stadt",40 - 45 Jahre,1179,611,568
False,8215097,"Kraichtal, Stadt",45 - 50 Jahre,963,504,459
False,8215097,"Kraichtal, Stadt",50 - 55 Jahre,876,429,447
False,8215097,"Kraichtal, Stadt",55 - 60 Jahre,704,366,338
False,8215097,"Kraichtal, Stadt",60 - 65 Jahre,922,461,461
False,8215097,"Kraichtal, Stadt",65 - 75 Jahre,1245,591,654
False,8215097,"Kraichtal, Stadt",75 und mehr Jahre,916,269,647
False,8215097,"Kraichtal, Stadt",Insgesamt,14728,7341,7387
False,8215099,Graben-Neudorf,unter 3 Jahre,333,170,163
False,8215099,Graben-Neudorf,3 -  6 Jahre,357,179,178
False,8215099,Graben-Neudorf,6 - 10 Jahre,570,296,274
False,8215099,Graben-Neudorf,10 - 15 Jahre,755,396,359
False,8215099,Graben-Neudorf,15 - 18 Jahre,403,216,187
False,8215099,Graben-Neudorf,18 - 20 Jahre,280,158,122
False,8215099,Graben-Neudorf,20 - 25 Jahre,611,334,277
False,8215099,Graben-Neudorf,25 - 30 Jahre,548,293,255
False,8215099,Graben-Neudorf,30 - 35 Jahre,842,418,424
False,8215099,Graben-Neudorf,35 - 40 Jahre,1070,551,519
False,8215099,Graben-Neudorf,40 - 45 Jahre,1029,506,523
False,8215099,Graben-Neudorf,45 - 50 Jahre,830,435,395
False,8215099,Graben-Neudorf,50 - 55 Jahre,673,360,313
False,8215099,Graben-Neudorf,55 - 60 Jahre,564,293,271
False,8215099,Graben-Neudorf,60 - 65 Jahre,704,342,362
False,8215099,Graben-Neudorf,65 - 75 Jahre,964,442,522
False,8215099,Graben-Neudorf,75 und mehr Jahre,627,194,433
False,8215099,Graben-Neudorf,Insgesamt,11160,5583,5577
False,8215100,Bad Schönborn,unter 3 Jahre,410,215,195
False,8215100,Bad Schönborn,3 -  6 Jahre,424,216,208
False,8215100,Bad Schönborn,6 - 10 Jahre,535,271,264
False,8215100,Bad Schönborn,10 - 15 Jahre,648,315,333
False,8215100,Bad Schönborn,15 - 18 Jahre,395,184,211
False,8215100,Bad Schönborn,18 - 20 Jahre,249,126,123
False,8215100,Bad Schönborn,20 - 25 Jahre,562,265,297
False,8215100,Bad Schönborn,25 - 30 Jahre,637,312,325
False,8215100,Bad Schönborn,30 - 35 Jahre,891,473,418
False,8215100,Bad Schönborn,35 - 40 Jahre,1015,537,478
False,8215100,Bad Schönborn,40 - 45 Jahre,911,492,419
False,8215100,Bad Schönborn,45 - 50 Jahre,789,414,375
False,8215100,Bad Schönborn,50 - 55 Jahre,688,349,339
False,8215100,Bad Schönborn,55 - 60 Jahre,573,308,265
False,8215100,Bad Schönborn,60 - 65 Jahre,659,331,328
False,8215100,Bad Schönborn,65 - 75 Jahre,938,448,490
False,8215100,Bad Schönborn,75 und mehr Jahre,997,254,743
False,8215100,Bad Schönborn,Insgesamt,11321,5510,5811
False,8215101,Pfinztal,unter 3 Jahre,555,285,270
False,8215101,Pfinztal,3 -  6 Jahre,600,317,283
False,8215101,Pfinztal,6 - 10 Jahre,808,393,415
False,8215101,Pfinztal,10 - 15 Jahre,1078,526,552
False,8215101,Pfinztal,15 - 18 Jahre,541,304,237
False,8215101,Pfinztal,18 - 20 Jahre,372,190,182
False,8215101,Pfinztal,20 - 25 Jahre,863,439,424
False,8215101,Pfinztal,25 - 30 Jahre,899,459,440
False,8215101,Pfinztal,30 - 35 Jahre,1445,723,722
False,8215101,Pfinztal,35 - 40 Jahre,1615,807,808
False,8215101,Pfinztal,40 - 45 Jahre,1430,721,709
False,8215101,Pfinztal,45 - 50 Jahre,1328,697,631
False,8215101,Pfinztal,50 - 55 Jahre,1175,580,595
False,8215101,Pfinztal,55 - 60 Jahre,1007,484,523
False,8215101,Pfinztal,60 - 65 Jahre,1255,627,628
False,8215101,Pfinztal,65 - 75 Jahre,1700,776,924
False,8215101,Pfinztal,75 und mehr Jahre,1292,415,877
False,8215101,Pfinztal,Insgesamt,17963,8743,9220
False,8215102,Eggenstein-Leopoldshafen,unter 3 Jahre,503,250,253
False,8215102,Eggenstein-Leopoldshafen,3 -  6 Jahre,498,259,239
False,8215102,Eggenstein-Leopoldshafen,6 - 10 Jahre,624,327,297
False,8215102,Eggenstein-Leopoldshafen,10 - 15 Jahre,728,350,378
False,8215102,Eggenstein-Leopoldshafen,15 - 18 Jahre,449,224,225
False,8215102,Eggenstein-Leopoldshafen,18 - 20 Jahre,281,132,149
False,8215102,Eggenstein-Leopoldshafen,20 - 25 Jahre,722,330,392
False,8215102,Eggenstein-Leopoldshafen,25 - 30 Jahre,925,434,491
False,8215102,Eggenstein-Leopoldshafen,30 - 35 Jahre,1372,707,665
False,8215102,Eggenstein-Leopoldshafen,35 - 40 Jahre,1410,745,665
False,8215102,Eggenstein-Leopoldshafen,40 - 45 Jahre,1259,629,630
False,8215102,Eggenstein-Leopoldshafen,45 - 50 Jahre,1079,550,529
False,8215102,Eggenstein-Leopoldshafen,50 - 55 Jahre,1027,474,553
False,8215102,Eggenstein-Leopoldshafen,55 - 60 Jahre,1013,508,505
False,8215102,Eggenstein-Leopoldshafen,60 - 65 Jahre,1144,554,590
False,8215102,Eggenstein-Leopoldshafen,65 - 75 Jahre,1343,672,671
False,8215102,Eggenstein-Leopoldshafen,75 und mehr Jahre,687,236,451
False,8215102,Eggenstein-Leopoldshafen,Insgesamt,15064,7381,7683
False,8215103,Karlsdorf-Neuthard,unter 3 Jahre,311,159,152
False,8215103,Karlsdorf-Neuthard,3 -  6 Jahre,324,165,159
False,8215103,Karlsdorf-Neuthard,6 - 10 Jahre,424,220,204
False,8215103,Karlsdorf-Neuthard,10 - 15 Jahre,533,281,252
False,8215103,Karlsdorf-Neuthard,15 - 18 Jahre,307,149,158
False,8215103,Karlsdorf-Neuthard,18 - 20 Jahre,221,123,98
False,8215103,Karlsdorf-Neuthard,20 - 25 Jahre,448,223,225
False,8215103,Karlsdorf-Neuthard,25 - 30 Jahre,583,295,288
False,8215103,Karlsdorf-Neuthard,30 - 35 Jahre,807,417,390
False,8215103,Karlsdorf-Neuthard,35 - 40 Jahre,847,443,404
False,8215103,Karlsdorf-Neuthard,40 - 45 Jahre,768,403,365
False,8215103,Karlsdorf-Neuthard,45 - 50 Jahre,625,322,303
False,8215103,Karlsdorf-Neuthard,50 - 55 Jahre,601,301,300
False,8215103,Karlsdorf-Neuthard,55 - 60 Jahre,517,286,231
False,8215103,Karlsdorf-Neuthard,60 - 65 Jahre,668,332,336
False,8215103,Karlsdorf-Neuthard,65 - 75 Jahre,734,333,401
False,8215103,Karlsdorf-Neuthard,75 und mehr Jahre,442,135,307
False,8215103,Karlsdorf-Neuthard,Insgesamt,9160,4587,4573
False,8215105,Linkenheim-Hochstetten,unter 3 Jahre,377,173,204
False,8215105,Linkenheim-Hochstetten,3 -  6 Jahre,433,238,195
False,8215105,Linkenheim-Hochstetten,6 - 10 Jahre,577,288,289
False,8215105,Linkenheim-Hochstetten,10 - 15 Jahre,700,344,356
False,8215105,Linkenheim-Hochstetten,15 - 18 Jahre,400,197,203
False,8215105,Linkenheim-Hochstetten,18 - 20 Jahre,246,121,125
False,8215105,Linkenheim-Hochstetten,20 - 25 Jahre,569,288,281
False,8215105,Linkenheim-Hochstetten,25 - 30 Jahre,631,318,313
False,8215105,Linkenheim-Hochstetten,30 - 35 Jahre,948,457,491
False,8215105,Linkenheim-Hochstetten,35 - 40 Jahre,1086,556,530
False,8215105,Linkenheim-Hochstetten,40 - 45 Jahre,1027,542,485
False,8215105,Linkenheim-Hochstetten,45 - 50 Jahre,845,429,416
False,8215105,Linkenheim-Hochstetten,50 - 55 Jahre,746,365,381
False,8215105,Linkenheim-Hochstetten,55 - 60 Jahre,642,345,297
False,8215105,Linkenheim-Hochstetten,60 - 65 Jahre,741,361,380
False,8215105,Linkenheim-Hochstetten,65 - 75 Jahre,981,473,508
False,8215105,Linkenheim-Hochstetten,75 und mehr Jahre,649,211,438
False,8215105,Linkenheim-Hochstetten,Insgesamt,11598,5706,5892
False,8215106,"Waghäusel, Stadt",unter 3 Jahre,546,277,269
False,8215106,"Waghäusel, Stadt",3 -  6 Jahre,611,328,283
False,8215106,"Waghäusel, Stadt",6 - 10 Jahre,873,443,430
False,8215106,"Waghäusel, Stadt",10 - 15 Jahre,1180,621,559
False,8215106,"Waghäusel, Stadt",15 - 18 Jahre,656,332,324
False,8215106,"Waghäusel, Stadt",18 - 20 Jahre,475,231,244
False,8215106,"Waghäusel, Stadt",20 - 25 Jahre,1059,545,514
False,8215106,"Waghäusel, Stadt",25 - 30 Jahre,1264,656,608
False,8215106,"Waghäusel, Stadt",30 - 35 Jahre,1600,788,812
False,8215106,"Waghäusel, Stadt",35 - 40 Jahre,1745,912,833
False,8215106,"Waghäusel, Stadt",40 - 45 Jahre,1541,765,776
False,8215106,"Waghäusel, Stadt",45 - 50 Jahre,1442,740,702
False,8215106,"Waghäusel, Stadt",50 - 55 Jahre,1241,620,621
False,8215106,"Waghäusel, Stadt",55 - 60 Jahre,1071,524,547
False,8215106,"Waghäusel, Stadt",60 - 65 Jahre,1379,707,672
False,8215106,"Waghäusel, Stadt",65 - 75 Jahre,1700,774,926
False,8215106,"Waghäusel, Stadt",75 und mehr Jahre,1249,385,864
False,8215106,"Waghäusel, Stadt",Insgesamt,19632,9648,9984
False,8215107,Oberhausen-Rheinhausen,unter 3 Jahre,253,114,139
False,8215107,Oberhausen-Rheinhausen,3 -  6 Jahre,299,143,156
False,8215107,Oberhausen-Rheinhausen,6 - 10 Jahre,426,206,220
False,8215107,Oberhausen-Rheinhausen,10 - 15 Jahre,553,303,250
False,8215107,Oberhausen-Rheinhausen,15 - 18 Jahre,299,175,124
False,8215107,Oberhausen-Rheinhausen,18 - 20 Jahre,213,107,106
False,8215107,Oberhausen-Rheinhausen,20 - 25 Jahre,446,224,222
False,8215107,Oberhausen-Rheinhausen,25 - 30 Jahre,486,234,252
False,8215107,Oberhausen-Rheinhausen,30 - 35 Jahre,710,361,349
False,8215107,Oberhausen-Rheinhausen,35 - 40 Jahre,854,421,433
False,8215107,Oberhausen-Rheinhausen,40 - 45 Jahre,863,452,411
False,8215107,Oberhausen-Rheinhausen,45 - 50 Jahre,660,326,334
False,8215107,Oberhausen-Rheinhausen,50 - 55 Jahre,628,320,308
False,8215107,Oberhausen-Rheinhausen,55 - 60 Jahre,520,299,221
False,8215107,Oberhausen-Rheinhausen,60 - 65 Jahre,652,313,339
False,8215107,Oberhausen-Rheinhausen,65 - 75 Jahre,985,466,519
False,8215107,Oberhausen-Rheinhausen,75 und mehr Jahre,527,159,368
False,8215107,Oberhausen-Rheinhausen,Insgesamt,9374,4623,4751
False,8215108,"Rheinstetten, Stadt",unter 3 Jahre,549,292,257
False,8215108,"Rheinstetten, Stadt",3 -  6 Jahre,622,299,323
False,8215108,"Rheinstetten, Stadt",6 - 10 Jahre,944,493,451
False,8215108,"Rheinstetten, Stadt",10 - 15 Jahre,1164,598,566
False,8215108,"Rheinstetten, Stadt",15 - 18 Jahre,642,342,300
False,8215108,"Rheinstetten, Stadt",18 - 20 Jahre,425,226,199
False,8215108,"Rheinstetten, Stadt",20 - 25 Jahre,927,449,478
False,8215108,"Rheinstetten, Stadt",25 - 30 Jahre,1022,502,520
False,8215108,"Rheinstetten, Stadt",30 - 35 Jahre,1589,785,804
False,8215108,"Rheinstetten, Stadt",35 - 40 Jahre,1901,965,936
False,8215108,"Rheinstetten, Stadt",40 - 45 Jahre,1660,841,819
False,8215108,"Rheinstetten, Stadt",45 - 50 Jahre,1469,741,728
False,8215108,"Rheinstetten, Stadt",50 - 55 Jahre,1398,660,738
False,8215108,"Rheinstetten, Stadt",55 - 60 Jahre,1345,658,687
False,8215108,"Rheinstetten, Stadt",60 - 65 Jahre,1549,759,790
False,8215108,"Rheinstetten, Stadt",65 - 75 Jahre,1943,902,1041
False,8215108,"Rheinstetten, Stadt",75 und mehr Jahre,1184,384,800
False,8215108,"Rheinstetten, Stadt",Insgesamt,20333,9896,10437
False,8215109,"Stutensee, Stadt",unter 3 Jahre,692,347,345
False,8215109,"Stutensee, Stadt",3 -  6 Jahre,676,337,339
False,8215109,"Stutensee, Stadt",6 - 10 Jahre,968,500,468
False,8215109,"Stutensee, Stadt",10 - 15 Jahre,1252,645,607
False,8215109,"Stutensee, Stadt",15 - 18 Jahre,690,376,314
False,8215109,"Stutensee, Stadt",18 - 20 Jahre,508,278,230
False,8215109,"Stutensee, Stadt",20 - 25 Jahre,1136,540,596
False,8215109,"Stutensee, Stadt",25 - 30 Jahre,1200,618,582
False,8215109,"Stutensee, Stadt",30 - 35 Jahre,1692,871,821
False,8215109,"Stutensee, Stadt",35 - 40 Jahre,2136,1066,1070
False,8215109,"Stutensee, Stadt",40 - 45 Jahre,1864,974,890
False,8215109,"Stutensee, Stadt",45 - 50 Jahre,1694,819,875
False,8215109,"Stutensee, Stadt",50 - 55 Jahre,1555,811,744
False,8215109,"Stutensee, Stadt",55 - 60 Jahre,1345,695,650
False,8215109,"Stutensee, Stadt",60 - 65 Jahre,1451,730,721
False,8215109,"Stutensee, Stadt",65 - 75 Jahre,1758,817,941
False,8215109,"Stutensee, Stadt",75 und mehr Jahre,1177,387,790
False,8215109,"Stutensee, Stadt",Insgesamt,21794,10811,10983
False,8215110,Waldbronn,unter 3 Jahre,323,168,155
False,8215110,Waldbronn,3 -  6 Jahre,375,188,187
False,8215110,Waldbronn,6 - 10 Jahre,496,256,240
False,8215110,Waldbronn,10 - 15 Jahre,638,352,286
False,8215110,Waldbronn,15 - 18 Jahre,368,174,194
False,8215110,Waldbronn,18 - 20 Jahre,270,130,140
False,8215110,Waldbronn,20 - 25 Jahre,589,316,273
False,8215110,Waldbronn,25 - 30 Jahre,699,335,364
False,8215110,Waldbronn,30 - 35 Jahre,913,451,462
False,8215110,Waldbronn,35 - 40 Jahre,1087,573,514
False,8215110,Waldbronn,40 - 45 Jahre,935,450,485
False,8215110,Waldbronn,45 - 50 Jahre,829,407,422
False,8215110,Waldbronn,50 - 55 Jahre,786,392,394
False,8215110,Waldbronn,55 - 60 Jahre,817,408,409
False,8215110,Waldbronn,60 - 65 Jahre,997,511,486
False,8215110,Waldbronn,65 - 75 Jahre,1320,643,677
False,8215110,Waldbronn,75 und mehr Jahre,896,294,602
False,8215110,Waldbronn,Insgesamt,12338,6048,6290
False,8215111,Dettenheim,unter 3 Jahre,199,112,87
False,8215111,Dettenheim,3 -  6 Jahre,215,117,98
False,8215111,Dettenheim,6 - 10 Jahre,323,163,160
False,8215111,Dettenheim,10 - 15 Jahre,484,248,236
False,8215111,Dettenheim,15 - 18 Jahre,224,126,98
False,8215111,Dettenheim,18 - 20 Jahre,146,71,75
False,8215111,Dettenheim,20 - 25 Jahre,283,144,139
False,8215111,Dettenheim,25 - 30 Jahre,359,192,167
False,8215111,Dettenheim,30 - 35 Jahre,472,224,248
False,8215111,Dettenheim,35 - 40 Jahre,659,320,339
False,8215111,Dettenheim,40 - 45 Jahre,645,348,297
False,8215111,Dettenheim,45 - 50 Jahre,526,263,263
False,8215111,Dettenheim,50 - 55 Jahre,462,248,214
False,8215111,Dettenheim,55 - 60 Jahre,347,182,165
False,8215111,Dettenheim,60 - 65 Jahre,424,217,207
False,8215111,Dettenheim,65 - 75 Jahre,588,269,319
False,8215111,Dettenheim,75 und mehr Jahre,387,136,251
False,8215111,Dettenheim,Insgesamt,6743,3380,3363
False,8216,Landkreis Rastatt,unter 3 Jahre,6414,3294,3120
False,8216,Landkreis Rastatt,3 -  6 Jahre,7145,3700,3445
False,8216,Landkreis Rastatt,6 - 10 Jahre,10109,5226,4883
False,8216,Landkreis Rastatt,10 - 15 Jahre,13071,6698,6373
False,8216,Landkreis Rastatt,15 - 18 Jahre,7453,3777,3676
False,8216,Landkreis Rastatt,18 - 20 Jahre,4998,2527,2471
False,8216,Landkreis Rastatt,20 - 25 Jahre,11301,5765,5536
False,8216,Landkreis Rastatt,25 - 30 Jahre,12323,6173,6150
False,8216,Landkreis Rastatt,30 - 35 Jahre,17592,8926,8666
False,8216,Landkreis Rastatt,35 - 40 Jahre,19959,10217,9742
False,8216,Landkreis Rastatt,40 - 45 Jahre,18108,9304,8804
False,8216,Landkreis Rastatt,45 - 50 Jahre,16069,8142,7927
False,8216,Landkreis Rastatt,50 - 55 Jahre,13477,6861,6616
False,8216,Landkreis Rastatt,55 - 60 Jahre,12310,6256,6054
False,8216,Landkreis Rastatt,60 - 65 Jahre,15531,7568,7963
False,8216,Landkreis Rastatt,65 - 75 Jahre,21615,9969,11646
False,8216,Landkreis Rastatt,75 und mehr Jahre,15853,4913,10940
False,8216,Landkreis Rastatt,Insgesamt,223328,109316,114012
False,8216002,Au am Rhein,unter 3 Jahre,101,54,47
False,8216002,Au am Rhein,3 -  6 Jahre,146,65,81
False,8216002,Au am Rhein,6 - 10 Jahre,166,85,81
False,8216002,Au am Rhein,10 - 15 Jahre,199,100,99
False,8216002,Au am Rhein,15 - 18 Jahre,107,61,46
False,8216002,Au am Rhein,18 - 20 Jahre,71,39,32
False,8216002,Au am Rhein,20 - 25 Jahre,143,77,66
False,8216002,Au am Rhein,25 - 30 Jahre,143,68,75
False,8216002,Au am Rhein,30 - 35 Jahre,311,167,144
False,8216002,Au am Rhein,35 - 40 Jahre,360,172,188
False,8216002,Au am Rhein,40 - 45 Jahre,310,167,143
False,8216002,Au am Rhein,45 - 50 Jahre,227,124,103
False,8216002,Au am Rhein,50 - 55 Jahre,189,102,87
False,8216002,Au am Rhein,55 - 60 Jahre,135,63,72
False,8216002,Au am Rhein,60 - 65 Jahre,234,103,131
False,8216002,Au am Rhein,65 - 75 Jahre,294,145,149
False,8216002,Au am Rhein,75 und mehr Jahre,182,58,124
False,8216002,Au am Rhein,Insgesamt,3318,1650,1668
False,8216005,Bietigheim,unter 3 Jahre,177,84,93
False,8216005,Bietigheim,3 -  6 Jahre,195,92,103
False,8216005,Bietigheim,6 - 10 Jahre,245,101,144
False,8216005,Bietigheim,10 - 15 Jahre,329,182,147
False,8216005,Bietigheim,15 - 18 Jahre,198,84,114
False,8216005,Bietigheim,18 - 20 Jahre,135,58,77
False,8216005,Bietigheim,20 - 25 Jahre,267,137,130
False,8216005,Bietigheim,25 - 30 Jahre,326,164,162
False,8216005,Bietigheim,30 - 35 Jahre,486,247,239
False,8216005,Bietigheim,35 - 40 Jahre,536,264,272
False,8216005,Bietigheim,40 - 45 Jahre,470,236,234
False,8216005,Bietigheim,45 - 50 Jahre,427,226,201
False,8216005,Bietigheim,50 - 55 Jahre,388,201,187
False,8216005,Bietigheim,55 - 60 Jahre,296,139,157
False,8216005,Bietigheim,60 - 65 Jahre,380,196,184
False,8216005,Bietigheim,65 - 75 Jahre,571,263,308
False,8216005,Bietigheim,75 und mehr Jahre,491,152,339
False,8216005,Bietigheim,Insgesamt,5917,2826,3091
False,8216006,Bischweier,unter 3 Jahre,108,56,52
False,8216006,Bischweier,3 -  6 Jahre,100,46,54
False,8216006,Bischweier,6 - 10 Jahre,126,62,64
False,8216006,Bischweier,10 - 15 Jahre,149,72,77
False,8216006,Bischweier,15 - 18 Jahre,95,47,48
False,8216006,Bischweier,18 - 20 Jahre,59,26,33
False,8216006,Bischweier,20 - 25 Jahre,152,79,73
False,8216006,Bischweier,25 - 30 Jahre,178,75,103
False,8216006,Bischweier,30 - 35 Jahre,305,147,158
False,8216006,Bischweier,35 - 40 Jahre,319,163,156
False,8216006,Bischweier,40 - 45 Jahre,222,114,108
False,8216006,Bischweier,45 - 50 Jahre,245,124,121
False,8216006,Bischweier,50 - 55 Jahre,176,87,89
False,8216006,Bischweier,55 - 60 Jahre,186,99,87
False,8216006,Bischweier,60 - 65 Jahre,204,102,102
False,8216006,Bischweier,65 - 75 Jahre,284,144,140
False,8216006,Bischweier,75 und mehr Jahre,156,49,107
False,8216006,Bischweier,Insgesamt,3064,1492,1572
False,8216007,"Bühl, Stadt",unter 3 Jahre,886,454,432
False,8216007,"Bühl, Stadt",3 -  6 Jahre,979,536,443
False,8216007,"Bühl, Stadt",6 - 10 Jahre,1421,747,674
False,8216007,"Bühl, Stadt",10 - 15 Jahre,1621,836,785
False,8216007,"Bühl, Stadt",15 - 18 Jahre,952,505,447
False,8216007,"Bühl, Stadt",18 - 20 Jahre,643,333,310
False,8216007,"Bühl, Stadt",20 - 25 Jahre,1470,763,707
False,8216007,"Bühl, Stadt",25 - 30 Jahre,1755,844,911
False,8216007,"Bühl, Stadt",30 - 35 Jahre,2387,1209,1178
False,8216007,"Bühl, Stadt",35 - 40 Jahre,2673,1358,1315
False,8216007,"Bühl, Stadt",40 - 45 Jahre,2274,1158,1116
False,8216007,"Bühl, Stadt",45 - 50 Jahre,1976,966,1010
False,8216007,"Bühl, Stadt",50 - 55 Jahre,1684,856,828
False,8216007,"Bühl, Stadt",55 - 60 Jahre,1573,785,788
False,8216007,"Bühl, Stadt",60 - 65 Jahre,1777,874,903
False,8216007,"Bühl, Stadt",65 - 75 Jahre,2543,1147,1396
False,8216007,"Bühl, Stadt",75 und mehr Jahre,2076,601,1475
False,8216007,"Bühl, Stadt",Insgesamt,28690,13972,14718
False,8216008,Bühlertal,unter 3 Jahre,229,111,118
False,8216008,Bühlertal,3 -  6 Jahre,219,110,109
False,8216008,Bühlertal,6 - 10 Jahre,316,157,159
False,8216008,Bühlertal,10 - 15 Jahre,469,240,229
False,8216008,Bühlertal,15 - 18 Jahre,248,135,113
False,8216008,Bühlertal,18 - 20 Jahre,204,109,95
False,8216008,Bühlertal,20 - 25 Jahre,396,215,181
False,8216008,Bühlertal,25 - 30 Jahre,475,241,234
False,8216008,Bühlertal,30 - 35 Jahre,645,340,305
False,8216008,Bühlertal,35 - 40 Jahre,781,405,376
False,8216008,Bühlertal,40 - 45 Jahre,617,303,314
False,8216008,Bühlertal,45 - 50 Jahre,609,315,294
False,8216008,Bühlertal,50 - 55 Jahre,472,253,219
False,8216008,Bühlertal,55 - 60 Jahre,387,210,177
False,8216008,Bühlertal,60 - 65 Jahre,646,302,344
False,8216008,Bühlertal,65 - 75 Jahre,853,392,461
False,8216008,Bühlertal,75 und mehr Jahre,600,191,409
False,8216008,Bühlertal,Insgesamt,8166,4029,4137
False,8216009,Durmersheim,unter 3 Jahre,338,178,160
False,8216009,Durmersheim,3 -  6 Jahre,378,207,171
False,8216009,Durmersheim,6 - 10 Jahre,467,253,214
False,8216009,Durmersheim,10 - 15 Jahre,630,284,346
False,8216009,Durmersheim,15 - 18 Jahre,366,193,173
False,8216009,Durmersheim,18 - 20 Jahre,251,128,123
False,8216009,Durmersheim,20 - 25 Jahre,565,287,278
False,8216009,Durmersheim,25 - 30 Jahre,710,347,363
False,8216009,Durmersheim,30 - 35 Jahre,988,503,485
False,8216009,Durmersheim,35 - 40 Jahre,1061,538,523
False,8216009,Durmersheim,40 - 45 Jahre,1006,507,499
False,8216009,Durmersheim,45 - 50 Jahre,815,390,425
False,8216009,Durmersheim,50 - 55 Jahre,774,396,378
False,8216009,Durmersheim,55 - 60 Jahre,716,362,354
False,8216009,Durmersheim,60 - 65 Jahre,748,381,367
False,8216009,Durmersheim,65 - 75 Jahre,1056,511,545
False,8216009,Durmersheim,75 und mehr Jahre,643,212,431
False,8216009,Durmersheim,Insgesamt,11512,5677,5835
False,8216012,Elchesheim-Illingen,unter 3 Jahre,98,55,43
False,8216012,Elchesheim-Illingen,3 -  6 Jahre,105,60,45
False,8216012,Elchesheim-Illingen,6 - 10 Jahre,140,68,72
False,8216012,Elchesheim-Illingen,10 - 15 Jahre,169,97,72
False,8216012,Elchesheim-Illingen,15 - 18 Jahre,115,56,59
False,8216012,Elchesheim-Illingen,18 - 20 Jahre,75,36,39
False,8216012,Elchesheim-Illingen,20 - 25 Jahre,143,76,67
False,8216012,Elchesheim-Illingen,25 - 30 Jahre,167,82,85
False,8216012,Elchesheim-Illingen,30 - 35 Jahre,266,126,140
False,8216012,Elchesheim-Illingen,35 - 40 Jahre,253,135,118
False,8216012,Elchesheim-Illingen,40 - 45 Jahre,304,144,160
False,8216012,Elchesheim-Illingen,45 - 50 Jahre,231,129,102
False,8216012,Elchesheim-Illingen,50 - 55 Jahre,195,105,90
False,8216012,Elchesheim-Illingen,55 - 60 Jahre,185,91,94
False,8216012,Elchesheim-Illingen,60 - 65 Jahre,196,98,98
False,8216012,Elchesheim-Illingen,65 - 75 Jahre,298,149,149
False,8216012,Elchesheim-Illingen,75 und mehr Jahre,179,59,120
False,8216012,Elchesheim-Illingen,Insgesamt,3119,1566,1553
False,8216013,Forbach,unter 3 Jahre,162,84,78
False,8216013,Forbach,3 -  6 Jahre,190,98,92
False,8216013,Forbach,6 - 10 Jahre,260,137,123
False,8216013,Forbach,10 - 15 Jahre,312,161,151
False,8216013,Forbach,15 - 18 Jahre,168,78,90
False,8216013,Forbach,18 - 20 Jahre,118,56,62
False,8216013,Forbach,20 - 25 Jahre,273,140,133
False,8216013,Forbach,25 - 30 Jahre,297,138,159
False,8216013,Forbach,30 - 35 Jahre,442,227,215
False,8216013,Forbach,35 - 40 Jahre,482,249,233
False,8216013,Forbach,40 - 45 Jahre,426,229,197
False,8216013,Forbach,45 - 50 Jahre,389,202,187
False,8216013,Forbach,50 - 55 Jahre,319,166,153
False,8216013,Forbach,55 - 60 Jahre,297,148,149
False,8216013,Forbach,60 - 65 Jahre,442,224,218
False,8216013,Forbach,65 - 75 Jahre,664,295,369
False,8216013,Forbach,75 und mehr Jahre,392,127,265
False,8216013,Forbach,Insgesamt,5633,2759,2874
False,8216015,"Gaggenau, Stadt",unter 3 Jahre,798,392,406
False,8216015,"Gaggenau, Stadt",3 -  6 Jahre,883,483,400
False,8216015,"Gaggenau, Stadt",6 - 10 Jahre,1244,639,605
False,8216015,"Gaggenau, Stadt",10 - 15 Jahre,1604,805,799
False,8216015,"Gaggenau, Stadt",15 - 18 Jahre,879,449,430
False,8216015,"Gaggenau, Stadt",18 - 20 Jahre,657,343,314
False,8216015,"Gaggenau, Stadt",20 - 25 Jahre,1559,812,747
False,8216015,"Gaggenau, Stadt",25 - 30 Jahre,1576,844,732
False,8216015,"Gaggenau, Stadt",30 - 35 Jahre,2179,1111,1068
False,8216015,"Gaggenau, Stadt",35 - 40 Jahre,2495,1253,1242
False,8216015,"Gaggenau, Stadt",40 - 45 Jahre,2145,1090,1055
False,8216015,"Gaggenau, Stadt",45 - 50 Jahre,2060,1007,1053
False,8216015,"Gaggenau, Stadt",50 - 55 Jahre,1993,1015,978
False,8216015,"Gaggenau, Stadt",55 - 60 Jahre,1893,941,952
False,8216015,"Gaggenau, Stadt",60 - 65 Jahre,2333,1145,1188
False,8216015,"Gaggenau, Stadt",65 - 75 Jahre,3097,1443,1654
False,8216015,"Gaggenau, Stadt",75 und mehr Jahre,2308,717,1591
False,8216015,"Gaggenau, Stadt",Insgesamt,29703,14489,15214
False,8216017,"Gernsbach, Stadt",unter 3 Jahre,358,186,172
False,8216017,"Gernsbach, Stadt",3 -  6 Jahre,383,194,189
False,8216017,"Gernsbach, Stadt",6 - 10 Jahre,612,304,308
False,8216017,"Gernsbach, Stadt",10 - 15 Jahre,792,418,374
False,8216017,"Gernsbach, Stadt",15 - 18 Jahre,483,260,223
False,8216017,"Gernsbach, Stadt",18 - 20 Jahre,316,169,147
False,8216017,"Gernsbach, Stadt",20 - 25 Jahre,718,372,346
False,8216017,"Gernsbach, Stadt",25 - 30 Jahre,755,388,367
False,8216017,"Gernsbach, Stadt",30 - 35 Jahre,1061,511,550
False,8216017,"Gernsbach, Stadt",35 - 40 Jahre,1237,667,570
False,8216017,"Gernsbach, Stadt",40 - 45 Jahre,1139,575,564
False,8216017,"Gernsbach, Stadt",45 - 50 Jahre,1046,533,513
False,8216017,"Gernsbach, Stadt",50 - 55 Jahre,891,435,456
False,8216017,"Gernsbach, Stadt",55 - 60 Jahre,873,463,410
False,8216017,"Gernsbach, Stadt",60 - 65 Jahre,1081,505,576
False,8216017,"Gernsbach, Stadt",65 - 75 Jahre,1474,690,784
False,8216017,"Gernsbach, Stadt",75 und mehr Jahre,1292,391,901
False,8216017,"Gernsbach, Stadt",Insgesamt,14511,7061,7450
False,8216022,Hügelsheim,unter 3 Jahre,212,116,96
False,8216022,Hügelsheim,3 -  6 Jahre,239,113,126
False,8216022,Hügelsheim,6 - 10 Jahre,311,163,148
False,8216022,Hügelsheim,10 - 15 Jahre,378,199,179
False,8216022,Hügelsheim,15 - 18 Jahre,205,110,95
False,8216022,Hügelsheim,18 - 20 Jahre,130,63,67
False,8216022,Hügelsheim,20 - 25 Jahre,256,122,134
False,8216022,Hügelsheim,25 - 30 Jahre,314,134,180
False,8216022,Hügelsheim,30 - 35 Jahre,460,227,233
False,8216022,Hügelsheim,35 - 40 Jahre,540,290,250
False,8216022,Hügelsheim,40 - 45 Jahre,481,232,249
False,8216022,Hügelsheim,45 - 50 Jahre,340,177,163
False,8216022,Hügelsheim,50 - 55 Jahre,203,108,95
False,8216022,Hügelsheim,55 - 60 Jahre,148,87,61
False,8216022,Hügelsheim,60 - 65 Jahre,188,83,105
False,8216022,Hügelsheim,65 - 75 Jahre,250,101,149
False,8216022,Hügelsheim,75 und mehr Jahre,145,46,99
False,8216022,Hügelsheim,Insgesamt,4800,2371,2429
False,8216023,Iffezheim,unter 3 Jahre,144,79,65
False,8216023,Iffezheim,3 -  6 Jahre,147,79,68
False,8216023,Iffezheim,6 - 10 Jahre,251,129,122
False,8216023,Iffezheim,10 - 15 Jahre,331,163,168
False,8216023,Iffezheim,15 - 18 Jahre,183,84,99
False,8216023,Iffezheim,18 - 20 Jahre,97,47,50
False,8216023,Iffezheim,20 - 25 Jahre,239,123,116
False,8216023,Iffezheim,25 - 30 Jahre,250,128,122
False,8216023,Iffezheim,30 - 35 Jahre,377,207,170
False,8216023,Iffezheim,35 - 40 Jahre,488,234,254
False,8216023,Iffezheim,40 - 45 Jahre,409,225,184
False,8216023,Iffezheim,45 - 50 Jahre,379,205,174
False,8216023,Iffezheim,50 - 55 Jahre,245,126,119
False,8216023,Iffezheim,55 - 60 Jahre,216,107,109
False,8216023,Iffezheim,60 - 65 Jahre,293,150,143
False,8216023,Iffezheim,65 - 75 Jahre,394,184,210
False,8216023,Iffezheim,75 und mehr Jahre,253,73,180
False,8216023,Iffezheim,Insgesamt,4696,2343,2353
False,8216024,"Kuppenheim, Stadt",unter 3 Jahre,201,104,97
False,8216024,"Kuppenheim, Stadt",3 -  6 Jahre,233,123,110
False,8216024,"Kuppenheim, Stadt",6 - 10 Jahre,323,167,156
False,8216024,"Kuppenheim, Stadt",10 - 15 Jahre,453,234,219
False,8216024,"Kuppenheim, Stadt",15 - 18 Jahre,226,110,116
False,8216024,"Kuppenheim, Stadt",18 - 20 Jahre,158,74,84
False,8216024,"Kuppenheim, Stadt",20 - 25 Jahre,368,195,173
False,8216024,"Kuppenheim, Stadt",25 - 30 Jahre,456,228,228
False,8216024,"Kuppenheim, Stadt",30 - 35 Jahre,596,302,294
False,8216024,"Kuppenheim, Stadt",35 - 40 Jahre,659,357,302
False,8216024,"Kuppenheim, Stadt",40 - 45 Jahre,569,279,290
False,8216024,"Kuppenheim, Stadt",45 - 50 Jahre,545,285,260
False,8216024,"Kuppenheim, Stadt",50 - 55 Jahre,497,241,256
False,8216024,"Kuppenheim, Stadt",55 - 60 Jahre,472,234,238
False,8216024,"Kuppenheim, Stadt",60 - 65 Jahre,577,292,285
False,8216024,"Kuppenheim, Stadt",65 - 75 Jahre,695,338,357
False,8216024,"Kuppenheim, Stadt",75 und mehr Jahre,557,159,398
False,8216024,"Kuppenheim, Stadt",Insgesamt,7585,3722,3863
False,8216028,"Lichtenau, Stadt",unter 3 Jahre,153,73,80
False,8216028,"Lichtenau, Stadt",3 -  6 Jahre,169,69,100
False,8216028,"Lichtenau, Stadt",6 - 10 Jahre,273,150,123
False,8216028,"Lichtenau, Stadt",10 - 15 Jahre,324,164,160
False,8216028,"Lichtenau, Stadt",15 - 18 Jahre,180,83,97
False,8216028,"Lichtenau, Stadt",18 - 20 Jahre,120,69,51
False,8216028,"Lichtenau, Stadt",20 - 25 Jahre,260,130,130
False,8216028,"Lichtenau, Stadt",25 - 30 Jahre,287,139,148
False,8216028,"Lichtenau, Stadt",30 - 35 Jahre,402,200,202
False,8216028,"Lichtenau, Stadt",35 - 40 Jahre,472,235,237
False,8216028,"Lichtenau, Stadt",40 - 45 Jahre,436,219,217
False,8216028,"Lichtenau, Stadt",45 - 50 Jahre,318,158,160
False,8216028,"Lichtenau, Stadt",50 - 55 Jahre,299,162,137
False,8216028,"Lichtenau, Stadt",55 - 60 Jahre,239,121,118
False,8216028,"Lichtenau, Stadt",60 - 65 Jahre,292,150,142
False,8216028,"Lichtenau, Stadt",65 - 75 Jahre,434,215,219
False,8216028,"Lichtenau, Stadt",75 und mehr Jahre,307,96,211
False,8216028,"Lichtenau, Stadt",Insgesamt,4965,2433,2532
False,8216029,Loffenau,unter 3 Jahre,76,38,38
False,8216029,Loffenau,3 -  6 Jahre,92,48,44
False,8216029,Loffenau,6 - 10 Jahre,132,61,71
False,8216029,Loffenau,10 - 15 Jahre,186,98,88
False,8216029,Loffenau,15 - 18 Jahre,77,37,40
False,8216029,Loffenau,18 - 20 Jahre,57,22,35
False,8216029,Loffenau,20 - 25 Jahre,96,48,48
False,8216029,Loffenau,25 - 30 Jahre,134,71,63
False,8216029,Loffenau,30 - 35 Jahre,225,109,116
False,8216029,Loffenau,35 - 40 Jahre,265,138,127
False,8216029,Loffenau,40 - 45 Jahre,227,127,100
False,8216029,Loffenau,45 - 50 Jahre,170,90,80
False,8216029,Loffenau,50 - 55 Jahre,168,92,76
False,8216029,Loffenau,55 - 60 Jahre,135,64,71
False,8216029,Loffenau,60 - 65 Jahre,210,110,100
False,8216029,Loffenau,65 - 75 Jahre,243,114,129
False,8216029,Loffenau,75 und mehr Jahre,139,45,94
False,8216029,Loffenau,Insgesamt,2632,1312,1320
False,8216033,Muggensturm,unter 3 Jahre,176,88,88
False,8216033,Muggensturm,3 -  6 Jahre,204,97,107
False,8216033,Muggensturm,6 - 10 Jahre,285,156,129
False,8216033,Muggensturm,10 - 15 Jahre,379,184,195
False,8216033,Muggensturm,15 - 18 Jahre,182,106,76
False,8216033,Muggensturm,18 - 20 Jahre,140,76,64
False,8216033,Muggensturm,20 - 25 Jahre,296,150,146
False,8216033,Muggensturm,25 - 30 Jahre,308,175,133
False,8216033,Muggensturm,30 - 35 Jahre,513,257,256
False,8216033,Muggensturm,35 - 40 Jahre,587,281,306
False,8216033,Muggensturm,40 - 45 Jahre,529,269,260
False,8216033,Muggensturm,45 - 50 Jahre,473,245,228
False,8216033,Muggensturm,50 - 55 Jahre,379,200,179
False,8216033,Muggensturm,55 - 60 Jahre,338,193,145
False,8216033,Muggensturm,60 - 65 Jahre,391,188,203
False,8216033,Muggensturm,65 - 75 Jahre,552,263,289
False,8216033,Muggensturm,75 und mehr Jahre,340,98,242
False,8216033,Muggensturm,Insgesamt,6072,3026,3046
False,8216039,Ötigheim,unter 3 Jahre,139,64,75
False,8216039,Ötigheim,3 -  6 Jahre,148,90,58
False,8216039,Ötigheim,6 - 10 Jahre,217,117,100
False,8216039,Ötigheim,10 - 15 Jahre,254,126,128
False,8216039,Ötigheim,15 - 18 Jahre,149,80,69
False,8216039,Ötigheim,18 - 20 Jahre,98,53,45
False,8216039,Ötigheim,20 - 25 Jahre,219,117,102
False,8216039,Ötigheim,25 - 30 Jahre,251,122,129
False,8216039,Ötigheim,30 - 35 Jahre,372,178,194
False,8216039,Ötigheim,35 - 40 Jahre,363,177,186
False,8216039,Ötigheim,40 - 45 Jahre,373,187,186
False,8216039,Ötigheim,45 - 50 Jahre,339,161,178
False,8216039,Ötigheim,50 - 55 Jahre,296,153,143
False,8216039,Ötigheim,55 - 60 Jahre,240,125,115
False,8216039,Ötigheim,60 - 65 Jahre,284,136,148
False,8216039,Ötigheim,65 - 75 Jahre,392,183,209
False,8216039,Ötigheim,75 und mehr Jahre,269,106,163
False,8216039,Ötigheim,Insgesamt,4403,2175,2228
False,8216041,Ottersweier,unter 3 Jahre,187,94,93
False,8216041,Ottersweier,3 -  6 Jahre,243,120,123
False,8216041,Ottersweier,6 - 10 Jahre,313,149,164
False,8216041,Ottersweier,10 - 15 Jahre,424,229,195
False,8216041,Ottersweier,15 - 18 Jahre,192,87,105
False,8216041,Ottersweier,18 - 20 Jahre,118,57,61
False,8216041,Ottersweier,20 - 25 Jahre,291,146,145
False,8216041,Ottersweier,25 - 30 Jahre,327,183,144
False,8216041,Ottersweier,30 - 35 Jahre,504,251,253
False,8216041,Ottersweier,35 - 40 Jahre,564,284,280
False,8216041,Ottersweier,40 - 45 Jahre,525,265,260
False,8216041,Ottersweier,45 - 50 Jahre,443,244,199
False,8216041,Ottersweier,50 - 55 Jahre,383,189,194
False,8216041,Ottersweier,55 - 60 Jahre,339,195,144
False,8216041,Ottersweier,60 - 65 Jahre,415,221,194
False,8216041,Ottersweier,65 - 75 Jahre,639,295,344
False,8216041,Ottersweier,75 und mehr Jahre,439,143,296
False,8216041,Ottersweier,Insgesamt,6346,3152,3194
False,8216043,"Rastatt, Stadt",unter 3 Jahre,1125,603,522
False,8216043,"Rastatt, Stadt",3 -  6 Jahre,1215,622,593
False,8216043,"Rastatt, Stadt",6 - 10 Jahre,1891,981,910
False,8216043,"Rastatt, Stadt",10 - 15 Jahre,2667,1416,1251
False,8216043,"Rastatt, Stadt",15 - 18 Jahre,1670,821,849
False,8216043,"Rastatt, Stadt",18 - 20 Jahre,1087,525,562
False,8216043,"Rastatt, Stadt",20 - 25 Jahre,2550,1272,1278
False,8216043,"Rastatt, Stadt",25 - 30 Jahre,2476,1257,1219
False,8216043,"Rastatt, Stadt",30 - 35 Jahre,3098,1648,1450
False,8216043,"Rastatt, Stadt",35 - 40 Jahre,3614,1885,1729
False,8216043,"Rastatt, Stadt",40 - 45 Jahre,3738,1970,1768
False,8216043,"Rastatt, Stadt",45 - 50 Jahre,3352,1700,1652
False,8216043,"Rastatt, Stadt",50 - 55 Jahre,2623,1286,1337
False,8216043,"Rastatt, Stadt",55 - 60 Jahre,2518,1241,1277
False,8216043,"Rastatt, Stadt",60 - 65 Jahre,3376,1596,1780
False,8216043,"Rastatt, Stadt",65 - 75 Jahre,4953,2203,2750
False,8216043,"Rastatt, Stadt",75 und mehr Jahre,3702,1152,2550
False,8216043,"Rastatt, Stadt",Insgesamt,45655,22178,23477
False,8216049,Sinzheim,unter 3 Jahre,344,178,166
False,8216049,Sinzheim,3 -  6 Jahre,416,205,211
False,8216049,Sinzheim,6 - 10 Jahre,502,269,233
False,8216049,Sinzheim,10 - 15 Jahre,636,293,343
False,8216049,Sinzheim,15 - 18 Jahre,330,178,152
False,8216049,Sinzheim,18 - 20 Jahre,211,111,100
False,8216049,Sinzheim,20 - 25 Jahre,435,213,222
False,8216049,Sinzheim,25 - 30 Jahre,522,225,297
False,8216049,Sinzheim,30 - 35 Jahre,958,457,501
False,8216049,Sinzheim,35 - 40 Jahre,1074,542,532
False,8216049,Sinzheim,40 - 45 Jahre,923,444,479
False,8216049,Sinzheim,45 - 50 Jahre,810,414,396
False,8216049,Sinzheim,50 - 55 Jahre,659,342,317
False,8216049,Sinzheim,55 - 60 Jahre,570,305,265
False,8216049,Sinzheim,60 - 65 Jahre,681,332,349
False,8216049,Sinzheim,65 - 75 Jahre,890,407,483
False,8216049,Sinzheim,75 und mehr Jahre,714,207,507
False,8216049,Sinzheim,Insgesamt,10675,5122,5553
False,8216052,Steinmauern,unter 3 Jahre,85,37,48
False,8216052,Steinmauern,3 -  6 Jahre,95,52,43
False,8216052,Steinmauern,6 - 10 Jahre,158,87,71
False,8216052,Steinmauern,10 - 15 Jahre,190,98,92
False,8216052,Steinmauern,15 - 18 Jahre,97,49,48
False,8216052,Steinmauern,18 - 20 Jahre,52,31,21
False,8216052,Steinmauern,20 - 25 Jahre,145,66,79
False,8216052,Steinmauern,25 - 30 Jahre,128,66,62
False,8216052,Steinmauern,30 - 35 Jahre,199,100,99
False,8216052,Steinmauern,35 - 40 Jahre,261,124,137
False,8216052,Steinmauern,40 - 45 Jahre,248,132,116
False,8216052,Steinmauern,45 - 50 Jahre,204,107,97
False,8216052,Steinmauern,50 - 55 Jahre,160,81,79
False,8216052,Steinmauern,55 - 60 Jahre,139,70,69
False,8216052,Steinmauern,60 - 65 Jahre,175,87,88
False,8216052,Steinmauern,65 - 75 Jahre,249,112,137
False,8216052,Steinmauern,75 und mehr Jahre,166,63,103
False,8216052,Steinmauern,Insgesamt,2751,1362,1389
False,8216059,Weisenbach,unter 3 Jahre,96,49,47
False,8216059,Weisenbach,3 -  6 Jahre,99,57,42
False,8216059,Weisenbach,6 - 10 Jahre,128,67,61
False,8216059,Weisenbach,10 - 15 Jahre,150,80,70
False,8216059,Weisenbach,15 - 18 Jahre,84,44,40
False,8216059,Weisenbach,18 - 20 Jahre,51,27,24
False,8216059,Weisenbach,20 - 25 Jahre,134,63,71
False,8216059,Weisenbach,25 - 30 Jahre,130,71,59
False,8216059,Weisenbach,30 - 35 Jahre,210,86,124
False,8216059,Weisenbach,35 - 40 Jahre,245,135,110
False,8216059,Weisenbach,40 - 45 Jahre,218,129,89
False,8216059,Weisenbach,45 - 50 Jahre,173,75,98
False,8216059,Weisenbach,50 - 55 Jahre,141,83,58
False,8216059,Weisenbach,55 - 60 Jahre,110,52,58
False,8216059,Weisenbach,60 - 65 Jahre,202,88,114
False,8216059,Weisenbach,65 - 75 Jahre,286,141,145
False,8216059,Weisenbach,75 und mehr Jahre,178,58,120
False,8216059,Weisenbach,Insgesamt,2635,1305,1330
False,8216063,Rheinmünster,unter 3 Jahre,221,117,104
False,8216063,Rheinmünster,3 -  6 Jahre,267,134,133
False,8216063,Rheinmünster,6 - 10 Jahre,328,177,151
False,8216063,Rheinmünster,10 - 15 Jahre,425,219,206
False,8216063,Rheinmünster,15 - 18 Jahre,267,120,147
False,8216063,Rheinmünster,18 - 20 Jahre,150,75,75
False,8216063,Rheinmünster,20 - 25 Jahre,326,162,164
False,8216063,Rheinmünster,25 - 30 Jahre,358,183,175
False,8216063,Rheinmünster,30 - 35 Jahre,608,316,292
False,8216063,Rheinmünster,35 - 40 Jahre,630,331,299
False,8216063,Rheinmünster,40 - 45 Jahre,519,303,216
False,8216063,Rheinmünster,45 - 50 Jahre,498,265,233
False,8216063,Rheinmünster,50 - 55 Jahre,343,182,161
False,8216063,Rheinmünster,55 - 60 Jahre,305,161,144
False,8216063,Rheinmünster,60 - 65 Jahre,406,205,201
False,8216063,Rheinmünster,65 - 75 Jahre,504,234,270
False,8216063,Rheinmünster,75 und mehr Jahre,325,110,215
False,8216063,Rheinmünster,Insgesamt,6480,3294,3186
False,8221,Stadtkreis Heidelberg,unter 3 Jahre,3466,1809,1657
False,8221,Stadtkreis Heidelberg,3 -  6 Jahre,3454,1768,1686
False,8221,Stadtkreis Heidelberg,6 - 10 Jahre,4549,2311,2238
False,8221,Stadtkreis Heidelberg,10 - 15 Jahre,5725,2900,2825
False,8221,Stadtkreis Heidelberg,15 - 18 Jahre,3190,1594,1596
False,8221,Stadtkreis Heidelberg,18 - 20 Jahre,2742,1279,1463
False,8221,Stadtkreis Heidelberg,20 - 25 Jahre,12190,5057,7133
False,8221,Stadtkreis Heidelberg,25 - 30 Jahre,13093,6301,6792
False,8221,Stadtkreis Heidelberg,30 - 35 Jahre,14313,7203,7110
False,8221,Stadtkreis Heidelberg,35 - 40 Jahre,14048,7154,6894
False,8221,Stadtkreis Heidelberg,40 - 45 Jahre,10786,5495,5291
False,8221,Stadtkreis Heidelberg,45 - 50 Jahre,8957,4496,4461
False,8221,Stadtkreis Heidelberg,50 - 55 Jahre,7724,3870,3854
False,8221,Stadtkreis Heidelberg,55 - 60 Jahre,7306,3644,3662
False,8221,Stadtkreis Heidelberg,60 - 65 Jahre,7526,3661,3865
False,8221,Stadtkreis Heidelberg,65 - 75 Jahre,10617,4585,6032
False,8221,Stadtkreis Heidelberg,75 und mehr Jahre,10573,3028,7545
False,8221,Stadtkreis Heidelberg,Insgesamt,140259,66155,74104
False,8221000,"Heidelberg, Stadt",unter 3 Jahre,3466,1809,1657
False,8221000,"Heidelberg, Stadt",3 -  6 Jahre,3454,1768,1686
False,8221000,"Heidelberg, Stadt",6 - 10 Jahre,4549,2311,2238
False,8221000,"Heidelberg, Stadt",10 - 15 Jahre,5725,2900,2825
False,8221000,"Heidelberg, Stadt",15 - 18 Jahre,3190,1594,1596
False,8221000,"Heidelberg, Stadt",18 - 20 Jahre,2742,1279,1463
False,8221000,"Heidelberg, Stadt",20 - 25 Jahre,12190,5057,7133
False,8221000,"Heidelberg, Stadt",25 - 30 Jahre,13093,6301,6792
False,8221000,"Heidelberg, Stadt",30 - 35 Jahre,14313,7203,7110
False,8221000,"Heidelberg, Stadt",35 - 40 Jahre,14048,7154,6894
False,8221000,"Heidelberg, Stadt",40 - 45 Jahre,10786,5495,5291
False,8221000,"Heidelberg, Stadt",45 - 50 Jahre,8957,4496,4461
False,8221000,"Heidelberg, Stadt",50 - 55 Jahre,7724,3870,3854
False,8221000,"Heidelberg, Stadt",55 - 60 Jahre,7306,3644,3662
False,8221000,"Heidelberg, Stadt",60 - 65 Jahre,7526,3661,3865
False,8221000,"Heidelberg, Stadt",65 - 75 Jahre,10617,4585,6032
False,8221000,"Heidelberg, Stadt",75 und mehr Jahre,10573,3028,7545
False,8221000,"Heidelberg, Stadt",Insgesamt,140259,66155,74104
False,8222,Stadtkreis Mannheim,unter 3 Jahre,8488,4314,4174
False,8222,Stadtkreis Mannheim,3 -  6 Jahre,8410,4356,4054
False,8222,Stadtkreis Mannheim,6 - 10 Jahre,11148,5712,5436
False,8222,Stadtkreis Mannheim,10 - 15 Jahre,14287,7338,6949
False,8222,Stadtkreis Mannheim,15 - 18 Jahre,7984,4039,3945
False,8222,Stadtkreis Mannheim,18 - 20 Jahre,6038,3001,3037
False,8222,Stadtkreis Mannheim,20 - 25 Jahre,18547,9180,9367
False,8222,Stadtkreis Mannheim,25 - 30 Jahre,21378,10738,10640
False,8222,Stadtkreis Mannheim,30 - 35 Jahre,27056,14120,12936
False,8222,Stadtkreis Mannheim,35 - 40 Jahre,29175,15425,13750
False,8222,Stadtkreis Mannheim,40 - 45 Jahre,23832,12615,11217
False,8222,Stadtkreis Mannheim,45 - 50 Jahre,20113,10231,9882
False,8222,Stadtkreis Mannheim,50 - 55 Jahre,19455,9757,9698
False,8222,Stadtkreis Mannheim,55 - 60 Jahre,18370,9459,8911
False,8222,Stadtkreis Mannheim,60 - 65 Jahre,20378,10280,10098
False,8222,Stadtkreis Mannheim,65 - 75 Jahre,28703,13012,15691
False,8222,Stadtkreis Mannheim,75 und mehr Jahre,23367,7126,16241
False,8222,Stadtkreis Mannheim,Insgesamt,306729,150703,156026
False,8222000,"Mannheim, Universitätsstadt",unter 3 Jahre,8488,4314,4174
False,8222000,"Mannheim, Universitätsstadt",3 -  6 Jahre,8410,4356,4054
False,8222000,"Mannheim, Universitätsstadt",6 - 10 Jahre,11148,5712,5436
False,8222000,"Mannheim, Universitätsstadt",10 - 15 Jahre,14287,7338,6949
False,8222000,"Mannheim, Universitätsstadt",15 - 18 Jahre,7984,4039,3945
False,8222000,"Mannheim, Universitätsstadt",18 - 20 Jahre,6038,3001,3037
False,8222000,"Mannheim, Universitätsstadt",20 - 25 Jahre,18547,9180,9367
False,8222000,"Mannheim, Universitätsstadt",25 - 30 Jahre,21378,10738,10640
False,8222000,"Mannheim, Universitätsstadt",30 - 35 Jahre,27056,14120,12936
False,8222000,"Mannheim, Universitätsstadt",35 - 40 Jahre,29175,15425,13750
False,8222000,"Mannheim, Universitätsstadt",40 - 45 Jahre,23832,12615,11217
False,8222000,"Mannheim, Universitätsstadt",45 - 50 Jahre,20113,10231,9882
False,8222000,"Mannheim, Universitätsstadt",50 - 55 Jahre,19455,9757,9698
False,8222000,"Mannheim, Universitätsstadt",55 - 60 Jahre,18370,9459,8911
False,8222000,"Mannheim, Universitätsstadt",60 - 65 Jahre,20378,10280,10098
False,8222000,"Mannheim, Universitätsstadt",65 - 75 Jahre,28703,13012,15691
False,8222000,"Mannheim, Universitätsstadt",75 und mehr Jahre,23367,7126,16241
False,8222000,"Mannheim, Universitätsstadt",Insgesamt,306729,150703,156026
False,8225,Landkreis Neckar-Odenwald-Kreis,unter 3 Jahre,4457,2345,2112
False,8225,Landkreis Neckar-Odenwald-Kreis,3 -  6 Jahre,4919,2582,2337
False,8225,Landkreis Neckar-Odenwald-Kreis,6 - 10 Jahre,7057,3599,3458
False,8225,Landkreis Neckar-Odenwald-Kreis,10 - 15 Jahre,9527,4860,4667
False,8225,Landkreis Neckar-Odenwald-Kreis,15 - 18 Jahre,5491,2843,2648
False,8225,Landkreis Neckar-Odenwald-Kreis,18 - 20 Jahre,3588,1794,1794
False,8225,Landkreis Neckar-Odenwald-Kreis,20 - 25 Jahre,8230,4360,3870
False,8225,Landkreis Neckar-Odenwald-Kreis,25 - 30 Jahre,8672,4440,4232
False,8225,Landkreis Neckar-Odenwald-Kreis,30 - 35 Jahre,12055,6514,5541
False,8225,Landkreis Neckar-Odenwald-Kreis,35 - 40 Jahre,13277,6954,6323
False,8225,Landkreis Neckar-Odenwald-Kreis,40 - 45 Jahre,11894,6078,5816
False,8225,Landkreis Neckar-Odenwald-Kreis,45 - 50 Jahre,10147,5188,4959
False,8225,Landkreis Neckar-Odenwald-Kreis,50 - 55 Jahre,8788,4513,4275
False,8225,Landkreis Neckar-Odenwald-Kreis,55 - 60 Jahre,7538,3834,3704
False,8225,Landkreis Neckar-Odenwald-Kreis,60 - 65 Jahre,9625,4853,4772
False,8225,Landkreis Neckar-Odenwald-Kreis,65 - 75 Jahre,13569,6285,7284
False,8225,Landkreis Neckar-Odenwald-Kreis,75 und mehr Jahre,10590,3265,7325
False,8225,Landkreis Neckar-Odenwald-Kreis,Insgesamt,149424,74307,75117
False,8225001,"Adelsheim, Stadt",unter 3 Jahre,159,91,68
False,8225001,"Adelsheim, Stadt",3 -  6 Jahre,142,74,68
False,8225001,"Adelsheim, Stadt",6 - 10 Jahre,228,121,107
False,8225001,"Adelsheim, Stadt",10 - 15 Jahre,294,143,151
False,8225001,"Adelsheim, Stadt",15 - 18 Jahre,196,106,90
False,8225001,"Adelsheim, Stadt",18 - 20 Jahre,113,44,69
False,8225001,"Adelsheim, Stadt",20 - 25 Jahre,248,122,126
False,8225001,"Adelsheim, Stadt",25 - 30 Jahre,338,176,162
False,8225001,"Adelsheim, Stadt",30 - 35 Jahre,712,511,201
False,8225001,"Adelsheim, Stadt",35 - 40 Jahre,463,236,227
False,8225001,"Adelsheim, Stadt",40 - 45 Jahre,396,229,167
False,8225001,"Adelsheim, Stadt",45 - 50 Jahre,327,173,154
False,8225001,"Adelsheim, Stadt",50 - 55 Jahre,301,153,148
False,8225001,"Adelsheim, Stadt",55 - 60 Jahre,256,131,125
False,8225001,"Adelsheim, Stadt",60 - 65 Jahre,372,179,193
False,8225001,"Adelsheim, Stadt",65 - 75 Jahre,501,226,275
False,8225001,"Adelsheim, Stadt",75 und mehr Jahre,379,122,257
False,8225001,"Adelsheim, Stadt",Insgesamt,5425,2837,2588
False,8225002,Aglasterhausen,unter 3 Jahre,163,81,82
False,8225002,Aglasterhausen,3 -  6 Jahre,139,65,74
False,8225002,Aglasterhausen,6 - 10 Jahre,231,124,107
False,8225002,Aglasterhausen,10 - 15 Jahre,288,153,135
False,8225002,Aglasterhausen,15 - 18 Jahre,160,77,83
False,8225002,Aglasterhausen,18 - 20 Jahre,116,58,58
False,8225002,Aglasterhausen,20 - 25 Jahre,276,143,133
False,8225002,Aglasterhausen,25 - 30 Jahre,276,140,136
False,8225002,Aglasterhausen,30 - 35 Jahre,366,196,170
False,8225002,Aglasterhausen,35 - 40 Jahre,386,195,191
False,8225002,Aglasterhausen,40 - 45 Jahre,400,208,192
False,8225002,Aglasterhausen,45 - 50 Jahre,315,142,173
False,8225002,Aglasterhausen,50 - 55 Jahre,281,149,132
False,8225002,Aglasterhausen,55 - 60 Jahre,205,106,99
False,8225002,Aglasterhausen,60 - 65 Jahre,295,142,153
False,8225002,Aglasterhausen,65 - 75 Jahre,427,209,218
False,8225002,Aglasterhausen,75 und mehr Jahre,360,104,256
False,8225002,Aglasterhausen,Insgesamt,4684,2292,2392
False,8225009,Billigheim,unter 3 Jahre,197,120,77
False,8225009,Billigheim,3 -  6 Jahre,212,106,106
False,8225009,Billigheim,6 - 10 Jahre,295,150,145
False,8225009,Billigheim,10 - 15 Jahre,406,208,198
False,8225009,Billigheim,15 - 18 Jahre,216,119,97
False,8225009,Billigheim,18 - 20 Jahre,126,58,68
False,8225009,Billigheim,20 - 25 Jahre,297,160,137
False,8225009,Billigheim,25 - 30 Jahre,344,174,170
False,8225009,Billigheim,30 - 35 Jahre,491,257,234
False,8225009,Billigheim,35 - 40 Jahre,519,263,256
False,8225009,Billigheim,40 - 45 Jahre,504,275,229
False,8225009,Billigheim,45 - 50 Jahre,388,204,184
False,8225009,Billigheim,50 - 55 Jahre,334,166,168
False,8225009,Billigheim,55 - 60 Jahre,303,164,139
False,8225009,Billigheim,60 - 65 Jahre,376,196,180
False,8225009,Billigheim,65 - 75 Jahre,508,242,266
False,8225009,Billigheim,75 und mehr Jahre,337,98,239
False,8225009,Billigheim,Insgesamt,5853,2960,2893
False,8225010,Binau,unter 3 Jahre,32,21,11
False,8225010,Binau,3 -  6 Jahre,38,25,13
False,8225010,Binau,6 - 10 Jahre,55,28,27
False,8225010,Binau,10 - 15 Jahre,78,36,42
False,8225010,Binau,15 - 18 Jahre,45,22,23
False,8225010,Binau,18 - 20 Jahre,13,8,5
False,8225010,Binau,20 - 25 Jahre,72,39,33
False,8225010,Binau,25 - 30 Jahre,83,40,43
False,8225010,Binau,30 - 35 Jahre,112,59,53
False,8225010,Binau,35 - 40 Jahre,114,57,57
False,8225010,Binau,40 - 45 Jahre,97,43,54
False,8225010,Binau,45 - 50 Jahre,97,49,48
False,8225010,Binau,50 - 55 Jahre,106,53,53
False,8225010,Binau,55 - 60 Jahre,93,48,45
False,8225010,Binau,60 - 65 Jahre,100,56,44
False,8225010,Binau,65 - 75 Jahre,112,66,46
False,8225010,Binau,75 und mehr Jahre,90,31,59
False,8225010,Binau,Insgesamt,1337,681,656
False,8225014,"Buchen (Odenwald), Stadt",unter 3 Jahre,590,303,287
False,8225014,"Buchen (Odenwald), Stadt",3 -  6 Jahre,629,328,301
False,8225014,"Buchen (Odenwald), Stadt",6 - 10 Jahre,899,474,425
False,8225014,"Buchen (Odenwald), Stadt",10 - 15 Jahre,1248,660,588
False,8225014,"Buchen (Odenwald), Stadt",15 - 18 Jahre,747,382,365
False,8225014,"Buchen (Odenwald), Stadt",18 - 20 Jahre,483,230,253
False,8225014,"Buchen (Odenwald), Stadt",20 - 25 Jahre,1072,551,521
False,8225014,"Buchen (Odenwald), Stadt",25 - 30 Jahre,1026,528,498
False,8225014,"Buchen (Odenwald), Stadt",30 - 35 Jahre,1332,714,618
False,8225014,"Buchen (Odenwald), Stadt",35 - 40 Jahre,1558,785,773
False,8225014,"Buchen (Odenwald), Stadt",40 - 45 Jahre,1447,732,715
False,8225014,"Buchen (Odenwald), Stadt",45 - 50 Jahre,1253,630,623
False,8225014,"Buchen (Odenwald), Stadt",50 - 55 Jahre,1100,572,528
False,8225014,"Buchen (Odenwald), Stadt",55 - 60 Jahre,904,457,447
False,8225014,"Buchen (Odenwald), Stadt",60 - 65 Jahre,1218,628,590
False,8225014,"Buchen (Odenwald), Stadt",65 - 75 Jahre,1688,788,900
False,8225014,"Buchen (Odenwald), Stadt",75 und mehr Jahre,1387,424,963
False,8225014,"Buchen (Odenwald), Stadt",Insgesamt,18581,9186,9395
False,8225024,Fahrenbach,unter 3 Jahre,72,32,40
False,8225024,Fahrenbach,3 -  6 Jahre,99,51,48
False,8225024,Fahrenbach,6 - 10 Jahre,121,56,65
False,8225024,Fahrenbach,10 - 15 Jahre,208,102,106
False,8225024,Fahrenbach,15 - 18 Jahre,109,53,56
False,8225024,Fahrenbach,18 - 20 Jahre,60,27,33
False,8225024,Fahrenbach,20 - 25 Jahre,174,87,87
False,8225024,Fahrenbach,25 - 30 Jahre,165,78,87
False,8225024,Fahrenbach,30 - 35 Jahre,232,111,121
False,8225024,Fahrenbach,35 - 40 Jahre,259,134,125
False,8225024,Fahrenbach,40 - 45 Jahre,226,122,104
False,8225024,Fahrenbach,45 - 50 Jahre,187,108,79
False,8225024,Fahrenbach,50 - 55 Jahre,162,78,84
False,8225024,Fahrenbach,55 - 60 Jahre,142,72,70
False,8225024,Fahrenbach,60 - 65 Jahre,181,92,89
False,8225024,Fahrenbach,65 - 75 Jahre,267,132,135
False,8225024,Fahrenbach,75 und mehr Jahre,217,53,164
False,8225024,Fahrenbach,Insgesamt,2881,1388,1493
False,8225032,Hardheim,unter 3 Jahre,197,109,88
False,8225032,Hardheim,3 -  6 Jahre,220,119,101
False,8225032,Hardheim,6 - 10 Jahre,366,181,185
False,8225032,Hardheim,10 - 15 Jahre,523,274,249
False,8225032,Hardheim,15 - 18 Jahre,281,140,141
False,8225032,Hardheim,18 - 20 Jahre,166,99,67
False,8225032,Hardheim,20 - 25 Jahre,421,235,186
False,8225032,Hardheim,25 - 30 Jahre,424,223,201
False,8225032,Hardheim,30 - 35 Jahre,618,331,287
False,8225032,Hardheim,35 - 40 Jahre,680,371,309
False,8225032,Hardheim,40 - 45 Jahre,611,313,298
False,8225032,Hardheim,45 - 50 Jahre,508,259,249
False,8225032,Hardheim,50 - 55 Jahre,405,212,193
False,8225032,Hardheim,55 - 60 Jahre,329,161,168
False,8225032,Hardheim,60 - 65 Jahre,459,228,231
False,8225032,Hardheim,65 - 75 Jahre,701,316,385
False,8225032,Hardheim,75 und mehr Jahre,527,171,356
False,8225032,Hardheim,Insgesamt,7436,3742,3694
False,8225033,Haßmersheim,unter 3 Jahre,164,78,86
False,8225033,Haßmersheim,3 -  6 Jahre,186,87,99
False,8225033,Haßmersheim,6 - 10 Jahre,232,118,114
False,8225033,Haßmersheim,10 - 15 Jahre,323,181,142
False,8225033,Haßmersheim,15 - 18 Jahre,192,104,88
False,8225033,Haßmersheim,18 - 20 Jahre,111,59,52
False,8225033,Haßmersheim,20 - 25 Jahre,269,140,129
False,8225033,Haßmersheim,25 - 30 Jahre,266,133,133
False,8225033,Haßmersheim,30 - 35 Jahre,399,202,197
False,8225033,Haßmersheim,35 - 40 Jahre,403,222,181
False,8225033,Haßmersheim,40 - 45 Jahre,414,202,212
False,8225033,Haßmersheim,45 - 50 Jahre,316,166,150
False,8225033,Haßmersheim,50 - 55 Jahre,252,127,125
False,8225033,Haßmersheim,55 - 60 Jahre,286,143,143
False,8225033,Haßmersheim,60 - 65 Jahre,310,158,152
False,8225033,Haßmersheim,65 - 75 Jahre,432,202,230
False,8225033,Haßmersheim,75 und mehr Jahre,297,92,205
False,8225033,Haßmersheim,Insgesamt,4852,2414,2438
False,8225039,Höpfingen,unter 3 Jahre,104,52,52
False,8225039,Höpfingen,3 -  6 Jahre,120,61,59
False,8225039,Höpfingen,6 - 10 Jahre,170,83,87
False,8225039,Höpfingen,10 - 15 Jahre,217,115,102
False,8225039,Höpfingen,15 - 18 Jahre,119,59,60
False,8225039,Höpfingen,18 - 20 Jahre,68,27,41
False,8225039,Höpfingen,20 - 25 Jahre,165,87,78
False,8225039,Höpfingen,25 - 30 Jahre,189,101,88
False,8225039,Höpfingen,30 - 35 Jahre,262,134,128
False,8225039,Höpfingen,35 - 40 Jahre,297,161,136
False,8225039,Höpfingen,40 - 45 Jahre,282,150,132
False,8225039,Höpfingen,45 - 50 Jahre,199,105,94
False,8225039,Höpfingen,50 - 55 Jahre,183,94,89
False,8225039,Höpfingen,55 - 60 Jahre,131,69,62
False,8225039,Höpfingen,60 - 65 Jahre,221,109,112
False,8225039,Höpfingen,65 - 75 Jahre,334,152,182
False,8225039,Höpfingen,75 und mehr Jahre,166,56,110
False,8225039,Höpfingen,Insgesamt,3227,1615,1612
False,8225042,Hüffenhardt,unter 3 Jahre,64,35,29
False,8225042,Hüffenhardt,3 -  6 Jahre,51,27,24
False,8225042,Hüffenhardt,6 - 10 Jahre,107,53,54
False,8225042,Hüffenhardt,10 - 15 Jahre,156,75,81
False,8225042,Hüffenhardt,15 - 18 Jahre,64,27,37
False,8225042,Hüffenhardt,18 - 20 Jahre,42,25,17
False,8225042,Hüffenhardt,20 - 25 Jahre,100,53,47
False,8225042,Hüffenhardt,25 - 30 Jahre,112,52,60
False,8225042,Hüffenhardt,30 - 35 Jahre,163,76,87
False,8225042,Hüffenhardt,35 - 40 Jahre,194,111,83
False,8225042,Hüffenhardt,40 - 45 Jahre,167,85,82
False,8225042,Hüffenhardt,45 - 50 Jahre,146,65,81
False,8225042,Hüffenhardt,50 - 55 Jahre,108,62,46
False,8225042,Hüffenhardt,55 - 60 Jahre,100,50,50
False,8225042,Hüffenhardt,60 - 65 Jahre,124,51,73
False,8225042,Hüffenhardt,65 - 75 Jahre,207,97,110
False,8225042,Hüffenhardt,75 und mehr Jahre,200,59,141
False,8225042,Hüffenhardt,Insgesamt,2105,1003,1102
False,8225052,Limbach,unter 3 Jahre,126,64,62
False,8225052,Limbach,3 -  6 Jahre,175,99,76
False,8225052,Limbach,6 - 10 Jahre,242,118,124
False,8225052,Limbach,10 - 15 Jahre,327,164,163
False,8225052,Limbach,15 - 18 Jahre,160,76,84
False,8225052,Limbach,18 - 20 Jahre,136,70,66
False,8225052,Limbach,20 - 25 Jahre,240,127,113
False,8225052,Limbach,25 - 30 Jahre,238,141,97
False,8225052,Limbach,30 - 35 Jahre,353,194,159
False,8225052,Limbach,35 - 40 Jahre,442,215,227
False,8225052,Limbach,40 - 45 Jahre,393,202,191
False,8225052,Limbach,45 - 50 Jahre,342,190,152
False,8225052,Limbach,50 - 55 Jahre,242,136,106
False,8225052,Limbach,55 - 60 Jahre,196,95,101
False,8225052,Limbach,60 - 65 Jahre,283,154,129
False,8225052,Limbach,65 - 75 Jahre,466,209,257
False,8225052,Limbach,75 und mehr Jahre,367,124,243
False,8225052,Limbach,Insgesamt,4728,2378,2350
False,8225058,"Mosbach, Stadt",unter 3 Jahre,729,376,353
False,8225058,"Mosbach, Stadt",3 -  6 Jahre,781,433,348
False,8225058,"Mosbach, Stadt",6 - 10 Jahre,1025,530,495
False,8225058,"Mosbach, Stadt",10 - 15 Jahre,1425,699,726
False,8225058,"Mosbach, Stadt",15 - 18 Jahre,863,467,396
False,8225058,"Mosbach, Stadt",18 - 20 Jahre,664,339,325
False,8225058,"Mosbach, Stadt",20 - 25 Jahre,1487,796,691
False,8225058,"Mosbach, Stadt",25 - 30 Jahre,1554,782,772
False,8225058,"Mosbach, Stadt",30 - 35 Jahre,1990,1075,915
False,8225058,"Mosbach, Stadt",35 - 40 Jahre,2138,1120,1018
False,8225058,"Mosbach, Stadt",40 - 45 Jahre,1867,912,955
False,8225058,"Mosbach, Stadt",45 - 50 Jahre,1707,821,886
False,8225058,"Mosbach, Stadt",50 - 55 Jahre,1612,787,825
False,8225058,"Mosbach, Stadt",55 - 60 Jahre,1477,754,723
False,8225058,"Mosbach, Stadt",60 - 65 Jahre,1612,790,822
False,8225058,"Mosbach, Stadt",65 - 75 Jahre,2217,1010,1207
False,8225058,"Mosbach, Stadt",75 und mehr Jahre,1897,566,1331
False,8225058,"Mosbach, Stadt",Insgesamt,25045,12257,12788
False,8225060,Mudau,unter 3 Jahre,142,77,65
False,8225060,Mudau,3 -  6 Jahre,172,95,77
False,8225060,Mudau,6 - 10 Jahre,263,128,135
False,8225060,Mudau,10 - 15 Jahre,350,176,174
False,8225060,Mudau,15 - 18 Jahre,202,112,90
False,8225060,Mudau,18 - 20 Jahre,127,69,58
False,8225060,Mudau,20 - 25 Jahre,260,138,122
False,8225060,Mudau,25 - 30 Jahre,275,149,126
False,8225060,Mudau,30 - 35 Jahre,383,197,186
False,8225060,Mudau,35 - 40 Jahre,486,260,226
False,8225060,Mudau,40 - 45 Jahre,455,232,223
False,8225060,Mudau,45 - 50 Jahre,380,221,159
False,8225060,Mudau,50 - 55 Jahre,261,147,114
False,8225060,Mudau,55 - 60 Jahre,198,97,101
False,8225060,Mudau,60 - 65 Jahre,298,154,144
False,8225060,Mudau,65 - 75 Jahre,481,212,269
False,8225060,Mudau,75 und mehr Jahre,347,108,239
False,8225060,Mudau,Insgesamt,5080,2572,2508
False,8225064,Neckargerach,unter 3 Jahre,79,43,36
False,8225064,Neckargerach,3 -  6 Jahre,90,39,51
False,8225064,Neckargerach,6 - 10 Jahre,124,63,61
False,8225064,Neckargerach,10 - 15 Jahre,166,78,88
False,8225064,Neckargerach,15 - 18 Jahre,70,32,38
False,8225064,Neckargerach,18 - 20 Jahre,49,20,29
False,8225064,Neckargerach,20 - 25 Jahre,124,73,51
False,8225064,Neckargerach,25 - 30 Jahre,131,70,61
False,8225064,Neckargerach,30 - 35 Jahre,189,102,87
False,8225064,Neckargerach,35 - 40 Jahre,215,114,101
False,8225064,Neckargerach,40 - 45 Jahre,168,101,67
False,8225064,Neckargerach,45 - 50 Jahre,168,76,92
False,8225064,Neckargerach,50 - 55 Jahre,135,66,69
False,8225064,Neckargerach,55 - 60 Jahre,133,64,69
False,8225064,Neckargerach,60 - 65 Jahre,173,97,76
False,8225064,Neckargerach,65 - 75 Jahre,217,98,119
False,8225064,Neckargerach,75 und mehr Jahre,174,49,125
False,8225064,Neckargerach,Insgesamt,2405,1185,1220
False,8225067,Neckarzimmern,unter 3 Jahre,49,31,18
False,8225067,Neckarzimmern,3 -  6 Jahre,63,29,34
False,8225067,Neckarzimmern,6 - 10 Jahre,78,42,36
False,8225067,Neckarzimmern,10 - 15 Jahre,92,45,47
False,8225067,Neckarzimmern,15 - 18 Jahre,45,19,26
False,8225067,Neckarzimmern,18 - 20 Jahre,35,19,16
False,8225067,Neckarzimmern,20 - 25 Jahre,94,50,44
False,8225067,Neckarzimmern,25 - 30 Jahre,103,47,56
False,8225067,Neckarzimmern,30 - 35 Jahre,140,69,71
False,8225067,Neckarzimmern,35 - 40 Jahre,117,56,61
False,8225067,Neckarzimmern,40 - 45 Jahre,116,56,60
False,8225067,Neckarzimmern,45 - 50 Jahre,114,61,53
False,8225067,Neckarzimmern,50 - 55 Jahre,114,51,63
False,8225067,Neckarzimmern,55 - 60 Jahre,98,57,41
False,8225067,Neckarzimmern,60 - 65 Jahre,99,53,46
False,8225067,Neckarzimmern,65 - 75 Jahre,89,42,47
False,8225067,Neckarzimmern,75 und mehr Jahre,98,29,69
False,8225067,Neckarzimmern,Insgesamt,1544,756,788
False,8225068,Neunkirchen,unter 3 Jahre,71,38,33
False,8225068,Neunkirchen,3 -  6 Jahre,76,46,30
False,8225068,Neunkirchen,6 - 10 Jahre,112,55,57
False,8225068,Neunkirchen,10 - 15 Jahre,94,46,48
False,8225068,Neunkirchen,15 - 18 Jahre,68,34,34
False,8225068,Neunkirchen,18 - 20 Jahre,51,26,25
False,8225068,Neunkirchen,20 - 25 Jahre,76,37,39
False,8225068,Neunkirchen,25 - 30 Jahre,94,55,39
False,8225068,Neunkirchen,30 - 35 Jahre,115,62,53
False,8225068,Neunkirchen,35 - 40 Jahre,209,108,101
False,8225068,Neunkirchen,40 - 45 Jahre,141,77,64
False,8225068,Neunkirchen,45 - 50 Jahre,119,64,55
False,8225068,Neunkirchen,50 - 55 Jahre,87,46,41
False,8225068,Neunkirchen,55 - 60 Jahre,78,38,40
False,8225068,Neunkirchen,60 - 65 Jahre,105,50,55
False,8225068,Neunkirchen,65 - 75 Jahre,172,82,90
False,8225068,Neunkirchen,75 und mehr Jahre,96,30,66
False,8225068,Neunkirchen,Insgesamt,1764,894,870
False,8225074,Obrigheim,unter 3 Jahre,147,82,65
False,8225074,Obrigheim,3 -  6 Jahre,157,78,79
False,8225074,Obrigheim,6 - 10 Jahre,257,115,142
False,8225074,Obrigheim,10 - 15 Jahre,346,155,191
False,8225074,Obrigheim,15 - 18 Jahre,181,88,93
False,8225074,Obrigheim,18 - 20 Jahre,125,64,61
False,8225074,Obrigheim,20 - 25 Jahre,296,142,154
False,8225074,Obrigheim,25 - 30 Jahre,312,165,147
False,8225074,Obrigheim,30 - 35 Jahre,417,236,181
False,8225074,Obrigheim,35 - 40 Jahre,427,236,191
False,8225074,Obrigheim,40 - 45 Jahre,399,198,201
False,8225074,Obrigheim,45 - 50 Jahre,369,190,179
False,8225074,Obrigheim,50 - 55 Jahre,342,161,181
False,8225074,Obrigheim,55 - 60 Jahre,348,172,176
False,8225074,Obrigheim,60 - 65 Jahre,374,190,184
False,8225074,Obrigheim,65 - 75 Jahre,521,237,284
False,8225074,Obrigheim,75 und mehr Jahre,328,123,205
False,8225074,Obrigheim,Insgesamt,5346,2632,2714
False,8225075,"Osterburken, Stadt",unter 3 Jahre,193,101,92
False,8225075,"Osterburken, Stadt",3 -  6 Jahre,177,89,88
False,8225075,"Osterburken, Stadt",6 - 10 Jahre,287,161,126
False,8225075,"Osterburken, Stadt",10 - 15 Jahre,372,190,182
False,8225075,"Osterburken, Stadt",15 - 18 Jahre,245,133,112
False,8225075,"Osterburken, Stadt",18 - 20 Jahre,166,80,86
False,8225075,"Osterburken, Stadt",20 - 25 Jahre,409,223,186
False,8225075,"Osterburken, Stadt",25 - 30 Jahre,417,215,202
False,8225075,"Osterburken, Stadt",30 - 35 Jahre,461,238,223
False,8225075,"Osterburken, Stadt",35 - 40 Jahre,538,280,258
False,8225075,"Osterburken, Stadt",40 - 45 Jahre,460,244,216
False,8225075,"Osterburken, Stadt",45 - 50 Jahre,448,230,218
False,8225075,"Osterburken, Stadt",50 - 55 Jahre,358,186,172
False,8225075,"Osterburken, Stadt",55 - 60 Jahre,287,146,141
False,8225075,"Osterburken, Stadt",60 - 65 Jahre,387,189,198
False,8225075,"Osterburken, Stadt",65 - 75 Jahre,592,272,320
False,8225075,"Osterburken, Stadt",75 und mehr Jahre,543,155,388
False,8225075,"Osterburken, Stadt",Insgesamt,6340,3132,3208
False,8225082,Rosenberg,unter 3 Jahre,54,20,34
False,8225082,Rosenberg,3 -  6 Jahre,70,35,35
False,8225082,Rosenberg,6 - 10 Jahre,106,55,51
False,8225082,Rosenberg,10 - 15 Jahre,135,63,72
False,8225082,Rosenberg,15 - 18 Jahre,82,36,46
False,8225082,Rosenberg,18 - 20 Jahre,47,28,19
False,8225082,Rosenberg,20 - 25 Jahre,104,61,43
False,8225082,Rosenberg,25 - 30 Jahre,132,67,65
False,8225082,Rosenberg,30 - 35 Jahre,168,89,79
False,8225082,Rosenberg,35 - 40 Jahre,208,113,95
False,8225082,Rosenberg,40 - 45 Jahre,151,73,78
False,8225082,Rosenberg,45 - 50 Jahre,154,68,86
False,8225082,Rosenberg,50 - 55 Jahre,134,72,62
False,8225082,Rosenberg,55 - 60 Jahre,97,52,45
False,8225082,Rosenberg,60 - 65 Jahre,162,81,81
False,8225082,Rosenberg,65 - 75 Jahre,227,117,110
False,8225082,Rosenberg,75 und mehr Jahre,168,53,115
False,8225082,Rosenberg,Insgesamt,2199,1083,1116
False,8225091,Seckach,unter 3 Jahre,154,81,73
False,8225091,Seckach,3 -  6 Jahre,145,73,72
False,8225091,Seckach,6 - 10 Jahre,232,115,117
False,8225091,Seckach,10 - 15 Jahre,360,200,160
False,8225091,Seckach,15 - 18 Jahre,215,123,92
False,8225091,Seckach,18 - 20 Jahre,112,53,59
False,8225091,Seckach,20 - 25 Jahre,246,140,106
False,8225091,Seckach,25 - 30 Jahre,226,121,105
False,8225091,Seckach,30 - 35 Jahre,336,165,171
False,8225091,Seckach,35 - 40 Jahre,408,214,194
False,8225091,Seckach,40 - 45 Jahre,354,181,173
False,8225091,Seckach,45 - 50 Jahre,314,156,158
False,8225091,Seckach,50 - 55 Jahre,230,123,107
False,8225091,Seckach,55 - 60 Jahre,177,86,91
False,8225091,Seckach,60 - 65 Jahre,254,127,127
False,8225091,Seckach,65 - 75 Jahre,358,162,196
False,8225091,Seckach,75 und mehr Jahre,274,85,189
False,8225091,Seckach,Insgesamt,4395,2205,2190
False,8225109,"Walldürn, Stadt",unter 3 Jahre,342,181,161
False,8225109,"Walldürn, Stadt",3 -  6 Jahre,412,210,202
False,8225109,"Walldürn, Stadt",6 - 10 Jahre,565,294,271
False,8225109,"Walldürn, Stadt",10 - 15 Jahre,709,374,335
False,8225109,"Walldürn, Stadt",15 - 18 Jahre,448,229,219
False,8225109,"Walldürn, Stadt",18 - 20 Jahre,261,135,126
False,8225109,"Walldürn, Stadt",20 - 25 Jahre,670,356,314
False,8225109,"Walldürn, Stadt",25 - 30 Jahre,678,335,343
False,8225109,"Walldürn, Stadt",30 - 35 Jahre,971,518,453
False,8225109,"Walldürn, Stadt",35 - 40 Jahre,1051,559,492
False,8225109,"Walldürn, Stadt",40 - 45 Jahre,952,476,476
False,8225109,"Walldürn, Stadt",45 - 50 Jahre,780,402,378
False,8225109,"Walldürn, Stadt",50 - 55 Jahre,703,366,337
False,8225109,"Walldürn, Stadt",55 - 60 Jahre,618,320,298
False,8225109,"Walldürn, Stadt",60 - 65 Jahre,857,434,423
False,8225109,"Walldürn, Stadt",65 - 75 Jahre,1055,469,586
False,8225109,"Walldürn, Stadt",75 und mehr Jahre,878,257,621
False,8225109,"Walldürn, Stadt",Insgesamt,11950,5915,6035
False,8225113,Zwingenberg,unter 3 Jahre,20,11,9
False,8225113,Zwingenberg,3 -  6 Jahre,23,13,10
False,8225113,Zwingenberg,6 - 10 Jahre,32,13,19
False,8225113,Zwingenberg,10 - 15 Jahre,42,17,25
False,8225113,Zwingenberg,15 - 18 Jahre,37,17,20
False,8225113,Zwingenberg,18 - 20 Jahre,24,10,14
False,8225113,Zwingenberg,20 - 25 Jahre,45,22,23
False,8225113,Zwingenberg,25 - 30 Jahre,34,19,15
False,8225113,Zwingenberg,30 - 35 Jahre,36,27,9
False,8225113,Zwingenberg,35 - 40 Jahre,38,14,24
False,8225113,Zwingenberg,40 - 45 Jahre,74,36,38
False,8225113,Zwingenberg,45 - 50 Jahre,38,18,20
False,8225113,Zwingenberg,50 - 55 Jahre,49,28,21
False,8225113,Zwingenberg,55 - 60 Jahre,42,16,26
False,8225113,Zwingenberg,60 - 65 Jahre,30,17,13
False,8225113,Zwingenberg,65 - 75 Jahre,81,40,41
False,8225113,Zwingenberg,75 und mehr Jahre,56,20,36
False,8225113,Zwingenberg,Insgesamt,701,338,363
False,8225114,"Ravenstein, Stadt",unter 3 Jahre,103,62,41
False,8225114,"Ravenstein, Stadt",3 -  6 Jahre,95,53,42
False,8225114,"Ravenstein, Stadt",6 - 10 Jahre,147,78,69
False,8225114,"Ravenstein, Stadt",10 - 15 Jahre,227,125,102
False,8225114,"Ravenstein, Stadt",15 - 18 Jahre,117,59,58
False,8225114,"Ravenstein, Stadt",18 - 20 Jahre,74,38,36
False,8225114,"Ravenstein, Stadt",20 - 25 Jahre,161,96,65
False,8225114,"Ravenstein, Stadt",25 - 30 Jahre,196,92,104
False,8225114,"Ravenstein, Stadt",30 - 35 Jahre,260,139,121
False,8225114,"Ravenstein, Stadt",35 - 40 Jahre,263,146,117
False,8225114,"Ravenstein, Stadt",40 - 45 Jahre,244,118,126
False,8225114,"Ravenstein, Stadt",45 - 50 Jahre,189,105,84
False,8225114,"Ravenstein, Stadt",50 - 55 Jahre,155,82,73
False,8225114,"Ravenstein, Stadt",55 - 60 Jahre,133,64,69
False,8225114,"Ravenstein, Stadt",60 - 65 Jahre,184,99,85
False,8225114,"Ravenstein, Stadt",65 - 75 Jahre,305,141,164
False,8225114,"Ravenstein, Stadt",75 und mehr Jahre,208,66,142
False,8225114,"Ravenstein, Stadt",Insgesamt,3061,1563,1498
False,8225115,Schefflenz,unter 3 Jahre,136,72,64
False,8225115,Schefflenz,3 -  6 Jahre,142,75,67
False,8225115,Schefflenz,6 - 10 Jahre,215,99,116
False,8225115,Schefflenz,10 - 15 Jahre,314,148,166
False,8225115,Schefflenz,15 - 18 Jahre,160,85,75
False,8225115,Schefflenz,18 - 20 Jahre,96,48,48
False,8225115,Schefflenz,20 - 25 Jahre,221,113,108
False,8225115,Schefflenz,25 - 30 Jahre,255,136,119
False,8225115,Schefflenz,30 - 35 Jahre,307,156,151
False,8225115,Schefflenz,35 - 40 Jahre,389,186,203
False,8225115,Schefflenz,40 - 45 Jahre,354,189,165
False,8225115,Schefflenz,45 - 50 Jahre,308,153,155
False,8225115,Schefflenz,50 - 55 Jahre,282,148,134
False,8225115,Schefflenz,55 - 60 Jahre,221,113,108
False,8225115,Schefflenz,60 - 65 Jahre,276,142,134
False,8225115,Schefflenz,65 - 75 Jahre,384,170,214
False,8225115,Schefflenz,75 und mehr Jahre,330,103,227
False,8225115,Schefflenz,Insgesamt,4390,2136,2254
False,8225116,Schwarzach,unter 3 Jahre,41,18,23
False,8225116,Schwarzach,3 -  6 Jahre,94,57,37
False,8225116,Schwarzach,6 - 10 Jahre,126,72,54
False,8225116,Schwarzach,10 - 15 Jahre,155,85,70
False,8225116,Schwarzach,15 - 18 Jahre,101,50,51
False,8225116,Schwarzach,18 - 20 Jahre,64,32,32
False,8225116,Schwarzach,20 - 25 Jahre,175,104,71
False,8225116,Schwarzach,25 - 30 Jahre,192,111,81
False,8225116,Schwarzach,30 - 35 Jahre,391,212,179
False,8225116,Schwarzach,35 - 40 Jahre,493,285,208
False,8225116,Schwarzach,40 - 45 Jahre,307,174,133
False,8225116,Schwarzach,45 - 50 Jahre,225,127,98
False,8225116,Schwarzach,50 - 55 Jahre,188,108,80
False,8225116,Schwarzach,55 - 60 Jahre,137,78,59
False,8225116,Schwarzach,60 - 65 Jahre,155,72,83
False,8225116,Schwarzach,65 - 75 Jahre,203,97,106
False,8225116,Schwarzach,75 und mehr Jahre,156,39,117
False,8225116,Schwarzach,Insgesamt,3203,1721,1482
False,8225117,Elztal,unter 3 Jahre,184,91,93
False,8225117,Elztal,3 -  6 Jahre,233,110,123
False,8225117,Elztal,6 - 10 Jahre,307,164,143
False,8225117,Elztal,10 - 15 Jahre,371,195,176
False,8225117,Elztal,15 - 18 Jahre,218,109,109
False,8225117,Elztal,18 - 20 Jahre,158,77,81
False,8225117,Elztal,20 - 25 Jahre,338,166,172
False,8225117,Elztal,25 - 30 Jahre,347,160,187
False,8225117,Elztal,30 - 35 Jahre,451,245,206
False,8225117,Elztal,35 - 40 Jahre,539,269,270
False,8225117,Elztal,40 - 45 Jahre,510,258,252
False,8225117,Elztal,45 - 50 Jahre,402,212,190
False,8225117,Elztal,50 - 55 Jahre,380,184,196
False,8225117,Elztal,55 - 60 Jahre,305,163,142
False,8225117,Elztal,60 - 65 Jahre,377,187,190
False,8225117,Elztal,65 - 75 Jahre,526,274,252
False,8225117,Elztal,75 und mehr Jahre,320,117,203
False,8225117,Elztal,Insgesamt,5966,2981,2985
False,8225118,Waldbrunn,unter 3 Jahre,145,75,70
False,8225118,Waldbrunn,3 -  6 Jahre,178,105,73
False,8225118,Waldbrunn,6 - 10 Jahre,235,109,126
False,8225118,Waldbrunn,10 - 15 Jahre,301,153,148
False,8225118,Waldbrunn,15 - 18 Jahre,150,85,65
False,8225118,Waldbrunn,18 - 20 Jahre,101,51,50
False,8225118,Waldbrunn,20 - 25 Jahre,190,99,91
False,8225118,Waldbrunn,25 - 30 Jahre,265,130,135
False,8225118,Waldbrunn,30 - 35 Jahre,400,199,201
False,8225118,Waldbrunn,35 - 40 Jahre,443,244,199
False,8225118,Waldbrunn,40 - 45 Jahre,405,192,213
False,8225118,Waldbrunn,45 - 50 Jahre,354,193,161
False,8225118,Waldbrunn,50 - 55 Jahre,284,156,128
False,8225118,Waldbrunn,55 - 60 Jahre,244,118,126
False,8225118,Waldbrunn,60 - 65 Jahre,343,178,165
False,8225118,Waldbrunn,65 - 75 Jahre,498,223,275
False,8225118,Waldbrunn,75 und mehr Jahre,390,131,259
False,8225118,Waldbrunn,Insgesamt,4926,2441,2485
False,8226,Landkreis Rhein-Neckar-Kreis,unter 3 Jahre,15557,7928,7629
False,8226,Landkreis Rhein-Neckar-Kreis,3 -  6 Jahre,16521,8357,8164
False,8226,Landkreis Rhein-Neckar-Kreis,6 - 10 Jahre,22681,11631,11050
False,8226,Landkreis Rhein-Neckar-Kreis,10 - 15 Jahre,29192,15099,14093
False,8226,Landkreis Rhein-Neckar-Kreis,15 - 18 Jahre,16291,8311,7980
False,8226,Landkreis Rhein-Neckar-Kreis,18 - 20 Jahre,11365,5801,5564
False,8226,Landkreis Rhein-Neckar-Kreis,20 - 25 Jahre,27168,13641,13527
False,8226,Landkreis Rhein-Neckar-Kreis,25 - 30 Jahre,29694,14811,14883
False,8226,Landkreis Rhein-Neckar-Kreis,30 - 35 Jahre,44200,22439,21761
False,8226,Landkreis Rhein-Neckar-Kreis,35 - 40 Jahre,47953,24390,23563
False,8226,Landkreis Rhein-Neckar-Kreis,40 - 45 Jahre,42230,21317,20913
False,8226,Landkreis Rhein-Neckar-Kreis,45 - 50 Jahre,36240,17965,18275
False,8226,Landkreis Rhein-Neckar-Kreis,50 - 55 Jahre,34155,17034,17121
False,8226,Landkreis Rhein-Neckar-Kreis,55 - 60 Jahre,31554,15805,15749
False,8226,Landkreis Rhein-Neckar-Kreis,60 - 65 Jahre,36091,18058,18033
False,8226,Landkreis Rhein-Neckar-Kreis,65 - 75 Jahre,47958,22373,25585
False,8226,Landkreis Rhein-Neckar-Kreis,75 und mehr Jahre,35178,11261,23917
False,8226,Landkreis Rhein-Neckar-Kreis,Insgesamt,524028,256221,267807
False,8226003,Altlußheim,unter 3 Jahre,131,59,72
False,8226003,Altlußheim,3 -  6 Jahre,151,64,87
False,8226003,Altlußheim,6 - 10 Jahre,263,119,144
False,8226003,Altlußheim,10 - 15 Jahre,293,143,150
False,8226003,Altlußheim,15 - 18 Jahre,152,73,79
False,8226003,Altlußheim,18 - 20 Jahre,101,45,56
False,8226003,Altlußheim,20 - 25 Jahre,217,109,108
False,8226003,Altlußheim,25 - 30 Jahre,249,126,123
False,8226003,Altlußheim,30 - 35 Jahre,402,193,209
False,8226003,Altlußheim,35 - 40 Jahre,497,241,256
False,8226003,Altlußheim,40 - 45 Jahre,392,206,186
False,8226003,Altlußheim,45 - 50 Jahre,379,185,194
False,8226003,Altlußheim,50 - 55 Jahre,327,172,155
False,8226003,Altlußheim,55 - 60 Jahre,347,166,181
False,8226003,Altlußheim,60 - 65 Jahre,380,190,190
False,8226003,Altlußheim,65 - 75 Jahre,490,233,257
False,8226003,Altlußheim,75 und mehr Jahre,321,103,218
False,8226003,Altlußheim,Insgesamt,5092,2427,2665
False,8226006,Bammental,unter 3 Jahre,162,81,81
False,8226006,Bammental,3 -  6 Jahre,224,109,115
False,8226006,Bammental,6 - 10 Jahre,270,138,132
False,8226006,Bammental,10 - 15 Jahre,445,244,201
False,8226006,Bammental,15 - 18 Jahre,246,129,117
False,8226006,Bammental,18 - 20 Jahre,153,89,64
False,8226006,Bammental,20 - 25 Jahre,357,198,159
False,8226006,Bammental,25 - 30 Jahre,370,211,159
False,8226006,Bammental,30 - 35 Jahre,430,231,199
False,8226006,Bammental,35 - 40 Jahre,572,269,303
False,8226006,Bammental,40 - 45 Jahre,545,258,287
False,8226006,Bammental,45 - 50 Jahre,521,259,262
False,8226006,Bammental,50 - 55 Jahre,396,213,183
False,8226006,Bammental,55 - 60 Jahre,390,191,199
False,8226006,Bammental,60 - 65 Jahre,433,215,218
False,8226006,Bammental,65 - 75 Jahre,531,228,303
False,8226006,Bammental,75 und mehr Jahre,500,149,351
False,8226006,Bammental,Insgesamt,6545,3212,3333
False,8226009,Brühl,unter 3 Jahre,341,161,180
False,8226009,Brühl,3 -  6 Jahre,363,188,175
False,8226009,Brühl,6 - 10 Jahre,545,252,293
False,8226009,Brühl,10 - 15 Jahre,743,385,358
False,8226009,Brühl,15 - 18 Jahre,386,186,200
False,8226009,Brühl,18 - 20 Jahre,321,185,136
False,8226009,Brühl,20 - 25 Jahre,635,317,318
False,8226009,Brühl,25 - 30 Jahre,665,345,320
False,8226009,Brühl,30 - 35 Jahre,1090,536,554
False,8226009,Brühl,35 - 40 Jahre,1168,576,592
False,8226009,Brühl,40 - 45 Jahre,1200,580,620
False,8226009,Brühl,45 - 50 Jahre,1065,526,539
False,8226009,Brühl,50 - 55 Jahre,1125,577,548
False,8226009,Brühl,55 - 60 Jahre,963,476,487
False,8226009,Brühl,60 - 65 Jahre,1007,505,502
False,8226009,Brühl,65 - 75 Jahre,1368,638,730
False,8226009,Brühl,75 und mehr Jahre,1019,327,692
False,8226009,Brühl,Insgesamt,14004,6760,7244
False,8226010,Dielheim,unter 3 Jahre,327,163,164
False,8226010,Dielheim,3 -  6 Jahre,345,168,177
False,8226010,Dielheim,6 - 10 Jahre,413,206,207
False,8226010,Dielheim,10 - 15 Jahre,578,291,287
False,8226010,Dielheim,15 - 18 Jahre,297,145,152
False,8226010,Dielheim,18 - 20 Jahre,187,99,88
False,8226010,Dielheim,20 - 25 Jahre,401,211,190
False,8226010,Dielheim,25 - 30 Jahre,501,241,260
False,8226010,Dielheim,30 - 35 Jahre,839,421,418
False,8226010,Dielheim,35 - 40 Jahre,894,432,462
False,8226010,Dielheim,40 - 45 Jahre,724,363,361
False,8226010,Dielheim,45 - 50 Jahre,589,301,288
False,8226010,Dielheim,50 - 55 Jahre,545,282,263
False,8226010,Dielheim,55 - 60 Jahre,447,247,200
False,8226010,Dielheim,60 - 65 Jahre,564,273,291
False,8226010,Dielheim,65 - 75 Jahre,702,338,364
False,8226010,Dielheim,75 und mehr Jahre,432,135,297
False,8226010,Dielheim,Insgesamt,8785,4316,4469
False,8226012,Dossenheim,unter 3 Jahre,387,224,163
False,8226012,Dossenheim,3 -  6 Jahre,334,167,167
False,8226012,Dossenheim,6 - 10 Jahre,469,242,227
False,8226012,Dossenheim,10 - 15 Jahre,515,262,253
False,8226012,Dossenheim,15 - 18 Jahre,317,160,157
False,8226012,Dossenheim,18 - 20 Jahre,187,95,92
False,8226012,Dossenheim,20 - 25 Jahre,725,329,396
False,8226012,Dossenheim,25 - 30 Jahre,934,441,493
False,8226012,Dossenheim,30 - 35 Jahre,1224,596,628
False,8226012,Dossenheim,35 - 40 Jahre,1260,635,625
False,8226012,Dossenheim,40 - 45 Jahre,994,483,511
False,8226012,Dossenheim,45 - 50 Jahre,756,346,410
False,8226012,Dossenheim,50 - 55 Jahre,688,349,339
False,8226012,Dossenheim,55 - 60 Jahre,579,272,307
False,8226012,Dossenheim,60 - 65 Jahre,682,343,339
False,8226012,Dossenheim,65 - 75 Jahre,908,394,514
False,8226012,Dossenheim,75 und mehr Jahre,681,226,455
False,8226012,Dossenheim,Insgesamt,11640,5564,6076
False,8226013,"Eberbach, Stadt",unter 3 Jahre,452,233,219
False,8226013,"Eberbach, Stadt",3 -  6 Jahre,478,251,227
False,8226013,"Eberbach, Stadt",6 - 10 Jahre,660,341,319
False,8226013,"Eberbach, Stadt",10 - 15 Jahre,882,480,402
False,8226013,"Eberbach, Stadt",15 - 18 Jahre,450,220,230
False,8226013,"Eberbach, Stadt",18 - 20 Jahre,349,176,173
False,8226013,"Eberbach, Stadt",20 - 25 Jahre,796,388,408
False,8226013,"Eberbach, Stadt",25 - 30 Jahre,807,391,416
False,8226013,"Eberbach, Stadt",30 - 35 Jahre,1149,556,593
False,8226013,"Eberbach, Stadt",35 - 40 Jahre,1246,622,624
False,8226013,"Eberbach, Stadt",40 - 45 Jahre,1121,572,549
False,8226013,"Eberbach, Stadt",45 - 50 Jahre,997,473,524
False,8226013,"Eberbach, Stadt",50 - 55 Jahre,965,465,500
False,8226013,"Eberbach, Stadt",55 - 60 Jahre,919,432,487
False,8226013,"Eberbach, Stadt",60 - 65 Jahre,1207,628,579
False,8226013,"Eberbach, Stadt",65 - 75 Jahre,1678,777,901
False,8226013,"Eberbach, Stadt",75 und mehr Jahre,1536,438,1098
False,8226013,"Eberbach, Stadt",Insgesamt,15692,7443,8249
False,8226017,Epfenbach,unter 3 Jahre,66,37,29
False,8226017,Epfenbach,3 -  6 Jahre,83,49,34
False,8226017,Epfenbach,6 - 10 Jahre,130,64,66
False,8226017,Epfenbach,10 - 15 Jahre,151,84,67
False,8226017,Epfenbach,15 - 18 Jahre,83,39,44
False,8226017,Epfenbach,18 - 20 Jahre,49,22,27
False,8226017,Epfenbach,20 - 25 Jahre,136,75,61
False,8226017,Epfenbach,25 - 30 Jahre,120,66,54
False,8226017,Epfenbach,30 - 35 Jahre,184,80,104
False,8226017,Epfenbach,35 - 40 Jahre,209,122,87
False,8226017,Epfenbach,40 - 45 Jahre,192,100,92
False,8226017,Epfenbach,45 - 50 Jahre,187,87,100
False,8226017,Epfenbach,50 - 55 Jahre,165,94,71
False,8226017,Epfenbach,55 - 60 Jahre,126,57,69
False,8226017,Epfenbach,60 - 65 Jahre,139,85,54
False,8226017,Epfenbach,65 - 75 Jahre,217,102,115
False,8226017,Epfenbach,75 und mehr Jahre,137,42,95
False,8226017,Epfenbach,Insgesamt,2374,1205,1169
False,8226018,"Eppelheim, Stadt",unter 3 Jahre,441,217,224
False,8226018,"Eppelheim, Stadt",3 -  6 Jahre,409,208,201
False,8226018,"Eppelheim, Stadt",6 - 10 Jahre,567,302,265
False,8226018,"Eppelheim, Stadt",10 - 15 Jahre,670,345,325
False,8226018,"Eppelheim, Stadt",15 - 18 Jahre,368,175,193
False,8226018,"Eppelheim, Stadt",18 - 20 Jahre,238,121,117
False,8226018,"Eppelheim, Stadt",20 - 25 Jahre,836,397,439
False,8226018,"Eppelheim, Stadt",25 - 30 Jahre,1000,510,490
False,8226018,"Eppelheim, Stadt",30 - 35 Jahre,1348,739,609
False,8226018,"Eppelheim, Stadt",35 - 40 Jahre,1361,703,658
False,8226018,"Eppelheim, Stadt",40 - 45 Jahre,1055,539,516
False,8226018,"Eppelheim, Stadt",45 - 50 Jahre,959,463,496
False,8226018,"Eppelheim, Stadt",50 - 55 Jahre,904,471,433
False,8226018,"Eppelheim, Stadt",55 - 60 Jahre,841,406,435
False,8226018,"Eppelheim, Stadt",60 - 65 Jahre,967,469,498
False,8226018,"Eppelheim, Stadt",65 - 75 Jahre,1223,578,645
False,8226018,"Eppelheim, Stadt",75 und mehr Jahre,785,248,537
False,8226018,"Eppelheim, Stadt",Insgesamt,13972,6891,7081
False,8226020,Eschelbronn,unter 3 Jahre,110,50,60
False,8226020,Eschelbronn,3 -  6 Jahre,88,42,46
False,8226020,Eschelbronn,6 - 10 Jahre,135,80,55
False,8226020,Eschelbronn,10 - 15 Jahre,161,79,82
False,8226020,Eschelbronn,15 - 18 Jahre,93,44,49
False,8226020,Eschelbronn,18 - 20 Jahre,58,26,32
False,8226020,Eschelbronn,20 - 25 Jahre,148,78,70
False,8226020,Eschelbronn,25 - 30 Jahre,164,84,80
False,8226020,Eschelbronn,30 - 35 Jahre,201,98,103
False,8226020,Eschelbronn,35 - 40 Jahre,212,103,109
False,8226020,Eschelbronn,40 - 45 Jahre,187,98,89
False,8226020,Eschelbronn,45 - 50 Jahre,185,92,93
False,8226020,Eschelbronn,50 - 55 Jahre,163,89,74
False,8226020,Eschelbronn,55 - 60 Jahre,111,57,54
False,8226020,Eschelbronn,60 - 65 Jahre,159,87,72
False,8226020,Eschelbronn,65 - 75 Jahre,233,113,120
False,8226020,Eschelbronn,75 und mehr Jahre,159,55,104
False,8226020,Eschelbronn,Insgesamt,2567,1275,1292
False,8226022,Gaiberg,unter 3 Jahre,88,43,45
False,8226022,Gaiberg,3 -  6 Jahre,90,41,49
False,8226022,Gaiberg,6 - 10 Jahre,132,74,58
False,8226022,Gaiberg,10 - 15 Jahre,157,89,68
False,8226022,Gaiberg,15 - 18 Jahre,87,50,37
False,8226022,Gaiberg,18 - 20 Jahre,50,23,27
False,8226022,Gaiberg,20 - 25 Jahre,116,49,67
False,8226022,Gaiberg,25 - 30 Jahre,109,55,54
False,8226022,Gaiberg,30 - 35 Jahre,165,75,90
False,8226022,Gaiberg,35 - 40 Jahre,230,104,126
False,8226022,Gaiberg,40 - 45 Jahre,214,120,94
False,8226022,Gaiberg,45 - 50 Jahre,160,70,90
False,8226022,Gaiberg,50 - 55 Jahre,180,81,99
False,8226022,Gaiberg,55 - 60 Jahre,162,83,79
False,8226022,Gaiberg,60 - 65 Jahre,147,75,72
False,8226022,Gaiberg,65 - 75 Jahre,221,103,118
False,8226022,Gaiberg,75 und mehr Jahre,139,58,81
False,8226022,Gaiberg,Insgesamt,2447,1193,1254
False,8226027,Heddesbach,unter 3 Jahre,21,11,10
False,8226027,Heddesbach,3 -  6 Jahre,21,7,14
False,8226027,Heddesbach,6 - 10 Jahre,25,16,9
False,8226027,Heddesbach,10 - 15 Jahre,36,16,20
False,8226027,Heddesbach,15 - 18 Jahre,13,4,9
False,8226027,Heddesbach,18 - 20 Jahre,8,2,6
False,8226027,Heddesbach,20 - 25 Jahre,19,8,11
False,8226027,Heddesbach,25 - 30 Jahre,17,7,10
False,8226027,Heddesbach,30 - 35 Jahre,43,19,24
False,8226027,Heddesbach,35 - 40 Jahre,42,21,21
False,8226027,Heddesbach,40 - 45 Jahre,49,24,25
False,8226027,Heddesbach,45 - 50 Jahre,31,14,17
False,8226027,Heddesbach,50 - 55 Jahre,27,13,14
False,8226027,Heddesbach,55 - 60 Jahre,33,21,12
False,8226027,Heddesbach,60 - 65 Jahre,33,14,19
False,8226027,Heddesbach,65 - 75 Jahre,46,23,23
False,8226027,Heddesbach,75 und mehr Jahre,59,16,43
False,8226027,Heddesbach,Insgesamt,523,236,287
False,8226028,Heddesheim,unter 3 Jahre,303,140,163
False,8226028,Heddesheim,3 -  6 Jahre,375,184,191
False,8226028,Heddesheim,6 - 10 Jahre,442,237,205
False,8226028,Heddesheim,10 - 15 Jahre,579,294,285
False,8226028,Heddesheim,15 - 18 Jahre,334,160,174
False,8226028,Heddesheim,18 - 20 Jahre,245,120,125
False,8226028,Heddesheim,20 - 25 Jahre,503,261,242
False,8226028,Heddesheim,25 - 30 Jahre,639,325,314
False,8226028,Heddesheim,30 - 35 Jahre,1059,539,520
False,8226028,Heddesheim,35 - 40 Jahre,1023,526,497
False,8226028,Heddesheim,40 - 45 Jahre,966,482,484
False,8226028,Heddesheim,45 - 50 Jahre,816,390,426
False,8226028,Heddesheim,50 - 55 Jahre,850,431,419
False,8226028,Heddesheim,55 - 60 Jahre,738,356,382
False,8226028,Heddesheim,60 - 65 Jahre,826,415,411
False,8226028,Heddesheim,65 - 75 Jahre,1131,538,593
False,8226028,Heddesheim,75 und mehr Jahre,684,235,449
False,8226028,Heddesheim,Insgesamt,11513,5633,5880
False,8226029,Heiligkreuzsteinach,unter 3 Jahre,84,44,40
False,8226029,Heiligkreuzsteinach,3 -  6 Jahre,104,51,53
False,8226029,Heiligkreuzsteinach,6 - 10 Jahre,128,66,62
False,8226029,Heiligkreuzsteinach,10 - 15 Jahre,195,92,103
False,8226029,Heiligkreuzsteinach,15 - 18 Jahre,103,51,52
False,8226029,Heiligkreuzsteinach,18 - 20 Jahre,64,31,33
False,8226029,Heiligkreuzsteinach,20 - 25 Jahre,153,82,71
False,8226029,Heiligkreuzsteinach,25 - 30 Jahre,151,87,64
False,8226029,Heiligkreuzsteinach,30 - 35 Jahre,257,135,122
False,8226029,Heiligkreuzsteinach,35 - 40 Jahre,271,138,133
False,8226029,Heiligkreuzsteinach,40 - 45 Jahre,249,141,108
False,8226029,Heiligkreuzsteinach,45 - 50 Jahre,194,106,88
False,8226029,Heiligkreuzsteinach,50 - 55 Jahre,180,91,89
False,8226029,Heiligkreuzsteinach,55 - 60 Jahre,183,93,90
False,8226029,Heiligkreuzsteinach,60 - 65 Jahre,242,133,109
False,8226029,Heiligkreuzsteinach,65 - 75 Jahre,248,122,126
False,8226029,Heiligkreuzsteinach,75 und mehr Jahre,221,78,143
False,8226029,Heiligkreuzsteinach,Insgesamt,3027,1541,1486
False,8226031,"Hemsbach, Stadt",unter 3 Jahre,328,181,147
False,8226031,"Hemsbach, Stadt",3 -  6 Jahre,355,174,181
False,8226031,"Hemsbach, Stadt",6 - 10 Jahre,473,260,213
False,8226031,"Hemsbach, Stadt",10 - 15 Jahre,634,332,302
False,8226031,"Hemsbach, Stadt",15 - 18 Jahre,395,205,190
False,8226031,"Hemsbach, Stadt",18 - 20 Jahre,267,120,147
False,8226031,"Hemsbach, Stadt",20 - 25 Jahre,655,358,297
False,8226031,"Hemsbach, Stadt",25 - 30 Jahre,706,352,354
False,8226031,"Hemsbach, Stadt",30 - 35 Jahre,1016,544,472
False,8226031,"Hemsbach, Stadt",35 - 40 Jahre,1081,566,515
False,8226031,"Hemsbach, Stadt",40 - 45 Jahre,956,485,471
False,8226031,"Hemsbach, Stadt",45 - 50 Jahre,834,407,427
False,8226031,"Hemsbach, Stadt",50 - 55 Jahre,829,409,420
False,8226031,"Hemsbach, Stadt",55 - 60 Jahre,879,438,441
False,8226031,"Hemsbach, Stadt",60 - 65 Jahre,1015,509,506
False,8226031,"Hemsbach, Stadt",65 - 75 Jahre,1180,572,608
False,8226031,"Hemsbach, Stadt",75 und mehr Jahre,796,262,534
False,8226031,"Hemsbach, Stadt",Insgesamt,12399,6174,6225
False,8226032,"Hockenheim, Stadt",unter 3 Jahre,637,341,296
False,8226032,"Hockenheim, Stadt",3 -  6 Jahre,657,334,323
False,8226032,"Hockenheim, Stadt",6 - 10 Jahre,829,420,409
False,8226032,"Hockenheim, Stadt",10 - 15 Jahre,1165,602,563
False,8226032,"Hockenheim, Stadt",15 - 18 Jahre,623,341,282
False,8226032,"Hockenheim, Stadt",18 - 20 Jahre,428,229,199
False,8226032,"Hockenheim, Stadt",20 - 25 Jahre,1081,545,536
False,8226032,"Hockenheim, Stadt",25 - 30 Jahre,1200,615,585
False,8226032,"Hockenheim, Stadt",30 - 35 Jahre,1754,899,855
False,8226032,"Hockenheim, Stadt",35 - 40 Jahre,1866,954,912
False,8226032,"Hockenheim, Stadt",40 - 45 Jahre,1698,853,845
False,8226032,"Hockenheim, Stadt",45 - 50 Jahre,1392,700,692
False,8226032,"Hockenheim, Stadt",50 - 55 Jahre,1299,673,626
False,8226032,"Hockenheim, Stadt",55 - 60 Jahre,1148,596,552
False,8226032,"Hockenheim, Stadt",60 - 65 Jahre,1295,638,657
False,8226032,"Hockenheim, Stadt",65 - 75 Jahre,1702,770,932
False,8226032,"Hockenheim, Stadt",75 und mehr Jahre,1381,425,956
False,8226032,"Hockenheim, Stadt",Insgesamt,20155,9935,10220
False,8226036,Ilvesheim,unter 3 Jahre,194,109,85
False,8226036,Ilvesheim,3 -  6 Jahre,200,107,93
False,8226036,Ilvesheim,6 - 10 Jahre,235,130,105
False,8226036,Ilvesheim,10 - 15 Jahre,337,171,166
False,8226036,Ilvesheim,15 - 18 Jahre,187,97,90
False,8226036,Ilvesheim,18 - 20 Jahre,136,66,70
False,8226036,Ilvesheim,20 - 25 Jahre,289,149,140
False,8226036,Ilvesheim,25 - 30 Jahre,379,187,192
False,8226036,Ilvesheim,30 - 35 Jahre,575,297,278
False,8226036,Ilvesheim,35 - 40 Jahre,592,287,305
False,8226036,Ilvesheim,40 - 45 Jahre,585,278,307
False,8226036,Ilvesheim,45 - 50 Jahre,502,249,253
False,8226036,Ilvesheim,50 - 55 Jahre,502,257,245
False,8226036,Ilvesheim,55 - 60 Jahre,454,231,223
False,8226036,Ilvesheim,60 - 65 Jahre,506,248,258
False,8226036,Ilvesheim,65 - 75 Jahre,881,399,482
False,8226036,Ilvesheim,75 und mehr Jahre,663,253,410
False,8226036,Ilvesheim,Insgesamt,7217,3515,3702
False,8226037,Ketsch,unter 3 Jahre,390,195,195
False,8226037,Ketsch,3 -  6 Jahre,396,210,186
False,8226037,Ketsch,6 - 10 Jahre,527,261,266
False,8226037,Ketsch,10 - 15 Jahre,678,344,334
False,8226037,Ketsch,15 - 18 Jahre,415,213,202
False,8226037,Ketsch,18 - 20 Jahre,261,129,132
False,8226037,Ketsch,20 - 25 Jahre,617,304,313
False,8226037,Ketsch,25 - 30 Jahre,654,326,328
False,8226037,Ketsch,30 - 35 Jahre,1102,549,553
False,8226037,Ketsch,35 - 40 Jahre,1145,617,528
False,8226037,Ketsch,40 - 45 Jahre,1026,529,497
False,8226037,Ketsch,45 - 50 Jahre,868,433,435
False,8226037,Ketsch,50 - 55 Jahre,940,453,487
False,8226037,Ketsch,55 - 60 Jahre,931,477,454
False,8226037,Ketsch,60 - 65 Jahre,999,511,488
False,8226037,Ketsch,65 - 75 Jahre,1240,617,623
False,8226037,Ketsch,75 und mehr Jahre,825,269,556
False,8226037,Ketsch,Insgesamt,13014,6437,6577
False,8226038,"Ladenburg, Stadt",unter 3 Jahre,340,167,173
False,8226038,"Ladenburg, Stadt",3 -  6 Jahre,350,175,175
False,8226038,"Ladenburg, Stadt",6 - 10 Jahre,501,255,246
False,8226038,"Ladenburg, Stadt",10 - 15 Jahre,612,312,300
False,8226038,"Ladenburg, Stadt",15 - 18 Jahre,370,184,186
False,8226038,"Ladenburg, Stadt",18 - 20 Jahre,224,122,102
False,8226038,"Ladenburg, Stadt",20 - 25 Jahre,533,276,257
False,8226038,"Ladenburg, Stadt",25 - 30 Jahre,564,273,291
False,8226038,"Ladenburg, Stadt",30 - 35 Jahre,812,390,422
False,8226038,"Ladenburg, Stadt",35 - 40 Jahre,956,484,472
False,8226038,"Ladenburg, Stadt",40 - 45 Jahre,906,447,459
False,8226038,"Ladenburg, Stadt",45 - 50 Jahre,911,431,480
False,8226038,"Ladenburg, Stadt",50 - 55 Jahre,786,387,399
False,8226038,"Ladenburg, Stadt",55 - 60 Jahre,826,392,434
False,8226038,"Ladenburg, Stadt",60 - 65 Jahre,961,493,468
False,8226038,"Ladenburg, Stadt",65 - 75 Jahre,1098,530,568
False,8226038,"Ladenburg, Stadt",75 und mehr Jahre,832,266,566
False,8226038,"Ladenburg, Stadt",Insgesamt,11582,5584,5998
False,8226040,Laudenbach,unter 3 Jahre,181,98,83
False,8226040,Laudenbach,3 -  6 Jahre,181,82,99
False,8226040,Laudenbach,6 - 10 Jahre,282,149,133
False,8226040,Laudenbach,10 - 15 Jahre,332,155,177
False,8226040,Laudenbach,15 - 18 Jahre,187,91,96
False,8226040,Laudenbach,18 - 20 Jahre,135,64,71
False,8226040,Laudenbach,20 - 25 Jahre,318,150,168
False,8226040,Laudenbach,25 - 30 Jahre,288,144,144
False,8226040,Laudenbach,30 - 35 Jahre,479,239,240
False,8226040,Laudenbach,35 - 40 Jahre,487,250,237
False,8226040,Laudenbach,40 - 45 Jahre,505,225,280
False,8226040,Laudenbach,45 - 50 Jahre,399,202,197
False,8226040,Laudenbach,50 - 55 Jahre,421,189,232
False,8226040,Laudenbach,55 - 60 Jahre,424,217,207
False,8226040,Laudenbach,60 - 65 Jahre,360,194,166
False,8226040,Laudenbach,65 - 75 Jahre,479,221,258
False,8226040,Laudenbach,75 und mehr Jahre,319,116,203
False,8226040,Laudenbach,Insgesamt,5777,2786,2991
False,8226041,"Leimen, Stadt",unter 3 Jahre,814,443,371
False,8226041,"Leimen, Stadt",3 -  6 Jahre,774,410,364
False,8226041,"Leimen, Stadt",6 - 10 Jahre,1105,559,546
False,8226041,"Leimen, Stadt",10 - 15 Jahre,1517,777,740
False,8226041,"Leimen, Stadt",15 - 18 Jahre,916,461,455
False,8226041,"Leimen, Stadt",18 - 20 Jahre,621,305,316
False,8226041,"Leimen, Stadt",20 - 25 Jahre,1672,812,860
False,8226041,"Leimen, Stadt",25 - 30 Jahre,1695,795,900
False,8226041,"Leimen, Stadt",30 - 35 Jahre,2324,1164,1160
False,8226041,"Leimen, Stadt",35 - 40 Jahre,2508,1292,1216
False,8226041,"Leimen, Stadt",40 - 45 Jahre,2269,1145,1124
False,8226041,"Leimen, Stadt",45 - 50 Jahre,1904,944,960
False,8226041,"Leimen, Stadt",50 - 55 Jahre,1604,807,797
False,8226041,"Leimen, Stadt",55 - 60 Jahre,1395,713,682
False,8226041,"Leimen, Stadt",60 - 65 Jahre,1628,802,826
False,8226041,"Leimen, Stadt",65 - 75 Jahre,2186,1008,1178
False,8226041,"Leimen, Stadt",75 und mehr Jahre,1546,514,1032
False,8226041,"Leimen, Stadt",Insgesamt,26478,12951,13527
False,8226046,Malsch,unter 3 Jahre,90,45,45
False,8226046,Malsch,3 -  6 Jahre,106,57,49
False,8226046,Malsch,6 - 10 Jahre,156,79,77
False,8226046,Malsch,10 - 15 Jahre,206,113,93
False,8226046,Malsch,15 - 18 Jahre,111,57,54
False,8226046,Malsch,18 - 20 Jahre,75,35,40
False,8226046,Malsch,20 - 25 Jahre,131,63,68
False,8226046,Malsch,25 - 30 Jahre,156,86,70
False,8226046,Malsch,30 - 35 Jahre,273,128,145
False,8226046,Malsch,35 - 40 Jahre,344,177,167
False,8226046,Malsch,40 - 45 Jahre,302,154,148
False,8226046,Malsch,45 - 50 Jahre,234,121,113
False,8226046,Malsch,50 - 55 Jahre,176,94,82
False,8226046,Malsch,55 - 60 Jahre,170,97,73
False,8226046,Malsch,60 - 65 Jahre,195,101,94
False,8226046,Malsch,65 - 75 Jahre,269,119,150
False,8226046,Malsch,75 und mehr Jahre,195,62,133
False,8226046,Malsch,Insgesamt,3189,1588,1601
False,8226048,Mauer,unter 3 Jahre,129,59,70
False,8226048,Mauer,3 -  6 Jahre,117,49,68
False,8226048,Mauer,6 - 10 Jahre,147,69,78
False,8226048,Mauer,10 - 15 Jahre,221,104,117
False,8226048,Mauer,15 - 18 Jahre,131,56,75
False,8226048,Mauer,18 - 20 Jahre,89,38,51
False,8226048,Mauer,20 - 25 Jahre,198,106,92
False,8226048,Mauer,25 - 30 Jahre,191,104,87
False,8226048,Mauer,30 - 35 Jahre,298,156,142
False,8226048,Mauer,35 - 40 Jahre,290,149,141
False,8226048,Mauer,40 - 45 Jahre,297,147,150
False,8226048,Mauer,45 - 50 Jahre,247,135,112
False,8226048,Mauer,50 - 55 Jahre,218,108,110
False,8226048,Mauer,55 - 60 Jahre,222,113,109
False,8226048,Mauer,60 - 65 Jahre,228,126,102
False,8226048,Mauer,65 - 75 Jahre,299,140,159
False,8226048,Mauer,75 und mehr Jahre,166,57,109
False,8226048,Mauer,Insgesamt,3488,1716,1772
False,8226049,Meckesheim,unter 3 Jahre,161,80,81
False,8226049,Meckesheim,3 -  6 Jahre,175,95,80
False,8226049,Meckesheim,6 - 10 Jahre,227,117,110
False,8226049,Meckesheim,10 - 15 Jahre,330,187,143
False,8226049,Meckesheim,15 - 18 Jahre,158,70,88
False,8226049,Meckesheim,18 - 20 Jahre,113,50,63
False,8226049,Meckesheim,20 - 25 Jahre,274,144,130
False,8226049,Meckesheim,25 - 30 Jahre,332,169,163
False,8226049,Meckesheim,30 - 35 Jahre,471,251,220
False,8226049,Meckesheim,35 - 40 Jahre,429,235,194
False,8226049,Meckesheim,40 - 45 Jahre,438,232,206
False,8226049,Meckesheim,45 - 50 Jahre,367,184,183
False,8226049,Meckesheim,50 - 55 Jahre,411,200,211
False,8226049,Meckesheim,55 - 60 Jahre,321,182,139
False,8226049,Meckesheim,60 - 65 Jahre,349,171,178
False,8226049,Meckesheim,65 - 75 Jahre,486,231,255
False,8226049,Meckesheim,75 und mehr Jahre,323,103,220
False,8226049,Meckesheim,Insgesamt,5365,2701,2664
False,8226054,Mühlhausen,unter 3 Jahre,284,157,127
False,8226054,Mühlhausen,3 -  6 Jahre,301,152,149
False,8226054,Mühlhausen,6 - 10 Jahre,446,243,203
False,8226054,Mühlhausen,10 - 15 Jahre,471,233,238
False,8226054,Mühlhausen,15 - 18 Jahre,269,141,128
False,8226054,Mühlhausen,18 - 20 Jahre,189,109,80
False,8226054,Mühlhausen,20 - 25 Jahre,400,202,198
False,8226054,Mühlhausen,25 - 30 Jahre,461,238,223
False,8226054,Mühlhausen,30 - 35 Jahre,709,351,358
False,8226054,Mühlhausen,35 - 40 Jahre,821,441,380
False,8226054,Mühlhausen,40 - 45 Jahre,710,380,330
False,8226054,Mühlhausen,45 - 50 Jahre,547,262,285
False,8226054,Mühlhausen,50 - 55 Jahre,470,246,224
False,8226054,Mühlhausen,55 - 60 Jahre,367,190,177
False,8226054,Mühlhausen,60 - 65 Jahre,447,243,204
False,8226054,Mühlhausen,65 - 75 Jahre,607,272,335
False,8226054,Mühlhausen,75 und mehr Jahre,349,124,225
False,8226054,Mühlhausen,Insgesamt,7848,3984,3864
False,8226055,"Neckarbischofsheim, Stadt",unter 3 Jahre,100,46,54
False,8226055,"Neckarbischofsheim, Stadt",3 -  6 Jahre,118,62,56
False,8226055,"Neckarbischofsheim, Stadt",6 - 10 Jahre,188,97,91
False,8226055,"Neckarbischofsheim, Stadt",10 - 15 Jahre,276,141,135
False,8226055,"Neckarbischofsheim, Stadt",15 - 18 Jahre,151,83,68
False,8226055,"Neckarbischofsheim, Stadt",18 - 20 Jahre,121,63,58
False,8226055,"Neckarbischofsheim, Stadt",20 - 25 Jahre,227,114,113
False,8226055,"Neckarbischofsheim, Stadt",25 - 30 Jahre,206,124,82
False,8226055,"Neckarbischofsheim, Stadt",30 - 35 Jahre,306,163,143
False,8226055,"Neckarbischofsheim, Stadt",35 - 40 Jahre,375,194,181
False,8226055,"Neckarbischofsheim, Stadt",40 - 45 Jahre,332,170,162
False,8226055,"Neckarbischofsheim, Stadt",45 - 50 Jahre,246,126,120
False,8226055,"Neckarbischofsheim, Stadt",50 - 55 Jahre,235,121,114
False,8226055,"Neckarbischofsheim, Stadt",55 - 60 Jahre,203,109,94
False,8226055,"Neckarbischofsheim, Stadt",60 - 65 Jahre,233,106,127
False,8226055,"Neckarbischofsheim, Stadt",65 - 75 Jahre,374,178,196
False,8226055,"Neckarbischofsheim, Stadt",75 und mehr Jahre,287,88,199
False,8226055,"Neckarbischofsheim, Stadt",Insgesamt,3978,1985,1993
False,8226056,"Neckargemünd, Stadt",unter 3 Jahre,316,162,154
False,8226056,"Neckargemünd, Stadt",3 -  6 Jahre,389,212,177
False,8226056,"Neckargemünd, Stadt",6 - 10 Jahre,495,264,231
False,8226056,"Neckargemünd, Stadt",10 - 15 Jahre,700,335,365
False,8226056,"Neckargemünd, Stadt",15 - 18 Jahre,413,221,192
False,8226056,"Neckargemünd, Stadt",18 - 20 Jahre,344,190,154
False,8226056,"Neckargemünd, Stadt",20 - 25 Jahre,934,536,398
False,8226056,"Neckargemünd, Stadt",25 - 30 Jahre,866,463,403
False,8226056,"Neckargemünd, Stadt",30 - 35 Jahre,1148,601,547
False,8226056,"Neckargemünd, Stadt",35 - 40 Jahre,1261,647,614
False,8226056,"Neckargemünd, Stadt",40 - 45 Jahre,1091,533,558
False,8226056,"Neckargemünd, Stadt",45 - 50 Jahre,1035,517,518
False,8226056,"Neckargemünd, Stadt",50 - 55 Jahre,911,432,479
False,8226056,"Neckargemünd, Stadt",55 - 60 Jahre,972,462,510
False,8226056,"Neckargemünd, Stadt",60 - 65 Jahre,973,457,516
False,8226056,"Neckargemünd, Stadt",65 - 75 Jahre,1226,591,635
False,8226056,"Neckargemünd, Stadt",75 und mehr Jahre,1097,357,740
False,8226056,"Neckargemünd, Stadt",Insgesamt,14171,6980,7191
False,8226058,Neidenstein,unter 3 Jahre,76,37,39
False,8226058,Neidenstein,3 -  6 Jahre,78,34,44
False,8226058,Neidenstein,6 - 10 Jahre,103,48,55
False,8226058,Neidenstein,10 - 15 Jahre,122,57,65
False,8226058,Neidenstein,15 - 18 Jahre,48,27,21
False,8226058,Neidenstein,18 - 20 Jahre,29,21,8
False,8226058,Neidenstein,20 - 25 Jahre,98,47,51
False,8226058,Neidenstein,25 - 30 Jahre,109,48,61
False,8226058,Neidenstein,30 - 35 Jahre,182,99,83
False,8226058,Neidenstein,35 - 40 Jahre,183,80,103
False,8226058,Neidenstein,40 - 45 Jahre,143,70,73
False,8226058,Neidenstein,45 - 50 Jahre,119,63,56
False,8226058,Neidenstein,50 - 55 Jahre,106,57,49
False,8226058,Neidenstein,55 - 60 Jahre,91,53,38
False,8226058,Neidenstein,60 - 65 Jahre,122,63,59
False,8226058,Neidenstein,65 - 75 Jahre,155,67,88
False,8226058,Neidenstein,75 und mehr Jahre,112,38,74
False,8226058,Neidenstein,Insgesamt,1876,909,967
False,8226059,Neulußheim,unter 3 Jahre,220,111,109
False,8226059,Neulußheim,3 -  6 Jahre,204,106,98
False,8226059,Neulußheim,6 - 10 Jahre,310,165,145
False,8226059,Neulußheim,10 - 15 Jahre,349,184,165
False,8226059,Neulußheim,15 - 18 Jahre,185,98,87
False,8226059,Neulußheim,18 - 20 Jahre,121,72,49
False,8226059,Neulußheim,20 - 25 Jahre,298,149,149
False,8226059,Neulußheim,25 - 30 Jahre,342,168,174
False,8226059,Neulußheim,30 - 35 Jahre,614,294,320
False,8226059,Neulußheim,35 - 40 Jahre,596,301,295
False,8226059,Neulußheim,40 - 45 Jahre,570,303,267
False,8226059,Neulußheim,45 - 50 Jahre,419,214,205
False,8226059,Neulußheim,50 - 55 Jahre,405,201,204
False,8226059,Neulußheim,55 - 60 Jahre,344,176,168
False,8226059,Neulußheim,60 - 65 Jahre,399,199,200
False,8226059,Neulußheim,65 - 75 Jahre,540,256,284
False,8226059,Neulußheim,75 und mehr Jahre,375,126,249
False,8226059,Neulußheim,Insgesamt,6291,3123,3168
False,8226060,Nußloch,unter 3 Jahre,310,158,152
False,8226060,Nußloch,3 -  6 Jahre,344,175,169
False,8226060,Nußloch,6 - 10 Jahre,453,225,228
False,8226060,Nußloch,10 - 15 Jahre,601,296,305
False,8226060,Nußloch,15 - 18 Jahre,329,172,157
False,8226060,Nußloch,18 - 20 Jahre,240,116,124
False,8226060,Nußloch,20 - 25 Jahre,532,258,274
False,8226060,Nußloch,25 - 30 Jahre,632,323,309
False,8226060,Nußloch,30 - 35 Jahre,1022,503,519
False,8226060,Nußloch,35 - 40 Jahre,925,468,457
False,8226060,Nußloch,40 - 45 Jahre,858,425,433
False,8226060,Nußloch,45 - 50 Jahre,760,375,385
False,8226060,Nußloch,50 - 55 Jahre,674,331,343
False,8226060,Nußloch,55 - 60 Jahre,638,329,309
False,8226060,Nußloch,60 - 65 Jahre,642,318,324
False,8226060,Nußloch,65 - 75 Jahre,923,434,489
False,8226060,Nußloch,75 und mehr Jahre,701,217,484
False,8226060,Nußloch,Insgesamt,10584,5123,5461
False,8226062,Oftersheim,unter 3 Jahre,261,130,131
False,8226062,Oftersheim,3 -  6 Jahre,301,157,144
False,8226062,Oftersheim,6 - 10 Jahre,398,199,199
False,8226062,Oftersheim,10 - 15 Jahre,533,296,237
False,8226062,Oftersheim,15 - 18 Jahre,330,168,162
False,8226062,Oftersheim,18 - 20 Jahre,221,112,109
False,8226062,Oftersheim,20 - 25 Jahre,504,255,249
False,8226062,Oftersheim,25 - 30 Jahre,491,219,272
False,8226062,Oftersheim,30 - 35 Jahre,853,404,449
False,8226062,Oftersheim,35 - 40 Jahre,931,462,469
False,8226062,Oftersheim,40 - 45 Jahre,757,361,396
False,8226062,Oftersheim,45 - 50 Jahre,735,338,397
False,8226062,Oftersheim,50 - 55 Jahre,773,384,389
False,8226062,Oftersheim,55 - 60 Jahre,650,322,328
False,8226062,Oftersheim,60 - 65 Jahre,781,380,401
False,8226062,Oftersheim,65 - 75 Jahre,1103,514,589
False,8226062,Oftersheim,75 und mehr Jahre,757,260,497
False,8226062,Oftersheim,Insgesamt,10379,4961,5418
False,8226063,Plankstadt,unter 3 Jahre,250,128,122
False,8226063,Plankstadt,3 -  6 Jahre,280,145,135
False,8226063,Plankstadt,6 - 10 Jahre,404,213,191
False,8226063,Plankstadt,10 - 15 Jahre,526,278,248
False,8226063,Plankstadt,15 - 18 Jahre,255,149,106
False,8226063,Plankstadt,18 - 20 Jahre,211,97,114
False,8226063,Plankstadt,20 - 25 Jahre,427,203,224
False,8226063,Plankstadt,25 - 30 Jahre,480,238,242
False,8226063,Plankstadt,30 - 35 Jahre,753,386,367
False,8226063,Plankstadt,35 - 40 Jahre,846,422,424
False,8226063,Plankstadt,40 - 45 Jahre,723,371,352
False,8226063,Plankstadt,45 - 50 Jahre,687,315,372
False,8226063,Plankstadt,50 - 55 Jahre,662,328,334
False,8226063,Plankstadt,55 - 60 Jahre,582,302,280
False,8226063,Plankstadt,60 - 65 Jahre,735,356,379
False,8226063,Plankstadt,65 - 75 Jahre,929,414,515
False,8226063,Plankstadt,75 und mehr Jahre,849,250,599
False,8226063,Plankstadt,Insgesamt,9599,4595,5004
False,8226065,"Rauenberg, Stadt",unter 3 Jahre,251,112,139
False,8226065,"Rauenberg, Stadt",3 -  6 Jahre,257,130,127
False,8226065,"Rauenberg, Stadt",6 - 10 Jahre,331,154,177
False,8226065,"Rauenberg, Stadt",10 - 15 Jahre,393,213,180
False,8226065,"Rauenberg, Stadt",15 - 18 Jahre,243,119,124
False,8226065,"Rauenberg, Stadt",18 - 20 Jahre,149,76,73
False,8226065,"Rauenberg, Stadt",20 - 25 Jahre,382,177,205
False,8226065,"Rauenberg, Stadt",25 - 30 Jahre,445,223,222
False,8226065,"Rauenberg, Stadt",30 - 35 Jahre,676,359,317
False,8226065,"Rauenberg, Stadt",35 - 40 Jahre,770,418,352
False,8226065,"Rauenberg, Stadt",40 - 45 Jahre,616,326,290
False,8226065,"Rauenberg, Stadt",45 - 50 Jahre,484,243,241
False,8226065,"Rauenberg, Stadt",50 - 55 Jahre,442,235,207
False,8226065,"Rauenberg, Stadt",55 - 60 Jahre,369,197,172
False,8226065,"Rauenberg, Stadt",60 - 65 Jahre,448,222,226
False,8226065,"Rauenberg, Stadt",65 - 75 Jahre,651,290,361
False,8226065,"Rauenberg, Stadt",75 und mehr Jahre,358,122,236
False,8226065,"Rauenberg, Stadt",Insgesamt,7265,3616,3649
False,8226066,Reichartshausen,unter 3 Jahre,66,32,34
False,8226066,Reichartshausen,3 -  6 Jahre,75,32,43
False,8226066,Reichartshausen,6 - 10 Jahre,86,43,43
False,8226066,Reichartshausen,10 - 15 Jahre,135,71,64
False,8226066,Reichartshausen,15 - 18 Jahre,68,32,36
False,8226066,Reichartshausen,18 - 20 Jahre,44,19,25
False,8226066,Reichartshausen,20 - 25 Jahre,91,48,43
False,8226066,Reichartshausen,25 - 30 Jahre,103,56,47
False,8226066,Reichartshausen,30 - 35 Jahre,140,70,70
False,8226066,Reichartshausen,35 - 40 Jahre,173,83,90
False,8226066,Reichartshausen,40 - 45 Jahre,165,95,70
False,8226066,Reichartshausen,45 - 50 Jahre,120,58,62
False,8226066,Reichartshausen,50 - 55 Jahre,95,45,50
False,8226066,Reichartshausen,55 - 60 Jahre,95,50,45
False,8226066,Reichartshausen,60 - 65 Jahre,126,66,60
False,8226066,Reichartshausen,65 - 75 Jahre,180,85,95
False,8226066,Reichartshausen,75 und mehr Jahre,91,29,62
False,8226066,Reichartshausen,Insgesamt,1853,914,939
False,8226068,Reilingen,unter 3 Jahre,200,97,103
False,8226068,Reilingen,3 -  6 Jahre,232,114,118
False,8226068,Reilingen,6 - 10 Jahre,310,162,148
False,8226068,Reilingen,10 - 15 Jahre,390,192,198
False,8226068,Reilingen,15 - 18 Jahre,236,131,105
False,8226068,Reilingen,18 - 20 Jahre,170,77,93
False,8226068,Reilingen,20 - 25 Jahre,343,176,167
False,8226068,Reilingen,25 - 30 Jahre,356,180,176
False,8226068,Reilingen,30 - 35 Jahre,526,256,270
False,8226068,Reilingen,35 - 40 Jahre,647,339,308
False,8226068,Reilingen,40 - 45 Jahre,586,307,279
False,8226068,Reilingen,45 - 50 Jahre,487,250,237
False,8226068,Reilingen,50 - 55 Jahre,476,233,243
False,8226068,Reilingen,55 - 60 Jahre,434,234,200
False,8226068,Reilingen,60 - 65 Jahre,463,231,232
False,8226068,Reilingen,65 - 75 Jahre,626,292,334
False,8226068,Reilingen,75 und mehr Jahre,430,129,301
False,8226068,Reilingen,Insgesamt,6912,3400,3512
False,8226076,Sandhausen,unter 3 Jahre,408,224,184
False,8226076,Sandhausen,3 -  6 Jahre,408,196,212
False,8226076,Sandhausen,6 - 10 Jahre,595,317,278
False,8226076,Sandhausen,10 - 15 Jahre,722,385,337
False,8226076,Sandhausen,15 - 18 Jahre,434,245,189
False,8226076,Sandhausen,18 - 20 Jahre,294,157,137
False,8226076,Sandhausen,20 - 25 Jahre,709,335,374
False,8226076,Sandhausen,25 - 30 Jahre,844,397,447
False,8226076,Sandhausen,30 - 35 Jahre,1188,619,569
False,8226076,Sandhausen,35 - 40 Jahre,1262,621,641
False,8226076,Sandhausen,40 - 45 Jahre,1089,541,548
False,8226076,Sandhausen,45 - 50 Jahre,1006,497,509
False,8226076,Sandhausen,50 - 55 Jahre,986,468,518
False,8226076,Sandhausen,55 - 60 Jahre,873,436,437
False,8226076,Sandhausen,60 - 65 Jahre,986,476,510
False,8226076,Sandhausen,65 - 75 Jahre,1320,629,691
False,8226076,Sandhausen,75 und mehr Jahre,822,267,555
False,8226076,Sandhausen,Insgesamt,13946,6810,7136
False,8226080,"Schönau, Stadt",unter 3 Jahre,135,64,71
False,8226080,"Schönau, Stadt",3 -  6 Jahre,176,95,81
False,8226080,"Schönau, Stadt",6 - 10 Jahre,229,127,102
False,8226080,"Schönau, Stadt",10 - 15 Jahre,279,151,128
False,8226080,"Schönau, Stadt",15 - 18 Jahre,143,69,74
False,8226080,"Schönau, Stadt",18 - 20 Jahre,84,51,33
False,8226080,"Schönau, Stadt",20 - 25 Jahre,207,105,102
False,8226080,"Schönau, Stadt",25 - 30 Jahre,199,97,102
False,8226080,"Schönau, Stadt",30 - 35 Jahre,373,185,188
False,8226080,"Schönau, Stadt",35 - 40 Jahre,415,208,207
False,8226080,"Schönau, Stadt",40 - 45 Jahre,384,202,182
False,8226080,"Schönau, Stadt",45 - 50 Jahre,339,169,170
False,8226080,"Schönau, Stadt",50 - 55 Jahre,296,141,155
False,8226080,"Schönau, Stadt",55 - 60 Jahre,309,151,158
False,8226080,"Schönau, Stadt",60 - 65 Jahre,356,180,176
False,8226080,"Schönau, Stadt",65 - 75 Jahre,479,230,249
False,8226080,"Schönau, Stadt",75 und mehr Jahre,383,105,278
False,8226080,"Schönau, Stadt",Insgesamt,4786,2330,2456
False,8226081,Schönbrunn,unter 3 Jahre,85,52,33
False,8226081,Schönbrunn,3 -  6 Jahre,105,46,59
False,8226081,Schönbrunn,6 - 10 Jahre,153,83,70
False,8226081,Schönbrunn,10 - 15 Jahre,222,129,93
False,8226081,Schönbrunn,15 - 18 Jahre,106,57,49
False,8226081,Schönbrunn,18 - 20 Jahre,82,44,38
False,8226081,Schönbrunn,20 - 25 Jahre,151,75,76
False,8226081,Schönbrunn,25 - 30 Jahre,129,64,65
False,8226081,Schönbrunn,30 - 35 Jahre,259,140,119
False,8226081,Schönbrunn,35 - 40 Jahre,275,133,142
False,8226081,Schönbrunn,40 - 45 Jahre,265,134,131
False,8226081,Schönbrunn,45 - 50 Jahre,223,116,107
False,8226081,Schönbrunn,50 - 55 Jahre,209,102,107
False,8226081,Schönbrunn,55 - 60 Jahre,173,93,80
False,8226081,Schönbrunn,60 - 65 Jahre,197,115,82
False,8226081,Schönbrunn,65 - 75 Jahre,272,138,134
False,8226081,Schönbrunn,75 und mehr Jahre,187,61,126
False,8226081,Schönbrunn,Insgesamt,3093,1582,1511
False,8226082,"Schriesheim, Stadt",unter 3 Jahre,416,190,226
False,8226082,"Schriesheim, Stadt",3 -  6 Jahre,420,217,203
False,8226082,"Schriesheim, Stadt",6 - 10 Jahre,534,292,242
False,8226082,"Schriesheim, Stadt",10 - 15 Jahre,646,353,293
False,8226082,"Schriesheim, Stadt",15 - 18 Jahre,383,201,182
False,8226082,"Schriesheim, Stadt",18 - 20 Jahre,304,155,149
False,8226082,"Schriesheim, Stadt",20 - 25 Jahre,787,374,413
False,8226082,"Schriesheim, Stadt",25 - 30 Jahre,825,402,423
False,8226082,"Schriesheim, Stadt",30 - 35 Jahre,1151,595,556
False,8226082,"Schriesheim, Stadt",35 - 40 Jahre,1272,619,653
False,8226082,"Schriesheim, Stadt",40 - 45 Jahre,1098,540,558
False,8226082,"Schriesheim, Stadt",45 - 50 Jahre,1005,483,522
False,8226082,"Schriesheim, Stadt",50 - 55 Jahre,983,488,495
False,8226082,"Schriesheim, Stadt",55 - 60 Jahre,965,476,489
False,8226082,"Schriesheim, Stadt",60 - 65 Jahre,933,475,458
False,8226082,"Schriesheim, Stadt",65 - 75 Jahre,1183,572,611
False,8226082,"Schriesheim, Stadt",75 und mehr Jahre,1116,326,790
False,8226082,"Schriesheim, Stadt",Insgesamt,14021,6758,7263
False,8226084,"Schwetzingen, Stadt",unter 3 Jahre,674,334,340
False,8226084,"Schwetzingen, Stadt",3 -  6 Jahre,649,308,341
False,8226084,"Schwetzingen, Stadt",6 - 10 Jahre,953,463,490
False,8226084,"Schwetzingen, Stadt",10 - 15 Jahre,1202,623,579
False,8226084,"Schwetzingen, Stadt",15 - 18 Jahre,646,334,312
False,8226084,"Schwetzingen, Stadt",18 - 20 Jahre,445,222,223
False,8226084,"Schwetzingen, Stadt",20 - 25 Jahre,1244,626,618
False,8226084,"Schwetzingen, Stadt",25 - 30 Jahre,1445,715,730
False,8226084,"Schwetzingen, Stadt",30 - 35 Jahre,2167,1110,1057
False,8226084,"Schwetzingen, Stadt",35 - 40 Jahre,2294,1196,1098
False,8226084,"Schwetzingen, Stadt",40 - 45 Jahre,1887,936,951
False,8226084,"Schwetzingen, Stadt",45 - 50 Jahre,1445,727,718
False,8226084,"Schwetzingen, Stadt",50 - 55 Jahre,1364,712,652
False,8226084,"Schwetzingen, Stadt",55 - 60 Jahre,1279,639,640
False,8226084,"Schwetzingen, Stadt",60 - 65 Jahre,1376,660,716
False,8226084,"Schwetzingen, Stadt",65 - 75 Jahre,1790,762,1028
False,8226084,"Schwetzingen, Stadt",75 und mehr Jahre,1407,432,975
False,8226084,"Schwetzingen, Stadt",Insgesamt,22267,10799,11468
False,8226085,"Sinsheim, Stadt",unter 3 Jahre,1071,534,537
False,8226085,"Sinsheim, Stadt",3 -  6 Jahre,1281,651,630
False,8226085,"Sinsheim, Stadt",6 - 10 Jahre,1692,842,850
False,8226085,"Sinsheim, Stadt",10 - 15 Jahre,2173,1147,1026
False,8226085,"Sinsheim, Stadt",15 - 18 Jahre,1220,616,604
False,8226085,"Sinsheim, Stadt",18 - 20 Jahre,799,394,405
False,8226085,"Sinsheim, Stadt",20 - 25 Jahre,1897,971,926
False,8226085,"Sinsheim, Stadt",25 - 30 Jahre,2084,1035,1049
False,8226085,"Sinsheim, Stadt",30 - 35 Jahre,2751,1402,1349
False,8226085,"Sinsheim, Stadt",35 - 40 Jahre,3065,1573,1492
False,8226085,"Sinsheim, Stadt",40 - 45 Jahre,2786,1396,1390
False,8226085,"Sinsheim, Stadt",45 - 50 Jahre,2403,1199,1204
False,8226085,"Sinsheim, Stadt",50 - 55 Jahre,2124,1108,1016
False,8226085,"Sinsheim, Stadt",55 - 60 Jahre,1780,915,865
False,8226085,"Sinsheim, Stadt",60 - 65 Jahre,2133,1065,1068
False,8226085,"Sinsheim, Stadt",65 - 75 Jahre,2854,1291,1563
False,8226085,"Sinsheim, Stadt",75 und mehr Jahre,2058,624,1434
False,8226085,"Sinsheim, Stadt",Insgesamt,34171,16763,17408
False,8226086,Spechbach,unter 3 Jahre,52,31,21
False,8226086,Spechbach,3 -  6 Jahre,49,23,26
False,8226086,Spechbach,6 - 10 Jahre,91,54,37
False,8226086,Spechbach,10 - 15 Jahre,120,75,45
False,8226086,Spechbach,15 - 18 Jahre,49,29,20
False,8226086,Spechbach,18 - 20 Jahre,38,24,14
False,8226086,Spechbach,20 - 25 Jahre,77,37,40
False,8226086,Spechbach,25 - 30 Jahre,74,38,36
False,8226086,Spechbach,30 - 35 Jahre,131,61,70
False,8226086,Spechbach,35 - 40 Jahre,140,74,66
False,8226086,Spechbach,40 - 45 Jahre,141,71,70
False,8226086,Spechbach,45 - 50 Jahre,102,54,48
False,8226086,Spechbach,50 - 55 Jahre,95,53,42
False,8226086,Spechbach,55 - 60 Jahre,91,41,50
False,8226086,Spechbach,60 - 65 Jahre,117,59,58
False,8226086,Spechbach,65 - 75 Jahre,152,70,82
False,8226086,Spechbach,75 und mehr Jahre,156,42,114
False,8226086,Spechbach,Insgesamt,1675,836,839
False,8226091,"Waibstadt, Stadt",unter 3 Jahre,183,89,94
False,8226091,"Waibstadt, Stadt",3 -  6 Jahre,188,95,93
False,8226091,"Waibstadt, Stadt",6 - 10 Jahre,306,170,136
False,8226091,"Waibstadt, Stadt",10 - 15 Jahre,380,185,195
False,8226091,"Waibstadt, Stadt",15 - 18 Jahre,197,97,100
False,8226091,"Waibstadt, Stadt",18 - 20 Jahre,150,74,76
False,8226091,"Waibstadt, Stadt",20 - 25 Jahre,278,144,134
False,8226091,"Waibstadt, Stadt",25 - 30 Jahre,309,153,156
False,8226091,"Waibstadt, Stadt",30 - 35 Jahre,454,236,218
False,8226091,"Waibstadt, Stadt",35 - 40 Jahre,466,231,235
False,8226091,"Waibstadt, Stadt",40 - 45 Jahre,442,219,223
False,8226091,"Waibstadt, Stadt",45 - 50 Jahre,405,190,215
False,8226091,"Waibstadt, Stadt",50 - 55 Jahre,355,191,164
False,8226091,"Waibstadt, Stadt",55 - 60 Jahre,280,148,132
False,8226091,"Waibstadt, Stadt",60 - 65 Jahre,408,201,207
False,8226091,"Waibstadt, Stadt",65 - 75 Jahre,510,238,272
False,8226091,"Waibstadt, Stadt",75 und mehr Jahre,374,102,272
False,8226091,"Waibstadt, Stadt",Insgesamt,5685,2763,2922
False,8226095,"Walldorf, Stadt",unter 3 Jahre,455,241,214
False,8226095,"Walldorf, Stadt",3 -  6 Jahre,441,219,222
False,8226095,"Walldorf, Stadt",6 - 10 Jahre,604,316,288
False,8226095,"Walldorf, Stadt",10 - 15 Jahre,781,417,364
False,8226095,"Walldorf, Stadt",15 - 18 Jahre,442,217,225
False,8226095,"Walldorf, Stadt",18 - 20 Jahre,305,139,166
False,8226095,"Walldorf, Stadt",20 - 25 Jahre,704,349,355
False,8226095,"Walldorf, Stadt",25 - 30 Jahre,784,396,388
False,8226095,"Walldorf, Stadt",30 - 35 Jahre,1306,688,618
False,8226095,"Walldorf, Stadt",35 - 40 Jahre,1362,704,658
False,8226095,"Walldorf, Stadt",40 - 45 Jahre,1050,541,509
False,8226095,"Walldorf, Stadt",45 - 50 Jahre,894,440,454
False,8226095,"Walldorf, Stadt",50 - 55 Jahre,905,437,468
False,8226095,"Walldorf, Stadt",55 - 60 Jahre,837,390,447
False,8226095,"Walldorf, Stadt",60 - 65 Jahre,1051,525,526
False,8226095,"Walldorf, Stadt",65 - 75 Jahre,1330,642,688
False,8226095,"Walldorf, Stadt",75 und mehr Jahre,826,287,539
False,8226095,"Walldorf, Stadt",Insgesamt,14077,6948,7129
False,8226096,"Weinheim, Stadt",unter 3 Jahre,1226,617,609
False,8226096,"Weinheim, Stadt",3 -  6 Jahre,1219,629,590
False,8226096,"Weinheim, Stadt",6 - 10 Jahre,1647,864,783
False,8226096,"Weinheim, Stadt",10 - 15 Jahre,2088,1064,1024
False,8226096,"Weinheim, Stadt",15 - 18 Jahre,1175,627,548
False,8226096,"Weinheim, Stadt",18 - 20 Jahre,904,446,458
False,8226096,"Weinheim, Stadt",20 - 25 Jahre,1983,996,987
False,8226096,"Weinheim, Stadt",25 - 30 Jahre,2337,1162,1175
False,8226096,"Weinheim, Stadt",30 - 35 Jahre,3310,1699,1611
False,8226096,"Weinheim, Stadt",35 - 40 Jahre,3614,1842,1772
False,8226096,"Weinheim, Stadt",40 - 45 Jahre,3131,1619,1512
False,8226096,"Weinheim, Stadt",45 - 50 Jahre,2743,1397,1346
False,8226096,"Weinheim, Stadt",50 - 55 Jahre,2726,1294,1432
False,8226096,"Weinheim, Stadt",55 - 60 Jahre,2921,1435,1486
False,8226096,"Weinheim, Stadt",60 - 65 Jahre,3426,1680,1746
False,8226096,"Weinheim, Stadt",65 - 75 Jahre,4488,2111,2377
False,8226096,"Weinheim, Stadt",75 und mehr Jahre,3582,1180,2402
False,8226096,"Weinheim, Stadt",Insgesamt,42520,20662,21858
False,8226097,Wiesenbach,unter 3 Jahre,91,49,42
False,8226097,Wiesenbach,3 -  6 Jahre,124,75,49
False,8226097,Wiesenbach,6 - 10 Jahre,169,79,90
False,8226097,Wiesenbach,10 - 15 Jahre,186,97,89
False,8226097,Wiesenbach,15 - 18 Jahre,102,46,56
False,8226097,Wiesenbach,18 - 20 Jahre,60,37,23
False,8226097,Wiesenbach,20 - 25 Jahre,149,91,58
False,8226097,Wiesenbach,25 - 30 Jahre,128,60,68
False,8226097,Wiesenbach,30 - 35 Jahre,237,108,129
False,8226097,Wiesenbach,35 - 40 Jahre,268,128,140
False,8226097,Wiesenbach,40 - 45 Jahre,246,121,125
False,8226097,Wiesenbach,45 - 50 Jahre,208,98,110
False,8226097,Wiesenbach,50 - 55 Jahre,192,81,111
False,8226097,Wiesenbach,55 - 60 Jahre,217,112,105
False,8226097,Wiesenbach,60 - 65 Jahre,228,105,123
False,8226097,Wiesenbach,65 - 75 Jahre,282,141,141
False,8226097,Wiesenbach,75 und mehr Jahre,179,75,104
False,8226097,Wiesenbach,Insgesamt,3066,1503,1563
False,8226098,"Wiesloch, Stadt",unter 3 Jahre,713,364,349
False,8226098,"Wiesloch, Stadt",3 -  6 Jahre,821,416,405
False,8226098,"Wiesloch, Stadt",6 - 10 Jahre,1117,533,584
False,8226098,"Wiesloch, Stadt",10 - 15 Jahre,1518,783,735
False,8226098,"Wiesloch, Stadt",15 - 18 Jahre,784,395,389
False,8226098,"Wiesloch, Stadt",18 - 20 Jahre,546,307,239
False,8226098,"Wiesloch, Stadt",20 - 25 Jahre,1337,651,686
False,8226098,"Wiesloch, Stadt",25 - 30 Jahre,1423,731,692
False,8226098,"Wiesloch, Stadt",30 - 35 Jahre,2286,1207,1079
False,8226098,"Wiesloch, Stadt",35 - 40 Jahre,2394,1203,1191
False,8226098,"Wiesloch, Stadt",40 - 45 Jahre,2110,1084,1026
False,8226098,"Wiesloch, Stadt",45 - 50 Jahre,1813,952,861
False,8226098,"Wiesloch, Stadt",50 - 55 Jahre,1612,807,805
False,8226098,"Wiesloch, Stadt",55 - 60 Jahre,1456,744,712
False,8226098,"Wiesloch, Stadt",60 - 65 Jahre,1600,824,776
False,8226098,"Wiesloch, Stadt",65 - 75 Jahre,2249,1014,1235
False,8226098,"Wiesloch, Stadt",75 und mehr Jahre,1604,499,1105
False,8226098,"Wiesloch, Stadt",Insgesamt,25383,12514,12869
False,8226099,Wilhelmsfeld,unter 3 Jahre,103,47,56
False,8226099,Wilhelmsfeld,3 -  6 Jahre,122,64,58
False,8226099,Wilhelmsfeld,6 - 10 Jahre,136,68,68
False,8226099,Wilhelmsfeld,10 - 15 Jahre,189,95,94
False,8226099,Wilhelmsfeld,15 - 18 Jahre,85,40,45
False,8226099,Wilhelmsfeld,18 - 20 Jahre,74,39,35
False,8226099,Wilhelmsfeld,20 - 25 Jahre,166,74,92
False,8226099,Wilhelmsfeld,25 - 30 Jahre,168,84,84
False,8226099,Wilhelmsfeld,30 - 35 Jahre,275,143,132
False,8226099,Wilhelmsfeld,35 - 40 Jahre,309,156,153
False,8226099,Wilhelmsfeld,40 - 45 Jahre,261,138,123
False,8226099,Wilhelmsfeld,45 - 50 Jahre,235,125,110
False,8226099,Wilhelmsfeld,50 - 55 Jahre,203,108,95
False,8226099,Wilhelmsfeld,55 - 60 Jahre,202,89,113
False,8226099,Wilhelmsfeld,60 - 65 Jahre,242,123,119
False,8226099,Wilhelmsfeld,65 - 75 Jahre,312,155,157
False,8226099,Wilhelmsfeld,75 und mehr Jahre,223,73,150
False,8226099,Wilhelmsfeld,Insgesamt,3305,1621,1684
False,8226101,Zuzenhausen,unter 3 Jahre,71,30,41
False,8226101,Zuzenhausen,3 -  6 Jahre,66,34,32
False,8226101,Zuzenhausen,6 - 10 Jahre,118,59,59
False,8226101,Zuzenhausen,10 - 15 Jahre,106,51,55
False,8226101,Zuzenhausen,15 - 18 Jahre,62,31,31
False,8226101,Zuzenhausen,18 - 20 Jahre,49,27,22
False,8226101,Zuzenhausen,20 - 25 Jahre,103,47,56
False,8226101,Zuzenhausen,25 - 30 Jahre,122,67,55
False,8226101,Zuzenhausen,30 - 35 Jahre,197,101,96
False,8226101,Zuzenhausen,35 - 40 Jahre,184,90,94
False,8226101,Zuzenhausen,40 - 45 Jahre,147,80,67
False,8226101,Zuzenhausen,45 - 50 Jahre,125,62,63
False,8226101,Zuzenhausen,50 - 55 Jahre,121,58,63
False,8226101,Zuzenhausen,55 - 60 Jahre,119,59,60
False,8226101,Zuzenhausen,60 - 65 Jahre,136,66,70
False,8226101,Zuzenhausen,65 - 75 Jahre,199,88,111
False,8226101,Zuzenhausen,75 und mehr Jahre,111,35,76
False,8226101,Zuzenhausen,Insgesamt,2036,985,1051
False,8226102,Angelbachtal,unter 3 Jahre,162,86,76
False,8226102,Angelbachtal,3 -  6 Jahre,192,93,99
False,8226102,Angelbachtal,6 - 10 Jahre,274,132,142
False,8226102,Angelbachtal,10 - 15 Jahre,311,160,151
False,8226102,Angelbachtal,15 - 18 Jahre,159,79,80
False,8226102,Angelbachtal,18 - 20 Jahre,110,59,51
False,8226102,Angelbachtal,20 - 25 Jahre,207,108,99
False,8226102,Angelbachtal,25 - 30 Jahre,255,115,140
False,8226102,Angelbachtal,30 - 35 Jahre,409,203,206
False,8226102,Angelbachtal,35 - 40 Jahre,508,262,246
False,8226102,Angelbachtal,40 - 45 Jahre,393,217,176
False,8226102,Angelbachtal,45 - 50 Jahre,304,157,147
False,8226102,Angelbachtal,50 - 55 Jahre,282,135,147
False,8226102,Angelbachtal,55 - 60 Jahre,244,127,117
False,8226102,Angelbachtal,60 - 65 Jahre,291,145,146
False,8226102,Angelbachtal,65 - 75 Jahre,378,176,202
False,8226102,Angelbachtal,75 und mehr Jahre,313,82,231
False,8226102,Angelbachtal,Insgesamt,4792,2336,2456
False,8226103,St. Leon-Rot,unter 3 Jahre,377,196,181
False,8226103,St. Leon-Rot,3 -  6 Jahre,466,229,237
False,8226103,St. Leon-Rot,6 - 10 Jahre,658,359,299
False,8226103,St. Leon-Rot,10 - 15 Jahre,814,418,396
False,8226103,St. Leon-Rot,15 - 18 Jahre,420,205,215
False,8226103,St. Leon-Rot,18 - 20 Jahre,306,159,147
False,8226103,St. Leon-Rot,20 - 25 Jahre,561,302,259
False,8226103,St. Leon-Rot,25 - 30 Jahre,643,330,313
False,8226103,St. Leon-Rot,30 - 35 Jahre,997,463,534
False,8226103,St. Leon-Rot,35 - 40 Jahre,1218,627,591
False,8226103,St. Leon-Rot,40 - 45 Jahre,1082,543,539
False,8226103,St. Leon-Rot,45 - 50 Jahre,823,419,404
False,8226103,St. Leon-Rot,50 - 55 Jahre,750,387,363
False,8226103,St. Leon-Rot,55 - 60 Jahre,543,274,269
False,8226103,St. Leon-Rot,60 - 65 Jahre,757,392,365
False,8226103,St. Leon-Rot,65 - 75 Jahre,1043,492,551
False,8226103,St. Leon-Rot,75 und mehr Jahre,571,172,399
False,8226103,St. Leon-Rot,Insgesamt,12029,5967,6062
False,8226104,Lobbach,unter 3 Jahre,82,50,32
False,8226104,Lobbach,3 -  6 Jahre,80,50,30
False,8226104,Lobbach,6 - 10 Jahre,119,55,64
False,8226104,Lobbach,10 - 15 Jahre,155,77,78
False,8226104,Lobbach,15 - 18 Jahre,78,46,32
False,8226104,Lobbach,18 - 20 Jahre,43,24,19
False,8226104,Lobbach,20 - 25 Jahre,134,70,64
False,8226104,Lobbach,25 - 30 Jahre,111,50,61
False,8226104,Lobbach,30 - 35 Jahre,200,108,92
False,8226104,Lobbach,35 - 40 Jahre,203,91,112
False,8226104,Lobbach,40 - 45 Jahre,197,98,99
False,8226104,Lobbach,45 - 50 Jahre,207,107,100
False,8226104,Lobbach,50 - 55 Jahre,154,77,77
False,8226104,Lobbach,55 - 60 Jahre,135,65,70
False,8226104,Lobbach,60 - 65 Jahre,154,88,66
False,8226104,Lobbach,65 - 75 Jahre,196,83,113
False,8226104,Lobbach,75 und mehr Jahre,160,47,113
False,8226104,Lobbach,Insgesamt,2408,1186,1222
False,8226105,Edingen-Neckarhausen,unter 3 Jahre,376,191,185
False,8226105,Edingen-Neckarhausen,3 -  6 Jahre,404,202,202
False,8226105,Edingen-Neckarhausen,6 - 10 Jahre,544,287,257
False,8226105,Edingen-Neckarhausen,10 - 15 Jahre,652,324,328
False,8226105,Edingen-Neckarhausen,15 - 18 Jahre,398,199,199
False,8226105,Edingen-Neckarhausen,18 - 20 Jahre,278,157,121
False,8226105,Edingen-Neckarhausen,20 - 25 Jahre,719,348,371
False,8226105,Edingen-Neckarhausen,25 - 30 Jahre,732,362,370
False,8226105,Edingen-Neckarhausen,30 - 35 Jahre,1069,525,544
False,8226105,Edingen-Neckarhausen,35 - 40 Jahre,1245,632,613
False,8226105,Edingen-Neckarhausen,40 - 45 Jahre,1034,520,514
False,8226105,Edingen-Neckarhausen,45 - 50 Jahre,950,473,477
False,8226105,Edingen-Neckarhausen,50 - 55 Jahre,936,435,501
False,8226105,Edingen-Neckarhausen,55 - 60 Jahre,906,438,468
False,8226105,Edingen-Neckarhausen,60 - 65 Jahre,1014,514,500
False,8226105,Edingen-Neckarhausen,65 - 75 Jahre,1475,703,772
False,8226105,Edingen-Neckarhausen,75 und mehr Jahre,1111,387,724
False,8226105,Edingen-Neckarhausen,Insgesamt,13843,6697,7146
False,8226106,Helmstadt-Bargen,unter 3 Jahre,112,54,58
False,8226106,Helmstadt-Bargen,3 -  6 Jahre,133,57,76
False,8226106,Helmstadt-Bargen,6 - 10 Jahre,222,118,104
False,8226106,Helmstadt-Bargen,10 - 15 Jahre,298,149,149
False,8226106,Helmstadt-Bargen,15 - 18 Jahre,185,97,88
False,8226106,Helmstadt-Bargen,18 - 20 Jahre,96,55,41
False,8226106,Helmstadt-Bargen,20 - 25 Jahre,217,106,111
False,8226106,Helmstadt-Bargen,25 - 30 Jahre,180,95,85
False,8226106,Helmstadt-Bargen,30 - 35 Jahre,257,126,131
False,8226106,Helmstadt-Bargen,35 - 40 Jahre,350,183,167
False,8226106,Helmstadt-Bargen,40 - 45 Jahre,375,180,195
False,8226106,Helmstadt-Bargen,45 - 50 Jahre,272,139,133
False,8226106,Helmstadt-Bargen,50 - 55 Jahre,234,122,112
False,8226106,Helmstadt-Bargen,55 - 60 Jahre,167,97,70
False,8226106,Helmstadt-Bargen,60 - 65 Jahre,238,122,116
False,8226106,Helmstadt-Bargen,65 - 75 Jahre,353,160,193
False,8226106,Helmstadt-Bargen,75 und mehr Jahre,210,69,141
False,8226106,Helmstadt-Bargen,Insgesamt,3899,1929,1970
False,8226107,Hirschberg an der Bergstraße,unter 3 Jahre,254,134,120
False,8226107,Hirschberg an der Bergstraße,3 -  6 Jahre,222,117,105
False,8226107,Hirschberg an der Bergstraße,6 - 10 Jahre,335,164,171
False,8226107,Hirschberg an der Bergstraße,10 - 15 Jahre,417,219,198
False,8226107,Hirschberg an der Bergstraße,15 - 18 Jahre,274,129,145
False,8226107,Hirschberg an der Bergstraße,18 - 20 Jahre,200,87,113
False,8226107,Hirschberg an der Bergstraße,20 - 25 Jahre,492,258,234
False,8226107,Hirschberg an der Bergstraße,25 - 30 Jahre,520,238,282
False,8226107,Hirschberg an der Bergstraße,30 - 35 Jahre,759,399,360
False,8226107,Hirschberg an der Bergstraße,35 - 40 Jahre,898,459,439
False,8226107,Hirschberg an der Bergstraße,40 - 45 Jahre,691,335,356
False,8226107,Hirschberg an der Bergstraße,45 - 50 Jahre,602,282,320
False,8226107,Hirschberg an der Bergstraße,50 - 55 Jahre,678,312,366
False,8226107,Hirschberg an der Bergstraße,55 - 60 Jahre,703,339,364
False,8226107,Hirschberg an der Bergstraße,60 - 65 Jahre,757,377,380
False,8226107,Hirschberg an der Bergstraße,65 - 75 Jahre,963,491,472
False,8226107,Hirschberg an der Bergstraße,75 und mehr Jahre,660,219,441
False,8226107,Hirschberg an der Bergstraße,Insgesamt,9425,4559,4866
False,8231,Stadtkreis Pforzheim,unter 3 Jahre,3448,1750,1698
False,8231,Stadtkreis Pforzheim,3 -  6 Jahre,3541,1791,1750
False,8231,Stadtkreis Pforzheim,6 - 10 Jahre,4722,2386,2336
False,8231,Stadtkreis Pforzheim,10 - 15 Jahre,6190,3250,2940
False,8231,Stadtkreis Pforzheim,15 - 18 Jahre,3596,1848,1748
False,8231,Stadtkreis Pforzheim,18 - 20 Jahre,2698,1352,1346
False,8231,Stadtkreis Pforzheim,20 - 25 Jahre,6793,3332,3461
False,8231,Stadtkreis Pforzheim,25 - 30 Jahre,7319,3680,3639
False,8231,Stadtkreis Pforzheim,30 - 35 Jahre,9131,4745,4386
False,8231,Stadtkreis Pforzheim,35 - 40 Jahre,9792,5127,4665
False,8231,Stadtkreis Pforzheim,40 - 45 Jahre,8650,4384,4266
False,8231,Stadtkreis Pforzheim,45 - 50 Jahre,7590,3710,3880
False,8231,Stadtkreis Pforzheim,50 - 55 Jahre,7014,3314,3700
False,8231,Stadtkreis Pforzheim,55 - 60 Jahre,6920,3315,3605
False,8231,Stadtkreis Pforzheim,60 - 65 Jahre,8210,3941,4269
False,8231,Stadtkreis Pforzheim,65 - 75 Jahre,11730,5066,6664
False,8231,Stadtkreis Pforzheim,75 und mehr Jahre,9812,2844,6968
False,8231,Stadtkreis Pforzheim,Insgesamt,117156,55835,61321
False,8231000,"Pforzheim, Stadt",unter 3 Jahre,3448,1750,1698
False,8231000,"Pforzheim, Stadt",3 -  6 Jahre,3541,1791,1750
False,8231000,"Pforzheim, Stadt",6 - 10 Jahre,4722,2386,2336
False,8231000,"Pforzheim, Stadt",10 - 15 Jahre,6190,3250,2940
False,8231000,"Pforzheim, Stadt",15 - 18 Jahre,3596,1848,1748
False,8231000,"Pforzheim, Stadt",18 - 20 Jahre,2698,1352,1346
False,8231000,"Pforzheim, Stadt",20 - 25 Jahre,6793,3332,3461
False,8231000,"Pforzheim, Stadt",25 - 30 Jahre,7319,3680,3639
False,8231000,"Pforzheim, Stadt",30 - 35 Jahre,9131,4745,4386
False,8231000,"Pforzheim, Stadt",35 - 40 Jahre,9792,5127,4665
False,8231000,"Pforzheim, Stadt",40 - 45 Jahre,8650,4384,4266
False,8231000,"Pforzheim, Stadt",45 - 50 Jahre,7590,3710,3880
False,8231000,"Pforzheim, Stadt",50 - 55 Jahre,7014,3314,3700
False,8231000,"Pforzheim, Stadt",55 - 60 Jahre,6920,3315,3605
False,8231000,"Pforzheim, Stadt",60 - 65 Jahre,8210,3941,4269
False,8231000,"Pforzheim, Stadt",65 - 75 Jahre,11730,5066,6664
False,8231000,"Pforzheim, Stadt",75 und mehr Jahre,9812,2844,6968
False,8231000,"Pforzheim, Stadt",Insgesamt,117156,55835,61321
False,8235,Landkreis Calw,unter 3 Jahre,5203,2745,2458
False,8235,Landkreis Calw,3 -  6 Jahre,5609,2819,2790
False,8235,Landkreis Calw,6 - 10 Jahre,7820,4017,3803
False,8235,Landkreis Calw,10 - 15 Jahre,10437,5376,5061
False,8235,Landkreis Calw,15 - 18 Jahre,5650,2852,2798
False,8235,Landkreis Calw,18 - 20 Jahre,3833,1966,1867
False,8235,Landkreis Calw,20 - 25 Jahre,8876,4598,4278
False,8235,Landkreis Calw,25 - 30 Jahre,9229,4664,4565
False,8235,Landkreis Calw,30 - 35 Jahre,12622,6394,6228
False,8235,Landkreis Calw,35 - 40 Jahre,13990,7167,6823
False,8235,Landkreis Calw,40 - 45 Jahre,12321,6233,6088
False,8235,Landkreis Calw,45 - 50 Jahre,10715,5394,5321
False,8235,Landkreis Calw,50 - 55 Jahre,9109,4650,4459
False,8235,Landkreis Calw,55 - 60 Jahre,8336,4287,4049
False,8235,Landkreis Calw,60 - 65 Jahre,10179,4843,5336
False,8235,Landkreis Calw,65 - 75 Jahre,14080,6539,7541
False,8235,Landkreis Calw,75 und mehr Jahre,10950,3355,7595
False,8235,Landkreis Calw,Insgesamt,158959,77899,81060
False,8235006,"Altensteig, Stadt",unter 3 Jahre,385,195,190
False,8235006,"Altensteig, Stadt",3 -  6 Jahre,424,205,219
False,8235006,"Altensteig, Stadt",6 - 10 Jahre,582,277,305
False,8235006,"Altensteig, Stadt",10 - 15 Jahre,823,417,406
False,8235006,"Altensteig, Stadt",15 - 18 Jahre,422,206,216
False,8235006,"Altensteig, Stadt",18 - 20 Jahre,284,127,157
False,8235006,"Altensteig, Stadt",20 - 25 Jahre,671,342,329
False,8235006,"Altensteig, Stadt",25 - 30 Jahre,651,350,301
False,8235006,"Altensteig, Stadt",30 - 35 Jahre,858,437,421
False,8235006,"Altensteig, Stadt",35 - 40 Jahre,863,435,428
False,8235006,"Altensteig, Stadt",40 - 45 Jahre,798,396,402
False,8235006,"Altensteig, Stadt",45 - 50 Jahre,657,339,318
False,8235006,"Altensteig, Stadt",50 - 55 Jahre,557,298,259
False,8235006,"Altensteig, Stadt",55 - 60 Jahre,521,267,254
False,8235006,"Altensteig, Stadt",60 - 65 Jahre,672,337,335
False,8235006,"Altensteig, Stadt",65 - 75 Jahre,968,439,529
False,8235006,"Altensteig, Stadt",75 und mehr Jahre,791,227,564
False,8235006,"Altensteig, Stadt",Insgesamt,10927,5294,5633
False,8235007,Althengstett,unter 3 Jahre,301,166,135
False,8235007,Althengstett,3 -  6 Jahre,340,168,172
False,8235007,Althengstett,6 - 10 Jahre,447,218,229
False,8235007,Althengstett,10 - 15 Jahre,613,311,302
False,8235007,Althengstett,15 - 18 Jahre,282,139,143
False,8235007,Althengstett,18 - 20 Jahre,202,115,87
False,8235007,Althengstett,20 - 25 Jahre,443,220,223
False,8235007,Althengstett,25 - 30 Jahre,462,229,233
False,8235007,Althengstett,30 - 35 Jahre,610,293,317
False,8235007,Althengstett,35 - 40 Jahre,806,404,402
False,8235007,Althengstett,40 - 45 Jahre,679,349,330
False,8235007,Althengstett,45 - 50 Jahre,605,291,314
False,8235007,Althengstett,50 - 55 Jahre,477,252,225
False,8235007,Althengstett,55 - 60 Jahre,375,194,181
False,8235007,Althengstett,60 - 65 Jahre,405,214,191
False,8235007,Althengstett,65 - 75 Jahre,516,249,267
False,8235007,Althengstett,75 und mehr Jahre,334,121,213
False,8235007,Althengstett,Insgesamt,7897,3933,3964
False,8235008,"Bad Liebenzell, Stadt",unter 3 Jahre,258,126,132
False,8235008,"Bad Liebenzell, Stadt",3 -  6 Jahre,273,123,150
False,8235008,"Bad Liebenzell, Stadt",6 - 10 Jahre,388,235,153
False,8235008,"Bad Liebenzell, Stadt",10 - 15 Jahre,565,316,249
False,8235008,"Bad Liebenzell, Stadt",15 - 18 Jahre,340,179,161
False,8235008,"Bad Liebenzell, Stadt",18 - 20 Jahre,222,117,105
False,8235008,"Bad Liebenzell, Stadt",20 - 25 Jahre,557,286,271
False,8235008,"Bad Liebenzell, Stadt",25 - 30 Jahre,568,258,310
False,8235008,"Bad Liebenzell, Stadt",30 - 35 Jahre,804,409,395
False,8235008,"Bad Liebenzell, Stadt",35 - 40 Jahre,887,448,439
False,8235008,"Bad Liebenzell, Stadt",40 - 45 Jahre,730,344,386
False,8235008,"Bad Liebenzell, Stadt",45 - 50 Jahre,648,339,309
False,8235008,"Bad Liebenzell, Stadt",50 - 55 Jahre,518,264,254
False,8235008,"Bad Liebenzell, Stadt",55 - 60 Jahre,505,237,268
False,8235008,"Bad Liebenzell, Stadt",60 - 65 Jahre,564,240,324
False,8235008,"Bad Liebenzell, Stadt",65 - 75 Jahre,835,353,482
False,8235008,"Bad Liebenzell, Stadt",75 und mehr Jahre,821,269,552
False,8235008,"Bad Liebenzell, Stadt",Insgesamt,9483,4543,4940
False,8235018,Dobel,unter 3 Jahre,69,35,34
False,8235018,Dobel,3 -  6 Jahre,68,37,31
False,8235018,Dobel,6 - 10 Jahre,104,62,42
False,8235018,Dobel,10 - 15 Jahre,136,65,71
False,8235018,Dobel,15 - 18 Jahre,79,47,32
False,8235018,Dobel,18 - 20 Jahre,59,28,31
False,8235018,Dobel,20 - 25 Jahre,89,56,33
False,8235018,Dobel,25 - 30 Jahre,88,38,50
False,8235018,Dobel,30 - 35 Jahre,156,69,87
False,8235018,Dobel,35 - 40 Jahre,199,104,95
False,8235018,Dobel,40 - 45 Jahre,179,89,90
False,8235018,Dobel,45 - 50 Jahre,151,85,66
False,8235018,Dobel,50 - 55 Jahre,136,67,69
False,8235018,Dobel,55 - 60 Jahre,101,43,58
False,8235018,Dobel,60 - 65 Jahre,156,87,69
False,8235018,Dobel,65 - 75 Jahre,239,103,136
False,8235018,Dobel,75 und mehr Jahre,232,76,156
False,8235018,Dobel,Insgesamt,2241,1091,1150
False,8235020,Ebhausen,unter 3 Jahre,174,90,84
False,8235020,Ebhausen,3 -  6 Jahre,189,102,87
False,8235020,Ebhausen,6 - 10 Jahre,319,165,154
False,8235020,Ebhausen,10 - 15 Jahre,369,162,207
False,8235020,Ebhausen,15 - 18 Jahre,211,116,95
False,8235020,Ebhausen,18 - 20 Jahre,120,54,66
False,8235020,Ebhausen,20 - 25 Jahre,248,126,122
False,8235020,Ebhausen,25 - 30 Jahre,280,150,130
False,8235020,Ebhausen,30 - 35 Jahre,417,217,200
False,8235020,Ebhausen,35 - 40 Jahre,468,237,231
False,8235020,Ebhausen,40 - 45 Jahre,392,213,179
False,8235020,Ebhausen,45 - 50 Jahre,281,142,139
False,8235020,Ebhausen,50 - 55 Jahre,224,119,105
False,8235020,Ebhausen,55 - 60 Jahre,202,96,106
False,8235020,Ebhausen,60 - 65 Jahre,268,133,135
False,8235020,Ebhausen,65 - 75 Jahre,395,183,212
False,8235020,Ebhausen,75 und mehr Jahre,223,70,153
False,8235020,Ebhausen,Insgesamt,4780,2375,2405
False,8235022,Egenhausen,unter 3 Jahre,96,42,54
False,8235022,Egenhausen,3 -  6 Jahre,96,50,46
False,8235022,Egenhausen,6 - 10 Jahre,124,61,63
False,8235022,Egenhausen,10 - 15 Jahre,155,74,81
False,8235022,Egenhausen,15 - 18 Jahre,75,39,36
False,8235022,Egenhausen,18 - 20 Jahre,52,27,25
False,8235022,Egenhausen,20 - 25 Jahre,91,46,45
False,8235022,Egenhausen,25 - 30 Jahre,106,47,59
False,8235022,Egenhausen,30 - 35 Jahre,155,77,78
False,8235022,Egenhausen,35 - 40 Jahre,180,99,81
False,8235022,Egenhausen,40 - 45 Jahre,131,64,67
False,8235022,Egenhausen,45 - 50 Jahre,101,54,47
False,8235022,Egenhausen,50 - 55 Jahre,100,51,49
False,8235022,Egenhausen,55 - 60 Jahre,96,48,48
False,8235022,Egenhausen,60 - 65 Jahre,131,64,67
False,8235022,Egenhausen,65 - 75 Jahre,159,76,83
False,8235022,Egenhausen,75 und mehr Jahre,88,28,60
False,8235022,Egenhausen,Insgesamt,1936,947,989
False,8235025,Enzklösterle,unter 3 Jahre,33,21,12
False,8235025,Enzklösterle,3 -  6 Jahre,50,23,27
False,8235025,Enzklösterle,6 - 10 Jahre,57,27,30
False,8235025,Enzklösterle,10 - 15 Jahre,85,52,33
False,8235025,Enzklösterle,15 - 18 Jahre,36,22,14
False,8235025,Enzklösterle,18 - 20 Jahre,29,17,12
False,8235025,Enzklösterle,20 - 25 Jahre,77,37,40
False,8235025,Enzklösterle,25 - 30 Jahre,60,29,31
False,8235025,Enzklösterle,30 - 35 Jahre,94,39,55
False,8235025,Enzklösterle,35 - 40 Jahre,86,47,39
False,8235025,Enzklösterle,40 - 45 Jahre,91,46,45
False,8235025,Enzklösterle,45 - 50 Jahre,70,30,40
False,8235025,Enzklösterle,50 - 55 Jahre,82,39,43
False,8235025,Enzklösterle,55 - 60 Jahre,62,31,31
False,8235025,Enzklösterle,60 - 65 Jahre,111,54,57
False,8235025,Enzklösterle,65 - 75 Jahre,152,65,87
False,8235025,Enzklösterle,75 und mehr Jahre,114,38,76
False,8235025,Enzklösterle,Insgesamt,1289,617,672
False,8235029,Gechingen,unter 3 Jahre,158,86,72
False,8235029,Gechingen,3 -  6 Jahre,154,78,76
False,8235029,Gechingen,6 - 10 Jahre,205,109,96
False,8235029,Gechingen,10 - 15 Jahre,253,128,125
False,8235029,Gechingen,15 - 18 Jahre,147,71,76
False,8235029,Gechingen,18 - 20 Jahre,78,38,40
False,8235029,Gechingen,20 - 25 Jahre,195,104,91
False,8235029,Gechingen,25 - 30 Jahre,253,115,138
False,8235029,Gechingen,30 - 35 Jahre,356,174,182
False,8235029,Gechingen,35 - 40 Jahre,386,191,195
False,8235029,Gechingen,40 - 45 Jahre,338,179,159
False,8235029,Gechingen,45 - 50 Jahre,277,136,141
False,8235029,Gechingen,50 - 55 Jahre,212,97,115
False,8235029,Gechingen,55 - 60 Jahre,219,116,103
False,8235029,Gechingen,60 - 65 Jahre,239,118,121
False,8235029,Gechingen,65 - 75 Jahre,279,137,142
False,8235029,Gechingen,75 und mehr Jahre,174,63,111
False,8235029,Gechingen,Insgesamt,3923,1940,1983
False,8235032,"Haiterbach, Stadt",unter 3 Jahre,216,108,108
False,8235032,"Haiterbach, Stadt",3 -  6 Jahre,245,119,126
False,8235032,"Haiterbach, Stadt",6 - 10 Jahre,337,159,178
False,8235032,"Haiterbach, Stadt",10 - 15 Jahre,385,189,196
False,8235032,"Haiterbach, Stadt",15 - 18 Jahre,200,102,98
False,8235032,"Haiterbach, Stadt",18 - 20 Jahre,150,67,83
False,8235032,"Haiterbach, Stadt",20 - 25 Jahre,336,181,155
False,8235032,"Haiterbach, Stadt",25 - 30 Jahre,401,218,183
False,8235032,"Haiterbach, Stadt",30 - 35 Jahre,466,240,226
False,8235032,"Haiterbach, Stadt",35 - 40 Jahre,544,295,249
False,8235032,"Haiterbach, Stadt",40 - 45 Jahre,416,213,203
False,8235032,"Haiterbach, Stadt",45 - 50 Jahre,389,198,191
False,8235032,"Haiterbach, Stadt",50 - 55 Jahre,304,155,149
False,8235032,"Haiterbach, Stadt",55 - 60 Jahre,278,134,144
False,8235032,"Haiterbach, Stadt",60 - 65 Jahre,334,162,172
False,8235032,"Haiterbach, Stadt",65 - 75 Jahre,494,246,248
False,8235032,"Haiterbach, Stadt",75 und mehr Jahre,334,75,259
False,8235032,"Haiterbach, Stadt",Insgesamt,5829,2861,2968
False,8235033,"Bad Herrenalb, Stadt",unter 3 Jahre,171,93,78
False,8235033,"Bad Herrenalb, Stadt",3 -  6 Jahre,195,103,92
False,8235033,"Bad Herrenalb, Stadt",6 - 10 Jahre,267,125,142
False,8235033,"Bad Herrenalb, Stadt",10 - 15 Jahre,386,198,188
False,8235033,"Bad Herrenalb, Stadt",15 - 18 Jahre,192,96,96
False,8235033,"Bad Herrenalb, Stadt",18 - 20 Jahre,158,67,91
False,8235033,"Bad Herrenalb, Stadt",20 - 25 Jahre,331,159,172
False,8235033,"Bad Herrenalb, Stadt",25 - 30 Jahre,311,142,169
False,8235033,"Bad Herrenalb, Stadt",30 - 35 Jahre,513,254,259
False,8235033,"Bad Herrenalb, Stadt",35 - 40 Jahre,566,264,302
False,8235033,"Bad Herrenalb, Stadt",40 - 45 Jahre,537,272,265
False,8235033,"Bad Herrenalb, Stadt",45 - 50 Jahre,469,240,229
False,8235033,"Bad Herrenalb, Stadt",50 - 55 Jahre,431,212,219
False,8235033,"Bad Herrenalb, Stadt",55 - 60 Jahre,394,193,201
False,8235033,"Bad Herrenalb, Stadt",60 - 65 Jahre,586,242,344
False,8235033,"Bad Herrenalb, Stadt",65 - 75 Jahre,878,379,499
False,8235033,"Bad Herrenalb, Stadt",75 und mehr Jahre,911,303,608
False,8235033,"Bad Herrenalb, Stadt",Insgesamt,7296,3342,3954
False,8235035,Höfen an der Enz,unter 3 Jahre,55,29,26
False,8235035,Höfen an der Enz,3 -  6 Jahre,65,32,33
False,8235035,Höfen an der Enz,6 - 10 Jahre,69,41,28
False,8235035,Höfen an der Enz,10 - 15 Jahre,96,47,49
False,8235035,Höfen an der Enz,15 - 18 Jahre,74,34,40
False,8235035,Höfen an der Enz,18 - 20 Jahre,37,19,18
False,8235035,Höfen an der Enz,20 - 25 Jahre,82,41,41
False,8235035,Höfen an der Enz,25 - 30 Jahre,102,50,52
False,8235035,Höfen an der Enz,30 - 35 Jahre,141,78,63
False,8235035,Höfen an der Enz,35 - 40 Jahre,145,66,79
False,8235035,Höfen an der Enz,40 - 45 Jahre,145,74,71
False,8235035,Höfen an der Enz,45 - 50 Jahre,125,70,55
False,8235035,Höfen an der Enz,50 - 55 Jahre,94,50,44
False,8235035,Höfen an der Enz,55 - 60 Jahre,84,39,45
False,8235035,Höfen an der Enz,60 - 65 Jahre,115,51,64
False,8235035,Höfen an der Enz,65 - 75 Jahre,180,78,102
False,8235035,Höfen an der Enz,75 und mehr Jahre,103,36,67
False,8235035,Höfen an der Enz,Insgesamt,1712,835,877
False,8235046,"Nagold, Stadt",unter 3 Jahre,731,402,329
False,8235046,"Nagold, Stadt",3 -  6 Jahre,724,347,377
False,8235046,"Nagold, Stadt",6 - 10 Jahre,1054,543,511
False,8235046,"Nagold, Stadt",10 - 15 Jahre,1424,733,691
False,8235046,"Nagold, Stadt",15 - 18 Jahre,815,394,421
False,8235046,"Nagold, Stadt",18 - 20 Jahre,569,304,265
False,8235046,"Nagold, Stadt",20 - 25 Jahre,1481,723,758
False,8235046,"Nagold, Stadt",25 - 30 Jahre,1438,757,681
False,8235046,"Nagold, Stadt",30 - 35 Jahre,1794,906,888
False,8235046,"Nagold, Stadt",35 - 40 Jahre,1855,899,956
False,8235046,"Nagold, Stadt",40 - 45 Jahre,1698,848,850
False,8235046,"Nagold, Stadt",45 - 50 Jahre,1692,815,877
False,8235046,"Nagold, Stadt",50 - 55 Jahre,1381,693,688
False,8235046,"Nagold, Stadt",55 - 60 Jahre,1256,667,589
False,8235046,"Nagold, Stadt",60 - 65 Jahre,1439,707,732
False,8235046,"Nagold, Stadt",65 - 75 Jahre,1987,942,1045
False,8235046,"Nagold, Stadt",75 und mehr Jahre,1469,445,1024
False,8235046,"Nagold, Stadt",Insgesamt,22807,11125,11682
False,8235047,"Neubulach, Stadt",unter 3 Jahre,190,104,86
False,8235047,"Neubulach, Stadt",3 -  6 Jahre,209,103,106
False,8235047,"Neubulach, Stadt",6 - 10 Jahre,355,187,168
False,8235047,"Neubulach, Stadt",10 - 15 Jahre,373,192,181
False,8235047,"Neubulach, Stadt",15 - 18 Jahre,197,107,90
False,8235047,"Neubulach, Stadt",18 - 20 Jahre,119,57,62
False,8235047,"Neubulach, Stadt",20 - 25 Jahre,266,151,115
False,8235047,"Neubulach, Stadt",25 - 30 Jahre,305,138,167
False,8235047,"Neubulach, Stadt",30 - 35 Jahre,401,221,180
False,8235047,"Neubulach, Stadt",35 - 40 Jahre,496,261,235
False,8235047,"Neubulach, Stadt",40 - 45 Jahre,370,186,184
False,8235047,"Neubulach, Stadt",45 - 50 Jahre,358,189,169
False,8235047,"Neubulach, Stadt",50 - 55 Jahre,255,133,122
False,8235047,"Neubulach, Stadt",55 - 60 Jahre,223,117,106
False,8235047,"Neubulach, Stadt",60 - 65 Jahre,301,142,159
False,8235047,"Neubulach, Stadt",65 - 75 Jahre,475,220,255
False,8235047,"Neubulach, Stadt",75 und mehr Jahre,355,106,249
False,8235047,"Neubulach, Stadt",Insgesamt,5248,2614,2634
False,8235050,Neuweiler,unter 3 Jahre,109,56,53
False,8235050,Neuweiler,3 -  6 Jahre,116,61,55
False,8235050,Neuweiler,6 - 10 Jahre,187,94,93
False,8235050,Neuweiler,10 - 15 Jahre,253,150,103
False,8235050,Neuweiler,15 - 18 Jahre,109,46,63
False,8235050,Neuweiler,18 - 20 Jahre,80,46,34
False,8235050,Neuweiler,20 - 25 Jahre,159,92,67
False,8235050,Neuweiler,25 - 30 Jahre,162,73,89
False,8235050,Neuweiler,30 - 35 Jahre,249,126,123
False,8235050,Neuweiler,35 - 40 Jahre,308,169,139
False,8235050,Neuweiler,40 - 45 Jahre,257,127,130
False,8235050,Neuweiler,45 - 50 Jahre,174,97,77
False,8235050,Neuweiler,50 - 55 Jahre,149,79,70
False,8235050,Neuweiler,55 - 60 Jahre,150,91,59
False,8235050,Neuweiler,60 - 65 Jahre,211,107,104
False,8235050,Neuweiler,65 - 75 Jahre,280,127,153
False,8235050,Neuweiler,75 und mehr Jahre,167,51,116
False,8235050,Neuweiler,Insgesamt,3120,1592,1528
False,8235055,Oberreichenbach,unter 3 Jahre,119,73,46
False,8235055,Oberreichenbach,3 -  6 Jahre,108,54,54
False,8235055,Oberreichenbach,6 - 10 Jahre,133,76,57
False,8235055,Oberreichenbach,10 - 15 Jahre,208,100,108
False,8235055,Oberreichenbach,15 - 18 Jahre,118,68,50
False,8235055,Oberreichenbach,18 - 20 Jahre,70,35,35
False,8235055,Oberreichenbach,20 - 25 Jahre,141,89,52
False,8235055,Oberreichenbach,25 - 30 Jahre,138,71,67
False,8235055,Oberreichenbach,30 - 35 Jahre,245,117,128
False,8235055,Oberreichenbach,35 - 40 Jahre,253,115,138
False,8235055,Oberreichenbach,40 - 45 Jahre,242,124,118
False,8235055,Oberreichenbach,45 - 50 Jahre,184,97,87
False,8235055,Oberreichenbach,50 - 55 Jahre,173,80,93
False,8235055,Oberreichenbach,55 - 60 Jahre,128,67,61
False,8235055,Oberreichenbach,60 - 65 Jahre,170,77,93
False,8235055,Oberreichenbach,65 - 75 Jahre,230,108,122
False,8235055,Oberreichenbach,75 und mehr Jahre,172,53,119
False,8235055,Oberreichenbach,Insgesamt,2832,1404,1428
False,8235057,Ostelsheim,unter 3 Jahre,97,48,49
False,8235057,Ostelsheim,3 -  6 Jahre,97,42,55
False,8235057,Ostelsheim,6 - 10 Jahre,113,67,46
False,8235057,Ostelsheim,10 - 15 Jahre,172,77,95
False,8235057,Ostelsheim,15 - 18 Jahre,81,44,37
False,8235057,Ostelsheim,18 - 20 Jahre,60,35,25
False,8235057,Ostelsheim,20 - 25 Jahre,122,64,58
False,8235057,Ostelsheim,25 - 30 Jahre,138,71,67
False,8235057,Ostelsheim,30 - 35 Jahre,210,101,109
False,8235057,Ostelsheim,35 - 40 Jahre,217,111,106
False,8235057,Ostelsheim,40 - 45 Jahre,216,113,103
False,8235057,Ostelsheim,45 - 50 Jahre,157,80,77
False,8235057,Ostelsheim,50 - 55 Jahre,113,51,62
False,8235057,Ostelsheim,55 - 60 Jahre,117,57,60
False,8235057,Ostelsheim,60 - 65 Jahre,173,83,90
False,8235057,Ostelsheim,65 - 75 Jahre,179,95,84
False,8235057,Ostelsheim,75 und mehr Jahre,88,27,61
False,8235057,Ostelsheim,Insgesamt,2350,1166,1184
False,8235060,Rohrdorf,unter 3 Jahre,54,35,19
False,8235060,Rohrdorf,3 -  6 Jahre,60,27,33
False,8235060,Rohrdorf,6 - 10 Jahre,92,43,49
False,8235060,Rohrdorf,10 - 15 Jahre,119,68,51
False,8235060,Rohrdorf,15 - 18 Jahre,62,34,28
False,8235060,Rohrdorf,18 - 20 Jahre,59,34,25
False,8235060,Rohrdorf,20 - 25 Jahre,129,63,66
False,8235060,Rohrdorf,25 - 30 Jahre,111,48,63
False,8235060,Rohrdorf,30 - 35 Jahre,159,86,73
False,8235060,Rohrdorf,35 - 40 Jahre,180,104,76
False,8235060,Rohrdorf,40 - 45 Jahre,163,81,82
False,8235060,Rohrdorf,45 - 50 Jahre,138,71,67
False,8235060,Rohrdorf,50 - 55 Jahre,127,61,66
False,8235060,Rohrdorf,55 - 60 Jahre,107,62,45
False,8235060,Rohrdorf,60 - 65 Jahre,129,66,63
False,8235060,Rohrdorf,65 - 75 Jahre,187,86,101
False,8235060,Rohrdorf,75 und mehr Jahre,130,43,87
False,8235060,Rohrdorf,Insgesamt,2006,1012,994
False,8235065,Schömberg,unter 3 Jahre,222,112,110
False,8235065,Schömberg,3 -  6 Jahre,293,156,137
False,8235065,Schömberg,6 - 10 Jahre,369,184,185
False,8235065,Schömberg,10 - 15 Jahre,535,298,237
False,8235065,Schömberg,15 - 18 Jahre,308,149,159
False,8235065,Schömberg,18 - 20 Jahre,187,110,77
False,8235065,Schömberg,20 - 25 Jahre,441,230,211
False,8235065,Schömberg,25 - 30 Jahre,446,230,216
False,8235065,Schömberg,30 - 35 Jahre,713,357,356
False,8235065,Schömberg,35 - 40 Jahre,967,543,424
False,8235065,Schömberg,40 - 45 Jahre,755,417,338
False,8235065,Schömberg,45 - 50 Jahre,567,281,286
False,8235065,Schömberg,50 - 55 Jahre,498,275,223
False,8235065,Schömberg,55 - 60 Jahre,390,201,189
False,8235065,Schömberg,60 - 65 Jahre,521,234,287
False,8235065,Schömberg,65 - 75 Jahre,694,329,365
False,8235065,Schömberg,75 und mehr Jahre,609,188,421
False,8235065,Schömberg,Insgesamt,8515,4294,4221
False,8235066,Simmersfeld,unter 3 Jahre,77,46,31
False,8235066,Simmersfeld,3 -  6 Jahre,99,48,51
False,8235066,Simmersfeld,6 - 10 Jahre,102,63,39
False,8235066,Simmersfeld,10 - 15 Jahre,186,100,86
False,8235066,Simmersfeld,15 - 18 Jahre,90,49,41
False,8235066,Simmersfeld,18 - 20 Jahre,46,24,22
False,8235066,Simmersfeld,20 - 25 Jahre,105,56,49
False,8235066,Simmersfeld,25 - 30 Jahre,110,62,48
False,8235066,Simmersfeld,30 - 35 Jahre,190,101,89
False,8235066,Simmersfeld,35 - 40 Jahre,205,102,103
False,8235066,Simmersfeld,40 - 45 Jahre,166,86,80
False,8235066,Simmersfeld,45 - 50 Jahre,149,86,63
False,8235066,Simmersfeld,50 - 55 Jahre,114,63,51
False,8235066,Simmersfeld,55 - 60 Jahre,105,54,51
False,8235066,Simmersfeld,60 - 65 Jahre,105,48,57
False,8235066,Simmersfeld,65 - 75 Jahre,169,75,94
False,8235066,Simmersfeld,75 und mehr Jahre,114,37,77
False,8235066,Simmersfeld,Insgesamt,2132,1100,1032
False,8235067,Simmozheim,unter 3 Jahre,119,66,53
False,8235067,Simmozheim,3 -  6 Jahre,117,61,56
False,8235067,Simmozheim,6 - 10 Jahre,159,71,88
False,8235067,Simmozheim,10 - 15 Jahre,189,95,94
False,8235067,Simmozheim,15 - 18 Jahre,96,49,47
False,8235067,Simmozheim,18 - 20 Jahre,48,21,27
False,8235067,Simmozheim,20 - 25 Jahre,154,70,84
False,8235067,Simmozheim,25 - 30 Jahre,161,73,88
False,8235067,Simmozheim,30 - 35 Jahre,221,118,103
False,8235067,Simmozheim,35 - 40 Jahre,234,104,130
False,8235067,Simmozheim,40 - 45 Jahre,230,121,109
False,8235067,Simmozheim,45 - 50 Jahre,207,104,103
False,8235067,Simmozheim,50 - 55 Jahre,158,90,68
False,8235067,Simmozheim,55 - 60 Jahre,124,64,60
False,8235067,Simmozheim,60 - 65 Jahre,171,80,91
False,8235067,Simmozheim,65 - 75 Jahre,160,79,81
False,8235067,Simmozheim,75 und mehr Jahre,106,34,72
False,8235067,Simmozheim,Insgesamt,2654,1300,1354
False,8235073,Unterreichenbach,unter 3 Jahre,61,32,29
False,8235073,Unterreichenbach,3 -  6 Jahre,92,50,42
False,8235073,Unterreichenbach,6 - 10 Jahre,97,44,53
False,8235073,Unterreichenbach,10 - 15 Jahre,137,63,74
False,8235073,Unterreichenbach,15 - 18 Jahre,86,52,34
False,8235073,Unterreichenbach,18 - 20 Jahre,56,29,27
False,8235073,Unterreichenbach,20 - 25 Jahre,104,57,47
False,8235073,Unterreichenbach,25 - 30 Jahre,110,55,55
False,8235073,Unterreichenbach,30 - 35 Jahre,201,102,99
False,8235073,Unterreichenbach,35 - 40 Jahre,200,108,92
False,8235073,Unterreichenbach,40 - 45 Jahre,178,93,85
False,8235073,Unterreichenbach,45 - 50 Jahre,142,67,75
False,8235073,Unterreichenbach,50 - 55 Jahre,146,74,72
False,8235073,Unterreichenbach,55 - 60 Jahre,129,62,67
False,8235073,Unterreichenbach,60 - 65 Jahre,153,73,80
False,8235073,Unterreichenbach,65 - 75 Jahre,187,80,107
False,8235073,Unterreichenbach,75 und mehr Jahre,188,60,128
False,8235073,Unterreichenbach,Insgesamt,2267,1101,1166
False,8235079,"Bad Wildbad, Stadt",unter 3 Jahre,288,156,132
False,8235079,"Bad Wildbad, Stadt",3 -  6 Jahre,305,173,132
False,8235079,"Bad Wildbad, Stadt",6 - 10 Jahre,432,207,225
False,8235079,"Bad Wildbad, Stadt",10 - 15 Jahre,648,315,333
False,8235079,"Bad Wildbad, Stadt",15 - 18 Jahre,358,178,180
False,8235079,"Bad Wildbad, Stadt",18 - 20 Jahre,216,105,111
False,8235079,"Bad Wildbad, Stadt",20 - 25 Jahre,568,279,289
False,8235079,"Bad Wildbad, Stadt",25 - 30 Jahre,650,328,322
False,8235079,"Bad Wildbad, Stadt",30 - 35 Jahre,854,436,418
False,8235079,"Bad Wildbad, Stadt",35 - 40 Jahre,937,513,424
False,8235079,"Bad Wildbad, Stadt",40 - 45 Jahre,811,399,412
False,8235079,"Bad Wildbad, Stadt",45 - 50 Jahre,691,359,332
False,8235079,"Bad Wildbad, Stadt",50 - 55 Jahre,612,294,318
False,8235079,"Bad Wildbad, Stadt",55 - 60 Jahre,649,321,328
False,8235079,"Bad Wildbad, Stadt",60 - 65 Jahre,877,380,497
False,8235079,"Bad Wildbad, Stadt",65 - 75 Jahre,1335,625,710
False,8235079,"Bad Wildbad, Stadt",75 und mehr Jahre,983,278,705
False,8235079,"Bad Wildbad, Stadt",Insgesamt,11214,5346,5868
False,8235080,"Wildberg, Stadt",unter 3 Jahre,337,172,165
False,8235080,"Wildberg, Stadt",3 -  6 Jahre,373,199,174
False,8235080,"Wildberg, Stadt",6 - 10 Jahre,558,311,247
False,8235080,"Wildberg, Stadt",10 - 15 Jahre,708,362,346
False,8235080,"Wildberg, Stadt",15 - 18 Jahre,372,197,175
False,8235080,"Wildberg, Stadt",18 - 20 Jahre,278,149,129
False,8235080,"Wildberg, Stadt",20 - 25 Jahre,540,257,283
False,8235080,"Wildberg, Stadt",25 - 30 Jahre,586,304,282
False,8235080,"Wildberg, Stadt",30 - 35 Jahre,780,406,374
False,8235080,"Wildberg, Stadt",35 - 40 Jahre,880,442,438
False,8235080,"Wildberg, Stadt",40 - 45 Jahre,803,406,397
False,8235080,"Wildberg, Stadt",45 - 50 Jahre,767,384,383
False,8235080,"Wildberg, Stadt",50 - 55 Jahre,618,315,303
False,8235080,"Wildberg, Stadt",55 - 60 Jahre,546,285,261
False,8235080,"Wildberg, Stadt",60 - 65 Jahre,673,342,331
False,8235080,"Wildberg, Stadt",65 - 75 Jahre,785,374,411
False,8235080,"Wildberg, Stadt",75 und mehr Jahre,588,166,422
False,8235080,"Wildberg, Stadt",Insgesamt,10192,5071,5121
False,8235084,"Bad Teinach-Zavelstein, Stadt",unter 3 Jahre,114,67,47
False,8235084,"Bad Teinach-Zavelstein, Stadt",3 -  6 Jahre,110,49,61
False,8235084,"Bad Teinach-Zavelstein, Stadt",6 - 10 Jahre,158,86,72
False,8235084,"Bad Teinach-Zavelstein, Stadt",10 - 15 Jahre,179,81,98
False,8235084,"Bad Teinach-Zavelstein, Stadt",15 - 18 Jahre,122,54,68
False,8235084,"Bad Teinach-Zavelstein, Stadt",18 - 20 Jahre,86,41,45
False,8235084,"Bad Teinach-Zavelstein, Stadt",20 - 25 Jahre,105,63,42
False,8235084,"Bad Teinach-Zavelstein, Stadt",25 - 30 Jahre,159,75,84
False,8235084,"Bad Teinach-Zavelstein, Stadt",30 - 35 Jahre,212,108,104
False,8235084,"Bad Teinach-Zavelstein, Stadt",35 - 40 Jahre,284,146,138
False,8235084,"Bad Teinach-Zavelstein, Stadt",40 - 45 Jahre,233,123,110
False,8235084,"Bad Teinach-Zavelstein, Stadt",45 - 50 Jahre,183,82,101
False,8235084,"Bad Teinach-Zavelstein, Stadt",50 - 55 Jahre,145,76,69
False,8235084,"Bad Teinach-Zavelstein, Stadt",55 - 60 Jahre,133,69,64
False,8235084,"Bad Teinach-Zavelstein, Stadt",60 - 65 Jahre,188,90,98
False,8235084,"Bad Teinach-Zavelstein, Stadt",65 - 75 Jahre,323,151,172
False,8235084,"Bad Teinach-Zavelstein, Stadt",75 und mehr Jahre,218,79,139
False,8235084,"Bad Teinach-Zavelstein, Stadt",Insgesamt,2952,1440,1512
False,8235085,"Calw, Stadt",unter 3 Jahre,769,385,384
False,8235085,"Calw, Stadt",3 -  6 Jahre,807,409,398
False,8235085,"Calw, Stadt",6 - 10 Jahre,1112,562,550
False,8235085,"Calw, Stadt",10 - 15 Jahre,1440,783,657
False,8235085,"Calw, Stadt",15 - 18 Jahre,778,380,398
False,8235085,"Calw, Stadt",18 - 20 Jahre,568,300,268
False,8235085,"Calw, Stadt",20 - 25 Jahre,1441,806,635
False,8235085,"Calw, Stadt",25 - 30 Jahre,1433,753,680
False,8235085,"Calw, Stadt",30 - 35 Jahre,1823,922,901
False,8235085,"Calw, Stadt",35 - 40 Jahre,1844,960,884
False,8235085,"Calw, Stadt",40 - 45 Jahre,1763,870,893
False,8235085,"Calw, Stadt",45 - 50 Jahre,1533,758,775
False,8235085,"Calw, Stadt",50 - 55 Jahre,1485,762,723
False,8235085,"Calw, Stadt",55 - 60 Jahre,1442,772,670
False,8235085,"Calw, Stadt",60 - 65 Jahre,1487,712,775
False,8235085,"Calw, Stadt",65 - 75 Jahre,1994,940,1054
False,8235085,"Calw, Stadt",75 und mehr Jahre,1638,482,1156
False,8235085,"Calw, Stadt",Insgesamt,23357,11556,11801
False,8236,Landkreis Enzkreis,unter 3 Jahre,6346,3231,3115
False,8236,Landkreis Enzkreis,3 -  6 Jahre,6943,3570,3373
False,8236,Landkreis Enzkreis,6 - 10 Jahre,9645,4967,4678
False,8236,Landkreis Enzkreis,10 - 15 Jahre,12336,6384,5952
False,8236,Landkreis Enzkreis,15 - 18 Jahre,6607,3285,3322
False,8236,Landkreis Enzkreis,18 - 20 Jahre,4418,2278,2140
False,8236,Landkreis Enzkreis,20 - 25 Jahre,9581,4985,4596
False,8236,Landkreis Enzkreis,25 - 30 Jahre,10497,5273,5224
False,8236,Landkreis Enzkreis,30 - 35 Jahre,15529,7760,7769
False,8236,Landkreis Enzkreis,35 - 40 Jahre,17503,8878,8625
False,8236,Landkreis Enzkreis,40 - 45 Jahre,15429,7907,7522
False,8236,Landkreis Enzkreis,45 - 50 Jahre,13206,6666,6540
False,8236,Landkreis Enzkreis,50 - 55 Jahre,11447,5739,5708
False,8236,Landkreis Enzkreis,55 - 60 Jahre,11411,5838,5573
False,8236,Landkreis Enzkreis,60 - 65 Jahre,12791,6411,6380
False,8236,Landkreis Enzkreis,65 - 75 Jahre,17162,7908,9254
False,8236,Landkreis Enzkreis,75 und mehr Jahre,12001,3834,8167
False,8236,Landkreis Enzkreis,Insgesamt,192852,94914,97938
False,8236004,Birkenfeld,unter 3 Jahre,291,149,142
False,8236004,Birkenfeld,3 -  6 Jahre,361,200,161
False,8236004,Birkenfeld,6 - 10 Jahre,502,275,227
False,8236004,Birkenfeld,10 - 15 Jahre,629,317,312
False,8236004,Birkenfeld,15 - 18 Jahre,321,157,164
False,8236004,Birkenfeld,18 - 20 Jahre,222,122,100
False,8236004,Birkenfeld,20 - 25 Jahre,458,212,246
False,8236004,Birkenfeld,25 - 30 Jahre,565,293,272
False,8236004,Birkenfeld,30 - 35 Jahre,797,403,394
False,8236004,Birkenfeld,35 - 40 Jahre,902,444,458
False,8236004,Birkenfeld,40 - 45 Jahre,798,418,380
False,8236004,Birkenfeld,45 - 50 Jahre,728,367,361
False,8236004,Birkenfeld,50 - 55 Jahre,544,247,297
False,8236004,Birkenfeld,55 - 60 Jahre,611,299,312
False,8236004,Birkenfeld,60 - 65 Jahre,732,365,367
False,8236004,Birkenfeld,65 - 75 Jahre,1048,486,562
False,8236004,Birkenfeld,75 und mehr Jahre,749,247,502
False,8236004,Birkenfeld,Insgesamt,10258,5001,5257
False,8236011,Eisingen,unter 3 Jahre,169,86,83
False,8236011,Eisingen,3 -  6 Jahre,166,78,88
False,8236011,Eisingen,6 - 10 Jahre,234,118,116
False,8236011,Eisingen,10 - 15 Jahre,270,137,133
False,8236011,Eisingen,15 - 18 Jahre,160,82,78
False,8236011,Eisingen,18 - 20 Jahre,107,58,49
False,8236011,Eisingen,20 - 25 Jahre,239,115,124
False,8236011,Eisingen,25 - 30 Jahre,280,152,128
False,8236011,Eisingen,30 - 35 Jahre,376,178,198
False,8236011,Eisingen,35 - 40 Jahre,402,203,199
False,8236011,Eisingen,40 - 45 Jahre,329,154,175
False,8236011,Eisingen,45 - 50 Jahre,289,143,146
False,8236011,Eisingen,50 - 55 Jahre,282,137,145
False,8236011,Eisingen,55 - 60 Jahre,293,143,150
False,8236011,Eisingen,60 - 65 Jahre,311,158,153
False,8236011,Eisingen,65 - 75 Jahre,362,174,188
False,8236011,Eisingen,75 und mehr Jahre,241,80,161
False,8236011,Eisingen,Insgesamt,4510,2196,2314
False,8236013,Engelsbrand,unter 3 Jahre,133,66,67
False,8236013,Engelsbrand,3 -  6 Jahre,122,62,60
False,8236013,Engelsbrand,6 - 10 Jahre,183,84,99
False,8236013,Engelsbrand,10 - 15 Jahre,270,143,127
False,8236013,Engelsbrand,15 - 18 Jahre,139,67,72
False,8236013,Engelsbrand,18 - 20 Jahre,100,47,53
False,8236013,Engelsbrand,20 - 25 Jahre,179,93,86
False,8236013,Engelsbrand,25 - 30 Jahre,168,89,79
False,8236013,Engelsbrand,30 - 35 Jahre,294,139,155
False,8236013,Engelsbrand,35 - 40 Jahre,357,182,175
False,8236013,Engelsbrand,40 - 45 Jahre,329,165,164
False,8236013,Engelsbrand,45 - 50 Jahre,301,135,166
False,8236013,Engelsbrand,50 - 55 Jahre,317,164,153
False,8236013,Engelsbrand,55 - 60 Jahre,303,145,158
False,8236013,Engelsbrand,60 - 65 Jahre,340,175,165
False,8236013,Engelsbrand,65 - 75 Jahre,430,196,234
False,8236013,Engelsbrand,75 und mehr Jahre,320,101,219
False,8236013,Engelsbrand,Insgesamt,4285,2053,2232
False,8236019,Friolzheim,unter 3 Jahre,144,73,71
False,8236019,Friolzheim,3 -  6 Jahre,143,73,70
False,8236019,Friolzheim,6 - 10 Jahre,197,106,91
False,8236019,Friolzheim,10 - 15 Jahre,246,113,133
False,8236019,Friolzheim,15 - 18 Jahre,142,67,75
False,8236019,Friolzheim,18 - 20 Jahre,77,39,38
False,8236019,Friolzheim,20 - 25 Jahre,188,111,77
False,8236019,Friolzheim,25 - 30 Jahre,187,96,91
False,8236019,Friolzheim,30 - 35 Jahre,289,138,151
False,8236019,Friolzheim,35 - 40 Jahre,315,167,148
False,8236019,Friolzheim,40 - 45 Jahre,291,144,147
False,8236019,Friolzheim,45 - 50 Jahre,287,149,138
False,8236019,Friolzheim,50 - 55 Jahre,244,126,118
False,8236019,Friolzheim,55 - 60 Jahre,205,119,86
False,8236019,Friolzheim,60 - 65 Jahre,206,101,105
False,8236019,Friolzheim,65 - 75 Jahre,255,111,144
False,8236019,Friolzheim,75 und mehr Jahre,121,36,85
False,8236019,Friolzheim,Insgesamt,3537,1769,1768
False,8236025,"Heimsheim, Stadt",unter 3 Jahre,151,74,77
False,8236025,"Heimsheim, Stadt",3 -  6 Jahre,161,81,80
False,8236025,"Heimsheim, Stadt",6 - 10 Jahre,238,137,101
False,8236025,"Heimsheim, Stadt",10 - 15 Jahre,289,153,136
False,8236025,"Heimsheim, Stadt",15 - 18 Jahre,136,73,63
False,8236025,"Heimsheim, Stadt",18 - 20 Jahre,109,57,52
False,8236025,"Heimsheim, Stadt",20 - 25 Jahre,253,144,109
False,8236025,"Heimsheim, Stadt",25 - 30 Jahre,263,117,146
False,8236025,"Heimsheim, Stadt",30 - 35 Jahre,417,217,200
False,8236025,"Heimsheim, Stadt",35 - 40 Jahre,498,292,206
False,8236025,"Heimsheim, Stadt",40 - 45 Jahre,508,326,182
False,8236025,"Heimsheim, Stadt",45 - 50 Jahre,401,244,157
False,8236025,"Heimsheim, Stadt",50 - 55 Jahre,371,201,170
False,8236025,"Heimsheim, Stadt",55 - 60 Jahre,353,230,123
False,8236025,"Heimsheim, Stadt",60 - 65 Jahre,341,194,147
False,8236025,"Heimsheim, Stadt",65 - 75 Jahre,402,197,205
False,8236025,"Heimsheim, Stadt",75 und mehr Jahre,264,86,178
False,8236025,"Heimsheim, Stadt",Insgesamt,5155,2823,2332
False,8236028,Illingen,unter 3 Jahre,217,107,110
False,8236028,Illingen,3 -  6 Jahre,267,145,122
False,8236028,Illingen,6 - 10 Jahre,369,193,176
False,8236028,Illingen,10 - 15 Jahre,444,244,200
False,8236028,Illingen,15 - 18 Jahre,257,125,132
False,8236028,Illingen,18 - 20 Jahre,159,77,82
False,8236028,Illingen,20 - 25 Jahre,366,196,170
False,8236028,Illingen,25 - 30 Jahre,392,209,183
False,8236028,Illingen,30 - 35 Jahre,528,267,261
False,8236028,Illingen,35 - 40 Jahre,631,315,316
False,8236028,Illingen,40 - 45 Jahre,564,276,288
False,8236028,Illingen,45 - 50 Jahre,511,256,255
False,8236028,Illingen,50 - 55 Jahre,489,248,241
False,8236028,Illingen,55 - 60 Jahre,479,249,230
False,8236028,Illingen,60 - 65 Jahre,474,242,232
False,8236028,Illingen,65 - 75 Jahre,693,304,389
False,8236028,Illingen,75 und mehr Jahre,431,158,273
False,8236028,Illingen,Insgesamt,7271,3611,3660
False,8236030,Ispringen,unter 3 Jahre,184,95,89
False,8236030,Ispringen,3 -  6 Jahre,207,100,107
False,8236030,Ispringen,6 - 10 Jahre,263,124,139
False,8236030,Ispringen,10 - 15 Jahre,340,180,160
False,8236030,Ispringen,15 - 18 Jahre,189,99,90
False,8236030,Ispringen,18 - 20 Jahre,133,63,70
False,8236030,Ispringen,20 - 25 Jahre,279,138,141
False,8236030,Ispringen,25 - 30 Jahre,313,164,149
False,8236030,Ispringen,30 - 35 Jahre,510,244,266
False,8236030,Ispringen,35 - 40 Jahre,519,268,251
False,8236030,Ispringen,40 - 45 Jahre,454,238,216
False,8236030,Ispringen,45 - 50 Jahre,392,190,202
False,8236030,Ispringen,50 - 55 Jahre,341,179,162
False,8236030,Ispringen,55 - 60 Jahre,358,166,192
False,8236030,Ispringen,60 - 65 Jahre,463,226,237
False,8236030,Ispringen,65 - 75 Jahre,692,312,380
False,8236030,Ispringen,75 und mehr Jahre,429,156,273
False,8236030,Ispringen,Insgesamt,6066,2942,3124
False,8236031,Kieselbronn,unter 3 Jahre,99,54,45
False,8236031,Kieselbronn,3 -  6 Jahre,100,46,54
False,8236031,Kieselbronn,6 - 10 Jahre,122,60,62
False,8236031,Kieselbronn,10 - 15 Jahre,177,83,94
False,8236031,Kieselbronn,15 - 18 Jahre,116,62,54
False,8236031,Kieselbronn,18 - 20 Jahre,64,30,34
False,8236031,Kieselbronn,20 - 25 Jahre,137,77,60
False,8236031,Kieselbronn,25 - 30 Jahre,135,75,60
False,8236031,Kieselbronn,30 - 35 Jahre,213,93,120
False,8236031,Kieselbronn,35 - 40 Jahre,273,137,136
False,8236031,Kieselbronn,40 - 45 Jahre,236,129,107
False,8236031,Kieselbronn,45 - 50 Jahre,195,93,102
False,8236031,Kieselbronn,50 - 55 Jahre,161,100,61
False,8236031,Kieselbronn,55 - 60 Jahre,161,79,82
False,8236031,Kieselbronn,60 - 65 Jahre,166,76,90
False,8236031,Kieselbronn,65 - 75 Jahre,239,123,116
False,8236031,Kieselbronn,75 und mehr Jahre,179,65,114
False,8236031,Kieselbronn,Insgesamt,2773,1382,1391
False,8236033,"Knittlingen, Stadt",unter 3 Jahre,263,127,136
False,8236033,"Knittlingen, Stadt",3 -  6 Jahre,303,169,134
False,8236033,"Knittlingen, Stadt",6 - 10 Jahre,415,213,202
False,8236033,"Knittlingen, Stadt",10 - 15 Jahre,487,257,230
False,8236033,"Knittlingen, Stadt",15 - 18 Jahre,274,136,138
False,8236033,"Knittlingen, Stadt",18 - 20 Jahre,166,93,73
False,8236033,"Knittlingen, Stadt",20 - 25 Jahre,402,193,209
False,8236033,"Knittlingen, Stadt",25 - 30 Jahre,463,232,231
False,8236033,"Knittlingen, Stadt",30 - 35 Jahre,610,309,301
False,8236033,"Knittlingen, Stadt",35 - 40 Jahre,680,343,337
False,8236033,"Knittlingen, Stadt",40 - 45 Jahre,585,303,282
False,8236033,"Knittlingen, Stadt",45 - 50 Jahre,499,228,271
False,8236033,"Knittlingen, Stadt",50 - 55 Jahre,426,204,222
False,8236033,"Knittlingen, Stadt",55 - 60 Jahre,404,214,190
False,8236033,"Knittlingen, Stadt",60 - 65 Jahre,496,244,252
False,8236033,"Knittlingen, Stadt",65 - 75 Jahre,633,296,337
False,8236033,"Knittlingen, Stadt",75 und mehr Jahre,379,118,261
False,8236033,"Knittlingen, Stadt",Insgesamt,7485,3679,3806
False,8236038,"Maulbronn, Stadt",unter 3 Jahre,214,101,113
False,8236038,"Maulbronn, Stadt",3 -  6 Jahre,227,118,109
False,8236038,"Maulbronn, Stadt",6 - 10 Jahre,330,140,190
False,8236038,"Maulbronn, Stadt",10 - 15 Jahre,434,230,204
False,8236038,"Maulbronn, Stadt",15 - 18 Jahre,254,114,140
False,8236038,"Maulbronn, Stadt",18 - 20 Jahre,147,88,59
False,8236038,"Maulbronn, Stadt",20 - 25 Jahre,327,172,155
False,8236038,"Maulbronn, Stadt",25 - 30 Jahre,374,197,177
False,8236038,"Maulbronn, Stadt",30 - 35 Jahre,499,246,253
False,8236038,"Maulbronn, Stadt",35 - 40 Jahre,598,292,306
False,8236038,"Maulbronn, Stadt",40 - 45 Jahre,525,257,268
False,8236038,"Maulbronn, Stadt",45 - 50 Jahre,413,214,199
False,8236038,"Maulbronn, Stadt",50 - 55 Jahre,321,168,153
False,8236038,"Maulbronn, Stadt",55 - 60 Jahre,407,213,194
False,8236038,"Maulbronn, Stadt",60 - 65 Jahre,450,220,230
False,8236038,"Maulbronn, Stadt",65 - 75 Jahre,603,288,315
False,8236038,"Maulbronn, Stadt",75 und mehr Jahre,367,127,240
False,8236038,"Maulbronn, Stadt",Insgesamt,6490,3185,3305
False,8236039,Mönsheim,unter 3 Jahre,86,46,40
False,8236039,Mönsheim,3 -  6 Jahre,114,55,59
False,8236039,Mönsheim,6 - 10 Jahre,128,68,60
False,8236039,Mönsheim,10 - 15 Jahre,165,91,74
False,8236039,Mönsheim,15 - 18 Jahre,75,31,44
False,8236039,Mönsheim,18 - 20 Jahre,65,39,26
False,8236039,Mönsheim,20 - 25 Jahre,163,85,78
False,8236039,Mönsheim,25 - 30 Jahre,131,64,67
False,8236039,Mönsheim,30 - 35 Jahre,181,103,78
False,8236039,Mönsheim,35 - 40 Jahre,234,111,123
False,8236039,Mönsheim,40 - 45 Jahre,203,92,111
False,8236039,Mönsheim,45 - 50 Jahre,195,105,90
False,8236039,Mönsheim,50 - 55 Jahre,160,83,77
False,8236039,Mönsheim,55 - 60 Jahre,158,85,73
False,8236039,Mönsheim,60 - 65 Jahre,181,90,91
False,8236039,Mönsheim,65 - 75 Jahre,225,108,117
False,8236039,Mönsheim,75 und mehr Jahre,121,40,81
False,8236039,Mönsheim,Insgesamt,2585,1296,1289
False,8236040,"Mühlacker, Stadt",unter 3 Jahre,850,428,422
False,8236040,"Mühlacker, Stadt",3 -  6 Jahre,887,454,433
False,8236040,"Mühlacker, Stadt",6 - 10 Jahre,1223,633,590
False,8236040,"Mühlacker, Stadt",10 - 15 Jahre,1672,890,782
False,8236040,"Mühlacker, Stadt",15 - 18 Jahre,903,450,453
False,8236040,"Mühlacker, Stadt",18 - 20 Jahre,625,329,296
False,8236040,"Mühlacker, Stadt",20 - 25 Jahre,1430,762,668
False,8236040,"Mühlacker, Stadt",25 - 30 Jahre,1524,783,741
False,8236040,"Mühlacker, Stadt",30 - 35 Jahre,2020,1046,974
False,8236040,"Mühlacker, Stadt",35 - 40 Jahre,2237,1176,1061
False,8236040,"Mühlacker, Stadt",40 - 45 Jahre,1911,976,935
False,8236040,"Mühlacker, Stadt",45 - 50 Jahre,1664,832,832
False,8236040,"Mühlacker, Stadt",50 - 55 Jahre,1502,727,775
False,8236040,"Mühlacker, Stadt",55 - 60 Jahre,1611,839,772
False,8236040,"Mühlacker, Stadt",60 - 65 Jahre,1810,917,893
False,8236040,"Mühlacker, Stadt",65 - 75 Jahre,2365,1065,1300
False,8236040,"Mühlacker, Stadt",75 und mehr Jahre,1777,561,1216
False,8236040,"Mühlacker, Stadt",Insgesamt,26011,12868,13143
False,8236043,"Neuenbürg, Stadt",unter 3 Jahre,242,130,112
False,8236043,"Neuenbürg, Stadt",3 -  6 Jahre,252,143,109
False,8236043,"Neuenbürg, Stadt",6 - 10 Jahre,376,203,173
False,8236043,"Neuenbürg, Stadt",10 - 15 Jahre,481,272,209
False,8236043,"Neuenbürg, Stadt",15 - 18 Jahre,260,134,126
False,8236043,"Neuenbürg, Stadt",18 - 20 Jahre,180,76,104
False,8236043,"Neuenbürg, Stadt",20 - 25 Jahre,335,168,167
False,8236043,"Neuenbürg, Stadt",25 - 30 Jahre,387,203,184
False,8236043,"Neuenbürg, Stadt",30 - 35 Jahre,603,304,299
False,8236043,"Neuenbürg, Stadt",35 - 40 Jahre,701,324,377
False,8236043,"Neuenbürg, Stadt",40 - 45 Jahre,603,314,289
False,8236043,"Neuenbürg, Stadt",45 - 50 Jahre,507,261,246
False,8236043,"Neuenbürg, Stadt",50 - 55 Jahre,422,188,234
False,8236043,"Neuenbürg, Stadt",55 - 60 Jahre,461,227,234
False,8236043,"Neuenbürg, Stadt",60 - 65 Jahre,554,255,299
False,8236043,"Neuenbürg, Stadt",65 - 75 Jahre,739,364,375
False,8236043,"Neuenbürg, Stadt",75 und mehr Jahre,571,165,406
False,8236043,"Neuenbürg, Stadt",Insgesamt,7674,3731,3943
False,8236044,Neuhausen,unter 3 Jahre,173,85,88
False,8236044,Neuhausen,3 -  6 Jahre,238,102,136
False,8236044,Neuhausen,6 - 10 Jahre,297,131,166
False,8236044,Neuhausen,10 - 15 Jahre,367,196,171
False,8236044,Neuhausen,15 - 18 Jahre,190,106,84
False,8236044,Neuhausen,18 - 20 Jahre,139,73,66
False,8236044,Neuhausen,20 - 25 Jahre,268,129,139
False,8236044,Neuhausen,25 - 30 Jahre,309,137,172
False,8236044,Neuhausen,30 - 35 Jahre,456,235,221
False,8236044,Neuhausen,35 - 40 Jahre,518,266,252
False,8236044,Neuhausen,40 - 45 Jahre,442,230,212
False,8236044,Neuhausen,45 - 50 Jahre,379,187,192
False,8236044,Neuhausen,50 - 55 Jahre,332,174,158
False,8236044,Neuhausen,55 - 60 Jahre,294,145,149
False,8236044,Neuhausen,60 - 65 Jahre,295,161,134
False,8236044,Neuhausen,65 - 75 Jahre,449,214,235
False,8236044,Neuhausen,75 und mehr Jahre,289,93,196
False,8236044,Neuhausen,Insgesamt,5435,2664,2771
False,8236046,Niefern-Öschelbronn,unter 3 Jahre,399,207,192
False,8236046,Niefern-Öschelbronn,3 -  6 Jahre,427,210,217
False,8236046,Niefern-Öschelbronn,6 - 10 Jahre,576,283,293
False,8236046,Niefern-Öschelbronn,10 - 15 Jahre,728,374,354
False,8236046,Niefern-Öschelbronn,15 - 18 Jahre,405,204,201
False,8236046,Niefern-Öschelbronn,18 - 20 Jahre,264,128,136
False,8236046,Niefern-Öschelbronn,20 - 25 Jahre,610,303,307
False,8236046,Niefern-Öschelbronn,25 - 30 Jahre,697,337,360
False,8236046,Niefern-Öschelbronn,30 - 35 Jahre,962,471,491
False,8236046,Niefern-Öschelbronn,35 - 40 Jahre,1068,547,521
False,8236046,Niefern-Öschelbronn,40 - 45 Jahre,931,485,446
False,8236046,Niefern-Öschelbronn,45 - 50 Jahre,746,367,379
False,8236046,Niefern-Öschelbronn,50 - 55 Jahre,673,325,348
False,8236046,Niefern-Öschelbronn,55 - 60 Jahre,666,315,351
False,8236046,Niefern-Öschelbronn,60 - 65 Jahre,781,378,403
False,8236046,Niefern-Öschelbronn,65 - 75 Jahre,1061,477,584
False,8236046,Niefern-Öschelbronn,75 und mehr Jahre,989,289,700
False,8236046,Niefern-Öschelbronn,Insgesamt,11983,5700,6283
False,8236050,Ötisheim,unter 3 Jahre,132,72,60
False,8236050,Ötisheim,3 -  6 Jahre,170,83,87
False,8236050,Ötisheim,6 - 10 Jahre,227,120,107
False,8236050,Ötisheim,10 - 15 Jahre,300,145,155
False,8236050,Ötisheim,15 - 18 Jahre,162,85,77
False,8236050,Ötisheim,18 - 20 Jahre,121,66,55
False,8236050,Ötisheim,20 - 25 Jahre,244,125,119
False,8236050,Ötisheim,25 - 30 Jahre,259,118,141
False,8236050,Ötisheim,30 - 35 Jahre,393,186,207
False,8236050,Ötisheim,35 - 40 Jahre,416,216,200
False,8236050,Ötisheim,40 - 45 Jahre,371,171,200
False,8236050,Ötisheim,45 - 50 Jahre,364,196,168
False,8236050,Ötisheim,50 - 55 Jahre,261,147,114
False,8236050,Ötisheim,55 - 60 Jahre,296,148,148
False,8236050,Ötisheim,60 - 65 Jahre,356,189,167
False,8236050,Ötisheim,65 - 75 Jahre,434,196,238
False,8236050,Ötisheim,75 und mehr Jahre,281,89,192
False,8236050,Ötisheim,Insgesamt,4787,2352,2435
False,8236061,Sternenfels,unter 3 Jahre,79,42,37
False,8236061,Sternenfels,3 -  6 Jahre,98,47,51
False,8236061,Sternenfels,6 - 10 Jahre,145,78,67
False,8236061,Sternenfels,10 - 15 Jahre,206,107,99
False,8236061,Sternenfels,15 - 18 Jahre,80,41,39
False,8236061,Sternenfels,18 - 20 Jahre,57,30,27
False,8236061,Sternenfels,20 - 25 Jahre,126,67,59
False,8236061,Sternenfels,25 - 30 Jahre,160,93,67
False,8236061,Sternenfels,30 - 35 Jahre,211,100,111
False,8236061,Sternenfels,35 - 40 Jahre,271,141,130
False,8236061,Sternenfels,40 - 45 Jahre,244,131,113
False,8236061,Sternenfels,45 - 50 Jahre,223,111,112
False,8236061,Sternenfels,50 - 55 Jahre,168,83,85
False,8236061,Sternenfels,55 - 60 Jahre,165,87,78
False,8236061,Sternenfels,60 - 65 Jahre,144,72,72
False,8236061,Sternenfels,65 - 75 Jahre,257,108,149
False,8236061,Sternenfels,75 und mehr Jahre,142,43,99
False,8236061,Sternenfels,Insgesamt,2776,1381,1395
False,8236062,Tiefenbronn,unter 3 Jahre,197,91,106
False,8236062,Tiefenbronn,3 -  6 Jahre,217,111,106
False,8236062,Tiefenbronn,6 - 10 Jahre,323,162,161
False,8236062,Tiefenbronn,10 - 15 Jahre,378,195,183
False,8236062,Tiefenbronn,15 - 18 Jahre,178,87,91
False,8236062,Tiefenbronn,18 - 20 Jahre,141,86,55
False,8236062,Tiefenbronn,20 - 25 Jahre,250,128,122
False,8236062,Tiefenbronn,25 - 30 Jahre,244,123,121
False,8236062,Tiefenbronn,30 - 35 Jahre,429,213,216
False,8236062,Tiefenbronn,35 - 40 Jahre,510,236,274
False,8236062,Tiefenbronn,40 - 45 Jahre,489,249,240
False,8236062,Tiefenbronn,45 - 50 Jahre,412,225,187
False,8236062,Tiefenbronn,50 - 55 Jahre,368,189,179
False,8236062,Tiefenbronn,55 - 60 Jahre,345,188,157
False,8236062,Tiefenbronn,60 - 65 Jahre,318,150,168
False,8236062,Tiefenbronn,65 - 75 Jahre,398,193,205
False,8236062,Tiefenbronn,75 und mehr Jahre,287,98,189
False,8236062,Tiefenbronn,Insgesamt,5484,2724,2760
False,8236065,Wiernsheim,unter 3 Jahre,240,130,110
False,8236065,Wiernsheim,3 -  6 Jahre,249,135,114
False,8236065,Wiernsheim,6 - 10 Jahre,334,175,159
False,8236065,Wiernsheim,10 - 15 Jahre,454,219,235
False,8236065,Wiernsheim,15 - 18 Jahre,218,101,117
False,8236065,Wiernsheim,18 - 20 Jahre,153,80,73
False,8236065,Wiernsheim,20 - 25 Jahre,333,157,176
False,8236065,Wiernsheim,25 - 30 Jahre,351,182,169
False,8236065,Wiernsheim,30 - 35 Jahre,564,282,282
False,8236065,Wiernsheim,35 - 40 Jahre,638,315,323
False,8236065,Wiernsheim,40 - 45 Jahre,578,284,294
False,8236065,Wiernsheim,45 - 50 Jahre,463,249,214
False,8236065,Wiernsheim,50 - 55 Jahre,389,202,187
False,8236065,Wiernsheim,55 - 60 Jahre,353,192,161
False,8236065,Wiernsheim,60 - 65 Jahre,378,189,189
False,8236065,Wiernsheim,65 - 75 Jahre,470,209,261
False,8236065,Wiernsheim,75 und mehr Jahre,283,93,190
False,8236065,Wiernsheim,Insgesamt,6448,3194,3254
False,8236067,Wimsheim,unter 3 Jahre,92,48,44
False,8236067,Wimsheim,3 -  6 Jahre,108,54,54
False,8236067,Wimsheim,6 - 10 Jahre,160,85,75
False,8236067,Wimsheim,10 - 15 Jahre,185,89,96
False,8236067,Wimsheim,15 - 18 Jahre,91,45,46
False,8236067,Wimsheim,18 - 20 Jahre,56,31,25
False,8236067,Wimsheim,20 - 25 Jahre,128,63,65
False,8236067,Wimsheim,25 - 30 Jahre,150,70,80
False,8236067,Wimsheim,30 - 35 Jahre,229,110,119
False,8236067,Wimsheim,35 - 40 Jahre,270,143,127
False,8236067,Wimsheim,40 - 45 Jahre,235,119,116
False,8236067,Wimsheim,45 - 50 Jahre,197,89,108
False,8236067,Wimsheim,50 - 55 Jahre,149,82,67
False,8236067,Wimsheim,55 - 60 Jahre,133,74,59
False,8236067,Wimsheim,60 - 65 Jahre,146,70,76
False,8236067,Wimsheim,65 - 75 Jahre,203,94,109
False,8236067,Wimsheim,75 und mehr Jahre,107,38,69
False,8236067,Wimsheim,Insgesamt,2639,1304,1335
False,8236068,Wurmberg,unter 3 Jahre,103,50,53
False,8236068,Wurmberg,3 -  6 Jahre,121,73,48
False,8236068,Wurmberg,6 - 10 Jahre,197,98,99
False,8236068,Wurmberg,10 - 15 Jahre,232,105,127
False,8236068,Wurmberg,15 - 18 Jahre,106,44,62
False,8236068,Wurmberg,18 - 20 Jahre,83,49,34
False,8236068,Wurmberg,20 - 25 Jahre,120,58,62
False,8236068,Wurmberg,25 - 30 Jahre,135,67,68
False,8236068,Wurmberg,30 - 35 Jahre,211,117,94
False,8236068,Wurmberg,35 - 40 Jahre,273,143,130
False,8236068,Wurmberg,40 - 45 Jahre,226,113,113
False,8236068,Wurmberg,45 - 50 Jahre,167,90,77
False,8236068,Wurmberg,50 - 55 Jahre,133,72,61
False,8236068,Wurmberg,55 - 60 Jahre,139,62,77
False,8236068,Wurmberg,60 - 65 Jahre,164,86,78
False,8236068,Wurmberg,65 - 75 Jahre,267,124,143
False,8236068,Wurmberg,75 und mehr Jahre,149,51,98
False,8236068,Wurmberg,Insgesamt,2826,1402,1424
False,8236070,Keltern,unter 3 Jahre,317,159,158
False,8236070,Keltern,3 -  6 Jahre,325,152,173
False,8236070,Keltern,6 - 10 Jahre,418,215,203
False,8236070,Keltern,10 - 15 Jahre,521,266,255
False,8236070,Keltern,15 - 18 Jahre,251,127,124
False,8236070,Keltern,18 - 20 Jahre,177,89,88
False,8236070,Keltern,20 - 25 Jahre,432,235,197
False,8236070,Keltern,25 - 30 Jahre,434,204,230
False,8236070,Keltern,30 - 35 Jahre,731,364,367
False,8236070,Keltern,35 - 40 Jahre,857,424,433
False,8236070,Keltern,40 - 45 Jahre,685,345,340
False,8236070,Keltern,45 - 50 Jahre,600,298,302
False,8236070,Keltern,50 - 55 Jahre,550,272,278
False,8236070,Keltern,55 - 60 Jahre,549,280,269
False,8236070,Keltern,60 - 65 Jahre,583,288,295
False,8236070,Keltern,65 - 75 Jahre,828,385,443
False,8236070,Keltern,75 und mehr Jahre,628,206,422
False,8236070,Keltern,Insgesamt,8886,4309,4577
False,8236071,Remchingen,unter 3 Jahre,383,207,176
False,8236071,Remchingen,3 -  6 Jahre,383,200,183
False,8236071,Remchingen,6 - 10 Jahre,556,292,264
False,8236071,Remchingen,10 - 15 Jahre,784,426,358
False,8236071,Remchingen,15 - 18 Jahre,443,226,217
False,8236071,Remchingen,18 - 20 Jahre,284,136,148
False,8236071,Remchingen,20 - 25 Jahre,620,352,268
False,8236071,Remchingen,25 - 30 Jahre,629,307,322
False,8236071,Remchingen,30 - 35 Jahre,972,467,505
False,8236071,Remchingen,35 - 40 Jahre,973,500,473
False,8236071,Remchingen,40 - 45 Jahre,884,435,449
False,8236071,Remchingen,45 - 50 Jahre,866,423,443
False,8236071,Remchingen,50 - 55 Jahre,723,363,360
False,8236071,Remchingen,55 - 60 Jahre,638,322,316
False,8236071,Remchingen,60 - 65 Jahre,753,377,376
False,8236071,Remchingen,65 - 75 Jahre,933,424,509
False,8236071,Remchingen,75 und mehr Jahre,628,202,426
False,8236071,Remchingen,Insgesamt,11452,5659,5793
False,8236072,Straubenhardt,unter 3 Jahre,336,163,173
False,8236072,Straubenhardt,3 -  6 Jahre,373,189,184
False,8236072,Straubenhardt,6 - 10 Jahre,552,309,243
False,8236072,Straubenhardt,10 - 15 Jahre,707,363,344
False,8236072,Straubenhardt,15 - 18 Jahre,381,191,190
False,8236072,Straubenhardt,18 - 20 Jahre,209,107,102
False,8236072,Straubenhardt,20 - 25 Jahre,442,241,201
False,8236072,Straubenhardt,25 - 30 Jahre,534,266,268
False,8236072,Straubenhardt,30 - 35 Jahre,844,428,416
False,8236072,Straubenhardt,35 - 40 Jahre,1007,504,503
False,8236072,Straubenhardt,40 - 45 Jahre,893,486,407
False,8236072,Straubenhardt,45 - 50 Jahre,667,336,331
False,8236072,Straubenhardt,50 - 55 Jahre,640,319,321
False,8236072,Straubenhardt,55 - 60 Jahre,575,308,267
False,8236072,Straubenhardt,60 - 65 Jahre,681,343,338
False,8236072,Straubenhardt,65 - 75 Jahre,901,400,501
False,8236072,Straubenhardt,75 und mehr Jahre,653,207,446
False,8236072,Straubenhardt,Insgesamt,10395,5160,5235
False,8236073,Neulingen,unter 3 Jahre,222,118,104
False,8236073,Neulingen,3 -  6 Jahre,262,137,125
False,8236073,Neulingen,6 - 10 Jahre,338,179,159
False,8236073,Neulingen,10 - 15 Jahre,472,235,237
False,8236073,Neulingen,15 - 18 Jahre,237,123,114
False,8236073,Neulingen,18 - 20 Jahre,142,69,73
False,8236073,Neulingen,20 - 25 Jahre,304,151,153
False,8236073,Neulingen,25 - 30 Jahre,291,154,137
False,8236073,Neulingen,30 - 35 Jahre,536,249,287
False,8236073,Neulingen,35 - 40 Jahre,601,305,296
False,8236073,Neulingen,40 - 45 Jahre,587,295,292
False,8236073,Neulingen,45 - 50 Jahre,449,236,213
False,8236073,Neulingen,50 - 55 Jahre,338,177,161
False,8236073,Neulingen,55 - 60 Jahre,314,156,158
False,8236073,Neulingen,60 - 65 Jahre,333,169,164
False,8236073,Neulingen,65 - 75 Jahre,511,228,283
False,8236073,Neulingen,75 und mehr Jahre,429,113,316
False,8236073,Neulingen,Insgesamt,6366,3094,3272
False,8236074,Kämpfelbach,unter 3 Jahre,189,100,89
False,8236074,Kämpfelbach,3 -  6 Jahre,209,113,96
False,8236074,Kämpfelbach,6 - 10 Jahre,297,149,148
False,8236074,Kämpfelbach,10 - 15 Jahre,336,159,177
False,8236074,Kämpfelbach,15 - 18 Jahre,199,98,101
False,8236074,Kämpfelbach,18 - 20 Jahre,128,47,81
False,8236074,Kämpfelbach,20 - 25 Jahre,316,177,139
False,8236074,Kämpfelbach,25 - 30 Jahre,350,159,191
False,8236074,Kämpfelbach,30 - 35 Jahre,483,271,212
False,8236074,Kämpfelbach,35 - 40 Jahre,555,276,279
False,8236074,Kämpfelbach,40 - 45 Jahre,503,255,248
False,8236074,Kämpfelbach,45 - 50 Jahre,389,189,200
False,8236074,Kämpfelbach,50 - 55 Jahre,354,187,167
False,8236074,Kämpfelbach,55 - 60 Jahre,345,167,178
False,8236074,Kämpfelbach,60 - 65 Jahre,414,200,214
False,8236074,Kämpfelbach,65 - 75 Jahre,586,270,316
False,8236074,Kämpfelbach,75 und mehr Jahre,419,139,280
False,8236074,Kämpfelbach,Insgesamt,6072,2956,3116
False,8236075,Ölbronn-Dürrn,unter 3 Jahre,104,48,56
False,8236075,Ölbronn-Dürrn,3 -  6 Jahre,125,63,62
False,8236075,Ölbronn-Dürrn,6 - 10 Jahre,183,103,80
False,8236075,Ölbronn-Dürrn,10 - 15 Jahre,248,145,103
False,8236075,Ölbronn-Dürrn,15 - 18 Jahre,124,57,67
False,8236075,Ölbronn-Dürrn,18 - 20 Jahre,87,46,41
False,8236075,Ölbronn-Dürrn,20 - 25 Jahre,177,90,87
False,8236075,Ölbronn-Dürrn,25 - 30 Jahre,193,110,83
False,8236075,Ölbronn-Dürrn,30 - 35 Jahre,279,134,145
False,8236075,Ölbronn-Dürrn,35 - 40 Jahre,318,166,152
False,8236075,Ölbronn-Dürrn,40 - 45 Jahre,276,141,135
False,8236075,Ölbronn-Dürrn,45 - 50 Jahre,242,122,120
False,8236075,Ölbronn-Dürrn,50 - 55 Jahre,182,97,85
False,8236075,Ölbronn-Dürrn,55 - 60 Jahre,170,79,91
False,8236075,Ölbronn-Dürrn,60 - 65 Jahre,223,118,105
False,8236075,Ölbronn-Dürrn,65 - 75 Jahre,326,160,166
False,8236075,Ölbronn-Dürrn,75 und mehr Jahre,190,59,131
False,8236075,Ölbronn-Dürrn,Insgesamt,3447,1738,1709
False,8236076,Königsbach-Stein,unter 3 Jahre,337,175,162
False,8236076,Königsbach-Stein,3 -  6 Jahre,328,177,151
False,8236076,Königsbach-Stein,6 - 10 Jahre,462,234,228
False,8236076,Königsbach-Stein,10 - 15 Jahre,514,250,264
False,8236076,Königsbach-Stein,15 - 18 Jahre,316,153,163
False,8236076,Königsbach-Stein,18 - 20 Jahre,223,123,100
False,8236076,Königsbach-Stein,20 - 25 Jahre,455,243,212
False,8236076,Königsbach-Stein,25 - 30 Jahre,579,272,307
False,8236076,Königsbach-Stein,30 - 35 Jahre,892,446,446
False,8236076,Königsbach-Stein,35 - 40 Jahre,881,442,439
False,8236076,Königsbach-Stein,40 - 45 Jahre,749,376,373
False,8236076,Königsbach-Stein,45 - 50 Jahre,660,331,329
False,8236076,Königsbach-Stein,50 - 55 Jahre,607,278,329
False,8236076,Königsbach-Stein,55 - 60 Jahre,625,307,318
False,8236076,Königsbach-Stein,60 - 65 Jahre,698,358,340
False,8236076,Königsbach-Stein,65 - 75 Jahre,852,402,450
False,8236076,Königsbach-Stein,75 und mehr Jahre,578,174,404
False,8236076,Königsbach-Stein,Insgesamt,9756,4741,5015
False,8237,Landkreis Freudenstadt,unter 3 Jahre,3882,2031,1851
False,8237,Landkreis Freudenstadt,3 -  6 Jahre,4317,2279,2038
False,8237,Landkreis Freudenstadt,6 - 10 Jahre,6063,3089,2974
False,8237,Landkreis Freudenstadt,10 - 15 Jahre,7527,3750,3777
False,8237,Landkreis Freudenstadt,15 - 18 Jahre,4170,2139,2031
False,8237,Landkreis Freudenstadt,18 - 20 Jahre,2937,1486,1451
False,8237,Landkreis Freudenstadt,20 - 25 Jahre,6857,3547,3310
False,8237,Landkreis Freudenstadt,25 - 30 Jahre,7563,3696,3867
False,8237,Landkreis Freudenstadt,30 - 35 Jahre,10062,5135,4927
False,8237,Landkreis Freudenstadt,35 - 40 Jahre,10479,5344,5135
False,8237,Landkreis Freudenstadt,40 - 45 Jahre,9220,4741,4479
False,8237,Landkreis Freudenstadt,45 - 50 Jahre,7976,4145,3831
False,8237,Landkreis Freudenstadt,50 - 55 Jahre,6562,3374,3188
False,8237,Landkreis Freudenstadt,55 - 60 Jahre,6097,3010,3087
False,8237,Landkreis Freudenstadt,60 - 65 Jahre,7877,3866,4011
False,8237,Landkreis Freudenstadt,65 - 75 Jahre,10768,4818,5950
False,8237,Landkreis Freudenstadt,75 und mehr Jahre,8491,2584,5907
False,8237,Landkreis Freudenstadt,Insgesamt,120848,59034,61814
False,8237002,"Alpirsbach, Stadt",unter 3 Jahre,201,111,90
False,8237002,"Alpirsbach, Stadt",3 -  6 Jahre,246,132,114
False,8237002,"Alpirsbach, Stadt",6 - 10 Jahre,317,152,165
False,8237002,"Alpirsbach, Stadt",10 - 15 Jahre,443,219,224
False,8237002,"Alpirsbach, Stadt",15 - 18 Jahre,227,111,116
False,8237002,"Alpirsbach, Stadt",18 - 20 Jahre,149,75,74
False,8237002,"Alpirsbach, Stadt",20 - 25 Jahre,353,209,144
False,8237002,"Alpirsbach, Stadt",25 - 30 Jahre,359,184,175
False,8237002,"Alpirsbach, Stadt",30 - 35 Jahre,538,277,261
False,8237002,"Alpirsbach, Stadt",35 - 40 Jahre,609,306,303
False,8237002,"Alpirsbach, Stadt",40 - 45 Jahre,519,269,250
False,8237002,"Alpirsbach, Stadt",45 - 50 Jahre,448,249,199
False,8237002,"Alpirsbach, Stadt",50 - 55 Jahre,384,199,185
False,8237002,"Alpirsbach, Stadt",55 - 60 Jahre,379,213,166
False,8237002,"Alpirsbach, Stadt",60 - 65 Jahre,470,231,239
False,8237002,"Alpirsbach, Stadt",65 - 75 Jahre,713,317,396
False,8237002,"Alpirsbach, Stadt",75 und mehr Jahre,563,176,387
False,8237002,"Alpirsbach, Stadt",Insgesamt,6918,3430,3488
False,8237004,Baiersbronn,unter 3 Jahre,501,269,232
False,8237004,Baiersbronn,3 -  6 Jahre,538,269,269
False,8237004,Baiersbronn,6 - 10 Jahre,789,405,384
False,8237004,Baiersbronn,10 - 15 Jahre,880,411,469
False,8237004,Baiersbronn,15 - 18 Jahre,544,276,268
False,8237004,Baiersbronn,18 - 20 Jahre,378,194,184
False,8237004,Baiersbronn,20 - 25 Jahre,1077,525,552
False,8237004,Baiersbronn,25 - 30 Jahre,1095,534,561
False,8237004,Baiersbronn,30 - 35 Jahre,1549,739,810
False,8237004,Baiersbronn,35 - 40 Jahre,1371,696,675
False,8237004,Baiersbronn,40 - 45 Jahre,1099,591,508
False,8237004,Baiersbronn,45 - 50 Jahre,929,475,454
False,8237004,Baiersbronn,50 - 55 Jahre,764,372,392
False,8237004,Baiersbronn,55 - 60 Jahre,815,382,433
False,8237004,Baiersbronn,60 - 65 Jahre,1140,559,581
False,8237004,Baiersbronn,65 - 75 Jahre,1508,699,809
False,8237004,Baiersbronn,75 und mehr Jahre,1290,395,895
False,8237004,Baiersbronn,Insgesamt,16267,7791,8476
False,8237019,"Dornstetten, Stadt",unter 3 Jahre,305,159,146
False,8237019,"Dornstetten, Stadt",3 -  6 Jahre,312,155,157
False,8237019,"Dornstetten, Stadt",6 - 10 Jahre,366,198,168
False,8237019,"Dornstetten, Stadt",10 - 15 Jahre,528,263,265
False,8237019,"Dornstetten, Stadt",15 - 18 Jahre,271,139,132
False,8237019,"Dornstetten, Stadt",18 - 20 Jahre,205,105,100
False,8237019,"Dornstetten, Stadt",20 - 25 Jahre,468,239,229
False,8237019,"Dornstetten, Stadt",25 - 30 Jahre,578,298,280
False,8237019,"Dornstetten, Stadt",30 - 35 Jahre,616,311,305
False,8237019,"Dornstetten, Stadt",35 - 40 Jahre,694,342,352
False,8237019,"Dornstetten, Stadt",40 - 45 Jahre,619,308,311
False,8237019,"Dornstetten, Stadt",45 - 50 Jahre,574,294,280
False,8237019,"Dornstetten, Stadt",50 - 55 Jahre,473,263,210
False,8237019,"Dornstetten, Stadt",55 - 60 Jahre,367,182,185
False,8237019,"Dornstetten, Stadt",60 - 65 Jahre,479,234,245
False,8237019,"Dornstetten, Stadt",65 - 75 Jahre,616,262,354
False,8237019,"Dornstetten, Stadt",75 und mehr Jahre,436,126,310
False,8237019,"Dornstetten, Stadt",Insgesamt,7907,3878,4029
False,8237024,Empfingen,unter 3 Jahre,127,67,60
False,8237024,Empfingen,3 -  6 Jahre,129,81,48
False,8237024,Empfingen,6 - 10 Jahre,236,128,108
False,8237024,Empfingen,10 - 15 Jahre,198,92,106
False,8237024,Empfingen,15 - 18 Jahre,100,55,45
False,8237024,Empfingen,18 - 20 Jahre,66,35,31
False,8237024,Empfingen,20 - 25 Jahre,187,100,87
False,8237024,Empfingen,25 - 30 Jahre,385,152,233
False,8237024,Empfingen,30 - 35 Jahre,475,261,214
False,8237024,Empfingen,35 - 40 Jahre,360,190,170
False,8237024,Empfingen,40 - 45 Jahre,405,237,168
False,8237024,Empfingen,45 - 50 Jahre,312,169,143
False,8237024,Empfingen,50 - 55 Jahre,241,108,133
False,8237024,Empfingen,55 - 60 Jahre,119,57,62
False,8237024,Empfingen,60 - 65 Jahre,187,107,80
False,8237024,Empfingen,65 - 75 Jahre,319,122,197
False,8237024,Empfingen,75 und mehr Jahre,191,72,119
False,8237024,Empfingen,Insgesamt,4037,2033,2004
False,8237027,Eutingen im Gäu,unter 3 Jahre,215,113,102
False,8237027,Eutingen im Gäu,3 -  6 Jahre,246,135,111
False,8237027,Eutingen im Gäu,6 - 10 Jahre,333,169,164
False,8237027,Eutingen im Gäu,10 - 15 Jahre,374,187,187
False,8237027,Eutingen im Gäu,15 - 18 Jahre,197,93,104
False,8237027,Eutingen im Gäu,18 - 20 Jahre,101,50,51
False,8237027,Eutingen im Gäu,20 - 25 Jahre,283,139,144
False,8237027,Eutingen im Gäu,25 - 30 Jahre,320,138,182
False,8237027,Eutingen im Gäu,30 - 35 Jahre,500,258,242
False,8237027,Eutingen im Gäu,35 - 40 Jahre,543,290,253
False,8237027,Eutingen im Gäu,40 - 45 Jahre,404,208,196
False,8237027,Eutingen im Gäu,45 - 50 Jahre,348,174,174
False,8237027,Eutingen im Gäu,50 - 55 Jahre,269,147,122
False,8237027,Eutingen im Gäu,55 - 60 Jahre,246,135,111
False,8237027,Eutingen im Gäu,60 - 65 Jahre,295,139,156
False,8237027,Eutingen im Gäu,65 - 75 Jahre,378,173,205
False,8237027,Eutingen im Gäu,75 und mehr Jahre,236,83,153
False,8237027,Eutingen im Gäu,Insgesamt,5288,2631,2657
False,8237028,"Freudenstadt, Stadt",unter 3 Jahre,687,366,321
False,8237028,"Freudenstadt, Stadt",3 -  6 Jahre,678,359,319
False,8237028,"Freudenstadt, Stadt",6 - 10 Jahre,972,479,493
False,8237028,"Freudenstadt, Stadt",10 - 15 Jahre,1280,663,617
False,8237028,"Freudenstadt, Stadt",15 - 18 Jahre,775,377,398
False,8237028,"Freudenstadt, Stadt",18 - 20 Jahre,614,293,321
False,8237028,"Freudenstadt, Stadt",20 - 25 Jahre,1284,658,626
False,8237028,"Freudenstadt, Stadt",25 - 30 Jahre,1299,605,694
False,8237028,"Freudenstadt, Stadt",30 - 35 Jahre,1808,875,933
False,8237028,"Freudenstadt, Stadt",35 - 40 Jahre,1902,957,945
False,8237028,"Freudenstadt, Stadt",40 - 45 Jahre,1712,837,875
False,8237028,"Freudenstadt, Stadt",45 - 50 Jahre,1595,804,791
False,8237028,"Freudenstadt, Stadt",50 - 55 Jahre,1335,680,655
False,8237028,"Freudenstadt, Stadt",55 - 60 Jahre,1324,615,709
False,8237028,"Freudenstadt, Stadt",60 - 65 Jahre,1635,774,861
False,8237028,"Freudenstadt, Stadt",65 - 75 Jahre,2378,1000,1378
False,8237028,"Freudenstadt, Stadt",75 und mehr Jahre,2279,696,1583
False,8237028,"Freudenstadt, Stadt",Insgesamt,23557,11038,12519
False,8237030,Glatten,unter 3 Jahre,84,43,41
False,8237030,Glatten,3 -  6 Jahre,88,47,41
False,8237030,Glatten,6 - 10 Jahre,141,61,80
False,8237030,Glatten,10 - 15 Jahre,155,64,91
False,8237030,Glatten,15 - 18 Jahre,104,59,45
False,8237030,Glatten,18 - 20 Jahre,69,31,38
False,8237030,Glatten,20 - 25 Jahre,165,90,75
False,8237030,Glatten,25 - 30 Jahre,124,65,59
False,8237030,Glatten,30 - 35 Jahre,182,107,75
False,8237030,Glatten,35 - 40 Jahre,190,82,108
False,8237030,Glatten,40 - 45 Jahre,209,100,109
False,8237030,Glatten,45 - 50 Jahre,192,105,87
False,8237030,Glatten,50 - 55 Jahre,130,63,67
False,8237030,Glatten,55 - 60 Jahre,127,59,68
False,8237030,Glatten,60 - 65 Jahre,167,84,83
False,8237030,Glatten,65 - 75 Jahre,238,103,135
False,8237030,Glatten,75 und mehr Jahre,146,40,106
False,8237030,Glatten,Insgesamt,2511,1203,1308
False,8237032,Grömbach,unter 3 Jahre,23,12,11
False,8237032,Grömbach,3 -  6 Jahre,25,15,10
False,8237032,Grömbach,6 - 10 Jahre,34,16,18
False,8237032,Grömbach,10 - 15 Jahre,51,30,21
False,8237032,Grömbach,15 - 18 Jahre,32,23,9
False,8237032,Grömbach,18 - 20 Jahre,16,10,6
False,8237032,Grömbach,20 - 25 Jahre,34,18,16
False,8237032,Grömbach,25 - 30 Jahre,39,24,15
False,8237032,Grömbach,30 - 35 Jahre,66,31,35
False,8237032,Grömbach,35 - 40 Jahre,55,30,25
False,8237032,Grömbach,40 - 45 Jahre,41,18,23
False,8237032,Grömbach,45 - 50 Jahre,44,25,19
False,8237032,Grömbach,50 - 55 Jahre,42,19,23
False,8237032,Grömbach,55 - 60 Jahre,31,15,16
False,8237032,Grömbach,60 - 65 Jahre,39,22,17
False,8237032,Grömbach,65 - 75 Jahre,45,19,26
False,8237032,Grömbach,75 und mehr Jahre,39,10,29
False,8237032,Grömbach,Insgesamt,656,337,319
False,8237040,"Horb am Neckar, Stadt",unter 3 Jahre,851,440,411
False,8237040,"Horb am Neckar, Stadt",3 -  6 Jahre,929,508,421
False,8237040,"Horb am Neckar, Stadt",6 - 10 Jahre,1317,693,624
False,8237040,"Horb am Neckar, Stadt",10 - 15 Jahre,1726,847,879
False,8237040,"Horb am Neckar, Stadt",15 - 18 Jahre,923,477,446
False,8237040,"Horb am Neckar, Stadt",18 - 20 Jahre,632,315,317
False,8237040,"Horb am Neckar, Stadt",20 - 25 Jahre,1489,774,715
False,8237040,"Horb am Neckar, Stadt",25 - 30 Jahre,1706,881,825
False,8237040,"Horb am Neckar, Stadt",30 - 35 Jahre,2055,1079,976
False,8237040,"Horb am Neckar, Stadt",35 - 40 Jahre,2259,1165,1094
False,8237040,"Horb am Neckar, Stadt",40 - 45 Jahre,2018,1047,971
False,8237040,"Horb am Neckar, Stadt",45 - 50 Jahre,1714,885,829
False,8237040,"Horb am Neckar, Stadt",50 - 55 Jahre,1474,767,707
False,8237040,"Horb am Neckar, Stadt",55 - 60 Jahre,1286,663,623
False,8237040,"Horb am Neckar, Stadt",60 - 65 Jahre,1593,799,794
False,8237040,"Horb am Neckar, Stadt",65 - 75 Jahre,2066,965,1101
False,8237040,"Horb am Neckar, Stadt",75 und mehr Jahre,1416,412,1004
False,8237040,"Horb am Neckar, Stadt",Insgesamt,25454,12717,12737
False,8237045,Loßburg,unter 3 Jahre,230,119,111
False,8237045,Loßburg,3 -  6 Jahre,285,145,140
False,8237045,Loßburg,6 - 10 Jahre,402,213,189
False,8237045,Loßburg,10 - 15 Jahre,543,290,253
False,8237045,Loßburg,15 - 18 Jahre,307,155,152
False,8237045,Loßburg,18 - 20 Jahre,204,108,96
False,8237045,Loßburg,20 - 25 Jahre,377,204,173
False,8237045,Loßburg,25 - 30 Jahre,432,208,224
False,8237045,Loßburg,30 - 35 Jahre,622,334,288
False,8237045,Loßburg,35 - 40 Jahre,724,386,338
False,8237045,Loßburg,40 - 45 Jahre,641,319,322
False,8237045,Loßburg,45 - 50 Jahre,473,258,215
False,8237045,Loßburg,50 - 55 Jahre,412,220,192
False,8237045,Loßburg,55 - 60 Jahre,416,204,212
False,8237045,Loßburg,60 - 65 Jahre,541,266,275
False,8237045,Loßburg,65 - 75 Jahre,738,348,390
False,8237045,Loßburg,75 und mehr Jahre,523,155,368
False,8237045,Loßburg,Insgesamt,7870,3932,3938
False,8237054,Pfalzgrafenweiler,unter 3 Jahre,252,118,134
False,8237054,Pfalzgrafenweiler,3 -  6 Jahre,315,151,164
False,8237054,Pfalzgrafenweiler,6 - 10 Jahre,384,198,186
False,8237054,Pfalzgrafenweiler,10 - 15 Jahre,478,249,229
False,8237054,Pfalzgrafenweiler,15 - 18 Jahre,239,132,107
False,8237054,Pfalzgrafenweiler,18 - 20 Jahre,168,89,79
False,8237054,Pfalzgrafenweiler,20 - 25 Jahre,367,194,173
False,8237054,Pfalzgrafenweiler,25 - 30 Jahre,431,215,216
False,8237054,Pfalzgrafenweiler,30 - 35 Jahre,579,295,284
False,8237054,Pfalzgrafenweiler,35 - 40 Jahre,563,284,279
False,8237054,Pfalzgrafenweiler,40 - 45 Jahre,510,244,266
False,8237054,Pfalzgrafenweiler,45 - 50 Jahre,447,228,219
False,8237054,Pfalzgrafenweiler,50 - 55 Jahre,319,162,157
False,8237054,Pfalzgrafenweiler,55 - 60 Jahre,296,148,148
False,8237054,Pfalzgrafenweiler,60 - 65 Jahre,441,213,228
False,8237054,Pfalzgrafenweiler,65 - 75 Jahre,559,276,283
False,8237054,Pfalzgrafenweiler,75 und mehr Jahre,454,131,323
False,8237054,Pfalzgrafenweiler,Insgesamt,6802,3327,3475
False,8237061,Schopfloch,unter 3 Jahre,96,58,38
False,8237061,Schopfloch,3 -  6 Jahre,103,58,45
False,8237061,Schopfloch,6 - 10 Jahre,144,71,73
False,8237061,Schopfloch,10 - 15 Jahre,180,76,104
False,8237061,Schopfloch,15 - 18 Jahre,73,40,33
False,8237061,Schopfloch,18 - 20 Jahre,51,28,23
False,8237061,Schopfloch,20 - 25 Jahre,144,71,73
False,8237061,Schopfloch,25 - 30 Jahre,152,71,81
False,8237061,Schopfloch,30 - 35 Jahre,201,103,98
False,8237061,Schopfloch,35 - 40 Jahre,201,108,93
False,8237061,Schopfloch,40 - 45 Jahre,169,83,86
False,8237061,Schopfloch,45 - 50 Jahre,183,106,77
False,8237061,Schopfloch,50 - 55 Jahre,120,60,60
False,8237061,Schopfloch,55 - 60 Jahre,123,64,59
False,8237061,Schopfloch,60 - 65 Jahre,161,75,86
False,8237061,Schopfloch,65 - 75 Jahre,222,97,125
False,8237061,Schopfloch,75 und mehr Jahre,159,51,108
False,8237061,Schopfloch,Insgesamt,2482,1220,1262
False,8237072,Wörnersberg,unter 3 Jahre,9,3,6
False,8237072,Wörnersberg,3 -  6 Jahre,12,10,2
False,8237072,Wörnersberg,6 - 10 Jahre,12,6,6
False,8237072,Wörnersberg,10 - 15 Jahre,14,8,6
False,8237072,Wörnersberg,15 - 18 Jahre,9,5,4
False,8237072,Wörnersberg,18 - 20 Jahre,9,4,5
False,8237072,Wörnersberg,20 - 25 Jahre,17,5,12
False,8237072,Wörnersberg,25 - 30 Jahre,14,3,11
False,8237072,Wörnersberg,30 - 35 Jahre,9,6,3
False,8237072,Wörnersberg,35 - 40 Jahre,25,12,13
False,8237072,Wörnersberg,40 - 45 Jahre,20,9,11
False,8237072,Wörnersberg,45 - 50 Jahre,12,9,3
False,8237072,Wörnersberg,50 - 55 Jahre,7,4,3
False,8237072,Wörnersberg,55 - 60 Jahre,12,5,7
False,8237072,Wörnersberg,60 - 65 Jahre,10,6,4
False,8237072,Wörnersberg,65 - 75 Jahre,16,5,11
False,8237072,Wörnersberg,75 und mehr Jahre,12,4,8
False,8237072,Wörnersberg,Insgesamt,219,104,115
False,8237073,Seewald,unter 3 Jahre,61,35,26
False,8237073,Seewald,3 -  6 Jahre,84,41,43
False,8237073,Seewald,6 - 10 Jahre,136,68,68
False,8237073,Seewald,10 - 15 Jahre,138,70,68
False,8237073,Seewald,15 - 18 Jahre,80,44,36
False,8237073,Seewald,18 - 20 Jahre,43,20,23
False,8237073,Seewald,20 - 25 Jahre,113,59,54
False,8237073,Seewald,25 - 30 Jahre,120,65,55
False,8237073,Seewald,30 - 35 Jahre,200,116,84
False,8237073,Seewald,35 - 40 Jahre,234,111,123
False,8237073,Seewald,40 - 45 Jahre,188,102,86
False,8237073,Seewald,45 - 50 Jahre,132,68,64
False,8237073,Seewald,50 - 55 Jahre,115,65,50
False,8237073,Seewald,55 - 60 Jahre,128,59,69
False,8237073,Seewald,60 - 65 Jahre,188,89,99
False,8237073,Seewald,65 - 75 Jahre,248,120,128
False,8237073,Seewald,75 und mehr Jahre,216,68,148
False,8237073,Seewald,Insgesamt,2424,1200,1224
False,8237074,Waldachtal,unter 3 Jahre,183,89,94
False,8237074,Waldachtal,3 -  6 Jahre,236,122,114
False,8237074,Waldachtal,6 - 10 Jahre,368,177,191
False,8237074,Waldachtal,10 - 15 Jahre,417,221,196
False,8237074,Waldachtal,15 - 18 Jahre,215,111,104
False,8237074,Waldachtal,18 - 20 Jahre,168,93,75
False,8237074,Waldachtal,20 - 25 Jahre,365,189,176
False,8237074,Waldachtal,25 - 30 Jahre,372,178,194
False,8237074,Waldachtal,30 - 35 Jahre,488,245,243
False,8237074,Waldachtal,35 - 40 Jahre,547,286,261
False,8237074,Waldachtal,40 - 45 Jahre,503,270,233
False,8237074,Waldachtal,45 - 50 Jahre,448,231,217
False,8237074,Waldachtal,50 - 55 Jahre,351,182,169
False,8237074,Waldachtal,55 - 60 Jahre,309,157,152
False,8237074,Waldachtal,60 - 65 Jahre,357,182,175
False,8237074,Waldachtal,65 - 75 Jahre,465,182,283
False,8237074,Waldachtal,75 und mehr Jahre,320,101,219
False,8237074,Waldachtal,Insgesamt,6112,3016,3096
False,8237075,Bad Rippoldsau-Schapbach,unter 3 Jahre,57,29,28
False,8237075,Bad Rippoldsau-Schapbach,3 -  6 Jahre,91,51,40
False,8237075,Bad Rippoldsau-Schapbach,6 - 10 Jahre,112,55,57
False,8237075,Bad Rippoldsau-Schapbach,10 - 15 Jahre,122,60,62
False,8237075,Bad Rippoldsau-Schapbach,15 - 18 Jahre,74,42,32
False,8237075,Bad Rippoldsau-Schapbach,18 - 20 Jahre,64,36,28
False,8237075,Bad Rippoldsau-Schapbach,20 - 25 Jahre,134,73,61
False,8237075,Bad Rippoldsau-Schapbach,25 - 30 Jahre,137,75,62
False,8237075,Bad Rippoldsau-Schapbach,30 - 35 Jahre,174,98,76
False,8237075,Bad Rippoldsau-Schapbach,35 - 40 Jahre,202,99,103
False,8237075,Bad Rippoldsau-Schapbach,40 - 45 Jahre,163,99,64
False,8237075,Bad Rippoldsau-Schapbach,45 - 50 Jahre,125,65,60
False,8237075,Bad Rippoldsau-Schapbach,50 - 55 Jahre,126,63,63
False,8237075,Bad Rippoldsau-Schapbach,55 - 60 Jahre,119,52,67
False,8237075,Bad Rippoldsau-Schapbach,60 - 65 Jahre,174,86,88
False,8237075,Bad Rippoldsau-Schapbach,65 - 75 Jahre,259,130,129
False,8237075,Bad Rippoldsau-Schapbach,75 und mehr Jahre,211,64,147
False,8237075,Bad Rippoldsau-Schapbach,Insgesamt,2344,1177,1167
False,83,Regierungsbezirk Freiburg,unter 3 Jahre,66320,34262,32058
False,83,Regierungsbezirk Freiburg,3 -  6 Jahre,70894,36399,34495
False,83,Regierungsbezirk Freiburg,6 - 10 Jahre,97953,50429,47524
False,83,Regierungsbezirk Freiburg,10 - 15 Jahre,127947,65100,62847
False,83,Regierungsbezirk Freiburg,15 - 18 Jahre,71451,36776,34675
False,83,Regierungsbezirk Freiburg,18 - 20 Jahre,49156,24758,24398
False,83,Regierungsbezirk Freiburg,20 - 25 Jahre,121873,60940,60933
False,83,Regierungsbezirk Freiburg,25 - 30 Jahre,129562,65136,64426
False,83,Regierungsbezirk Freiburg,30 - 35 Jahre,176520,89364,87156
False,83,Regierungsbezirk Freiburg,35 - 40 Jahre,190511,97089,93422
False,83,Regierungsbezirk Freiburg,40 - 45 Jahre,167455,85367,82088
False,83,Regierungsbezirk Freiburg,45 - 50 Jahre,144363,72542,71821
False,83,Regierungsbezirk Freiburg,50 - 55 Jahre,122310,61556,60754
False,83,Regierungsbezirk Freiburg,55 - 60 Jahre,115157,56914,58243
False,83,Regierungsbezirk Freiburg,60 - 65 Jahre,139861,68339,71522
False,83,Regierungsbezirk Freiburg,65 - 75 Jahre,193143,88783,104360
False,83,Regierungsbezirk Freiburg,75 und mehr Jahre,153149,46507,106642
False,83,Regierungsbezirk Freiburg,Insgesamt,2137625,1040261,1097364
False,8311,Stadtkreis Freiburg im Breisgau,unter 3 Jahre,5818,3077,2741
False,8311,Stadtkreis Freiburg im Breisgau,3 -  6 Jahre,5514,2854,2660
False,8311,Stadtkreis Freiburg im Breisgau,6 - 10 Jahre,7061,3511,3550
False,8311,Stadtkreis Freiburg im Breisgau,10 - 15 Jahre,9017,4609,4408
False,8311,Stadtkreis Freiburg im Breisgau,15 - 18 Jahre,5202,2648,2554
False,8311,Stadtkreis Freiburg im Breisgau,18 - 20 Jahre,4102,1933,2169
False,8311,Stadtkreis Freiburg im Breisgau,20 - 25 Jahre,17392,7840,9552
False,8311,Stadtkreis Freiburg im Breisgau,25 - 30 Jahre,17775,8817,8958
False,8311,Stadtkreis Freiburg im Breisgau,30 - 35 Jahre,20229,10133,10096
False,8311,Stadtkreis Freiburg im Breisgau,35 - 40 Jahre,20966,10737,10229
False,8311,Stadtkreis Freiburg im Breisgau,40 - 45 Jahre,16675,8680,7995
False,8311,Stadtkreis Freiburg im Breisgau,45 - 50 Jahre,13154,6623,6531
False,8311,Stadtkreis Freiburg im Breisgau,50 - 55 Jahre,10530,5194,5336
False,8311,Stadtkreis Freiburg im Breisgau,55 - 60 Jahre,10160,4867,5293
False,8311,Stadtkreis Freiburg im Breisgau,60 - 65 Jahre,10746,4975,5771
False,8311,Stadtkreis Freiburg im Breisgau,65 - 75 Jahre,15364,6594,8770
False,8311,Stadtkreis Freiburg im Breisgau,75 und mehr Jahre,15397,4285,11112
False,8311,Stadtkreis Freiburg im Breisgau,Insgesamt,205102,97377,107725
False,8311000,"Freiburg im Breisgau, Stadt",unter 3 Jahre,5818,3077,2741
False,8311000,"Freiburg im Breisgau, Stadt",3 -  6 Jahre,5514,2854,2660
False,8311000,"Freiburg im Breisgau, Stadt",6 - 10 Jahre,7061,3511,3550
False,8311000,"Freiburg im Breisgau, Stadt",10 - 15 Jahre,9017,4609,4408
False,8311000,"Freiburg im Breisgau, Stadt",15 - 18 Jahre,5202,2648,2554
False,8311000,"Freiburg im Breisgau, Stadt",18 - 20 Jahre,4102,1933,2169
False,8311000,"Freiburg im Breisgau, Stadt",20 - 25 Jahre,17392,7840,9552
False,8311000,"Freiburg im Breisgau, Stadt",25 - 30 Jahre,17775,8817,8958
False,8311000,"Freiburg im Breisgau, Stadt",30 - 35 Jahre,20229,10133,10096
False,8311000,"Freiburg im Breisgau, Stadt",35 - 40 Jahre,20966,10737,10229
False,8311000,"Freiburg im Breisgau, Stadt",40 - 45 Jahre,16675,8680,7995
False,8311000,"Freiburg im Breisgau, Stadt",45 - 50 Jahre,13154,6623,6531
False,8311000,"Freiburg im Breisgau, Stadt",50 - 55 Jahre,10530,5194,5336
False,8311000,"Freiburg im Breisgau, Stadt",55 - 60 Jahre,10160,4867,5293
False,8311000,"Freiburg im Breisgau, Stadt",60 - 65 Jahre,10746,4975,5771
False,8311000,"Freiburg im Breisgau, Stadt",65 - 75 Jahre,15364,6594,8770
False,8311000,"Freiburg im Breisgau, Stadt",75 und mehr Jahre,15397,4285,11112
False,8311000,"Freiburg im Breisgau, Stadt",Insgesamt,205102,97377,107725
False,8315,Landkreis Breisgau-Hochschwarzwald,unter 3 Jahre,7745,4024,3721
False,8315,Landkreis Breisgau-Hochschwarzwald,3 -  6 Jahre,8407,4315,4092
False,8315,Landkreis Breisgau-Hochschwarzwald,6 - 10 Jahre,11515,6086,5429
False,8315,Landkreis Breisgau-Hochschwarzwald,10 - 15 Jahre,14659,7365,7294
False,8315,Landkreis Breisgau-Hochschwarzwald,15 - 18 Jahre,8063,4135,3928
False,8315,Landkreis Breisgau-Hochschwarzwald,18 - 20 Jahre,5630,2802,2828
False,8315,Landkreis Breisgau-Hochschwarzwald,20 - 25 Jahre,12753,6407,6346
False,8315,Landkreis Breisgau-Hochschwarzwald,25 - 30 Jahre,13704,6731,6973
False,8315,Landkreis Breisgau-Hochschwarzwald,30 - 35 Jahre,19839,9862,9977
False,8315,Landkreis Breisgau-Hochschwarzwald,35 - 40 Jahre,21360,10687,10673
False,8315,Landkreis Breisgau-Hochschwarzwald,40 - 45 Jahre,18930,9547,9383
False,8315,Landkreis Breisgau-Hochschwarzwald,45 - 50 Jahre,16914,8313,8601
False,8315,Landkreis Breisgau-Hochschwarzwald,50 - 55 Jahre,14522,7262,7260
False,8315,Landkreis Breisgau-Hochschwarzwald,55 - 60 Jahre,13514,6638,6876
False,8315,Landkreis Breisgau-Hochschwarzwald,60 - 65 Jahre,15569,7580,7989
False,8315,Landkreis Breisgau-Hochschwarzwald,65 - 75 Jahre,20747,9684,11063
False,8315,Landkreis Breisgau-Hochschwarzwald,75 und mehr Jahre,16674,5409,11265
False,8315,Landkreis Breisgau-Hochschwarzwald,Insgesamt,240545,116847,123698
False,8315003,Au,unter 3 Jahre,45,22,23
False,8315003,Au,3 -  6 Jahre,51,31,20
False,8315003,Au,6 - 10 Jahre,57,33,24
False,8315003,Au,10 - 15 Jahre,65,43,22
False,8315003,Au,15 - 18 Jahre,42,20,22
False,8315003,Au,18 - 20 Jahre,28,12,16
False,8315003,Au,20 - 25 Jahre,67,40,27
False,8315003,Au,25 - 30 Jahre,74,32,42
False,8315003,Au,30 - 35 Jahre,123,59,64
False,8315003,Au,35 - 40 Jahre,125,59,66
False,8315003,Au,40 - 45 Jahre,105,50,55
False,8315003,Au,45 - 50 Jahre,100,49,51
False,8315003,Au,50 - 55 Jahre,84,40,44
False,8315003,Au,55 - 60 Jahre,85,39,46
False,8315003,Au,60 - 65 Jahre,81,39,42
False,8315003,Au,65 - 75 Jahre,103,49,54
False,8315003,Au,75 und mehr Jahre,56,23,33
False,8315003,Au,Insgesamt,1291,640,651
False,8315004,Auggen,unter 3 Jahre,91,40,51
False,8315004,Auggen,3 -  6 Jahre,93,46,47
False,8315004,Auggen,6 - 10 Jahre,122,71,51
False,8315004,Auggen,10 - 15 Jahre,128,56,72
False,8315004,Auggen,15 - 18 Jahre,81,41,40
False,8315004,Auggen,18 - 20 Jahre,53,28,25
False,8315004,Auggen,20 - 25 Jahre,115,58,57
False,8315004,Auggen,25 - 30 Jahre,115,58,57
False,8315004,Auggen,30 - 35 Jahre,213,99,114
False,8315004,Auggen,35 - 40 Jahre,185,100,85
False,8315004,Auggen,40 - 45 Jahre,157,79,78
False,8315004,Auggen,45 - 50 Jahre,168,71,97
False,8315004,Auggen,50 - 55 Jahre,158,91,67
False,8315004,Auggen,55 - 60 Jahre,149,75,74
False,8315004,Auggen,60 - 65 Jahre,167,87,80
False,8315004,Auggen,65 - 75 Jahre,178,85,93
False,8315004,Auggen,75 und mehr Jahre,173,57,116
False,8315004,Auggen,Insgesamt,2346,1142,1204
False,8315006,"Bad Krozingen, Stadt",unter 3 Jahre,469,259,210
False,8315006,"Bad Krozingen, Stadt",3 -  6 Jahre,495,266,229
False,8315006,"Bad Krozingen, Stadt",6 - 10 Jahre,649,316,333
False,8315006,"Bad Krozingen, Stadt",10 - 15 Jahre,829,429,400
False,8315006,"Bad Krozingen, Stadt",15 - 18 Jahre,375,214,161
False,8315006,"Bad Krozingen, Stadt",18 - 20 Jahre,282,134,148
False,8315006,"Bad Krozingen, Stadt",20 - 25 Jahre,702,319,383
False,8315006,"Bad Krozingen, Stadt",25 - 30 Jahre,806,367,439
False,8315006,"Bad Krozingen, Stadt",30 - 35 Jahre,1073,529,544
False,8315006,"Bad Krozingen, Stadt",35 - 40 Jahre,1212,619,593
False,8315006,"Bad Krozingen, Stadt",40 - 45 Jahre,1077,537,540
False,8315006,"Bad Krozingen, Stadt",45 - 50 Jahre,1008,453,555
False,8315006,"Bad Krozingen, Stadt",50 - 55 Jahre,925,442,483
False,8315006,"Bad Krozingen, Stadt",55 - 60 Jahre,860,407,453
False,8315006,"Bad Krozingen, Stadt",60 - 65 Jahre,985,471,514
False,8315006,"Bad Krozingen, Stadt",65 - 75 Jahre,1427,617,810
False,8315006,"Bad Krozingen, Stadt",75 und mehr Jahre,1796,553,1243
False,8315006,"Bad Krozingen, Stadt",Insgesamt,14970,6932,8038
False,8315007,Badenweiler,unter 3 Jahre,89,38,51
False,8315007,Badenweiler,3 -  6 Jahre,78,49,29
False,8315007,Badenweiler,6 - 10 Jahre,140,72,68
False,8315007,Badenweiler,10 - 15 Jahre,170,83,87
False,8315007,Badenweiler,15 - 18 Jahre,96,42,54
False,8315007,Badenweiler,18 - 20 Jahre,67,27,40
False,8315007,Badenweiler,20 - 25 Jahre,172,79,93
False,8315007,Badenweiler,25 - 30 Jahre,147,63,84
False,8315007,Badenweiler,30 - 35 Jahre,247,116,131
False,8315007,Badenweiler,35 - 40 Jahre,234,117,117
False,8315007,Badenweiler,40 - 45 Jahre,243,134,109
False,8315007,Badenweiler,45 - 50 Jahre,254,125,129
False,8315007,Badenweiler,50 - 55 Jahre,234,107,127
False,8315007,Badenweiler,55 - 60 Jahre,252,125,127
False,8315007,Badenweiler,60 - 65 Jahre,300,146,154
False,8315007,Badenweiler,65 - 75 Jahre,441,186,255
False,8315007,Badenweiler,75 und mehr Jahre,550,194,356
False,8315007,Badenweiler,Insgesamt,3714,1703,2011
False,8315008,Ballrechten-Dottingen,unter 3 Jahre,73,41,32
False,8315008,Ballrechten-Dottingen,3 -  6 Jahre,91,50,41
False,8315008,Ballrechten-Dottingen,6 - 10 Jahre,121,66,55
False,8315008,Ballrechten-Dottingen,10 - 15 Jahre,170,82,88
False,8315008,Ballrechten-Dottingen,15 - 18 Jahre,78,43,35
False,8315008,Ballrechten-Dottingen,18 - 20 Jahre,52,25,27
False,8315008,Ballrechten-Dottingen,20 - 25 Jahre,123,67,56
False,8315008,Ballrechten-Dottingen,25 - 30 Jahre,122,64,58
False,8315008,Ballrechten-Dottingen,30 - 35 Jahre,191,91,100
False,8315008,Ballrechten-Dottingen,35 - 40 Jahre,210,105,105
False,8315008,Ballrechten-Dottingen,40 - 45 Jahre,164,72,92
False,8315008,Ballrechten-Dottingen,45 - 50 Jahre,157,77,80
False,8315008,Ballrechten-Dottingen,50 - 55 Jahre,140,74,66
False,8315008,Ballrechten-Dottingen,55 - 60 Jahre,103,49,54
False,8315008,Ballrechten-Dottingen,60 - 65 Jahre,99,55,44
False,8315008,Ballrechten-Dottingen,65 - 75 Jahre,118,54,64
False,8315008,Ballrechten-Dottingen,75 und mehr Jahre,102,35,67
False,8315008,Ballrechten-Dottingen,Insgesamt,2114,1050,1064
False,8315013,Bötzingen,unter 3 Jahre,196,93,103
False,8315013,Bötzingen,3 -  6 Jahre,214,113,101
False,8315013,Bötzingen,6 - 10 Jahre,258,134,124
False,8315013,Bötzingen,10 - 15 Jahre,361,194,167
False,8315013,Bötzingen,15 - 18 Jahre,169,89,80
False,8315013,Bötzingen,18 - 20 Jahre,127,59,68
False,8315013,Bötzingen,20 - 25 Jahre,269,149,120
False,8315013,Bötzingen,25 - 30 Jahre,336,160,176
False,8315013,Bötzingen,30 - 35 Jahre,465,236,229
False,8315013,Bötzingen,35 - 40 Jahre,505,262,243
False,8315013,Bötzingen,40 - 45 Jahre,358,199,159
False,8315013,Bötzingen,45 - 50 Jahre,334,151,183
False,8315013,Bötzingen,50 - 55 Jahre,288,142,146
False,8315013,Bötzingen,55 - 60 Jahre,301,168,133
False,8315013,Bötzingen,60 - 65 Jahre,308,154,154
False,8315013,Bötzingen,65 - 75 Jahre,398,199,199
False,8315013,Bötzingen,75 und mehr Jahre,221,71,150
False,8315013,Bötzingen,Insgesamt,5108,2573,2535
False,8315014,Bollschweil,unter 3 Jahre,64,26,38
False,8315014,Bollschweil,3 -  6 Jahre,73,36,37
False,8315014,Bollschweil,6 - 10 Jahre,135,75,60
False,8315014,Bollschweil,10 - 15 Jahre,156,75,81
False,8315014,Bollschweil,15 - 18 Jahre,71,32,39
False,8315014,Bollschweil,18 - 20 Jahre,47,29,18
False,8315014,Bollschweil,20 - 25 Jahre,113,46,67
False,8315014,Bollschweil,25 - 30 Jahre,119,62,57
False,8315014,Bollschweil,30 - 35 Jahre,185,91,94
False,8315014,Bollschweil,35 - 40 Jahre,241,120,121
False,8315014,Bollschweil,40 - 45 Jahre,196,103,93
False,8315014,Bollschweil,45 - 50 Jahre,173,81,92
False,8315014,Bollschweil,50 - 55 Jahre,154,65,89
False,8315014,Bollschweil,55 - 60 Jahre,135,75,60
False,8315014,Bollschweil,60 - 65 Jahre,162,75,87
False,8315014,Bollschweil,65 - 75 Jahre,177,95,82
False,8315014,Bollschweil,75 und mehr Jahre,129,52,77
False,8315014,Bollschweil,Insgesamt,2330,1138,1192
False,8315015,"Breisach am Rhein, Stadt",unter 3 Jahre,450,233,217
False,8315015,"Breisach am Rhein, Stadt",3 -  6 Jahre,512,251,261
False,8315015,"Breisach am Rhein, Stadt",6 - 10 Jahre,665,337,328
False,8315015,"Breisach am Rhein, Stadt",10 - 15 Jahre,858,450,408
False,8315015,"Breisach am Rhein, Stadt",15 - 18 Jahre,509,277,232
False,8315015,"Breisach am Rhein, Stadt",18 - 20 Jahre,340,185,155
False,8315015,"Breisach am Rhein, Stadt",20 - 25 Jahre,697,370,327
False,8315015,"Breisach am Rhein, Stadt",25 - 30 Jahre,724,383,341
False,8315015,"Breisach am Rhein, Stadt",30 - 35 Jahre,1076,567,509
False,8315015,"Breisach am Rhein, Stadt",35 - 40 Jahre,1089,515,574
False,8315015,"Breisach am Rhein, Stadt",40 - 45 Jahre,1109,525,584
False,8315015,"Breisach am Rhein, Stadt",45 - 50 Jahre,984,511,473
False,8315015,"Breisach am Rhein, Stadt",50 - 55 Jahre,870,463,407
False,8315015,"Breisach am Rhein, Stadt",55 - 60 Jahre,663,325,338
False,8315015,"Breisach am Rhein, Stadt",60 - 65 Jahre,799,394,405
False,8315015,"Breisach am Rhein, Stadt",65 - 75 Jahre,1031,479,552
False,8315015,"Breisach am Rhein, Stadt",75 und mehr Jahre,714,200,514
False,8315015,"Breisach am Rhein, Stadt",Insgesamt,13090,6465,6625
False,8315016,Breitnau,unter 3 Jahre,59,30,29
False,8315016,Breitnau,3 -  6 Jahre,40,27,13
False,8315016,Breitnau,6 - 10 Jahre,68,41,27
False,8315016,Breitnau,10 - 15 Jahre,84,39,45
False,8315016,Breitnau,15 - 18 Jahre,69,32,37
False,8315016,Breitnau,18 - 20 Jahre,81,46,35
False,8315016,Breitnau,20 - 25 Jahre,133,70,63
False,8315016,Breitnau,25 - 30 Jahre,186,88,98
False,8315016,Breitnau,30 - 35 Jahre,194,108,86
False,8315016,Breitnau,35 - 40 Jahre,129,72,57
False,8315016,Breitnau,40 - 45 Jahre,113,71,42
False,8315016,Breitnau,45 - 50 Jahre,111,57,54
False,8315016,Breitnau,50 - 55 Jahre,90,43,47
False,8315016,Breitnau,55 - 60 Jahre,86,48,38
False,8315016,Breitnau,60 - 65 Jahre,109,50,59
False,8315016,Breitnau,65 - 75 Jahre,131,65,66
False,8315016,Breitnau,75 und mehr Jahre,126,47,79
False,8315016,Breitnau,Insgesamt,1809,934,875
False,8315020,Buchenbach,unter 3 Jahre,122,69,53
False,8315020,Buchenbach,3 -  6 Jahre,139,69,70
False,8315020,Buchenbach,6 - 10 Jahre,191,102,89
False,8315020,Buchenbach,10 - 15 Jahre,213,110,103
False,8315020,Buchenbach,15 - 18 Jahre,114,61,53
False,8315020,Buchenbach,18 - 20 Jahre,60,21,39
False,8315020,Buchenbach,20 - 25 Jahre,177,97,80
False,8315020,Buchenbach,25 - 30 Jahre,183,96,87
False,8315020,Buchenbach,30 - 35 Jahre,281,145,136
False,8315020,Buchenbach,35 - 40 Jahre,325,154,171
False,8315020,Buchenbach,40 - 45 Jahre,240,125,115
False,8315020,Buchenbach,45 - 50 Jahre,217,100,117
False,8315020,Buchenbach,50 - 55 Jahre,194,97,97
False,8315020,Buchenbach,55 - 60 Jahre,189,93,96
False,8315020,Buchenbach,60 - 65 Jahre,192,90,102
False,8315020,Buchenbach,65 - 75 Jahre,238,110,128
False,8315020,Buchenbach,75 und mehr Jahre,141,51,90
False,8315020,Buchenbach,Insgesamt,3216,1590,1626
False,8315022,Buggingen,unter 3 Jahre,129,71,58
False,8315022,Buggingen,3 -  6 Jahre,125,65,60
False,8315022,Buggingen,6 - 10 Jahre,193,102,91
False,8315022,Buggingen,10 - 15 Jahre,236,130,106
False,8315022,Buggingen,15 - 18 Jahre,133,70,63
False,8315022,Buggingen,18 - 20 Jahre,101,51,50
False,8315022,Buggingen,20 - 25 Jahre,213,122,91
False,8315022,Buggingen,25 - 30 Jahre,192,94,98
False,8315022,Buggingen,30 - 35 Jahre,313,166,147
False,8315022,Buggingen,35 - 40 Jahre,336,181,155
False,8315022,Buggingen,40 - 45 Jahre,296,145,151
False,8315022,Buggingen,45 - 50 Jahre,271,143,128
False,8315022,Buggingen,50 - 55 Jahre,217,104,113
False,8315022,Buggingen,55 - 60 Jahre,200,102,98
False,8315022,Buggingen,60 - 65 Jahre,216,117,99
False,8315022,Buggingen,65 - 75 Jahre,342,154,188
False,8315022,Buggingen,75 und mehr Jahre,208,80,128
False,8315022,Buggingen,Insgesamt,3721,1897,1824
False,8315028,Ebringen,unter 3 Jahre,87,47,40
False,8315028,Ebringen,3 -  6 Jahre,94,41,53
False,8315028,Ebringen,6 - 10 Jahre,134,58,76
False,8315028,Ebringen,10 - 15 Jahre,166,92,74
False,8315028,Ebringen,15 - 18 Jahre,94,46,48
False,8315028,Ebringen,18 - 20 Jahre,59,25,34
False,8315028,Ebringen,20 - 25 Jahre,117,55,62
False,8315028,Ebringen,25 - 30 Jahre,135,67,68
False,8315028,Ebringen,30 - 35 Jahre,239,108,131
False,8315028,Ebringen,35 - 40 Jahre,278,141,137
False,8315028,Ebringen,40 - 45 Jahre,219,124,95
False,8315028,Ebringen,45 - 50 Jahre,185,97,88
False,8315028,Ebringen,50 - 55 Jahre,165,82,83
False,8315028,Ebringen,55 - 60 Jahre,131,63,68
False,8315028,Ebringen,60 - 65 Jahre,145,70,75
False,8315028,Ebringen,65 - 75 Jahre,203,87,116
False,8315028,Ebringen,75 und mehr Jahre,142,53,89
False,8315028,Ebringen,Insgesamt,2593,1256,1337
False,8315030,Eichstetten am Kaiserstuhl,unter 3 Jahre,134,72,62
False,8315030,Eichstetten am Kaiserstuhl,3 -  6 Jahre,135,63,72
False,8315030,Eichstetten am Kaiserstuhl,6 - 10 Jahre,178,100,78
False,8315030,Eichstetten am Kaiserstuhl,10 - 15 Jahre,252,123,129
False,8315030,Eichstetten am Kaiserstuhl,15 - 18 Jahre,121,63,58
False,8315030,Eichstetten am Kaiserstuhl,18 - 20 Jahre,82,37,45
False,8315030,Eichstetten am Kaiserstuhl,20 - 25 Jahre,165,80,85
False,8315030,Eichstetten am Kaiserstuhl,25 - 30 Jahre,166,83,83
False,8315030,Eichstetten am Kaiserstuhl,30 - 35 Jahre,275,140,135
False,8315030,Eichstetten am Kaiserstuhl,35 - 40 Jahre,306,152,154
False,8315030,Eichstetten am Kaiserstuhl,40 - 45 Jahre,259,136,123
False,8315030,Eichstetten am Kaiserstuhl,45 - 50 Jahre,224,111,113
False,8315030,Eichstetten am Kaiserstuhl,50 - 55 Jahre,176,96,80
False,8315030,Eichstetten am Kaiserstuhl,55 - 60 Jahre,123,62,61
False,8315030,Eichstetten am Kaiserstuhl,60 - 65 Jahre,141,71,70
False,8315030,Eichstetten am Kaiserstuhl,65 - 75 Jahre,223,99,124
False,8315030,Eichstetten am Kaiserstuhl,75 und mehr Jahre,176,62,114
False,8315030,Eichstetten am Kaiserstuhl,Insgesamt,3136,1550,1586
False,8315031,Eisenbach (Hochschwarzwald),unter 3 Jahre,103,53,50
False,8315031,Eisenbach (Hochschwarzwald),3 -  6 Jahre,108,47,61
False,8315031,Eisenbach (Hochschwarzwald),6 - 10 Jahre,132,76,56
False,8315031,Eisenbach (Hochschwarzwald),10 - 15 Jahre,143,73,70
False,8315031,Eisenbach (Hochschwarzwald),15 - 18 Jahre,77,50,27
False,8315031,Eisenbach (Hochschwarzwald),18 - 20 Jahre,50,32,18
False,8315031,Eisenbach (Hochschwarzwald),20 - 25 Jahre,136,73,63
False,8315031,Eisenbach (Hochschwarzwald),25 - 30 Jahre,126,66,60
False,8315031,Eisenbach (Hochschwarzwald),30 - 35 Jahre,168,78,90
False,8315031,Eisenbach (Hochschwarzwald),35 - 40 Jahre,218,118,100
False,8315031,Eisenbach (Hochschwarzwald),40 - 45 Jahre,167,94,73
False,8315031,Eisenbach (Hochschwarzwald),45 - 50 Jahre,135,66,69
False,8315031,Eisenbach (Hochschwarzwald),50 - 55 Jahre,131,66,65
False,8315031,Eisenbach (Hochschwarzwald),55 - 60 Jahre,135,75,60
False,8315031,Eisenbach (Hochschwarzwald),60 - 65 Jahre,173,85,88
False,8315031,Eisenbach (Hochschwarzwald),65 - 75 Jahre,214,95,119
False,8315031,Eisenbach (Hochschwarzwald),75 und mehr Jahre,160,62,98
False,8315031,Eisenbach (Hochschwarzwald),Insgesamt,2376,1209,1167
False,8315033,Eschbach,unter 3 Jahre,87,40,47
False,8315033,Eschbach,3 -  6 Jahre,91,45,46
False,8315033,Eschbach,6 - 10 Jahre,135,76,59
False,8315033,Eschbach,10 - 15 Jahre,139,70,69
False,8315033,Eschbach,15 - 18 Jahre,58,35,23
False,8315033,Eschbach,18 - 20 Jahre,50,32,18
False,8315033,Eschbach,20 - 25 Jahre,139,71,68
False,8315033,Eschbach,25 - 30 Jahre,144,66,78
False,8315033,Eschbach,30 - 35 Jahre,228,145,83
False,8315033,Eschbach,35 - 40 Jahre,213,113,100
False,8315033,Eschbach,40 - 45 Jahre,177,85,92
False,8315033,Eschbach,45 - 50 Jahre,145,84,61
False,8315033,Eschbach,50 - 55 Jahre,113,55,58
False,8315033,Eschbach,55 - 60 Jahre,95,46,49
False,8315033,Eschbach,60 - 65 Jahre,86,52,34
False,8315033,Eschbach,65 - 75 Jahre,109,47,62
False,8315033,Eschbach,75 und mehr Jahre,55,23,32
False,8315033,Eschbach,Insgesamt,2064,1085,979
False,8315037,Feldberg (Schwarzwald),unter 3 Jahre,39,21,18
False,8315037,Feldberg (Schwarzwald),3 -  6 Jahre,60,33,27
False,8315037,Feldberg (Schwarzwald),6 - 10 Jahre,69,34,35
False,8315037,Feldberg (Schwarzwald),10 - 15 Jahre,91,47,44
False,8315037,Feldberg (Schwarzwald),15 - 18 Jahre,39,24,15
False,8315037,Feldberg (Schwarzwald),18 - 20 Jahre,47,20,27
False,8315037,Feldberg (Schwarzwald),20 - 25 Jahre,97,35,62
False,8315037,Feldberg (Schwarzwald),25 - 30 Jahre,117,52,65
False,8315037,Feldberg (Schwarzwald),30 - 35 Jahre,167,90,77
False,8315037,Feldberg (Schwarzwald),35 - 40 Jahre,162,94,68
False,8315037,Feldberg (Schwarzwald),40 - 45 Jahre,140,67,73
False,8315037,Feldberg (Schwarzwald),45 - 50 Jahre,112,58,54
False,8315037,Feldberg (Schwarzwald),50 - 55 Jahre,96,47,49
False,8315037,Feldberg (Schwarzwald),55 - 60 Jahre,96,53,43
False,8315037,Feldberg (Schwarzwald),60 - 65 Jahre,136,68,68
False,8315037,Feldberg (Schwarzwald),65 - 75 Jahre,178,83,95
False,8315037,Feldberg (Schwarzwald),75 und mehr Jahre,123,48,75
False,8315037,Feldberg (Schwarzwald),Insgesamt,1769,874,895
False,8315039,Friedenweiler,unter 3 Jahre,66,34,32
False,8315039,Friedenweiler,3 -  6 Jahre,65,31,34
False,8315039,Friedenweiler,6 - 10 Jahre,98,52,46
False,8315039,Friedenweiler,10 - 15 Jahre,140,74,66
False,8315039,Friedenweiler,15 - 18 Jahre,82,41,41
False,8315039,Friedenweiler,18 - 20 Jahre,51,26,25
False,8315039,Friedenweiler,20 - 25 Jahre,89,50,39
False,8315039,Friedenweiler,25 - 30 Jahre,114,63,51
False,8315039,Friedenweiler,30 - 35 Jahre,127,57,70
False,8315039,Friedenweiler,35 - 40 Jahre,177,89,88
False,8315039,Friedenweiler,40 - 45 Jahre,149,68,81
False,8315039,Friedenweiler,45 - 50 Jahre,143,67,76
False,8315039,Friedenweiler,50 - 55 Jahre,113,60,53
False,8315039,Friedenweiler,55 - 60 Jahre,89,38,51
False,8315039,Friedenweiler,60 - 65 Jahre,110,55,55
False,8315039,Friedenweiler,65 - 75 Jahre,179,91,88
False,8315039,Friedenweiler,75 und mehr Jahre,229,59,170
False,8315039,Friedenweiler,Insgesamt,2021,955,1066
False,8315041,Glottertal,unter 3 Jahre,113,53,60
False,8315041,Glottertal,3 -  6 Jahre,116,56,60
False,8315041,Glottertal,6 - 10 Jahre,152,84,68
False,8315041,Glottertal,10 - 15 Jahre,184,73,111
False,8315041,Glottertal,15 - 18 Jahre,98,55,43
False,8315041,Glottertal,18 - 20 Jahre,80,32,48
False,8315041,Glottertal,20 - 25 Jahre,162,70,92
False,8315041,Glottertal,25 - 30 Jahre,180,82,98
False,8315041,Glottertal,30 - 35 Jahre,263,125,138
False,8315041,Glottertal,35 - 40 Jahre,307,163,144
False,8315041,Glottertal,40 - 45 Jahre,226,121,105
False,8315041,Glottertal,45 - 50 Jahre,189,99,90
False,8315041,Glottertal,50 - 55 Jahre,178,89,89
False,8315041,Glottertal,55 - 60 Jahre,136,79,57
False,8315041,Glottertal,60 - 65 Jahre,162,83,79
False,8315041,Glottertal,65 - 75 Jahre,291,132,159
False,8315041,Glottertal,75 und mehr Jahre,205,65,140
False,8315041,Glottertal,Insgesamt,3042,1461,1581
False,8315043,Gottenheim,unter 3 Jahre,70,37,33
False,8315043,Gottenheim,3 -  6 Jahre,77,40,37
False,8315043,Gottenheim,6 - 10 Jahre,115,60,55
False,8315043,Gottenheim,10 - 15 Jahre,178,84,94
False,8315043,Gottenheim,15 - 18 Jahre,88,45,43
False,8315043,Gottenheim,18 - 20 Jahre,60,31,29
False,8315043,Gottenheim,20 - 25 Jahre,129,71,58
False,8315043,Gottenheim,25 - 30 Jahre,151,82,69
False,8315043,Gottenheim,30 - 35 Jahre,211,109,102
False,8315043,Gottenheim,35 - 40 Jahre,221,102,119
False,8315043,Gottenheim,40 - 45 Jahre,209,102,107
False,8315043,Gottenheim,45 - 50 Jahre,191,89,102
False,8315043,Gottenheim,50 - 55 Jahre,138,74,64
False,8315043,Gottenheim,55 - 60 Jahre,114,60,54
False,8315043,Gottenheim,60 - 65 Jahre,125,65,60
False,8315043,Gottenheim,65 - 75 Jahre,230,102,128
False,8315043,Gottenheim,75 und mehr Jahre,150,45,105
False,8315043,Gottenheim,Insgesamt,2457,1198,1259
False,8315047,Gundelfingen,unter 3 Jahre,297,156,141
False,8315047,Gundelfingen,3 -  6 Jahre,311,147,164
False,8315047,Gundelfingen,6 - 10 Jahre,393,226,167
False,8315047,Gundelfingen,10 - 15 Jahre,511,240,271
False,8315047,Gundelfingen,15 - 18 Jahre,290,133,157
False,8315047,Gundelfingen,18 - 20 Jahre,218,115,103
False,8315047,Gundelfingen,20 - 25 Jahre,596,290,306
False,8315047,Gundelfingen,25 - 30 Jahre,641,319,322
False,8315047,Gundelfingen,30 - 35 Jahre,951,483,468
False,8315047,Gundelfingen,35 - 40 Jahre,1055,524,531
False,8315047,Gundelfingen,40 - 45 Jahre,913,464,449
False,8315047,Gundelfingen,45 - 50 Jahre,848,390,458
False,8315047,Gundelfingen,50 - 55 Jahre,770,351,419
False,8315047,Gundelfingen,55 - 60 Jahre,779,380,399
False,8315047,Gundelfingen,60 - 65 Jahre,773,376,397
False,8315047,Gundelfingen,65 - 75 Jahre,1015,462,553
False,8315047,Gundelfingen,75 und mehr Jahre,796,273,523
False,8315047,Gundelfingen,Insgesamt,11157,5329,5828
False,8315048,Hartheim,unter 3 Jahre,206,100,106
False,8315048,Hartheim,3 -  6 Jahre,185,106,79
False,8315048,Hartheim,6 - 10 Jahre,238,128,110
False,8315048,Hartheim,10 - 15 Jahre,285,160,125
False,8315048,Hartheim,15 - 18 Jahre,165,83,82
False,8315048,Hartheim,18 - 20 Jahre,109,48,61
False,8315048,Hartheim,20 - 25 Jahre,283,136,147
False,8315048,Hartheim,25 - 30 Jahre,329,153,176
False,8315048,Hartheim,30 - 35 Jahre,395,212,183
False,8315048,Hartheim,35 - 40 Jahre,422,211,211
False,8315048,Hartheim,40 - 45 Jahre,377,200,177
False,8315048,Hartheim,45 - 50 Jahre,370,191,179
False,8315048,Hartheim,50 - 55 Jahre,257,139,118
False,8315048,Hartheim,55 - 60 Jahre,191,98,93
False,8315048,Hartheim,60 - 65 Jahre,200,112,88
False,8315048,Hartheim,65 - 75 Jahre,263,120,143
False,8315048,Hartheim,75 und mehr Jahre,156,57,99
False,8315048,Hartheim,Insgesamt,4431,2254,2177
False,8315050,"Heitersheim, Stadt",unter 3 Jahre,183,94,89
False,8315050,"Heitersheim, Stadt",3 -  6 Jahre,222,118,104
False,8315050,"Heitersheim, Stadt",6 - 10 Jahre,288,149,139
False,8315050,"Heitersheim, Stadt",10 - 15 Jahre,336,185,151
False,8315050,"Heitersheim, Stadt",15 - 18 Jahre,210,98,112
False,8315050,"Heitersheim, Stadt",18 - 20 Jahre,154,76,78
False,8315050,"Heitersheim, Stadt",20 - 25 Jahre,270,146,124
False,8315050,"Heitersheim, Stadt",25 - 30 Jahre,288,134,154
False,8315050,"Heitersheim, Stadt",30 - 35 Jahre,471,239,232
False,8315050,"Heitersheim, Stadt",35 - 40 Jahre,478,225,253
False,8315050,"Heitersheim, Stadt",40 - 45 Jahre,509,261,248
False,8315050,"Heitersheim, Stadt",45 - 50 Jahre,375,196,179
False,8315050,"Heitersheim, Stadt",50 - 55 Jahre,322,152,170
False,8315050,"Heitersheim, Stadt",55 - 60 Jahre,292,145,147
False,8315050,"Heitersheim, Stadt",60 - 65 Jahre,332,178,154
False,8315050,"Heitersheim, Stadt",65 - 75 Jahre,452,200,252
False,8315050,"Heitersheim, Stadt",75 und mehr Jahre,365,107,258
False,8315050,"Heitersheim, Stadt",Insgesamt,5547,2703,2844
False,8315051,Heuweiler,unter 3 Jahre,27,11,16
False,8315051,Heuweiler,3 -  6 Jahre,25,13,12
False,8315051,Heuweiler,6 - 10 Jahre,50,25,25
False,8315051,Heuweiler,10 - 15 Jahre,74,31,43
False,8315051,Heuweiler,15 - 18 Jahre,42,22,20
False,8315051,Heuweiler,18 - 20 Jahre,16,12,4
False,8315051,Heuweiler,20 - 25 Jahre,53,28,25
False,8315051,Heuweiler,25 - 30 Jahre,37,16,21
False,8315051,Heuweiler,30 - 35 Jahre,108,52,56
False,8315051,Heuweiler,35 - 40 Jahre,96,48,48
False,8315051,Heuweiler,40 - 45 Jahre,95,39,56
False,8315051,Heuweiler,45 - 50 Jahre,81,42,39
False,8315051,Heuweiler,50 - 55 Jahre,62,37,25
False,8315051,Heuweiler,55 - 60 Jahre,48,22,26
False,8315051,Heuweiler,60 - 65 Jahre,51,24,27
False,8315051,Heuweiler,65 - 75 Jahre,91,47,44
False,8315051,Heuweiler,75 und mehr Jahre,54,15,39
False,8315051,Heuweiler,Insgesamt,1010,484,526
False,8315052,Hinterzarten,unter 3 Jahre,64,34,30
False,8315052,Hinterzarten,3 -  6 Jahre,66,30,36
False,8315052,Hinterzarten,6 - 10 Jahre,103,51,52
False,8315052,Hinterzarten,10 - 15 Jahre,131,69,62
False,8315052,Hinterzarten,15 - 18 Jahre,83,41,42
False,8315052,Hinterzarten,18 - 20 Jahre,94,35,59
False,8315052,Hinterzarten,20 - 25 Jahre,184,88,96
False,8315052,Hinterzarten,25 - 30 Jahre,222,100,122
False,8315052,Hinterzarten,30 - 35 Jahre,229,90,139
False,8315052,Hinterzarten,35 - 40 Jahre,210,98,112
False,8315052,Hinterzarten,40 - 45 Jahre,148,72,76
False,8315052,Hinterzarten,45 - 50 Jahre,118,41,77
False,8315052,Hinterzarten,50 - 55 Jahre,154,77,77
False,8315052,Hinterzarten,55 - 60 Jahre,154,67,87
False,8315052,Hinterzarten,60 - 65 Jahre,168,85,83
False,8315052,Hinterzarten,65 - 75 Jahre,239,107,132
False,8315052,Hinterzarten,75 und mehr Jahre,208,77,131
False,8315052,Hinterzarten,Insgesamt,2575,1162,1413
False,8315056,Horben,unter 3 Jahre,45,26,19
False,8315056,Horben,3 -  6 Jahre,42,18,24
False,8315056,Horben,6 - 10 Jahre,58,35,23
False,8315056,Horben,10 - 15 Jahre,64,27,37
False,8315056,Horben,15 - 18 Jahre,24,14,10
False,8315056,Horben,18 - 20 Jahre,15,6,9
False,8315056,Horben,20 - 25 Jahre,43,21,22
False,8315056,Horben,25 - 30 Jahre,67,31,36
False,8315056,Horben,30 - 35 Jahre,94,45,49
False,8315056,Horben,35 - 40 Jahre,115,52,63
False,8315056,Horben,40 - 45 Jahre,83,48,35
False,8315056,Horben,45 - 50 Jahre,57,31,26
False,8315056,Horben,50 - 55 Jahre,52,28,24
False,8315056,Horben,55 - 60 Jahre,65,27,38
False,8315056,Horben,60 - 65 Jahre,69,37,32
False,8315056,Horben,65 - 75 Jahre,92,42,50
False,8315056,Horben,75 und mehr Jahre,46,22,24
False,8315056,Horben,Insgesamt,1031,510,521
False,8315059,Ihringen,unter 3 Jahre,174,86,88
False,8315059,Ihringen,3 -  6 Jahre,196,95,101
False,8315059,Ihringen,6 - 10 Jahre,269,142,127
False,8315059,Ihringen,10 - 15 Jahre,357,170,187
False,8315059,Ihringen,15 - 18 Jahre,172,84,88
False,8315059,Ihringen,18 - 20 Jahre,151,74,77
False,8315059,Ihringen,20 - 25 Jahre,283,139,144
False,8315059,Ihringen,25 - 30 Jahre,356,189,167
False,8315059,Ihringen,30 - 35 Jahre,507,236,271
False,8315059,Ihringen,35 - 40 Jahre,508,262,246
False,8315059,Ihringen,40 - 45 Jahre,485,252,233
False,8315059,Ihringen,45 - 50 Jahre,414,213,201
False,8315059,Ihringen,50 - 55 Jahre,294,137,157
False,8315059,Ihringen,55 - 60 Jahre,289,137,152
False,8315059,Ihringen,60 - 65 Jahre,382,183,199
False,8315059,Ihringen,65 - 75 Jahre,527,246,281
False,8315059,Ihringen,75 und mehr Jahre,329,100,229
False,8315059,Ihringen,Insgesamt,5693,2745,2948
False,8315064,Kirchzarten,unter 3 Jahre,299,155,144
False,8315064,Kirchzarten,3 -  6 Jahre,303,142,161
False,8315064,Kirchzarten,6 - 10 Jahre,420,234,186
False,8315064,Kirchzarten,10 - 15 Jahre,563,278,285
False,8315064,Kirchzarten,15 - 18 Jahre,303,155,148
False,8315064,Kirchzarten,18 - 20 Jahre,219,109,110
False,8315064,Kirchzarten,20 - 25 Jahre,488,246,242
False,8315064,Kirchzarten,25 - 30 Jahre,460,224,236
False,8315064,Kirchzarten,30 - 35 Jahre,687,320,367
False,8315064,Kirchzarten,35 - 40 Jahre,775,369,406
False,8315064,Kirchzarten,40 - 45 Jahre,792,398,394
False,8315064,Kirchzarten,45 - 50 Jahre,672,312,360
False,8315064,Kirchzarten,50 - 55 Jahre,577,262,315
False,8315064,Kirchzarten,55 - 60 Jahre,624,277,347
False,8315064,Kirchzarten,60 - 65 Jahre,716,338,378
False,8315064,Kirchzarten,65 - 75 Jahre,866,405,461
False,8315064,Kirchzarten,75 und mehr Jahre,730,219,511
False,8315064,Kirchzarten,Insgesamt,9494,4443,5051
False,8315068,Lenzkirch,unter 3 Jahre,158,79,79
False,8315068,Lenzkirch,3 -  6 Jahre,134,57,77
False,8315068,Lenzkirch,6 - 10 Jahre,198,112,86
False,8315068,Lenzkirch,10 - 15 Jahre,294,152,142
False,8315068,Lenzkirch,15 - 18 Jahre,167,92,75
False,8315068,Lenzkirch,18 - 20 Jahre,150,71,79
False,8315068,Lenzkirch,20 - 25 Jahre,314,173,141
False,8315068,Lenzkirch,25 - 30 Jahre,309,138,171
False,8315068,Lenzkirch,30 - 35 Jahre,447,197,250
False,8315068,Lenzkirch,35 - 40 Jahre,410,230,180
False,8315068,Lenzkirch,40 - 45 Jahre,369,192,177
False,8315068,Lenzkirch,45 - 50 Jahre,321,159,162
False,8315068,Lenzkirch,50 - 55 Jahre,303,156,147
False,8315068,Lenzkirch,55 - 60 Jahre,257,122,135
False,8315068,Lenzkirch,60 - 65 Jahre,366,167,199
False,8315068,Lenzkirch,65 - 75 Jahre,535,237,298
False,8315068,Lenzkirch,75 und mehr Jahre,431,131,300
False,8315068,Lenzkirch,Insgesamt,5163,2465,2698
False,8315070,"Löffingen, Stadt",unter 3 Jahre,291,145,146
False,8315070,"Löffingen, Stadt",3 -  6 Jahre,274,142,132
False,8315070,"Löffingen, Stadt",6 - 10 Jahre,365,197,168
False,8315070,"Löffingen, Stadt",10 - 15 Jahre,503,245,258
False,8315070,"Löffingen, Stadt",15 - 18 Jahre,293,155,138
False,8315070,"Löffingen, Stadt",18 - 20 Jahre,168,103,65
False,8315070,"Löffingen, Stadt",20 - 25 Jahre,404,207,197
False,8315070,"Löffingen, Stadt",25 - 30 Jahre,453,221,232
False,8315070,"Löffingen, Stadt",30 - 35 Jahre,652,331,321
False,8315070,"Löffingen, Stadt",35 - 40 Jahre,640,338,302
False,8315070,"Löffingen, Stadt",40 - 45 Jahre,587,295,292
False,8315070,"Löffingen, Stadt",45 - 50 Jahre,531,269,262
False,8315070,"Löffingen, Stadt",50 - 55 Jahre,405,216,189
False,8315070,"Löffingen, Stadt",55 - 60 Jahre,386,196,190
False,8315070,"Löffingen, Stadt",60 - 65 Jahre,455,225,230
False,8315070,"Löffingen, Stadt",65 - 75 Jahre,707,343,364
False,8315070,"Löffingen, Stadt",75 und mehr Jahre,479,147,332
False,8315070,"Löffingen, Stadt",Insgesamt,7593,3775,3818
False,8315072,Merdingen,unter 3 Jahre,88,48,40
False,8315072,Merdingen,3 -  6 Jahre,104,49,55
False,8315072,Merdingen,6 - 10 Jahre,113,55,58
False,8315072,Merdingen,10 - 15 Jahre,165,64,101
False,8315072,Merdingen,15 - 18 Jahre,83,45,38
False,8315072,Merdingen,18 - 20 Jahre,55,32,23
False,8315072,Merdingen,20 - 25 Jahre,130,75,55
False,8315072,Merdingen,25 - 30 Jahre,157,78,79
False,8315072,Merdingen,30 - 35 Jahre,218,107,111
False,8315072,Merdingen,35 - 40 Jahre,278,143,135
False,8315072,Merdingen,40 - 45 Jahre,210,106,104
False,8315072,Merdingen,45 - 50 Jahre,199,98,101
False,8315072,Merdingen,50 - 55 Jahre,146,74,72
False,8315072,Merdingen,55 - 60 Jahre,108,57,51
False,8315072,Merdingen,60 - 65 Jahre,149,77,72
False,8315072,Merdingen,65 - 75 Jahre,199,93,106
False,8315072,Merdingen,75 und mehr Jahre,109,34,75
False,8315072,Merdingen,Insgesamt,2511,1235,1276
False,8315073,Merzhausen,unter 3 Jahre,107,53,54
False,8315073,Merzhausen,3 -  6 Jahre,132,62,70
False,8315073,Merzhausen,6 - 10 Jahre,146,77,69
False,8315073,Merzhausen,10 - 15 Jahre,175,85,90
False,8315073,Merzhausen,15 - 18 Jahre,141,64,77
False,8315073,Merzhausen,18 - 20 Jahre,95,42,53
False,8315073,Merzhausen,20 - 25 Jahre,274,124,150
False,8315073,Merzhausen,25 - 30 Jahre,319,162,157
False,8315073,Merzhausen,30 - 35 Jahre,348,187,161
False,8315073,Merzhausen,35 - 40 Jahre,399,186,213
False,8315073,Merzhausen,40 - 45 Jahre,299,148,151
False,8315073,Merzhausen,45 - 50 Jahre,266,108,158
False,8315073,Merzhausen,50 - 55 Jahre,326,148,178
False,8315073,Merzhausen,55 - 60 Jahre,389,177,212
False,8315073,Merzhausen,60 - 65 Jahre,364,152,212
False,8315073,Merzhausen,65 - 75 Jahre,433,212,221
False,8315073,Merzhausen,75 und mehr Jahre,337,114,223
False,8315073,Merzhausen,Insgesamt,4550,2101,2449
False,8315074,"Müllheim, Stadt",unter 3 Jahre,523,271,252
False,8315074,"Müllheim, Stadt",3 -  6 Jahre,619,331,288
False,8315074,"Müllheim, Stadt",6 - 10 Jahre,848,433,415
False,8315074,"Müllheim, Stadt",10 - 15 Jahre,1105,559,546
False,8315074,"Müllheim, Stadt",15 - 18 Jahre,634,316,318
False,8315074,"Müllheim, Stadt",18 - 20 Jahre,402,186,216
False,8315074,"Müllheim, Stadt",20 - 25 Jahre,936,452,484
False,8315074,"Müllheim, Stadt",25 - 30 Jahre,1017,513,504
False,8315074,"Müllheim, Stadt",30 - 35 Jahre,1311,636,675
False,8315074,"Müllheim, Stadt",35 - 40 Jahre,1455,709,746
False,8315074,"Müllheim, Stadt",40 - 45 Jahre,1299,634,665
False,8315074,"Müllheim, Stadt",45 - 50 Jahre,1212,584,628
False,8315074,"Müllheim, Stadt",50 - 55 Jahre,975,485,490
False,8315074,"Müllheim, Stadt",55 - 60 Jahre,966,489,477
False,8315074,"Müllheim, Stadt",60 - 65 Jahre,1125,510,615
False,8315074,"Müllheim, Stadt",65 - 75 Jahre,1523,674,849
False,8315074,"Müllheim, Stadt",75 und mehr Jahre,1561,488,1073
False,8315074,"Müllheim, Stadt",Insgesamt,17511,8270,9241
False,8315076,"Neuenburg am Rhein, Stadt",unter 3 Jahre,389,208,181
False,8315076,"Neuenburg am Rhein, Stadt",3 -  6 Jahre,436,240,196
False,8315076,"Neuenburg am Rhein, Stadt",6 - 10 Jahre,651,319,332
False,8315076,"Neuenburg am Rhein, Stadt",10 - 15 Jahre,720,353,367
False,8315076,"Neuenburg am Rhein, Stadt",15 - 18 Jahre,402,205,197
False,8315076,"Neuenburg am Rhein, Stadt",18 - 20 Jahre,249,130,119
False,8315076,"Neuenburg am Rhein, Stadt",20 - 25 Jahre,574,265,309
False,8315076,"Neuenburg am Rhein, Stadt",25 - 30 Jahre,665,322,343
False,8315076,"Neuenburg am Rhein, Stadt",30 - 35 Jahre,971,498,473
False,8315076,"Neuenburg am Rhein, Stadt",35 - 40 Jahre,1085,540,545
False,8315076,"Neuenburg am Rhein, Stadt",40 - 45 Jahre,927,478,449
False,8315076,"Neuenburg am Rhein, Stadt",45 - 50 Jahre,789,407,382
False,8315076,"Neuenburg am Rhein, Stadt",50 - 55 Jahre,663,344,319
False,8315076,"Neuenburg am Rhein, Stadt",55 - 60 Jahre,568,295,273
False,8315076,"Neuenburg am Rhein, Stadt",60 - 65 Jahre,621,302,319
False,8315076,"Neuenburg am Rhein, Stadt",65 - 75 Jahre,825,397,428
False,8315076,"Neuenburg am Rhein, Stadt",75 und mehr Jahre,523,172,351
False,8315076,"Neuenburg am Rhein, Stadt",Insgesamt,11058,5475,5583
False,8315084,Oberried,unter 3 Jahre,105,48,57
False,8315084,Oberried,3 -  6 Jahre,125,64,61
False,8315084,Oberried,6 - 10 Jahre,156,90,66
False,8315084,Oberried,10 - 15 Jahre,158,76,82
False,8315084,Oberried,15 - 18 Jahre,94,46,48
False,8315084,Oberried,18 - 20 Jahre,56,23,33
False,8315084,Oberried,20 - 25 Jahre,144,84,60
False,8315084,Oberried,25 - 30 Jahre,170,82,88
False,8315084,Oberried,30 - 35 Jahre,254,122,132
False,8315084,Oberried,35 - 40 Jahre,264,137,127
False,8315084,Oberried,40 - 45 Jahre,193,107,86
False,8315084,Oberried,45 - 50 Jahre,169,88,81
False,8315084,Oberried,50 - 55 Jahre,151,73,78
False,8315084,Oberried,55 - 60 Jahre,152,76,76
False,8315084,Oberried,60 - 65 Jahre,186,91,95
False,8315084,Oberried,65 - 75 Jahre,222,118,104
False,8315084,Oberried,75 und mehr Jahre,126,51,75
False,8315084,Oberried,Insgesamt,2725,1376,1349
False,8315089,Pfaffenweiler,unter 3 Jahre,87,45,42
False,8315089,Pfaffenweiler,3 -  6 Jahre,98,45,53
False,8315089,Pfaffenweiler,6 - 10 Jahre,94,54,40
False,8315089,Pfaffenweiler,10 - 15 Jahre,158,71,87
False,8315089,Pfaffenweiler,15 - 18 Jahre,81,38,43
False,8315089,Pfaffenweiler,18 - 20 Jahre,77,35,42
False,8315089,Pfaffenweiler,20 - 25 Jahre,134,74,60
False,8315089,Pfaffenweiler,25 - 30 Jahre,135,59,76
False,8315089,Pfaffenweiler,30 - 35 Jahre,248,122,126
False,8315089,Pfaffenweiler,35 - 40 Jahre,225,129,96
False,8315089,Pfaffenweiler,40 - 45 Jahre,199,90,109
False,8315089,Pfaffenweiler,45 - 50 Jahre,191,94,97
False,8315089,Pfaffenweiler,50 - 55 Jahre,174,92,82
False,8315089,Pfaffenweiler,55 - 60 Jahre,177,90,87
False,8315089,Pfaffenweiler,60 - 65 Jahre,184,86,98
False,8315089,Pfaffenweiler,65 - 75 Jahre,205,114,91
False,8315089,Pfaffenweiler,75 und mehr Jahre,112,30,82
False,8315089,Pfaffenweiler,Insgesamt,2579,1268,1311
False,8315094,St. Märgen,unter 3 Jahre,63,34,29
False,8315094,St. Märgen,3 -  6 Jahre,64,34,30
False,8315094,St. Märgen,6 - 10 Jahre,117,59,58
False,8315094,St. Märgen,10 - 15 Jahre,123,68,55
False,8315094,St. Märgen,15 - 18 Jahre,69,37,32
False,8315094,St. Märgen,18 - 20 Jahre,39,22,17
False,8315094,St. Märgen,20 - 25 Jahre,97,49,48
False,8315094,St. Märgen,25 - 30 Jahre,118,65,53
False,8315094,St. Märgen,30 - 35 Jahre,150,81,69
False,8315094,St. Märgen,35 - 40 Jahre,154,77,77
False,8315094,St. Märgen,40 - 45 Jahre,125,66,59
False,8315094,St. Märgen,45 - 50 Jahre,111,65,46
False,8315094,St. Märgen,50 - 55 Jahre,97,47,50
False,8315094,St. Märgen,55 - 60 Jahre,89,47,42
False,8315094,St. Märgen,60 - 65 Jahre,116,54,62
False,8315094,St. Märgen,65 - 75 Jahre,168,79,89
False,8315094,St. Märgen,75 und mehr Jahre,145,51,94
False,8315094,St. Märgen,Insgesamt,1845,935,910
False,8315095,St. Peter,unter 3 Jahre,100,43,57
False,8315095,St. Peter,3 -  6 Jahre,92,38,54
False,8315095,St. Peter,6 - 10 Jahre,133,86,47
False,8315095,St. Peter,10 - 15 Jahre,162,83,79
False,8315095,St. Peter,15 - 18 Jahre,79,40,39
False,8315095,St. Peter,18 - 20 Jahre,64,34,30
False,8315095,St. Peter,20 - 25 Jahre,124,58,66
False,8315095,St. Peter,25 - 30 Jahre,124,67,57
False,8315095,St. Peter,30 - 35 Jahre,171,90,81
False,8315095,St. Peter,35 - 40 Jahre,243,133,110
False,8315095,St. Peter,40 - 45 Jahre,183,98,85
False,8315095,St. Peter,45 - 50 Jahre,132,74,58
False,8315095,St. Peter,50 - 55 Jahre,117,53,64
False,8315095,St. Peter,55 - 60 Jahre,129,62,67
False,8315095,St. Peter,60 - 65 Jahre,153,67,86
False,8315095,St. Peter,65 - 75 Jahre,240,126,114
False,8315095,St. Peter,75 und mehr Jahre,130,41,89
False,8315095,St. Peter,Insgesamt,2376,1193,1183
False,8315098,Schallstadt,unter 3 Jahre,176,102,74
False,8315098,Schallstadt,3 -  6 Jahre,230,116,114
False,8315098,Schallstadt,6 - 10 Jahre,279,149,130
False,8315098,Schallstadt,10 - 15 Jahre,358,161,197
False,8315098,Schallstadt,15 - 18 Jahre,180,94,86
False,8315098,Schallstadt,18 - 20 Jahre,128,63,65
False,8315098,Schallstadt,20 - 25 Jahre,284,132,152
False,8315098,Schallstadt,25 - 30 Jahre,335,145,190
False,8315098,Schallstadt,30 - 35 Jahre,496,241,255
False,8315098,Schallstadt,35 - 40 Jahre,535,270,265
False,8315098,Schallstadt,40 - 45 Jahre,495,237,258
False,8315098,Schallstadt,45 - 50 Jahre,431,211,220
False,8315098,Schallstadt,50 - 55 Jahre,394,183,211
False,8315098,Schallstadt,55 - 60 Jahre,330,182,148
False,8315098,Schallstadt,60 - 65 Jahre,389,196,193
False,8315098,Schallstadt,65 - 75 Jahre,439,217,222
False,8315098,Schallstadt,75 und mehr Jahre,261,95,166
False,8315098,Schallstadt,Insgesamt,5740,2794,2946
False,8315102,Schluchsee,unter 3 Jahre,41,21,20
False,8315102,Schluchsee,3 -  6 Jahre,58,29,29
False,8315102,Schluchsee,6 - 10 Jahre,86,43,43
False,8315102,Schluchsee,10 - 15 Jahre,106,50,56
False,8315102,Schluchsee,15 - 18 Jahre,101,47,54
False,8315102,Schluchsee,18 - 20 Jahre,66,29,37
False,8315102,Schluchsee,20 - 25 Jahre,197,84,113
False,8315102,Schluchsee,25 - 30 Jahre,163,89,74
False,8315102,Schluchsee,30 - 35 Jahre,253,112,141
False,8315102,Schluchsee,35 - 40 Jahre,185,92,93
False,8315102,Schluchsee,40 - 45 Jahre,178,103,75
False,8315102,Schluchsee,45 - 50 Jahre,157,64,93
False,8315102,Schluchsee,50 - 55 Jahre,162,82,80
False,8315102,Schluchsee,55 - 60 Jahre,156,77,79
False,8315102,Schluchsee,60 - 65 Jahre,196,96,100
False,8315102,Schluchsee,65 - 75 Jahre,259,113,146
False,8315102,Schluchsee,75 und mehr Jahre,202,81,121
False,8315102,Schluchsee,Insgesamt,2566,1212,1354
False,8315107,Sölden,unter 3 Jahre,36,20,16
False,8315107,Sölden,3 -  6 Jahre,29,10,19
False,8315107,Sölden,6 - 10 Jahre,54,33,21
False,8315107,Sölden,10 - 15 Jahre,88,43,45
False,8315107,Sölden,15 - 18 Jahre,46,26,20
False,8315107,Sölden,18 - 20 Jahre,31,15,16
False,8315107,Sölden,20 - 25 Jahre,75,36,39
False,8315107,Sölden,25 - 30 Jahre,62,33,29
False,8315107,Sölden,30 - 35 Jahre,59,36,23
False,8315107,Sölden,35 - 40 Jahre,82,40,42
False,8315107,Sölden,40 - 45 Jahre,132,62,70
False,8315107,Sölden,45 - 50 Jahre,113,56,57
False,8315107,Sölden,50 - 55 Jahre,86,49,37
False,8315107,Sölden,55 - 60 Jahre,82,36,46
False,8315107,Sölden,60 - 65 Jahre,58,27,31
False,8315107,Sölden,65 - 75 Jahre,81,41,40
False,8315107,Sölden,75 und mehr Jahre,56,22,34
False,8315107,Sölden,Insgesamt,1170,585,585
False,8315108,"Staufen im Breisgau, Stadt",unter 3 Jahre,190,91,99
False,8315108,"Staufen im Breisgau, Stadt",3 -  6 Jahre,205,113,92
False,8315108,"Staufen im Breisgau, Stadt",6 - 10 Jahre,305,153,152
False,8315108,"Staufen im Breisgau, Stadt",10 - 15 Jahre,434,217,217
False,8315108,"Staufen im Breisgau, Stadt",15 - 18 Jahre,212,102,110
False,8315108,"Staufen im Breisgau, Stadt",18 - 20 Jahre,139,67,72
False,8315108,"Staufen im Breisgau, Stadt",20 - 25 Jahre,334,185,149
False,8315108,"Staufen im Breisgau, Stadt",25 - 30 Jahre,318,165,153
False,8315108,"Staufen im Breisgau, Stadt",30 - 35 Jahre,559,272,287
False,8315108,"Staufen im Breisgau, Stadt",35 - 40 Jahre,622,280,342
False,8315108,"Staufen im Breisgau, Stadt",40 - 45 Jahre,585,274,311
False,8315108,"Staufen im Breisgau, Stadt",45 - 50 Jahre,517,263,254
False,8315108,"Staufen im Breisgau, Stadt",50 - 55 Jahre,532,263,269
False,8315108,"Staufen im Breisgau, Stadt",55 - 60 Jahre,480,247,233
False,8315108,"Staufen im Breisgau, Stadt",60 - 65 Jahre,524,238,286
False,8315108,"Staufen im Breisgau, Stadt",65 - 75 Jahre,682,328,354
False,8315108,"Staufen im Breisgau, Stadt",75 und mehr Jahre,766,224,542
False,8315108,"Staufen im Breisgau, Stadt",Insgesamt,7404,3482,3922
False,8315109,Stegen,unter 3 Jahre,145,74,71
False,8315109,Stegen,3 -  6 Jahre,169,84,85
False,8315109,Stegen,6 - 10 Jahre,232,128,104
False,8315109,Stegen,10 - 15 Jahre,334,177,157
False,8315109,Stegen,15 - 18 Jahre,168,89,79
False,8315109,Stegen,18 - 20 Jahre,125,65,60
False,8315109,Stegen,20 - 25 Jahre,218,107,111
False,8315109,Stegen,25 - 30 Jahre,208,100,108
False,8315109,Stegen,30 - 35 Jahre,315,153,162
False,8315109,Stegen,35 - 40 Jahre,394,174,220
False,8315109,Stegen,40 - 45 Jahre,327,159,168
False,8315109,Stegen,45 - 50 Jahre,307,143,164
False,8315109,Stegen,50 - 55 Jahre,244,119,125
False,8315109,Stegen,55 - 60 Jahre,217,107,110
False,8315109,Stegen,60 - 65 Jahre,340,156,184
False,8315109,Stegen,65 - 75 Jahre,373,193,180
False,8315109,Stegen,75 und mehr Jahre,243,88,155
False,8315109,Stegen,Insgesamt,4359,2116,2243
False,8315111,"Sulzburg, Stadt",unter 3 Jahre,81,42,39
False,8315111,"Sulzburg, Stadt",3 -  6 Jahre,89,44,45
False,8315111,"Sulzburg, Stadt",6 - 10 Jahre,152,87,65
False,8315111,"Sulzburg, Stadt",10 - 15 Jahre,156,65,91
False,8315111,"Sulzburg, Stadt",15 - 18 Jahre,102,46,56
False,8315111,"Sulzburg, Stadt",18 - 20 Jahre,63,35,28
False,8315111,"Sulzburg, Stadt",20 - 25 Jahre,127,63,64
False,8315111,"Sulzburg, Stadt",25 - 30 Jahre,129,66,63
False,8315111,"Sulzburg, Stadt",30 - 35 Jahre,231,97,134
False,8315111,"Sulzburg, Stadt",35 - 40 Jahre,218,118,100
False,8315111,"Sulzburg, Stadt",40 - 45 Jahre,207,101,106
False,8315111,"Sulzburg, Stadt",45 - 50 Jahre,196,100,96
False,8315111,"Sulzburg, Stadt",50 - 55 Jahre,152,69,83
False,8315111,"Sulzburg, Stadt",55 - 60 Jahre,142,60,82
False,8315111,"Sulzburg, Stadt",60 - 65 Jahre,183,94,89
False,8315111,"Sulzburg, Stadt",65 - 75 Jahre,232,112,120
False,8315111,"Sulzburg, Stadt",75 und mehr Jahre,178,63,115
False,8315111,"Sulzburg, Stadt",Insgesamt,2638,1262,1376
False,8315113,"Titisee-Neustadt, Stadt",unter 3 Jahre,323,173,150
False,8315113,"Titisee-Neustadt, Stadt",3 -  6 Jahre,359,196,163
False,8315113,"Titisee-Neustadt, Stadt",6 - 10 Jahre,525,256,269
False,8315113,"Titisee-Neustadt, Stadt",10 - 15 Jahre,653,329,324
False,8315113,"Titisee-Neustadt, Stadt",15 - 18 Jahre,416,213,203
False,8315113,"Titisee-Neustadt, Stadt",18 - 20 Jahre,283,144,139
False,8315113,"Titisee-Neustadt, Stadt",20 - 25 Jahre,768,374,394
False,8315113,"Titisee-Neustadt, Stadt",25 - 30 Jahre,777,403,374
False,8315113,"Titisee-Neustadt, Stadt",30 - 35 Jahre,959,507,452
False,8315113,"Titisee-Neustadt, Stadt",35 - 40 Jahre,893,435,458
False,8315113,"Titisee-Neustadt, Stadt",40 - 45 Jahre,874,446,428
False,8315113,"Titisee-Neustadt, Stadt",45 - 50 Jahre,843,438,405
False,8315113,"Titisee-Neustadt, Stadt",50 - 55 Jahre,685,355,330
False,8315113,"Titisee-Neustadt, Stadt",55 - 60 Jahre,593,288,305
False,8315113,"Titisee-Neustadt, Stadt",60 - 65 Jahre,768,351,417
False,8315113,"Titisee-Neustadt, Stadt",65 - 75 Jahre,1182,539,643
False,8315113,"Titisee-Neustadt, Stadt",75 und mehr Jahre,1091,360,731
False,8315113,"Titisee-Neustadt, Stadt",Insgesamt,11992,5807,6185
False,8315115,Umkirch,unter 3 Jahre,144,90,54
False,8315115,Umkirch,3 -  6 Jahre,147,84,63
False,8315115,Umkirch,6 - 10 Jahre,238,114,124
False,8315115,Umkirch,10 - 15 Jahre,353,189,164
False,8315115,Umkirch,15 - 18 Jahre,203,105,98
False,8315115,Umkirch,18 - 20 Jahre,120,69,51
False,8315115,Umkirch,20 - 25 Jahre,291,148,143
False,8315115,Umkirch,25 - 30 Jahre,235,111,124
False,8315115,Umkirch,30 - 35 Jahre,342,169,173
False,8315115,Umkirch,35 - 40 Jahre,461,225,236
False,8315115,Umkirch,40 - 45 Jahre,454,232,222
False,8315115,Umkirch,45 - 50 Jahre,410,201,209
False,8315115,Umkirch,50 - 55 Jahre,354,180,174
False,8315115,Umkirch,55 - 60 Jahre,352,161,191
False,8315115,Umkirch,60 - 65 Jahre,382,196,186
False,8315115,Umkirch,65 - 75 Jahre,379,180,199
False,8315115,Umkirch,75 und mehr Jahre,245,73,172
False,8315115,Umkirch,Insgesamt,5110,2527,2583
False,8315125,Wittnau,unter 3 Jahre,38,24,14
False,8315125,Wittnau,3 -  6 Jahre,51,27,24
False,8315125,Wittnau,6 - 10 Jahre,75,39,36
False,8315125,Wittnau,10 - 15 Jahre,92,49,43
False,8315125,Wittnau,15 - 18 Jahre,41,21,20
False,8315125,Wittnau,18 - 20 Jahre,34,16,18
False,8315125,Wittnau,20 - 25 Jahre,74,40,34
False,8315125,Wittnau,25 - 30 Jahre,68,35,33
False,8315125,Wittnau,30 - 35 Jahre,109,49,60
False,8315125,Wittnau,35 - 40 Jahre,112,49,63
False,8315125,Wittnau,40 - 45 Jahre,128,72,56
False,8315125,Wittnau,45 - 50 Jahre,116,52,64
False,8315125,Wittnau,50 - 55 Jahre,76,38,38
False,8315125,Wittnau,55 - 60 Jahre,105,50,55
False,8315125,Wittnau,60 - 65 Jahre,81,47,34
False,8315125,Wittnau,65 - 75 Jahre,115,57,58
False,8315125,Wittnau,75 und mehr Jahre,69,28,41
False,8315125,Wittnau,Insgesamt,1384,693,691
False,8315130,Münstertal/Schwarzwald,unter 3 Jahre,178,98,80
False,8315130,Münstertal/Schwarzwald,3 -  6 Jahre,204,104,100
False,8315130,Münstertal/Schwarzwald,6 - 10 Jahre,287,151,136
False,8315130,Münstertal/Schwarzwald,10 - 15 Jahre,305,161,144
False,8315130,Münstertal/Schwarzwald,15 - 18 Jahre,157,89,68
False,8315130,Münstertal/Schwarzwald,18 - 20 Jahre,123,72,51
False,8315130,Münstertal/Schwarzwald,20 - 25 Jahre,234,137,97
False,8315130,Münstertal/Schwarzwald,25 - 30 Jahre,263,128,135
False,8315130,Münstertal/Schwarzwald,30 - 35 Jahre,443,211,232
False,8315130,Münstertal/Schwarzwald,35 - 40 Jahre,485,251,234
False,8315130,Münstertal/Schwarzwald,40 - 45 Jahre,370,181,189
False,8315130,Münstertal/Schwarzwald,45 - 50 Jahre,335,168,167
False,8315130,Münstertal/Schwarzwald,50 - 55 Jahre,252,138,114
False,8315130,Münstertal/Schwarzwald,55 - 60 Jahre,249,107,142
False,8315130,Münstertal/Schwarzwald,60 - 65 Jahre,406,204,202
False,8315130,Münstertal/Schwarzwald,65 - 75 Jahre,486,218,268
False,8315130,Münstertal/Schwarzwald,75 und mehr Jahre,370,121,249
False,8315130,Münstertal/Schwarzwald,Insgesamt,5147,2539,2608
False,8315131,Ehrenkirchen,unter 3 Jahre,246,141,105
False,8315131,Ehrenkirchen,3 -  6 Jahre,244,123,121
False,8315131,Ehrenkirchen,6 - 10 Jahre,320,172,148
False,8315131,Ehrenkirchen,10 - 15 Jahre,407,218,189
False,8315131,Ehrenkirchen,15 - 18 Jahre,210,104,106
False,8315131,Ehrenkirchen,18 - 20 Jahre,121,58,63
False,8315131,Ehrenkirchen,20 - 25 Jahre,289,157,132
False,8315131,Ehrenkirchen,25 - 30 Jahre,338,157,181
False,8315131,Ehrenkirchen,30 - 35 Jahre,593,292,301
False,8315131,Ehrenkirchen,35 - 40 Jahre,688,353,335
False,8315131,Ehrenkirchen,40 - 45 Jahre,569,295,274
False,8315131,Ehrenkirchen,45 - 50 Jahre,418,202,216
False,8315131,Ehrenkirchen,50 - 55 Jahre,374,202,172
False,8315131,Ehrenkirchen,55 - 60 Jahre,378,175,203
False,8315131,Ehrenkirchen,60 - 65 Jahre,424,218,206
False,8315131,Ehrenkirchen,65 - 75 Jahre,540,273,267
False,8315131,Ehrenkirchen,75 und mehr Jahre,347,109,238
False,8315131,Ehrenkirchen,Insgesamt,6506,3249,3257
False,8315132,March,unter 3 Jahre,268,137,131
False,8315132,March,3 -  6 Jahre,337,182,155
False,8315132,March,6 - 10 Jahre,430,234,196
False,8315132,March,10 - 15 Jahre,551,283,268
False,8315132,March,15 - 18 Jahre,287,137,150
False,8315132,March,18 - 20 Jahre,207,97,110
False,8315132,March,20 - 25 Jahre,441,212,229
False,8315132,March,25 - 30 Jahre,512,245,267
False,8315132,March,30 - 35 Jahre,764,385,379
False,8315132,March,35 - 40 Jahre,891,450,441
False,8315132,March,40 - 45 Jahre,790,400,390
False,8315132,March,45 - 50 Jahre,712,351,361
False,8315132,March,50 - 55 Jahre,549,283,266
False,8315132,March,55 - 60 Jahre,532,253,279
False,8315132,March,60 - 65 Jahre,521,274,247
False,8315132,March,65 - 75 Jahre,627,306,321
False,8315132,March,75 und mehr Jahre,387,127,260
False,8315132,March,Insgesamt,8806,4356,4450
False,8315133,"Vogtsburg im Kaiserstuhl, Stadt",unter 3 Jahre,187,96,91
False,8315133,"Vogtsburg im Kaiserstuhl, Stadt",3 -  6 Jahre,200,113,87
False,8315133,"Vogtsburg im Kaiserstuhl, Stadt",6 - 10 Jahre,280,166,114
False,8315133,"Vogtsburg im Kaiserstuhl, Stadt",10 - 15 Jahre,375,180,195
False,8315133,"Vogtsburg im Kaiserstuhl, Stadt",15 - 18 Jahre,214,114,100
False,8315133,"Vogtsburg im Kaiserstuhl, Stadt",18 - 20 Jahre,142,67,75
False,8315133,"Vogtsburg im Kaiserstuhl, Stadt",20 - 25 Jahre,275,155,120
False,8315133,"Vogtsburg im Kaiserstuhl, Stadt",25 - 30 Jahre,292,153,139
False,8315133,"Vogtsburg im Kaiserstuhl, Stadt",30 - 35 Jahre,465,231,234
False,8315133,"Vogtsburg im Kaiserstuhl, Stadt",35 - 40 Jahre,509,263,246
False,8315133,"Vogtsburg im Kaiserstuhl, Stadt",40 - 45 Jahre,424,200,224
False,8315133,"Vogtsburg im Kaiserstuhl, Stadt",45 - 50 Jahre,402,213,189
False,8315133,"Vogtsburg im Kaiserstuhl, Stadt",50 - 55 Jahre,353,193,160
False,8315133,"Vogtsburg im Kaiserstuhl, Stadt",55 - 60 Jahre,293,149,144
False,8315133,"Vogtsburg im Kaiserstuhl, Stadt",60 - 65 Jahre,391,192,199
False,8315133,"Vogtsburg im Kaiserstuhl, Stadt",65 - 75 Jahre,539,256,283
False,8315133,"Vogtsburg im Kaiserstuhl, Stadt",75 und mehr Jahre,366,109,257
False,8315133,"Vogtsburg im Kaiserstuhl, Stadt",Insgesamt,5707,2850,2857
False,8316,Landkreis Emmendingen,unter 3 Jahre,4791,2451,2340
False,8316,Landkreis Emmendingen,3 -  6 Jahre,5222,2644,2578
False,8316,Landkreis Emmendingen,6 - 10 Jahre,7217,3719,3498
False,8316,Landkreis Emmendingen,10 - 15 Jahre,9425,4839,4586
False,8316,Landkreis Emmendingen,15 - 18 Jahre,5224,2709,2515
False,8316,Landkreis Emmendingen,18 - 20 Jahre,3583,1829,1754
False,8316,Landkreis Emmendingen,20 - 25 Jahre,7951,4036,3915
False,8316,Landkreis Emmendingen,25 - 30 Jahre,8594,4288,4306
False,8316,Landkreis Emmendingen,30 - 35 Jahre,12301,6300,6001
False,8316,Landkreis Emmendingen,35 - 40 Jahre,13501,6834,6667
False,8316,Landkreis Emmendingen,40 - 45 Jahre,12269,6132,6137
False,8316,Landkreis Emmendingen,45 - 50 Jahre,10813,5486,5327
False,8316,Landkreis Emmendingen,50 - 55 Jahre,9066,4603,4463
False,8316,Landkreis Emmendingen,55 - 60 Jahre,8293,4052,4241
False,8316,Landkreis Emmendingen,60 - 65 Jahre,9882,4899,4983
False,8316,Landkreis Emmendingen,65 - 75 Jahre,13327,6199,7128
False,8316,Landkreis Emmendingen,75 und mehr Jahre,9955,3016,6939
False,8316,Landkreis Emmendingen,Insgesamt,151414,74036,77378
False,8316002,Bahlingen am Kaiserstuhl,unter 3 Jahre,109,60,49
False,8316002,Bahlingen am Kaiserstuhl,3 -  6 Jahre,118,58,60
False,8316002,Bahlingen am Kaiserstuhl,6 - 10 Jahre,172,94,78
False,8316002,Bahlingen am Kaiserstuhl,10 - 15 Jahre,260,108,152
False,8316002,Bahlingen am Kaiserstuhl,15 - 18 Jahre,120,68,52
False,8316002,Bahlingen am Kaiserstuhl,18 - 20 Jahre,81,42,39
False,8316002,Bahlingen am Kaiserstuhl,20 - 25 Jahre,236,124,112
False,8316002,Bahlingen am Kaiserstuhl,25 - 30 Jahre,198,101,97
False,8316002,Bahlingen am Kaiserstuhl,30 - 35 Jahre,274,143,131
False,8316002,Bahlingen am Kaiserstuhl,35 - 40 Jahre,343,170,173
False,8316002,Bahlingen am Kaiserstuhl,40 - 45 Jahre,336,162,174
False,8316002,Bahlingen am Kaiserstuhl,45 - 50 Jahre,301,152,149
False,8316002,Bahlingen am Kaiserstuhl,50 - 55 Jahre,203,120,83
False,8316002,Bahlingen am Kaiserstuhl,55 - 60 Jahre,155,76,79
False,8316002,Bahlingen am Kaiserstuhl,60 - 65 Jahre,210,104,106
False,8316002,Bahlingen am Kaiserstuhl,65 - 75 Jahre,311,142,169
False,8316002,Bahlingen am Kaiserstuhl,75 und mehr Jahre,201,68,133
False,8316002,Bahlingen am Kaiserstuhl,Insgesamt,3628,1792,1836
False,8316003,Biederbach,unter 3 Jahre,65,39,26
False,8316003,Biederbach,3 -  6 Jahre,62,32,30
False,8316003,Biederbach,6 - 10 Jahre,84,39,45
False,8316003,Biederbach,10 - 15 Jahre,118,63,55
False,8316003,Biederbach,15 - 18 Jahre,58,28,30
False,8316003,Biederbach,18 - 20 Jahre,47,28,19
False,8316003,Biederbach,20 - 25 Jahre,99,50,49
False,8316003,Biederbach,25 - 30 Jahre,136,65,71
False,8316003,Biederbach,30 - 35 Jahre,159,77,82
False,8316003,Biederbach,35 - 40 Jahre,158,94,64
False,8316003,Biederbach,40 - 45 Jahre,123,64,59
False,8316003,Biederbach,45 - 50 Jahre,91,47,44
False,8316003,Biederbach,50 - 55 Jahre,87,44,43
False,8316003,Biederbach,55 - 60 Jahre,74,40,34
False,8316003,Biederbach,60 - 65 Jahre,106,57,49
False,8316003,Biederbach,65 - 75 Jahre,144,68,76
False,8316003,Biederbach,75 und mehr Jahre,103,42,61
False,8316003,Biederbach,Insgesamt,1714,877,837
False,8316009,Denzlingen,unter 3 Jahre,357,193,164
False,8316009,Denzlingen,3 -  6 Jahre,393,190,203
False,8316009,Denzlingen,6 - 10 Jahre,554,285,269
False,8316009,Denzlingen,10 - 15 Jahre,715,365,350
False,8316009,Denzlingen,15 - 18 Jahre,398,218,180
False,8316009,Denzlingen,18 - 20 Jahre,316,171,145
False,8316009,Denzlingen,20 - 25 Jahre,654,325,329
False,8316009,Denzlingen,25 - 30 Jahre,740,354,386
False,8316009,Denzlingen,30 - 35 Jahre,995,506,489
False,8316009,Denzlingen,35 - 40 Jahre,1120,560,560
False,8316009,Denzlingen,40 - 45 Jahre,993,473,520
False,8316009,Denzlingen,45 - 50 Jahre,923,448,475
False,8316009,Denzlingen,50 - 55 Jahre,893,415,478
False,8316009,Denzlingen,55 - 60 Jahre,883,428,455
False,8316009,Denzlingen,60 - 65 Jahre,892,422,470
False,8316009,Denzlingen,65 - 75 Jahre,1046,505,541
False,8316009,Denzlingen,75 und mehr Jahre,919,308,611
False,8316009,Denzlingen,Insgesamt,12791,6166,6625
False,8316010,"Elzach, Stadt",unter 3 Jahre,252,121,131
False,8316010,"Elzach, Stadt",3 -  6 Jahre,264,125,139
False,8316010,"Elzach, Stadt",6 - 10 Jahre,355,169,186
False,8316010,"Elzach, Stadt",10 - 15 Jahre,469,228,241
False,8316010,"Elzach, Stadt",15 - 18 Jahre,222,119,103
False,8316010,"Elzach, Stadt",18 - 20 Jahre,167,92,75
False,8316010,"Elzach, Stadt",20 - 25 Jahre,380,189,191
False,8316010,"Elzach, Stadt",25 - 30 Jahre,417,223,194
False,8316010,"Elzach, Stadt",30 - 35 Jahre,566,301,265
False,8316010,"Elzach, Stadt",35 - 40 Jahre,581,312,269
False,8316010,"Elzach, Stadt",40 - 45 Jahre,536,291,245
False,8316010,"Elzach, Stadt",45 - 50 Jahre,483,249,234
False,8316010,"Elzach, Stadt",50 - 55 Jahre,350,178,172
False,8316010,"Elzach, Stadt",55 - 60 Jahre,295,150,145
False,8316010,"Elzach, Stadt",60 - 65 Jahre,446,229,217
False,8316010,"Elzach, Stadt",65 - 75 Jahre,688,333,355
False,8316010,"Elzach, Stadt",75 und mehr Jahre,466,133,333
False,8316010,"Elzach, Stadt",Insgesamt,6937,3442,3495
False,8316011,"Emmendingen, Stadt",unter 3 Jahre,741,378,363
False,8316011,"Emmendingen, Stadt",3 -  6 Jahre,823,428,395
False,8316011,"Emmendingen, Stadt",6 - 10 Jahre,1151,600,551
False,8316011,"Emmendingen, Stadt",10 - 15 Jahre,1462,763,699
False,8316011,"Emmendingen, Stadt",15 - 18 Jahre,836,440,396
False,8316011,"Emmendingen, Stadt",18 - 20 Jahre,602,287,315
False,8316011,"Emmendingen, Stadt",20 - 25 Jahre,1297,654,643
False,8316011,"Emmendingen, Stadt",25 - 30 Jahre,1350,689,661
False,8316011,"Emmendingen, Stadt",30 - 35 Jahre,1997,1034,963
False,8316011,"Emmendingen, Stadt",35 - 40 Jahre,2200,1085,1115
False,8316011,"Emmendingen, Stadt",40 - 45 Jahre,2050,989,1061
False,8316011,"Emmendingen, Stadt",45 - 50 Jahre,1872,923,949
False,8316011,"Emmendingen, Stadt",50 - 55 Jahre,1591,781,810
False,8316011,"Emmendingen, Stadt",55 - 60 Jahre,1526,726,800
False,8316011,"Emmendingen, Stadt",60 - 65 Jahre,1744,874,870
False,8316011,"Emmendingen, Stadt",65 - 75 Jahre,2181,977,1204
False,8316011,"Emmendingen, Stadt",75 und mehr Jahre,1817,564,1253
False,8316011,"Emmendingen, Stadt",Insgesamt,25240,12192,13048
False,8316012,"Endingen am Kaiserstuhl, Stadt",unter 3 Jahre,283,137,146
False,8316012,"Endingen am Kaiserstuhl, Stadt",3 -  6 Jahre,270,122,148
False,8316012,"Endingen am Kaiserstuhl, Stadt",6 - 10 Jahre,407,197,210
False,8316012,"Endingen am Kaiserstuhl, Stadt",10 - 15 Jahre,576,304,272
False,8316012,"Endingen am Kaiserstuhl, Stadt",15 - 18 Jahre,292,156,136
False,8316012,"Endingen am Kaiserstuhl, Stadt",18 - 20 Jahre,220,105,115
False,8316012,"Endingen am Kaiserstuhl, Stadt",20 - 25 Jahre,516,273,243
False,8316012,"Endingen am Kaiserstuhl, Stadt",25 - 30 Jahre,495,257,238
False,8316012,"Endingen am Kaiserstuhl, Stadt",30 - 35 Jahre,674,334,340
False,8316012,"Endingen am Kaiserstuhl, Stadt",35 - 40 Jahre,768,397,371
False,8316012,"Endingen am Kaiserstuhl, Stadt",40 - 45 Jahre,680,333,347
False,8316012,"Endingen am Kaiserstuhl, Stadt",45 - 50 Jahre,657,340,317
False,8316012,"Endingen am Kaiserstuhl, Stadt",50 - 55 Jahre,490,244,246
False,8316012,"Endingen am Kaiserstuhl, Stadt",55 - 60 Jahre,433,221,212
False,8316012,"Endingen am Kaiserstuhl, Stadt",60 - 65 Jahre,529,263,266
False,8316012,"Endingen am Kaiserstuhl, Stadt",65 - 75 Jahre,771,345,426
False,8316012,"Endingen am Kaiserstuhl, Stadt",75 und mehr Jahre,586,169,417
False,8316012,"Endingen am Kaiserstuhl, Stadt",Insgesamt,8647,4197,4450
False,8316013,Forchheim,unter 3 Jahre,57,25,32
False,8316013,Forchheim,3 -  6 Jahre,51,29,22
False,8316013,Forchheim,6 - 10 Jahre,59,37,22
False,8316013,Forchheim,10 - 15 Jahre,88,45,43
False,8316013,Forchheim,15 - 18 Jahre,46,21,25
False,8316013,Forchheim,18 - 20 Jahre,34,17,17
False,8316013,Forchheim,20 - 25 Jahre,79,41,38
False,8316013,Forchheim,25 - 30 Jahre,78,41,37
False,8316013,Forchheim,30 - 35 Jahre,105,60,45
False,8316013,Forchheim,35 - 40 Jahre,120,68,52
False,8316013,Forchheim,40 - 45 Jahre,90,46,44
False,8316013,Forchheim,45 - 50 Jahre,79,39,40
False,8316013,Forchheim,50 - 55 Jahre,67,35,32
False,8316013,Forchheim,55 - 60 Jahre,48,20,28
False,8316013,Forchheim,60 - 65 Jahre,65,29,36
False,8316013,Forchheim,65 - 75 Jahre,116,53,63
False,8316013,Forchheim,75 und mehr Jahre,65,17,48
False,8316013,Forchheim,Insgesamt,1247,623,624
False,8316014,Gutach im Breisgau,unter 3 Jahre,144,78,66
False,8316014,Gutach im Breisgau,3 -  6 Jahre,168,81,87
False,8316014,Gutach im Breisgau,6 - 10 Jahre,223,124,99
False,8316014,Gutach im Breisgau,10 - 15 Jahre,257,144,113
False,8316014,Gutach im Breisgau,15 - 18 Jahre,152,68,84
False,8316014,Gutach im Breisgau,18 - 20 Jahre,110,54,56
False,8316014,Gutach im Breisgau,20 - 25 Jahre,230,109,121
False,8316014,Gutach im Breisgau,25 - 30 Jahre,255,123,132
False,8316014,Gutach im Breisgau,30 - 35 Jahre,380,193,187
False,8316014,Gutach im Breisgau,35 - 40 Jahre,437,211,226
False,8316014,Gutach im Breisgau,40 - 45 Jahre,353,165,188
False,8316014,Gutach im Breisgau,45 - 50 Jahre,328,170,158
False,8316014,Gutach im Breisgau,50 - 55 Jahre,234,141,93
False,8316014,Gutach im Breisgau,55 - 60 Jahre,180,81,99
False,8316014,Gutach im Breisgau,60 - 65 Jahre,256,128,128
False,8316014,Gutach im Breisgau,65 - 75 Jahre,336,155,181
False,8316014,Gutach im Breisgau,75 und mehr Jahre,260,92,168
False,8316014,Gutach im Breisgau,Insgesamt,4303,2117,2186
False,8316017,"Herbolzheim, Stadt",unter 3 Jahre,307,156,151
False,8316017,"Herbolzheim, Stadt",3 -  6 Jahre,286,160,126
False,8316017,"Herbolzheim, Stadt",6 - 10 Jahre,464,249,215
False,8316017,"Herbolzheim, Stadt",10 - 15 Jahre,665,346,319
False,8316017,"Herbolzheim, Stadt",15 - 18 Jahre,361,191,170
False,8316017,"Herbolzheim, Stadt",18 - 20 Jahre,225,116,109
False,8316017,"Herbolzheim, Stadt",20 - 25 Jahre,512,243,269
False,8316017,"Herbolzheim, Stadt",25 - 30 Jahre,571,297,274
False,8316017,"Herbolzheim, Stadt",30 - 35 Jahre,734,399,335
False,8316017,"Herbolzheim, Stadt",35 - 40 Jahre,831,437,394
False,8316017,"Herbolzheim, Stadt",40 - 45 Jahre,754,389,365
False,8316017,"Herbolzheim, Stadt",45 - 50 Jahre,623,331,292
False,8316017,"Herbolzheim, Stadt",50 - 55 Jahre,523,251,272
False,8316017,"Herbolzheim, Stadt",55 - 60 Jahre,466,242,224
False,8316017,"Herbolzheim, Stadt",60 - 65 Jahre,568,274,294
False,8316017,"Herbolzheim, Stadt",65 - 75 Jahre,848,389,459
False,8316017,"Herbolzheim, Stadt",75 und mehr Jahre,566,160,406
False,8316017,"Herbolzheim, Stadt",Insgesamt,9304,4630,4674
False,8316020,"Kenzingen, Stadt",unter 3 Jahre,302,149,153
False,8316020,"Kenzingen, Stadt",3 -  6 Jahre,339,173,166
False,8316020,"Kenzingen, Stadt",6 - 10 Jahre,436,218,218
False,8316020,"Kenzingen, Stadt",10 - 15 Jahre,586,288,298
False,8316020,"Kenzingen, Stadt",15 - 18 Jahre,362,189,173
False,8316020,"Kenzingen, Stadt",18 - 20 Jahre,214,114,100
False,8316020,"Kenzingen, Stadt",20 - 25 Jahre,454,248,206
False,8316020,"Kenzingen, Stadt",25 - 30 Jahre,505,244,261
False,8316020,"Kenzingen, Stadt",30 - 35 Jahre,616,311,305
False,8316020,"Kenzingen, Stadt",35 - 40 Jahre,724,351,373
False,8316020,"Kenzingen, Stadt",40 - 45 Jahre,781,401,380
False,8316020,"Kenzingen, Stadt",45 - 50 Jahre,621,310,311
False,8316020,"Kenzingen, Stadt",50 - 55 Jahre,532,273,259
False,8316020,"Kenzingen, Stadt",55 - 60 Jahre,476,253,223
False,8316020,"Kenzingen, Stadt",60 - 65 Jahre,513,254,259
False,8316020,"Kenzingen, Stadt",65 - 75 Jahre,736,339,397
False,8316020,"Kenzingen, Stadt",75 und mehr Jahre,687,175,512
False,8316020,"Kenzingen, Stadt",Insgesamt,8884,4290,4594
False,8316024,Malterdingen,unter 3 Jahre,104,53,51
False,8316024,Malterdingen,3 -  6 Jahre,99,56,43
False,8316024,Malterdingen,6 - 10 Jahre,147,76,71
False,8316024,Malterdingen,10 - 15 Jahre,196,109,87
False,8316024,Malterdingen,15 - 18 Jahre,82,37,45
False,8316024,Malterdingen,18 - 20 Jahre,55,29,26
False,8316024,Malterdingen,20 - 25 Jahre,147,79,68
False,8316024,Malterdingen,25 - 30 Jahre,162,86,76
False,8316024,Malterdingen,30 - 35 Jahre,248,131,117
False,8316024,Malterdingen,35 - 40 Jahre,253,132,121
False,8316024,Malterdingen,40 - 45 Jahre,238,126,112
False,8316024,Malterdingen,45 - 50 Jahre,201,109,92
False,8316024,Malterdingen,50 - 55 Jahre,152,76,76
False,8316024,Malterdingen,55 - 60 Jahre,114,53,61
False,8316024,Malterdingen,60 - 65 Jahre,154,83,71
False,8316024,Malterdingen,65 - 75 Jahre,230,101,129
False,8316024,Malterdingen,75 und mehr Jahre,156,49,107
False,8316024,Malterdingen,Insgesamt,2738,1385,1353
False,8316036,Reute,unter 3 Jahre,110,61,49
False,8316036,Reute,3 -  6 Jahre,141,74,67
False,8316036,Reute,6 - 10 Jahre,153,73,80
False,8316036,Reute,10 - 15 Jahre,223,114,109
False,8316036,Reute,15 - 18 Jahre,113,64,49
False,8316036,Reute,18 - 20 Jahre,81,31,50
False,8316036,Reute,20 - 25 Jahre,155,70,85
False,8316036,Reute,25 - 30 Jahre,192,82,110
False,8316036,Reute,30 - 35 Jahre,284,136,148
False,8316036,Reute,35 - 40 Jahre,354,176,178
False,8316036,Reute,40 - 45 Jahre,236,115,121
False,8316036,Reute,45 - 50 Jahre,219,106,113
False,8316036,Reute,50 - 55 Jahre,187,98,89
False,8316036,Reute,55 - 60 Jahre,149,80,69
False,8316036,Reute,60 - 65 Jahre,183,94,89
False,8316036,Reute,65 - 75 Jahre,179,87,92
False,8316036,Reute,75 und mehr Jahre,113,29,84
False,8316036,Reute,Insgesamt,3072,1490,1582
False,8316037,Riegel am Kaiserstuhl,unter 3 Jahre,123,56,67
False,8316037,Riegel am Kaiserstuhl,3 -  6 Jahre,106,56,50
False,8316037,Riegel am Kaiserstuhl,6 - 10 Jahre,173,94,79
False,8316037,Riegel am Kaiserstuhl,10 - 15 Jahre,224,110,114
False,8316037,Riegel am Kaiserstuhl,15 - 18 Jahre,122,66,56
False,8316037,Riegel am Kaiserstuhl,18 - 20 Jahre,91,50,41
False,8316037,Riegel am Kaiserstuhl,20 - 25 Jahre,193,90,103
False,8316037,Riegel am Kaiserstuhl,25 - 30 Jahre,163,62,101
False,8316037,Riegel am Kaiserstuhl,30 - 35 Jahre,352,183,169
False,8316037,Riegel am Kaiserstuhl,35 - 40 Jahre,340,164,176
False,8316037,Riegel am Kaiserstuhl,40 - 45 Jahre,295,154,141
False,8316037,Riegel am Kaiserstuhl,45 - 50 Jahre,252,139,113
False,8316037,Riegel am Kaiserstuhl,50 - 55 Jahre,196,88,108
False,8316037,Riegel am Kaiserstuhl,55 - 60 Jahre,200,97,103
False,8316037,Riegel am Kaiserstuhl,60 - 65 Jahre,182,93,89
False,8316037,Riegel am Kaiserstuhl,65 - 75 Jahre,245,120,125
False,8316037,Riegel am Kaiserstuhl,75 und mehr Jahre,154,59,95
False,8316037,Riegel am Kaiserstuhl,Insgesamt,3411,1681,1730
False,8316038,Sasbach am Kaiserstuhl,unter 3 Jahre,98,47,51
False,8316038,Sasbach am Kaiserstuhl,3 -  6 Jahre,112,53,59
False,8316038,Sasbach am Kaiserstuhl,6 - 10 Jahre,167,82,85
False,8316038,Sasbach am Kaiserstuhl,10 - 15 Jahre,201,98,103
False,8316038,Sasbach am Kaiserstuhl,15 - 18 Jahre,131,56,75
False,8316038,Sasbach am Kaiserstuhl,18 - 20 Jahre,89,42,47
False,8316038,Sasbach am Kaiserstuhl,20 - 25 Jahre,159,74,85
False,8316038,Sasbach am Kaiserstuhl,25 - 30 Jahre,193,98,95
False,8316038,Sasbach am Kaiserstuhl,30 - 35 Jahre,272,146,126
False,8316038,Sasbach am Kaiserstuhl,35 - 40 Jahre,296,160,136
False,8316038,Sasbach am Kaiserstuhl,40 - 45 Jahre,266,123,143
False,8316038,Sasbach am Kaiserstuhl,45 - 50 Jahre,224,117,107
False,8316038,Sasbach am Kaiserstuhl,50 - 55 Jahre,211,111,100
False,8316038,Sasbach am Kaiserstuhl,55 - 60 Jahre,158,79,79
False,8316038,Sasbach am Kaiserstuhl,60 - 65 Jahre,191,94,97
False,8316038,Sasbach am Kaiserstuhl,65 - 75 Jahre,274,150,124
False,8316038,Sasbach am Kaiserstuhl,75 und mehr Jahre,197,58,139
False,8316038,Sasbach am Kaiserstuhl,Insgesamt,3239,1588,1651
False,8316039,Sexau,unter 3 Jahre,70,31,39
False,8316039,Sexau,3 -  6 Jahre,108,54,54
False,8316039,Sexau,6 - 10 Jahre,157,73,84
False,8316039,Sexau,10 - 15 Jahre,177,88,89
False,8316039,Sexau,15 - 18 Jahre,103,50,53
False,8316039,Sexau,18 - 20 Jahre,76,41,35
False,8316039,Sexau,20 - 25 Jahre,152,86,66
False,8316039,Sexau,25 - 30 Jahre,154,73,81
False,8316039,Sexau,30 - 35 Jahre,268,134,134
False,8316039,Sexau,35 - 40 Jahre,298,139,159
False,8316039,Sexau,40 - 45 Jahre,276,142,134
False,8316039,Sexau,45 - 50 Jahre,237,131,106
False,8316039,Sexau,50 - 55 Jahre,220,107,113
False,8316039,Sexau,55 - 60 Jahre,188,94,94
False,8316039,Sexau,60 - 65 Jahre,210,99,111
False,8316039,Sexau,65 - 75 Jahre,274,143,131
False,8316039,Sexau,75 und mehr Jahre,176,59,117
False,8316039,Sexau,Insgesamt,3144,1544,1600
False,8316042,Simonswald,unter 3 Jahre,102,56,46
False,8316042,Simonswald,3 -  6 Jahre,123,63,60
False,8316042,Simonswald,6 - 10 Jahre,146,65,81
False,8316042,Simonswald,10 - 15 Jahre,184,101,83
False,8316042,Simonswald,15 - 18 Jahre,128,71,57
False,8316042,Simonswald,18 - 20 Jahre,65,36,29
False,8316042,Simonswald,20 - 25 Jahre,183,85,98
False,8316042,Simonswald,25 - 30 Jahre,193,96,97
False,8316042,Simonswald,30 - 35 Jahre,265,142,123
False,8316042,Simonswald,35 - 40 Jahre,289,156,133
False,8316042,Simonswald,40 - 45 Jahre,224,113,111
False,8316042,Simonswald,45 - 50 Jahre,212,120,92
False,8316042,Simonswald,50 - 55 Jahre,178,91,87
False,8316042,Simonswald,55 - 60 Jahre,157,74,83
False,8316042,Simonswald,60 - 65 Jahre,191,102,89
False,8316042,Simonswald,65 - 75 Jahre,281,129,152
False,8316042,Simonswald,75 und mehr Jahre,184,63,121
False,8316042,Simonswald,Insgesamt,3105,1563,1542
False,8316043,Teningen,unter 3 Jahre,373,190,183
False,8316043,Teningen,3 -  6 Jahre,375,193,182
False,8316043,Teningen,6 - 10 Jahre,534,286,248
False,8316043,Teningen,10 - 15 Jahre,694,353,341
False,8316043,Teningen,15 - 18 Jahre,357,184,173
False,8316043,Teningen,18 - 20 Jahre,236,123,113
False,8316043,Teningen,20 - 25 Jahre,568,315,253
False,8316043,Teningen,25 - 30 Jahre,667,324,343
False,8316043,Teningen,30 - 35 Jahre,992,508,484
False,8316043,Teningen,35 - 40 Jahre,1011,495,516
False,8316043,Teningen,40 - 45 Jahre,938,476,462
False,8316043,Teningen,45 - 50 Jahre,857,424,433
False,8316043,Teningen,50 - 55 Jahre,727,393,334
False,8316043,Teningen,55 - 60 Jahre,681,341,340
False,8316043,Teningen,60 - 65 Jahre,933,457,476
False,8316043,Teningen,65 - 75 Jahre,1081,513,568
False,8316043,Teningen,75 und mehr Jahre,719,224,495
False,8316043,Teningen,Insgesamt,11743,5799,5944
False,8316045,Vörstetten,unter 3 Jahre,74,32,42
False,8316045,Vörstetten,3 -  6 Jahre,87,50,37
False,8316045,Vörstetten,6 - 10 Jahre,147,92,55
False,8316045,Vörstetten,10 - 15 Jahre,174,88,86
False,8316045,Vörstetten,15 - 18 Jahre,103,47,56
False,8316045,Vörstetten,18 - 20 Jahre,57,26,31
False,8316045,Vörstetten,20 - 25 Jahre,127,66,61
False,8316045,Vörstetten,25 - 30 Jahre,142,78,64
False,8316045,Vörstetten,30 - 35 Jahre,213,95,118
False,8316045,Vörstetten,35 - 40 Jahre,248,134,114
False,8316045,Vörstetten,40 - 45 Jahre,232,105,127
False,8316045,Vörstetten,45 - 50 Jahre,213,100,113
False,8316045,Vörstetten,50 - 55 Jahre,173,98,75
False,8316045,Vörstetten,55 - 60 Jahre,179,91,88
False,8316045,Vörstetten,60 - 65 Jahre,170,83,87
False,8316045,Vörstetten,65 - 75 Jahre,173,86,87
False,8316045,Vörstetten,75 und mehr Jahre,142,48,94
False,8316045,Vörstetten,Insgesamt,2654,1319,1335
False,8316049,Weisweil,unter 3 Jahre,64,34,30
False,8316049,Weisweil,3 -  6 Jahre,83,40,43
False,8316049,Weisweil,6 - 10 Jahre,118,51,67
False,8316049,Weisweil,10 - 15 Jahre,164,85,79
False,8316049,Weisweil,15 - 18 Jahre,72,38,34
False,8316049,Weisweil,18 - 20 Jahre,51,33,18
False,8316049,Weisweil,20 - 25 Jahre,105,54,51
False,8316049,Weisweil,25 - 30 Jahre,113,50,63
False,8316049,Weisweil,30 - 35 Jahre,175,87,88
False,8316049,Weisweil,35 - 40 Jahre,217,107,110
False,8316049,Weisweil,40 - 45 Jahre,216,116,100
False,8316049,Weisweil,45 - 50 Jahre,130,73,57
False,8316049,Weisweil,50 - 55 Jahre,117,62,55
False,8316049,Weisweil,55 - 60 Jahre,87,41,46
False,8316049,Weisweil,60 - 65 Jahre,124,54,70
False,8316049,Weisweil,65 - 75 Jahre,147,71,76
False,8316049,Weisweil,75 und mehr Jahre,91,29,62
False,8316049,Weisweil,Insgesamt,2074,1025,1049
False,8316051,Wyhl am Kaiserstuhl,unter 3 Jahre,113,66,47
False,8316051,Wyhl am Kaiserstuhl,3 -  6 Jahre,150,59,91
False,8316051,Wyhl am Kaiserstuhl,6 - 10 Jahre,186,105,81
False,8316051,Wyhl am Kaiserstuhl,10 - 15 Jahre,245,124,121
False,8316051,Wyhl am Kaiserstuhl,15 - 18 Jahre,158,84,74
False,8316051,Wyhl am Kaiserstuhl,18 - 20 Jahre,92,51,41
False,8316051,Wyhl am Kaiserstuhl,20 - 25 Jahre,199,95,104
False,8316051,Wyhl am Kaiserstuhl,25 - 30 Jahre,216,118,98
False,8316051,Wyhl am Kaiserstuhl,30 - 35 Jahre,323,156,167
False,8316051,Wyhl am Kaiserstuhl,35 - 40 Jahre,329,174,155
False,8316051,Wyhl am Kaiserstuhl,40 - 45 Jahre,369,176,193
False,8316051,Wyhl am Kaiserstuhl,45 - 50 Jahre,246,146,100
False,8316051,Wyhl am Kaiserstuhl,50 - 55 Jahre,188,94,94
False,8316051,Wyhl am Kaiserstuhl,55 - 60 Jahre,155,78,77
False,8316051,Wyhl am Kaiserstuhl,60 - 65 Jahre,189,99,90
False,8316051,Wyhl am Kaiserstuhl,65 - 75 Jahre,252,117,135
False,8316051,Wyhl am Kaiserstuhl,75 und mehr Jahre,176,48,128
False,8316051,Wyhl am Kaiserstuhl,Insgesamt,3586,1790,1796
False,8316053,Rheinhausen,unter 3 Jahre,115,69,46
False,8316053,Rheinhausen,3 -  6 Jahre,140,70,70
False,8316053,Rheinhausen,6 - 10 Jahre,148,74,74
False,8316053,Rheinhausen,10 - 15 Jahre,218,128,90
False,8316053,Rheinhausen,15 - 18 Jahre,99,49,50
False,8316053,Rheinhausen,18 - 20 Jahre,66,23,43
False,8316053,Rheinhausen,20 - 25 Jahre,179,92,87
False,8316053,Rheinhausen,25 - 30 Jahre,177,94,83
False,8316053,Rheinhausen,30 - 35 Jahre,299,157,142
False,8316053,Rheinhausen,35 - 40 Jahre,314,169,145
False,8316053,Rheinhausen,40 - 45 Jahre,240,117,123
False,8316053,Rheinhausen,45 - 50 Jahre,202,108,94
False,8316053,Rheinhausen,50 - 55 Jahre,196,111,85
False,8316053,Rheinhausen,55 - 60 Jahre,165,74,91
False,8316053,Rheinhausen,60 - 65 Jahre,223,102,121
False,8316053,Rheinhausen,65 - 75 Jahre,307,153,154
False,8316053,Rheinhausen,75 und mehr Jahre,168,35,133
False,8316053,Rheinhausen,Insgesamt,3256,1625,1631
False,8316054,Freiamt,unter 3 Jahre,153,72,81
False,8316054,Freiamt,3 -  6 Jahre,164,93,71
False,8316054,Freiamt,6 - 10 Jahre,206,104,102
False,8316054,Freiamt,10 - 15 Jahre,254,143,111
False,8316054,Freiamt,15 - 18 Jahre,145,68,77
False,8316054,Freiamt,18 - 20 Jahre,81,42,39
False,8316054,Freiamt,20 - 25 Jahre,187,104,83
False,8316054,Freiamt,25 - 30 Jahre,247,123,124
False,8316054,Freiamt,30 - 35 Jahre,364,188,176
False,8316054,Freiamt,35 - 40 Jahre,392,211,181
False,8316054,Freiamt,40 - 45 Jahre,333,173,160
False,8316054,Freiamt,45 - 50 Jahre,302,150,152
False,8316054,Freiamt,50 - 55 Jahre,237,124,113
False,8316054,Freiamt,55 - 60 Jahre,191,91,100
False,8316054,Freiamt,60 - 65 Jahre,253,134,119
False,8316054,Freiamt,65 - 75 Jahre,427,186,241
False,8316054,Freiamt,75 und mehr Jahre,273,100,173
False,8316054,Freiamt,Insgesamt,4209,2106,2103
False,8316055,Winden im Elztal,unter 3 Jahre,108,63,45
False,8316055,Winden im Elztal,3 -  6 Jahre,111,50,61
False,8316055,Winden im Elztal,6 - 10 Jahre,128,59,69
False,8316055,Winden im Elztal,10 - 15 Jahre,179,90,89
False,8316055,Winden im Elztal,15 - 18 Jahre,117,64,53
False,8316055,Winden im Elztal,18 - 20 Jahre,66,27,39
False,8316055,Winden im Elztal,20 - 25 Jahre,146,80,66
False,8316055,Winden im Elztal,25 - 30 Jahre,150,81,69
False,8316055,Winden im Elztal,30 - 35 Jahre,230,119,111
False,8316055,Winden im Elztal,35 - 40 Jahre,244,128,116
False,8316055,Winden im Elztal,40 - 45 Jahre,244,129,115
False,8316055,Winden im Elztal,45 - 50 Jahre,206,109,97
False,8316055,Winden im Elztal,50 - 55 Jahre,146,81,65
False,8316055,Winden im Elztal,55 - 60 Jahre,109,59,50
False,8316055,Winden im Elztal,60 - 65 Jahre,164,81,83
False,8316055,Winden im Elztal,65 - 75 Jahre,245,107,138
False,8316055,Winden im Elztal,75 und mehr Jahre,156,52,104
False,8316055,Winden im Elztal,Insgesamt,2749,1379,1370
False,8316056,"Waldkirch, Stadt",unter 3 Jahre,567,285,282
False,8316056,"Waldkirch, Stadt",3 -  6 Jahre,649,335,314
False,8316056,"Waldkirch, Stadt",6 - 10 Jahre,902,473,429
False,8316056,"Waldkirch, Stadt",10 - 15 Jahre,1096,554,542
False,8316056,"Waldkirch, Stadt",15 - 18 Jahre,647,333,314
False,8316056,"Waldkirch, Stadt",18 - 20 Jahre,461,249,212
False,8316056,"Waldkirch, Stadt",20 - 25 Jahre,994,490,504
False,8316056,"Waldkirch, Stadt",25 - 30 Jahre,1080,529,551
False,8316056,"Waldkirch, Stadt",30 - 35 Jahre,1516,760,756
False,8316056,"Waldkirch, Stadt",35 - 40 Jahre,1634,804,830
False,8316056,"Waldkirch, Stadt",40 - 45 Jahre,1466,754,712
False,8316056,"Waldkirch, Stadt",45 - 50 Jahre,1334,645,689
False,8316056,"Waldkirch, Stadt",50 - 55 Jahre,1168,587,581
False,8316056,"Waldkirch, Stadt",55 - 60 Jahre,1224,563,661
False,8316056,"Waldkirch, Stadt",60 - 65 Jahre,1386,690,696
False,8316056,"Waldkirch, Stadt",65 - 75 Jahre,2035,930,1105
False,8316056,"Waldkirch, Stadt",75 und mehr Jahre,1580,435,1145
False,8316056,"Waldkirch, Stadt",Insgesamt,19739,9416,10323
False,8317,Landkreis Ortenaukreis,unter 3 Jahre,12785,6605,6180
False,8317,Landkreis Ortenaukreis,3 -  6 Jahre,14020,7218,6802
False,8317,Landkreis Ortenaukreis,6 - 10 Jahre,19499,9951,9548
False,8317,Landkreis Ortenaukreis,10 - 15 Jahre,25958,13313,12645
False,8317,Landkreis Ortenaukreis,15 - 18 Jahre,14343,7418,6925
False,8317,Landkreis Ortenaukreis,18 - 20 Jahre,9696,4961,4735
False,8317,Landkreis Ortenaukreis,20 - 25 Jahre,21811,11118,10693
False,8317,Landkreis Ortenaukreis,25 - 30 Jahre,23710,12047,11663
False,8317,Landkreis Ortenaukreis,30 - 35 Jahre,32865,16767,16098
False,8317,Landkreis Ortenaukreis,35 - 40 Jahre,35453,18105,17348
False,8317,Landkreis Ortenaukreis,40 - 45 Jahre,31918,16287,15631
False,8317,Landkreis Ortenaukreis,45 - 50 Jahre,28385,14404,13981
False,8317,Landkreis Ortenaukreis,50 - 55 Jahre,23310,11876,11434
False,8317,Landkreis Ortenaukreis,55 - 60 Jahre,20665,10283,10382
False,8317,Landkreis Ortenaukreis,60 - 65 Jahre,26997,13248,13749
False,8317,Landkreis Ortenaukreis,65 - 75 Jahre,37566,17178,20388
False,8317,Landkreis Ortenaukreis,75 und mehr Jahre,29145,8703,20442
False,8317,Landkreis Ortenaukreis,Insgesamt,408126,199482,208644
False,8317001,"Achern, Stadt",unter 3 Jahre,819,412,407
False,8317001,"Achern, Stadt",3 -  6 Jahre,867,468,399
False,8317001,"Achern, Stadt",6 - 10 Jahre,1212,638,574
False,8317001,"Achern, Stadt",10 - 15 Jahre,1515,785,730
False,8317001,"Achern, Stadt",15 - 18 Jahre,873,461,412
False,8317001,"Achern, Stadt",18 - 20 Jahre,652,343,309
False,8317001,"Achern, Stadt",20 - 25 Jahre,1295,658,637
False,8317001,"Achern, Stadt",25 - 30 Jahre,1380,701,679
False,8317001,"Achern, Stadt",30 - 35 Jahre,1860,903,957
False,8317001,"Achern, Stadt",35 - 40 Jahre,2021,1021,1000
False,8317001,"Achern, Stadt",40 - 45 Jahre,1780,859,921
False,8317001,"Achern, Stadt",45 - 50 Jahre,1661,861,800
False,8317001,"Achern, Stadt",50 - 55 Jahre,1305,670,635
False,8317001,"Achern, Stadt",55 - 60 Jahre,1238,579,659
False,8317001,"Achern, Stadt",60 - 65 Jahre,1463,720,743
False,8317001,"Achern, Stadt",65 - 75 Jahre,2136,954,1182
False,8317001,"Achern, Stadt",75 und mehr Jahre,1834,565,1269
False,8317001,"Achern, Stadt",Insgesamt,23911,11598,12313
False,8317005,Appenweier,unter 3 Jahre,294,161,133
False,8317005,Appenweier,3 -  6 Jahre,348,175,173
False,8317005,Appenweier,6 - 10 Jahre,476,241,235
False,8317005,Appenweier,10 - 15 Jahre,647,334,313
False,8317005,Appenweier,15 - 18 Jahre,360,194,166
False,8317005,Appenweier,18 - 20 Jahre,231,120,111
False,8317005,Appenweier,20 - 25 Jahre,525,266,259
False,8317005,Appenweier,25 - 30 Jahre,517,276,241
False,8317005,Appenweier,30 - 35 Jahre,742,363,379
False,8317005,Appenweier,35 - 40 Jahre,871,424,447
False,8317005,Appenweier,40 - 45 Jahre,803,400,403
False,8317005,Appenweier,45 - 50 Jahre,747,368,379
False,8317005,Appenweier,50 - 55 Jahre,607,304,303
False,8317005,Appenweier,55 - 60 Jahre,493,246,247
False,8317005,Appenweier,60 - 65 Jahre,643,340,303
False,8317005,Appenweier,65 - 75 Jahre,756,338,418
False,8317005,Appenweier,75 und mehr Jahre,623,198,425
False,8317005,Appenweier,Insgesamt,9683,4748,4935
False,8317008,Bad Peterstal-Griesbach,unter 3 Jahre,90,50,40
False,8317008,Bad Peterstal-Griesbach,3 -  6 Jahre,76,38,38
False,8317008,Bad Peterstal-Griesbach,6 - 10 Jahre,127,68,59
False,8317008,Bad Peterstal-Griesbach,10 - 15 Jahre,177,84,93
False,8317008,Bad Peterstal-Griesbach,15 - 18 Jahre,105,50,55
False,8317008,Bad Peterstal-Griesbach,18 - 20 Jahre,92,33,59
False,8317008,Bad Peterstal-Griesbach,20 - 25 Jahre,183,86,97
False,8317008,Bad Peterstal-Griesbach,25 - 30 Jahre,167,98,69
False,8317008,Bad Peterstal-Griesbach,30 - 35 Jahre,234,134,100
False,8317008,Bad Peterstal-Griesbach,35 - 40 Jahre,199,95,104
False,8317008,Bad Peterstal-Griesbach,40 - 45 Jahre,202,95,107
False,8317008,Bad Peterstal-Griesbach,45 - 50 Jahre,176,100,76
False,8317008,Bad Peterstal-Griesbach,50 - 55 Jahre,156,68,88
False,8317008,Bad Peterstal-Griesbach,55 - 60 Jahre,136,64,72
False,8317008,Bad Peterstal-Griesbach,60 - 65 Jahre,244,121,123
False,8317008,Bad Peterstal-Griesbach,65 - 75 Jahre,319,144,175
False,8317008,Bad Peterstal-Griesbach,75 und mehr Jahre,267,82,185
False,8317008,Bad Peterstal-Griesbach,Insgesamt,2950,1410,1540
False,8317009,Berghaupten,unter 3 Jahre,87,49,38
False,8317009,Berghaupten,3 -  6 Jahre,86,49,37
False,8317009,Berghaupten,6 - 10 Jahre,107,52,55
False,8317009,Berghaupten,10 - 15 Jahre,165,86,79
False,8317009,Berghaupten,15 - 18 Jahre,75,31,44
False,8317009,Berghaupten,18 - 20 Jahre,48,25,23
False,8317009,Berghaupten,20 - 25 Jahre,108,50,58
False,8317009,Berghaupten,25 - 30 Jahre,136,69,67
False,8317009,Berghaupten,30 - 35 Jahre,215,110,105
False,8317009,Berghaupten,35 - 40 Jahre,219,113,106
False,8317009,Berghaupten,40 - 45 Jahre,186,98,88
False,8317009,Berghaupten,45 - 50 Jahre,162,84,78
False,8317009,Berghaupten,50 - 55 Jahre,157,81,76
False,8317009,Berghaupten,55 - 60 Jahre,109,51,58
False,8317009,Berghaupten,60 - 65 Jahre,165,84,81
False,8317009,Berghaupten,65 - 75 Jahre,199,97,102
False,8317009,Berghaupten,75 und mehr Jahre,144,46,98
False,8317009,Berghaupten,Insgesamt,2368,1175,1193
False,8317011,Biberach,unter 3 Jahre,90,45,45
False,8317011,Biberach,3 -  6 Jahre,109,57,52
False,8317011,Biberach,6 - 10 Jahre,175,84,91
False,8317011,Biberach,10 - 15 Jahre,225,110,115
False,8317011,Biberach,15 - 18 Jahre,117,60,57
False,8317011,Biberach,18 - 20 Jahre,77,48,29
False,8317011,Biberach,20 - 25 Jahre,159,85,74
False,8317011,Biberach,25 - 30 Jahre,197,94,103
False,8317011,Biberach,30 - 35 Jahre,278,165,113
False,8317011,Biberach,35 - 40 Jahre,282,144,138
False,8317011,Biberach,40 - 45 Jahre,276,142,134
False,8317011,Biberach,45 - 50 Jahre,237,128,109
False,8317011,Biberach,50 - 55 Jahre,160,81,79
False,8317011,Biberach,55 - 60 Jahre,148,75,73
False,8317011,Biberach,60 - 65 Jahre,198,95,103
False,8317011,Biberach,65 - 75 Jahre,308,139,169
False,8317011,Biberach,75 und mehr Jahre,185,54,131
False,8317011,Biberach,Insgesamt,3221,1606,1615
False,8317021,Durbach,unter 3 Jahre,121,63,58
False,8317021,Durbach,3 -  6 Jahre,116,63,53
False,8317021,Durbach,6 - 10 Jahre,180,92,88
False,8317021,Durbach,10 - 15 Jahre,253,142,111
False,8317021,Durbach,15 - 18 Jahre,134,61,73
False,8317021,Durbach,18 - 20 Jahre,104,52,52
False,8317021,Durbach,20 - 25 Jahre,183,105,78
False,8317021,Durbach,25 - 30 Jahre,201,95,106
False,8317021,Durbach,30 - 35 Jahre,313,163,150
False,8317021,Durbach,35 - 40 Jahre,354,188,166
False,8317021,Durbach,40 - 45 Jahre,308,160,148
False,8317021,Durbach,45 - 50 Jahre,318,153,165
False,8317021,Durbach,50 - 55 Jahre,257,143,114
False,8317021,Durbach,55 - 60 Jahre,227,104,123
False,8317021,Durbach,60 - 65 Jahre,262,129,133
False,8317021,Durbach,65 - 75 Jahre,344,168,176
False,8317021,Durbach,75 und mehr Jahre,226,70,156
False,8317021,Durbach,Insgesamt,3901,1951,1950
False,8317026,"Ettenheim, Stadt",unter 3 Jahre,345,182,163
False,8317026,"Ettenheim, Stadt",3 -  6 Jahre,384,176,208
False,8317026,"Ettenheim, Stadt",6 - 10 Jahre,567,264,303
False,8317026,"Ettenheim, Stadt",10 - 15 Jahre,753,367,386
False,8317026,"Ettenheim, Stadt",15 - 18 Jahre,398,204,194
False,8317026,"Ettenheim, Stadt",18 - 20 Jahre,295,153,142
False,8317026,"Ettenheim, Stadt",20 - 25 Jahre,638,323,315
False,8317026,"Ettenheim, Stadt",25 - 30 Jahre,680,377,303
False,8317026,"Ettenheim, Stadt",30 - 35 Jahre,969,500,469
False,8317026,"Ettenheim, Stadt",35 - 40 Jahre,1045,502,543
False,8317026,"Ettenheim, Stadt",40 - 45 Jahre,969,489,480
False,8317026,"Ettenheim, Stadt",45 - 50 Jahre,798,406,392
False,8317026,"Ettenheim, Stadt",50 - 55 Jahre,614,323,291
False,8317026,"Ettenheim, Stadt",55 - 60 Jahre,536,276,260
False,8317026,"Ettenheim, Stadt",60 - 65 Jahre,771,367,404
False,8317026,"Ettenheim, Stadt",65 - 75 Jahre,1035,476,559
False,8317026,"Ettenheim, Stadt",75 und mehr Jahre,718,201,517
False,8317026,"Ettenheim, Stadt",Insgesamt,11515,5586,5929
False,8317029,Fischerbach,unter 3 Jahre,61,34,27
False,8317029,Fischerbach,3 -  6 Jahre,73,36,37
False,8317029,Fischerbach,6 - 10 Jahre,86,46,40
False,8317029,Fischerbach,10 - 15 Jahre,102,62,40
False,8317029,Fischerbach,15 - 18 Jahre,59,37,22
False,8317029,Fischerbach,18 - 20 Jahre,38,18,20
False,8317029,Fischerbach,20 - 25 Jahre,78,43,35
False,8317029,Fischerbach,25 - 30 Jahre,98,46,52
False,8317029,Fischerbach,30 - 35 Jahre,158,73,85
False,8317029,Fischerbach,35 - 40 Jahre,142,74,68
False,8317029,Fischerbach,40 - 45 Jahre,135,71,64
False,8317029,Fischerbach,45 - 50 Jahre,87,42,45
False,8317029,Fischerbach,50 - 55 Jahre,81,41,40
False,8317029,Fischerbach,55 - 60 Jahre,88,39,49
False,8317029,Fischerbach,60 - 65 Jahre,140,74,66
False,8317029,Fischerbach,65 - 75 Jahre,150,66,84
False,8317029,Fischerbach,75 und mehr Jahre,76,33,43
False,8317029,Fischerbach,Insgesamt,1652,835,817
False,8317031,Friesenheim,unter 3 Jahre,368,203,165
False,8317031,Friesenheim,3 -  6 Jahre,465,257,208
False,8317031,Friesenheim,6 - 10 Jahre,605,300,305
False,8317031,Friesenheim,10 - 15 Jahre,808,417,391
False,8317031,Friesenheim,15 - 18 Jahre,453,236,217
False,8317031,Friesenheim,18 - 20 Jahre,295,146,149
False,8317031,Friesenheim,20 - 25 Jahre,637,331,306
False,8317031,Friesenheim,25 - 30 Jahre,667,335,332
False,8317031,Friesenheim,30 - 35 Jahre,1027,509,518
False,8317031,Friesenheim,35 - 40 Jahre,1168,600,568
False,8317031,Friesenheim,40 - 45 Jahre,1106,562,544
False,8317031,Friesenheim,45 - 50 Jahre,889,450,439
False,8317031,Friesenheim,50 - 55 Jahre,676,339,337
False,8317031,Friesenheim,55 - 60 Jahre,626,314,312
False,8317031,Friesenheim,60 - 65 Jahre,730,350,380
False,8317031,Friesenheim,65 - 75 Jahre,1084,501,583
False,8317031,Friesenheim,75 und mehr Jahre,872,268,604
False,8317031,Friesenheim,Insgesamt,12476,6118,6358
False,8317034,"Gengenbach, Stadt",unter 3 Jahre,254,133,121
False,8317034,"Gengenbach, Stadt",3 -  6 Jahre,308,175,133
False,8317034,"Gengenbach, Stadt",6 - 10 Jahre,459,223,236
False,8317034,"Gengenbach, Stadt",10 - 15 Jahre,628,321,307
False,8317034,"Gengenbach, Stadt",15 - 18 Jahre,356,188,168
False,8317034,"Gengenbach, Stadt",18 - 20 Jahre,250,132,118
False,8317034,"Gengenbach, Stadt",20 - 25 Jahre,606,300,306
False,8317034,"Gengenbach, Stadt",25 - 30 Jahre,608,320,288
False,8317034,"Gengenbach, Stadt",30 - 35 Jahre,882,414,468
False,8317034,"Gengenbach, Stadt",35 - 40 Jahre,901,441,460
False,8317034,"Gengenbach, Stadt",40 - 45 Jahre,766,378,388
False,8317034,"Gengenbach, Stadt",45 - 50 Jahre,780,381,399
False,8317034,"Gengenbach, Stadt",50 - 55 Jahre,645,331,314
False,8317034,"Gengenbach, Stadt",55 - 60 Jahre,597,301,296
False,8317034,"Gengenbach, Stadt",60 - 65 Jahre,755,380,375
False,8317034,"Gengenbach, Stadt",65 - 75 Jahre,1124,515,609
False,8317034,"Gengenbach, Stadt",75 und mehr Jahre,1019,267,752
False,8317034,"Gengenbach, Stadt",Insgesamt,10938,5200,5738
False,8317039,Gutach (Schwarzwaldbahn),unter 3 Jahre,79,39,40
False,8317039,Gutach (Schwarzwaldbahn),3 -  6 Jahre,73,36,37
False,8317039,Gutach (Schwarzwaldbahn),6 - 10 Jahre,92,44,48
False,8317039,Gutach (Schwarzwaldbahn),10 - 15 Jahre,123,59,64
False,8317039,Gutach (Schwarzwaldbahn),15 - 18 Jahre,86,40,46
False,8317039,Gutach (Schwarzwaldbahn),18 - 20 Jahre,53,27,26
False,8317039,Gutach (Schwarzwaldbahn),20 - 25 Jahre,120,54,66
False,8317039,Gutach (Schwarzwaldbahn),25 - 30 Jahre,131,75,56
False,8317039,Gutach (Schwarzwaldbahn),30 - 35 Jahre,168,89,79
False,8317039,Gutach (Schwarzwaldbahn),35 - 40 Jahre,163,84,79
False,8317039,Gutach (Schwarzwaldbahn),40 - 45 Jahre,165,88,77
False,8317039,Gutach (Schwarzwaldbahn),45 - 50 Jahre,139,74,65
False,8317039,Gutach (Schwarzwaldbahn),50 - 55 Jahre,125,61,64
False,8317039,Gutach (Schwarzwaldbahn),55 - 60 Jahre,133,68,65
False,8317039,Gutach (Schwarzwaldbahn),60 - 65 Jahre,177,91,86
False,8317039,Gutach (Schwarzwaldbahn),65 - 75 Jahre,232,100,132
False,8317039,Gutach (Schwarzwaldbahn),75 und mehr Jahre,177,65,112
False,8317039,Gutach (Schwarzwaldbahn),Insgesamt,2236,1094,1142
False,8317040,"Haslach im Kinzigtal, Stadt",unter 3 Jahre,231,120,111
False,8317040,"Haslach im Kinzigtal, Stadt",3 -  6 Jahre,241,133,108
False,8317040,"Haslach im Kinzigtal, Stadt",6 - 10 Jahre,321,142,179
False,8317040,"Haslach im Kinzigtal, Stadt",10 - 15 Jahre,442,238,204
False,8317040,"Haslach im Kinzigtal, Stadt",15 - 18 Jahre,247,124,123
False,8317040,"Haslach im Kinzigtal, Stadt",18 - 20 Jahre,138,74,64
False,8317040,"Haslach im Kinzigtal, Stadt",20 - 25 Jahre,362,163,199
False,8317040,"Haslach im Kinzigtal, Stadt",25 - 30 Jahre,414,218,196
False,8317040,"Haslach im Kinzigtal, Stadt",30 - 35 Jahre,536,283,253
False,8317040,"Haslach im Kinzigtal, Stadt",35 - 40 Jahre,623,313,310
False,8317040,"Haslach im Kinzigtal, Stadt",40 - 45 Jahre,554,277,277
False,8317040,"Haslach im Kinzigtal, Stadt",45 - 50 Jahre,453,239,214
False,8317040,"Haslach im Kinzigtal, Stadt",50 - 55 Jahre,340,172,168
False,8317040,"Haslach im Kinzigtal, Stadt",55 - 60 Jahre,323,151,172
False,8317040,"Haslach im Kinzigtal, Stadt",60 - 65 Jahre,476,223,253
False,8317040,"Haslach im Kinzigtal, Stadt",65 - 75 Jahre,653,315,338
False,8317040,"Haslach im Kinzigtal, Stadt",75 und mehr Jahre,582,158,424
False,8317040,"Haslach im Kinzigtal, Stadt",Insgesamt,6936,3343,3593
False,8317041,"Hausach, Stadt",unter 3 Jahre,157,85,72
False,8317041,"Hausach, Stadt",3 -  6 Jahre,190,96,94
False,8317041,"Hausach, Stadt",6 - 10 Jahre,270,138,132
False,8317041,"Hausach, Stadt",10 - 15 Jahre,347,183,164
False,8317041,"Hausach, Stadt",15 - 18 Jahre,206,104,102
False,8317041,"Hausach, Stadt",18 - 20 Jahre,158,86,72
False,8317041,"Hausach, Stadt",20 - 25 Jahre,321,163,158
False,8317041,"Hausach, Stadt",25 - 30 Jahre,314,172,142
False,8317041,"Hausach, Stadt",30 - 35 Jahre,422,221,201
False,8317041,"Hausach, Stadt",35 - 40 Jahre,495,247,248
False,8317041,"Hausach, Stadt",40 - 45 Jahre,452,234,218
False,8317041,"Hausach, Stadt",45 - 50 Jahre,398,204,194
False,8317041,"Hausach, Stadt",50 - 55 Jahre,305,158,147
False,8317041,"Hausach, Stadt",55 - 60 Jahre,277,137,140
False,8317041,"Hausach, Stadt",60 - 65 Jahre,384,192,192
False,8317041,"Hausach, Stadt",65 - 75 Jahre,589,255,334
False,8317041,"Hausach, Stadt",75 und mehr Jahre,455,128,327
False,8317041,"Hausach, Stadt",Insgesamt,5740,2803,2937
False,8317046,Hofstetten,unter 3 Jahre,71,40,31
False,8317046,Hofstetten,3 -  6 Jahre,73,35,38
False,8317046,Hofstetten,6 - 10 Jahre,67,35,32
False,8317046,Hofstetten,10 - 15 Jahre,104,54,50
False,8317046,Hofstetten,15 - 18 Jahre,64,33,31
False,8317046,Hofstetten,18 - 20 Jahre,48,30,18
False,8317046,Hofstetten,20 - 25 Jahre,90,50,40
False,8317046,Hofstetten,25 - 30 Jahre,115,64,51
False,8317046,Hofstetten,30 - 35 Jahre,145,81,64
False,8317046,Hofstetten,35 - 40 Jahre,152,79,73
False,8317046,Hofstetten,40 - 45 Jahre,106,55,51
False,8317046,Hofstetten,45 - 50 Jahre,108,62,46
False,8317046,Hofstetten,50 - 55 Jahre,93,44,49
False,8317046,Hofstetten,55 - 60 Jahre,95,45,50
False,8317046,Hofstetten,60 - 65 Jahre,97,54,43
False,8317046,Hofstetten,65 - 75 Jahre,103,52,51
False,8317046,Hofstetten,75 und mehr Jahre,83,24,59
False,8317046,Hofstetten,Insgesamt,1614,837,777
False,8317047,Hohberg,unter 3 Jahre,266,124,142
False,8317047,Hohberg,3 -  6 Jahre,290,145,145
False,8317047,Hohberg,6 - 10 Jahre,389,203,186
False,8317047,Hohberg,10 - 15 Jahre,517,264,253
False,8317047,Hohberg,15 - 18 Jahre,255,147,108
False,8317047,Hohberg,18 - 20 Jahre,157,82,75
False,8317047,Hohberg,20 - 25 Jahre,371,174,197
False,8317047,Hohberg,25 - 30 Jahre,422,202,220
False,8317047,Hohberg,30 - 35 Jahre,650,317,333
False,8317047,Hohberg,35 - 40 Jahre,728,375,353
False,8317047,Hohberg,40 - 45 Jahre,635,343,292
False,8317047,Hohberg,45 - 50 Jahre,545,273,272
False,8317047,Hohberg,50 - 55 Jahre,437,225,212
False,8317047,Hohberg,55 - 60 Jahre,370,192,178
False,8317047,Hohberg,60 - 65 Jahre,453,217,236
False,8317047,Hohberg,65 - 75 Jahre,690,310,380
False,8317047,Hohberg,75 und mehr Jahre,489,154,335
False,8317047,Hohberg,Insgesamt,7664,3747,3917
False,8317051,"Hornberg, Stadt",unter 3 Jahre,119,60,59
False,8317051,"Hornberg, Stadt",3 -  6 Jahre,148,75,73
False,8317051,"Hornberg, Stadt",6 - 10 Jahre,187,96,91
False,8317051,"Hornberg, Stadt",10 - 15 Jahre,264,133,131
False,8317051,"Hornberg, Stadt",15 - 18 Jahre,139,80,59
False,8317051,"Hornberg, Stadt",18 - 20 Jahre,101,54,47
False,8317051,"Hornberg, Stadt",20 - 25 Jahre,247,121,126
False,8317051,"Hornberg, Stadt",25 - 30 Jahre,247,138,109
False,8317051,"Hornberg, Stadt",30 - 35 Jahre,331,171,160
False,8317051,"Hornberg, Stadt",35 - 40 Jahre,339,182,157
False,8317051,"Hornberg, Stadt",40 - 45 Jahre,381,191,190
False,8317051,"Hornberg, Stadt",45 - 50 Jahre,331,183,148
False,8317051,"Hornberg, Stadt",50 - 55 Jahre,282,157,125
False,8317051,"Hornberg, Stadt",55 - 60 Jahre,230,103,127
False,8317051,"Hornberg, Stadt",60 - 65 Jahre,332,158,174
False,8317051,"Hornberg, Stadt",65 - 75 Jahre,515,224,291
False,8317051,"Hornberg, Stadt",75 und mehr Jahre,343,105,238
False,8317051,"Hornberg, Stadt",Insgesamt,4536,2231,2305
False,8317056,Kappelrodeck,unter 3 Jahre,212,101,111
False,8317056,Kappelrodeck,3 -  6 Jahre,190,92,98
False,8317056,Kappelrodeck,6 - 10 Jahre,293,159,134
False,8317056,Kappelrodeck,10 - 15 Jahre,385,196,189
False,8317056,Kappelrodeck,15 - 18 Jahre,208,103,105
False,8317056,Kappelrodeck,18 - 20 Jahre,125,65,60
False,8317056,Kappelrodeck,20 - 25 Jahre,327,168,159
False,8317056,Kappelrodeck,25 - 30 Jahre,347,168,179
False,8317056,Kappelrodeck,30 - 35 Jahre,468,250,218
False,8317056,Kappelrodeck,35 - 40 Jahre,465,248,217
False,8317056,Kappelrodeck,40 - 45 Jahre,458,239,219
False,8317056,Kappelrodeck,45 - 50 Jahre,375,198,177
False,8317056,Kappelrodeck,50 - 55 Jahre,327,160,167
False,8317056,Kappelrodeck,55 - 60 Jahre,265,121,144
False,8317056,Kappelrodeck,60 - 65 Jahre,397,203,194
False,8317056,Kappelrodeck,65 - 75 Jahre,581,269,312
False,8317056,Kappelrodeck,75 und mehr Jahre,414,119,295
False,8317056,Kappelrodeck,Insgesamt,5837,2859,2978
False,8317057,"Kehl, Stadt",unter 3 Jahre,943,486,457
False,8317057,"Kehl, Stadt",3 -  6 Jahre,1038,509,529
False,8317057,"Kehl, Stadt",6 - 10 Jahre,1465,734,731
False,8317057,"Kehl, Stadt",10 - 15 Jahre,2087,1079,1008
False,8317057,"Kehl, Stadt",15 - 18 Jahre,1153,607,546
False,8317057,"Kehl, Stadt",18 - 20 Jahre,797,414,383
False,8317057,"Kehl, Stadt",20 - 25 Jahre,1898,957,941
False,8317057,"Kehl, Stadt",25 - 30 Jahre,1996,1008,988
False,8317057,"Kehl, Stadt",30 - 35 Jahre,2765,1393,1372
False,8317057,"Kehl, Stadt",35 - 40 Jahre,2647,1320,1327
False,8317057,"Kehl, Stadt",40 - 45 Jahre,2587,1307,1280
False,8317057,"Kehl, Stadt",45 - 50 Jahre,2430,1228,1202
False,8317057,"Kehl, Stadt",50 - 55 Jahre,2113,1055,1058
False,8317057,"Kehl, Stadt",55 - 60 Jahre,1910,994,916
False,8317057,"Kehl, Stadt",60 - 65 Jahre,2276,1105,1171
False,8317057,"Kehl, Stadt",65 - 75 Jahre,3113,1440,1673
False,8317057,"Kehl, Stadt",75 und mehr Jahre,2291,689,1602
False,8317057,"Kehl, Stadt",Insgesamt,33509,16325,17184
False,8317059,Kippenheim,unter 3 Jahre,155,82,73
False,8317059,Kippenheim,3 -  6 Jahre,185,102,83
False,8317059,Kippenheim,6 - 10 Jahre,237,119,118
False,8317059,Kippenheim,10 - 15 Jahre,350,181,169
False,8317059,Kippenheim,15 - 18 Jahre,167,72,95
False,8317059,Kippenheim,18 - 20 Jahre,122,73,49
False,8317059,Kippenheim,20 - 25 Jahre,296,148,148
False,8317059,Kippenheim,25 - 30 Jahre,288,142,146
False,8317059,Kippenheim,30 - 35 Jahre,400,224,176
False,8317059,Kippenheim,35 - 40 Jahre,440,205,235
False,8317059,Kippenheim,40 - 45 Jahre,393,216,177
False,8317059,Kippenheim,45 - 50 Jahre,395,199,196
False,8317059,Kippenheim,50 - 55 Jahre,295,155,140
False,8317059,Kippenheim,55 - 60 Jahre,276,139,137
False,8317059,Kippenheim,60 - 65 Jahre,333,171,162
False,8317059,Kippenheim,65 - 75 Jahre,499,231,268
False,8317059,Kippenheim,75 und mehr Jahre,266,91,175
False,8317059,Kippenheim,Insgesamt,5097,2550,2547
False,8317065,"Lahr/Schwarzwald, Stadt",unter 3 Jahre,1324,691,633
False,8317065,"Lahr/Schwarzwald, Stadt",3 -  6 Jahre,1417,706,711
False,8317065,"Lahr/Schwarzwald, Stadt",6 - 10 Jahre,1937,988,949
False,8317065,"Lahr/Schwarzwald, Stadt",10 - 15 Jahre,2680,1333,1347
False,8317065,"Lahr/Schwarzwald, Stadt",15 - 18 Jahre,1570,772,798
False,8317065,"Lahr/Schwarzwald, Stadt",18 - 20 Jahre,1096,533,563
False,8317065,"Lahr/Schwarzwald, Stadt",20 - 25 Jahre,2463,1236,1227
False,8317065,"Lahr/Schwarzwald, Stadt",25 - 30 Jahre,2597,1329,1268
False,8317065,"Lahr/Schwarzwald, Stadt",30 - 35 Jahre,3358,1691,1667
False,8317065,"Lahr/Schwarzwald, Stadt",35 - 40 Jahre,3505,1823,1682
False,8317065,"Lahr/Schwarzwald, Stadt",40 - 45 Jahre,3195,1614,1581
False,8317065,"Lahr/Schwarzwald, Stadt",45 - 50 Jahre,2910,1469,1441
False,8317065,"Lahr/Schwarzwald, Stadt",50 - 55 Jahre,2394,1205,1189
False,8317065,"Lahr/Schwarzwald, Stadt",55 - 60 Jahre,2090,1030,1060
False,8317065,"Lahr/Schwarzwald, Stadt",60 - 65 Jahre,2761,1335,1426
False,8317065,"Lahr/Schwarzwald, Stadt",65 - 75 Jahre,3961,1757,2204
False,8317065,"Lahr/Schwarzwald, Stadt",75 und mehr Jahre,3297,955,2342
False,8317065,"Lahr/Schwarzwald, Stadt",Insgesamt,42555,20467,22088
False,8317067,Lautenbach,unter 3 Jahre,63,29,34
False,8317067,Lautenbach,3 -  6 Jahre,56,28,28
False,8317067,Lautenbach,6 - 10 Jahre,81,43,38
False,8317067,Lautenbach,10 - 15 Jahre,103,57,46
False,8317067,Lautenbach,15 - 18 Jahre,77,37,40
False,8317067,Lautenbach,18 - 20 Jahre,55,34,21
False,8317067,Lautenbach,20 - 25 Jahre,106,56,50
False,8317067,Lautenbach,25 - 30 Jahre,103,57,46
False,8317067,Lautenbach,30 - 35 Jahre,153,91,62
False,8317067,Lautenbach,35 - 40 Jahre,164,83,81
False,8317067,Lautenbach,40 - 45 Jahre,143,79,64
False,8317067,Lautenbach,45 - 50 Jahre,135,65,70
False,8317067,Lautenbach,50 - 55 Jahre,124,70,54
False,8317067,Lautenbach,55 - 60 Jahre,81,37,44
False,8317067,Lautenbach,60 - 65 Jahre,135,69,66
False,8317067,Lautenbach,65 - 75 Jahre,191,98,93
False,8317067,Lautenbach,75 und mehr Jahre,120,39,81
False,8317067,Lautenbach,Insgesamt,1890,972,918
False,8317068,Lauf,unter 3 Jahre,120,69,51
False,8317068,Lauf,3 -  6 Jahre,153,76,77
False,8317068,Lauf,6 - 10 Jahre,186,101,85
False,8317068,Lauf,10 - 15 Jahre,223,124,99
False,8317068,Lauf,15 - 18 Jahre,132,71,61
False,8317068,Lauf,18 - 20 Jahre,83,47,36
False,8317068,Lauf,20 - 25 Jahre,189,105,84
False,8317068,Lauf,25 - 30 Jahre,204,94,110
False,8317068,Lauf,30 - 35 Jahre,259,130,129
False,8317068,Lauf,35 - 40 Jahre,340,179,161
False,8317068,Lauf,40 - 45 Jahre,311,153,158
False,8317068,Lauf,45 - 50 Jahre,300,145,155
False,8317068,Lauf,50 - 55 Jahre,236,118,118
False,8317068,Lauf,55 - 60 Jahre,219,113,106
False,8317068,Lauf,60 - 65 Jahre,278,143,135
False,8317068,Lauf,65 - 75 Jahre,394,163,231
False,8317068,Lauf,75 und mehr Jahre,290,86,204
False,8317068,Lauf,Insgesamt,3917,1917,2000
False,8317073,"Mahlberg, Stadt",unter 3 Jahre,148,77,71
False,8317073,"Mahlberg, Stadt",3 -  6 Jahre,164,85,79
False,8317073,"Mahlberg, Stadt",6 - 10 Jahre,248,128,120
False,8317073,"Mahlberg, Stadt",10 - 15 Jahre,338,166,172
False,8317073,"Mahlberg, Stadt",15 - 18 Jahre,165,94,71
False,8317073,"Mahlberg, Stadt",18 - 20 Jahre,128,64,64
False,8317073,"Mahlberg, Stadt",20 - 25 Jahre,255,114,141
False,8317073,"Mahlberg, Stadt",25 - 30 Jahre,255,130,125
False,8317073,"Mahlberg, Stadt",30 - 35 Jahre,398,198,200
False,8317073,"Mahlberg, Stadt",35 - 40 Jahre,487,236,251
False,8317073,"Mahlberg, Stadt",40 - 45 Jahre,405,200,205
False,8317073,"Mahlberg, Stadt",45 - 50 Jahre,297,153,144
False,8317073,"Mahlberg, Stadt",50 - 55 Jahre,248,135,113
False,8317073,"Mahlberg, Stadt",55 - 60 Jahre,173,96,77
False,8317073,"Mahlberg, Stadt",60 - 65 Jahre,240,102,138
False,8317073,"Mahlberg, Stadt",65 - 75 Jahre,306,139,167
False,8317073,"Mahlberg, Stadt",75 und mehr Jahre,212,67,145
False,8317073,"Mahlberg, Stadt",Insgesamt,4467,2184,2283
False,8317075,Meißenheim,unter 3 Jahre,129,64,65
False,8317075,Meißenheim,3 -  6 Jahre,110,61,49
False,8317075,Meißenheim,6 - 10 Jahre,177,88,89
False,8317075,Meißenheim,10 - 15 Jahre,241,130,111
False,8317075,Meißenheim,15 - 18 Jahre,121,60,61
False,8317075,Meißenheim,18 - 20 Jahre,66,29,37
False,8317075,Meißenheim,20 - 25 Jahre,156,91,65
False,8317075,Meißenheim,25 - 30 Jahre,178,84,94
False,8317075,Meißenheim,30 - 35 Jahre,316,183,133
False,8317075,Meißenheim,35 - 40 Jahre,327,173,154
False,8317075,Meißenheim,40 - 45 Jahre,320,165,155
False,8317075,Meißenheim,45 - 50 Jahre,266,137,129
False,8317075,Meißenheim,50 - 55 Jahre,207,108,99
False,8317075,Meißenheim,55 - 60 Jahre,172,87,85
False,8317075,Meißenheim,60 - 65 Jahre,228,114,114
False,8317075,Meißenheim,65 - 75 Jahre,352,158,194
False,8317075,Meißenheim,75 und mehr Jahre,212,70,142
False,8317075,Meißenheim,Insgesamt,3578,1802,1776
False,8317078,Mühlenbach,unter 3 Jahre,72,39,33
False,8317078,Mühlenbach,3 -  6 Jahre,79,40,39
False,8317078,Mühlenbach,6 - 10 Jahre,88,45,43
False,8317078,Mühlenbach,10 - 15 Jahre,127,57,70
False,8317078,Mühlenbach,15 - 18 Jahre,67,36,31
False,8317078,Mühlenbach,18 - 20 Jahre,35,16,19
False,8317078,Mühlenbach,20 - 25 Jahre,92,38,54
False,8317078,Mühlenbach,25 - 30 Jahre,122,67,55
False,8317078,Mühlenbach,30 - 35 Jahre,150,73,77
False,8317078,Mühlenbach,35 - 40 Jahre,144,76,68
False,8317078,Mühlenbach,40 - 45 Jahre,110,67,43
False,8317078,Mühlenbach,45 - 50 Jahre,107,63,44
False,8317078,Mühlenbach,50 - 55 Jahre,74,34,40
False,8317078,Mühlenbach,55 - 60 Jahre,56,26,30
False,8317078,Mühlenbach,60 - 65 Jahre,118,59,59
False,8317078,Mühlenbach,65 - 75 Jahre,145,80,65
False,8317078,Mühlenbach,75 und mehr Jahre,95,24,71
False,8317078,Mühlenbach,Insgesamt,1681,840,841
False,8317085,Nordrach,unter 3 Jahre,70,40,30
False,8317085,Nordrach,3 -  6 Jahre,89,41,48
False,8317085,Nordrach,6 - 10 Jahre,100,49,51
False,8317085,Nordrach,10 - 15 Jahre,108,57,51
False,8317085,Nordrach,15 - 18 Jahre,63,38,25
False,8317085,Nordrach,18 - 20 Jahre,50,32,18
False,8317085,Nordrach,20 - 25 Jahre,88,41,47
False,8317085,Nordrach,25 - 30 Jahre,73,34,39
False,8317085,Nordrach,30 - 35 Jahre,181,102,79
False,8317085,Nordrach,35 - 40 Jahre,168,90,78
False,8317085,Nordrach,40 - 45 Jahre,155,89,66
False,8317085,Nordrach,45 - 50 Jahre,134,71,63
False,8317085,Nordrach,50 - 55 Jahre,116,63,53
False,8317085,Nordrach,55 - 60 Jahre,108,61,47
False,8317085,Nordrach,60 - 65 Jahre,166,81,85
False,8317085,Nordrach,65 - 75 Jahre,183,94,89
False,8317085,Nordrach,75 und mehr Jahre,123,44,79
False,8317085,Nordrach,Insgesamt,1975,1027,948
False,8317088,Oberharmersbach,unter 3 Jahre,98,56,42
False,8317088,Oberharmersbach,3 -  6 Jahre,118,62,56
False,8317088,Oberharmersbach,6 - 10 Jahre,168,80,88
False,8317088,Oberharmersbach,10 - 15 Jahre,202,108,94
False,8317088,Oberharmersbach,15 - 18 Jahre,103,60,43
False,8317088,Oberharmersbach,18 - 20 Jahre,55,26,29
False,8317088,Oberharmersbach,20 - 25 Jahre,131,68,63
False,8317088,Oberharmersbach,25 - 30 Jahre,137,62,75
False,8317088,Oberharmersbach,30 - 35 Jahre,203,105,98
False,8317088,Oberharmersbach,35 - 40 Jahre,254,131,123
False,8317088,Oberharmersbach,40 - 45 Jahre,206,115,91
False,8317088,Oberharmersbach,45 - 50 Jahre,155,87,68
False,8317088,Oberharmersbach,50 - 55 Jahre,118,57,61
False,8317088,Oberharmersbach,55 - 60 Jahre,94,49,45
False,8317088,Oberharmersbach,60 - 65 Jahre,174,84,90
False,8317088,Oberharmersbach,65 - 75 Jahre,229,111,118
False,8317088,Oberharmersbach,75 und mehr Jahre,149,37,112
False,8317088,Oberharmersbach,Insgesamt,2594,1298,1296
False,8317089,"Oberkirch, Stadt",unter 3 Jahre,664,335,329
False,8317089,"Oberkirch, Stadt",3 -  6 Jahre,736,391,345
False,8317089,"Oberkirch, Stadt",6 - 10 Jahre,1080,552,528
False,8317089,"Oberkirch, Stadt",10 - 15 Jahre,1463,749,714
False,8317089,"Oberkirch, Stadt",15 - 18 Jahre,769,411,358
False,8317089,"Oberkirch, Stadt",18 - 20 Jahre,487,242,245
False,8317089,"Oberkirch, Stadt",20 - 25 Jahre,1018,522,496
False,8317089,"Oberkirch, Stadt",25 - 30 Jahre,1155,579,576
False,8317089,"Oberkirch, Stadt",30 - 35 Jahre,1603,813,790
False,8317089,"Oberkirch, Stadt",35 - 40 Jahre,1710,870,840
False,8317089,"Oberkirch, Stadt",40 - 45 Jahre,1553,807,746
False,8317089,"Oberkirch, Stadt",45 - 50 Jahre,1301,662,639
False,8317089,"Oberkirch, Stadt",50 - 55 Jahre,1046,548,498
False,8317089,"Oberkirch, Stadt",55 - 60 Jahre,926,465,461
False,8317089,"Oberkirch, Stadt",60 - 65 Jahre,1236,610,626
False,8317089,"Oberkirch, Stadt",65 - 75 Jahre,1800,827,973
False,8317089,"Oberkirch, Stadt",75 und mehr Jahre,1332,412,920
False,8317089,"Oberkirch, Stadt",Insgesamt,19879,9795,10084
False,8317093,Oberwolfach,unter 3 Jahre,106,57,49
False,8317093,Oberwolfach,3 -  6 Jahre,116,59,57
False,8317093,Oberwolfach,6 - 10 Jahre,142,80,62
False,8317093,Oberwolfach,10 - 15 Jahre,156,67,89
False,8317093,Oberwolfach,15 - 18 Jahre,120,63,57
False,8317093,Oberwolfach,18 - 20 Jahre,76,40,36
False,8317093,Oberwolfach,20 - 25 Jahre,161,74,87
False,8317093,Oberwolfach,25 - 30 Jahre,162,88,74
False,8317093,Oberwolfach,30 - 35 Jahre,223,107,116
False,8317093,Oberwolfach,35 - 40 Jahre,249,148,101
False,8317093,Oberwolfach,40 - 45 Jahre,192,88,104
False,8317093,Oberwolfach,45 - 50 Jahre,155,75,80
False,8317093,Oberwolfach,50 - 55 Jahre,122,68,54
False,8317093,Oberwolfach,55 - 60 Jahre,140,77,63
False,8317093,Oberwolfach,60 - 65 Jahre,191,97,94
False,8317093,Oberwolfach,65 - 75 Jahre,257,128,129
False,8317093,Oberwolfach,75 und mehr Jahre,195,52,143
False,8317093,Oberwolfach,Insgesamt,2763,1368,1395
False,8317096,"Offenburg, Stadt",unter 3 Jahre,1719,871,848
False,8317096,"Offenburg, Stadt",3 -  6 Jahre,1838,928,910
False,8317096,"Offenburg, Stadt",6 - 10 Jahre,2526,1346,1180
False,8317096,"Offenburg, Stadt",10 - 15 Jahre,3322,1762,1560
False,8317096,"Offenburg, Stadt",15 - 18 Jahre,1906,977,929
False,8317096,"Offenburg, Stadt",18 - 20 Jahre,1267,635,632
False,8317096,"Offenburg, Stadt",20 - 25 Jahre,3155,1645,1510
False,8317096,"Offenburg, Stadt",25 - 30 Jahre,3611,1776,1835
False,8317096,"Offenburg, Stadt",30 - 35 Jahre,4541,2340,2201
False,8317096,"Offenburg, Stadt",35 - 40 Jahre,4713,2382,2331
False,8317096,"Offenburg, Stadt",40 - 45 Jahre,4394,2213,2181
False,8317096,"Offenburg, Stadt",45 - 50 Jahre,3999,1956,2043
False,8317096,"Offenburg, Stadt",50 - 55 Jahre,3405,1669,1736
False,8317096,"Offenburg, Stadt",55 - 60 Jahre,3210,1560,1650
False,8317096,"Offenburg, Stadt",60 - 65 Jahre,3920,1882,2038
False,8317096,"Offenburg, Stadt",65 - 75 Jahre,5357,2411,2946
False,8317096,"Offenburg, Stadt",75 und mehr Jahre,4572,1382,3190
False,8317096,"Offenburg, Stadt",Insgesamt,57455,27735,29720
False,8317097,Ohlsbach,unter 3 Jahre,111,59,52
False,8317097,Ohlsbach,3 -  6 Jahre,101,55,46
False,8317097,Ohlsbach,6 - 10 Jahre,156,83,73
False,8317097,Ohlsbach,10 - 15 Jahre,181,98,83
False,8317097,Ohlsbach,15 - 18 Jahre,99,57,42
False,8317097,Ohlsbach,18 - 20 Jahre,61,35,26
False,8317097,Ohlsbach,20 - 25 Jahre,125,65,60
False,8317097,Ohlsbach,25 - 30 Jahre,161,73,88
False,8317097,Ohlsbach,30 - 35 Jahre,266,125,141
False,8317097,Ohlsbach,35 - 40 Jahre,281,143,138
False,8317097,Ohlsbach,40 - 45 Jahre,244,134,110
False,8317097,Ohlsbach,45 - 50 Jahre,206,95,111
False,8317097,Ohlsbach,50 - 55 Jahre,180,88,92
False,8317097,Ohlsbach,55 - 60 Jahre,154,83,71
False,8317097,Ohlsbach,60 - 65 Jahre,188,96,92
False,8317097,Ohlsbach,65 - 75 Jahre,257,118,139
False,8317097,Ohlsbach,75 und mehr Jahre,177,76,101
False,8317097,Ohlsbach,Insgesamt,2948,1483,1465
False,8317098,"Oppenau, Stadt",unter 3 Jahre,155,70,85
False,8317098,"Oppenau, Stadt",3 -  6 Jahre,161,83,78
False,8317098,"Oppenau, Stadt",6 - 10 Jahre,240,125,115
False,8317098,"Oppenau, Stadt",10 - 15 Jahre,360,178,182
False,8317098,"Oppenau, Stadt",15 - 18 Jahre,172,91,81
False,8317098,"Oppenau, Stadt",18 - 20 Jahre,115,67,48
False,8317098,"Oppenau, Stadt",20 - 25 Jahre,249,132,117
False,8317098,"Oppenau, Stadt",25 - 30 Jahre,265,138,127
False,8317098,"Oppenau, Stadt",30 - 35 Jahre,399,219,180
False,8317098,"Oppenau, Stadt",35 - 40 Jahre,413,221,192
False,8317098,"Oppenau, Stadt",40 - 45 Jahre,355,177,178
False,8317098,"Oppenau, Stadt",45 - 50 Jahre,334,175,159
False,8317098,"Oppenau, Stadt",50 - 55 Jahre,266,136,130
False,8317098,"Oppenau, Stadt",55 - 60 Jahre,221,109,112
False,8317098,"Oppenau, Stadt",60 - 65 Jahre,384,193,191
False,8317098,"Oppenau, Stadt",65 - 75 Jahre,539,247,292
False,8317098,"Oppenau, Stadt",75 und mehr Jahre,488,128,360
False,8317098,"Oppenau, Stadt",Insgesamt,5116,2489,2627
False,8317100,Ortenberg,unter 3 Jahre,112,60,52
False,8317100,Ortenberg,3 -  6 Jahre,113,61,52
False,8317100,Ortenberg,6 - 10 Jahre,149,76,73
False,8317100,Ortenberg,10 - 15 Jahre,169,80,89
False,8317100,Ortenberg,15 - 18 Jahre,91,49,42
False,8317100,Ortenberg,18 - 20 Jahre,62,24,38
False,8317100,Ortenberg,20 - 25 Jahre,149,78,71
False,8317100,Ortenberg,25 - 30 Jahre,172,72,100
False,8317100,Ortenberg,30 - 35 Jahre,270,149,121
False,8317100,Ortenberg,35 - 40 Jahre,304,165,139
False,8317100,Ortenberg,40 - 45 Jahre,244,134,110
False,8317100,Ortenberg,45 - 50 Jahre,229,111,118
False,8317100,Ortenberg,50 - 55 Jahre,176,86,90
False,8317100,Ortenberg,55 - 60 Jahre,174,88,86
False,8317100,Ortenberg,60 - 65 Jahre,213,101,112
False,8317100,Ortenberg,65 - 75 Jahre,314,148,166
False,8317100,Ortenberg,75 und mehr Jahre,256,79,177
False,8317100,Ortenberg,Insgesamt,3197,1561,1636
False,8317102,Ottenhöfen im Schwarzwald,unter 3 Jahre,114,56,58
False,8317102,Ottenhöfen im Schwarzwald,3 -  6 Jahre,124,65,59
False,8317102,Ottenhöfen im Schwarzwald,6 - 10 Jahre,163,77,86
False,8317102,Ottenhöfen im Schwarzwald,10 - 15 Jahre,222,116,106
False,8317102,Ottenhöfen im Schwarzwald,15 - 18 Jahre,130,65,65
False,8317102,Ottenhöfen im Schwarzwald,18 - 20 Jahre,75,34,41
False,8317102,Ottenhöfen im Schwarzwald,20 - 25 Jahre,166,96,70
False,8317102,Ottenhöfen im Schwarzwald,25 - 30 Jahre,153,74,79
False,8317102,Ottenhöfen im Schwarzwald,30 - 35 Jahre,282,145,137
False,8317102,Ottenhöfen im Schwarzwald,35 - 40 Jahre,275,142,133
False,8317102,Ottenhöfen im Schwarzwald,40 - 45 Jahre,212,114,98
False,8317102,Ottenhöfen im Schwarzwald,45 - 50 Jahre,172,92,80
False,8317102,Ottenhöfen im Schwarzwald,50 - 55 Jahre,166,80,86
False,8317102,Ottenhöfen im Schwarzwald,55 - 60 Jahre,155,77,78
False,8317102,Ottenhöfen im Schwarzwald,60 - 65 Jahre,237,114,123
False,8317102,Ottenhöfen im Schwarzwald,65 - 75 Jahre,325,146,179
False,8317102,Ottenhöfen im Schwarzwald,75 und mehr Jahre,274,86,188
False,8317102,Ottenhöfen im Schwarzwald,Insgesamt,3245,1579,1666
False,8317110,"Renchen, Stadt",unter 3 Jahre,209,102,107
False,8317110,"Renchen, Stadt",3 -  6 Jahre,260,140,120
False,8317110,"Renchen, Stadt",6 - 10 Jahre,377,177,200
False,8317110,"Renchen, Stadt",10 - 15 Jahre,522,255,267
False,8317110,"Renchen, Stadt",15 - 18 Jahre,260,138,122
False,8317110,"Renchen, Stadt",18 - 20 Jahre,149,77,72
False,8317110,"Renchen, Stadt",20 - 25 Jahre,339,182,157
False,8317110,"Renchen, Stadt",25 - 30 Jahre,414,199,215
False,8317110,"Renchen, Stadt",30 - 35 Jahre,584,284,300
False,8317110,"Renchen, Stadt",35 - 40 Jahre,677,350,327
False,8317110,"Renchen, Stadt",40 - 45 Jahre,557,277,280
False,8317110,"Renchen, Stadt",45 - 50 Jahre,492,260,232
False,8317110,"Renchen, Stadt",50 - 55 Jahre,350,190,160
False,8317110,"Renchen, Stadt",55 - 60 Jahre,311,162,149
False,8317110,"Renchen, Stadt",60 - 65 Jahre,426,196,230
False,8317110,"Renchen, Stadt",65 - 75 Jahre,613,292,321
False,8317110,"Renchen, Stadt",75 und mehr Jahre,416,121,295
False,8317110,"Renchen, Stadt",Insgesamt,6956,3402,3554
False,8317113,Ringsheim,unter 3 Jahre,74,46,28
False,8317113,Ringsheim,3 -  6 Jahre,73,43,30
False,8317113,Ringsheim,6 - 10 Jahre,85,40,45
False,8317113,Ringsheim,10 - 15 Jahre,107,47,60
False,8317113,Ringsheim,15 - 18 Jahre,66,29,37
False,8317113,Ringsheim,18 - 20 Jahre,52,24,28
False,8317113,Ringsheim,20 - 25 Jahre,116,54,62
False,8317113,Ringsheim,25 - 30 Jahre,118,58,60
False,8317113,Ringsheim,30 - 35 Jahre,181,101,80
False,8317113,Ringsheim,35 - 40 Jahre,184,96,88
False,8317113,Ringsheim,40 - 45 Jahre,157,81,76
False,8317113,Ringsheim,45 - 50 Jahre,149,80,69
False,8317113,Ringsheim,50 - 55 Jahre,119,59,60
False,8317113,Ringsheim,55 - 60 Jahre,96,51,45
False,8317113,Ringsheim,60 - 65 Jahre,171,87,84
False,8317113,Ringsheim,65 - 75 Jahre,196,95,101
False,8317113,Ringsheim,75 und mehr Jahre,136,45,91
False,8317113,Ringsheim,Insgesamt,2080,1036,1044
False,8317114,Rust,unter 3 Jahre,118,62,56
False,8317114,Rust,3 -  6 Jahre,130,68,62
False,8317114,Rust,6 - 10 Jahre,163,81,82
False,8317114,Rust,10 - 15 Jahre,235,122,113
False,8317114,Rust,15 - 18 Jahre,133,70,63
False,8317114,Rust,18 - 20 Jahre,87,41,46
False,8317114,Rust,20 - 25 Jahre,213,99,114
False,8317114,Rust,25 - 30 Jahre,221,112,109
False,8317114,Rust,30 - 35 Jahre,308,147,161
False,8317114,Rust,35 - 40 Jahre,305,143,162
False,8317114,Rust,40 - 45 Jahre,282,152,130
False,8317114,Rust,45 - 50 Jahre,221,121,100
False,8317114,Rust,50 - 55 Jahre,215,123,92
False,8317114,Rust,55 - 60 Jahre,156,86,70
False,8317114,Rust,60 - 65 Jahre,179,89,90
False,8317114,Rust,65 - 75 Jahre,279,123,156
False,8317114,Rust,75 und mehr Jahre,146,35,111
False,8317114,Rust,Insgesamt,3391,1674,1717
False,8317116,Sasbach,unter 3 Jahre,176,89,87
False,8317116,Sasbach,3 -  6 Jahre,168,77,91
False,8317116,Sasbach,6 - 10 Jahre,253,127,126
False,8317116,Sasbach,10 - 15 Jahre,344,186,158
False,8317116,Sasbach,15 - 18 Jahre,188,95,93
False,8317116,Sasbach,18 - 20 Jahre,139,73,66
False,8317116,Sasbach,20 - 25 Jahre,325,184,141
False,8317116,Sasbach,25 - 30 Jahre,361,196,165
False,8317116,Sasbach,30 - 35 Jahre,485,288,197
False,8317116,Sasbach,35 - 40 Jahre,485,270,215
False,8317116,Sasbach,40 - 45 Jahre,392,201,191
False,8317116,Sasbach,45 - 50 Jahre,360,180,180
False,8317116,Sasbach,50 - 55 Jahre,316,159,157
False,8317116,Sasbach,55 - 60 Jahre,258,118,140
False,8317116,Sasbach,60 - 65 Jahre,315,160,155
False,8317116,Sasbach,65 - 75 Jahre,515,218,297
False,8317116,Sasbach,75 und mehr Jahre,363,80,283
False,8317116,Sasbach,Insgesamt,5443,2701,2742
False,8317118,Sasbachwalden,unter 3 Jahre,60,32,28
False,8317118,Sasbachwalden,3 -  6 Jahre,77,38,39
False,8317118,Sasbachwalden,6 - 10 Jahre,99,52,47
False,8317118,Sasbachwalden,10 - 15 Jahre,116,62,54
False,8317118,Sasbachwalden,15 - 18 Jahre,61,27,34
False,8317118,Sasbachwalden,18 - 20 Jahre,35,21,14
False,8317118,Sasbachwalden,20 - 25 Jahre,115,50,65
False,8317118,Sasbachwalden,25 - 30 Jahre,130,70,60
False,8317118,Sasbachwalden,30 - 35 Jahre,206,109,97
False,8317118,Sasbachwalden,35 - 40 Jahre,207,106,101
False,8317118,Sasbachwalden,40 - 45 Jahre,194,103,91
False,8317118,Sasbachwalden,45 - 50 Jahre,166,84,82
False,8317118,Sasbachwalden,50 - 55 Jahre,156,74,82
False,8317118,Sasbachwalden,55 - 60 Jahre,130,58,72
False,8317118,Sasbachwalden,60 - 65 Jahre,209,100,109
False,8317118,Sasbachwalden,65 - 75 Jahre,246,117,129
False,8317118,Sasbachwalden,75 und mehr Jahre,220,64,156
False,8317118,Sasbachwalden,Insgesamt,2427,1167,1260
False,8317121,Schuttertal,unter 3 Jahre,141,68,73
False,8317121,Schuttertal,3 -  6 Jahre,146,86,60
False,8317121,Schuttertal,6 - 10 Jahre,158,89,69
False,8317121,Schuttertal,10 - 15 Jahre,259,131,128
False,8317121,Schuttertal,15 - 18 Jahre,113,59,54
False,8317121,Schuttertal,18 - 20 Jahre,77,51,26
False,8317121,Schuttertal,20 - 25 Jahre,167,88,79
False,8317121,Schuttertal,25 - 30 Jahre,186,100,86
False,8317121,Schuttertal,30 - 35 Jahre,263,136,127
False,8317121,Schuttertal,35 - 40 Jahre,332,186,146
False,8317121,Schuttertal,40 - 45 Jahre,262,136,126
False,8317121,Schuttertal,45 - 50 Jahre,196,109,87
False,8317121,Schuttertal,50 - 55 Jahre,157,93,64
False,8317121,Schuttertal,55 - 60 Jahre,137,64,73
False,8317121,Schuttertal,60 - 65 Jahre,205,93,112
False,8317121,Schuttertal,65 - 75 Jahre,326,155,171
False,8317121,Schuttertal,75 und mehr Jahre,188,53,135
False,8317121,Schuttertal,Insgesamt,3313,1697,1616
False,8317122,Schutterwald,unter 3 Jahre,203,113,90
False,8317122,Schutterwald,3 -  6 Jahre,236,115,121
False,8317122,Schutterwald,6 - 10 Jahre,348,197,151
False,8317122,Schutterwald,10 - 15 Jahre,443,256,187
False,8317122,Schutterwald,15 - 18 Jahre,224,126,98
False,8317122,Schutterwald,18 - 20 Jahre,151,78,73
False,8317122,Schutterwald,20 - 25 Jahre,283,154,129
False,8317122,Schutterwald,25 - 30 Jahre,347,179,168
False,8317122,Schutterwald,30 - 35 Jahre,562,286,276
False,8317122,Schutterwald,35 - 40 Jahre,632,318,314
False,8317122,Schutterwald,40 - 45 Jahre,573,312,261
False,8317122,Schutterwald,45 - 50 Jahre,504,243,261
False,8317122,Schutterwald,50 - 55 Jahre,445,234,211
False,8317122,Schutterwald,55 - 60 Jahre,383,191,192
False,8317122,Schutterwald,60 - 65 Jahre,523,263,260
False,8317122,Schutterwald,65 - 75 Jahre,628,302,326
False,8317122,Schutterwald,75 und mehr Jahre,456,149,307
False,8317122,Schutterwald,Insgesamt,6941,3516,3425
False,8317126,Seebach,unter 3 Jahre,50,28,22
False,8317126,Seebach,3 -  6 Jahre,62,37,25
False,8317126,Seebach,6 - 10 Jahre,91,47,44
False,8317126,Seebach,10 - 15 Jahre,84,37,47
False,8317126,Seebach,15 - 18 Jahre,55,29,26
False,8317126,Seebach,18 - 20 Jahre,38,16,22
False,8317126,Seebach,20 - 25 Jahre,76,35,41
False,8317126,Seebach,25 - 30 Jahre,96,57,39
False,8317126,Seebach,30 - 35 Jahre,137,74,63
False,8317126,Seebach,35 - 40 Jahre,134,62,72
False,8317126,Seebach,40 - 45 Jahre,114,67,47
False,8317126,Seebach,45 - 50 Jahre,88,50,38
False,8317126,Seebach,50 - 55 Jahre,67,26,41
False,8317126,Seebach,55 - 60 Jahre,51,28,23
False,8317126,Seebach,60 - 65 Jahre,109,51,58
False,8317126,Seebach,65 - 75 Jahre,149,67,82
False,8317126,Seebach,75 und mehr Jahre,84,30,54
False,8317126,Seebach,Insgesamt,1485,741,744
False,8317127,Seelbach,unter 3 Jahre,129,70,59
False,8317127,Seelbach,3 -  6 Jahre,168,85,83
False,8317127,Seelbach,6 - 10 Jahre,242,106,136
False,8317127,Seelbach,10 - 15 Jahre,343,177,166
False,8317127,Seelbach,15 - 18 Jahre,188,103,85
False,8317127,Seelbach,18 - 20 Jahre,116,50,66
False,8317127,Seelbach,20 - 25 Jahre,284,149,135
False,8317127,Seelbach,25 - 30 Jahre,250,142,108
False,8317127,Seelbach,30 - 35 Jahre,345,174,171
False,8317127,Seelbach,35 - 40 Jahre,492,250,242
False,8317127,Seelbach,40 - 45 Jahre,409,210,199
False,8317127,Seelbach,45 - 50 Jahre,339,172,167
False,8317127,Seelbach,50 - 55 Jahre,336,176,160
False,8317127,Seelbach,55 - 60 Jahre,290,162,128
False,8317127,Seelbach,60 - 65 Jahre,396,196,200
False,8317127,Seelbach,65 - 75 Jahre,489,223,266
False,8317127,Seelbach,75 und mehr Jahre,413,132,281
False,8317127,Seelbach,Insgesamt,5229,2577,2652
False,8317129,Steinach,unter 3 Jahre,131,70,61
False,8317129,Steinach,3 -  6 Jahre,161,81,80
False,8317129,Steinach,6 - 10 Jahre,199,100,99
False,8317129,Steinach,10 - 15 Jahre,281,142,139
False,8317129,Steinach,15 - 18 Jahre,136,69,67
False,8317129,Steinach,18 - 20 Jahre,90,47,43
False,8317129,Steinach,20 - 25 Jahre,209,117,92
False,8317129,Steinach,25 - 30 Jahre,240,126,114
False,8317129,Steinach,30 - 35 Jahre,311,173,138
False,8317129,Steinach,35 - 40 Jahre,372,198,174
False,8317129,Steinach,40 - 45 Jahre,309,169,140
False,8317129,Steinach,45 - 50 Jahre,276,141,135
False,8317129,Steinach,50 - 55 Jahre,166,93,73
False,8317129,Steinach,55 - 60 Jahre,160,83,77
False,8317129,Steinach,60 - 65 Jahre,254,128,126
False,8317129,Steinach,65 - 75 Jahre,350,166,184
False,8317129,Steinach,75 und mehr Jahre,250,72,178
False,8317129,Steinach,Insgesamt,3895,1975,1920
False,8317141,Willstätt,unter 3 Jahre,315,159,156
False,8317141,Willstätt,3 -  6 Jahre,321,174,147
False,8317141,Willstätt,6 - 10 Jahre,435,232,203
False,8317141,Willstätt,10 - 15 Jahre,606,315,291
False,8317141,Willstätt,15 - 18 Jahre,328,153,175
False,8317141,Willstätt,18 - 20 Jahre,203,97,106
False,8317141,Willstätt,20 - 25 Jahre,448,212,236
False,8317141,Willstätt,25 - 30 Jahre,539,271,268
False,8317141,Willstätt,30 - 35 Jahre,757,377,380
False,8317141,Willstätt,35 - 40 Jahre,844,449,395
False,8317141,Willstätt,40 - 45 Jahre,756,381,375
False,8317141,Willstätt,45 - 50 Jahre,691,351,340
False,8317141,Willstätt,50 - 55 Jahre,539,278,261
False,8317141,Willstätt,55 - 60 Jahre,450,223,227
False,8317141,Willstätt,60 - 65 Jahre,546,278,268
False,8317141,Willstätt,65 - 75 Jahre,755,371,384
False,8317141,Willstätt,75 und mehr Jahre,458,152,306
False,8317141,Willstätt,Insgesamt,8991,4473,4518
False,8317145,"Wolfach, Stadt",unter 3 Jahre,149,72,77
False,8317145,"Wolfach, Stadt",3 -  6 Jahre,177,104,73
False,8317145,"Wolfach, Stadt",6 - 10 Jahre,259,138,121
False,8317145,"Wolfach, Stadt",10 - 15 Jahre,314,154,160
False,8317145,"Wolfach, Stadt",15 - 18 Jahre,162,83,79
False,8317145,"Wolfach, Stadt",18 - 20 Jahre,138,77,61
False,8317145,"Wolfach, Stadt",20 - 25 Jahre,325,152,173
False,8317145,"Wolfach, Stadt",25 - 30 Jahre,352,203,149
False,8317145,"Wolfach, Stadt",30 - 35 Jahre,446,233,213
False,8317145,"Wolfach, Stadt",35 - 40 Jahre,544,313,231
False,8317145,"Wolfach, Stadt",40 - 45 Jahre,407,207,200
False,8317145,"Wolfach, Stadt",45 - 50 Jahre,435,215,220
False,8317145,"Wolfach, Stadt",50 - 55 Jahre,342,181,161
False,8317145,"Wolfach, Stadt",55 - 60 Jahre,335,162,173
False,8317145,"Wolfach, Stadt",60 - 65 Jahre,434,223,211
False,8317145,"Wolfach, Stadt",65 - 75 Jahre,613,279,334
False,8317145,"Wolfach, Stadt",75 und mehr Jahre,526,135,391
False,8317145,"Wolfach, Stadt",Insgesamt,5958,2931,3027
False,8317146,"Zell am Harmersbach, Stadt",unter 3 Jahre,253,125,128
False,8317146,"Zell am Harmersbach, Stadt",3 -  6 Jahre,252,132,120
False,8317146,"Zell am Harmersbach, Stadt",6 - 10 Jahre,380,191,189
False,8317146,"Zell am Harmersbach, Stadt",10 - 15 Jahre,503,259,244
False,8317146,"Zell am Harmersbach, Stadt",15 - 18 Jahre,276,136,140
False,8317146,"Zell am Harmersbach, Stadt",18 - 20 Jahre,207,107,100
False,8317146,"Zell am Harmersbach, Stadt",20 - 25 Jahre,432,225,207
False,8317146,"Zell am Harmersbach, Stadt",25 - 30 Jahre,503,257,246
False,8317146,"Zell am Harmersbach, Stadt",30 - 35 Jahre,591,312,279
False,8317146,"Zell am Harmersbach, Stadt",35 - 40 Jahre,708,357,351
False,8317146,"Zell am Harmersbach, Stadt",40 - 45 Jahre,594,288,306
False,8317146,"Zell am Harmersbach, Stadt",45 - 50 Jahre,575,295,280
False,8317146,"Zell am Harmersbach, Stadt",50 - 55 Jahre,439,223,216
False,8317146,"Zell am Harmersbach, Stadt",55 - 60 Jahre,427,208,219
False,8317146,"Zell am Harmersbach, Stadt",60 - 65 Jahre,505,246,259
False,8317146,"Zell am Harmersbach, Stadt",65 - 75 Jahre,675,328,347
False,8317146,"Zell am Harmersbach, Stadt",75 und mehr Jahre,639,191,448
False,8317146,"Zell am Harmersbach, Stadt",Insgesamt,7959,3880,4079
False,8317150,Schwanau,unter 3 Jahre,229,134,95
False,8317150,Schwanau,3 -  6 Jahre,242,117,125
False,8317150,Schwanau,6 - 10 Jahre,300,145,155
False,8317150,Schwanau,10 - 15 Jahre,418,191,227
False,8317150,Schwanau,15 - 18 Jahre,241,121,120
False,8317150,Schwanau,18 - 20 Jahre,137,70,67
False,8317150,Schwanau,20 - 25 Jahre,321,172,149
False,8317150,Schwanau,25 - 30 Jahre,354,164,190
False,8317150,Schwanau,30 - 35 Jahre,570,299,271
False,8317150,Schwanau,35 - 40 Jahre,641,327,314
False,8317150,Schwanau,40 - 45 Jahre,491,246,245
False,8317150,Schwanau,45 - 50 Jahre,438,225,213
False,8317150,Schwanau,50 - 55 Jahre,362,193,169
False,8317150,Schwanau,55 - 60 Jahre,299,146,153
False,8317150,Schwanau,60 - 65 Jahre,438,213,225
False,8317150,Schwanau,65 - 75 Jahre,607,268,339
False,8317150,Schwanau,75 und mehr Jahre,505,104,401
False,8317150,Schwanau,Insgesamt,6593,3135,3458
False,8317151,Neuried,unter 3 Jahre,309,159,150
False,8317151,Neuried,3 -  6 Jahre,331,178,153
False,8317151,Neuried,6 - 10 Jahre,502,266,236
False,8317151,Neuried,10 - 15 Jahre,610,309,301
False,8317151,Neuried,15 - 18 Jahre,329,171,158
False,8317151,Neuried,18 - 20 Jahre,211,100,111
False,8317151,Neuried,20 - 25 Jahre,456,225,231
False,8317151,Neuried,25 - 30 Jahre,488,229,259
False,8317151,Neuried,30 - 35 Jahre,736,346,390
False,8317151,Neuried,35 - 40 Jahre,844,436,408
False,8317151,Neuried,40 - 45 Jahre,792,405,387
False,8317151,Neuried,45 - 50 Jahre,615,306,309
False,8317151,Neuried,50 - 55 Jahre,543,281,262
False,8317151,Neuried,55 - 60 Jahre,399,199,200
False,8317151,Neuried,60 - 65 Jahre,566,291,275
False,8317151,Neuried,65 - 75 Jahre,790,345,445
False,8317151,Neuried,75 und mehr Jahre,550,169,381
False,8317151,Neuried,Insgesamt,9071,4415,4656
False,8317152,Kappel-Grafenhausen,unter 3 Jahre,173,83,90
False,8317152,Kappel-Grafenhausen,3 -  6 Jahre,184,94,90
False,8317152,Kappel-Grafenhausen,6 - 10 Jahre,297,149,148
False,8317152,Kappel-Grafenhausen,10 - 15 Jahre,321,152,169
False,8317152,Kappel-Grafenhausen,15 - 18 Jahre,177,95,82
False,8317152,Kappel-Grafenhausen,18 - 20 Jahre,100,55,45
False,8317152,Kappel-Grafenhausen,20 - 25 Jahre,258,150,108
False,8317152,Kappel-Grafenhausen,25 - 30 Jahre,292,143,149
False,8317152,Kappel-Grafenhausen,30 - 35 Jahre,406,191,215
False,8317152,Kappel-Grafenhausen,35 - 40 Jahre,473,243,230
False,8317152,Kappel-Grafenhausen,40 - 45 Jahre,379,205,174
False,8317152,Kappel-Grafenhausen,45 - 50 Jahre,323,175,148
False,8317152,Kappel-Grafenhausen,50 - 55 Jahre,255,122,133
False,8317152,Kappel-Grafenhausen,55 - 60 Jahre,206,108,98
False,8317152,Kappel-Grafenhausen,60 - 65 Jahre,276,134,142
False,8317152,Kappel-Grafenhausen,65 - 75 Jahre,337,164,173
False,8317152,Kappel-Grafenhausen,75 und mehr Jahre,252,87,165
False,8317152,Kappel-Grafenhausen,Insgesamt,4709,2350,2359
False,8317153,"Rheinau, Stadt",unter 3 Jahre,299,151,148
False,8317153,"Rheinau, Stadt",3 -  6 Jahre,397,191,206
False,8317153,"Rheinau, Stadt",6 - 10 Jahre,555,275,280
False,8317153,"Rheinau, Stadt",10 - 15 Jahre,665,341,324
False,8317153,"Rheinau, Stadt",15 - 18 Jahre,366,201,165
False,8317153,"Rheinau, Stadt",18 - 20 Jahre,274,144,130
False,8317153,"Rheinau, Stadt",20 - 25 Jahre,497,264,233
False,8317153,"Rheinau, Stadt",25 - 30 Jahre,546,286,260
False,8317153,"Rheinau, Stadt",30 - 35 Jahre,812,403,409
False,8317153,"Rheinau, Stadt",35 - 40 Jahre,991,484,507
False,8317153,"Rheinau, Stadt",40 - 45 Jahre,949,494,455
False,8317153,"Rheinau, Stadt",45 - 50 Jahre,788,408,380
False,8317153,"Rheinau, Stadt",50 - 55 Jahre,650,338,312
False,8317153,"Rheinau, Stadt",55 - 60 Jahre,527,277,250
False,8317153,"Rheinau, Stadt",60 - 65 Jahre,680,346,334
False,8317153,"Rheinau, Stadt",65 - 75 Jahre,958,446,512
False,8317153,"Rheinau, Stadt",75 und mehr Jahre,687,230,457
False,8317153,"Rheinau, Stadt",Insgesamt,10641,5279,5362
False,8325,Landkreis Rottweil,unter 3 Jahre,4506,2350,2156
False,8325,Landkreis Rottweil,3 -  6 Jahre,5012,2506,2506
False,8325,Landkreis Rottweil,6 - 10 Jahre,7187,3722,3465
False,8325,Landkreis Rottweil,10 - 15 Jahre,9182,4596,4586
False,8325,Landkreis Rottweil,15 - 18 Jahre,5106,2630,2476
False,8325,Landkreis Rottweil,18 - 20 Jahre,3346,1706,1640
False,8325,Landkreis Rottweil,20 - 25 Jahre,7388,3877,3511
False,8325,Landkreis Rottweil,25 - 30 Jahre,7992,4156,3836
False,8325,Landkreis Rottweil,30 - 35 Jahre,11190,5796,5394
False,8325,Landkreis Rottweil,35 - 40 Jahre,11944,6184,5760
False,8325,Landkreis Rottweil,40 - 45 Jahre,10493,5413,5080
False,8325,Landkreis Rottweil,45 - 50 Jahre,8967,4512,4455
False,8325,Landkreis Rottweil,50 - 55 Jahre,7866,3984,3882
False,8325,Landkreis Rottweil,55 - 60 Jahre,7669,3924,3745
False,8325,Landkreis Rottweil,60 - 65 Jahre,9672,4784,4888
False,8325,Landkreis Rottweil,65 - 75 Jahre,13069,5948,7121
False,8325,Landkreis Rottweil,75 und mehr Jahre,10284,3019,7265
False,8325,Landkreis Rottweil,Insgesamt,140873,69107,71766
False,8325001,Aichhalden,unter 3 Jahre,147,82,65
False,8325001,Aichhalden,3 -  6 Jahre,156,92,64
False,8325001,Aichhalden,6 - 10 Jahre,254,132,122
False,8325001,Aichhalden,10 - 15 Jahre,261,139,122
False,8325001,Aichhalden,15 - 18 Jahre,178,107,71
False,8325001,Aichhalden,18 - 20 Jahre,94,54,40
False,8325001,Aichhalden,20 - 25 Jahre,233,123,110
False,8325001,Aichhalden,25 - 30 Jahre,211,120,91
False,8325001,Aichhalden,30 - 35 Jahre,324,166,158
False,8325001,Aichhalden,35 - 40 Jahre,371,177,194
False,8325001,Aichhalden,40 - 45 Jahre,336,173,163
False,8325001,Aichhalden,45 - 50 Jahre,244,128,116
False,8325001,Aichhalden,50 - 55 Jahre,237,121,116
False,8325001,Aichhalden,55 - 60 Jahre,223,111,112
False,8325001,Aichhalden,60 - 65 Jahre,304,160,144
False,8325001,Aichhalden,65 - 75 Jahre,367,168,199
False,8325001,Aichhalden,75 und mehr Jahre,242,66,176
False,8325001,Aichhalden,Insgesamt,4182,2119,2063
False,8325009,Bösingen,unter 3 Jahre,144,73,71
False,8325009,Bösingen,3 -  6 Jahre,149,68,81
False,8325009,Bösingen,6 - 10 Jahre,216,111,105
False,8325009,Bösingen,10 - 15 Jahre,263,129,134
False,8325009,Bösingen,15 - 18 Jahre,129,66,63
False,8325009,Bösingen,18 - 20 Jahre,81,41,40
False,8325009,Bösingen,20 - 25 Jahre,185,103,82
False,8325009,Bösingen,25 - 30 Jahre,233,126,107
False,8325009,Bösingen,30 - 35 Jahre,329,177,152
False,8325009,Bösingen,35 - 40 Jahre,301,161,140
False,8325009,Bösingen,40 - 45 Jahre,270,140,130
False,8325009,Bösingen,45 - 50 Jahre,202,109,93
False,8325009,Bösingen,50 - 55 Jahre,167,88,79
False,8325009,Bösingen,55 - 60 Jahre,162,86,76
False,8325009,Bösingen,60 - 65 Jahre,182,86,96
False,8325009,Bösingen,65 - 75 Jahre,266,126,140
False,8325009,Bösingen,75 und mehr Jahre,141,53,88
False,8325009,Bösingen,Insgesamt,3420,1743,1677
False,8325011,Dietingen,unter 3 Jahre,151,69,82
False,8325011,Dietingen,3 -  6 Jahre,157,65,92
False,8325011,Dietingen,6 - 10 Jahre,220,109,111
False,8325011,Dietingen,10 - 15 Jahre,256,124,132
False,8325011,Dietingen,15 - 18 Jahre,135,63,72
False,8325011,Dietingen,18 - 20 Jahre,83,39,44
False,8325011,Dietingen,20 - 25 Jahre,197,94,103
False,8325011,Dietingen,25 - 30 Jahre,221,108,113
False,8325011,Dietingen,30 - 35 Jahre,341,173,168
False,8325011,Dietingen,35 - 40 Jahre,374,202,172
False,8325011,Dietingen,40 - 45 Jahre,297,151,146
False,8325011,Dietingen,45 - 50 Jahre,227,123,104
False,8325011,Dietingen,50 - 55 Jahre,205,97,108
False,8325011,Dietingen,55 - 60 Jahre,197,98,99
False,8325011,Dietingen,60 - 65 Jahre,269,137,132
False,8325011,Dietingen,65 - 75 Jahre,391,191,200
False,8325011,Dietingen,75 und mehr Jahre,206,73,133
False,8325011,Dietingen,Insgesamt,3927,1916,2011
False,8325012,"Dornhan, Stadt",unter 3 Jahre,195,101,94
False,8325012,"Dornhan, Stadt",3 -  6 Jahre,231,102,129
False,8325012,"Dornhan, Stadt",6 - 10 Jahre,306,158,148
False,8325012,"Dornhan, Stadt",10 - 15 Jahre,439,235,204
False,8325012,"Dornhan, Stadt",15 - 18 Jahre,228,133,95
False,8325012,"Dornhan, Stadt",18 - 20 Jahre,129,71,58
False,8325012,"Dornhan, Stadt",20 - 25 Jahre,314,170,144
False,8325012,"Dornhan, Stadt",25 - 30 Jahre,348,189,159
False,8325012,"Dornhan, Stadt",30 - 35 Jahre,421,220,201
False,8325012,"Dornhan, Stadt",35 - 40 Jahre,596,313,283
False,8325012,"Dornhan, Stadt",40 - 45 Jahre,433,210,223
False,8325012,"Dornhan, Stadt",45 - 50 Jahre,369,194,175
False,8325012,"Dornhan, Stadt",50 - 55 Jahre,350,193,157
False,8325012,"Dornhan, Stadt",55 - 60 Jahre,309,159,150
False,8325012,"Dornhan, Stadt",60 - 65 Jahre,445,221,224
False,8325012,"Dornhan, Stadt",65 - 75 Jahre,562,262,300
False,8325012,"Dornhan, Stadt",75 und mehr Jahre,424,122,302
False,8325012,"Dornhan, Stadt",Insgesamt,6099,3053,3046
False,8325014,Dunningen,unter 3 Jahre,192,103,89
False,8325014,Dunningen,3 -  6 Jahre,240,118,122
False,8325014,Dunningen,6 - 10 Jahre,333,164,169
False,8325014,Dunningen,10 - 15 Jahre,459,243,216
False,8325014,Dunningen,15 - 18 Jahre,249,122,127
False,8325014,Dunningen,18 - 20 Jahre,151,76,75
False,8325014,Dunningen,20 - 25 Jahre,304,157,147
False,8325014,Dunningen,25 - 30 Jahre,333,165,168
False,8325014,Dunningen,30 - 35 Jahre,464,232,232
False,8325014,Dunningen,35 - 40 Jahre,500,259,241
False,8325014,Dunningen,40 - 45 Jahre,479,263,216
False,8325014,Dunningen,45 - 50 Jahre,425,220,205
False,8325014,Dunningen,50 - 55 Jahre,288,152,136
False,8325014,Dunningen,55 - 60 Jahre,241,128,113
False,8325014,Dunningen,60 - 65 Jahre,371,193,178
False,8325014,Dunningen,65 - 75 Jahre,482,221,261
False,8325014,Dunningen,75 und mehr Jahre,310,92,218
False,8325014,Dunningen,Insgesamt,5821,2908,2913
False,8325015,Epfendorf,unter 3 Jahre,131,59,72
False,8325015,Epfendorf,3 -  6 Jahre,133,64,69
False,8325015,Epfendorf,6 - 10 Jahre,177,97,80
False,8325015,Epfendorf,10 - 15 Jahre,239,105,134
False,8325015,Epfendorf,15 - 18 Jahre,110,55,55
False,8325015,Epfendorf,18 - 20 Jahre,93,49,44
False,8325015,Epfendorf,20 - 25 Jahre,151,73,78
False,8325015,Epfendorf,25 - 30 Jahre,185,89,96
False,8325015,Epfendorf,30 - 35 Jahre,298,155,143
False,8325015,Epfendorf,35 - 40 Jahre,329,157,172
False,8325015,Epfendorf,40 - 45 Jahre,309,170,139
False,8325015,Epfendorf,45 - 50 Jahre,198,103,95
False,8325015,Epfendorf,50 - 55 Jahre,191,107,84
False,8325015,Epfendorf,55 - 60 Jahre,161,80,81
False,8325015,Epfendorf,60 - 65 Jahre,243,123,120
False,8325015,Epfendorf,65 - 75 Jahre,313,123,190
False,8325015,Epfendorf,75 und mehr Jahre,218,65,153
False,8325015,Epfendorf,Insgesamt,3479,1674,1805
False,8325024,Hardt,unter 3 Jahre,67,33,34
False,8325024,Hardt,3 -  6 Jahre,111,52,59
False,8325024,Hardt,6 - 10 Jahre,143,71,72
False,8325024,Hardt,10 - 15 Jahre,178,96,82
False,8325024,Hardt,15 - 18 Jahre,102,52,50
False,8325024,Hardt,18 - 20 Jahre,62,38,24
False,8325024,Hardt,20 - 25 Jahre,120,67,53
False,8325024,Hardt,25 - 30 Jahre,143,67,76
False,8325024,Hardt,30 - 35 Jahre,202,102,100
False,8325024,Hardt,35 - 40 Jahre,205,105,100
False,8325024,Hardt,40 - 45 Jahre,178,81,97
False,8325024,Hardt,45 - 50 Jahre,195,104,91
False,8325024,Hardt,50 - 55 Jahre,138,65,73
False,8325024,Hardt,55 - 60 Jahre,155,73,82
False,8325024,Hardt,60 - 65 Jahre,187,99,88
False,8325024,Hardt,65 - 75 Jahre,184,98,86
False,8325024,Hardt,75 und mehr Jahre,127,38,89
False,8325024,Hardt,Insgesamt,2497,1241,1256
False,8325036,Lauterbach,unter 3 Jahre,91,51,40
False,8325036,Lauterbach,3 -  6 Jahre,120,65,55
False,8325036,Lauterbach,6 - 10 Jahre,201,107,94
False,8325036,Lauterbach,10 - 15 Jahre,185,100,85
False,8325036,Lauterbach,15 - 18 Jahre,99,55,44
False,8325036,Lauterbach,18 - 20 Jahre,64,35,29
False,8325036,Lauterbach,20 - 25 Jahre,141,78,63
False,8325036,Lauterbach,25 - 30 Jahre,189,93,96
False,8325036,Lauterbach,30 - 35 Jahre,253,136,117
False,8325036,Lauterbach,35 - 40 Jahre,263,134,129
False,8325036,Lauterbach,40 - 45 Jahre,224,116,108
False,8325036,Lauterbach,45 - 50 Jahre,165,74,91
False,8325036,Lauterbach,50 - 55 Jahre,166,89,77
False,8325036,Lauterbach,55 - 60 Jahre,202,99,103
False,8325036,Lauterbach,60 - 65 Jahre,258,125,133
False,8325036,Lauterbach,65 - 75 Jahre,392,178,214
False,8325036,Lauterbach,75 und mehr Jahre,240,60,180
False,8325036,Lauterbach,Insgesamt,3253,1595,1658
False,8325045,"Oberndorf am Neckar, Stadt",unter 3 Jahre,481,258,223
False,8325045,"Oberndorf am Neckar, Stadt",3 -  6 Jahre,501,272,229
False,8325045,"Oberndorf am Neckar, Stadt",6 - 10 Jahre,648,325,323
False,8325045,"Oberndorf am Neckar, Stadt",10 - 15 Jahre,841,390,451
False,8325045,"Oberndorf am Neckar, Stadt",15 - 18 Jahre,512,255,257
False,8325045,"Oberndorf am Neckar, Stadt",18 - 20 Jahre,333,169,164
False,8325045,"Oberndorf am Neckar, Stadt",20 - 25 Jahre,732,389,343
False,8325045,"Oberndorf am Neckar, Stadt",25 - 30 Jahre,791,403,388
False,8325045,"Oberndorf am Neckar, Stadt",30 - 35 Jahre,1175,622,553
False,8325045,"Oberndorf am Neckar, Stadt",35 - 40 Jahre,1226,662,564
False,8325045,"Oberndorf am Neckar, Stadt",40 - 45 Jahre,995,543,452
False,8325045,"Oberndorf am Neckar, Stadt",45 - 50 Jahre,903,442,461
False,8325045,"Oberndorf am Neckar, Stadt",50 - 55 Jahre,876,421,455
False,8325045,"Oberndorf am Neckar, Stadt",55 - 60 Jahre,899,467,432
False,8325045,"Oberndorf am Neckar, Stadt",60 - 65 Jahre,1084,539,545
False,8325045,"Oberndorf am Neckar, Stadt",65 - 75 Jahre,1364,624,740
False,8325045,"Oberndorf am Neckar, Stadt",75 und mehr Jahre,1274,369,905
False,8325045,"Oberndorf am Neckar, Stadt",Insgesamt,14635,7150,7485
False,8325049,"Rottweil, Stadt",unter 3 Jahre,764,413,351
False,8325049,"Rottweil, Stadt",3 -  6 Jahre,794,377,417
False,8325049,"Rottweil, Stadt",6 - 10 Jahre,1126,583,543
False,8325049,"Rottweil, Stadt",10 - 15 Jahre,1498,738,760
False,8325049,"Rottweil, Stadt",15 - 18 Jahre,907,430,477
False,8325049,"Rottweil, Stadt",18 - 20 Jahre,613,301,312
False,8325049,"Rottweil, Stadt",20 - 25 Jahre,1443,758,685
False,8325049,"Rottweil, Stadt",25 - 30 Jahre,1503,777,726
False,8325049,"Rottweil, Stadt",30 - 35 Jahre,2043,1062,981
False,8325049,"Rottweil, Stadt",35 - 40 Jahre,2030,1028,1002
False,8325049,"Rottweil, Stadt",40 - 45 Jahre,1793,909,884
False,8325049,"Rottweil, Stadt",45 - 50 Jahre,1696,848,848
False,8325049,"Rottweil, Stadt",50 - 55 Jahre,1520,734,786
False,8325049,"Rottweil, Stadt",55 - 60 Jahre,1498,756,742
False,8325049,"Rottweil, Stadt",60 - 65 Jahre,1648,805,843
False,8325049,"Rottweil, Stadt",65 - 75 Jahre,2343,1017,1326
False,8325049,"Rottweil, Stadt",75 und mehr Jahre,2127,590,1537
False,8325049,"Rottweil, Stadt",Insgesamt,25346,12126,13220
False,8325050,Schenkenzell,unter 3 Jahre,59,28,31
False,8325050,Schenkenzell,3 -  6 Jahre,70,34,36
False,8325050,Schenkenzell,6 - 10 Jahre,124,62,62
False,8325050,Schenkenzell,10 - 15 Jahre,139,80,59
False,8325050,Schenkenzell,15 - 18 Jahre,75,48,27
False,8325050,Schenkenzell,18 - 20 Jahre,45,20,25
False,8325050,Schenkenzell,20 - 25 Jahre,62,36,26
False,8325050,Schenkenzell,25 - 30 Jahre,105,59,46
False,8325050,Schenkenzell,30 - 35 Jahre,148,68,80
False,8325050,Schenkenzell,35 - 40 Jahre,179,98,81
False,8325050,Schenkenzell,40 - 45 Jahre,141,78,63
False,8325050,Schenkenzell,45 - 50 Jahre,107,53,54
False,8325050,Schenkenzell,50 - 55 Jahre,84,47,37
False,8325050,Schenkenzell,55 - 60 Jahre,102,52,50
False,8325050,Schenkenzell,60 - 65 Jahre,147,67,80
False,8325050,Schenkenzell,65 - 75 Jahre,220,108,112
False,8325050,Schenkenzell,75 und mehr Jahre,156,50,106
False,8325050,Schenkenzell,Insgesamt,1963,988,975
False,8325051,"Schiltach, Stadt",unter 3 Jahre,119,58,61
False,8325051,"Schiltach, Stadt",3 -  6 Jahre,144,70,74
False,8325051,"Schiltach, Stadt",6 - 10 Jahre,207,105,102
False,8325051,"Schiltach, Stadt",10 - 15 Jahre,225,118,107
False,8325051,"Schiltach, Stadt",15 - 18 Jahre,143,65,78
False,8325051,"Schiltach, Stadt",18 - 20 Jahre,104,51,53
False,8325051,"Schiltach, Stadt",20 - 25 Jahre,204,98,106
False,8325051,"Schiltach, Stadt",25 - 30 Jahre,170,83,87
False,8325051,"Schiltach, Stadt",30 - 35 Jahre,288,148,140
False,8325051,"Schiltach, Stadt",35 - 40 Jahre,339,172,167
False,8325051,"Schiltach, Stadt",40 - 45 Jahre,315,167,148
False,8325051,"Schiltach, Stadt",45 - 50 Jahre,248,127,121
False,8325051,"Schiltach, Stadt",50 - 55 Jahre,187,107,80
False,8325051,"Schiltach, Stadt",55 - 60 Jahre,209,97,112
False,8325051,"Schiltach, Stadt",60 - 65 Jahre,304,149,155
False,8325051,"Schiltach, Stadt",65 - 75 Jahre,440,202,238
False,8325051,"Schiltach, Stadt",75 und mehr Jahre,370,116,254
False,8325051,"Schiltach, Stadt",Insgesamt,4016,1933,2083
False,8325053,"Schramberg, Stadt",unter 3 Jahre,659,335,324
False,8325053,"Schramberg, Stadt",3 -  6 Jahre,804,416,388
False,8325053,"Schramberg, Stadt",6 - 10 Jahre,1071,560,511
False,8325053,"Schramberg, Stadt",10 - 15 Jahre,1412,724,688
False,8325053,"Schramberg, Stadt",15 - 18 Jahre,800,438,362
False,8325053,"Schramberg, Stadt",18 - 20 Jahre,549,283,266
False,8325053,"Schramberg, Stadt",20 - 25 Jahre,1243,655,588
False,8325053,"Schramberg, Stadt",25 - 30 Jahre,1345,757,588
False,8325053,"Schramberg, Stadt",30 - 35 Jahre,1757,896,861
False,8325053,"Schramberg, Stadt",35 - 40 Jahre,1721,906,815
False,8325053,"Schramberg, Stadt",40 - 45 Jahre,1578,814,764
False,8325053,"Schramberg, Stadt",45 - 50 Jahre,1417,695,722
False,8325053,"Schramberg, Stadt",50 - 55 Jahre,1288,632,656
False,8325053,"Schramberg, Stadt",55 - 60 Jahre,1299,659,640
False,8325053,"Schramberg, Stadt",60 - 65 Jahre,1567,762,805
False,8325053,"Schramberg, Stadt",65 - 75 Jahre,2176,963,1213
False,8325053,"Schramberg, Stadt",75 und mehr Jahre,1980,598,1382
False,8325053,"Schramberg, Stadt",Insgesamt,22666,11093,11573
False,8325057,"Sulz am Neckar, Stadt",unter 3 Jahre,443,222,221
False,8325057,"Sulz am Neckar, Stadt",3 -  6 Jahre,470,232,238
False,8325057,"Sulz am Neckar, Stadt",6 - 10 Jahre,661,338,323
False,8325057,"Sulz am Neckar, Stadt",10 - 15 Jahre,871,409,462
False,8325057,"Sulz am Neckar, Stadt",15 - 18 Jahre,499,267,232
False,8325057,"Sulz am Neckar, Stadt",18 - 20 Jahre,279,138,141
False,8325057,"Sulz am Neckar, Stadt",20 - 25 Jahre,644,340,304
False,8325057,"Sulz am Neckar, Stadt",25 - 30 Jahre,687,351,336
False,8325057,"Sulz am Neckar, Stadt",30 - 35 Jahre,961,499,462
False,8325057,"Sulz am Neckar, Stadt",35 - 40 Jahre,1105,552,553
False,8325057,"Sulz am Neckar, Stadt",40 - 45 Jahre,979,504,475
False,8325057,"Sulz am Neckar, Stadt",45 - 50 Jahre,778,393,385
False,8325057,"Sulz am Neckar, Stadt",50 - 55 Jahre,653,342,311
False,8325057,"Sulz am Neckar, Stadt",55 - 60 Jahre,594,315,279
False,8325057,"Sulz am Neckar, Stadt",60 - 65 Jahre,809,411,398
False,8325057,"Sulz am Neckar, Stadt",65 - 75 Jahre,1259,574,685
False,8325057,"Sulz am Neckar, Stadt",75 und mehr Jahre,873,237,636
False,8325057,"Sulz am Neckar, Stadt",Insgesamt,12565,6124,6441
False,8325060,Villingendorf,unter 3 Jahre,113,60,53
False,8325060,Villingendorf,3 -  6 Jahre,125,62,63
False,8325060,Villingendorf,6 - 10 Jahre,180,93,87
False,8325060,Villingendorf,10 - 15 Jahre,230,118,112
False,8325060,Villingendorf,15 - 18 Jahre,94,44,50
False,8325060,Villingendorf,18 - 20 Jahre,84,44,40
False,8325060,Villingendorf,20 - 25 Jahre,158,74,84
False,8325060,Villingendorf,25 - 30 Jahre,197,94,103
False,8325060,Villingendorf,30 - 35 Jahre,283,140,143
False,8325060,Villingendorf,35 - 40 Jahre,280,142,138
False,8325060,Villingendorf,40 - 45 Jahre,231,108,123
False,8325060,Villingendorf,45 - 50 Jahre,208,104,104
False,8325060,Villingendorf,50 - 55 Jahre,164,89,75
False,8325060,Villingendorf,55 - 60 Jahre,158,82,76
False,8325060,Villingendorf,60 - 65 Jahre,183,88,95
False,8325060,Villingendorf,65 - 75 Jahre,250,115,135
False,8325060,Villingendorf,75 und mehr Jahre,166,60,106
False,8325060,Villingendorf,Insgesamt,3104,1517,1587
False,8325061,Vöhringen,unter 3 Jahre,151,87,64
False,8325061,Vöhringen,3 -  6 Jahre,140,71,69
False,8325061,Vöhringen,6 - 10 Jahre,221,120,101
False,8325061,Vöhringen,10 - 15 Jahre,281,137,144
False,8325061,Vöhringen,15 - 18 Jahre,140,79,61
False,8325061,Vöhringen,18 - 20 Jahre,90,45,45
False,8325061,Vöhringen,20 - 25 Jahre,212,119,93
False,8325061,Vöhringen,25 - 30 Jahre,256,133,123
False,8325061,Vöhringen,30 - 35 Jahre,316,173,143
False,8325061,Vöhringen,35 - 40 Jahre,366,194,172
False,8325061,Vöhringen,40 - 45 Jahre,278,150,128
False,8325061,Vöhringen,45 - 50 Jahre,222,104,118
False,8325061,Vöhringen,50 - 55 Jahre,225,120,105
False,8325061,Vöhringen,55 - 60 Jahre,212,100,112
False,8325061,Vöhringen,60 - 65 Jahre,249,117,132
False,8325061,Vöhringen,65 - 75 Jahre,349,162,187
False,8325061,Vöhringen,75 und mehr Jahre,219,43,176
False,8325061,Vöhringen,Insgesamt,3927,1954,1973
False,8325064,Wellendingen,unter 3 Jahre,114,59,55
False,8325064,Wellendingen,3 -  6 Jahre,111,60,51
False,8325064,Wellendingen,6 - 10 Jahre,159,81,78
False,8325064,Wellendingen,10 - 15 Jahre,211,114,97
False,8325064,Wellendingen,15 - 18 Jahre,107,51,56
False,8325064,Wellendingen,18 - 20 Jahre,74,36,38
False,8325064,Wellendingen,20 - 25 Jahre,161,95,66
False,8325064,Wellendingen,25 - 30 Jahre,168,88,80
False,8325064,Wellendingen,30 - 35 Jahre,242,135,107
False,8325064,Wellendingen,35 - 40 Jahre,285,143,142
False,8325064,Wellendingen,40 - 45 Jahre,257,131,126
False,8325064,Wellendingen,45 - 50 Jahre,210,113,97
False,8325064,Wellendingen,50 - 55 Jahre,151,86,65
False,8325064,Wellendingen,55 - 60 Jahre,163,97,66
False,8325064,Wellendingen,60 - 65 Jahre,182,83,99
False,8325064,Wellendingen,65 - 75 Jahre,225,106,119
False,8325064,Wellendingen,75 und mehr Jahre,153,43,110
False,8325064,Wellendingen,Insgesamt,2973,1521,1452
False,8325069,Zimmern ob Rottweil,unter 3 Jahre,156,82,74
False,8325069,Zimmern ob Rottweil,3 -  6 Jahre,179,89,90
False,8325069,Zimmern ob Rottweil,6 - 10 Jahre,292,160,132
False,8325069,Zimmern ob Rottweil,10 - 15 Jahre,436,201,235
False,8325069,Zimmern ob Rottweil,15 - 18 Jahre,206,102,104
False,8325069,Zimmern ob Rottweil,18 - 20 Jahre,165,75,90
False,8325069,Zimmern ob Rottweil,20 - 25 Jahre,363,197,166
False,8325069,Zimmern ob Rottweil,25 - 30 Jahre,305,150,155
False,8325069,Zimmern ob Rottweil,30 - 35 Jahre,450,230,220
False,8325069,Zimmern ob Rottweil,35 - 40 Jahre,468,246,222
False,8325069,Zimmern ob Rottweil,40 - 45 Jahre,512,236,276
False,8325069,Zimmern ob Rottweil,45 - 50 Jahre,426,209,217
False,8325069,Zimmern ob Rottweil,50 - 55 Jahre,330,168,162
False,8325069,Zimmern ob Rottweil,55 - 60 Jahre,293,150,143
False,8325069,Zimmern ob Rottweil,60 - 65 Jahre,399,197,202
False,8325069,Zimmern ob Rottweil,65 - 75 Jahre,449,212,237
False,8325069,Zimmern ob Rottweil,75 und mehr Jahre,385,133,252
False,8325069,Zimmern ob Rottweil,Insgesamt,5814,2837,2977
False,8325070,Fluorn-Winzeln,unter 3 Jahre,93,54,39
False,8325070,Fluorn-Winzeln,3 -  6 Jahre,126,66,60
False,8325070,Fluorn-Winzeln,6 - 10 Jahre,206,113,93
False,8325070,Fluorn-Winzeln,10 - 15 Jahre,218,122,96
False,8325070,Fluorn-Winzeln,15 - 18 Jahre,109,49,60
False,8325070,Fluorn-Winzeln,18 - 20 Jahre,57,21,36
False,8325070,Fluorn-Winzeln,20 - 25 Jahre,151,82,69
False,8325070,Fluorn-Winzeln,25 - 30 Jahre,188,93,95
False,8325070,Fluorn-Winzeln,30 - 35 Jahre,290,151,139
False,8325070,Fluorn-Winzeln,35 - 40 Jahre,292,163,129
False,8325070,Fluorn-Winzeln,40 - 45 Jahre,244,141,103
False,8325070,Fluorn-Winzeln,45 - 50 Jahre,174,89,85
False,8325070,Fluorn-Winzeln,50 - 55 Jahre,183,89,94
False,8325070,Fluorn-Winzeln,55 - 60 Jahre,186,106,80
False,8325070,Fluorn-Winzeln,60 - 65 Jahre,251,117,134
False,8325070,Fluorn-Winzeln,65 - 75 Jahre,283,145,138
False,8325070,Fluorn-Winzeln,75 und mehr Jahre,210,58,152
False,8325070,Fluorn-Winzeln,Insgesamt,3261,1659,1602
False,8325071,Eschbronn,unter 3 Jahre,64,38,26
False,8325071,Eschbronn,3 -  6 Jahre,68,37,31
False,8325071,Eschbronn,6 - 10 Jahre,98,56,42
False,8325071,Eschbronn,10 - 15 Jahre,118,63,55
False,8325071,Eschbronn,15 - 18 Jahre,55,30,25
False,8325071,Eschbronn,18 - 20 Jahre,62,32,30
False,8325071,Eschbronn,20 - 25 Jahre,87,40,47
False,8325071,Eschbronn,25 - 30 Jahre,121,55,66
False,8325071,Eschbronn,30 - 35 Jahre,165,96,69
False,8325071,Eschbronn,35 - 40 Jahre,192,107,85
False,8325071,Eschbronn,40 - 45 Jahre,150,78,72
False,8325071,Eschbronn,45 - 50 Jahre,137,71,66
False,8325071,Eschbronn,50 - 55 Jahre,110,51,59
False,8325071,Eschbronn,55 - 60 Jahre,132,64,68
False,8325071,Eschbronn,60 - 65 Jahre,180,93,87
False,8325071,Eschbronn,65 - 75 Jahre,182,86,96
False,8325071,Eschbronn,75 und mehr Jahre,135,51,84
False,8325071,Eschbronn,Insgesamt,2056,1048,1008
False,8325072,Deißlingen,unter 3 Jahre,172,85,87
False,8325072,Deißlingen,3 -  6 Jahre,183,94,89
False,8325072,Deißlingen,6 - 10 Jahre,344,177,167
False,8325072,Deißlingen,10 - 15 Jahre,422,211,211
False,8325072,Deißlingen,15 - 18 Jahre,229,119,110
False,8325072,Deißlingen,18 - 20 Jahre,134,88,46
False,8325072,Deißlingen,20 - 25 Jahre,283,129,154
False,8325072,Deißlingen,25 - 30 Jahre,293,156,137
False,8325072,Deißlingen,30 - 35 Jahre,440,215,225
False,8325072,Deißlingen,35 - 40 Jahre,522,263,259
False,8325072,Deißlingen,40 - 45 Jahre,494,250,244
False,8325072,Deißlingen,45 - 50 Jahre,416,209,207
False,8325072,Deißlingen,50 - 55 Jahre,353,186,167
False,8325072,Deißlingen,55 - 60 Jahre,274,145,129
False,8325072,Deißlingen,60 - 65 Jahre,410,212,198
False,8325072,Deißlingen,65 - 75 Jahre,572,267,305
False,8325072,Deißlingen,75 und mehr Jahre,328,102,226
False,8325072,Deißlingen,Insgesamt,5869,2908,2961
False,8326,Landkreis Schwarzw.-Baar-Kreis,unter 3 Jahre,6313,3305,3008
False,8326,Landkreis Schwarzw.-Baar-Kreis,3 -  6 Jahre,6879,3615,3264
False,8326,Landkreis Schwarzw.-Baar-Kreis,6 - 10 Jahre,9488,4907,4581
False,8326,Landkreis Schwarzw.-Baar-Kreis,10 - 15 Jahre,12940,6684,6256
False,8326,Landkreis Schwarzw.-Baar-Kreis,15 - 18 Jahre,7313,3752,3561
False,8326,Landkreis Schwarzw.-Baar-Kreis,18 - 20 Jahre,5012,2500,2512
False,8326,Landkreis Schwarzw.-Baar-Kreis,20 - 25 Jahre,11441,5963,5478
False,8326,Landkreis Schwarzw.-Baar-Kreis,25 - 30 Jahre,11917,6064,5853
False,8326,Landkreis Schwarzw.-Baar-Kreis,30 - 35 Jahre,15826,8105,7721
False,8326,Landkreis Schwarzw.-Baar-Kreis,35 - 40 Jahre,17060,8727,8333
False,8326,Landkreis Schwarzw.-Baar-Kreis,40 - 45 Jahre,15819,8059,7760
False,8326,Landkreis Schwarzw.-Baar-Kreis,45 - 50 Jahre,13946,6821,7125
False,8326,Landkreis Schwarzw.-Baar-Kreis,50 - 55 Jahre,12471,6265,6206
False,8326,Landkreis Schwarzw.-Baar-Kreis,55 - 60 Jahre,11973,5892,6081
False,8326,Landkreis Schwarzw.-Baar-Kreis,60 - 65 Jahre,14859,7243,7616
False,8326,Landkreis Schwarzw.-Baar-Kreis,65 - 75 Jahre,21063,9656,11407
False,8326,Landkreis Schwarzw.-Baar-Kreis,75 und mehr Jahre,16027,4938,11089
False,8326,Landkreis Schwarzw.-Baar-Kreis,Insgesamt,210347,102496,107851
False,8326003,"Bad Dürrheim, Stadt",unter 3 Jahre,305,161,144
False,8326003,"Bad Dürrheim, Stadt",3 -  6 Jahre,307,162,145
False,8326003,"Bad Dürrheim, Stadt",6 - 10 Jahre,447,228,219
False,8326003,"Bad Dürrheim, Stadt",10 - 15 Jahre,591,290,301
False,8326003,"Bad Dürrheim, Stadt",15 - 18 Jahre,367,196,171
False,8326003,"Bad Dürrheim, Stadt",18 - 20 Jahre,232,117,115
False,8326003,"Bad Dürrheim, Stadt",20 - 25 Jahre,484,256,228
False,8326003,"Bad Dürrheim, Stadt",25 - 30 Jahre,559,270,289
False,8326003,"Bad Dürrheim, Stadt",30 - 35 Jahre,810,411,399
False,8326003,"Bad Dürrheim, Stadt",35 - 40 Jahre,922,432,490
False,8326003,"Bad Dürrheim, Stadt",40 - 45 Jahre,864,425,439
False,8326003,"Bad Dürrheim, Stadt",45 - 50 Jahre,735,345,390
False,8326003,"Bad Dürrheim, Stadt",50 - 55 Jahre,708,337,371
False,8326003,"Bad Dürrheim, Stadt",55 - 60 Jahre,722,325,397
False,8326003,"Bad Dürrheim, Stadt",60 - 65 Jahre,950,420,530
False,8326003,"Bad Dürrheim, Stadt",65 - 75 Jahre,1417,630,787
False,8326003,"Bad Dürrheim, Stadt",75 und mehr Jahre,1752,513,1239
False,8326003,"Bad Dürrheim, Stadt",Insgesamt,12172,5518,6654
False,8326005,"Blumberg, Stadt",unter 3 Jahre,326,156,170
False,8326005,"Blumberg, Stadt",3 -  6 Jahre,396,224,172
False,8326005,"Blumberg, Stadt",6 - 10 Jahre,553,275,278
False,8326005,"Blumberg, Stadt",10 - 15 Jahre,720,384,336
False,8326005,"Blumberg, Stadt",15 - 18 Jahre,431,216,215
False,8326005,"Blumberg, Stadt",18 - 20 Jahre,262,134,128
False,8326005,"Blumberg, Stadt",20 - 25 Jahre,604,311,293
False,8326005,"Blumberg, Stadt",25 - 30 Jahre,618,301,317
False,8326005,"Blumberg, Stadt",30 - 35 Jahre,790,402,388
False,8326005,"Blumberg, Stadt",35 - 40 Jahre,871,454,417
False,8326005,"Blumberg, Stadt",40 - 45 Jahre,816,421,395
False,8326005,"Blumberg, Stadt",45 - 50 Jahre,673,331,342
False,8326005,"Blumberg, Stadt",50 - 55 Jahre,633,333,300
False,8326005,"Blumberg, Stadt",55 - 60 Jahre,596,328,268
False,8326005,"Blumberg, Stadt",60 - 65 Jahre,737,362,375
False,8326005,"Blumberg, Stadt",65 - 75 Jahre,979,460,519
False,8326005,"Blumberg, Stadt",75 und mehr Jahre,635,188,447
False,8326005,"Blumberg, Stadt",Insgesamt,10640,5280,5360
False,8326006,"Bräunlingen, Stadt",unter 3 Jahre,215,105,110
False,8326006,"Bräunlingen, Stadt",3 -  6 Jahre,241,133,108
False,8326006,"Bräunlingen, Stadt",6 - 10 Jahre,346,152,194
False,8326006,"Bräunlingen, Stadt",10 - 15 Jahre,450,219,231
False,8326006,"Bräunlingen, Stadt",15 - 18 Jahre,228,116,112
False,8326006,"Bräunlingen, Stadt",18 - 20 Jahre,140,75,65
False,8326006,"Bräunlingen, Stadt",20 - 25 Jahre,307,157,150
False,8326006,"Bräunlingen, Stadt",25 - 30 Jahre,375,194,181
False,8326006,"Bräunlingen, Stadt",30 - 35 Jahre,499,253,246
False,8326006,"Bräunlingen, Stadt",35 - 40 Jahre,596,310,286
False,8326006,"Bräunlingen, Stadt",40 - 45 Jahre,516,269,247
False,8326006,"Bräunlingen, Stadt",45 - 50 Jahre,420,227,193
False,8326006,"Bräunlingen, Stadt",50 - 55 Jahre,317,161,156
False,8326006,"Bräunlingen, Stadt",55 - 60 Jahre,251,138,113
False,8326006,"Bräunlingen, Stadt",60 - 65 Jahre,370,195,175
False,8326006,"Bräunlingen, Stadt",65 - 75 Jahre,488,219,269
False,8326006,"Bräunlingen, Stadt",75 und mehr Jahre,359,116,243
False,8326006,"Bräunlingen, Stadt",Insgesamt,6118,3039,3079
False,8326010,Dauchingen,unter 3 Jahre,102,55,47
False,8326010,Dauchingen,3 -  6 Jahre,110,60,50
False,8326010,Dauchingen,6 - 10 Jahre,182,99,83
False,8326010,Dauchingen,10 - 15 Jahre,224,124,100
False,8326010,Dauchingen,15 - 18 Jahre,120,70,50
False,8326010,Dauchingen,18 - 20 Jahre,66,30,36
False,8326010,Dauchingen,20 - 25 Jahre,154,76,78
False,8326010,Dauchingen,25 - 30 Jahre,194,86,108
False,8326010,Dauchingen,30 - 35 Jahre,304,146,158
False,8326010,Dauchingen,35 - 40 Jahre,370,193,177
False,8326010,Dauchingen,40 - 45 Jahre,301,152,149
False,8326010,Dauchingen,45 - 50 Jahre,257,120,137
False,8326010,Dauchingen,50 - 55 Jahre,213,114,99
False,8326010,Dauchingen,55 - 60 Jahre,209,110,99
False,8326010,Dauchingen,60 - 65 Jahre,288,130,158
False,8326010,Dauchingen,65 - 75 Jahre,306,164,142
False,8326010,Dauchingen,75 und mehr Jahre,173,61,112
False,8326010,Dauchingen,Insgesamt,3573,1790,1783
False,8326012,"Donaueschingen, Stadt",unter 3 Jahre,681,343,338
False,8326012,"Donaueschingen, Stadt",3 -  6 Jahre,723,365,358
False,8326012,"Donaueschingen, Stadt",6 - 10 Jahre,970,511,459
False,8326012,"Donaueschingen, Stadt",10 - 15 Jahre,1342,680,662
False,8326012,"Donaueschingen, Stadt",15 - 18 Jahre,724,386,338
False,8326012,"Donaueschingen, Stadt",18 - 20 Jahre,538,259,279
False,8326012,"Donaueschingen, Stadt",20 - 25 Jahre,1330,713,617
False,8326012,"Donaueschingen, Stadt",25 - 30 Jahre,1280,675,605
False,8326012,"Donaueschingen, Stadt",30 - 35 Jahre,1671,883,788
False,8326012,"Donaueschingen, Stadt",35 - 40 Jahre,1648,794,854
False,8326012,"Donaueschingen, Stadt",40 - 45 Jahre,1637,835,802
False,8326012,"Donaueschingen, Stadt",45 - 50 Jahre,1537,754,783
False,8326012,"Donaueschingen, Stadt",50 - 55 Jahre,1245,644,601
False,8326012,"Donaueschingen, Stadt",55 - 60 Jahre,1073,539,534
False,8326012,"Donaueschingen, Stadt",60 - 65 Jahre,1447,698,749
False,8326012,"Donaueschingen, Stadt",65 - 75 Jahre,1876,871,1005
False,8326012,"Donaueschingen, Stadt",75 und mehr Jahre,1543,477,1066
False,8326012,"Donaueschingen, Stadt",Insgesamt,21265,10427,10838
False,8326017,"Furtwangen im Schwarzwald, Stadt",unter 3 Jahre,326,173,153
False,8326017,"Furtwangen im Schwarzwald, Stadt",3 -  6 Jahre,347,177,170
False,8326017,"Furtwangen im Schwarzwald, Stadt",6 - 10 Jahre,470,245,225
False,8326017,"Furtwangen im Schwarzwald, Stadt",10 - 15 Jahre,619,336,283
False,8326017,"Furtwangen im Schwarzwald, Stadt",15 - 18 Jahre,343,160,183
False,8326017,"Furtwangen im Schwarzwald, Stadt",18 - 20 Jahre,248,142,106
False,8326017,"Furtwangen im Schwarzwald, Stadt",20 - 25 Jahre,575,326,249
False,8326017,"Furtwangen im Schwarzwald, Stadt",25 - 30 Jahre,601,336,265
False,8326017,"Furtwangen im Schwarzwald, Stadt",30 - 35 Jahre,772,427,345
False,8326017,"Furtwangen im Schwarzwald, Stadt",35 - 40 Jahre,963,566,397
False,8326017,"Furtwangen im Schwarzwald, Stadt",40 - 45 Jahre,790,413,377
False,8326017,"Furtwangen im Schwarzwald, Stadt",45 - 50 Jahre,571,306,265
False,8326017,"Furtwangen im Schwarzwald, Stadt",50 - 55 Jahre,505,267,238
False,8326017,"Furtwangen im Schwarzwald, Stadt",55 - 60 Jahre,476,237,239
False,8326017,"Furtwangen im Schwarzwald, Stadt",60 - 65 Jahre,651,327,324
False,8326017,"Furtwangen im Schwarzwald, Stadt",65 - 75 Jahre,976,449,527
False,8326017,"Furtwangen im Schwarzwald, Stadt",75 und mehr Jahre,642,186,456
False,8326017,"Furtwangen im Schwarzwald, Stadt",Insgesamt,9875,5073,4802
False,8326020,Gütenbach,unter 3 Jahre,32,7,25
False,8326020,Gütenbach,3 -  6 Jahre,43,25,18
False,8326020,Gütenbach,6 - 10 Jahre,55,28,27
False,8326020,Gütenbach,10 - 15 Jahre,92,58,34
False,8326020,Gütenbach,15 - 18 Jahre,66,27,39
False,8326020,Gütenbach,18 - 20 Jahre,42,25,17
False,8326020,Gütenbach,20 - 25 Jahre,64,33,31
False,8326020,Gütenbach,25 - 30 Jahre,64,34,30
False,8326020,Gütenbach,30 - 35 Jahre,95,46,49
False,8326020,Gütenbach,35 - 40 Jahre,124,63,61
False,8326020,Gütenbach,40 - 45 Jahre,127,67,60
False,8326020,Gütenbach,45 - 50 Jahre,94,46,48
False,8326020,Gütenbach,50 - 55 Jahre,62,39,23
False,8326020,Gütenbach,55 - 60 Jahre,76,38,38
False,8326020,Gütenbach,60 - 65 Jahre,95,43,52
False,8326020,Gütenbach,65 - 75 Jahre,165,76,89
False,8326020,Gütenbach,75 und mehr Jahre,99,45,54
False,8326020,Gütenbach,Insgesamt,1395,700,695
False,8326027,"Hüfingen, Stadt",unter 3 Jahre,253,134,119
False,8326027,"Hüfingen, Stadt",3 -  6 Jahre,325,199,126
False,8326027,"Hüfingen, Stadt",6 - 10 Jahre,422,205,217
False,8326027,"Hüfingen, Stadt",10 - 15 Jahre,536,306,230
False,8326027,"Hüfingen, Stadt",15 - 18 Jahre,289,137,152
False,8326027,"Hüfingen, Stadt",18 - 20 Jahre,227,120,107
False,8326027,"Hüfingen, Stadt",20 - 25 Jahre,433,219,214
False,8326027,"Hüfingen, Stadt",25 - 30 Jahre,482,246,236
False,8326027,"Hüfingen, Stadt",30 - 35 Jahre,667,328,339
False,8326027,"Hüfingen, Stadt",35 - 40 Jahre,695,367,328
False,8326027,"Hüfingen, Stadt",40 - 45 Jahre,627,316,311
False,8326027,"Hüfingen, Stadt",45 - 50 Jahre,499,251,248
False,8326027,"Hüfingen, Stadt",50 - 55 Jahre,393,207,186
False,8326027,"Hüfingen, Stadt",55 - 60 Jahre,333,177,156
False,8326027,"Hüfingen, Stadt",60 - 65 Jahre,406,201,205
False,8326027,"Hüfingen, Stadt",65 - 75 Jahre,636,309,327
False,8326027,"Hüfingen, Stadt",75 und mehr Jahre,466,156,310
False,8326027,"Hüfingen, Stadt",Insgesamt,7689,3878,3811
False,8326031,Königsfeld im Schwarzwald,unter 3 Jahre,154,81,73
False,8326031,Königsfeld im Schwarzwald,3 -  6 Jahre,172,90,82
False,8326031,Königsfeld im Schwarzwald,6 - 10 Jahre,291,158,133
False,8326031,Königsfeld im Schwarzwald,10 - 15 Jahre,397,223,174
False,8326031,Königsfeld im Schwarzwald,15 - 18 Jahre,223,119,104
False,8326031,Königsfeld im Schwarzwald,18 - 20 Jahre,192,80,112
False,8326031,Königsfeld im Schwarzwald,20 - 25 Jahre,318,167,151
False,8326031,Königsfeld im Schwarzwald,25 - 30 Jahre,288,130,158
False,8326031,Königsfeld im Schwarzwald,30 - 35 Jahre,442,243,199
False,8326031,Königsfeld im Schwarzwald,35 - 40 Jahre,429,203,226
False,8326031,Königsfeld im Schwarzwald,40 - 45 Jahre,451,217,234
False,8326031,Königsfeld im Schwarzwald,45 - 50 Jahre,442,209,233
False,8326031,Königsfeld im Schwarzwald,50 - 55 Jahre,368,188,180
False,8326031,Königsfeld im Schwarzwald,55 - 60 Jahre,304,143,161
False,8326031,Königsfeld im Schwarzwald,60 - 65 Jahre,357,172,185
False,8326031,Königsfeld im Schwarzwald,65 - 75 Jahre,619,262,357
False,8326031,Königsfeld im Schwarzwald,75 und mehr Jahre,535,155,380
False,8326031,Königsfeld im Schwarzwald,Insgesamt,5982,2840,3142
False,8326037,Mönchweiler,unter 3 Jahre,89,48,41
False,8326037,Mönchweiler,3 -  6 Jahre,111,52,59
False,8326037,Mönchweiler,6 - 10 Jahre,130,67,63
False,8326037,Mönchweiler,10 - 15 Jahre,178,91,87
False,8326037,Mönchweiler,15 - 18 Jahre,115,66,49
False,8326037,Mönchweiler,18 - 20 Jahre,77,33,44
False,8326037,Mönchweiler,20 - 25 Jahre,166,88,78
False,8326037,Mönchweiler,25 - 30 Jahre,151,71,80
False,8326037,Mönchweiler,30 - 35 Jahre,261,135,126
False,8326037,Mönchweiler,35 - 40 Jahre,242,117,125
False,8326037,Mönchweiler,40 - 45 Jahre,257,116,141
False,8326037,Mönchweiler,45 - 50 Jahre,236,120,116
False,8326037,Mönchweiler,50 - 55 Jahre,203,95,108
False,8326037,Mönchweiler,55 - 60 Jahre,205,109,96
False,8326037,Mönchweiler,60 - 65 Jahre,244,122,122
False,8326037,Mönchweiler,65 - 75 Jahre,322,155,167
False,8326037,Mönchweiler,75 und mehr Jahre,187,59,128
False,8326037,Mönchweiler,Insgesamt,3174,1544,1630
False,8326041,Niedereschach,unter 3 Jahre,197,108,89
False,8326041,Niedereschach,3 -  6 Jahre,231,111,120
False,8326041,Niedereschach,6 - 10 Jahre,268,144,124
False,8326041,Niedereschach,10 - 15 Jahre,447,235,212
False,8326041,Niedereschach,15 - 18 Jahre,219,102,117
False,8326041,Niedereschach,18 - 20 Jahre,133,64,69
False,8326041,Niedereschach,20 - 25 Jahre,301,152,149
False,8326041,Niedereschach,25 - 30 Jahre,309,164,145
False,8326041,Niedereschach,30 - 35 Jahre,451,213,238
False,8326041,Niedereschach,35 - 40 Jahre,602,304,298
False,8326041,Niedereschach,40 - 45 Jahre,514,263,251
False,8326041,Niedereschach,45 - 50 Jahre,454,234,220
False,8326041,Niedereschach,50 - 55 Jahre,370,200,170
False,8326041,Niedereschach,55 - 60 Jahre,322,163,159
False,8326041,Niedereschach,60 - 65 Jahre,330,165,165
False,8326041,Niedereschach,65 - 75 Jahre,456,210,246
False,8326041,Niedereschach,75 und mehr Jahre,261,95,166
False,8326041,Niedereschach,Insgesamt,5865,2927,2938
False,8326052,"St. Georgen im Schwarzwald, Stadt",unter 3 Jahre,392,200,192
False,8326052,"St. Georgen im Schwarzwald, Stadt",3 -  6 Jahre,451,249,202
False,8326052,"St. Georgen im Schwarzwald, Stadt",6 - 10 Jahre,653,343,310
False,8326052,"St. Georgen im Schwarzwald, Stadt",10 - 15 Jahre,835,441,394
False,8326052,"St. Georgen im Schwarzwald, Stadt",15 - 18 Jahre,481,245,236
False,8326052,"St. Georgen im Schwarzwald, Stadt",18 - 20 Jahre,322,165,157
False,8326052,"St. Georgen im Schwarzwald, Stadt",20 - 25 Jahre,748,412,336
False,8326052,"St. Georgen im Schwarzwald, Stadt",25 - 30 Jahre,761,385,376
False,8326052,"St. Georgen im Schwarzwald, Stadt",30 - 35 Jahre,999,493,506
False,8326052,"St. Georgen im Schwarzwald, Stadt",35 - 40 Jahre,1106,536,570
False,8326052,"St. Georgen im Schwarzwald, Stadt",40 - 45 Jahre,975,512,463
False,8326052,"St. Georgen im Schwarzwald, Stadt",45 - 50 Jahre,865,388,477
False,8326052,"St. Georgen im Schwarzwald, Stadt",50 - 55 Jahre,817,406,411
False,8326052,"St. Georgen im Schwarzwald, Stadt",55 - 60 Jahre,828,398,430
False,8326052,"St. Georgen im Schwarzwald, Stadt",60 - 65 Jahre,1074,522,552
False,8326052,"St. Georgen im Schwarzwald, Stadt",65 - 75 Jahre,1473,676,797
False,8326052,"St. Georgen im Schwarzwald, Stadt",75 und mehr Jahre,1145,345,800
False,8326052,"St. Georgen im Schwarzwald, Stadt",Insgesamt,13925,6716,7209
False,8326054,Schönwald im Schwarzwald,unter 3 Jahre,58,34,24
False,8326054,Schönwald im Schwarzwald,3 -  6 Jahre,78,41,37
False,8326054,Schönwald im Schwarzwald,6 - 10 Jahre,122,60,62
False,8326054,Schönwald im Schwarzwald,10 - 15 Jahre,158,89,69
False,8326054,Schönwald im Schwarzwald,15 - 18 Jahre,75,40,35
False,8326054,Schönwald im Schwarzwald,18 - 20 Jahre,60,30,30
False,8326054,Schönwald im Schwarzwald,20 - 25 Jahre,116,67,49
False,8326054,Schönwald im Schwarzwald,25 - 30 Jahre,131,72,59
False,8326054,Schönwald im Schwarzwald,30 - 35 Jahre,170,78,92
False,8326054,Schönwald im Schwarzwald,35 - 40 Jahre,219,110,109
False,8326054,Schönwald im Schwarzwald,40 - 45 Jahre,183,88,95
False,8326054,Schönwald im Schwarzwald,45 - 50 Jahre,135,78,57
False,8326054,Schönwald im Schwarzwald,50 - 55 Jahre,149,72,77
False,8326054,Schönwald im Schwarzwald,55 - 60 Jahre,152,77,75
False,8326054,Schönwald im Schwarzwald,60 - 65 Jahre,215,101,114
False,8326054,Schönwald im Schwarzwald,65 - 75 Jahre,259,130,129
False,8326054,Schönwald im Schwarzwald,75 und mehr Jahre,191,63,128
False,8326054,Schönwald im Schwarzwald,Insgesamt,2471,1230,1241
False,8326055,Schonach im Schwarzwald,unter 3 Jahre,155,84,71
False,8326055,Schonach im Schwarzwald,3 -  6 Jahre,159,78,81
False,8326055,Schonach im Schwarzwald,6 - 10 Jahre,219,117,102
False,8326055,Schonach im Schwarzwald,10 - 15 Jahre,292,143,149
False,8326055,Schonach im Schwarzwald,15 - 18 Jahre,150,81,69
False,8326055,Schonach im Schwarzwald,18 - 20 Jahre,85,47,38
False,8326055,Schonach im Schwarzwald,20 - 25 Jahre,214,100,114
False,8326055,Schonach im Schwarzwald,25 - 30 Jahre,235,127,108
False,8326055,Schonach im Schwarzwald,30 - 35 Jahre,309,170,139
False,8326055,Schonach im Schwarzwald,35 - 40 Jahre,328,148,180
False,8326055,Schonach im Schwarzwald,40 - 45 Jahre,295,166,129
False,8326055,Schonach im Schwarzwald,45 - 50 Jahre,287,132,155
False,8326055,Schonach im Schwarzwald,50 - 55 Jahre,240,129,111
False,8326055,Schonach im Schwarzwald,55 - 60 Jahre,250,118,132
False,8326055,Schonach im Schwarzwald,60 - 65 Jahre,394,182,212
False,8326055,Schonach im Schwarzwald,65 - 75 Jahre,485,235,250
False,8326055,Schonach im Schwarzwald,75 und mehr Jahre,259,92,167
False,8326055,Schonach im Schwarzwald,Insgesamt,4356,2149,2207
False,8326060,"Triberg im Schwarzwald, Stadt",unter 3 Jahre,163,87,76
False,8326060,"Triberg im Schwarzwald, Stadt",3 -  6 Jahre,204,93,111
False,8326060,"Triberg im Schwarzwald, Stadt",6 - 10 Jahre,250,131,119
False,8326060,"Triberg im Schwarzwald, Stadt",10 - 15 Jahre,357,180,177
False,8326060,"Triberg im Schwarzwald, Stadt",15 - 18 Jahre,177,103,74
False,8326060,"Triberg im Schwarzwald, Stadt",18 - 20 Jahre,115,60,55
False,8326060,"Triberg im Schwarzwald, Stadt",20 - 25 Jahre,268,133,135
False,8326060,"Triberg im Schwarzwald, Stadt",25 - 30 Jahre,293,143,150
False,8326060,"Triberg im Schwarzwald, Stadt",30 - 35 Jahre,373,186,187
False,8326060,"Triberg im Schwarzwald, Stadt",35 - 40 Jahre,440,225,215
False,8326060,"Triberg im Schwarzwald, Stadt",40 - 45 Jahre,361,201,160
False,8326060,"Triberg im Schwarzwald, Stadt",45 - 50 Jahre,307,150,157
False,8326060,"Triberg im Schwarzwald, Stadt",50 - 55 Jahre,277,152,125
False,8326060,"Triberg im Schwarzwald, Stadt",55 - 60 Jahre,310,149,161
False,8326060,"Triberg im Schwarzwald, Stadt",60 - 65 Jahre,386,190,196
False,8326060,"Triberg im Schwarzwald, Stadt",65 - 75 Jahre,685,305,380
False,8326060,"Triberg im Schwarzwald, Stadt",75 und mehr Jahre,491,154,337
False,8326060,"Triberg im Schwarzwald, Stadt",Insgesamt,5457,2642,2815
False,8326061,Tuningen,unter 3 Jahre,87,43,44
False,8326061,Tuningen,3 -  6 Jahre,82,42,40
False,8326061,Tuningen,6 - 10 Jahre,167,83,84
False,8326061,Tuningen,10 - 15 Jahre,201,107,94
False,8326061,Tuningen,15 - 18 Jahre,122,61,61
False,8326061,Tuningen,18 - 20 Jahre,69,34,35
False,8326061,Tuningen,20 - 25 Jahre,129,63,66
False,8326061,Tuningen,25 - 30 Jahre,147,62,85
False,8326061,Tuningen,30 - 35 Jahre,227,111,116
False,8326061,Tuningen,35 - 40 Jahre,264,146,118
False,8326061,Tuningen,40 - 45 Jahre,228,119,109
False,8326061,Tuningen,45 - 50 Jahre,183,95,88
False,8326061,Tuningen,50 - 55 Jahre,144,82,62
False,8326061,Tuningen,55 - 60 Jahre,147,70,77
False,8326061,Tuningen,60 - 65 Jahre,173,92,81
False,8326061,Tuningen,65 - 75 Jahre,244,110,134
False,8326061,Tuningen,75 und mehr Jahre,164,56,108
False,8326061,Tuningen,Insgesamt,2778,1376,1402
False,8326065,Unterkirnach,unter 3 Jahre,92,56,36
False,8326065,Unterkirnach,3 -  6 Jahre,91,47,44
False,8326065,Unterkirnach,6 - 10 Jahre,131,78,53
False,8326065,Unterkirnach,10 - 15 Jahre,202,106,96
False,8326065,Unterkirnach,15 - 18 Jahre,120,75,45
False,8326065,Unterkirnach,18 - 20 Jahre,83,37,46
False,8326065,Unterkirnach,20 - 25 Jahre,173,101,72
False,8326065,Unterkirnach,25 - 30 Jahre,192,120,72
False,8326065,Unterkirnach,30 - 35 Jahre,258,140,118
False,8326065,Unterkirnach,35 - 40 Jahre,281,154,127
False,8326065,Unterkirnach,40 - 45 Jahre,244,119,125
False,8326065,Unterkirnach,45 - 50 Jahre,195,107,88
False,8326065,Unterkirnach,50 - 55 Jahre,183,98,85
False,8326065,Unterkirnach,55 - 60 Jahre,162,81,81
False,8326065,Unterkirnach,60 - 65 Jahre,167,83,84
False,8326065,Unterkirnach,65 - 75 Jahre,247,129,118
False,8326065,Unterkirnach,75 und mehr Jahre,119,39,80
False,8326065,Unterkirnach,Insgesamt,2940,1570,1370
False,8326068,"Vöhrenbach, Stadt",unter 3 Jahre,145,76,69
False,8326068,"Vöhrenbach, Stadt",3 -  6 Jahre,166,89,77
False,8326068,"Vöhrenbach, Stadt",6 - 10 Jahre,195,99,96
False,8326068,"Vöhrenbach, Stadt",10 - 15 Jahre,263,128,135
False,8326068,"Vöhrenbach, Stadt",15 - 18 Jahre,155,74,81
False,8326068,"Vöhrenbach, Stadt",18 - 20 Jahre,83,38,45
False,8326068,"Vöhrenbach, Stadt",20 - 25 Jahre,211,109,102
False,8326068,"Vöhrenbach, Stadt",25 - 30 Jahre,223,125,98
False,8326068,"Vöhrenbach, Stadt",30 - 35 Jahre,336,177,159
False,8326068,"Vöhrenbach, Stadt",35 - 40 Jahre,337,174,163
False,8326068,"Vöhrenbach, Stadt",40 - 45 Jahre,306,183,123
False,8326068,"Vöhrenbach, Stadt",45 - 50 Jahre,236,122,114
False,8326068,"Vöhrenbach, Stadt",50 - 55 Jahre,258,130,128
False,8326068,"Vöhrenbach, Stadt",55 - 60 Jahre,212,111,101
False,8326068,"Vöhrenbach, Stadt",60 - 65 Jahre,317,171,146
False,8326068,"Vöhrenbach, Stadt",65 - 75 Jahre,422,204,218
False,8326068,"Vöhrenbach, Stadt",75 und mehr Jahre,269,98,171
False,8326068,"Vöhrenbach, Stadt",Insgesamt,4134,2108,2026
False,8326074,"Villingen-Schwenningen, Stadt",unter 3 Jahre,2343,1251,1092
False,8326074,"Villingen-Schwenningen, Stadt",3 -  6 Jahre,2450,1270,1180
False,8326074,"Villingen-Schwenningen, Stadt",6 - 10 Jahre,3371,1752,1619
False,8326074,"Villingen-Schwenningen, Stadt",10 - 15 Jahre,4665,2366,2299
False,8326074,"Villingen-Schwenningen, Stadt",15 - 18 Jahre,2688,1369,1319
False,8326074,"Villingen-Schwenningen, Stadt",18 - 20 Jahre,1921,956,965
False,8326074,"Villingen-Schwenningen, Stadt",20 - 25 Jahre,4538,2312,2226
False,8326074,"Villingen-Schwenningen, Stadt",25 - 30 Jahre,4680,2363,2317
False,8326074,"Villingen-Schwenningen, Stadt",30 - 35 Jahre,5937,3041,2896
False,8326074,"Villingen-Schwenningen, Stadt",35 - 40 Jahre,6175,3208,2967
False,8326074,"Villingen-Schwenningen, Stadt",40 - 45 Jahre,5870,2945,2925
False,8326074,"Villingen-Schwenningen, Stadt",45 - 50 Jahre,5423,2619,2804
False,8326074,"Villingen-Schwenningen, Stadt",50 - 55 Jahre,5035,2432,2603
False,8326074,"Villingen-Schwenningen, Stadt",55 - 60 Jahre,5055,2435,2620
False,8326074,"Villingen-Schwenningen, Stadt",60 - 65 Jahre,5957,2909,3048
False,8326074,"Villingen-Schwenningen, Stadt",65 - 75 Jahre,8586,3869,4717
False,8326074,"Villingen-Schwenningen, Stadt",75 und mehr Jahre,6520,1956,4564
False,8326074,"Villingen-Schwenningen, Stadt",Insgesamt,81214,39053,42161
False,8326075,Brigachtal,unter 3 Jahre,198,103,95
False,8326075,Brigachtal,3 -  6 Jahre,192,108,84
False,8326075,Brigachtal,6 - 10 Jahre,246,132,114
False,8326075,Brigachtal,10 - 15 Jahre,371,178,193
False,8326075,Brigachtal,15 - 18 Jahre,220,109,111
False,8326075,Brigachtal,18 - 20 Jahre,117,54,63
False,8326075,Brigachtal,20 - 25 Jahre,308,168,140
False,8326075,Brigachtal,25 - 30 Jahre,334,160,174
False,8326075,Brigachtal,30 - 35 Jahre,455,222,233
False,8326075,Brigachtal,35 - 40 Jahre,448,223,225
False,8326075,Brigachtal,40 - 45 Jahre,457,232,225
False,8326075,Brigachtal,45 - 50 Jahre,397,187,210
False,8326075,Brigachtal,50 - 55 Jahre,351,179,172
False,8326075,Brigachtal,55 - 60 Jahre,290,146,144
False,8326075,Brigachtal,60 - 65 Jahre,301,158,143
False,8326075,Brigachtal,65 - 75 Jahre,422,193,229
False,8326075,Brigachtal,75 und mehr Jahre,217,84,133
False,8326075,Brigachtal,Insgesamt,5324,2636,2688
False,8327,Landkreis Tuttlingen,unter 3 Jahre,4557,2379,2178
False,8327,Landkreis Tuttlingen,3 -  6 Jahre,4698,2387,2311
False,8327,Landkreis Tuttlingen,6 - 10 Jahre,6402,3266,3136
False,8327,Landkreis Tuttlingen,10 - 15 Jahre,8736,4405,4331
False,8327,Landkreis Tuttlingen,15 - 18 Jahre,4785,2540,2245
False,8327,Landkreis Tuttlingen,18 - 20 Jahre,3276,1706,1570
False,8327,Landkreis Tuttlingen,20 - 25 Jahre,7726,3970,3756
False,8327,Landkreis Tuttlingen,25 - 30 Jahre,8042,4202,3840
False,8327,Landkreis Tuttlingen,30 - 35 Jahre,10273,5283,4990
False,8327,Landkreis Tuttlingen,35 - 40 Jahre,11128,5803,5325
False,8327,Landkreis Tuttlingen,40 - 45 Jahre,10121,5107,5014
False,8327,Landkreis Tuttlingen,45 - 50 Jahre,8873,4451,4422
False,8327,Landkreis Tuttlingen,50 - 55 Jahre,7328,3720,3608
False,8327,Landkreis Tuttlingen,55 - 60 Jahre,6999,3467,3532
False,8327,Landkreis Tuttlingen,60 - 65 Jahre,8820,4376,4444
False,8327,Landkreis Tuttlingen,65 - 75 Jahre,12262,5721,6541
False,8327,Landkreis Tuttlingen,75 und mehr Jahre,8890,2790,6100
False,8327,Landkreis Tuttlingen,Insgesamt,132916,65573,67343
False,8327002,Aldingen,unter 3 Jahre,251,123,128
False,8327002,Aldingen,3 -  6 Jahre,280,140,140
False,8327002,Aldingen,6 - 10 Jahre,386,221,165
False,8327002,Aldingen,10 - 15 Jahre,538,270,268
False,8327002,Aldingen,15 - 18 Jahre,244,133,111
False,8327002,Aldingen,18 - 20 Jahre,154,80,74
False,8327002,Aldingen,20 - 25 Jahre,428,202,226
False,8327002,Aldingen,25 - 30 Jahre,479,231,248
False,8327002,Aldingen,30 - 35 Jahre,604,297,307
False,8327002,Aldingen,35 - 40 Jahre,617,342,275
False,8327002,Aldingen,40 - 45 Jahre,527,273,254
False,8327002,Aldingen,45 - 50 Jahre,487,244,243
False,8327002,Aldingen,50 - 55 Jahre,377,194,183
False,8327002,Aldingen,55 - 60 Jahre,347,172,175
False,8327002,Aldingen,60 - 65 Jahre,476,241,235
False,8327002,Aldingen,65 - 75 Jahre,700,318,382
False,8327002,Aldingen,75 und mehr Jahre,428,145,283
False,8327002,Aldingen,Insgesamt,7323,3626,3697
False,8327004,Bärenthal,unter 3 Jahre,12,6,6
False,8327004,Bärenthal,3 -  6 Jahre,15,9,6
False,8327004,Bärenthal,6 - 10 Jahre,23,10,13
False,8327004,Bärenthal,10 - 15 Jahre,28,13,15
False,8327004,Bärenthal,15 - 18 Jahre,19,9,10
False,8327004,Bärenthal,18 - 20 Jahre,10,8,2
False,8327004,Bärenthal,20 - 25 Jahre,21,12,9
False,8327004,Bärenthal,25 - 30 Jahre,19,12,7
False,8327004,Bärenthal,30 - 35 Jahre,34,13,21
False,8327004,Bärenthal,35 - 40 Jahre,34,21,13
False,8327004,Bärenthal,40 - 45 Jahre,35,14,21
False,8327004,Bärenthal,45 - 50 Jahre,32,21,11
False,8327004,Bärenthal,50 - 55 Jahre,14,7,7
False,8327004,Bärenthal,55 - 60 Jahre,21,11,10
False,8327004,Bärenthal,60 - 65 Jahre,33,13,20
False,8327004,Bärenthal,65 - 75 Jahre,46,23,23
False,8327004,Bärenthal,75 und mehr Jahre,42,13,29
False,8327004,Bärenthal,Insgesamt,438,215,223
False,8327005,Balgheim,unter 3 Jahre,27,12,15
False,8327005,Balgheim,3 -  6 Jahre,42,20,22
False,8327005,Balgheim,6 - 10 Jahre,51,29,22
False,8327005,Balgheim,10 - 15 Jahre,65,37,28
False,8327005,Balgheim,15 - 18 Jahre,44,25,19
False,8327005,Balgheim,18 - 20 Jahre,33,17,16
False,8327005,Balgheim,20 - 25 Jahre,62,34,28
False,8327005,Balgheim,25 - 30 Jahre,57,30,27
False,8327005,Balgheim,30 - 35 Jahre,87,42,45
False,8327005,Balgheim,35 - 40 Jahre,85,37,48
False,8327005,Balgheim,40 - 45 Jahre,82,41,41
False,8327005,Balgheim,45 - 50 Jahre,83,46,37
False,8327005,Balgheim,50 - 55 Jahre,56,30,26
False,8327005,Balgheim,55 - 60 Jahre,57,25,32
False,8327005,Balgheim,60 - 65 Jahre,59,34,25
False,8327005,Balgheim,65 - 75 Jahre,65,35,30
False,8327005,Balgheim,75 und mehr Jahre,48,15,33
False,8327005,Balgheim,Insgesamt,1003,509,494
False,8327006,Böttingen,unter 3 Jahre,50,27,23
False,8327006,Böttingen,3 -  6 Jahre,70,39,31
False,8327006,Böttingen,6 - 10 Jahre,83,38,45
False,8327006,Böttingen,10 - 15 Jahre,90,54,36
False,8327006,Böttingen,15 - 18 Jahre,52,24,28
False,8327006,Böttingen,18 - 20 Jahre,29,13,16
False,8327006,Böttingen,20 - 25 Jahre,71,42,29
False,8327006,Böttingen,25 - 30 Jahre,104,53,51
False,8327006,Böttingen,30 - 35 Jahre,120,61,59
False,8327006,Böttingen,35 - 40 Jahre,154,77,77
False,8327006,Böttingen,40 - 45 Jahre,104,67,37
False,8327006,Böttingen,45 - 50 Jahre,98,48,50
False,8327006,Böttingen,50 - 55 Jahre,68,39,29
False,8327006,Böttingen,55 - 60 Jahre,60,32,28
False,8327006,Böttingen,60 - 65 Jahre,91,47,44
False,8327006,Böttingen,65 - 75 Jahre,126,50,76
False,8327006,Böttingen,75 und mehr Jahre,72,21,51
False,8327006,Böttingen,Insgesamt,1442,732,710
False,8327007,Bubsheim,unter 3 Jahre,35,24,11
False,8327007,Bubsheim,3 -  6 Jahre,39,18,21
False,8327007,Bubsheim,6 - 10 Jahre,57,25,32
False,8327007,Bubsheim,10 - 15 Jahre,66,37,29
False,8327007,Bubsheim,15 - 18 Jahre,39,20,19
False,8327007,Bubsheim,18 - 20 Jahre,31,19,12
False,8327007,Bubsheim,20 - 25 Jahre,83,44,39
False,8327007,Bubsheim,25 - 30 Jahre,83,46,37
False,8327007,Bubsheim,30 - 35 Jahre,72,47,25
False,8327007,Bubsheim,35 - 40 Jahre,83,50,33
False,8327007,Bubsheim,40 - 45 Jahre,87,37,50
False,8327007,Bubsheim,45 - 50 Jahre,86,46,40
False,8327007,Bubsheim,50 - 55 Jahre,58,28,30
False,8327007,Bubsheim,55 - 60 Jahre,35,19,16
False,8327007,Bubsheim,60 - 65 Jahre,61,29,32
False,8327007,Bubsheim,65 - 75 Jahre,76,39,37
False,8327007,Bubsheim,75 und mehr Jahre,38,9,29
False,8327007,Bubsheim,Insgesamt,1029,537,492
False,8327008,Buchheim,unter 3 Jahre,17,6,11
False,8327008,Buchheim,3 -  6 Jahre,29,18,11
False,8327008,Buchheim,6 - 10 Jahre,45,22,23
False,8327008,Buchheim,10 - 15 Jahre,49,23,26
False,8327008,Buchheim,15 - 18 Jahre,31,18,13
False,8327008,Buchheim,18 - 20 Jahre,23,15,8
False,8327008,Buchheim,20 - 25 Jahre,36,22,14
False,8327008,Buchheim,25 - 30 Jahre,30,12,18
False,8327008,Buchheim,30 - 35 Jahre,44,24,20
False,8327008,Buchheim,35 - 40 Jahre,48,26,22
False,8327008,Buchheim,40 - 45 Jahre,52,29,23
False,8327008,Buchheim,45 - 50 Jahre,48,24,24
False,8327008,Buchheim,50 - 55 Jahre,37,25,12
False,8327008,Buchheim,55 - 60 Jahre,15,6,9
False,8327008,Buchheim,60 - 65 Jahre,28,14,14
False,8327008,Buchheim,65 - 75 Jahre,68,32,36
False,8327008,Buchheim,75 und mehr Jahre,35,9,26
False,8327008,Buchheim,Insgesamt,635,325,310
False,8327009,Deilingen,unter 3 Jahre,66,33,33
False,8327009,Deilingen,3 -  6 Jahre,69,38,31
False,8327009,Deilingen,6 - 10 Jahre,97,52,45
False,8327009,Deilingen,10 - 15 Jahre,118,55,63
False,8327009,Deilingen,15 - 18 Jahre,63,39,24
False,8327009,Deilingen,18 - 20 Jahre,36,12,24
False,8327009,Deilingen,20 - 25 Jahre,127,65,62
False,8327009,Deilingen,25 - 30 Jahre,117,66,51
False,8327009,Deilingen,30 - 35 Jahre,118,59,59
False,8327009,Deilingen,35 - 40 Jahre,128,64,64
False,8327009,Deilingen,40 - 45 Jahre,132,67,65
False,8327009,Deilingen,45 - 50 Jahre,112,61,51
False,8327009,Deilingen,50 - 55 Jahre,90,52,38
False,8327009,Deilingen,55 - 60 Jahre,65,33,32
False,8327009,Deilingen,60 - 65 Jahre,106,44,62
False,8327009,Deilingen,65 - 75 Jahre,155,63,92
False,8327009,Deilingen,75 und mehr Jahre,92,32,60
False,8327009,Deilingen,Insgesamt,1691,835,856
False,8327010,Denkingen,unter 3 Jahre,80,44,36
False,8327010,Denkingen,3 -  6 Jahre,93,49,44
False,8327010,Denkingen,6 - 10 Jahre,142,79,63
False,8327010,Denkingen,10 - 15 Jahre,178,92,86
False,8327010,Denkingen,15 - 18 Jahre,97,53,44
False,8327010,Denkingen,18 - 20 Jahre,54,29,25
False,8327010,Denkingen,20 - 25 Jahre,125,68,57
False,8327010,Denkingen,25 - 30 Jahre,166,87,79
False,8327010,Denkingen,30 - 35 Jahre,193,108,85
False,8327010,Denkingen,35 - 40 Jahre,220,117,103
False,8327010,Denkingen,40 - 45 Jahre,160,79,81
False,8327010,Denkingen,45 - 50 Jahre,156,73,83
False,8327010,Denkingen,50 - 55 Jahre,137,70,67
False,8327010,Denkingen,55 - 60 Jahre,121,59,62
False,8327010,Denkingen,60 - 65 Jahre,168,91,77
False,8327010,Denkingen,65 - 75 Jahre,208,109,99
False,8327010,Denkingen,75 und mehr Jahre,124,39,85
False,8327010,Denkingen,Insgesamt,2422,1246,1176
False,8327011,Dürbheim,unter 3 Jahre,42,22,20
False,8327011,Dürbheim,3 -  6 Jahre,62,35,27
False,8327011,Dürbheim,6 - 10 Jahre,84,42,42
False,8327011,Dürbheim,10 - 15 Jahre,119,61,58
False,8327011,Dürbheim,15 - 18 Jahre,52,27,25
False,8327011,Dürbheim,18 - 20 Jahre,33,15,18
False,8327011,Dürbheim,20 - 25 Jahre,76,43,33
False,8327011,Dürbheim,25 - 30 Jahre,82,37,45
False,8327011,Dürbheim,30 - 35 Jahre,120,55,65
False,8327011,Dürbheim,35 - 40 Jahre,177,92,85
False,8327011,Dürbheim,40 - 45 Jahre,128,68,60
False,8327011,Dürbheim,45 - 50 Jahre,105,53,52
False,8327011,Dürbheim,50 - 55 Jahre,91,46,45
False,8327011,Dürbheim,55 - 60 Jahre,74,42,32
False,8327011,Dürbheim,60 - 65 Jahre,96,51,45
False,8327011,Dürbheim,65 - 75 Jahre,130,65,65
False,8327011,Dürbheim,75 und mehr Jahre,74,22,52
False,8327011,Dürbheim,Insgesamt,1545,776,769
False,8327012,Durchhausen,unter 3 Jahre,24,12,12
False,8327012,Durchhausen,3 -  6 Jahre,37,21,16
False,8327012,Durchhausen,6 - 10 Jahre,40,17,23
False,8327012,Durchhausen,10 - 15 Jahre,69,38,31
False,8327012,Durchhausen,15 - 18 Jahre,34,20,14
False,8327012,Durchhausen,18 - 20 Jahre,22,14,8
False,8327012,Durchhausen,20 - 25 Jahre,41,18,23
False,8327012,Durchhausen,25 - 30 Jahre,38,27,11
False,8327012,Durchhausen,30 - 35 Jahre,65,31,34
False,8327012,Durchhausen,35 - 40 Jahre,67,37,30
False,8327012,Durchhausen,40 - 45 Jahre,80,41,39
False,8327012,Durchhausen,45 - 50 Jahre,46,28,18
False,8327012,Durchhausen,50 - 55 Jahre,43,25,18
False,8327012,Durchhausen,55 - 60 Jahre,48,19,29
False,8327012,Durchhausen,60 - 65 Jahre,73,39,34
False,8327012,Durchhausen,65 - 75 Jahre,83,40,43
False,8327012,Durchhausen,75 und mehr Jahre,60,23,37
False,8327012,Durchhausen,Insgesamt,870,450,420
False,8327013,Egesheim,unter 3 Jahre,21,8,13
False,8327013,Egesheim,3 -  6 Jahre,24,12,12
False,8327013,Egesheim,6 - 10 Jahre,25,15,10
False,8327013,Egesheim,10 - 15 Jahre,46,29,17
False,8327013,Egesheim,15 - 18 Jahre,30,18,12
False,8327013,Egesheim,18 - 20 Jahre,23,11,12
False,8327013,Egesheim,20 - 25 Jahre,54,33,21
False,8327013,Egesheim,25 - 30 Jahre,42,22,20
False,8327013,Egesheim,30 - 35 Jahre,38,25,13
False,8327013,Egesheim,35 - 40 Jahre,46,25,21
False,8327013,Egesheim,40 - 45 Jahre,60,32,28
False,8327013,Egesheim,45 - 50 Jahre,26,14,12
False,8327013,Egesheim,50 - 55 Jahre,35,14,21
False,8327013,Egesheim,55 - 60 Jahre,27,19,8
False,8327013,Egesheim,60 - 65 Jahre,40,17,23
False,8327013,Egesheim,65 - 75 Jahre,39,16,23
False,8327013,Egesheim,75 und mehr Jahre,29,6,23
False,8327013,Egesheim,Insgesamt,605,316,289
False,8327016,"Fridingen an der Donau, Stadt",unter 3 Jahre,105,55,50
False,8327016,"Fridingen an der Donau, Stadt",3 -  6 Jahre,111,57,54
False,8327016,"Fridingen an der Donau, Stadt",6 - 10 Jahre,188,97,91
False,8327016,"Fridingen an der Donau, Stadt",10 - 15 Jahre,236,108,128
False,8327016,"Fridingen an der Donau, Stadt",15 - 18 Jahre,132,69,63
False,8327016,"Fridingen an der Donau, Stadt",18 - 20 Jahre,79,43,36
False,8327016,"Fridingen an der Donau, Stadt",20 - 25 Jahre,168,87,81
False,8327016,"Fridingen an der Donau, Stadt",25 - 30 Jahre,152,77,75
False,8327016,"Fridingen an der Donau, Stadt",30 - 35 Jahre,213,109,104
False,8327016,"Fridingen an der Donau, Stadt",35 - 40 Jahre,312,148,164
False,8327016,"Fridingen an der Donau, Stadt",40 - 45 Jahre,260,134,126
False,8327016,"Fridingen an der Donau, Stadt",45 - 50 Jahre,223,107,116
False,8327016,"Fridingen an der Donau, Stadt",50 - 55 Jahre,200,107,93
False,8327016,"Fridingen an der Donau, Stadt",55 - 60 Jahre,177,89,88
False,8327016,"Fridingen an der Donau, Stadt",60 - 65 Jahre,231,108,123
False,8327016,"Fridingen an der Donau, Stadt",65 - 75 Jahre,355,176,179
False,8327016,"Fridingen an der Donau, Stadt",75 und mehr Jahre,185,67,118
False,8327016,"Fridingen an der Donau, Stadt",Insgesamt,3327,1638,1689
False,8327017,Frittlingen,unter 3 Jahre,73,37,36
False,8327017,Frittlingen,3 -  6 Jahre,78,43,35
False,8327017,Frittlingen,6 - 10 Jahre,119,56,63
False,8327017,Frittlingen,10 - 15 Jahre,123,62,61
False,8327017,Frittlingen,15 - 18 Jahre,86,48,38
False,8327017,Frittlingen,18 - 20 Jahre,61,31,30
False,8327017,Frittlingen,20 - 25 Jahre,113,60,53
False,8327017,Frittlingen,25 - 30 Jahre,118,61,57
False,8327017,Frittlingen,30 - 35 Jahre,162,85,77
False,8327017,Frittlingen,35 - 40 Jahre,167,90,77
False,8327017,Frittlingen,40 - 45 Jahre,175,87,88
False,8327017,Frittlingen,45 - 50 Jahre,151,85,66
False,8327017,Frittlingen,50 - 55 Jahre,125,68,57
False,8327017,Frittlingen,55 - 60 Jahre,82,50,32
False,8327017,Frittlingen,60 - 65 Jahre,121,57,64
False,8327017,Frittlingen,65 - 75 Jahre,163,78,85
False,8327017,Frittlingen,75 und mehr Jahre,111,40,71
False,8327017,Frittlingen,Insgesamt,2028,1038,990
False,8327018,"Geisingen, Stadt",unter 3 Jahre,219,112,107
False,8327018,"Geisingen, Stadt",3 -  6 Jahre,235,121,114
False,8327018,"Geisingen, Stadt",6 - 10 Jahre,310,141,169
False,8327018,"Geisingen, Stadt",10 - 15 Jahre,404,217,187
False,8327018,"Geisingen, Stadt",15 - 18 Jahre,230,117,113
False,8327018,"Geisingen, Stadt",18 - 20 Jahre,158,64,94
False,8327018,"Geisingen, Stadt",20 - 25 Jahre,351,169,182
False,8327018,"Geisingen, Stadt",25 - 30 Jahre,355,181,174
False,8327018,"Geisingen, Stadt",30 - 35 Jahre,418,208,210
False,8327018,"Geisingen, Stadt",35 - 40 Jahre,491,274,217
False,8327018,"Geisingen, Stadt",40 - 45 Jahre,470,224,246
False,8327018,"Geisingen, Stadt",45 - 50 Jahre,459,245,214
False,8327018,"Geisingen, Stadt",50 - 55 Jahre,348,180,168
False,8327018,"Geisingen, Stadt",55 - 60 Jahre,313,171,142
False,8327018,"Geisingen, Stadt",60 - 65 Jahre,398,219,179
False,8327018,"Geisingen, Stadt",65 - 75 Jahre,505,234,271
False,8327018,"Geisingen, Stadt",75 und mehr Jahre,483,158,325
False,8327018,"Geisingen, Stadt",Insgesamt,6147,3035,3112
False,8327019,Gosheim,unter 3 Jahre,142,75,67
False,8327019,Gosheim,3 -  6 Jahre,153,78,75
False,8327019,Gosheim,6 - 10 Jahre,201,105,96
False,8327019,Gosheim,10 - 15 Jahre,284,157,127
False,8327019,Gosheim,15 - 18 Jahre,153,79,74
False,8327019,Gosheim,18 - 20 Jahre,103,52,51
False,8327019,Gosheim,20 - 25 Jahre,249,138,111
False,8327019,Gosheim,25 - 30 Jahre,207,98,109
False,8327019,Gosheim,30 - 35 Jahre,276,148,128
False,8327019,Gosheim,35 - 40 Jahre,348,167,181
False,8327019,Gosheim,40 - 45 Jahre,326,172,154
False,8327019,Gosheim,45 - 50 Jahre,232,129,103
False,8327019,Gosheim,50 - 55 Jahre,187,97,90
False,8327019,Gosheim,55 - 60 Jahre,166,77,89
False,8327019,Gosheim,60 - 65 Jahre,224,101,123
False,8327019,Gosheim,65 - 75 Jahre,368,157,211
False,8327019,Gosheim,75 und mehr Jahre,170,59,111
False,8327019,Gosheim,Insgesamt,3789,1889,1900
False,8327020,Gunningen,unter 3 Jahre,25,12,13
False,8327020,Gunningen,3 -  6 Jahre,27,12,15
False,8327020,Gunningen,6 - 10 Jahre,38,25,13
False,8327020,Gunningen,10 - 15 Jahre,54,24,30
False,8327020,Gunningen,15 - 18 Jahre,23,13,10
False,8327020,Gunningen,18 - 20 Jahre,19,15,4
False,8327020,Gunningen,20 - 25 Jahre,46,27,19
False,8327020,Gunningen,25 - 30 Jahre,48,31,17
False,8327020,Gunningen,30 - 35 Jahre,53,24,29
False,8327020,Gunningen,35 - 40 Jahre,57,25,32
False,8327020,Gunningen,40 - 45 Jahre,62,30,32
False,8327020,Gunningen,45 - 50 Jahre,52,27,25
False,8327020,Gunningen,50 - 55 Jahre,29,14,15
False,8327020,Gunningen,55 - 60 Jahre,46,26,20
False,8327020,Gunningen,60 - 65 Jahre,50,26,24
False,8327020,Gunningen,65 - 75 Jahre,31,16,15
False,8327020,Gunningen,75 und mehr Jahre,41,14,27
False,8327020,Gunningen,Insgesamt,701,361,340
False,8327023,Hausen ob Verena,unter 3 Jahre,22,9,13
False,8327023,Hausen ob Verena,3 -  6 Jahre,34,19,15
False,8327023,Hausen ob Verena,6 - 10 Jahre,46,25,21
False,8327023,Hausen ob Verena,10 - 15 Jahre,56,25,31
False,8327023,Hausen ob Verena,15 - 18 Jahre,25,7,18
False,8327023,Hausen ob Verena,18 - 20 Jahre,19,11,8
False,8327023,Hausen ob Verena,20 - 25 Jahre,35,19,16
False,8327023,Hausen ob Verena,25 - 30 Jahre,34,16,18
False,8327023,Hausen ob Verena,30 - 35 Jahre,55,23,32
False,8327023,Hausen ob Verena,35 - 40 Jahre,68,38,30
False,8327023,Hausen ob Verena,40 - 45 Jahre,54,20,34
False,8327023,Hausen ob Verena,45 - 50 Jahre,45,22,23
False,8327023,Hausen ob Verena,50 - 55 Jahre,42,23,19
False,8327023,Hausen ob Verena,55 - 60 Jahre,34,15,19
False,8327023,Hausen ob Verena,60 - 65 Jahre,65,38,27
False,8327023,Hausen ob Verena,65 - 75 Jahre,65,30,35
False,8327023,Hausen ob Verena,75 und mehr Jahre,43,15,28
False,8327023,Hausen ob Verena,Insgesamt,742,355,387
False,8327025,Immendingen,unter 3 Jahre,218,110,108
False,8327025,Immendingen,3 -  6 Jahre,172,86,86
False,8327025,Immendingen,6 - 10 Jahre,277,149,128
False,8327025,Immendingen,10 - 15 Jahre,364,178,186
False,8327025,Immendingen,15 - 18 Jahre,212,116,96
False,8327025,Immendingen,18 - 20 Jahre,138,73,65
False,8327025,Immendingen,20 - 25 Jahre,381,227,154
False,8327025,Immendingen,25 - 30 Jahre,448,271,177
False,8327025,Immendingen,30 - 35 Jahre,563,345,218
False,8327025,Immendingen,35 - 40 Jahre,555,321,234
False,8327025,Immendingen,40 - 45 Jahre,438,234,204
False,8327025,Immendingen,45 - 50 Jahre,352,174,178
False,8327025,Immendingen,50 - 55 Jahre,316,172,144
False,8327025,Immendingen,55 - 60 Jahre,268,142,126
False,8327025,Immendingen,60 - 65 Jahre,359,178,181
False,8327025,Immendingen,65 - 75 Jahre,487,241,246
False,8327025,Immendingen,75 und mehr Jahre,317,117,200
False,8327025,Immendingen,Insgesamt,5865,3134,2731
False,8327027,Irndorf,unter 3 Jahre,28,13,15
False,8327027,Irndorf,3 -  6 Jahre,26,9,17
False,8327027,Irndorf,6 - 10 Jahre,47,20,27
False,8327027,Irndorf,10 - 15 Jahre,41,15,26
False,8327027,Irndorf,15 - 18 Jahre,23,13,10
False,8327027,Irndorf,18 - 20 Jahre,17,8,9
False,8327027,Irndorf,20 - 25 Jahre,40,26,14
False,8327027,Irndorf,25 - 30 Jahre,35,17,18
False,8327027,Irndorf,30 - 35 Jahre,56,32,24
False,8327027,Irndorf,35 - 40 Jahre,74,36,38
False,8327027,Irndorf,40 - 45 Jahre,57,27,30
False,8327027,Irndorf,45 - 50 Jahre,45,27,18
False,8327027,Irndorf,50 - 55 Jahre,22,16,6
False,8327027,Irndorf,55 - 60 Jahre,32,11,21
False,8327027,Irndorf,60 - 65 Jahre,61,31,30
False,8327027,Irndorf,65 - 75 Jahre,92,45,47
False,8327027,Irndorf,75 und mehr Jahre,61,14,47
False,8327027,Irndorf,Insgesamt,757,360,397
False,8327029,Königsheim,unter 3 Jahre,19,10,9
False,8327029,Königsheim,3 -  6 Jahre,18,11,7
False,8327029,Königsheim,6 - 10 Jahre,31,16,15
False,8327029,Königsheim,10 - 15 Jahre,30,14,16
False,8327029,Königsheim,15 - 18 Jahre,17,8,9
False,8327029,Königsheim,18 - 20 Jahre,10,7,3
False,8327029,Königsheim,20 - 25 Jahre,45,21,24
False,8327029,Königsheim,25 - 30 Jahre,31,19,12
False,8327029,Königsheim,30 - 35 Jahre,45,20,25
False,8327029,Königsheim,35 - 40 Jahre,45,24,21
False,8327029,Königsheim,40 - 45 Jahre,42,25,17
False,8327029,Königsheim,45 - 50 Jahre,34,18,16
False,8327029,Königsheim,50 - 55 Jahre,21,9,12
False,8327029,Königsheim,55 - 60 Jahre,22,12,10
False,8327029,Königsheim,60 - 65 Jahre,40,20,20
False,8327029,Königsheim,65 - 75 Jahre,58,29,29
False,8327029,Königsheim,75 und mehr Jahre,24,9,15
False,8327029,Königsheim,Insgesamt,532,272,260
False,8327030,Kolbingen,unter 3 Jahre,42,20,22
False,8327030,Kolbingen,3 -  6 Jahre,48,19,29
False,8327030,Kolbingen,6 - 10 Jahre,75,33,42
False,8327030,Kolbingen,10 - 15 Jahre,75,43,32
False,8327030,Kolbingen,15 - 18 Jahre,40,20,20
False,8327030,Kolbingen,18 - 20 Jahre,28,13,15
False,8327030,Kolbingen,20 - 25 Jahre,66,39,27
False,8327030,Kolbingen,25 - 30 Jahre,70,35,35
False,8327030,Kolbingen,30 - 35 Jahre,107,59,48
False,8327030,Kolbingen,35 - 40 Jahre,114,59,55
False,8327030,Kolbingen,40 - 45 Jahre,99,52,47
False,8327030,Kolbingen,45 - 50 Jahre,84,38,46
False,8327030,Kolbingen,50 - 55 Jahre,70,38,32
False,8327030,Kolbingen,55 - 60 Jahre,61,27,34
False,8327030,Kolbingen,60 - 65 Jahre,91,45,46
False,8327030,Kolbingen,65 - 75 Jahre,126,68,58
False,8327030,Kolbingen,75 und mehr Jahre,69,21,48
False,8327030,Kolbingen,Insgesamt,1265,629,636
False,8327033,Mahlstetten,unter 3 Jahre,21,10,11
False,8327033,Mahlstetten,3 -  6 Jahre,25,15,10
False,8327033,Mahlstetten,6 - 10 Jahre,36,24,12
False,8327033,Mahlstetten,10 - 15 Jahre,55,28,27
False,8327033,Mahlstetten,15 - 18 Jahre,28,19,9
False,8327033,Mahlstetten,18 - 20 Jahre,23,11,12
False,8327033,Mahlstetten,20 - 25 Jahre,40,24,16
False,8327033,Mahlstetten,25 - 30 Jahre,28,14,14
False,8327033,Mahlstetten,30 - 35 Jahre,47,28,19
False,8327033,Mahlstetten,35 - 40 Jahre,59,27,32
False,8327033,Mahlstetten,40 - 45 Jahre,81,40,41
False,8327033,Mahlstetten,45 - 50 Jahre,52,31,21
False,8327033,Mahlstetten,50 - 55 Jahre,32,17,15
False,8327033,Mahlstetten,55 - 60 Jahre,27,14,13
False,8327033,Mahlstetten,60 - 65 Jahre,60,27,33
False,8327033,Mahlstetten,65 - 75 Jahre,98,50,48
False,8327033,Mahlstetten,75 und mehr Jahre,41,15,26
False,8327033,Mahlstetten,Insgesamt,753,394,359
False,8327036,"Mühlheim an der Donau, Stadt",unter 3 Jahre,136,81,55
False,8327036,"Mühlheim an der Donau, Stadt",3 -  6 Jahre,117,57,60
False,8327036,"Mühlheim an der Donau, Stadt",6 - 10 Jahre,132,59,73
False,8327036,"Mühlheim an der Donau, Stadt",10 - 15 Jahre,205,109,96
False,8327036,"Mühlheim an der Donau, Stadt",15 - 18 Jahre,111,55,56
False,8327036,"Mühlheim an der Donau, Stadt",18 - 20 Jahre,84,47,37
False,8327036,"Mühlheim an der Donau, Stadt",20 - 25 Jahre,198,104,94
False,8327036,"Mühlheim an der Donau, Stadt",25 - 30 Jahre,210,111,99
False,8327036,"Mühlheim an der Donau, Stadt",30 - 35 Jahre,285,132,153
False,8327036,"Mühlheim an der Donau, Stadt",35 - 40 Jahre,284,149,135
False,8327036,"Mühlheim an der Donau, Stadt",40 - 45 Jahre,247,127,120
False,8327036,"Mühlheim an der Donau, Stadt",45 - 50 Jahre,241,115,126
False,8327036,"Mühlheim an der Donau, Stadt",50 - 55 Jahre,230,109,121
False,8327036,"Mühlheim an der Donau, Stadt",55 - 60 Jahre,231,123,108
False,8327036,"Mühlheim an der Donau, Stadt",60 - 65 Jahre,253,141,112
False,8327036,"Mühlheim an der Donau, Stadt",65 - 75 Jahre,330,160,170
False,8327036,"Mühlheim an der Donau, Stadt",75 und mehr Jahre,196,60,136
False,8327036,"Mühlheim an der Donau, Stadt",Insgesamt,3490,1739,1751
False,8327038,Neuhausen ob Eck,unter 3 Jahre,119,58,61
False,8327038,Neuhausen ob Eck,3 -  6 Jahre,160,86,74
False,8327038,Neuhausen ob Eck,6 - 10 Jahre,194,105,89
False,8327038,Neuhausen ob Eck,10 - 15 Jahre,281,162,119
False,8327038,Neuhausen ob Eck,15 - 18 Jahre,184,98,86
False,8327038,Neuhausen ob Eck,18 - 20 Jahre,96,59,37
False,8327038,Neuhausen ob Eck,20 - 25 Jahre,190,91,99
False,8327038,Neuhausen ob Eck,25 - 30 Jahre,176,85,91
False,8327038,Neuhausen ob Eck,30 - 35 Jahre,262,141,121
False,8327038,Neuhausen ob Eck,35 - 40 Jahre,346,176,170
False,8327038,Neuhausen ob Eck,40 - 45 Jahre,328,163,165
False,8327038,Neuhausen ob Eck,45 - 50 Jahre,255,133,122
False,8327038,Neuhausen ob Eck,50 - 55 Jahre,153,85,68
False,8327038,Neuhausen ob Eck,55 - 60 Jahre,158,62,96
False,8327038,Neuhausen ob Eck,60 - 65 Jahre,229,123,106
False,8327038,Neuhausen ob Eck,65 - 75 Jahre,312,137,175
False,8327038,Neuhausen ob Eck,75 und mehr Jahre,192,66,126
False,8327038,Neuhausen ob Eck,Insgesamt,3635,1830,1805
False,8327040,Reichenbach am Heuberg,unter 3 Jahre,23,15,8
False,8327040,Reichenbach am Heuberg,3 -  6 Jahre,19,7,12
False,8327040,Reichenbach am Heuberg,6 - 10 Jahre,35,17,18
False,8327040,Reichenbach am Heuberg,10 - 15 Jahre,47,25,22
False,8327040,Reichenbach am Heuberg,15 - 18 Jahre,18,10,8
False,8327040,Reichenbach am Heuberg,18 - 20 Jahre,17,6,11
False,8327040,Reichenbach am Heuberg,20 - 25 Jahre,24,13,11
False,8327040,Reichenbach am Heuberg,25 - 30 Jahre,35,15,20
False,8327040,Reichenbach am Heuberg,30 - 35 Jahre,39,22,17
False,8327040,Reichenbach am Heuberg,35 - 40 Jahre,47,24,23
False,8327040,Reichenbach am Heuberg,40 - 45 Jahre,46,25,21
False,8327040,Reichenbach am Heuberg,45 - 50 Jahre,36,23,13
False,8327040,Reichenbach am Heuberg,50 - 55 Jahre,16,7,9
False,8327040,Reichenbach am Heuberg,55 - 60 Jahre,15,4,11
False,8327040,Reichenbach am Heuberg,60 - 65 Jahre,39,17,22
False,8327040,Reichenbach am Heuberg,65 - 75 Jahre,37,13,24
False,8327040,Reichenbach am Heuberg,75 und mehr Jahre,18,6,12
False,8327040,Reichenbach am Heuberg,Insgesamt,511,249,262
False,8327041,Renquishausen,unter 3 Jahre,30,15,15
False,8327041,Renquishausen,3 -  6 Jahre,32,19,13
False,8327041,Renquishausen,6 - 10 Jahre,44,23,21
False,8327041,Renquishausen,10 - 15 Jahre,60,32,28
False,8327041,Renquishausen,15 - 18 Jahre,30,16,14
False,8327041,Renquishausen,18 - 20 Jahre,12,6,6
False,8327041,Renquishausen,20 - 25 Jahre,52,24,28
False,8327041,Renquishausen,25 - 30 Jahre,33,18,15
False,8327041,Renquishausen,30 - 35 Jahre,73,40,33
False,8327041,Renquishausen,35 - 40 Jahre,72,31,41
False,8327041,Renquishausen,40 - 45 Jahre,64,32,32
False,8327041,Renquishausen,45 - 50 Jahre,48,27,21
False,8327041,Renquishausen,50 - 55 Jahre,37,18,19
False,8327041,Renquishausen,55 - 60 Jahre,31,16,15
False,8327041,Renquishausen,60 - 65 Jahre,34,18,16
False,8327041,Renquishausen,65 - 75 Jahre,63,34,29
False,8327041,Renquishausen,75 und mehr Jahre,37,11,26
False,8327041,Renquishausen,Insgesamt,752,380,372
False,8327046,"Spaichingen, Stadt",unter 3 Jahre,384,204,180
False,8327046,"Spaichingen, Stadt",3 -  6 Jahre,392,217,175
False,8327046,"Spaichingen, Stadt",6 - 10 Jahre,593,307,286
False,8327046,"Spaichingen, Stadt",10 - 15 Jahre,798,401,397
False,8327046,"Spaichingen, Stadt",15 - 18 Jahre,440,231,209
False,8327046,"Spaichingen, Stadt",18 - 20 Jahre,319,163,156
False,8327046,"Spaichingen, Stadt",20 - 25 Jahre,695,370,325
False,8327046,"Spaichingen, Stadt",25 - 30 Jahre,744,360,384
False,8327046,"Spaichingen, Stadt",30 - 35 Jahre,842,456,386
False,8327046,"Spaichingen, Stadt",35 - 40 Jahre,964,482,482
False,8327046,"Spaichingen, Stadt",40 - 45 Jahre,895,464,431
False,8327046,"Spaichingen, Stadt",45 - 50 Jahre,897,429,468
False,8327046,"Spaichingen, Stadt",50 - 55 Jahre,687,355,332
False,8327046,"Spaichingen, Stadt",55 - 60 Jahre,676,332,344
False,8327046,"Spaichingen, Stadt",60 - 65 Jahre,850,418,432
False,8327046,"Spaichingen, Stadt",65 - 75 Jahre,1131,528,603
False,8327046,"Spaichingen, Stadt",75 und mehr Jahre,945,261,684
False,8327046,"Spaichingen, Stadt",Insgesamt,12252,5978,6274
False,8327048,Talheim,unter 3 Jahre,41,20,21
False,8327048,Talheim,3 -  6 Jahre,46,22,24
False,8327048,Talheim,6 - 10 Jahre,64,39,25
False,8327048,Talheim,10 - 15 Jahre,74,32,42
False,8327048,Talheim,15 - 18 Jahre,45,24,21
False,8327048,Talheim,18 - 20 Jahre,28,14,14
False,8327048,Talheim,20 - 25 Jahre,69,37,32
False,8327048,Talheim,25 - 30 Jahre,43,23,20
False,8327048,Talheim,30 - 35 Jahre,99,44,55
False,8327048,Talheim,35 - 40 Jahre,105,54,51
False,8327048,Talheim,40 - 45 Jahre,92,44,48
False,8327048,Talheim,45 - 50 Jahre,78,44,34
False,8327048,Talheim,50 - 55 Jahre,57,25,32
False,8327048,Talheim,55 - 60 Jahre,58,30,28
False,8327048,Talheim,60 - 65 Jahre,79,36,43
False,8327048,Talheim,65 - 75 Jahre,114,50,64
False,8327048,Talheim,75 und mehr Jahre,89,27,62
False,8327048,Talheim,Insgesamt,1181,565,616
False,8327049,"Trossingen, Stadt",unter 3 Jahre,530,286,244
False,8327049,"Trossingen, Stadt",3 -  6 Jahre,498,249,249
False,8327049,"Trossingen, Stadt",6 - 10 Jahre,672,324,348
False,8327049,"Trossingen, Stadt",10 - 15 Jahre,969,466,503
False,8327049,"Trossingen, Stadt",15 - 18 Jahre,557,291,266
False,8327049,"Trossingen, Stadt",18 - 20 Jahre,352,185,167
False,8327049,"Trossingen, Stadt",20 - 25 Jahre,899,436,463
False,8327049,"Trossingen, Stadt",25 - 30 Jahre,924,503,421
False,8327049,"Trossingen, Stadt",30 - 35 Jahre,1105,541,564
False,8327049,"Trossingen, Stadt",35 - 40 Jahre,1150,604,546
False,8327049,"Trossingen, Stadt",40 - 45 Jahre,1048,495,553
False,8327049,"Trossingen, Stadt",45 - 50 Jahre,1022,506,516
False,8327049,"Trossingen, Stadt",50 - 55 Jahre,815,404,411
False,8327049,"Trossingen, Stadt",55 - 60 Jahre,754,375,379
False,8327049,"Trossingen, Stadt",60 - 65 Jahre,957,448,509
False,8327049,"Trossingen, Stadt",65 - 75 Jahre,1383,649,734
False,8327049,"Trossingen, Stadt",75 und mehr Jahre,1140,352,788
False,8327049,"Trossingen, Stadt",Insgesamt,14775,7114,7661
False,8327050,"Tuttlingen, Stadt",unter 3 Jahre,1147,607,540
False,8327050,"Tuttlingen, Stadt",3 -  6 Jahre,1120,549,571
False,8327050,"Tuttlingen, Stadt",6 - 10 Jahre,1502,766,736
False,8327050,"Tuttlingen, Stadt",10 - 15 Jahre,2086,1023,1063
False,8327050,"Tuttlingen, Stadt",15 - 18 Jahre,1126,625,501
False,8327050,"Tuttlingen, Stadt",18 - 20 Jahre,857,438,419
False,8327050,"Tuttlingen, Stadt",20 - 25 Jahre,2033,1014,1019
False,8327050,"Tuttlingen, Stadt",25 - 30 Jahre,2178,1154,1024
False,8327050,"Tuttlingen, Stadt",30 - 35 Jahre,2763,1405,1358
False,8327050,"Tuttlingen, Stadt",35 - 40 Jahre,2681,1389,1292
False,8327050,"Tuttlingen, Stadt",40 - 45 Jahre,2560,1274,1286
False,8327050,"Tuttlingen, Stadt",45 - 50 Jahre,2144,1035,1109
False,8327050,"Tuttlingen, Stadt",50 - 55 Jahre,1965,940,1025
False,8327050,"Tuttlingen, Stadt",55 - 60 Jahre,2063,1030,1033
False,8327050,"Tuttlingen, Stadt",60 - 65 Jahre,2331,1123,1208
False,8327050,"Tuttlingen, Stadt",65 - 75 Jahre,3413,1558,1855
False,8327050,"Tuttlingen, Stadt",75 und mehr Jahre,2738,809,1929
False,8327050,"Tuttlingen, Stadt",Insgesamt,34707,16739,17968
False,8327051,Wehingen,unter 3 Jahre,142,72,70
False,8327051,Wehingen,3 -  6 Jahre,141,69,72
False,8327051,Wehingen,6 - 10 Jahre,189,102,87
False,8327051,Wehingen,10 - 15 Jahre,271,134,137
False,8327051,Wehingen,15 - 18 Jahre,156,79,77
False,8327051,Wehingen,18 - 20 Jahre,104,59,45
False,8327051,Wehingen,20 - 25 Jahre,262,129,133
False,8327051,Wehingen,25 - 30 Jahre,201,105,96
False,8327051,Wehingen,30 - 35 Jahre,276,140,136
False,8327051,Wehingen,35 - 40 Jahre,330,187,143
False,8327051,Wehingen,40 - 45 Jahre,259,127,132
False,8327051,Wehingen,45 - 50 Jahre,258,127,131
False,8327051,Wehingen,50 - 55 Jahre,220,111,109
False,8327051,Wehingen,55 - 60 Jahre,184,92,92
False,8327051,Wehingen,60 - 65 Jahre,250,131,119
False,8327051,Wehingen,65 - 75 Jahre,289,125,164
False,8327051,Wehingen,75 und mehr Jahre,177,55,122
False,8327051,Wehingen,Insgesamt,3709,1844,1865
False,8327054,Wurmlingen,unter 3 Jahre,125,66,59
False,8327054,Wurmlingen,3 -  6 Jahre,118,60,58
False,8327054,Wurmlingen,6 - 10 Jahre,156,71,85
False,8327054,Wurmlingen,10 - 15 Jahre,237,124,113
False,8327054,Wurmlingen,15 - 18 Jahre,141,71,70
False,8327054,Wurmlingen,18 - 20 Jahre,98,52,46
False,8327054,Wurmlingen,20 - 25 Jahre,176,95,81
False,8327054,Wurmlingen,25 - 30 Jahre,187,93,94
False,8327054,Wurmlingen,30 - 35 Jahre,282,136,146
False,8327054,Wurmlingen,35 - 40 Jahre,349,177,172
False,8327054,Wurmlingen,40 - 45 Jahre,307,161,146
False,8327054,Wurmlingen,45 - 50 Jahre,254,127,127
False,8327054,Wurmlingen,50 - 55 Jahre,221,122,99
False,8327054,Wurmlingen,55 - 60 Jahre,233,109,124
False,8327054,Wurmlingen,60 - 65 Jahre,297,146,151
False,8327054,Wurmlingen,65 - 75 Jahre,376,171,205
False,8327054,Wurmlingen,75 und mehr Jahre,232,80,152
False,8327054,Wurmlingen,Insgesamt,3789,1861,1928
False,8327055,Seitingen-Oberflacht,unter 3 Jahre,94,42,52
False,8327055,Seitingen-Oberflacht,3 -  6 Jahre,93,48,45
False,8327055,Seitingen-Oberflacht,6 - 10 Jahre,107,59,48
False,8327055,Seitingen-Oberflacht,10 - 15 Jahre,150,89,61
False,8327055,Seitingen-Oberflacht,15 - 18 Jahre,77,44,33
False,8327055,Seitingen-Oberflacht,18 - 20 Jahre,42,22,20
False,8327055,Seitingen-Oberflacht,20 - 25 Jahre,128,63,65
False,8327055,Seitingen-Oberflacht,25 - 30 Jahre,137,66,71
False,8327055,Seitingen-Oberflacht,30 - 35 Jahre,163,81,82
False,8327055,Seitingen-Oberflacht,35 - 40 Jahre,210,98,112
False,8327055,Seitingen-Oberflacht,40 - 45 Jahre,180,103,77
False,8327055,Seitingen-Oberflacht,45 - 50 Jahre,136,66,70
False,8327055,Seitingen-Oberflacht,50 - 55 Jahre,140,68,72
False,8327055,Seitingen-Oberflacht,55 - 60 Jahre,138,61,77
False,8327055,Seitingen-Oberflacht,60 - 65 Jahre,143,86,57
False,8327055,Seitingen-Oberflacht,65 - 75 Jahre,188,93,95
False,8327055,Seitingen-Oberflacht,75 und mehr Jahre,127,43,84
False,8327055,Seitingen-Oberflacht,Insgesamt,2253,1132,1121
False,8327056,Rietheim-Weilheim,unter 3 Jahre,78,32,46
False,8327056,Rietheim-Weilheim,3 -  6 Jahre,99,49,50
False,8327056,Rietheim-Weilheim,6 - 10 Jahre,102,49,53
False,8327056,Rietheim-Weilheim,10 - 15 Jahre,163,89,74
False,8327056,Rietheim-Weilheim,15 - 18 Jahre,89,34,55
False,8327056,Rietheim-Weilheim,18 - 20 Jahre,61,33,28
False,8327056,Rietheim-Weilheim,20 - 25 Jahre,118,71,47
False,8327056,Rietheim-Weilheim,25 - 30 Jahre,154,77,77
False,8327056,Rietheim-Weilheim,30 - 35 Jahre,223,112,111
False,8327056,Rietheim-Weilheim,35 - 40 Jahre,213,99,114
False,8327056,Rietheim-Weilheim,40 - 45 Jahre,206,98,108
False,8327056,Rietheim-Weilheim,45 - 50 Jahre,169,82,87
False,8327056,Rietheim-Weilheim,50 - 55 Jahre,139,67,72
False,8327056,Rietheim-Weilheim,55 - 60 Jahre,145,59,86
False,8327056,Rietheim-Weilheim,60 - 65 Jahre,164,87,77
False,8327056,Rietheim-Weilheim,65 - 75 Jahre,254,120,134
False,8327056,Rietheim-Weilheim,75 und mehr Jahre,175,76,99
False,8327056,Rietheim-Weilheim,Insgesamt,2552,1234,1318
False,8327057,Emmingen-Liptingen,unter 3 Jahre,169,101,68
False,8327057,Emmingen-Liptingen,3 -  6 Jahre,176,86,90
False,8327057,Emmingen-Liptingen,6 - 10 Jahre,211,104,107
False,8327057,Emmingen-Liptingen,10 - 15 Jahre,307,139,168
False,8327057,Emmingen-Liptingen,15 - 18 Jahre,137,67,70
False,8327057,Emmingen-Liptingen,18 - 20 Jahre,103,61,42
False,8327057,Emmingen-Liptingen,20 - 25 Jahre,224,103,121
False,8327057,Emmingen-Liptingen,25 - 30 Jahre,277,149,128
False,8327057,Emmingen-Liptingen,30 - 35 Jahre,371,190,181
False,8327057,Emmingen-Liptingen,35 - 40 Jahre,428,236,192
False,8327057,Emmingen-Liptingen,40 - 45 Jahre,378,201,177
False,8327057,Emmingen-Liptingen,45 - 50 Jahre,327,176,151
False,8327057,Emmingen-Liptingen,50 - 55 Jahre,250,138,112
False,8327057,Emmingen-Liptingen,55 - 60 Jahre,215,103,112
False,8327057,Emmingen-Liptingen,60 - 65 Jahre,263,132,131
False,8327057,Emmingen-Liptingen,65 - 75 Jahre,328,169,159
False,8327057,Emmingen-Liptingen,75 und mehr Jahre,237,81,156
False,8327057,Emmingen-Liptingen,Insgesamt,4401,2236,2165
False,8335,Landkreis Konstanz,unter 3 Jahre,7886,4017,3869
False,8335,Landkreis Konstanz,3 -  6 Jahre,8131,4149,3982
False,8335,Landkreis Konstanz,6 - 10 Jahre,11159,5755,5404
False,8335,Landkreis Konstanz,10 - 15 Jahre,14146,7114,7032
False,8335,Landkreis Konstanz,15 - 18 Jahre,7977,4015,3962
False,8335,Landkreis Konstanz,18 - 20 Jahre,5547,2768,2779
False,8335,Landkreis Konstanz,20 - 25 Jahre,16059,7939,8120
False,8335,Landkreis Konstanz,25 - 30 Jahre,16501,8364,8137
False,8335,Landkreis Konstanz,30 - 35 Jahre,22944,11497,11447
False,8335,Landkreis Konstanz,35 - 40 Jahre,24989,12859,12130
False,8335,Landkreis Konstanz,40 - 45 Jahre,20738,10662,10076
False,8335,Landkreis Konstanz,45 - 50 Jahre,17428,8754,8674
False,8335,Landkreis Konstanz,50 - 55 Jahre,15272,7614,7658
False,8335,Landkreis Konstanz,55 - 60 Jahre,15263,7526,7737
False,8335,Landkreis Konstanz,60 - 65 Jahre,17964,8822,9142
False,8335,Landkreis Konstanz,65 - 75 Jahre,24215,11184,13031
False,8335,Landkreis Konstanz,75 und mehr Jahre,19964,6082,13882
False,8335,Landkreis Konstanz,Insgesamt,266183,129121,137062
False,8335001,"Aach, Stadt",unter 3 Jahre,76,32,44
False,8335001,"Aach, Stadt",3 -  6 Jahre,78,53,25
False,8335001,"Aach, Stadt",6 - 10 Jahre,130,65,65
False,8335001,"Aach, Stadt",10 - 15 Jahre,125,66,59
False,8335001,"Aach, Stadt",15 - 18 Jahre,75,38,37
False,8335001,"Aach, Stadt",18 - 20 Jahre,48,30,18
False,8335001,"Aach, Stadt",20 - 25 Jahre,103,52,51
False,8335001,"Aach, Stadt",25 - 30 Jahre,121,60,61
False,8335001,"Aach, Stadt",30 - 35 Jahre,194,113,81
False,8335001,"Aach, Stadt",35 - 40 Jahre,220,116,104
False,8335001,"Aach, Stadt",40 - 45 Jahre,181,94,87
False,8335001,"Aach, Stadt",45 - 50 Jahre,155,77,78
False,8335001,"Aach, Stadt",50 - 55 Jahre,118,66,52
False,8335001,"Aach, Stadt",55 - 60 Jahre,77,38,39
False,8335001,"Aach, Stadt",60 - 65 Jahre,117,57,60
False,8335001,"Aach, Stadt",65 - 75 Jahre,179,89,90
False,8335001,"Aach, Stadt",75 und mehr Jahre,116,41,75
False,8335001,"Aach, Stadt",Insgesamt,2113,1087,1026
False,8335002,Allensbach,unter 3 Jahre,217,115,102
False,8335002,Allensbach,3 -  6 Jahre,225,113,112
False,8335002,Allensbach,6 - 10 Jahre,317,165,152
False,8335002,Allensbach,10 - 15 Jahre,368,176,192
False,8335002,Allensbach,15 - 18 Jahre,223,99,124
False,8335002,Allensbach,18 - 20 Jahre,155,66,89
False,8335002,Allensbach,20 - 25 Jahre,314,140,174
False,8335002,Allensbach,25 - 30 Jahre,414,191,223
False,8335002,Allensbach,30 - 35 Jahre,591,254,337
False,8335002,Allensbach,35 - 40 Jahre,708,345,363
False,8335002,Allensbach,40 - 45 Jahre,604,293,311
False,8335002,Allensbach,45 - 50 Jahre,507,260,247
False,8335002,Allensbach,50 - 55 Jahre,396,188,208
False,8335002,Allensbach,55 - 60 Jahre,471,234,237
False,8335002,Allensbach,60 - 65 Jahre,474,227,247
False,8335002,Allensbach,65 - 75 Jahre,545,216,329
False,8335002,Allensbach,75 und mehr Jahre,520,135,385
False,8335002,Allensbach,Insgesamt,7049,3217,3832
False,8335015,Büsingen am Hochrhein,unter 3 Jahre,37,16,21
False,8335015,Büsingen am Hochrhein,3 -  6 Jahre,44,24,20
False,8335015,Büsingen am Hochrhein,6 - 10 Jahre,59,35,24
False,8335015,Büsingen am Hochrhein,10 - 15 Jahre,95,41,54
False,8335015,Büsingen am Hochrhein,15 - 18 Jahre,45,22,23
False,8335015,Büsingen am Hochrhein,18 - 20 Jahre,18,11,7
False,8335015,Büsingen am Hochrhein,20 - 25 Jahre,69,28,41
False,8335015,Büsingen am Hochrhein,25 - 30 Jahre,91,48,43
False,8335015,Büsingen am Hochrhein,30 - 35 Jahre,115,57,58
False,8335015,Büsingen am Hochrhein,35 - 40 Jahre,123,64,59
False,8335015,Büsingen am Hochrhein,40 - 45 Jahre,96,42,54
False,8335015,Büsingen am Hochrhein,45 - 50 Jahre,106,54,52
False,8335015,Büsingen am Hochrhein,50 - 55 Jahre,90,36,54
False,8335015,Büsingen am Hochrhein,55 - 60 Jahre,74,36,38
False,8335015,Büsingen am Hochrhein,60 - 65 Jahre,118,58,60
False,8335015,Büsingen am Hochrhein,65 - 75 Jahre,169,75,94
False,8335015,Büsingen am Hochrhein,75 und mehr Jahre,130,62,68
False,8335015,Büsingen am Hochrhein,Insgesamt,1479,709,770
False,8335021,Eigeltingen,unter 3 Jahre,125,65,60
False,8335021,Eigeltingen,3 -  6 Jahre,139,67,72
False,8335021,Eigeltingen,6 - 10 Jahre,197,101,96
False,8335021,Eigeltingen,10 - 15 Jahre,210,120,90
False,8335021,Eigeltingen,15 - 18 Jahre,123,57,66
False,8335021,Eigeltingen,18 - 20 Jahre,68,41,27
False,8335021,Eigeltingen,20 - 25 Jahre,186,89,97
False,8335021,Eigeltingen,25 - 30 Jahre,166,78,88
False,8335021,Eigeltingen,30 - 35 Jahre,277,152,125
False,8335021,Eigeltingen,35 - 40 Jahre,280,138,142
False,8335021,Eigeltingen,40 - 45 Jahre,319,154,165
False,8335021,Eigeltingen,45 - 50 Jahre,227,122,105
False,8335021,Eigeltingen,50 - 55 Jahre,203,107,96
False,8335021,Eigeltingen,55 - 60 Jahre,176,87,89
False,8335021,Eigeltingen,60 - 65 Jahre,190,99,91
False,8335021,Eigeltingen,65 - 75 Jahre,288,133,155
False,8335021,Eigeltingen,75 und mehr Jahre,200,64,136
False,8335021,Eigeltingen,Insgesamt,3374,1674,1700
False,8335022,"Engen, Stadt",unter 3 Jahre,328,170,158
False,8335022,"Engen, Stadt",3 -  6 Jahre,356,176,180
False,8335022,"Engen, Stadt",6 - 10 Jahre,512,284,228
False,8335022,"Engen, Stadt",10 - 15 Jahre,621,324,297
False,8335022,"Engen, Stadt",15 - 18 Jahre,310,171,139
False,8335022,"Engen, Stadt",18 - 20 Jahre,233,106,127
False,8335022,"Engen, Stadt",20 - 25 Jahre,486,220,266
False,8335022,"Engen, Stadt",25 - 30 Jahre,554,255,299
False,8335022,"Engen, Stadt",30 - 35 Jahre,775,382,393
False,8335022,"Engen, Stadt",35 - 40 Jahre,901,474,427
False,8335022,"Engen, Stadt",40 - 45 Jahre,770,401,369
False,8335022,"Engen, Stadt",45 - 50 Jahre,646,326,320
False,8335022,"Engen, Stadt",50 - 55 Jahre,565,278,287
False,8335022,"Engen, Stadt",55 - 60 Jahre,531,260,271
False,8335022,"Engen, Stadt",60 - 65 Jahre,697,346,351
False,8335022,"Engen, Stadt",65 - 75 Jahre,951,428,523
False,8335022,"Engen, Stadt",75 und mehr Jahre,688,198,490
False,8335022,"Engen, Stadt",Insgesamt,9924,4799,5125
False,8335025,Gaienhofen,unter 3 Jahre,72,30,42
False,8335025,Gaienhofen,3 -  6 Jahre,71,38,33
False,8335025,Gaienhofen,6 - 10 Jahre,102,64,38
False,8335025,Gaienhofen,10 - 15 Jahre,182,88,94
False,8335025,Gaienhofen,15 - 18 Jahre,114,48,66
False,8335025,Gaienhofen,18 - 20 Jahre,75,39,36
False,8335025,Gaienhofen,20 - 25 Jahre,175,102,73
False,8335025,Gaienhofen,25 - 30 Jahre,157,80,77
False,8335025,Gaienhofen,30 - 35 Jahre,209,99,110
False,8335025,Gaienhofen,35 - 40 Jahre,215,111,104
False,8335025,Gaienhofen,40 - 45 Jahre,224,85,139
False,8335025,Gaienhofen,45 - 50 Jahre,243,122,121
False,8335025,Gaienhofen,50 - 55 Jahre,233,122,111
False,8335025,Gaienhofen,55 - 60 Jahre,205,88,117
False,8335025,Gaienhofen,60 - 65 Jahre,243,120,123
False,8335025,Gaienhofen,65 - 75 Jahre,294,146,148
False,8335025,Gaienhofen,75 und mehr Jahre,246,83,163
False,8335025,Gaienhofen,Insgesamt,3060,1465,1595
False,8335026,Gailingen am Hochrhein,unter 3 Jahre,60,29,31
False,8335026,Gailingen am Hochrhein,3 -  6 Jahre,66,33,33
False,8335026,Gailingen am Hochrhein,6 - 10 Jahre,111,58,53
False,8335026,Gailingen am Hochrhein,10 - 15 Jahre,132,60,72
False,8335026,Gailingen am Hochrhein,15 - 18 Jahre,77,33,44
False,8335026,Gailingen am Hochrhein,18 - 20 Jahre,52,23,29
False,8335026,Gailingen am Hochrhein,20 - 25 Jahre,147,59,88
False,8335026,Gailingen am Hochrhein,25 - 30 Jahre,229,129,100
False,8335026,Gailingen am Hochrhein,30 - 35 Jahre,319,190,129
False,8335026,Gailingen am Hochrhein,35 - 40 Jahre,204,90,114
False,8335026,Gailingen am Hochrhein,40 - 45 Jahre,222,108,114
False,8335026,Gailingen am Hochrhein,45 - 50 Jahre,177,88,89
False,8335026,Gailingen am Hochrhein,50 - 55 Jahre,144,74,70
False,8335026,Gailingen am Hochrhein,55 - 60 Jahre,166,82,84
False,8335026,Gailingen am Hochrhein,60 - 65 Jahre,194,91,103
False,8335026,Gailingen am Hochrhein,65 - 75 Jahre,256,122,134
False,8335026,Gailingen am Hochrhein,75 und mehr Jahre,233,84,149
False,8335026,Gailingen am Hochrhein,Insgesamt,2789,1353,1436
False,8335028,Gottmadingen,unter 3 Jahre,329,171,158
False,8335028,Gottmadingen,3 -  6 Jahre,358,206,152
False,8335028,Gottmadingen,6 - 10 Jahre,486,248,238
False,8335028,Gottmadingen,10 - 15 Jahre,576,302,274
False,8335028,Gottmadingen,15 - 18 Jahre,301,166,135
False,8335028,Gottmadingen,18 - 20 Jahre,191,104,87
False,8335028,Gottmadingen,20 - 25 Jahre,496,251,245
False,8335028,Gottmadingen,25 - 30 Jahre,563,267,296
False,8335028,Gottmadingen,30 - 35 Jahre,823,406,417
False,8335028,Gottmadingen,35 - 40 Jahre,904,441,463
False,8335028,Gottmadingen,40 - 45 Jahre,757,394,363
False,8335028,Gottmadingen,45 - 50 Jahre,578,303,275
False,8335028,Gottmadingen,50 - 55 Jahre,569,277,292
False,8335028,Gottmadingen,55 - 60 Jahre,564,276,288
False,8335028,Gottmadingen,60 - 65 Jahre,714,359,355
False,8335028,Gottmadingen,65 - 75 Jahre,1035,473,562
False,8335028,Gottmadingen,75 und mehr Jahre,789,258,531
False,8335028,Gottmadingen,Insgesamt,10033,4902,5131
False,8335035,Hilzingen,unter 3 Jahre,267,135,132
False,8335035,Hilzingen,3 -  6 Jahre,309,148,161
False,8335035,Hilzingen,6 - 10 Jahre,402,204,198
False,8335035,Hilzingen,10 - 15 Jahre,526,271,255
False,8335035,Hilzingen,15 - 18 Jahre,256,140,116
False,8335035,Hilzingen,18 - 20 Jahre,157,86,71
False,8335035,Hilzingen,20 - 25 Jahre,413,225,188
False,8335035,Hilzingen,25 - 30 Jahre,464,221,243
False,8335035,Hilzingen,30 - 35 Jahre,718,345,373
False,8335035,Hilzingen,35 - 40 Jahre,834,418,416
False,8335035,Hilzingen,40 - 45 Jahre,627,322,305
False,8335035,Hilzingen,45 - 50 Jahre,552,279,273
False,8335035,Hilzingen,50 - 55 Jahre,471,242,229
False,8335035,Hilzingen,55 - 60 Jahre,441,212,229
False,8335035,Hilzingen,60 - 65 Jahre,529,260,269
False,8335035,Hilzingen,65 - 75 Jahre,637,317,320
False,8335035,Hilzingen,75 und mehr Jahre,408,147,261
False,8335035,Hilzingen,Insgesamt,8011,3972,4039
False,8335043,"Konstanz, Universitätsstadt",unter 3 Jahre,2075,1062,1013
False,8335043,"Konstanz, Universitätsstadt",3 -  6 Jahre,2000,1013,987
False,8335043,"Konstanz, Universitätsstadt",6 - 10 Jahre,2562,1301,1261
False,8335043,"Konstanz, Universitätsstadt",10 - 15 Jahre,3345,1689,1656
False,8335043,"Konstanz, Universitätsstadt",15 - 18 Jahre,1852,917,935
False,8335043,"Konstanz, Universitätsstadt",18 - 20 Jahre,1527,698,829
False,8335043,"Konstanz, Universitätsstadt",20 - 25 Jahre,6741,3166,3575
False,8335043,"Konstanz, Universitätsstadt",25 - 30 Jahre,6073,3246,2827
False,8335043,"Konstanz, Universitätsstadt",30 - 35 Jahre,7602,3868,3734
False,8335043,"Konstanz, Universitätsstadt",35 - 40 Jahre,8096,4299,3797
False,8335043,"Konstanz, Universitätsstadt",40 - 45 Jahre,5886,3051,2835
False,8335043,"Konstanz, Universitätsstadt",45 - 50 Jahre,4637,2279,2358
False,8335043,"Konstanz, Universitätsstadt",50 - 55 Jahre,4108,2019,2089
False,8335043,"Konstanz, Universitätsstadt",55 - 60 Jahre,4524,2193,2331
False,8335043,"Konstanz, Universitätsstadt",60 - 65 Jahre,4956,2408,2548
False,8335043,"Konstanz, Universitätsstadt",65 - 75 Jahre,6469,2925,3544
False,8335043,"Konstanz, Universitätsstadt",75 und mehr Jahre,6051,1799,4252
False,8335043,"Konstanz, Universitätsstadt",Insgesamt,78504,37933,40571
False,8335055,Moos,unter 3 Jahre,100,47,53
False,8335055,Moos,3 -  6 Jahre,107,55,52
False,8335055,Moos,6 - 10 Jahre,160,84,76
False,8335055,Moos,10 - 15 Jahre,185,104,81
False,8335055,Moos,15 - 18 Jahre,101,52,49
False,8335055,Moos,18 - 20 Jahre,68,36,32
False,8335055,Moos,20 - 25 Jahre,134,69,65
False,8335055,Moos,25 - 30 Jahre,153,69,84
False,8335055,Moos,30 - 35 Jahre,266,130,136
False,8335055,Moos,35 - 40 Jahre,337,180,157
False,8335055,Moos,40 - 45 Jahre,287,129,158
False,8335055,Moos,45 - 50 Jahre,249,139,110
False,8335055,Moos,50 - 55 Jahre,216,103,113
False,8335055,Moos,55 - 60 Jahre,189,104,85
False,8335055,Moos,60 - 65 Jahre,196,102,94
False,8335055,Moos,65 - 75 Jahre,245,115,130
False,8335055,Moos,75 und mehr Jahre,195,69,126
False,8335055,Moos,Insgesamt,3188,1587,1601
False,8335057,Mühlingen,unter 3 Jahre,97,51,46
False,8335057,Mühlingen,3 -  6 Jahre,114,56,58
False,8335057,Mühlingen,6 - 10 Jahre,97,48,49
False,8335057,Mühlingen,10 - 15 Jahre,153,77,76
False,8335057,Mühlingen,15 - 18 Jahre,99,56,43
False,8335057,Mühlingen,18 - 20 Jahre,49,26,23
False,8335057,Mühlingen,20 - 25 Jahre,121,66,55
False,8335057,Mühlingen,25 - 30 Jahre,126,55,71
False,8335057,Mühlingen,30 - 35 Jahre,193,102,91
False,8335057,Mühlingen,35 - 40 Jahre,218,114,104
False,8335057,Mühlingen,40 - 45 Jahre,185,93,92
False,8335057,Mühlingen,45 - 50 Jahre,143,73,70
False,8335057,Mühlingen,50 - 55 Jahre,108,64,44
False,8335057,Mühlingen,55 - 60 Jahre,87,46,41
False,8335057,Mühlingen,60 - 65 Jahre,126,61,65
False,8335057,Mühlingen,65 - 75 Jahre,187,90,97
False,8335057,Mühlingen,75 und mehr Jahre,126,38,88
False,8335057,Mühlingen,Insgesamt,2229,1116,1113
False,8335061,Öhningen,unter 3 Jahre,94,40,54
False,8335061,Öhningen,3 -  6 Jahre,99,53,46
False,8335061,Öhningen,6 - 10 Jahre,149,80,69
False,8335061,Öhningen,10 - 15 Jahre,197,100,97
False,8335061,Öhningen,15 - 18 Jahre,108,59,49
False,8335061,Öhningen,18 - 20 Jahre,73,42,31
False,8335061,Öhningen,20 - 25 Jahre,147,79,68
False,8335061,Öhningen,25 - 30 Jahre,157,77,80
False,8335061,Öhningen,30 - 35 Jahre,247,126,121
False,8335061,Öhningen,35 - 40 Jahre,349,186,163
False,8335061,Öhningen,40 - 45 Jahre,253,121,132
False,8335061,Öhningen,45 - 50 Jahre,236,123,113
False,8335061,Öhningen,50 - 55 Jahre,213,104,109
False,8335061,Öhningen,55 - 60 Jahre,242,121,121
False,8335061,Öhningen,60 - 65 Jahre,279,147,132
False,8335061,Öhningen,65 - 75 Jahre,403,198,205
False,8335061,Öhningen,75 und mehr Jahre,320,112,208
False,8335061,Öhningen,Insgesamt,3566,1768,1798
False,8335063,"Radolfzell am Bodensee, Stadt",unter 3 Jahre,811,421,390
False,8335063,"Radolfzell am Bodensee, Stadt",3 -  6 Jahre,847,438,409
False,8335063,"Radolfzell am Bodensee, Stadt",6 - 10 Jahre,1231,616,615
False,8335063,"Radolfzell am Bodensee, Stadt",10 - 15 Jahre,1554,804,750
False,8335063,"Radolfzell am Bodensee, Stadt",15 - 18 Jahre,868,443,425
False,8335063,"Radolfzell am Bodensee, Stadt",18 - 20 Jahre,589,307,282
False,8335063,"Radolfzell am Bodensee, Stadt",20 - 25 Jahre,1405,730,675
False,8335063,"Radolfzell am Bodensee, Stadt",25 - 30 Jahre,1613,796,817
False,8335063,"Radolfzell am Bodensee, Stadt",30 - 35 Jahre,2458,1230,1228
False,8335063,"Radolfzell am Bodensee, Stadt",35 - 40 Jahre,2734,1349,1385
False,8335063,"Radolfzell am Bodensee, Stadt",40 - 45 Jahre,2301,1196,1105
False,8335063,"Radolfzell am Bodensee, Stadt",45 - 50 Jahre,2106,1055,1051
False,8335063,"Radolfzell am Bodensee, Stadt",50 - 55 Jahre,1777,899,878
False,8335063,"Radolfzell am Bodensee, Stadt",55 - 60 Jahre,1812,906,906
False,8335063,"Radolfzell am Bodensee, Stadt",60 - 65 Jahre,1960,960,1000
False,8335063,"Radolfzell am Bodensee, Stadt",65 - 75 Jahre,2494,1149,1345
False,8335063,"Radolfzell am Bodensee, Stadt",75 und mehr Jahre,2302,678,1624
False,8335063,"Radolfzell am Bodensee, Stadt",Insgesamt,28862,13977,14885
False,8335066,Reichenau,unter 3 Jahre,170,87,83
False,8335066,Reichenau,3 -  6 Jahre,172,87,85
False,8335066,Reichenau,6 - 10 Jahre,252,139,113
False,8335066,Reichenau,10 - 15 Jahre,272,142,130
False,8335066,Reichenau,15 - 18 Jahre,159,78,81
False,8335066,Reichenau,18 - 20 Jahre,117,44,73
False,8335066,Reichenau,20 - 25 Jahre,275,127,148
False,8335066,Reichenau,25 - 30 Jahre,313,153,160
False,8335066,Reichenau,30 - 35 Jahre,480,238,242
False,8335066,Reichenau,35 - 40 Jahre,520,266,254
False,8335066,Reichenau,40 - 45 Jahre,442,234,208
False,8335066,Reichenau,45 - 50 Jahre,327,168,159
False,8335066,Reichenau,50 - 55 Jahre,294,154,140
False,8335066,Reichenau,55 - 60 Jahre,240,122,118
False,8335066,Reichenau,60 - 65 Jahre,284,149,135
False,8335066,Reichenau,65 - 75 Jahre,447,206,241
False,8335066,Reichenau,75 und mehr Jahre,330,106,224
False,8335066,Reichenau,Insgesamt,5094,2500,2594
False,8335075,"Singen (Hohentwiel), Stadt",unter 3 Jahre,1393,710,683
False,8335075,"Singen (Hohentwiel), Stadt",3 -  6 Jahre,1406,704,702
False,8335075,"Singen (Hohentwiel), Stadt",6 - 10 Jahre,1973,993,980
False,8335075,"Singen (Hohentwiel), Stadt",10 - 15 Jahre,2299,1115,1184
False,8335075,"Singen (Hohentwiel), Stadt",15 - 18 Jahre,1383,707,676
False,8335075,"Singen (Hohentwiel), Stadt",18 - 20 Jahre,903,455,448
False,8335075,"Singen (Hohentwiel), Stadt",20 - 25 Jahre,2322,1203,1119
False,8335075,"Singen (Hohentwiel), Stadt",25 - 30 Jahre,2504,1299,1205
False,8335075,"Singen (Hohentwiel), Stadt",30 - 35 Jahre,3431,1673,1758
False,8335075,"Singen (Hohentwiel), Stadt",35 - 40 Jahre,3629,1856,1773
False,8335075,"Singen (Hohentwiel), Stadt",40 - 45 Jahre,3263,1735,1528
False,8335075,"Singen (Hohentwiel), Stadt",45 - 50 Jahre,2915,1450,1465
False,8335075,"Singen (Hohentwiel), Stadt",50 - 55 Jahre,2612,1298,1314
False,8335075,"Singen (Hohentwiel), Stadt",55 - 60 Jahre,2684,1306,1378
False,8335075,"Singen (Hohentwiel), Stadt",60 - 65 Jahre,3339,1638,1701
False,8335075,"Singen (Hohentwiel), Stadt",65 - 75 Jahre,4959,2249,2710
False,8335075,"Singen (Hohentwiel), Stadt",75 und mehr Jahre,3718,1124,2594
False,8335075,"Singen (Hohentwiel), Stadt",Insgesamt,44733,21515,23218
False,8335077,Steißlingen,unter 3 Jahre,170,84,86
False,8335077,Steißlingen,3 -  6 Jahre,162,85,77
False,8335077,Steißlingen,6 - 10 Jahre,215,121,94
False,8335077,Steißlingen,10 - 15 Jahre,273,141,132
False,8335077,Steißlingen,15 - 18 Jahre,122,58,64
False,8335077,Steißlingen,18 - 20 Jahre,78,40,38
False,8335077,Steißlingen,20 - 25 Jahre,174,101,73
False,8335077,Steißlingen,25 - 30 Jahre,251,117,134
False,8335077,Steißlingen,30 - 35 Jahre,404,210,194
False,8335077,Steißlingen,35 - 40 Jahre,406,211,195
False,8335077,Steißlingen,40 - 45 Jahre,370,195,175
False,8335077,Steißlingen,45 - 50 Jahre,252,143,109
False,8335077,Steißlingen,50 - 55 Jahre,245,127,118
False,8335077,Steißlingen,55 - 60 Jahre,219,110,109
False,8335077,Steißlingen,60 - 65 Jahre,310,147,163
False,8335077,Steißlingen,65 - 75 Jahre,352,170,182
False,8335077,Steißlingen,75 und mehr Jahre,245,83,162
False,8335077,Steißlingen,Insgesamt,4248,2143,2105
False,8335079,"Stockach, Stadt",unter 3 Jahre,477,252,225
False,8335079,"Stockach, Stadt",3 -  6 Jahre,531,270,261
False,8335079,"Stockach, Stadt",6 - 10 Jahre,773,412,361
False,8335079,"Stockach, Stadt",10 - 15 Jahre,1109,545,564
False,8335079,"Stockach, Stadt",15 - 18 Jahre,725,353,372
False,8335079,"Stockach, Stadt",18 - 20 Jahre,470,257,213
False,8335079,"Stockach, Stadt",20 - 25 Jahre,826,433,393
False,8335079,"Stockach, Stadt",25 - 30 Jahre,888,411,477
False,8335079,"Stockach, Stadt",30 - 35 Jahre,1232,610,622
False,8335079,"Stockach, Stadt",35 - 40 Jahre,1383,683,700
False,8335079,"Stockach, Stadt",40 - 45 Jahre,1372,679,693
False,8335079,"Stockach, Stadt",45 - 50 Jahre,1203,595,608
False,8335079,"Stockach, Stadt",50 - 55 Jahre,1020,522,498
False,8335079,"Stockach, Stadt",55 - 60 Jahre,834,422,412
False,8335079,"Stockach, Stadt",60 - 65 Jahre,1070,542,528
False,8335079,"Stockach, Stadt",65 - 75 Jahre,1347,617,730
False,8335079,"Stockach, Stadt",75 und mehr Jahre,1201,350,851
False,8335079,"Stockach, Stadt",Insgesamt,16461,7953,8508
False,8335080,"Tengen, Stadt",unter 3 Jahre,136,62,74
False,8335080,"Tengen, Stadt",3 -  6 Jahre,164,79,85
False,8335080,"Tengen, Stadt",6 - 10 Jahre,227,125,102
False,8335080,"Tengen, Stadt",10 - 15 Jahre,318,158,160
False,8335080,"Tengen, Stadt",15 - 18 Jahre,178,83,95
False,8335080,"Tengen, Stadt",18 - 20 Jahre,100,50,50
False,8335080,"Tengen, Stadt",20 - 25 Jahre,171,89,82
False,8335080,"Tengen, Stadt",25 - 30 Jahre,174,83,91
False,8335080,"Tengen, Stadt",30 - 35 Jahre,387,201,186
False,8335080,"Tengen, Stadt",35 - 40 Jahre,458,241,217
False,8335080,"Tengen, Stadt",40 - 45 Jahre,362,181,181
False,8335080,"Tengen, Stadt",45 - 50 Jahre,305,159,146
False,8335080,"Tengen, Stadt",50 - 55 Jahre,222,117,105
False,8335080,"Tengen, Stadt",55 - 60 Jahre,190,99,91
False,8335080,"Tengen, Stadt",60 - 65 Jahre,307,154,153
False,8335080,"Tengen, Stadt",65 - 75 Jahre,500,244,256
False,8335080,"Tengen, Stadt",75 und mehr Jahre,446,122,324
False,8335080,"Tengen, Stadt",Insgesamt,4645,2247,2398
False,8335081,Volkertshausen,unter 3 Jahre,84,45,39
False,8335081,Volkertshausen,3 -  6 Jahre,103,60,43
False,8335081,Volkertshausen,6 - 10 Jahre,153,86,67
False,8335081,Volkertshausen,10 - 15 Jahre,202,97,105
False,8335081,Volkertshausen,15 - 18 Jahre,105,59,46
False,8335081,Volkertshausen,18 - 20 Jahre,57,33,24
False,8335081,Volkertshausen,20 - 25 Jahre,140,71,69
False,8335081,Volkertshausen,25 - 30 Jahre,127,61,66
False,8335081,Volkertshausen,30 - 35 Jahre,221,109,112
False,8335081,Volkertshausen,35 - 40 Jahre,271,144,127
False,8335081,Volkertshausen,40 - 45 Jahre,244,132,112
False,8335081,Volkertshausen,45 - 50 Jahre,193,93,100
False,8335081,Volkertshausen,50 - 55 Jahre,157,83,74
False,8335081,Volkertshausen,55 - 60 Jahre,126,62,64
False,8335081,Volkertshausen,60 - 65 Jahre,153,69,84
False,8335081,Volkertshausen,65 - 75 Jahre,217,108,109
False,8335081,Volkertshausen,75 und mehr Jahre,154,53,101
False,8335081,Volkertshausen,Insgesamt,2707,1365,1342
False,8335096,Hohenfels,unter 3 Jahre,56,26,30
False,8335096,Hohenfels,3 -  6 Jahre,59,29,30
False,8335096,Hohenfels,6 - 10 Jahre,97,48,49
False,8335096,Hohenfels,10 - 15 Jahre,127,69,58
False,8335096,Hohenfels,15 - 18 Jahre,71,32,39
False,8335096,Hohenfels,18 - 20 Jahre,54,25,29
False,8335096,Hohenfels,20 - 25 Jahre,125,75,50
False,8335096,Hohenfels,25 - 30 Jahre,118,60,58
False,8335096,Hohenfels,30 - 35 Jahre,136,71,65
False,8335096,Hohenfels,35 - 40 Jahre,147,78,69
False,8335096,Hohenfels,40 - 45 Jahre,147,72,75
False,8335096,Hohenfels,45 - 50 Jahre,114,55,59
False,8335096,Hohenfels,50 - 55 Jahre,133,67,66
False,8335096,Hohenfels,55 - 60 Jahre,117,65,52
False,8335096,Hohenfels,60 - 65 Jahre,119,68,51
False,8335096,Hohenfels,65 - 75 Jahre,148,76,72
False,8335096,Hohenfels,75 und mehr Jahre,96,26,70
False,8335096,Hohenfels,Insgesamt,1864,942,922
False,8335097,Mühlhausen-Ehingen,unter 3 Jahre,118,65,53
False,8335097,Mühlhausen-Ehingen,3 -  6 Jahre,127,71,56
False,8335097,Mühlhausen-Ehingen,6 - 10 Jahre,188,97,91
False,8335097,Mühlhausen-Ehingen,10 - 15 Jahre,256,130,126
False,8335097,Mühlhausen-Ehingen,15 - 18 Jahre,139,76,63
False,8335097,Mühlhausen-Ehingen,18 - 20 Jahre,87,44,43
False,8335097,Mühlhausen-Ehingen,20 - 25 Jahre,172,87,85
False,8335097,Mühlhausen-Ehingen,25 - 30 Jahre,192,96,96
False,8335097,Mühlhausen-Ehingen,30 - 35 Jahre,302,154,148
False,8335097,Mühlhausen-Ehingen,35 - 40 Jahre,333,174,159
False,8335097,Mühlhausen-Ehingen,40 - 45 Jahre,322,162,160
False,8335097,Mühlhausen-Ehingen,45 - 50 Jahre,260,128,132
False,8335097,Mühlhausen-Ehingen,50 - 55 Jahre,214,109,105
False,8335097,Mühlhausen-Ehingen,55 - 60 Jahre,196,102,94
False,8335097,Mühlhausen-Ehingen,60 - 65 Jahre,237,118,119
False,8335097,Mühlhausen-Ehingen,65 - 75 Jahre,313,163,150
False,8335097,Mühlhausen-Ehingen,75 und mehr Jahre,185,66,119
False,8335097,Mühlhausen-Ehingen,Insgesamt,3641,1842,1799
False,8335098,Bodman-Ludwigshafen,unter 3 Jahre,111,54,57
False,8335098,Bodman-Ludwigshafen,3 -  6 Jahre,89,40,49
False,8335098,Bodman-Ludwigshafen,6 - 10 Jahre,114,51,63
False,8335098,Bodman-Ludwigshafen,10 - 15 Jahre,178,85,93
False,8335098,Bodman-Ludwigshafen,15 - 18 Jahre,104,49,55
False,8335098,Bodman-Ludwigshafen,18 - 20 Jahre,75,35,40
False,8335098,Bodman-Ludwigshafen,20 - 25 Jahre,177,88,89
False,8335098,Bodman-Ludwigshafen,25 - 30 Jahre,212,112,100
False,8335098,Bodman-Ludwigshafen,30 - 35 Jahre,295,137,158
False,8335098,Bodman-Ludwigshafen,35 - 40 Jahre,326,168,158
False,8335098,Bodman-Ludwigshafen,40 - 45 Jahre,287,162,125
False,8335098,Bodman-Ludwigshafen,45 - 50 Jahre,298,149,149
False,8335098,Bodman-Ludwigshafen,50 - 55 Jahre,285,144,141
False,8335098,Bodman-Ludwigshafen,55 - 60 Jahre,248,135,113
False,8335098,Bodman-Ludwigshafen,60 - 65 Jahre,323,137,186
False,8335098,Bodman-Ludwigshafen,65 - 75 Jahre,416,208,208
False,8335098,Bodman-Ludwigshafen,75 und mehr Jahre,426,124,302
False,8335098,Bodman-Ludwigshafen,Insgesamt,3964,1878,2086
False,8335099,Orsingen-Nenzingen,unter 3 Jahre,125,66,59
False,8335099,Orsingen-Nenzingen,3 -  6 Jahre,123,63,60
False,8335099,Orsingen-Nenzingen,6 - 10 Jahre,153,79,74
False,8335099,Orsingen-Nenzingen,10 - 15 Jahre,196,95,101
False,8335099,Orsingen-Nenzingen,15 - 18 Jahre,92,47,45
False,8335099,Orsingen-Nenzingen,18 - 20 Jahre,51,28,23
False,8335099,Orsingen-Nenzingen,20 - 25 Jahre,141,71,70
False,8335099,Orsingen-Nenzingen,25 - 30 Jahre,166,74,92
False,8335099,Orsingen-Nenzingen,30 - 35 Jahre,276,140,136
False,8335099,Orsingen-Nenzingen,35 - 40 Jahre,306,155,151
False,8335099,Orsingen-Nenzingen,40 - 45 Jahre,250,144,106
False,8335099,Orsingen-Nenzingen,45 - 50 Jahre,172,86,86
False,8335099,Orsingen-Nenzingen,50 - 55 Jahre,166,94,72
False,8335099,Orsingen-Nenzingen,55 - 60 Jahre,135,68,67
False,8335099,Orsingen-Nenzingen,60 - 65 Jahre,181,86,95
False,8335099,Orsingen-Nenzingen,65 - 75 Jahre,245,125,120
False,8335099,Orsingen-Nenzingen,75 und mehr Jahre,129,36,93
False,8335099,Orsingen-Nenzingen,Insgesamt,2907,1457,1450
False,8335100,Rielasingen-Worblingen,unter 3 Jahre,358,182,176
False,8335100,Rielasingen-Worblingen,3 -  6 Jahre,382,188,194
False,8335100,Rielasingen-Worblingen,6 - 10 Jahre,499,251,248
False,8335100,Rielasingen-Worblingen,10 - 15 Jahre,647,315,332
False,8335100,Rielasingen-Worblingen,15 - 18 Jahre,347,172,175
False,8335100,Rielasingen-Worblingen,18 - 20 Jahre,252,142,110
False,8335100,Rielasingen-Worblingen,20 - 25 Jahre,599,318,281
False,8335100,Rielasingen-Worblingen,25 - 30 Jahre,675,326,349
False,8335100,Rielasingen-Worblingen,30 - 35 Jahre,993,500,493
False,8335100,Rielasingen-Worblingen,35 - 40 Jahre,1087,558,529
False,8335100,Rielasingen-Worblingen,40 - 45 Jahre,967,483,484
False,8335100,Rielasingen-Worblingen,45 - 50 Jahre,827,428,399
False,8335100,Rielasingen-Worblingen,50 - 55 Jahre,713,320,393
False,8335100,Rielasingen-Worblingen,55 - 60 Jahre,715,352,363
False,8335100,Rielasingen-Worblingen,60 - 65 Jahre,848,419,429
False,8335100,Rielasingen-Worblingen,65 - 75 Jahre,1119,542,577
False,8335100,Rielasingen-Worblingen,75 und mehr Jahre,710,224,486
False,8335100,Rielasingen-Worblingen,Insgesamt,11738,5720,6018
False,8336,Landkreis Lörrach,unter 3 Jahre,6663,3386,3277
False,8336,Landkreis Lörrach,3 -  6 Jahre,7362,3826,3536
False,8336,Landkreis Lörrach,6 - 10 Jahre,10336,5321,5015
False,8336,Landkreis Lörrach,10 - 15 Jahre,13239,6748,6491
False,8336,Landkreis Lörrach,15 - 18 Jahre,7325,3768,3557
False,8336,Landkreis Lörrach,18 - 20 Jahre,4968,2472,2496
False,8336,Landkreis Lörrach,20 - 25 Jahre,10808,5431,5377
False,8336,Landkreis Lörrach,25 - 30 Jahre,12025,5926,6099
False,8336,Landkreis Lörrach,30 - 35 Jahre,17884,9051,8833
False,8336,Landkreis Lörrach,35 - 40 Jahre,19771,9862,9909
False,8336,Landkreis Lörrach,40 - 45 Jahre,17730,8933,8797
False,8336,Landkreis Lörrach,45 - 50 Jahre,14802,7586,7216
False,8336,Landkreis Lörrach,50 - 55 Jahre,12544,6271,6273
False,8336,Landkreis Lörrach,55 - 60 Jahre,11951,5910,6041
False,8336,Landkreis Lörrach,60 - 65 Jahre,14561,7088,7473
False,8336,Landkreis Lörrach,65 - 75 Jahre,20398,9548,10850
False,8336,Landkreis Lörrach,75 und mehr Jahre,14808,4478,10330
False,8336,Landkreis Lörrach,Insgesamt,217175,105605,111570
False,8336004,Aitern,unter 3 Jahre,17,11,6
False,8336004,Aitern,3 -  6 Jahre,35,22,13
False,8336004,Aitern,6 - 10 Jahre,32,20,12
False,8336004,Aitern,10 - 15 Jahre,35,23,12
False,8336004,Aitern,15 - 18 Jahre,20,7,13
False,8336004,Aitern,18 - 20 Jahre,20,10,10
False,8336004,Aitern,20 - 25 Jahre,35,23,12
False,8336004,Aitern,25 - 30 Jahre,40,20,20
False,8336004,Aitern,30 - 35 Jahre,47,21,26
False,8336004,Aitern,35 - 40 Jahre,56,31,25
False,8336004,Aitern,40 - 45 Jahre,40,19,21
False,8336004,Aitern,45 - 50 Jahre,34,19,15
False,8336004,Aitern,50 - 55 Jahre,31,17,14
False,8336004,Aitern,55 - 60 Jahre,25,12,13
False,8336004,Aitern,60 - 65 Jahre,36,15,21
False,8336004,Aitern,65 - 75 Jahre,51,23,28
False,8336004,Aitern,75 und mehr Jahre,32,15,17
False,8336004,Aitern,Insgesamt,586,308,278
False,8336006,Bad Bellingen,unter 3 Jahre,112,59,53
False,8336006,Bad Bellingen,3 -  6 Jahre,117,63,54
False,8336006,Bad Bellingen,6 - 10 Jahre,169,82,87
False,8336006,Bad Bellingen,10 - 15 Jahre,199,93,106
False,8336006,Bad Bellingen,15 - 18 Jahre,108,56,52
False,8336006,Bad Bellingen,18 - 20 Jahre,88,55,33
False,8336006,Bad Bellingen,20 - 25 Jahre,183,89,94
False,8336006,Bad Bellingen,25 - 30 Jahre,174,92,82
False,8336006,Bad Bellingen,30 - 35 Jahre,289,137,152
False,8336006,Bad Bellingen,35 - 40 Jahre,329,169,160
False,8336006,Bad Bellingen,40 - 45 Jahre,302,147,155
False,8336006,Bad Bellingen,45 - 50 Jahre,270,143,127
False,8336006,Bad Bellingen,50 - 55 Jahre,223,118,105
False,8336006,Bad Bellingen,55 - 60 Jahre,182,69,113
False,8336006,Bad Bellingen,60 - 65 Jahre,274,139,135
False,8336006,Bad Bellingen,65 - 75 Jahre,385,173,212
False,8336006,Bad Bellingen,75 und mehr Jahre,343,108,235
False,8336006,Bad Bellingen,Insgesamt,3747,1792,1955
False,8336008,Binzen,unter 3 Jahre,82,47,35
False,8336008,Binzen,3 -  6 Jahre,94,51,43
False,8336008,Binzen,6 - 10 Jahre,106,57,49
False,8336008,Binzen,10 - 15 Jahre,177,84,93
False,8336008,Binzen,15 - 18 Jahre,75,41,34
False,8336008,Binzen,18 - 20 Jahre,53,25,28
False,8336008,Binzen,20 - 25 Jahre,115,60,55
False,8336008,Binzen,25 - 30 Jahre,129,63,66
False,8336008,Binzen,30 - 35 Jahre,230,110,120
False,8336008,Binzen,35 - 40 Jahre,228,100,128
False,8336008,Binzen,40 - 45 Jahre,203,97,106
False,8336008,Binzen,45 - 50 Jahre,197,99,98
False,8336008,Binzen,50 - 55 Jahre,173,90,83
False,8336008,Binzen,55 - 60 Jahre,164,73,91
False,8336008,Binzen,60 - 65 Jahre,172,90,82
False,8336008,Binzen,65 - 75 Jahre,231,117,114
False,8336008,Binzen,75 und mehr Jahre,134,41,93
False,8336008,Binzen,Insgesamt,2563,1245,1318
False,8336010,Böllen,unter 3 Jahre,5,4,1
False,8336010,Böllen,3 -  6 Jahre,8,1,7
False,8336010,Böllen,6 - 10 Jahre,8,3,5
False,8336010,Böllen,10 - 15 Jahre,2,2,0
False,8336010,Böllen,15 - 18 Jahre,0,0,0
False,8336010,Böllen,18 - 20 Jahre,2,2,0
False,8336010,Böllen,20 - 25 Jahre,3,0,3
False,8336010,Böllen,25 - 30 Jahre,10,6,4
False,8336010,Böllen,30 - 35 Jahre,10,5,5
False,8336010,Böllen,35 - 40 Jahre,10,6,4
False,8336010,Böllen,40 - 45 Jahre,11,6,5
False,8336010,Böllen,45 - 50 Jahre,5,1,4
False,8336010,Böllen,50 - 55 Jahre,3,3,0
False,8336010,Böllen,55 - 60 Jahre,2,2,0
False,8336010,Böllen,60 - 65 Jahre,3,1,2
False,8336010,Böllen,65 - 75 Jahre,18,10,8
False,8336010,Böllen,75 und mehr Jahre,7,4,3
False,8336010,Böllen,Insgesamt,107,56,51
False,8336014,Efringen-Kirchen,unter 3 Jahre,261,132,129
False,8336014,Efringen-Kirchen,3 -  6 Jahre,275,147,128
False,8336014,Efringen-Kirchen,6 - 10 Jahre,412,237,175
False,8336014,Efringen-Kirchen,10 - 15 Jahre,529,256,273
False,8336014,Efringen-Kirchen,15 - 18 Jahre,334,173,161
False,8336014,Efringen-Kirchen,18 - 20 Jahre,191,94,97
False,8336014,Efringen-Kirchen,20 - 25 Jahre,381,195,186
False,8336014,Efringen-Kirchen,25 - 30 Jahre,440,209,231
False,8336014,Efringen-Kirchen,30 - 35 Jahre,648,329,319
False,8336014,Efringen-Kirchen,35 - 40 Jahre,747,357,390
False,8336014,Efringen-Kirchen,40 - 45 Jahre,721,373,348
False,8336014,Efringen-Kirchen,45 - 50 Jahre,612,306,306
False,8336014,Efringen-Kirchen,50 - 55 Jahre,439,228,211
False,8336014,Efringen-Kirchen,55 - 60 Jahre,429,216,213
False,8336014,Efringen-Kirchen,60 - 65 Jahre,502,258,244
False,8336014,Efringen-Kirchen,65 - 75 Jahre,673,327,346
False,8336014,Efringen-Kirchen,75 und mehr Jahre,432,137,295
False,8336014,Efringen-Kirchen,Insgesamt,8026,3974,4052
False,8336019,Eimeldingen,unter 3 Jahre,71,41,30
False,8336019,Eimeldingen,3 -  6 Jahre,88,48,40
False,8336019,Eimeldingen,6 - 10 Jahre,116,50,66
False,8336019,Eimeldingen,10 - 15 Jahre,128,70,58
False,8336019,Eimeldingen,15 - 18 Jahre,62,38,24
False,8336019,Eimeldingen,18 - 20 Jahre,46,22,24
False,8336019,Eimeldingen,20 - 25 Jahre,98,49,49
False,8336019,Eimeldingen,25 - 30 Jahre,143,64,79
False,8336019,Eimeldingen,30 - 35 Jahre,212,105,107
False,8336019,Eimeldingen,35 - 40 Jahre,257,129,128
False,8336019,Eimeldingen,40 - 45 Jahre,197,108,89
False,8336019,Eimeldingen,45 - 50 Jahre,150,75,75
False,8336019,Eimeldingen,50 - 55 Jahre,129,61,68
False,8336019,Eimeldingen,55 - 60 Jahre,112,53,59
False,8336019,Eimeldingen,60 - 65 Jahre,108,51,57
False,8336019,Eimeldingen,65 - 75 Jahre,141,74,67
False,8336019,Eimeldingen,75 und mehr Jahre,93,34,59
False,8336019,Eimeldingen,Insgesamt,2151,1072,1079
False,8336024,Fischingen,unter 3 Jahre,18,8,10
False,8336024,Fischingen,3 -  6 Jahre,17,10,7
False,8336024,Fischingen,6 - 10 Jahre,20,12,8
False,8336024,Fischingen,10 - 15 Jahre,27,19,8
False,8336024,Fischingen,15 - 18 Jahre,18,14,4
False,8336024,Fischingen,18 - 20 Jahre,13,5,8
False,8336024,Fischingen,20 - 25 Jahre,41,20,21
False,8336024,Fischingen,25 - 30 Jahre,31,18,13
False,8336024,Fischingen,30 - 35 Jahre,52,31,21
False,8336024,Fischingen,35 - 40 Jahre,50,27,23
False,8336024,Fischingen,40 - 45 Jahre,47,22,25
False,8336024,Fischingen,45 - 50 Jahre,52,26,26
False,8336024,Fischingen,50 - 55 Jahre,39,19,20
False,8336024,Fischingen,55 - 60 Jahre,48,25,23
False,8336024,Fischingen,60 - 65 Jahre,35,18,17
False,8336024,Fischingen,65 - 75 Jahre,56,25,31
False,8336024,Fischingen,75 und mehr Jahre,28,11,17
False,8336024,Fischingen,Insgesamt,592,310,282
False,8336025,Fröhnd,unter 3 Jahre,12,6,6
False,8336025,Fröhnd,3 -  6 Jahre,16,12,4
False,8336025,Fröhnd,6 - 10 Jahre,25,12,13
False,8336025,Fröhnd,10 - 15 Jahre,37,23,14
False,8336025,Fröhnd,15 - 18 Jahre,22,10,12
False,8336025,Fröhnd,18 - 20 Jahre,14,8,6
False,8336025,Fröhnd,20 - 25 Jahre,25,15,10
False,8336025,Fröhnd,25 - 30 Jahre,23,13,10
False,8336025,Fröhnd,30 - 35 Jahre,44,26,18
False,8336025,Fröhnd,35 - 40 Jahre,40,19,21
False,8336025,Fröhnd,40 - 45 Jahre,46,23,23
False,8336025,Fröhnd,45 - 50 Jahre,37,23,14
False,8336025,Fröhnd,50 - 55 Jahre,17,10,7
False,8336025,Fröhnd,55 - 60 Jahre,13,4,9
False,8336025,Fröhnd,60 - 65 Jahre,28,16,12
False,8336025,Fröhnd,65 - 75 Jahre,52,26,26
False,8336025,Fröhnd,75 und mehr Jahre,35,17,18
False,8336025,Fröhnd,Insgesamt,486,263,223
False,8336034,Hasel,unter 3 Jahre,32,13,19
False,8336034,Hasel,3 -  6 Jahre,39,25,14
False,8336034,Hasel,6 - 10 Jahre,51,26,25
False,8336034,Hasel,10 - 15 Jahre,87,36,51
False,8336034,Hasel,15 - 18 Jahre,48,23,25
False,8336034,Hasel,18 - 20 Jahre,23,12,11
False,8336034,Hasel,20 - 25 Jahre,49,26,23
False,8336034,Hasel,25 - 30 Jahre,63,28,35
False,8336034,Hasel,30 - 35 Jahre,88,50,38
False,8336034,Hasel,35 - 40 Jahre,107,56,51
False,8336034,Hasel,40 - 45 Jahre,81,37,44
False,8336034,Hasel,45 - 50 Jahre,79,48,31
False,8336034,Hasel,50 - 55 Jahre,64,33,31
False,8336034,Hasel,55 - 60 Jahre,57,27,30
False,8336034,Hasel,60 - 65 Jahre,64,32,32
False,8336034,Hasel,65 - 75 Jahre,129,64,65
False,8336034,Hasel,75 und mehr Jahre,55,19,36
False,8336034,Hasel,Insgesamt,1116,555,561
False,8336036,Hausen im Wiesental,unter 3 Jahre,75,34,41
False,8336036,Hausen im Wiesental,3 -  6 Jahre,95,62,33
False,8336036,Hausen im Wiesental,6 - 10 Jahre,129,61,68
False,8336036,Hausen im Wiesental,10 - 15 Jahre,145,71,74
False,8336036,Hausen im Wiesental,15 - 18 Jahre,73,37,36
False,8336036,Hausen im Wiesental,18 - 20 Jahre,61,33,28
False,8336036,Hausen im Wiesental,20 - 25 Jahre,130,63,67
False,8336036,Hausen im Wiesental,25 - 30 Jahre,127,72,55
False,8336036,Hausen im Wiesental,30 - 35 Jahre,192,87,105
False,8336036,Hausen im Wiesental,35 - 40 Jahre,228,125,103
False,8336036,Hausen im Wiesental,40 - 45 Jahre,188,89,99
False,8336036,Hausen im Wiesental,45 - 50 Jahre,152,79,73
False,8336036,Hausen im Wiesental,50 - 55 Jahre,138,71,67
False,8336036,Hausen im Wiesental,55 - 60 Jahre,126,58,68
False,8336036,Hausen im Wiesental,60 - 65 Jahre,159,79,80
False,8336036,Hausen im Wiesental,65 - 75 Jahre,233,109,124
False,8336036,Hausen im Wiesental,75 und mehr Jahre,114,30,84
False,8336036,Hausen im Wiesental,Insgesamt,2365,1160,1205
False,8336043,Inzlingen,unter 3 Jahre,71,40,31
False,8336043,Inzlingen,3 -  6 Jahre,59,26,33
False,8336043,Inzlingen,6 - 10 Jahre,111,56,55
False,8336043,Inzlingen,10 - 15 Jahre,132,65,67
False,8336043,Inzlingen,15 - 18 Jahre,88,45,43
False,8336043,Inzlingen,18 - 20 Jahre,65,36,29
False,8336043,Inzlingen,20 - 25 Jahre,105,57,48
False,8336043,Inzlingen,25 - 30 Jahre,113,54,59
False,8336043,Inzlingen,30 - 35 Jahre,224,93,131
False,8336043,Inzlingen,35 - 40 Jahre,207,94,113
False,8336043,Inzlingen,40 - 45 Jahre,229,113,116
False,8336043,Inzlingen,45 - 50 Jahre,191,93,98
False,8336043,Inzlingen,50 - 55 Jahre,152,69,83
False,8336043,Inzlingen,55 - 60 Jahre,163,75,88
False,8336043,Inzlingen,60 - 65 Jahre,204,110,94
False,8336043,Inzlingen,65 - 75 Jahre,266,130,136
False,8336043,Inzlingen,75 und mehr Jahre,168,52,116
False,8336043,Inzlingen,Insgesamt,2548,1208,1340
False,8336045,"Kandern, Stadt",unter 3 Jahre,203,105,98
False,8336045,"Kandern, Stadt",3 -  6 Jahre,247,131,116
False,8336045,"Kandern, Stadt",6 - 10 Jahre,348,176,172
False,8336045,"Kandern, Stadt",10 - 15 Jahre,536,242,294
False,8336045,"Kandern, Stadt",15 - 18 Jahre,332,156,176
False,8336045,"Kandern, Stadt",18 - 20 Jahre,196,96,100
False,8336045,"Kandern, Stadt",20 - 25 Jahre,369,175,194
False,8336045,"Kandern, Stadt",25 - 30 Jahre,326,151,175
False,8336045,"Kandern, Stadt",30 - 35 Jahre,645,324,321
False,8336045,"Kandern, Stadt",35 - 40 Jahre,728,357,371
False,8336045,"Kandern, Stadt",40 - 45 Jahre,687,333,354
False,8336045,"Kandern, Stadt",45 - 50 Jahre,539,287,252
False,8336045,"Kandern, Stadt",50 - 55 Jahre,439,232,207
False,8336045,"Kandern, Stadt",55 - 60 Jahre,411,209,202
False,8336045,"Kandern, Stadt",60 - 65 Jahre,496,250,246
False,8336045,"Kandern, Stadt",65 - 75 Jahre,716,325,391
False,8336045,"Kandern, Stadt",75 und mehr Jahre,667,203,464
False,8336045,"Kandern, Stadt",Insgesamt,7885,3752,4133
False,8336050,"Lörrach, Stadt",unter 3 Jahre,1375,699,676
False,8336050,"Lörrach, Stadt",3 -  6 Jahre,1450,768,682
False,8336050,"Lörrach, Stadt",6 - 10 Jahre,1984,993,991
False,8336050,"Lörrach, Stadt",10 - 15 Jahre,2539,1321,1218
False,8336050,"Lörrach, Stadt",15 - 18 Jahre,1424,731,693
False,8336050,"Lörrach, Stadt",18 - 20 Jahre,1009,501,508
False,8336050,"Lörrach, Stadt",20 - 25 Jahre,2354,1167,1187
False,8336050,"Lörrach, Stadt",25 - 30 Jahre,2599,1264,1335
False,8336050,"Lörrach, Stadt",30 - 35 Jahre,3724,1910,1814
False,8336050,"Lörrach, Stadt",35 - 40 Jahre,4117,2019,2098
False,8336050,"Lörrach, Stadt",40 - 45 Jahre,3704,1886,1818
False,8336050,"Lörrach, Stadt",45 - 50 Jahre,3137,1629,1508
False,8336050,"Lörrach, Stadt",50 - 55 Jahre,2682,1302,1380
False,8336050,"Lörrach, Stadt",55 - 60 Jahre,2492,1221,1271
False,8336050,"Lörrach, Stadt",60 - 65 Jahre,3079,1488,1591
False,8336050,"Lörrach, Stadt",65 - 75 Jahre,4410,2005,2405
False,8336050,"Lörrach, Stadt",75 und mehr Jahre,3600,1002,2598
False,8336050,"Lörrach, Stadt",Insgesamt,45679,21906,23773
False,8336057,Maulburg,unter 3 Jahre,118,60,58
False,8336057,Maulburg,3 -  6 Jahre,147,68,79
False,8336057,Maulburg,6 - 10 Jahre,214,122,92
False,8336057,Maulburg,10 - 15 Jahre,272,143,129
False,8336057,Maulburg,15 - 18 Jahre,151,81,70
False,8336057,Maulburg,18 - 20 Jahre,92,48,44
False,8336057,Maulburg,20 - 25 Jahre,186,103,83
False,8336057,Maulburg,25 - 30 Jahre,218,103,115
False,8336057,Maulburg,30 - 35 Jahre,306,164,142
False,8336057,Maulburg,35 - 40 Jahre,354,188,166
False,8336057,Maulburg,40 - 45 Jahre,355,172,183
False,8336057,Maulburg,45 - 50 Jahre,279,148,131
False,8336057,Maulburg,50 - 55 Jahre,221,114,107
False,8336057,Maulburg,55 - 60 Jahre,224,108,116
False,8336057,Maulburg,60 - 65 Jahre,251,130,121
False,8336057,Maulburg,65 - 75 Jahre,335,148,187
False,8336057,Maulburg,75 und mehr Jahre,230,89,141
False,8336057,Maulburg,Insgesamt,3953,1989,1964
False,8336069,"Rheinfelden (Baden), Stadt",unter 3 Jahre,1063,545,518
False,8336069,"Rheinfelden (Baden), Stadt",3 -  6 Jahre,1091,548,543
False,8336069,"Rheinfelden (Baden), Stadt",6 - 10 Jahre,1579,813,766
False,8336069,"Rheinfelden (Baden), Stadt",10 - 15 Jahre,1918,949,969
False,8336069,"Rheinfelden (Baden), Stadt",15 - 18 Jahre,1001,518,483
False,8336069,"Rheinfelden (Baden), Stadt",18 - 20 Jahre,735,375,360
False,8336069,"Rheinfelden (Baden), Stadt",20 - 25 Jahre,1648,857,791
False,8336069,"Rheinfelden (Baden), Stadt",25 - 30 Jahre,1898,975,923
False,8336069,"Rheinfelden (Baden), Stadt",30 - 35 Jahre,2814,1457,1357
False,8336069,"Rheinfelden (Baden), Stadt",35 - 40 Jahre,2934,1473,1461
False,8336069,"Rheinfelden (Baden), Stadt",40 - 45 Jahre,2613,1327,1286
False,8336069,"Rheinfelden (Baden), Stadt",45 - 50 Jahre,2041,1017,1024
False,8336069,"Rheinfelden (Baden), Stadt",50 - 55 Jahre,1750,874,876
False,8336069,"Rheinfelden (Baden), Stadt",55 - 60 Jahre,1840,895,945
False,8336069,"Rheinfelden (Baden), Stadt",60 - 65 Jahre,2218,1030,1188
False,8336069,"Rheinfelden (Baden), Stadt",65 - 75 Jahre,2943,1406,1537
False,8336069,"Rheinfelden (Baden), Stadt",75 und mehr Jahre,1775,534,1241
False,8336069,"Rheinfelden (Baden), Stadt",Insgesamt,31861,15593,16268
False,8336073,Rümmingen,unter 3 Jahre,42,26,16
False,8336073,Rümmingen,3 -  6 Jahre,57,30,27
False,8336073,Rümmingen,6 - 10 Jahre,70,37,33
False,8336073,Rümmingen,10 - 15 Jahre,81,41,40
False,8336073,Rümmingen,15 - 18 Jahre,60,24,36
False,8336073,Rümmingen,18 - 20 Jahre,34,13,21
False,8336073,Rümmingen,20 - 25 Jahre,77,36,41
False,8336073,Rümmingen,25 - 30 Jahre,90,50,40
False,8336073,Rümmingen,30 - 35 Jahre,127,54,73
False,8336073,Rümmingen,35 - 40 Jahre,145,70,75
False,8336073,Rümmingen,40 - 45 Jahre,125,74,51
False,8336073,Rümmingen,45 - 50 Jahre,104,43,61
False,8336073,Rümmingen,50 - 55 Jahre,139,74,65
False,8336073,Rümmingen,55 - 60 Jahre,101,58,43
False,8336073,Rümmingen,60 - 65 Jahre,95,48,47
False,8336073,Rümmingen,65 - 75 Jahre,89,54,35
False,8336073,Rümmingen,75 und mehr Jahre,67,24,43
False,8336073,Rümmingen,Insgesamt,1503,756,747
False,8336075,Schallbach,unter 3 Jahre,23,14,9
False,8336075,Schallbach,3 -  6 Jahre,26,14,12
False,8336075,Schallbach,6 - 10 Jahre,31,16,15
False,8336075,Schallbach,10 - 15 Jahre,57,24,33
False,8336075,Schallbach,15 - 18 Jahre,25,9,16
False,8336075,Schallbach,18 - 20 Jahre,14,5,9
False,8336075,Schallbach,20 - 25 Jahre,33,21,12
False,8336075,Schallbach,25 - 30 Jahre,21,12,9
False,8336075,Schallbach,30 - 35 Jahre,49,27,22
False,8336075,Schallbach,35 - 40 Jahre,51,19,32
False,8336075,Schallbach,40 - 45 Jahre,43,25,18
False,8336075,Schallbach,45 - 50 Jahre,64,33,31
False,8336075,Schallbach,50 - 55 Jahre,51,21,30
False,8336075,Schallbach,55 - 60 Jahre,40,22,18
False,8336075,Schallbach,60 - 65 Jahre,40,25,15
False,8336075,Schallbach,65 - 75 Jahre,48,17,31
False,8336075,Schallbach,75 und mehr Jahre,37,15,22
False,8336075,Schallbach,Insgesamt,653,319,334
False,8336078,Schliengen,unter 3 Jahre,154,77,77
False,8336078,Schliengen,3 -  6 Jahre,169,96,73
False,8336078,Schliengen,6 - 10 Jahre,267,130,137
False,8336078,Schliengen,10 - 15 Jahre,323,183,140
False,8336078,Schliengen,15 - 18 Jahre,155,77,78
False,8336078,Schliengen,18 - 20 Jahre,107,53,54
False,8336078,Schliengen,20 - 25 Jahre,220,108,112
False,8336078,Schliengen,25 - 30 Jahre,285,141,144
False,8336078,Schliengen,30 - 35 Jahre,427,215,212
False,8336078,Schliengen,35 - 40 Jahre,424,233,191
False,8336078,Schliengen,40 - 45 Jahre,456,233,223
False,8336078,Schliengen,45 - 50 Jahre,337,178,159
False,8336078,Schliengen,50 - 55 Jahre,289,158,131
False,8336078,Schliengen,55 - 60 Jahre,262,127,135
False,8336078,Schliengen,60 - 65 Jahre,291,141,150
False,8336078,Schliengen,65 - 75 Jahre,421,198,223
False,8336078,Schliengen,75 und mehr Jahre,319,111,208
False,8336078,Schliengen,Insgesamt,4906,2459,2447
False,8336079,"Schönau im Schwarzwald, Stadt",unter 3 Jahre,82,35,47
False,8336079,"Schönau im Schwarzwald, Stadt",3 -  6 Jahre,84,37,47
False,8336079,"Schönau im Schwarzwald, Stadt",6 - 10 Jahre,152,86,66
False,8336079,"Schönau im Schwarzwald, Stadt",10 - 15 Jahre,156,78,78
False,8336079,"Schönau im Schwarzwald, Stadt",15 - 18 Jahre,92,47,45
False,8336079,"Schönau im Schwarzwald, Stadt",18 - 20 Jahre,69,33,36
False,8336079,"Schönau im Schwarzwald, Stadt",20 - 25 Jahre,140,77,63
False,8336079,"Schönau im Schwarzwald, Stadt",25 - 30 Jahre,152,81,71
False,8336079,"Schönau im Schwarzwald, Stadt",30 - 35 Jahre,179,88,91
False,8336079,"Schönau im Schwarzwald, Stadt",35 - 40 Jahre,217,117,100
False,8336079,"Schönau im Schwarzwald, Stadt",40 - 45 Jahre,193,107,86
False,8336079,"Schönau im Schwarzwald, Stadt",45 - 50 Jahre,153,68,85
False,8336079,"Schönau im Schwarzwald, Stadt",50 - 55 Jahre,148,76,72
False,8336079,"Schönau im Schwarzwald, Stadt",55 - 60 Jahre,128,61,67
False,8336079,"Schönau im Schwarzwald, Stadt",60 - 65 Jahre,186,85,101
False,8336079,"Schönau im Schwarzwald, Stadt",65 - 75 Jahre,232,107,125
False,8336079,"Schönau im Schwarzwald, Stadt",75 und mehr Jahre,201,55,146
False,8336079,"Schönau im Schwarzwald, Stadt",Insgesamt,2564,1238,1326
False,8336080,Schönenberg,unter 3 Jahre,10,3,7
False,8336080,Schönenberg,3 -  6 Jahre,15,9,6
False,8336080,Schönenberg,6 - 10 Jahre,14,6,8
False,8336080,Schönenberg,10 - 15 Jahre,19,9,10
False,8336080,Schönenberg,15 - 18 Jahre,11,7,4
False,8336080,Schönenberg,18 - 20 Jahre,5,3,2
False,8336080,Schönenberg,20 - 25 Jahre,21,12,9
False,8336080,Schönenberg,25 - 30 Jahre,23,13,10
False,8336080,Schönenberg,30 - 35 Jahre,26,14,12
False,8336080,Schönenberg,35 - 40 Jahre,36,22,14
False,8336080,Schönenberg,40 - 45 Jahre,20,10,10
False,8336080,Schönenberg,45 - 50 Jahre,16,7,9
False,8336080,Schönenberg,50 - 55 Jahre,20,9,11
False,8336080,Schönenberg,55 - 60 Jahre,18,9,9
False,8336080,Schönenberg,60 - 65 Jahre,37,23,14
False,8336080,Schönenberg,65 - 75 Jahre,33,17,16
False,8336080,Schönenberg,75 und mehr Jahre,15,5,10
False,8336080,Schönenberg,Insgesamt,339,178,161
False,8336081,"Schopfheim, Stadt",unter 3 Jahre,575,285,290
False,8336081,"Schopfheim, Stadt",3 -  6 Jahre,684,345,339
False,8336081,"Schopfheim, Stadt",6 - 10 Jahre,953,474,479
False,8336081,"Schopfheim, Stadt",10 - 15 Jahre,1212,590,622
False,8336081,"Schopfheim, Stadt",15 - 18 Jahre,714,360,354
False,8336081,"Schopfheim, Stadt",18 - 20 Jahre,493,250,243
False,8336081,"Schopfheim, Stadt",20 - 25 Jahre,954,507,447
False,8336081,"Schopfheim, Stadt",25 - 30 Jahre,1025,519,506
False,8336081,"Schopfheim, Stadt",30 - 35 Jahre,1432,722,710
False,8336081,"Schopfheim, Stadt",35 - 40 Jahre,1746,858,888
False,8336081,"Schopfheim, Stadt",40 - 45 Jahre,1512,766,746
False,8336081,"Schopfheim, Stadt",45 - 50 Jahre,1337,675,662
False,8336081,"Schopfheim, Stadt",50 - 55 Jahre,1102,574,528
False,8336081,"Schopfheim, Stadt",55 - 60 Jahre,974,477,497
False,8336081,"Schopfheim, Stadt",60 - 65 Jahre,1130,561,569
False,8336081,"Schopfheim, Stadt",65 - 75 Jahre,1686,768,918
False,8336081,"Schopfheim, Stadt",75 und mehr Jahre,1509,439,1070
False,8336081,"Schopfheim, Stadt",Insgesamt,19038,9170,9868
False,8336082,Schwörstadt,unter 3 Jahre,82,35,47
False,8336082,Schwörstadt,3 -  6 Jahre,81,35,46
False,8336082,Schwörstadt,6 - 10 Jahre,131,62,69
False,8336082,Schwörstadt,10 - 15 Jahre,166,92,74
False,8336082,Schwörstadt,15 - 18 Jahre,99,54,45
False,8336082,Schwörstadt,18 - 20 Jahre,65,30,35
False,8336082,Schwörstadt,20 - 25 Jahre,120,66,54
False,8336082,Schwörstadt,25 - 30 Jahre,141,66,75
False,8336082,Schwörstadt,30 - 35 Jahre,227,126,101
False,8336082,Schwörstadt,35 - 40 Jahre,209,98,111
False,8336082,Schwörstadt,40 - 45 Jahre,187,93,94
False,8336082,Schwörstadt,45 - 50 Jahre,186,97,89
False,8336082,Schwörstadt,50 - 55 Jahre,141,74,67
False,8336082,Schwörstadt,55 - 60 Jahre,151,72,79
False,8336082,Schwörstadt,60 - 65 Jahre,147,81,66
False,8336082,Schwörstadt,65 - 75 Jahre,224,114,110
False,8336082,Schwörstadt,75 und mehr Jahre,141,49,92
False,8336082,Schwörstadt,Insgesamt,2498,1244,1254
False,8336084,Steinen,unter 3 Jahre,296,148,148
False,8336084,Steinen,3 -  6 Jahre,353,184,169
False,8336084,Steinen,6 - 10 Jahre,502,241,261
False,8336084,Steinen,10 - 15 Jahre,656,338,318
False,8336084,Steinen,15 - 18 Jahre,365,188,177
False,8336084,Steinen,18 - 20 Jahre,207,88,119
False,8336084,Steinen,20 - 25 Jahre,441,223,218
False,8336084,Steinen,25 - 30 Jahre,466,219,247
False,8336084,Steinen,30 - 35 Jahre,827,403,424
False,8336084,Steinen,35 - 40 Jahre,968,466,502
False,8336084,Steinen,40 - 45 Jahre,854,433,421
False,8336084,Steinen,45 - 50 Jahre,720,347,373
False,8336084,Steinen,50 - 55 Jahre,583,298,285
False,8336084,Steinen,55 - 60 Jahre,514,264,250
False,8336084,Steinen,60 - 65 Jahre,657,318,339
False,8336084,Steinen,65 - 75 Jahre,968,445,523
False,8336084,Steinen,75 und mehr Jahre,628,196,432
False,8336084,Steinen,Insgesamt,10005,4799,5206
False,8336087,"Todtnau, Stadt",unter 3 Jahre,187,96,91
False,8336087,"Todtnau, Stadt",3 -  6 Jahre,229,127,102
False,8336087,"Todtnau, Stadt",6 - 10 Jahre,254,128,126
False,8336087,"Todtnau, Stadt",10 - 15 Jahre,274,146,128
False,8336087,"Todtnau, Stadt",15 - 18 Jahre,142,75,67
False,8336087,"Todtnau, Stadt",18 - 20 Jahre,105,48,57
False,8336087,"Todtnau, Stadt",20 - 25 Jahre,248,105,143
False,8336087,"Todtnau, Stadt",25 - 30 Jahre,302,150,152
False,8336087,"Todtnau, Stadt",30 - 35 Jahre,430,211,219
False,8336087,"Todtnau, Stadt",35 - 40 Jahre,493,261,232
False,8336087,"Todtnau, Stadt",40 - 45 Jahre,359,193,166
False,8336087,"Todtnau, Stadt",45 - 50 Jahre,312,167,145
False,8336087,"Todtnau, Stadt",50 - 55 Jahre,259,130,129
False,8336087,"Todtnau, Stadt",55 - 60 Jahre,260,122,138
False,8336087,"Todtnau, Stadt",60 - 65 Jahre,347,162,185
False,8336087,"Todtnau, Stadt",65 - 75 Jahre,572,279,293
False,8336087,"Todtnau, Stadt",75 und mehr Jahre,404,121,283
False,8336087,"Todtnau, Stadt",Insgesamt,5177,2521,2656
False,8336089,Tunau,unter 3 Jahre,2,1,1
False,8336089,Tunau,3 -  6 Jahre,3,2,1
False,8336089,Tunau,6 - 10 Jahre,7,4,3
False,8336089,Tunau,10 - 15 Jahre,11,6,5
False,8336089,Tunau,15 - 18 Jahre,3,1,2
False,8336089,Tunau,18 - 20 Jahre,6,1,5
False,8336089,Tunau,20 - 25 Jahre,14,4,10
False,8336089,Tunau,25 - 30 Jahre,20,15,5
False,8336089,Tunau,30 - 35 Jahre,12,6,6
False,8336089,Tunau,35 - 40 Jahre,15,6,9
False,8336089,Tunau,40 - 45 Jahre,12,4,8
False,8336089,Tunau,45 - 50 Jahre,16,11,5
False,8336089,Tunau,50 - 55 Jahre,9,6,3
False,8336089,Tunau,55 - 60 Jahre,5,3,2
False,8336089,Tunau,60 - 65 Jahre,20,8,12
False,8336089,Tunau,65 - 75 Jahre,17,9,8
False,8336089,Tunau,75 und mehr Jahre,15,4,11
False,8336089,Tunau,Insgesamt,187,91,96
False,8336090,Utzenfeld,unter 3 Jahre,16,7,9
False,8336090,Utzenfeld,3 -  6 Jahre,15,7,8
False,8336090,Utzenfeld,6 - 10 Jahre,28,12,16
False,8336090,Utzenfeld,10 - 15 Jahre,37,20,17
False,8336090,Utzenfeld,15 - 18 Jahre,23,13,10
False,8336090,Utzenfeld,18 - 20 Jahre,21,13,8
False,8336090,Utzenfeld,20 - 25 Jahre,32,10,22
False,8336090,Utzenfeld,25 - 30 Jahre,26,11,15
False,8336090,Utzenfeld,30 - 35 Jahre,35,23,12
False,8336090,Utzenfeld,35 - 40 Jahre,47,22,25
False,8336090,Utzenfeld,40 - 45 Jahre,62,31,31
False,8336090,Utzenfeld,45 - 50 Jahre,48,28,20
False,8336090,Utzenfeld,50 - 55 Jahre,27,16,11
False,8336090,Utzenfeld,55 - 60 Jahre,41,19,22
False,8336090,Utzenfeld,60 - 65 Jahre,50,24,26
False,8336090,Utzenfeld,65 - 75 Jahre,57,31,26
False,8336090,Utzenfeld,75 und mehr Jahre,39,10,29
False,8336090,Utzenfeld,Insgesamt,604,297,307
False,8336091,"Weil am Rhein, Stadt",unter 3 Jahre,925,471,454
False,8336091,"Weil am Rhein, Stadt",3 -  6 Jahre,941,483,458
False,8336091,"Weil am Rhein, Stadt",6 - 10 Jahre,1323,712,611
False,8336091,"Weil am Rhein, Stadt",10 - 15 Jahre,1745,893,852
False,8336091,"Weil am Rhein, Stadt",15 - 18 Jahre,898,472,426
False,8336091,"Weil am Rhein, Stadt",18 - 20 Jahre,600,287,313
False,8336091,"Weil am Rhein, Stadt",20 - 25 Jahre,1477,691,786
False,8336091,"Weil am Rhein, Stadt",25 - 30 Jahre,1731,837,894
False,8336091,"Weil am Rhein, Stadt",30 - 35 Jahre,2406,1223,1183
False,8336091,"Weil am Rhein, Stadt",35 - 40 Jahre,2523,1280,1243
False,8336091,"Weil am Rhein, Stadt",40 - 45 Jahre,2304,1143,1161
False,8336091,"Weil am Rhein, Stadt",45 - 50 Jahre,1878,951,927
False,8336091,"Weil am Rhein, Stadt",50 - 55 Jahre,1706,825,881
False,8336091,"Weil am Rhein, Stadt",55 - 60 Jahre,1715,876,839
False,8336091,"Weil am Rhein, Stadt",60 - 65 Jahre,1998,968,1030
False,8336091,"Weil am Rhein, Stadt",65 - 75 Jahre,2770,1282,1488
False,8336091,"Weil am Rhein, Stadt",75 und mehr Jahre,2002,624,1378
False,8336091,"Weil am Rhein, Stadt",Insgesamt,28942,14018,14924
False,8336094,Wembach,unter 3 Jahre,12,5,7
False,8336094,Wembach,3 -  6 Jahre,8,5,3
False,8336094,Wembach,6 - 10 Jahre,13,4,9
False,8336094,Wembach,10 - 15 Jahre,22,10,12
False,8336094,Wembach,15 - 18 Jahre,11,6,5
False,8336094,Wembach,18 - 20 Jahre,7,6,1
False,8336094,Wembach,20 - 25 Jahre,12,5,7
False,8336094,Wembach,25 - 30 Jahre,18,9,9
False,8336094,Wembach,30 - 35 Jahre,23,11,12
False,8336094,Wembach,35 - 40 Jahre,13,5,8
False,8336094,Wembach,40 - 45 Jahre,19,10,9
False,8336094,Wembach,45 - 50 Jahre,17,11,6
False,8336094,Wembach,50 - 55 Jahre,18,7,11
False,8336094,Wembach,55 - 60 Jahre,7,3,4
False,8336094,Wembach,60 - 65 Jahre,23,11,12
False,8336094,Wembach,65 - 75 Jahre,28,13,15
False,8336094,Wembach,75 und mehr Jahre,25,8,17
False,8336094,Wembach,Insgesamt,276,129,147
False,8336096,Wieden,unter 3 Jahre,22,11,11
False,8336096,Wieden,3 -  6 Jahre,21,11,10
False,8336096,Wieden,6 - 10 Jahre,40,14,26
False,8336096,Wieden,10 - 15 Jahre,51,26,25
False,8336096,Wieden,15 - 18 Jahre,28,17,11
False,8336096,Wieden,18 - 20 Jahre,16,11,5
False,8336096,Wieden,20 - 25 Jahre,27,20,7
False,8336096,Wieden,25 - 30 Jahre,37,15,22
False,8336096,Wieden,30 - 35 Jahre,41,20,21
False,8336096,Wieden,35 - 40 Jahre,50,24,26
False,8336096,Wieden,40 - 45 Jahre,46,19,27
False,8336096,Wieden,45 - 50 Jahre,40,21,19
False,8336096,Wieden,50 - 55 Jahre,31,13,18
False,8336096,Wieden,55 - 60 Jahre,37,23,14
False,8336096,Wieden,60 - 65 Jahre,26,18,8
False,8336096,Wieden,65 - 75 Jahre,47,27,20
False,8336096,Wieden,75 und mehr Jahre,30,8,22
False,8336096,Wieden,Insgesamt,590,298,292
False,8336100,Wittlingen,unter 3 Jahre,32,16,16
False,8336100,Wittlingen,3 -  6 Jahre,30,20,10
False,8336100,Wittlingen,6 - 10 Jahre,38,19,19
False,8336100,Wittlingen,10 - 15 Jahre,59,31,28
False,8336100,Wittlingen,15 - 18 Jahre,51,15,36
False,8336100,Wittlingen,18 - 20 Jahre,26,9,17
False,8336100,Wittlingen,20 - 25 Jahre,28,13,15
False,8336100,Wittlingen,25 - 30 Jahre,36,17,19
False,8336100,Wittlingen,30 - 35 Jahre,60,27,33
False,8336100,Wittlingen,35 - 40 Jahre,88,35,53
False,8336100,Wittlingen,40 - 45 Jahre,79,43,36
False,8336100,Wittlingen,45 - 50 Jahre,65,43,22
False,8336100,Wittlingen,50 - 55 Jahre,43,20,23
False,8336100,Wittlingen,55 - 60 Jahre,33,17,16
False,8336100,Wittlingen,60 - 65 Jahre,52,21,31
False,8336100,Wittlingen,65 - 75 Jahre,72,40,32
False,8336100,Wittlingen,75 und mehr Jahre,40,13,27
False,8336100,Wittlingen,Insgesamt,832,399,433
False,8336103,"Zell im Wiesental, Stadt",unter 3 Jahre,184,98,86
False,8336103,"Zell im Wiesental, Stadt",3 -  6 Jahre,239,111,128
False,8336103,"Zell im Wiesental, Stadt",6 - 10 Jahre,341,188,153
False,8336103,"Zell im Wiesental, Stadt",10 - 15 Jahre,475,256,219
False,8336103,"Zell im Wiesental, Stadt",15 - 18 Jahre,245,147,98
False,8336103,"Zell im Wiesental, Stadt",18 - 20 Jahre,171,83,88
False,8336103,"Zell im Wiesental, Stadt",20 - 25 Jahre,337,168,169
False,8336103,"Zell im Wiesental, Stadt",25 - 30 Jahre,353,165,188
False,8336103,"Zell im Wiesental, Stadt",30 - 35 Jahre,482,243,239
False,8336103,"Zell im Wiesental, Stadt",35 - 40 Jahre,575,288,287
False,8336103,"Zell im Wiesental, Stadt",40 - 45 Jahre,512,273,239
False,8336103,"Zell im Wiesental, Stadt",45 - 50 Jahre,407,215,192
False,8336103,"Zell im Wiesental, Stadt",50 - 55 Jahre,325,170,155
False,8336103,"Zell im Wiesental, Stadt",55 - 60 Jahre,311,162,149
False,8336103,"Zell im Wiesental, Stadt",60 - 65 Jahre,412,196,216
False,8336103,"Zell im Wiesental, Stadt",65 - 75 Jahre,591,267,324
False,8336103,"Zell im Wiesental, Stadt",75 und mehr Jahre,366,99,267
False,8336103,"Zell im Wiesental, Stadt",Insgesamt,6326,3129,3197
False,8336104,Malsburg-Marzell,unter 3 Jahre,37,20,17
False,8336104,Malsburg-Marzell,3 -  6 Jahre,55,31,24
False,8336104,Malsburg-Marzell,6 - 10 Jahre,83,49,34
False,8336104,Malsburg-Marzell,10 - 15 Jahre,123,69,54
False,8336104,Malsburg-Marzell,15 - 18 Jahre,77,41,36
False,8336104,Malsburg-Marzell,18 - 20 Jahre,37,16,21
False,8336104,Malsburg-Marzell,20 - 25 Jahre,80,44,36
False,8336104,Malsburg-Marzell,25 - 30 Jahre,60,31,29
False,8336104,Malsburg-Marzell,30 - 35 Jahre,110,48,62
False,8336104,Malsburg-Marzell,35 - 40 Jahre,139,67,72
False,8336104,Malsburg-Marzell,40 - 45 Jahre,119,60,59
False,8336104,Malsburg-Marzell,45 - 50 Jahre,112,63,49
False,8336104,Malsburg-Marzell,50 - 55 Jahre,83,33,50
False,8336104,Malsburg-Marzell,55 - 60 Jahre,83,46,37
False,8336104,Malsburg-Marzell,60 - 65 Jahre,109,55,54
False,8336104,Malsburg-Marzell,65 - 75 Jahre,147,73,74
False,8336104,Malsburg-Marzell,75 und mehr Jahre,101,31,70
False,8336104,Malsburg-Marzell,Insgesamt,1555,777,778
False,8336105,Grenzach-Wyhlen,unter 3 Jahre,350,177,173
False,8336105,Grenzach-Wyhlen,3 -  6 Jahre,434,216,218
False,8336105,Grenzach-Wyhlen,6 - 10 Jahre,575,306,269
False,8336105,Grenzach-Wyhlen,10 - 15 Jahre,772,413,359
False,8336105,Grenzach-Wyhlen,15 - 18 Jahre,452,228,224
False,8336105,Grenzach-Wyhlen,18 - 20 Jahre,278,153,125
False,8336105,Grenzach-Wyhlen,20 - 25 Jahre,660,334,326
False,8336105,Grenzach-Wyhlen,25 - 30 Jahre,724,345,379
False,8336105,Grenzach-Wyhlen,30 - 35 Jahre,1168,575,593
False,8336105,Grenzach-Wyhlen,35 - 40 Jahre,1285,648,637
False,8336105,Grenzach-Wyhlen,40 - 45 Jahre,1080,508,572
False,8336105,Grenzach-Wyhlen,45 - 50 Jahre,938,474,464
False,8336105,Grenzach-Wyhlen,50 - 55 Jahre,869,423,446
False,8336105,Grenzach-Wyhlen,55 - 60 Jahre,808,410,398
False,8336105,Grenzach-Wyhlen,60 - 65 Jahre,1068,531,537
False,8336105,Grenzach-Wyhlen,65 - 75 Jahre,1354,649,705
False,8336105,Grenzach-Wyhlen,75 und mehr Jahre,854,269,585
False,8336105,Grenzach-Wyhlen,Insgesamt,13669,6659,7010
False,8336106,Häg-Ehrsberg,unter 3 Jahre,25,16,9
False,8336106,Häg-Ehrsberg,3 -  6 Jahre,36,22,14
False,8336106,Häg-Ehrsberg,6 - 10 Jahre,46,26,20
False,8336106,Häg-Ehrsberg,10 - 15 Jahre,50,20,30
False,8336106,Häg-Ehrsberg,15 - 18 Jahre,36,22,14
False,8336106,Häg-Ehrsberg,18 - 20 Jahre,26,18,8
False,8336106,Häg-Ehrsberg,20 - 25 Jahre,44,24,20
False,8336106,Häg-Ehrsberg,25 - 30 Jahre,45,23,22
False,8336106,Häg-Ehrsberg,30 - 35 Jahre,73,43,30
False,8336106,Häg-Ehrsberg,35 - 40 Jahre,68,48,20
False,8336106,Häg-Ehrsberg,40 - 45 Jahre,71,28,43
False,8336106,Häg-Ehrsberg,45 - 50 Jahre,67,40,27
False,8336106,Häg-Ehrsberg,50 - 55 Jahre,37,17,20
False,8336106,Häg-Ehrsberg,55 - 60 Jahre,22,11,11
False,8336106,Häg-Ehrsberg,60 - 65 Jahre,50,16,34
False,8336106,Häg-Ehrsberg,65 - 75 Jahre,85,35,50
False,8336106,Häg-Ehrsberg,75 und mehr Jahre,78,33,45
False,8336106,Häg-Ehrsberg,Insgesamt,859,442,417
False,8336107,Kleines Wiesental,unter 3 Jahre,92,41,51
False,8336107,Kleines Wiesental,3 -  6 Jahre,104,59,45
False,8336107,Kleines Wiesental,6 - 10 Jahre,164,87,77
False,8336107,Kleines Wiesental,10 - 15 Jahre,187,106,81
False,8336107,Kleines Wiesental,15 - 18 Jahre,82,35,47
False,8336107,Kleines Wiesental,18 - 20 Jahre,73,30,43
False,8336107,Kleines Wiesental,20 - 25 Jahre,121,64,57
False,8336107,Kleines Wiesental,25 - 30 Jahre,136,75,61
False,8336107,Kleines Wiesental,30 - 35 Jahre,225,123,102
False,8336107,Kleines Wiesental,35 - 40 Jahre,287,145,142
False,8336107,Kleines Wiesental,40 - 45 Jahre,253,128,125
False,8336107,Kleines Wiesental,45 - 50 Jahre,210,121,89
False,8336107,Kleines Wiesental,50 - 55 Jahre,164,86,78
False,8336107,Kleines Wiesental,55 - 60 Jahre,153,81,72
False,8336107,Kleines Wiesental,60 - 65 Jahre,194,89,105
False,8336107,Kleines Wiesental,65 - 75 Jahre,318,161,157
False,8336107,Kleines Wiesental,75 und mehr Jahre,224,68,156
False,8336107,Kleines Wiesental,Insgesamt,2987,1499,1488
False,8337,Landkreis Waldshut,unter 3 Jahre,5256,2668,2588
False,8337,Landkreis Waldshut,3 -  6 Jahre,5649,2885,2764
False,8337,Landkreis Waldshut,6 - 10 Jahre,8089,4191,3898
False,8337,Landkreis Waldshut,10 - 15 Jahre,10645,5427,5218
False,8337,Landkreis Waldshut,15 - 18 Jahre,6113,3161,2952
False,8337,Landkreis Waldshut,18 - 20 Jahre,3996,2081,1915
False,8337,Landkreis Waldshut,20 - 25 Jahre,8544,4359,4185
False,8337,Landkreis Waldshut,25 - 30 Jahre,9302,4541,4761
False,8337,Landkreis Waldshut,30 - 35 Jahre,13169,6570,6599
False,8337,Landkreis Waldshut,35 - 40 Jahre,14339,7291,7048
False,8337,Landkreis Waldshut,40 - 45 Jahre,12762,6547,6215
False,8337,Landkreis Waldshut,45 - 50 Jahre,11081,5592,5489
False,8337,Landkreis Waldshut,50 - 55 Jahre,9401,4767,4634
False,8337,Landkreis Waldshut,55 - 60 Jahre,8670,4355,4315
False,8337,Landkreis Waldshut,60 - 65 Jahre,10791,5324,5467
False,8337,Landkreis Waldshut,65 - 75 Jahre,15132,7071,8061
False,8337,Landkreis Waldshut,75 und mehr Jahre,12005,3787,8218
False,8337,Landkreis Waldshut,Insgesamt,164944,80617,84327
False,8337002,Albbruck,unter 3 Jahre,259,127,132
False,8337002,Albbruck,3 -  6 Jahre,254,128,126
False,8337002,Albbruck,6 - 10 Jahre,423,216,207
False,8337002,Albbruck,10 - 15 Jahre,521,282,239
False,8337002,Albbruck,15 - 18 Jahre,269,145,124
False,8337002,Albbruck,18 - 20 Jahre,210,111,99
False,8337002,Albbruck,20 - 25 Jahre,397,206,191
False,8337002,Albbruck,25 - 30 Jahre,416,210,206
False,8337002,Albbruck,30 - 35 Jahre,558,281,277
False,8337002,Albbruck,35 - 40 Jahre,676,347,329
False,8337002,Albbruck,40 - 45 Jahre,639,329,310
False,8337002,Albbruck,45 - 50 Jahre,464,226,238
False,8337002,Albbruck,50 - 55 Jahre,356,200,156
False,8337002,Albbruck,55 - 60 Jahre,337,153,184
False,8337002,Albbruck,60 - 65 Jahre,409,212,197
False,8337002,Albbruck,65 - 75 Jahre,647,298,349
False,8337002,Albbruck,75 und mehr Jahre,420,145,275
False,8337002,Albbruck,Insgesamt,7255,3616,3639
False,8337013,Bernau im Schwarzwald,unter 3 Jahre,66,32,34
False,8337013,Bernau im Schwarzwald,3 -  6 Jahre,64,35,29
False,8337013,Bernau im Schwarzwald,6 - 10 Jahre,100,56,44
False,8337013,Bernau im Schwarzwald,10 - 15 Jahre,129,66,63
False,8337013,Bernau im Schwarzwald,15 - 18 Jahre,73,41,32
False,8337013,Bernau im Schwarzwald,18 - 20 Jahre,41,22,19
False,8337013,Bernau im Schwarzwald,20 - 25 Jahre,120,65,55
False,8337013,Bernau im Schwarzwald,25 - 30 Jahre,89,44,45
False,8337013,Bernau im Schwarzwald,30 - 35 Jahre,141,75,66
False,8337013,Bernau im Schwarzwald,35 - 40 Jahre,166,84,82
False,8337013,Bernau im Schwarzwald,40 - 45 Jahre,169,87,82
False,8337013,Bernau im Schwarzwald,45 - 50 Jahre,134,64,70
False,8337013,Bernau im Schwarzwald,50 - 55 Jahre,105,50,55
False,8337013,Bernau im Schwarzwald,55 - 60 Jahre,117,60,57
False,8337013,Bernau im Schwarzwald,60 - 65 Jahre,127,65,62
False,8337013,Bernau im Schwarzwald,65 - 75 Jahre,196,95,101
False,8337013,Bernau im Schwarzwald,75 und mehr Jahre,140,64,76
False,8337013,Bernau im Schwarzwald,Insgesamt,1977,1005,972
False,8337022,"Bonndorf im Schwarzwald, Stadt",unter 3 Jahre,240,130,110
False,8337022,"Bonndorf im Schwarzwald, Stadt",3 -  6 Jahre,293,150,143
False,8337022,"Bonndorf im Schwarzwald, Stadt",6 - 10 Jahre,391,211,180
False,8337022,"Bonndorf im Schwarzwald, Stadt",10 - 15 Jahre,477,230,247
False,8337022,"Bonndorf im Schwarzwald, Stadt",15 - 18 Jahre,246,118,128
False,8337022,"Bonndorf im Schwarzwald, Stadt",18 - 20 Jahre,158,78,80
False,8337022,"Bonndorf im Schwarzwald, Stadt",20 - 25 Jahre,366,194,172
False,8337022,"Bonndorf im Schwarzwald, Stadt",25 - 30 Jahre,377,182,195
False,8337022,"Bonndorf im Schwarzwald, Stadt",30 - 35 Jahre,603,303,300
False,8337022,"Bonndorf im Schwarzwald, Stadt",35 - 40 Jahre,636,340,296
False,8337022,"Bonndorf im Schwarzwald, Stadt",40 - 45 Jahre,481,239,242
False,8337022,"Bonndorf im Schwarzwald, Stadt",45 - 50 Jahre,431,223,208
False,8337022,"Bonndorf im Schwarzwald, Stadt",50 - 55 Jahre,341,172,169
False,8337022,"Bonndorf im Schwarzwald, Stadt",55 - 60 Jahre,307,149,158
False,8337022,"Bonndorf im Schwarzwald, Stadt",60 - 65 Jahre,433,206,227
False,8337022,"Bonndorf im Schwarzwald, Stadt",65 - 75 Jahre,588,280,308
False,8337022,"Bonndorf im Schwarzwald, Stadt",75 und mehr Jahre,437,126,311
False,8337022,"Bonndorf im Schwarzwald, Stadt",Insgesamt,6805,3331,3474
False,8337027,Dachsberg (Südschwarzwald),unter 3 Jahre,63,32,31
False,8337027,Dachsberg (Südschwarzwald),3 -  6 Jahre,63,29,34
False,8337027,Dachsberg (Südschwarzwald),6 - 10 Jahre,82,42,40
False,8337027,Dachsberg (Südschwarzwald),10 - 15 Jahre,108,63,45
False,8337027,Dachsberg (Südschwarzwald),15 - 18 Jahre,67,30,37
False,8337027,Dachsberg (Südschwarzwald),18 - 20 Jahre,32,18,14
False,8337027,Dachsberg (Südschwarzwald),20 - 25 Jahre,56,41,15
False,8337027,Dachsberg (Südschwarzwald),25 - 30 Jahre,47,19,28
False,8337027,Dachsberg (Südschwarzwald),30 - 35 Jahre,95,49,46
False,8337027,Dachsberg (Südschwarzwald),35 - 40 Jahre,128,58,70
False,8337027,Dachsberg (Südschwarzwald),40 - 45 Jahre,111,61,50
False,8337027,Dachsberg (Südschwarzwald),45 - 50 Jahre,84,49,35
False,8337027,Dachsberg (Südschwarzwald),50 - 55 Jahre,65,31,34
False,8337027,Dachsberg (Südschwarzwald),55 - 60 Jahre,70,29,41
False,8337027,Dachsberg (Südschwarzwald),60 - 65 Jahre,79,34,45
False,8337027,Dachsberg (Südschwarzwald),65 - 75 Jahre,149,75,74
False,8337027,Dachsberg (Südschwarzwald),75 und mehr Jahre,99,33,66
False,8337027,Dachsberg (Südschwarzwald),Insgesamt,1398,693,705
False,8337030,Dettighofen,unter 3 Jahre,30,19,11
False,8337030,Dettighofen,3 -  6 Jahre,37,19,18
False,8337030,Dettighofen,6 - 10 Jahre,63,36,27
False,8337030,Dettighofen,10 - 15 Jahre,54,26,28
False,8337030,Dettighofen,15 - 18 Jahre,41,20,21
False,8337030,Dettighofen,18 - 20 Jahre,27,15,12
False,8337030,Dettighofen,20 - 25 Jahre,47,23,24
False,8337030,Dettighofen,25 - 30 Jahre,57,27,30
False,8337030,Dettighofen,30 - 35 Jahre,76,39,37
False,8337030,Dettighofen,35 - 40 Jahre,97,51,46
False,8337030,Dettighofen,40 - 45 Jahre,82,43,39
False,8337030,Dettighofen,45 - 50 Jahre,74,41,33
False,8337030,Dettighofen,50 - 55 Jahre,53,34,19
False,8337030,Dettighofen,55 - 60 Jahre,51,22,29
False,8337030,Dettighofen,60 - 65 Jahre,63,28,35
False,8337030,Dettighofen,65 - 75 Jahre,100,56,44
False,8337030,Dettighofen,75 und mehr Jahre,86,28,58
False,8337030,Dettighofen,Insgesamt,1038,527,511
False,8337032,Dogern,unter 3 Jahre,71,35,36
False,8337032,Dogern,3 -  6 Jahre,68,38,30
False,8337032,Dogern,6 - 10 Jahre,94,51,43
False,8337032,Dogern,10 - 15 Jahre,130,64,66
False,8337032,Dogern,15 - 18 Jahre,84,48,36
False,8337032,Dogern,18 - 20 Jahre,69,39,30
False,8337032,Dogern,20 - 25 Jahre,109,69,40
False,8337032,Dogern,25 - 30 Jahre,103,52,51
False,8337032,Dogern,30 - 35 Jahre,162,87,75
False,8337032,Dogern,35 - 40 Jahre,193,91,102
False,8337032,Dogern,40 - 45 Jahre,223,108,115
False,8337032,Dogern,45 - 50 Jahre,186,96,90
False,8337032,Dogern,50 - 55 Jahre,142,72,70
False,8337032,Dogern,55 - 60 Jahre,124,65,59
False,8337032,Dogern,60 - 65 Jahre,176,84,92
False,8337032,Dogern,65 - 75 Jahre,215,100,115
False,8337032,Dogern,75 und mehr Jahre,159,53,106
False,8337032,Dogern,Insgesamt,2308,1152,1156
False,8337038,Görwihl,unter 3 Jahre,140,68,72
False,8337038,Görwihl,3 -  6 Jahre,163,88,75
False,8337038,Görwihl,6 - 10 Jahre,247,132,115
False,8337038,Görwihl,10 - 15 Jahre,355,185,170
False,8337038,Görwihl,15 - 18 Jahre,208,110,98
False,8337038,Görwihl,18 - 20 Jahre,136,72,64
False,8337038,Görwihl,20 - 25 Jahre,247,125,122
False,8337038,Görwihl,25 - 30 Jahre,237,117,120
False,8337038,Görwihl,30 - 35 Jahre,367,180,187
False,8337038,Görwihl,35 - 40 Jahre,412,225,187
False,8337038,Görwihl,40 - 45 Jahre,354,185,169
False,8337038,Görwihl,45 - 50 Jahre,287,131,156
False,8337038,Görwihl,50 - 55 Jahre,244,124,120
False,8337038,Görwihl,55 - 60 Jahre,221,103,118
False,8337038,Görwihl,60 - 65 Jahre,250,133,117
False,8337038,Görwihl,65 - 75 Jahre,351,162,189
False,8337038,Görwihl,75 und mehr Jahre,313,97,216
False,8337038,Görwihl,Insgesamt,4532,2237,2295
False,8337039,Grafenhausen,unter 3 Jahre,90,49,41
False,8337039,Grafenhausen,3 -  6 Jahre,103,49,54
False,8337039,Grafenhausen,6 - 10 Jahre,106,58,48
False,8337039,Grafenhausen,10 - 15 Jahre,137,74,63
False,8337039,Grafenhausen,15 - 18 Jahre,96,66,30
False,8337039,Grafenhausen,18 - 20 Jahre,56,33,23
False,8337039,Grafenhausen,20 - 25 Jahre,124,68,56
False,8337039,Grafenhausen,25 - 30 Jahre,141,70,71
False,8337039,Grafenhausen,30 - 35 Jahre,168,87,81
False,8337039,Grafenhausen,35 - 40 Jahre,190,96,94
False,8337039,Grafenhausen,40 - 45 Jahre,162,80,82
False,8337039,Grafenhausen,45 - 50 Jahre,159,84,75
False,8337039,Grafenhausen,50 - 55 Jahre,122,61,61
False,8337039,Grafenhausen,55 - 60 Jahre,125,67,58
False,8337039,Grafenhausen,60 - 65 Jahre,153,73,80
False,8337039,Grafenhausen,65 - 75 Jahre,234,113,121
False,8337039,Grafenhausen,75 und mehr Jahre,172,64,108
False,8337039,Grafenhausen,Insgesamt,2338,1192,1146
False,8337045,Häusern,unter 3 Jahre,41,25,16
False,8337045,Häusern,3 -  6 Jahre,41,20,21
False,8337045,Häusern,6 - 10 Jahre,50,24,26
False,8337045,Häusern,10 - 15 Jahre,80,44,36
False,8337045,Häusern,15 - 18 Jahre,54,22,32
False,8337045,Häusern,18 - 20 Jahre,23,9,14
False,8337045,Häusern,20 - 25 Jahre,52,30,22
False,8337045,Häusern,25 - 30 Jahre,68,32,36
False,8337045,Häusern,30 - 35 Jahre,109,58,51
False,8337045,Häusern,35 - 40 Jahre,91,36,55
False,8337045,Häusern,40 - 45 Jahre,97,55,42
False,8337045,Häusern,45 - 50 Jahre,90,51,39
False,8337045,Häusern,50 - 55 Jahre,81,38,43
False,8337045,Häusern,55 - 60 Jahre,69,34,35
False,8337045,Häusern,60 - 65 Jahre,92,47,45
False,8337045,Häusern,65 - 75 Jahre,140,64,76
False,8337045,Häusern,75 und mehr Jahre,83,24,59
False,8337045,Häusern,Insgesamt,1261,613,648
False,8337049,Herrischried,unter 3 Jahre,81,39,42
False,8337049,Herrischried,3 -  6 Jahre,99,48,51
False,8337049,Herrischried,6 - 10 Jahre,122,60,62
False,8337049,Herrischried,10 - 15 Jahre,159,84,75
False,8337049,Herrischried,15 - 18 Jahre,113,62,51
False,8337049,Herrischried,18 - 20 Jahre,45,27,18
False,8337049,Herrischried,20 - 25 Jahre,120,62,58
False,8337049,Herrischried,25 - 30 Jahre,113,52,61
False,8337049,Herrischried,30 - 35 Jahre,198,107,91
False,8337049,Herrischried,35 - 40 Jahre,217,114,103
False,8337049,Herrischried,40 - 45 Jahre,202,102,100
False,8337049,Herrischried,45 - 50 Jahre,159,92,67
False,8337049,Herrischried,50 - 55 Jahre,137,62,75
False,8337049,Herrischried,55 - 60 Jahre,138,70,68
False,8337049,Herrischried,60 - 65 Jahre,186,84,102
False,8337049,Herrischried,65 - 75 Jahre,309,156,153
False,8337049,Herrischried,75 und mehr Jahre,303,102,201
False,8337049,Herrischried,Insgesamt,2701,1323,1378
False,8337051,Höchenschwand,unter 3 Jahre,54,28,26
False,8337051,Höchenschwand,3 -  6 Jahre,62,27,35
False,8337051,Höchenschwand,6 - 10 Jahre,125,74,51
False,8337051,Höchenschwand,10 - 15 Jahre,139,76,63
False,8337051,Höchenschwand,15 - 18 Jahre,88,37,51
False,8337051,Höchenschwand,18 - 20 Jahre,56,32,24
False,8337051,Höchenschwand,20 - 25 Jahre,99,52,47
False,8337051,Höchenschwand,25 - 30 Jahre,95,44,51
False,8337051,Höchenschwand,30 - 35 Jahre,196,84,112
False,8337051,Höchenschwand,35 - 40 Jahre,236,108,128
False,8337051,Höchenschwand,40 - 45 Jahre,175,82,93
False,8337051,Höchenschwand,45 - 50 Jahre,152,85,67
False,8337051,Höchenschwand,50 - 55 Jahre,127,58,69
False,8337051,Höchenschwand,55 - 60 Jahre,135,60,75
False,8337051,Höchenschwand,60 - 65 Jahre,198,86,112
False,8337051,Höchenschwand,65 - 75 Jahre,250,118,132
False,8337051,Höchenschwand,75 und mehr Jahre,187,65,122
False,8337051,Höchenschwand,Insgesamt,2374,1116,1258
False,8337053,Hohentengen am Hochrhein,unter 3 Jahre,118,62,56
False,8337053,Hohentengen am Hochrhein,3 -  6 Jahre,126,63,63
False,8337053,Hohentengen am Hochrhein,6 - 10 Jahre,178,104,74
False,8337053,Hohentengen am Hochrhein,10 - 15 Jahre,200,109,91
False,8337053,Hohentengen am Hochrhein,15 - 18 Jahre,118,60,58
False,8337053,Hohentengen am Hochrhein,18 - 20 Jahre,64,37,27
False,8337053,Hohentengen am Hochrhein,20 - 25 Jahre,191,102,89
False,8337053,Hohentengen am Hochrhein,25 - 30 Jahre,177,78,99
False,8337053,Hohentengen am Hochrhein,30 - 35 Jahre,286,118,168
False,8337053,Hohentengen am Hochrhein,35 - 40 Jahre,286,166,120
False,8337053,Hohentengen am Hochrhein,40 - 45 Jahre,314,165,149
False,8337053,Hohentengen am Hochrhein,45 - 50 Jahre,238,123,115
False,8337053,Hohentengen am Hochrhein,50 - 55 Jahre,166,83,83
False,8337053,Hohentengen am Hochrhein,55 - 60 Jahre,148,75,73
False,8337053,Hohentengen am Hochrhein,60 - 65 Jahre,194,98,96
False,8337053,Hohentengen am Hochrhein,65 - 75 Jahre,287,132,155
False,8337053,Hohentengen am Hochrhein,75 und mehr Jahre,208,82,126
False,8337053,Hohentengen am Hochrhein,Insgesamt,3299,1657,1642
False,8337059,Ibach,unter 3 Jahre,13,4,9
False,8337059,Ibach,3 -  6 Jahre,13,8,5
False,8337059,Ibach,6 - 10 Jahre,17,10,7
False,8337059,Ibach,10 - 15 Jahre,31,15,16
False,8337059,Ibach,15 - 18 Jahre,21,13,8
False,8337059,Ibach,18 - 20 Jahre,11,5,6
False,8337059,Ibach,20 - 25 Jahre,15,6,9
False,8337059,Ibach,25 - 30 Jahre,16,10,6
False,8337059,Ibach,30 - 35 Jahre,27,16,11
False,8337059,Ibach,35 - 40 Jahre,48,19,29
False,8337059,Ibach,40 - 45 Jahre,31,14,17
False,8337059,Ibach,45 - 50 Jahre,30,14,16
False,8337059,Ibach,50 - 55 Jahre,24,10,14
False,8337059,Ibach,55 - 60 Jahre,23,11,12
False,8337059,Ibach,60 - 65 Jahre,30,18,12
False,8337059,Ibach,65 - 75 Jahre,47,24,23
False,8337059,Ibach,75 und mehr Jahre,30,10,20
False,8337059,Ibach,Insgesamt,427,207,220
False,8337060,Jestetten,unter 3 Jahre,164,88,76
False,8337060,Jestetten,3 -  6 Jahre,180,87,93
False,8337060,Jestetten,6 - 10 Jahre,262,144,118
False,8337060,Jestetten,10 - 15 Jahre,341,178,163
False,8337060,Jestetten,15 - 18 Jahre,202,114,88
False,8337060,Jestetten,18 - 20 Jahre,120,58,62
False,8337060,Jestetten,20 - 25 Jahre,270,137,133
False,8337060,Jestetten,25 - 30 Jahre,300,152,148
False,8337060,Jestetten,30 - 35 Jahre,414,194,220
False,8337060,Jestetten,35 - 40 Jahre,477,253,224
False,8337060,Jestetten,40 - 45 Jahre,407,203,204
False,8337060,Jestetten,45 - 50 Jahre,329,161,168
False,8337060,Jestetten,50 - 55 Jahre,286,141,145
False,8337060,Jestetten,55 - 60 Jahre,289,147,142
False,8337060,Jestetten,60 - 65 Jahre,365,193,172
False,8337060,Jestetten,65 - 75 Jahre,439,208,231
False,8337060,Jestetten,75 und mehr Jahre,432,122,310
False,8337060,Jestetten,Insgesamt,5277,2580,2697
False,8337062,Klettgau,unter 3 Jahre,277,135,142
False,8337062,Klettgau,3 -  6 Jahre,287,133,154
False,8337062,Klettgau,6 - 10 Jahre,365,187,178
False,8337062,Klettgau,10 - 15 Jahre,457,253,204
False,8337062,Klettgau,15 - 18 Jahre,302,159,143
False,8337062,Klettgau,18 - 20 Jahre,175,74,101
False,8337062,Klettgau,20 - 25 Jahre,377,192,185
False,8337062,Klettgau,25 - 30 Jahre,410,206,204
False,8337062,Klettgau,30 - 35 Jahre,639,309,330
False,8337062,Klettgau,35 - 40 Jahre,659,348,311
False,8337062,Klettgau,40 - 45 Jahre,566,304,262
False,8337062,Klettgau,45 - 50 Jahre,493,264,229
False,8337062,Klettgau,50 - 55 Jahre,405,220,185
False,8337062,Klettgau,55 - 60 Jahre,358,174,184
False,8337062,Klettgau,60 - 65 Jahre,458,231,227
False,8337062,Klettgau,65 - 75 Jahre,630,292,338
False,8337062,Klettgau,75 und mehr Jahre,500,161,339
False,8337062,Klettgau,Insgesamt,7358,3642,3716
False,8337065,Lauchringen,unter 3 Jahre,234,118,116
False,8337065,Lauchringen,3 -  6 Jahre,225,105,120
False,8337065,Lauchringen,6 - 10 Jahre,353,187,166
False,8337065,Lauchringen,10 - 15 Jahre,448,213,235
False,8337065,Lauchringen,15 - 18 Jahre,269,138,131
False,8337065,Lauchringen,18 - 20 Jahre,191,106,85
False,8337065,Lauchringen,20 - 25 Jahre,406,218,188
False,8337065,Lauchringen,25 - 30 Jahre,471,228,243
False,8337065,Lauchringen,30 - 35 Jahre,593,294,299
False,8337065,Lauchringen,35 - 40 Jahre,589,297,292
False,8337065,Lauchringen,40 - 45 Jahre,562,289,273
False,8337065,Lauchringen,45 - 50 Jahre,521,245,276
False,8337065,Lauchringen,50 - 55 Jahre,450,226,224
False,8337065,Lauchringen,55 - 60 Jahre,425,220,205
False,8337065,Lauchringen,60 - 65 Jahre,450,232,218
False,8337065,Lauchringen,65 - 75 Jahre,597,286,311
False,8337065,Lauchringen,75 und mehr Jahre,394,132,262
False,8337065,Lauchringen,Insgesamt,7178,3534,3644
False,8337066,"Laufenburg (Baden), Stadt",unter 3 Jahre,223,113,110
False,8337066,"Laufenburg (Baden), Stadt",3 -  6 Jahre,266,126,140
False,8337066,"Laufenburg (Baden), Stadt",6 - 10 Jahre,424,206,218
False,8337066,"Laufenburg (Baden), Stadt",10 - 15 Jahre,586,288,298
False,8337066,"Laufenburg (Baden), Stadt",15 - 18 Jahre,323,171,152
False,8337066,"Laufenburg (Baden), Stadt",18 - 20 Jahre,218,108,110
False,8337066,"Laufenburg (Baden), Stadt",20 - 25 Jahre,430,216,214
False,8337066,"Laufenburg (Baden), Stadt",25 - 30 Jahre,498,243,255
False,8337066,"Laufenburg (Baden), Stadt",30 - 35 Jahre,674,323,351
False,8337066,"Laufenburg (Baden), Stadt",35 - 40 Jahre,757,371,386
False,8337066,"Laufenburg (Baden), Stadt",40 - 45 Jahre,693,346,347
False,8337066,"Laufenburg (Baden), Stadt",45 - 50 Jahre,560,290,270
False,8337066,"Laufenburg (Baden), Stadt",50 - 55 Jahre,482,239,243
False,8337066,"Laufenburg (Baden), Stadt",55 - 60 Jahre,448,233,215
False,8337066,"Laufenburg (Baden), Stadt",60 - 65 Jahre,519,269,250
False,8337066,"Laufenburg (Baden), Stadt",65 - 75 Jahre,743,350,393
False,8337066,"Laufenburg (Baden), Stadt",75 und mehr Jahre,514,173,341
False,8337066,"Laufenburg (Baden), Stadt",Insgesamt,8358,4065,4293
False,8337070,Lottstetten,unter 3 Jahre,53,28,25
False,8337070,Lottstetten,3 -  6 Jahre,77,36,41
False,8337070,Lottstetten,6 - 10 Jahre,123,68,55
False,8337070,Lottstetten,10 - 15 Jahre,117,65,52
False,8337070,Lottstetten,15 - 18 Jahre,86,50,36
False,8337070,Lottstetten,18 - 20 Jahre,43,19,24
False,8337070,Lottstetten,20 - 25 Jahre,109,61,48
False,8337070,Lottstetten,25 - 30 Jahre,121,45,76
False,8337070,Lottstetten,30 - 35 Jahre,178,92,86
False,8337070,Lottstetten,35 - 40 Jahre,204,101,103
False,8337070,Lottstetten,40 - 45 Jahre,181,95,86
False,8337070,Lottstetten,45 - 50 Jahre,132,72,60
False,8337070,Lottstetten,50 - 55 Jahre,120,55,65
False,8337070,Lottstetten,55 - 60 Jahre,145,68,77
False,8337070,Lottstetten,60 - 65 Jahre,154,80,74
False,8337070,Lottstetten,65 - 75 Jahre,165,75,90
False,8337070,Lottstetten,75 und mehr Jahre,138,40,98
False,8337070,Lottstetten,Insgesamt,2146,1050,1096
False,8337076,Murg,unter 3 Jahre,215,102,113
False,8337076,Murg,3 -  6 Jahre,234,134,100
False,8337076,Murg,6 - 10 Jahre,324,147,177
False,8337076,Murg,10 - 15 Jahre,515,262,253
False,8337076,Murg,15 - 18 Jahre,241,133,108
False,8337076,Murg,18 - 20 Jahre,171,82,89
False,8337076,Murg,20 - 25 Jahre,372,195,177
False,8337076,Murg,25 - 30 Jahre,407,201,206
False,8337076,Murg,30 - 35 Jahre,576,300,276
False,8337076,Murg,35 - 40 Jahre,602,291,311
False,8337076,Murg,40 - 45 Jahre,521,270,251
False,8337076,Murg,45 - 50 Jahre,486,250,236
False,8337076,Murg,50 - 55 Jahre,379,193,186
False,8337076,Murg,55 - 60 Jahre,326,171,155
False,8337076,Murg,60 - 65 Jahre,424,211,213
False,8337076,Murg,65 - 75 Jahre,621,299,322
False,8337076,Murg,75 und mehr Jahre,462,140,322
False,8337076,Murg,Insgesamt,6876,3381,3495
False,8337090,Rickenbach,unter 3 Jahre,143,70,73
False,8337090,Rickenbach,3 -  6 Jahre,132,77,55
False,8337090,Rickenbach,6 - 10 Jahre,177,84,93
False,8337090,Rickenbach,10 - 15 Jahre,261,136,125
False,8337090,Rickenbach,15 - 18 Jahre,148,80,68
False,8337090,Rickenbach,18 - 20 Jahre,100,55,45
False,8337090,Rickenbach,20 - 25 Jahre,217,114,103
False,8337090,Rickenbach,25 - 30 Jahre,209,102,107
False,8337090,Rickenbach,30 - 35 Jahre,277,145,132
False,8337090,Rickenbach,35 - 40 Jahre,343,156,187
False,8337090,Rickenbach,40 - 45 Jahre,299,150,149
False,8337090,Rickenbach,45 - 50 Jahre,244,132,112
False,8337090,Rickenbach,50 - 55 Jahre,216,113,103
False,8337090,Rickenbach,55 - 60 Jahre,194,90,104
False,8337090,Rickenbach,60 - 65 Jahre,278,140,138
False,8337090,Rickenbach,65 - 75 Jahre,359,174,185
False,8337090,Rickenbach,75 und mehr Jahre,259,92,167
False,8337090,Rickenbach,Insgesamt,3856,1910,1946
False,8337096,"Bad Säckingen, Stadt",unter 3 Jahre,534,302,232
False,8337096,"Bad Säckingen, Stadt",3 -  6 Jahre,503,269,234
False,8337096,"Bad Säckingen, Stadt",6 - 10 Jahre,736,401,335
False,8337096,"Bad Säckingen, Stadt",10 - 15 Jahre,911,456,455
False,8337096,"Bad Säckingen, Stadt",15 - 18 Jahre,538,278,260
False,8337096,"Bad Säckingen, Stadt",18 - 20 Jahre,362,198,164
False,8337096,"Bad Säckingen, Stadt",20 - 25 Jahre,777,342,435
False,8337096,"Bad Säckingen, Stadt",25 - 30 Jahre,932,446,486
False,8337096,"Bad Säckingen, Stadt",30 - 35 Jahre,1273,635,638
False,8337096,"Bad Säckingen, Stadt",35 - 40 Jahre,1253,620,633
False,8337096,"Bad Säckingen, Stadt",40 - 45 Jahre,1189,581,608
False,8337096,"Bad Säckingen, Stadt",45 - 50 Jahre,1109,554,555
False,8337096,"Bad Säckingen, Stadt",50 - 55 Jahre,998,490,508
False,8337096,"Bad Säckingen, Stadt",55 - 60 Jahre,967,497,470
False,8337096,"Bad Säckingen, Stadt",60 - 65 Jahre,1115,513,602
False,8337096,"Bad Säckingen, Stadt",65 - 75 Jahre,1693,744,949
False,8337096,"Bad Säckingen, Stadt",75 und mehr Jahre,1510,442,1068
False,8337096,"Bad Säckingen, Stadt",Insgesamt,16400,7768,8632
False,8337097,"St. Blasien, Stadt",unter 3 Jahre,96,46,50
False,8337097,"St. Blasien, Stadt",3 -  6 Jahre,99,57,42
False,8337097,"St. Blasien, Stadt",6 - 10 Jahre,124,63,61
False,8337097,"St. Blasien, Stadt",10 - 15 Jahre,234,115,119
False,8337097,"St. Blasien, Stadt",15 - 18 Jahre,185,90,95
False,8337097,"St. Blasien, Stadt",18 - 20 Jahre,131,87,44
False,8337097,"St. Blasien, Stadt",20 - 25 Jahre,259,125,134
False,8337097,"St. Blasien, Stadt",25 - 30 Jahre,267,163,104
False,8337097,"St. Blasien, Stadt",30 - 35 Jahre,383,270,113
False,8337097,"St. Blasien, Stadt",35 - 40 Jahre,253,111,142
False,8337097,"St. Blasien, Stadt",40 - 45 Jahre,281,142,139
False,8337097,"St. Blasien, Stadt",45 - 50 Jahre,245,112,133
False,8337097,"St. Blasien, Stadt",50 - 55 Jahre,262,139,123
False,8337097,"St. Blasien, Stadt",55 - 60 Jahre,204,98,106
False,8337097,"St. Blasien, Stadt",60 - 65 Jahre,302,138,164
False,8337097,"St. Blasien, Stadt",65 - 75 Jahre,371,180,191
False,8337097,"St. Blasien, Stadt",75 und mehr Jahre,336,109,227
False,8337097,"St. Blasien, Stadt",Insgesamt,4032,2045,1987
False,8337106,"Stühlingen, Stadt",unter 3 Jahre,165,77,88
False,8337106,"Stühlingen, Stadt",3 -  6 Jahre,206,107,99
False,8337106,"Stühlingen, Stadt",6 - 10 Jahre,254,125,129
False,8337106,"Stühlingen, Stadt",10 - 15 Jahre,381,196,185
False,8337106,"Stühlingen, Stadt",15 - 18 Jahre,196,108,88
False,8337106,"Stühlingen, Stadt",18 - 20 Jahre,121,60,61
False,8337106,"Stühlingen, Stadt",20 - 25 Jahre,276,149,127
False,8337106,"Stühlingen, Stadt",25 - 30 Jahre,298,159,139
False,8337106,"Stühlingen, Stadt",30 - 35 Jahre,410,208,202
False,8337106,"Stühlingen, Stadt",35 - 40 Jahre,462,227,235
False,8337106,"Stühlingen, Stadt",40 - 45 Jahre,416,222,194
False,8337106,"Stühlingen, Stadt",45 - 50 Jahre,355,202,153
False,8337106,"Stühlingen, Stadt",50 - 55 Jahre,308,158,150
False,8337106,"Stühlingen, Stadt",55 - 60 Jahre,225,120,105
False,8337106,"Stühlingen, Stadt",60 - 65 Jahre,346,176,170
False,8337106,"Stühlingen, Stadt",65 - 75 Jahre,449,219,230
False,8337106,"Stühlingen, Stadt",75 und mehr Jahre,390,124,266
False,8337106,"Stühlingen, Stadt",Insgesamt,5258,2637,2621
False,8337108,Todtmoos,unter 3 Jahre,52,30,22
False,8337108,Todtmoos,3 -  6 Jahre,52,30,22
False,8337108,Todtmoos,6 - 10 Jahre,90,43,47
False,8337108,Todtmoos,10 - 15 Jahre,145,75,70
False,8337108,Todtmoos,15 - 18 Jahre,62,28,34
False,8337108,Todtmoos,18 - 20 Jahre,59,23,36
False,8337108,Todtmoos,20 - 25 Jahre,99,45,54
False,8337108,Todtmoos,25 - 30 Jahre,97,46,51
False,8337108,Todtmoos,30 - 35 Jahre,126,55,71
False,8337108,Todtmoos,35 - 40 Jahre,216,99,117
False,8337108,Todtmoos,40 - 45 Jahre,170,90,80
False,8337108,Todtmoos,45 - 50 Jahre,162,71,91
False,8337108,Todtmoos,50 - 55 Jahre,145,75,70
False,8337108,Todtmoos,55 - 60 Jahre,125,69,56
False,8337108,Todtmoos,60 - 65 Jahre,139,66,73
False,8337108,Todtmoos,65 - 75 Jahre,216,85,131
False,8337108,Todtmoos,75 und mehr Jahre,149,49,100
False,8337108,Todtmoos,Insgesamt,2104,979,1125
False,8337116,"Wehr, Stadt",unter 3 Jahre,392,192,200
False,8337116,"Wehr, Stadt",3 -  6 Jahre,436,226,210
False,8337116,"Wehr, Stadt",6 - 10 Jahre,629,319,310
False,8337116,"Wehr, Stadt",10 - 15 Jahre,868,399,469
False,8337116,"Wehr, Stadt",15 - 18 Jahre,421,210,211
False,8337116,"Wehr, Stadt",18 - 20 Jahre,276,128,148
False,8337116,"Wehr, Stadt",20 - 25 Jahre,645,325,320
False,8337116,"Wehr, Stadt",25 - 30 Jahre,775,363,412
False,8337116,"Wehr, Stadt",30 - 35 Jahre,1023,508,515
False,8337116,"Wehr, Stadt",35 - 40 Jahre,1165,605,560
False,8337116,"Wehr, Stadt",40 - 45 Jahre,984,490,494
False,8337116,"Wehr, Stadt",45 - 50 Jahre,902,446,456
False,8337116,"Wehr, Stadt",50 - 55 Jahre,754,381,373
False,8337116,"Wehr, Stadt",55 - 60 Jahre,779,382,397
False,8337116,"Wehr, Stadt",60 - 65 Jahre,955,464,491
False,8337116,"Wehr, Stadt",65 - 75 Jahre,1248,586,662
False,8337116,"Wehr, Stadt",75 und mehr Jahre,876,268,608
False,8337116,"Wehr, Stadt",Insgesamt,13128,6292,6836
False,8337118,Weilheim,unter 3 Jahre,97,43,54
False,8337118,Weilheim,3 -  6 Jahre,126,54,72
False,8337118,Weilheim,6 - 10 Jahre,203,100,103
False,8337118,Weilheim,10 - 15 Jahre,219,115,104
False,8337118,Weilheim,15 - 18 Jahre,122,66,56
False,8337118,Weilheim,18 - 20 Jahre,83,41,42
False,8337118,Weilheim,20 - 25 Jahre,139,64,75
False,8337118,Weilheim,25 - 30 Jahre,160,69,91
False,8337118,Weilheim,30 - 35 Jahre,275,134,141
False,8337118,Weilheim,35 - 40 Jahre,361,179,182
False,8337118,Weilheim,40 - 45 Jahre,271,150,121
False,8337118,Weilheim,45 - 50 Jahre,195,103,92
False,8337118,Weilheim,50 - 55 Jahre,154,90,64
False,8337118,Weilheim,55 - 60 Jahre,144,79,65
False,8337118,Weilheim,60 - 65 Jahre,183,81,102
False,8337118,Weilheim,65 - 75 Jahre,258,133,125
False,8337118,Weilheim,75 und mehr Jahre,149,47,102
False,8337118,Weilheim,Insgesamt,3139,1548,1591
False,8337123,Wutöschingen,unter 3 Jahre,222,113,109
False,8337123,Wutöschingen,3 -  6 Jahre,239,116,123
False,8337123,Wutöschingen,6 - 10 Jahre,348,178,170
False,8337123,Wutöschingen,10 - 15 Jahre,453,227,226
False,8337123,Wutöschingen,15 - 18 Jahre,239,122,117
False,8337123,Wutöschingen,18 - 20 Jahre,171,95,76
False,8337123,Wutöschingen,20 - 25 Jahre,359,178,181
False,8337123,Wutöschingen,25 - 30 Jahre,400,200,200
False,8337123,Wutöschingen,30 - 35 Jahre,551,273,278
False,8337123,Wutöschingen,35 - 40 Jahre,592,311,281
False,8337123,Wutöschingen,40 - 45 Jahre,477,231,246
False,8337123,Wutöschingen,45 - 50 Jahre,442,221,221
False,8337123,Wutöschingen,50 - 55 Jahre,377,189,188
False,8337123,Wutöschingen,55 - 60 Jahre,335,183,152
False,8337123,Wutöschingen,60 - 65 Jahre,430,231,199
False,8337123,Wutöschingen,65 - 75 Jahre,486,230,256
False,8337123,Wutöschingen,75 und mehr Jahre,347,118,229
False,8337123,Wutöschingen,Insgesamt,6468,3216,3252
False,8337124,Eggingen,unter 3 Jahre,56,28,28
False,8337124,Eggingen,3 -  6 Jahre,77,40,37
False,8337124,Eggingen,6 - 10 Jahre,119,64,55
False,8337124,Eggingen,10 - 15 Jahre,127,71,56
False,8337124,Eggingen,15 - 18 Jahre,65,30,35
False,8337124,Eggingen,18 - 20 Jahre,47,20,27
False,8337124,Eggingen,20 - 25 Jahre,111,51,60
False,8337124,Eggingen,25 - 30 Jahre,96,42,54
False,8337124,Eggingen,30 - 35 Jahre,157,77,80
False,8337124,Eggingen,35 - 40 Jahre,155,84,71
False,8337124,Eggingen,40 - 45 Jahre,144,76,68
False,8337124,Eggingen,45 - 50 Jahre,111,62,49
False,8337124,Eggingen,50 - 55 Jahre,99,47,52
False,8337124,Eggingen,55 - 60 Jahre,79,43,36
False,8337124,Eggingen,60 - 65 Jahre,84,42,42
False,8337124,Eggingen,65 - 75 Jahre,135,70,65
False,8337124,Eggingen,75 und mehr Jahre,98,26,72
False,8337124,Eggingen,Insgesamt,1760,873,887
False,8337125,Küssaberg,unter 3 Jahre,185,100,85
False,8337125,Küssaberg,3 -  6 Jahre,197,104,93
False,8337125,Küssaberg,6 - 10 Jahre,260,124,136
False,8337125,Küssaberg,10 - 15 Jahre,312,179,133
False,8337125,Küssaberg,15 - 18 Jahre,199,100,99
False,8337125,Küssaberg,18 - 20 Jahre,111,58,53
False,8337125,Küssaberg,20 - 25 Jahre,260,136,124
False,8337125,Küssaberg,25 - 30 Jahre,303,145,158
False,8337125,Küssaberg,30 - 35 Jahre,527,251,276
False,8337125,Küssaberg,35 - 40 Jahre,538,293,245
False,8337125,Küssaberg,40 - 45 Jahre,456,246,210
False,8337125,Küssaberg,45 - 50 Jahre,351,169,182
False,8337125,Küssaberg,50 - 55 Jahre,313,144,169
False,8337125,Küssaberg,55 - 60 Jahre,285,139,146
False,8337125,Küssaberg,60 - 65 Jahre,359,200,159
False,8337125,Küssaberg,65 - 75 Jahre,490,227,263
False,8337125,Küssaberg,75 und mehr Jahre,350,119,231
False,8337125,Küssaberg,Insgesamt,5496,2734,2762
False,8337126,"Waldshut-Tiengen, Stadt",unter 3 Jahre,657,317,340
False,8337126,"Waldshut-Tiengen, Stadt",3 -  6 Jahre,677,351,326
False,8337126,"Waldshut-Tiengen, Stadt",6 - 10 Jahre,949,493,456
False,8337126,"Waldshut-Tiengen, Stadt",10 - 15 Jahre,1291,655,636
False,8337126,"Waldshut-Tiengen, Stadt",15 - 18 Jahre,768,363,405
False,8337126,"Waldshut-Tiengen, Stadt",18 - 20 Jahre,541,301,240
False,8337126,"Waldshut-Tiengen, Stadt",20 - 25 Jahre,1183,600,583
False,8337126,"Waldshut-Tiengen, Stadt",25 - 30 Jahre,1273,609,664
False,8337126,"Waldshut-Tiengen, Stadt",30 - 35 Jahre,1644,791,853
False,8337126,"Waldshut-Tiengen, Stadt",35 - 40 Jahre,1791,927,864
False,8337126,"Waldshut-Tiengen, Stadt",40 - 45 Jahre,1634,851,783
False,8337126,"Waldshut-Tiengen, Stadt",45 - 50 Jahre,1600,769,831
False,8337126,"Waldshut-Tiengen, Stadt",50 - 55 Jahre,1361,696,665
False,8337126,"Waldshut-Tiengen, Stadt",55 - 60 Jahre,1180,591,589
False,8337126,"Waldshut-Tiengen, Stadt",60 - 65 Jahre,1429,690,739
False,8337126,"Waldshut-Tiengen, Stadt",65 - 75 Jahre,2161,958,1203
False,8337126,"Waldshut-Tiengen, Stadt",75 und mehr Jahre,2000,570,1430
False,8337126,"Waldshut-Tiengen, Stadt",Insgesamt,22139,10532,11607
False,8337127,Wutach,unter 3 Jahre,56,23,33
False,8337127,Wutach,3 -  6 Jahre,46,19,27
False,8337127,Wutach,6 - 10 Jahre,75,36,39
False,8337127,Wutach,10 - 15 Jahre,84,31,53
False,8337127,Wutach,15 - 18 Jahre,52,27,25
False,8337127,Wutach,18 - 20 Jahre,25,15,10
False,8337127,Wutach,20 - 25 Jahre,66,33,33
False,8337127,Wutach,25 - 30 Jahre,79,37,42
False,8337127,Wutach,30 - 35 Jahre,92,54,38
False,8337127,Wutach,35 - 40 Jahre,109,60,49
False,8337127,Wutach,40 - 45 Jahre,91,51,40
False,8337127,Wutach,45 - 50 Jahre,66,37,29
False,8337127,Wutach,50 - 55 Jahre,62,34,28
False,8337127,Wutach,55 - 60 Jahre,45,18,27
False,8337127,Wutach,60 - 65 Jahre,94,49,45
False,8337127,Wutach,65 - 75 Jahre,128,71,57
False,8337127,Wutach,75 und mehr Jahre,82,22,60
False,8337127,Wutach,Insgesamt,1252,617,635
False,8337128,Ühlingen-Birkendorf,unter 3 Jahre,169,93,76
False,8337128,Ühlingen-Birkendorf,3 -  6 Jahre,204,112,92
False,8337128,Ühlingen-Birkendorf,6 - 10 Jahre,276,148,128
False,8337128,Ühlingen-Birkendorf,10 - 15 Jahre,375,195,180
False,8337128,Ühlingen-Birkendorf,15 - 18 Jahre,217,122,95
False,8337128,Ühlingen-Birkendorf,18 - 20 Jahre,123,55,68
False,8337128,Ühlingen-Birkendorf,20 - 25 Jahre,246,135,111
False,8337128,Ühlingen-Birkendorf,25 - 30 Jahre,270,148,122
False,8337128,Ühlingen-Birkendorf,30 - 35 Jahre,371,173,198
False,8337128,Ühlingen-Birkendorf,35 - 40 Jahre,437,223,214
False,8337128,Ühlingen-Birkendorf,40 - 45 Jahre,380,210,170
False,8337128,Ühlingen-Birkendorf,45 - 50 Jahre,290,153,137
False,8337128,Ühlingen-Birkendorf,50 - 55 Jahre,267,142,125
False,8337128,Ühlingen-Birkendorf,55 - 60 Jahre,252,135,117
False,8337128,Ühlingen-Birkendorf,60 - 65 Jahre,317,150,167
False,8337128,Ühlingen-Birkendorf,65 - 75 Jahre,430,211,219
False,8337128,Ühlingen-Birkendorf,75 und mehr Jahre,382,140,242
False,8337128,Ühlingen-Birkendorf,Insgesamt,5006,2545,2461
False,84,Regierungsbezirk Tübingen,unter 3 Jahre,58080,29619,28461
False,84,Regierungsbezirk Tübingen,3 -  6 Jahre,61167,31404,29763
False,84,Regierungsbezirk Tübingen,6 - 10 Jahre,85226,43850,41376
False,84,Regierungsbezirk Tübingen,10 - 15 Jahre,111005,56953,54052
False,84,Regierungsbezirk Tübingen,15 - 18 Jahre,61045,31451,29594
False,84,Regierungsbezirk Tübingen,18 - 20 Jahre,42384,21580,20804
False,84,Regierungsbezirk Tübingen,20 - 25 Jahre,101721,51581,50140
False,84,Regierungsbezirk Tübingen,25 - 30 Jahre,111342,56584,54758
False,84,Regierungsbezirk Tübingen,30 - 35 Jahre,147967,76245,71722
False,84,Regierungsbezirk Tübingen,35 - 40 Jahre,157534,81321,76213
False,84,Regierungsbezirk Tübingen,40 - 45 Jahre,138098,70647,67451
False,84,Regierungsbezirk Tübingen,45 - 50 Jahre,116597,58761,57836
False,84,Regierungsbezirk Tübingen,50 - 55 Jahre,101214,51599,49615
False,84,Regierungsbezirk Tübingen,55 - 60 Jahre,94069,47387,46682
False,84,Regierungsbezirk Tübingen,60 - 65 Jahre,112248,55442,56806
False,84,Regierungsbezirk Tübingen,65 - 75 Jahre,149690,69156,80534
False,84,Regierungsbezirk Tübingen,75 und mehr Jahre,117626,35810,81816
False,84,Regierungsbezirk Tübingen,Insgesamt,1767013,869390,897623
False,8415,Landkreis Reutlingen,unter 3 Jahre,8965,4553,4412
False,8415,Landkreis Reutlingen,3 -  6 Jahre,9261,4791,4470
False,8415,Landkreis Reutlingen,6 - 10 Jahre,13026,6643,6383
False,8415,Landkreis Reutlingen,10 - 15 Jahre,16739,8511,8228
False,8415,Landkreis Reutlingen,15 - 18 Jahre,9119,4720,4399
False,8415,Landkreis Reutlingen,18 - 20 Jahre,6540,3366,3174
False,8415,Landkreis Reutlingen,20 - 25 Jahre,15413,7768,7645
False,8415,Landkreis Reutlingen,25 - 30 Jahre,17402,8816,8586
False,8415,Landkreis Reutlingen,30 - 35 Jahre,23252,11873,11379
False,8415,Landkreis Reutlingen,35 - 40 Jahre,24807,12689,12118
False,8415,Landkreis Reutlingen,40 - 45 Jahre,21798,11226,10572
False,8415,Landkreis Reutlingen,45 - 50 Jahre,18247,9131,9116
False,8415,Landkreis Reutlingen,50 - 55 Jahre,15840,7967,7873
False,8415,Landkreis Reutlingen,55 - 60 Jahre,15268,7580,7688
False,8415,Landkreis Reutlingen,60 - 65 Jahre,18518,9016,9502
False,8415,Landkreis Reutlingen,65 - 75 Jahre,25146,11569,13577
False,8415,Landkreis Reutlingen,75 und mehr Jahre,18654,5556,13098
False,8415,Landkreis Reutlingen,Insgesamt,277995,135775,142220
False,8415014,Dettingen an der Erms,unter 3 Jahre,301,155,146
False,8415014,Dettingen an der Erms,3 -  6 Jahre,286,146,140
False,8415014,Dettingen an der Erms,6 - 10 Jahre,424,205,219
False,8415014,Dettingen an der Erms,10 - 15 Jahre,535,285,250
False,8415014,Dettingen an der Erms,15 - 18 Jahre,297,166,131
False,8415014,Dettingen an der Erms,18 - 20 Jahre,210,105,105
False,8415014,Dettingen an der Erms,20 - 25 Jahre,494,254,240
False,8415014,Dettingen an der Erms,25 - 30 Jahre,529,267,262
False,8415014,Dettingen an der Erms,30 - 35 Jahre,792,387,405
False,8415014,Dettingen an der Erms,35 - 40 Jahre,799,414,385
False,8415014,Dettingen an der Erms,40 - 45 Jahre,718,383,335
False,8415014,Dettingen an der Erms,45 - 50 Jahre,534,286,248
False,8415014,Dettingen an der Erms,50 - 55 Jahre,515,259,256
False,8415014,Dettingen an der Erms,55 - 60 Jahre,535,271,264
False,8415014,Dettingen an der Erms,60 - 65 Jahre,607,304,303
False,8415014,Dettingen an der Erms,65 - 75 Jahre,854,385,469
False,8415014,Dettingen an der Erms,75 und mehr Jahre,647,195,452
False,8415014,Dettingen an der Erms,Insgesamt,9077,4467,4610
False,8415019,Eningen unter Achalm,unter 3 Jahre,349,176,173
False,8415019,Eningen unter Achalm,3 -  6 Jahre,362,192,170
False,8415019,Eningen unter Achalm,6 - 10 Jahre,423,218,205
False,8415019,Eningen unter Achalm,10 - 15 Jahre,565,263,302
False,8415019,Eningen unter Achalm,15 - 18 Jahre,322,166,156
False,8415019,Eningen unter Achalm,18 - 20 Jahre,231,127,104
False,8415019,Eningen unter Achalm,20 - 25 Jahre,546,257,289
False,8415019,Eningen unter Achalm,25 - 30 Jahre,670,356,314
False,8415019,Eningen unter Achalm,30 - 35 Jahre,912,451,461
False,8415019,Eningen unter Achalm,35 - 40 Jahre,919,477,442
False,8415019,Eningen unter Achalm,40 - 45 Jahre,794,421,373
False,8415019,Eningen unter Achalm,45 - 50 Jahre,658,325,333
False,8415019,Eningen unter Achalm,50 - 55 Jahre,657,324,333
False,8415019,Eningen unter Achalm,55 - 60 Jahre,589,300,289
False,8415019,Eningen unter Achalm,60 - 65 Jahre,723,348,375
False,8415019,Eningen unter Achalm,65 - 75 Jahre,958,462,496
False,8415019,Eningen unter Achalm,75 und mehr Jahre,735,207,528
False,8415019,Eningen unter Achalm,Insgesamt,10413,5070,5343
False,8415027,Gomadingen,unter 3 Jahre,69,38,31
False,8415027,Gomadingen,3 -  6 Jahre,90,39,51
False,8415027,Gomadingen,6 - 10 Jahre,116,62,54
False,8415027,Gomadingen,10 - 15 Jahre,127,62,65
False,8415027,Gomadingen,15 - 18 Jahre,64,37,27
False,8415027,Gomadingen,18 - 20 Jahre,52,30,22
False,8415027,Gomadingen,20 - 25 Jahre,103,55,48
False,8415027,Gomadingen,25 - 30 Jahre,119,55,64
False,8415027,Gomadingen,30 - 35 Jahre,193,100,93
False,8415027,Gomadingen,35 - 40 Jahre,200,99,101
False,8415027,Gomadingen,40 - 45 Jahre,187,107,80
False,8415027,Gomadingen,45 - 50 Jahre,156,90,66
False,8415027,Gomadingen,50 - 55 Jahre,111,62,49
False,8415027,Gomadingen,55 - 60 Jahre,117,66,51
False,8415027,Gomadingen,60 - 65 Jahre,143,66,77
False,8415027,Gomadingen,65 - 75 Jahre,199,103,96
False,8415027,Gomadingen,75 und mehr Jahre,141,43,98
False,8415027,Gomadingen,Insgesamt,2187,1114,1073
False,8415028,Grabenstetten,unter 3 Jahre,49,22,27
False,8415028,Grabenstetten,3 -  6 Jahre,57,22,35
False,8415028,Grabenstetten,6 - 10 Jahre,67,31,36
False,8415028,Grabenstetten,10 - 15 Jahre,125,73,52
False,8415028,Grabenstetten,15 - 18 Jahre,67,40,27
False,8415028,Grabenstetten,18 - 20 Jahre,39,21,18
False,8415028,Grabenstetten,20 - 25 Jahre,65,41,24
False,8415028,Grabenstetten,25 - 30 Jahre,104,55,49
False,8415028,Grabenstetten,30 - 35 Jahre,114,60,54
False,8415028,Grabenstetten,35 - 40 Jahre,130,59,71
False,8415028,Grabenstetten,40 - 45 Jahre,130,62,68
False,8415028,Grabenstetten,45 - 50 Jahre,130,66,64
False,8415028,Grabenstetten,50 - 55 Jahre,91,57,34
False,8415028,Grabenstetten,55 - 60 Jahre,53,26,27
False,8415028,Grabenstetten,60 - 65 Jahre,92,40,52
False,8415028,Grabenstetten,65 - 75 Jahre,142,70,72
False,8415028,Grabenstetten,75 und mehr Jahre,94,40,54
False,8415028,Grabenstetten,Insgesamt,1549,785,764
False,8415029,Grafenberg,unter 3 Jahre,118,72,46
False,8415029,Grafenberg,3 -  6 Jahre,122,57,65
False,8415029,Grafenberg,6 - 10 Jahre,134,62,72
False,8415029,Grafenberg,10 - 15 Jahre,191,108,83
False,8415029,Grafenberg,15 - 18 Jahre,88,52,36
False,8415029,Grafenberg,18 - 20 Jahre,56,27,29
False,8415029,Grafenberg,20 - 25 Jahre,136,68,68
False,8415029,Grafenberg,25 - 30 Jahre,154,81,73
False,8415029,Grafenberg,30 - 35 Jahre,276,136,140
False,8415029,Grafenberg,35 - 40 Jahre,238,128,110
False,8415029,Grafenberg,40 - 45 Jahre,224,113,111
False,8415029,Grafenberg,45 - 50 Jahre,182,92,90
False,8415029,Grafenberg,50 - 55 Jahre,159,85,74
False,8415029,Grafenberg,55 - 60 Jahre,133,70,63
False,8415029,Grafenberg,60 - 65 Jahre,176,86,90
False,8415029,Grafenberg,65 - 75 Jahre,182,93,89
False,8415029,Grafenberg,75 und mehr Jahre,120,36,84
False,8415029,Grafenberg,Insgesamt,2689,1366,1323
False,8415034,"Hayingen, Stadt",unter 3 Jahre,68,35,33
False,8415034,"Hayingen, Stadt",3 -  6 Jahre,78,43,35
False,8415034,"Hayingen, Stadt",6 - 10 Jahre,110,67,43
False,8415034,"Hayingen, Stadt",10 - 15 Jahre,145,76,69
False,8415034,"Hayingen, Stadt",15 - 18 Jahre,90,35,55
False,8415034,"Hayingen, Stadt",18 - 20 Jahre,54,23,31
False,8415034,"Hayingen, Stadt",20 - 25 Jahre,120,74,46
False,8415034,"Hayingen, Stadt",25 - 30 Jahre,149,88,61
False,8415034,"Hayingen, Stadt",30 - 35 Jahre,167,89,78
False,8415034,"Hayingen, Stadt",35 - 40 Jahre,187,99,88
False,8415034,"Hayingen, Stadt",40 - 45 Jahre,132,76,56
False,8415034,"Hayingen, Stadt",45 - 50 Jahre,123,57,66
False,8415034,"Hayingen, Stadt",50 - 55 Jahre,127,69,58
False,8415034,"Hayingen, Stadt",55 - 60 Jahre,116,64,52
False,8415034,"Hayingen, Stadt",60 - 65 Jahre,150,78,72
False,8415034,"Hayingen, Stadt",65 - 75 Jahre,186,90,96
False,8415034,"Hayingen, Stadt",75 und mehr Jahre,147,51,96
False,8415034,"Hayingen, Stadt",Insgesamt,2149,1114,1035
False,8415039,Hülben,unter 3 Jahre,105,46,59
False,8415039,Hülben,3 -  6 Jahre,124,72,52
False,8415039,Hülben,6 - 10 Jahre,160,81,79
False,8415039,Hülben,10 - 15 Jahre,181,80,101
False,8415039,Hülben,15 - 18 Jahre,75,37,38
False,8415039,Hülben,18 - 20 Jahre,72,35,37
False,8415039,Hülben,20 - 25 Jahre,137,72,65
False,8415039,Hülben,25 - 30 Jahre,171,82,89
False,8415039,Hülben,30 - 35 Jahre,244,122,122
False,8415039,Hülben,35 - 40 Jahre,281,152,129
False,8415039,Hülben,40 - 45 Jahre,220,109,111
False,8415039,Hülben,45 - 50 Jahre,167,87,80
False,8415039,Hülben,50 - 55 Jahre,161,81,80
False,8415039,Hülben,55 - 60 Jahre,137,72,65
False,8415039,Hülben,60 - 65 Jahre,185,84,101
False,8415039,Hülben,65 - 75 Jahre,303,133,170
False,8415039,Hülben,75 und mehr Jahre,213,74,139
False,8415039,Hülben,Insgesamt,2936,1419,1517
False,8415048,Mehrstetten,unter 3 Jahre,55,33,22
False,8415048,Mehrstetten,3 -  6 Jahre,47,27,20
False,8415048,Mehrstetten,6 - 10 Jahre,80,43,37
False,8415048,Mehrstetten,10 - 15 Jahre,113,63,50
False,8415048,Mehrstetten,15 - 18 Jahre,63,31,32
False,8415048,Mehrstetten,18 - 20 Jahre,41,22,19
False,8415048,Mehrstetten,20 - 25 Jahre,77,44,33
False,8415048,Mehrstetten,25 - 30 Jahre,77,38,39
False,8415048,Mehrstetten,30 - 35 Jahre,116,58,58
False,8415048,Mehrstetten,35 - 40 Jahre,140,78,62
False,8415048,Mehrstetten,40 - 45 Jahre,101,53,48
False,8415048,Mehrstetten,45 - 50 Jahre,101,45,56
False,8415048,Mehrstetten,50 - 55 Jahre,80,46,34
False,8415048,Mehrstetten,55 - 60 Jahre,56,27,29
False,8415048,Mehrstetten,60 - 65 Jahre,73,34,39
False,8415048,Mehrstetten,65 - 75 Jahre,114,50,64
False,8415048,Mehrstetten,75 und mehr Jahre,83,27,56
False,8415048,Mehrstetten,Insgesamt,1417,719,698
False,8415050,"Metzingen, Stadt",unter 3 Jahre,663,342,321
False,8415050,"Metzingen, Stadt",3 -  6 Jahre,694,338,356
False,8415050,"Metzingen, Stadt",6 - 10 Jahre,953,452,501
False,8415050,"Metzingen, Stadt",10 - 15 Jahre,1291,635,656
False,8415050,"Metzingen, Stadt",15 - 18 Jahre,710,360,350
False,8415050,"Metzingen, Stadt",18 - 20 Jahre,467,239,228
False,8415050,"Metzingen, Stadt",20 - 25 Jahre,1161,609,552
False,8415050,"Metzingen, Stadt",25 - 30 Jahre,1419,705,714
False,8415050,"Metzingen, Stadt",30 - 35 Jahre,1667,845,822
False,8415050,"Metzingen, Stadt",35 - 40 Jahre,1826,953,873
False,8415050,"Metzingen, Stadt",40 - 45 Jahre,1647,808,839
False,8415050,"Metzingen, Stadt",45 - 50 Jahre,1392,672,720
False,8415050,"Metzingen, Stadt",50 - 55 Jahre,1231,604,627
False,8415050,"Metzingen, Stadt",55 - 60 Jahre,1216,614,602
False,8415050,"Metzingen, Stadt",60 - 65 Jahre,1586,746,840
False,8415050,"Metzingen, Stadt",65 - 75 Jahre,2183,1048,1135
False,8415050,"Metzingen, Stadt",75 und mehr Jahre,1573,469,1104
False,8415050,"Metzingen, Stadt",Insgesamt,21679,10439,11240
False,8415053,"Münsingen, Stadt",unter 3 Jahre,475,210,265
False,8415053,"Münsingen, Stadt",3 -  6 Jahre,504,261,243
False,8415053,"Münsingen, Stadt",6 - 10 Jahre,692,347,345
False,8415053,"Münsingen, Stadt",10 - 15 Jahre,993,496,497
False,8415053,"Münsingen, Stadt",15 - 18 Jahre,603,316,287
False,8415053,"Münsingen, Stadt",18 - 20 Jahre,397,210,187
False,8415053,"Münsingen, Stadt",20 - 25 Jahre,778,424,354
False,8415053,"Münsingen, Stadt",25 - 30 Jahre,824,403,421
False,8415053,"Münsingen, Stadt",30 - 35 Jahre,1126,604,522
False,8415053,"Münsingen, Stadt",35 - 40 Jahre,1269,649,620
False,8415053,"Münsingen, Stadt",40 - 45 Jahre,1091,560,531
False,8415053,"Münsingen, Stadt",45 - 50 Jahre,924,467,457
False,8415053,"Münsingen, Stadt",50 - 55 Jahre,750,381,369
False,8415053,"Münsingen, Stadt",55 - 60 Jahre,677,325,352
False,8415053,"Münsingen, Stadt",60 - 65 Jahre,948,484,464
False,8415053,"Münsingen, Stadt",65 - 75 Jahre,1278,549,729
False,8415053,"Münsingen, Stadt",75 und mehr Jahre,957,276,681
False,8415053,"Münsingen, Stadt",Insgesamt,14286,6962,7324
False,8415058,Pfronstetten,unter 3 Jahre,49,31,18
False,8415058,Pfronstetten,3 -  6 Jahre,64,36,28
False,8415058,Pfronstetten,6 - 10 Jahre,95,54,41
False,8415058,Pfronstetten,10 - 15 Jahre,123,72,51
False,8415058,Pfronstetten,15 - 18 Jahre,62,35,27
False,8415058,Pfronstetten,18 - 20 Jahre,35,19,16
False,8415058,Pfronstetten,20 - 25 Jahre,102,47,55
False,8415058,Pfronstetten,25 - 30 Jahre,96,54,42
False,8415058,Pfronstetten,30 - 35 Jahre,129,59,70
False,8415058,Pfronstetten,35 - 40 Jahre,134,79,55
False,8415058,Pfronstetten,40 - 45 Jahre,107,61,46
False,8415058,Pfronstetten,45 - 50 Jahre,106,60,46
False,8415058,Pfronstetten,50 - 55 Jahre,63,37,26
False,8415058,Pfronstetten,55 - 60 Jahre,65,33,32
False,8415058,Pfronstetten,60 - 65 Jahre,92,44,48
False,8415058,Pfronstetten,65 - 75 Jahre,130,65,65
False,8415058,Pfronstetten,75 und mehr Jahre,116,32,84
False,8415058,Pfronstetten,Insgesamt,1568,818,750
False,8415059,"Pfullingen, Stadt",unter 3 Jahre,601,299,302
False,8415059,"Pfullingen, Stadt",3 -  6 Jahre,587,284,303
False,8415059,"Pfullingen, Stadt",6 - 10 Jahre,794,381,413
False,8415059,"Pfullingen, Stadt",10 - 15 Jahre,993,484,509
False,8415059,"Pfullingen, Stadt",15 - 18 Jahre,536,288,248
False,8415059,"Pfullingen, Stadt",18 - 20 Jahre,428,232,196
False,8415059,"Pfullingen, Stadt",20 - 25 Jahre,1011,494,517
False,8415059,"Pfullingen, Stadt",25 - 30 Jahre,1086,546,540
False,8415059,"Pfullingen, Stadt",30 - 35 Jahre,1498,757,741
False,8415059,"Pfullingen, Stadt",35 - 40 Jahre,1643,848,795
False,8415059,"Pfullingen, Stadt",40 - 45 Jahre,1418,712,706
False,8415059,"Pfullingen, Stadt",45 - 50 Jahre,1120,531,589
False,8415059,"Pfullingen, Stadt",50 - 55 Jahre,1011,497,514
False,8415059,"Pfullingen, Stadt",55 - 60 Jahre,1083,521,562
False,8415059,"Pfullingen, Stadt",60 - 65 Jahre,1247,607,640
False,8415059,"Pfullingen, Stadt",65 - 75 Jahre,1685,756,929
False,8415059,"Pfullingen, Stadt",75 und mehr Jahre,1241,365,876
False,8415059,"Pfullingen, Stadt",Insgesamt,17982,8602,9380
False,8415060,Pliezhausen,unter 3 Jahre,355,181,174
False,8415060,Pliezhausen,3 -  6 Jahre,382,194,188
False,8415060,Pliezhausen,6 - 10 Jahre,475,238,237
False,8415060,Pliezhausen,10 - 15 Jahre,604,327,277
False,8415060,Pliezhausen,15 - 18 Jahre,328,185,143
False,8415060,Pliezhausen,18 - 20 Jahre,231,136,95
False,8415060,Pliezhausen,20 - 25 Jahre,470,226,244
False,8415060,Pliezhausen,25 - 30 Jahre,561,275,286
False,8415060,Pliezhausen,30 - 35 Jahre,797,393,404
False,8415060,Pliezhausen,35 - 40 Jahre,982,493,489
False,8415060,Pliezhausen,40 - 45 Jahre,738,377,361
False,8415060,Pliezhausen,45 - 50 Jahre,596,314,282
False,8415060,Pliezhausen,50 - 55 Jahre,551,283,268
False,8415060,Pliezhausen,55 - 60 Jahre,514,272,242
False,8415060,Pliezhausen,60 - 65 Jahre,579,291,288
False,8415060,Pliezhausen,65 - 75 Jahre,661,312,349
False,8415060,Pliezhausen,75 und mehr Jahre,413,116,297
False,8415060,Pliezhausen,Insgesamt,9237,4613,4624
False,8415061,"Reutlingen, Stadt",unter 3 Jahre,3276,1647,1629
False,8415061,"Reutlingen, Stadt",3 -  6 Jahre,3298,1742,1556
False,8415061,"Reutlingen, Stadt",6 - 10 Jahre,4803,2520,2283
False,8415061,"Reutlingen, Stadt",10 - 15 Jahre,6074,3134,2940
False,8415061,"Reutlingen, Stadt",15 - 18 Jahre,3478,1777,1701
False,8415061,"Reutlingen, Stadt",18 - 20 Jahre,2605,1326,1279
False,8415061,"Reutlingen, Stadt",20 - 25 Jahre,6501,3210,3291
False,8415061,"Reutlingen, Stadt",25 - 30 Jahre,7325,3741,3584
False,8415061,"Reutlingen, Stadt",30 - 35 Jahre,9410,4867,4543
False,8415061,"Reutlingen, Stadt",35 - 40 Jahre,9744,4929,4815
False,8415061,"Reutlingen, Stadt",40 - 45 Jahre,8618,4408,4210
False,8415061,"Reutlingen, Stadt",45 - 50 Jahre,7369,3657,3712
False,8415061,"Reutlingen, Stadt",50 - 55 Jahre,6299,3082,3217
False,8415061,"Reutlingen, Stadt",55 - 60 Jahre,6397,3131,3266
False,8415061,"Reutlingen, Stadt",60 - 65 Jahre,7476,3639,3837
False,8415061,"Reutlingen, Stadt",65 - 75 Jahre,10017,4539,5478
False,8415061,"Reutlingen, Stadt",75 und mehr Jahre,7960,2381,5579
False,8415061,"Reutlingen, Stadt",Insgesamt,110650,53730,56920
False,8415062,Riederich,unter 3 Jahre,148,67,81
False,8415062,Riederich,3 -  6 Jahre,148,86,62
False,8415062,Riederich,6 - 10 Jahre,186,85,101
False,8415062,Riederich,10 - 15 Jahre,264,133,131
False,8415062,Riederich,15 - 18 Jahre,131,74,57
False,8415062,Riederich,18 - 20 Jahre,79,38,41
False,8415062,Riederich,20 - 25 Jahre,238,124,114
False,8415062,Riederich,25 - 30 Jahre,228,114,114
False,8415062,Riederich,30 - 35 Jahre,372,188,184
False,8415062,Riederich,35 - 40 Jahre,389,207,182
False,8415062,Riederich,40 - 45 Jahre,359,183,176
False,8415062,Riederich,45 - 50 Jahre,297,132,165
False,8415062,Riederich,50 - 55 Jahre,302,159,143
False,8415062,Riederich,55 - 60 Jahre,288,135,153
False,8415062,Riederich,60 - 65 Jahre,299,150,149
False,8415062,Riederich,65 - 75 Jahre,376,191,185
False,8415062,Riederich,75 und mehr Jahre,181,46,135
False,8415062,Riederich,Insgesamt,4285,2112,2173
False,8415073,"Trochtelfingen, Stadt",unter 3 Jahre,250,143,107
False,8415073,"Trochtelfingen, Stadt",3 -  6 Jahre,267,148,119
False,8415073,"Trochtelfingen, Stadt",6 - 10 Jahre,375,186,189
False,8415073,"Trochtelfingen, Stadt",10 - 15 Jahre,438,220,218
False,8415073,"Trochtelfingen, Stadt",15 - 18 Jahre,199,93,106
False,8415073,"Trochtelfingen, Stadt",18 - 20 Jahre,173,84,89
False,8415073,"Trochtelfingen, Stadt",20 - 25 Jahre,374,205,169
False,8415073,"Trochtelfingen, Stadt",25 - 30 Jahre,424,213,211
False,8415073,"Trochtelfingen, Stadt",30 - 35 Jahre,567,312,255
False,8415073,"Trochtelfingen, Stadt",35 - 40 Jahre,533,276,257
False,8415073,"Trochtelfingen, Stadt",40 - 45 Jahre,525,287,238
False,8415073,"Trochtelfingen, Stadt",45 - 50 Jahre,432,222,210
False,8415073,"Trochtelfingen, Stadt",50 - 55 Jahre,378,182,196
False,8415073,"Trochtelfingen, Stadt",55 - 60 Jahre,327,173,154
False,8415073,"Trochtelfingen, Stadt",60 - 65 Jahre,375,194,181
False,8415073,"Trochtelfingen, Stadt",65 - 75 Jahre,575,263,312
False,8415073,"Trochtelfingen, Stadt",75 und mehr Jahre,369,104,265
False,8415073,"Trochtelfingen, Stadt",Insgesamt,6581,3305,3276
False,8415078,"Bad Urach, Stadt",unter 3 Jahre,378,204,174
False,8415078,"Bad Urach, Stadt",3 -  6 Jahre,386,199,187
False,8415078,"Bad Urach, Stadt",6 - 10 Jahre,599,306,293
False,8415078,"Bad Urach, Stadt",10 - 15 Jahre,825,420,405
False,8415078,"Bad Urach, Stadt",15 - 18 Jahre,438,231,207
False,8415078,"Bad Urach, Stadt",18 - 20 Jahre,264,129,135
False,8415078,"Bad Urach, Stadt",20 - 25 Jahre,695,340,355
False,8415078,"Bad Urach, Stadt",25 - 30 Jahre,769,388,381
False,8415078,"Bad Urach, Stadt",30 - 35 Jahre,1012,518,494
False,8415078,"Bad Urach, Stadt",35 - 40 Jahre,1070,531,539
False,8415078,"Bad Urach, Stadt",40 - 45 Jahre,932,493,439
False,8415078,"Bad Urach, Stadt",45 - 50 Jahre,840,408,432
False,8415078,"Bad Urach, Stadt",50 - 55 Jahre,764,406,358
False,8415078,"Bad Urach, Stadt",55 - 60 Jahre,715,358,357
False,8415078,"Bad Urach, Stadt",60 - 65 Jahre,853,403,450
False,8415078,"Bad Urach, Stadt",65 - 75 Jahre,1206,548,658
False,8415078,"Bad Urach, Stadt",75 und mehr Jahre,964,295,669
False,8415078,"Bad Urach, Stadt",Insgesamt,12710,6177,6533
False,8415080,Wannweil,unter 3 Jahre,169,97,72
False,8415080,Wannweil,3 -  6 Jahre,194,92,102
False,8415080,Wannweil,6 - 10 Jahre,246,108,138
False,8415080,Wannweil,10 - 15 Jahre,255,122,133
False,8415080,Wannweil,15 - 18 Jahre,138,70,68
False,8415080,Wannweil,18 - 20 Jahre,94,50,44
False,8415080,Wannweil,20 - 25 Jahre,218,111,107
False,8415080,Wannweil,25 - 30 Jahre,312,160,152
False,8415080,Wannweil,30 - 35 Jahre,431,213,218
False,8415080,Wannweil,35 - 40 Jahre,466,227,239
False,8415080,Wannweil,40 - 45 Jahre,431,224,207
False,8415080,Wannweil,45 - 50 Jahre,345,182,163
False,8415080,Wannweil,50 - 55 Jahre,296,149,147
False,8415080,Wannweil,55 - 60 Jahre,266,139,127
False,8415080,Wannweil,60 - 65 Jahre,341,161,180
False,8415080,Wannweil,65 - 75 Jahre,451,212,239
False,8415080,Wannweil,75 und mehr Jahre,335,107,228
False,8415080,Wannweil,Insgesamt,4988,2424,2564
False,8415085,Zwiefalten,unter 3 Jahre,59,34,25
False,8415085,Zwiefalten,3 -  6 Jahre,71,36,35
False,8415085,Zwiefalten,6 - 10 Jahre,120,67,53
False,8415085,Zwiefalten,10 - 15 Jahre,149,72,77
False,8415085,Zwiefalten,15 - 18 Jahre,69,43,26
False,8415085,Zwiefalten,18 - 20 Jahre,61,32,29
False,8415085,Zwiefalten,20 - 25 Jahre,136,65,71
False,8415085,Zwiefalten,25 - 30 Jahre,128,65,63
False,8415085,Zwiefalten,30 - 35 Jahre,152,84,68
False,8415085,Zwiefalten,35 - 40 Jahre,202,113,89
False,8415085,Zwiefalten,40 - 45 Jahre,153,76,77
False,8415085,Zwiefalten,45 - 50 Jahre,131,70,61
False,8415085,Zwiefalten,50 - 55 Jahre,111,68,43
False,8415085,Zwiefalten,55 - 60 Jahre,88,44,44
False,8415085,Zwiefalten,60 - 65 Jahre,143,64,79
False,8415085,Zwiefalten,65 - 75 Jahre,239,107,132
False,8415085,Zwiefalten,75 und mehr Jahre,168,48,120
False,8415085,Zwiefalten,Insgesamt,2180,1088,1092
False,8415086,Gutsbezirk Münsingen,unter 3 Jahre,11,4,7
False,8415086,Gutsbezirk Münsingen,3 -  6 Jahre,0,0,0
False,8415086,Gutsbezirk Münsingen,6 - 10 Jahre,3,2,1
False,8415086,Gutsbezirk Münsingen,10 - 15 Jahre,16,6,10
False,8415086,Gutsbezirk Münsingen,15 - 18 Jahre,7,3,4
False,8415086,Gutsbezirk Münsingen,18 - 20 Jahre,8,4,4
False,8415086,Gutsbezirk Münsingen,20 - 25 Jahre,29,13,16
False,8415086,Gutsbezirk Münsingen,25 - 30 Jahre,22,11,11
False,8415086,Gutsbezirk Münsingen,30 - 35 Jahre,29,14,15
False,8415086,Gutsbezirk Münsingen,35 - 40 Jahre,31,22,9
False,8415086,Gutsbezirk Münsingen,40 - 45 Jahre,31,17,14
False,8415086,Gutsbezirk Münsingen,45 - 50 Jahre,11,6,5
False,8415086,Gutsbezirk Münsingen,50 - 55 Jahre,16,7,9
False,8415086,Gutsbezirk Münsingen,55 - 60 Jahre,10,5,5
False,8415086,Gutsbezirk Münsingen,60 - 65 Jahre,11,6,5
False,8415086,Gutsbezirk Münsingen,65 - 75 Jahre,19,11,8
False,8415086,Gutsbezirk Münsingen,75 und mehr Jahre,9,5,4
False,8415086,Gutsbezirk Münsingen,Insgesamt,263,136,127
False,8415087,Walddorfhäslach,unter 3 Jahre,180,96,84
False,8415087,Walddorfhäslach,3 -  6 Jahre,211,108,103
False,8415087,Walddorfhäslach,6 - 10 Jahre,279,133,146
False,8415087,Walddorfhäslach,10 - 15 Jahre,355,173,182
False,8415087,Walddorfhäslach,15 - 18 Jahre,171,84,87
False,8415087,Walddorfhäslach,18 - 20 Jahre,134,76,58
False,8415087,Walddorfhäslach,20 - 25 Jahre,252,133,119
False,8415087,Walddorfhäslach,25 - 30 Jahre,278,119,159
False,8415087,Walddorfhäslach,30 - 35 Jahre,419,198,221
False,8415087,Walddorfhäslach,35 - 40 Jahre,483,260,223
False,8415087,Walddorfhäslach,40 - 45 Jahre,433,215,218
False,8415087,Walddorfhäslach,45 - 50 Jahre,359,182,177
False,8415087,Walddorfhäslach,50 - 55 Jahre,281,152,129
False,8415087,Walddorfhäslach,55 - 60 Jahre,228,121,107
False,8415087,Walddorfhäslach,60 - 65 Jahre,226,114,112
False,8415087,Walddorfhäslach,65 - 75 Jahre,319,154,165
False,8415087,Walddorfhäslach,75 und mehr Jahre,147,42,105
False,8415087,Walddorfhäslach,Insgesamt,4755,2360,2395
False,8415088,Römerstein,unter 3 Jahre,153,79,74
False,8415088,Römerstein,3 -  6 Jahre,149,72,77
False,8415088,Römerstein,6 - 10 Jahre,223,108,115
False,8415088,Römerstein,10 - 15 Jahre,256,118,138
False,8415088,Römerstein,15 - 18 Jahre,127,66,61
False,8415088,Römerstein,18 - 20 Jahre,87,36,51
False,8415088,Römerstein,20 - 25 Jahre,184,97,87
False,8415088,Römerstein,25 - 30 Jahre,226,127,99
False,8415088,Römerstein,30 - 35 Jahre,315,152,163
False,8415088,Römerstein,35 - 40 Jahre,321,160,161
False,8415088,Römerstein,40 - 45 Jahre,284,160,124
False,8415088,Römerstein,45 - 50 Jahre,239,124,115
False,8415088,Römerstein,50 - 55 Jahre,223,119,104
False,8415088,Römerstein,55 - 60 Jahre,172,86,86
False,8415088,Römerstein,60 - 65 Jahre,268,122,146
False,8415088,Römerstein,65 - 75 Jahre,375,178,197
False,8415088,Römerstein,75 und mehr Jahre,227,58,169
False,8415088,Römerstein,Insgesamt,3829,1862,1967
False,8415089,Engstingen,unter 3 Jahre,197,94,103
False,8415089,Engstingen,3 -  6 Jahre,219,118,101
False,8415089,Engstingen,6 - 10 Jahre,317,163,154
False,8415089,Engstingen,10 - 15 Jahre,436,214,222
False,8415089,Engstingen,15 - 18 Jahre,193,95,98
False,8415089,Engstingen,18 - 20 Jahre,118,53,65
False,8415089,Engstingen,20 - 25 Jahre,257,119,138
False,8415089,Engstingen,25 - 30 Jahre,252,132,120
False,8415089,Engstingen,30 - 35 Jahre,421,237,184
False,8415089,Engstingen,35 - 40 Jahre,516,264,252
False,8415089,Engstingen,40 - 45 Jahre,463,236,227
False,8415089,Engstingen,45 - 50 Jahre,349,176,173
False,8415089,Engstingen,50 - 55 Jahre,281,146,135
False,8415089,Engstingen,55 - 60 Jahre,245,128,117
False,8415089,Engstingen,60 - 65 Jahre,304,142,162
False,8415089,Engstingen,65 - 75 Jahre,443,211,232
False,8415089,Engstingen,75 und mehr Jahre,274,75,199
False,8415089,Engstingen,Insgesamt,5285,2603,2682
False,8415090,Hohenstein,unter 3 Jahre,161,82,79
False,8415090,Hohenstein,3 -  6 Jahre,167,81,86
False,8415090,Hohenstein,6 - 10 Jahre,237,130,107
False,8415090,Hohenstein,10 - 15 Jahre,232,122,110
False,8415090,Hohenstein,15 - 18 Jahre,111,56,55
False,8415090,Hohenstein,18 - 20 Jahre,91,41,50
False,8415090,Hohenstein,20 - 25 Jahre,213,107,106
False,8415090,Hohenstein,25 - 30 Jahre,261,134,127
False,8415090,Hohenstein,30 - 35 Jahre,303,150,153
False,8415090,Hohenstein,35 - 40 Jahre,344,188,156
False,8415090,Hohenstein,40 - 45 Jahre,297,144,153
False,8415090,Hohenstein,45 - 50 Jahre,206,99,107
False,8415090,Hohenstein,50 - 55 Jahre,185,106,79
False,8415090,Hohenstein,55 - 60 Jahre,144,63,81
False,8415090,Hohenstein,60 - 65 Jahre,207,102,105
False,8415090,Hohenstein,65 - 75 Jahre,328,159,169
False,8415090,Hohenstein,75 und mehr Jahre,191,61,130
False,8415090,Hohenstein,Insgesamt,3678,1825,1853
False,8415091,Sonnenbühl,unter 3 Jahre,265,126,139
False,8415091,Sonnenbühl,3 -  6 Jahre,259,135,124
False,8415091,Sonnenbühl,6 - 10 Jahre,362,180,182
False,8415091,Sonnenbühl,10 - 15 Jahre,455,239,216
False,8415091,Sonnenbühl,15 - 18 Jahre,224,111,113
False,8415091,Sonnenbühl,18 - 20 Jahre,145,84,61
False,8415091,Sonnenbühl,20 - 25 Jahre,360,199,161
False,8415091,Sonnenbühl,25 - 30 Jahre,428,211,217
False,8415091,Sonnenbühl,30 - 35 Jahre,634,316,318
False,8415091,Sonnenbühl,35 - 40 Jahre,660,343,317
False,8415091,Sonnenbühl,40 - 45 Jahre,561,292,269
False,8415091,Sonnenbühl,45 - 50 Jahre,454,253,201
False,8415091,Sonnenbühl,50 - 55 Jahre,400,201,199
False,8415091,Sonnenbühl,55 - 60 Jahre,318,160,158
False,8415091,Sonnenbühl,60 - 65 Jahre,463,240,223
False,8415091,Sonnenbühl,65 - 75 Jahre,605,270,335
False,8415091,Sonnenbühl,75 und mehr Jahre,365,109,256
False,8415091,Sonnenbühl,Insgesamt,6958,3469,3489
False,8415092,Lichtenstein,unter 3 Jahre,293,155,138
False,8415092,Lichtenstein,3 -  6 Jahre,315,165,150
False,8415092,Lichtenstein,6 - 10 Jahre,477,259,218
False,8415092,Lichtenstein,10 - 15 Jahre,628,316,312
False,8415092,Lichtenstein,15 - 18 Jahre,348,174,174
False,8415092,Lichtenstein,18 - 20 Jahre,233,120,113
False,8415092,Lichtenstein,20 - 25 Jahre,534,265,269
False,8415092,Lichtenstein,25 - 30 Jahre,562,287,275
False,8415092,Lichtenstein,30 - 35 Jahre,733,348,385
False,8415092,Lichtenstein,35 - 40 Jahre,799,386,413
False,8415092,Lichtenstein,40 - 45 Jahre,789,429,360
False,8415092,Lichtenstein,45 - 50 Jahre,683,338,345
False,8415092,Lichtenstein,50 - 55 Jahre,503,263,240
False,8415092,Lichtenstein,55 - 60 Jahre,504,241,263
False,8415092,Lichtenstein,60 - 65 Jahre,625,308,317
False,8415092,Lichtenstein,65 - 75 Jahre,821,370,451
False,8415092,Lichtenstein,75 und mehr Jahre,641,187,454
False,8415092,Lichtenstein,Insgesamt,9488,4611,4877
False,8415093,St. Johann,unter 3 Jahre,168,85,83
False,8415093,St. Johann,3 -  6 Jahre,180,98,82
False,8415093,St. Johann,6 - 10 Jahre,276,155,121
False,8415093,St. Johann,10 - 15 Jahre,370,198,172
False,8415093,St. Johann,15 - 18 Jahre,180,95,85
False,8415093,St. Johann,18 - 20 Jahre,135,67,68
False,8415093,St. Johann,20 - 25 Jahre,222,115,107
False,8415093,St. Johann,25 - 30 Jahre,228,109,119
False,8415093,St. Johann,30 - 35 Jahre,423,215,208
False,8415093,St. Johann,35 - 40 Jahre,501,255,246
False,8415093,St. Johann,40 - 45 Jahre,415,220,195
False,8415093,St. Johann,45 - 50 Jahre,343,190,153
False,8415093,St. Johann,50 - 55 Jahre,294,142,152
False,8415093,St. Johann,55 - 60 Jahre,275,135,140
False,8415093,St. Johann,60 - 65 Jahre,326,159,167
False,8415093,St. Johann,65 - 75 Jahre,497,240,257
False,8415093,St. Johann,75 und mehr Jahre,343,107,236
False,8415093,St. Johann,Insgesamt,5176,2585,2591
False,8416,Landkreis Tübingen,unter 3 Jahre,6852,3492,3360
False,8416,Landkreis Tübingen,3 -  6 Jahre,7020,3641,3379
False,8416,Landkreis Tübingen,6 - 10 Jahre,9557,4914,4643
False,8416,Landkreis Tübingen,10 - 15 Jahre,12447,6420,6027
False,8416,Landkreis Tübingen,15 - 18 Jahre,6855,3603,3252
False,8416,Landkreis Tübingen,18 - 20 Jahre,4931,2451,2480
False,8416,Landkreis Tübingen,20 - 25 Jahre,13800,6536,7264
False,8416,Landkreis Tübingen,25 - 30 Jahre,14505,7176,7329
False,8416,Landkreis Tübingen,30 - 35 Jahre,19029,9726,9303
False,8416,Landkreis Tübingen,35 - 40 Jahre,21735,11255,10480
False,8416,Landkreis Tübingen,40 - 45 Jahre,18670,9746,8924
False,8416,Landkreis Tübingen,45 - 50 Jahre,14383,7354,7029
False,8416,Landkreis Tübingen,50 - 55 Jahre,11287,5892,5395
False,8416,Landkreis Tübingen,55 - 60 Jahre,9822,5026,4796
False,8416,Landkreis Tübingen,60 - 65 Jahre,11467,5646,5821
False,8416,Landkreis Tübingen,65 - 75 Jahre,14857,6845,8012
False,8416,Landkreis Tübingen,75 und mehr Jahre,11318,3318,8000
False,8416,Landkreis Tübingen,Insgesamt,208535,103041,105494
False,8416006,Bodelshausen,unter 3 Jahre,178,89,89
False,8416006,Bodelshausen,3 -  6 Jahre,214,108,106
False,8416006,Bodelshausen,6 - 10 Jahre,277,146,131
False,8416006,Bodelshausen,10 - 15 Jahre,391,222,169
False,8416006,Bodelshausen,15 - 18 Jahre,210,121,89
False,8416006,Bodelshausen,18 - 20 Jahre,140,77,63
False,8416006,Bodelshausen,20 - 25 Jahre,383,194,189
False,8416006,Bodelshausen,25 - 30 Jahre,401,193,208
False,8416006,Bodelshausen,30 - 35 Jahre,487,243,244
False,8416006,Bodelshausen,35 - 40 Jahre,484,263,221
False,8416006,Bodelshausen,40 - 45 Jahre,446,228,218
False,8416006,Bodelshausen,45 - 50 Jahre,412,195,217
False,8416006,Bodelshausen,50 - 55 Jahre,333,165,168
False,8416006,Bodelshausen,55 - 60 Jahre,320,163,157
False,8416006,Bodelshausen,60 - 65 Jahre,367,178,189
False,8416006,Bodelshausen,65 - 75 Jahre,490,238,252
False,8416006,Bodelshausen,75 und mehr Jahre,276,91,185
False,8416006,Bodelshausen,Insgesamt,5809,2914,2895
False,8416009,Dettenhausen,unter 3 Jahre,161,76,85
False,8416009,Dettenhausen,3 -  6 Jahre,184,109,75
False,8416009,Dettenhausen,6 - 10 Jahre,263,133,130
False,8416009,Dettenhausen,10 - 15 Jahre,325,178,147
False,8416009,Dettenhausen,15 - 18 Jahre,195,124,71
False,8416009,Dettenhausen,18 - 20 Jahre,126,70,56
False,8416009,Dettenhausen,20 - 25 Jahre,297,144,153
False,8416009,Dettenhausen,25 - 30 Jahre,293,142,151
False,8416009,Dettenhausen,30 - 35 Jahre,418,218,200
False,8416009,Dettenhausen,35 - 40 Jahre,467,241,226
False,8416009,Dettenhausen,40 - 45 Jahre,465,244,221
False,8416009,Dettenhausen,45 - 50 Jahre,358,182,176
False,8416009,Dettenhausen,50 - 55 Jahre,337,158,179
False,8416009,Dettenhausen,55 - 60 Jahre,370,192,178
False,8416009,Dettenhausen,60 - 65 Jahre,357,175,182
False,8416009,Dettenhausen,65 - 75 Jahre,384,182,202
False,8416009,Dettenhausen,75 und mehr Jahre,283,95,188
False,8416009,Dettenhausen,Insgesamt,5283,2663,2620
False,8416011,Dußlingen,unter 3 Jahre,196,89,107
False,8416011,Dußlingen,3 -  6 Jahre,183,84,99
False,8416011,Dußlingen,6 - 10 Jahre,255,147,108
False,8416011,Dußlingen,10 - 15 Jahre,285,155,130
False,8416011,Dußlingen,15 - 18 Jahre,170,94,76
False,8416011,Dußlingen,18 - 20 Jahre,125,51,74
False,8416011,Dußlingen,20 - 25 Jahre,261,129,132
False,8416011,Dußlingen,25 - 30 Jahre,315,158,157
False,8416011,Dußlingen,30 - 35 Jahre,399,206,193
False,8416011,Dußlingen,35 - 40 Jahre,481,253,228
False,8416011,Dußlingen,40 - 45 Jahre,412,222,190
False,8416011,Dußlingen,45 - 50 Jahre,318,157,161
False,8416011,Dußlingen,50 - 55 Jahre,255,134,121
False,8416011,Dußlingen,55 - 60 Jahre,210,102,108
False,8416011,Dußlingen,60 - 65 Jahre,302,143,159
False,8416011,Dußlingen,65 - 75 Jahre,461,211,250
False,8416011,Dußlingen,75 und mehr Jahre,299,86,213
False,8416011,Dußlingen,Insgesamt,4927,2421,2506
False,8416015,Gomaringen,unter 3 Jahre,294,137,157
False,8416015,Gomaringen,3 -  6 Jahre,320,158,162
False,8416015,Gomaringen,6 - 10 Jahre,414,223,191
False,8416015,Gomaringen,10 - 15 Jahre,539,278,261
False,8416015,Gomaringen,15 - 18 Jahre,271,131,140
False,8416015,Gomaringen,18 - 20 Jahre,188,105,83
False,8416015,Gomaringen,20 - 25 Jahre,402,202,200
False,8416015,Gomaringen,25 - 30 Jahre,491,249,242
False,8416015,Gomaringen,30 - 35 Jahre,746,363,383
False,8416015,Gomaringen,35 - 40 Jahre,769,386,383
False,8416015,Gomaringen,40 - 45 Jahre,693,356,337
False,8416015,Gomaringen,45 - 50 Jahre,500,237,263
False,8416015,Gomaringen,50 - 55 Jahre,431,222,209
False,8416015,Gomaringen,55 - 60 Jahre,395,198,197
False,8416015,Gomaringen,60 - 65 Jahre,498,248,250
False,8416015,Gomaringen,65 - 75 Jahre,661,306,355
False,8416015,Gomaringen,75 und mehr Jahre,440,123,317
False,8416015,Gomaringen,Insgesamt,8052,3922,4130
False,8416018,Hirrlingen,unter 3 Jahre,117,66,51
False,8416018,Hirrlingen,3 -  6 Jahre,148,79,69
False,8416018,Hirrlingen,6 - 10 Jahre,202,85,117
False,8416018,Hirrlingen,10 - 15 Jahre,237,115,122
False,8416018,Hirrlingen,15 - 18 Jahre,103,50,53
False,8416018,Hirrlingen,18 - 20 Jahre,71,36,35
False,8416018,Hirrlingen,20 - 25 Jahre,161,81,80
False,8416018,Hirrlingen,25 - 30 Jahre,160,83,77
False,8416018,Hirrlingen,30 - 35 Jahre,231,119,112
False,8416018,Hirrlingen,35 - 40 Jahre,302,165,137
False,8416018,Hirrlingen,40 - 45 Jahre,241,131,110
False,8416018,Hirrlingen,45 - 50 Jahre,217,113,104
False,8416018,Hirrlingen,50 - 55 Jahre,147,81,66
False,8416018,Hirrlingen,55 - 60 Jahre,84,47,37
False,8416018,Hirrlingen,60 - 65 Jahre,172,83,89
False,8416018,Hirrlingen,65 - 75 Jahre,213,105,108
False,8416018,Hirrlingen,75 und mehr Jahre,124,36,88
False,8416018,Hirrlingen,Insgesamt,2930,1475,1455
False,8416022,Kirchentellinsfurt,unter 3 Jahre,183,83,100
False,8416022,Kirchentellinsfurt,3 -  6 Jahre,192,89,103
False,8416022,Kirchentellinsfurt,6 - 10 Jahre,249,136,113
False,8416022,Kirchentellinsfurt,10 - 15 Jahre,317,180,137
False,8416022,Kirchentellinsfurt,15 - 18 Jahre,185,103,82
False,8416022,Kirchentellinsfurt,18 - 20 Jahre,148,74,74
False,8416022,Kirchentellinsfurt,20 - 25 Jahre,257,131,126
False,8416022,Kirchentellinsfurt,25 - 30 Jahre,291,128,163
False,8416022,Kirchentellinsfurt,30 - 35 Jahre,471,243,228
False,8416022,Kirchentellinsfurt,35 - 40 Jahre,546,282,264
False,8416022,Kirchentellinsfurt,40 - 45 Jahre,456,222,234
False,8416022,Kirchentellinsfurt,45 - 50 Jahre,402,201,201
False,8416022,Kirchentellinsfurt,50 - 55 Jahre,325,171,154
False,8416022,Kirchentellinsfurt,55 - 60 Jahre,319,167,152
False,8416022,Kirchentellinsfurt,60 - 65 Jahre,285,143,142
False,8416022,Kirchentellinsfurt,65 - 75 Jahre,432,191,241
False,8416022,Kirchentellinsfurt,75 und mehr Jahre,274,85,189
False,8416022,Kirchentellinsfurt,Insgesamt,5332,2629,2703
False,8416023,Kusterdingen,unter 3 Jahre,303,154,149
False,8416023,Kusterdingen,3 -  6 Jahre,331,182,149
False,8416023,Kusterdingen,6 - 10 Jahre,466,234,232
False,8416023,Kusterdingen,10 - 15 Jahre,514,255,259
False,8416023,Kusterdingen,15 - 18 Jahre,247,130,117
False,8416023,Kusterdingen,18 - 20 Jahre,172,79,93
False,8416023,Kusterdingen,20 - 25 Jahre,401,183,218
False,8416023,Kusterdingen,25 - 30 Jahre,478,231,247
False,8416023,Kusterdingen,30 - 35 Jahre,733,369,364
False,8416023,Kusterdingen,35 - 40 Jahre,834,402,432
False,8416023,Kusterdingen,40 - 45 Jahre,687,354,333
False,8416023,Kusterdingen,45 - 50 Jahre,572,316,256
False,8416023,Kusterdingen,50 - 55 Jahre,432,220,212
False,8416023,Kusterdingen,55 - 60 Jahre,367,179,188
False,8416023,Kusterdingen,60 - 65 Jahre,543,270,273
False,8416023,Kusterdingen,65 - 75 Jahre,570,280,290
False,8416023,Kusterdingen,75 und mehr Jahre,422,119,303
False,8416023,Kusterdingen,Insgesamt,8072,3957,4115
False,8416025,"Mössingen, Stadt",unter 3 Jahre,687,366,321
False,8416025,"Mössingen, Stadt",3 -  6 Jahre,680,355,325
False,8416025,"Mössingen, Stadt",6 - 10 Jahre,982,525,457
False,8416025,"Mössingen, Stadt",10 - 15 Jahre,1358,695,663
False,8416025,"Mössingen, Stadt",15 - 18 Jahre,759,398,361
False,8416025,"Mössingen, Stadt",18 - 20 Jahre,525,284,241
False,8416025,"Mössingen, Stadt",20 - 25 Jahre,1138,572,566
False,8416025,"Mössingen, Stadt",25 - 30 Jahre,1160,563,597
False,8416025,"Mössingen, Stadt",30 - 35 Jahre,1520,773,747
False,8416025,"Mössingen, Stadt",35 - 40 Jahre,1625,835,790
False,8416025,"Mössingen, Stadt",40 - 45 Jahre,1553,775,778
False,8416025,"Mössingen, Stadt",45 - 50 Jahre,1330,641,689
False,8416025,"Mössingen, Stadt",50 - 55 Jahre,1082,550,532
False,8416025,"Mössingen, Stadt",55 - 60 Jahre,968,511,457
False,8416025,"Mössingen, Stadt",60 - 65 Jahre,1166,572,594
False,8416025,"Mössingen, Stadt",65 - 75 Jahre,1596,752,844
False,8416025,"Mössingen, Stadt",75 und mehr Jahre,1055,309,746
False,8416025,"Mössingen, Stadt",Insgesamt,19184,9476,9708
False,8416026,Nehren,unter 3 Jahre,126,67,59
False,8416026,Nehren,3 -  6 Jahre,113,63,50
False,8416026,Nehren,6 - 10 Jahre,164,85,79
False,8416026,Nehren,10 - 15 Jahre,237,129,108
False,8416026,Nehren,15 - 18 Jahre,129,77,52
False,8416026,Nehren,18 - 20 Jahre,89,45,44
False,8416026,Nehren,20 - 25 Jahre,228,98,130
False,8416026,Nehren,25 - 30 Jahre,204,93,111
False,8416026,Nehren,30 - 35 Jahre,308,160,148
False,8416026,Nehren,35 - 40 Jahre,311,168,143
False,8416026,Nehren,40 - 45 Jahre,302,146,156
False,8416026,Nehren,45 - 50 Jahre,281,134,147
False,8416026,Nehren,50 - 55 Jahre,230,124,106
False,8416026,Nehren,55 - 60 Jahre,179,95,84
False,8416026,Nehren,60 - 65 Jahre,198,89,109
False,8416026,Nehren,65 - 75 Jahre,293,131,162
False,8416026,Nehren,75 und mehr Jahre,235,78,157
False,8416026,Nehren,Insgesamt,3627,1782,1845
False,8416031,Ofterdingen,unter 3 Jahre,142,79,63
False,8416031,Ofterdingen,3 -  6 Jahre,154,86,68
False,8416031,Ofterdingen,6 - 10 Jahre,193,86,107
False,8416031,Ofterdingen,10 - 15 Jahre,260,121,139
False,8416031,Ofterdingen,15 - 18 Jahre,157,78,79
False,8416031,Ofterdingen,18 - 20 Jahre,113,52,61
False,8416031,Ofterdingen,20 - 25 Jahre,240,129,111
False,8416031,Ofterdingen,25 - 30 Jahre,249,126,123
False,8416031,Ofterdingen,30 - 35 Jahre,356,180,176
False,8416031,Ofterdingen,35 - 40 Jahre,418,228,190
False,8416031,Ofterdingen,40 - 45 Jahre,311,159,152
False,8416031,Ofterdingen,45 - 50 Jahre,329,160,169
False,8416031,Ofterdingen,50 - 55 Jahre,273,141,132
False,8416031,Ofterdingen,55 - 60 Jahre,204,115,89
False,8416031,Ofterdingen,60 - 65 Jahre,252,123,129
False,8416031,Ofterdingen,65 - 75 Jahre,341,163,178
False,8416031,Ofterdingen,75 und mehr Jahre,227,67,160
False,8416031,Ofterdingen,Insgesamt,4219,2093,2126
False,8416036,"Rottenburg am Neckar, Stadt",unter 3 Jahre,1425,727,698
False,8416036,"Rottenburg am Neckar, Stadt",3 -  6 Jahre,1537,805,732
False,8416036,"Rottenburg am Neckar, Stadt",6 - 10 Jahre,2157,1117,1040
False,8416036,"Rottenburg am Neckar, Stadt",10 - 15 Jahre,2851,1455,1396
False,8416036,"Rottenburg am Neckar, Stadt",15 - 18 Jahre,1576,834,742
False,8416036,"Rottenburg am Neckar, Stadt",18 - 20 Jahre,1071,563,508
False,8416036,"Rottenburg am Neckar, Stadt",20 - 25 Jahre,2390,1196,1194
False,8416036,"Rottenburg am Neckar, Stadt",25 - 30 Jahre,2481,1258,1223
False,8416036,"Rottenburg am Neckar, Stadt",30 - 35 Jahre,3409,1695,1714
False,8416036,"Rottenburg am Neckar, Stadt",35 - 40 Jahre,4023,2175,1848
False,8416036,"Rottenburg am Neckar, Stadt",40 - 45 Jahre,3651,1930,1721
False,8416036,"Rottenburg am Neckar, Stadt",45 - 50 Jahre,2876,1489,1387
False,8416036,"Rottenburg am Neckar, Stadt",50 - 55 Jahre,2222,1168,1054
False,8416036,"Rottenburg am Neckar, Stadt",55 - 60 Jahre,2044,1080,964
False,8416036,"Rottenburg am Neckar, Stadt",60 - 65 Jahre,2472,1276,1196
False,8416036,"Rottenburg am Neckar, Stadt",65 - 75 Jahre,3003,1412,1591
False,8416036,"Rottenburg am Neckar, Stadt",75 und mehr Jahre,2148,629,1519
False,8416036,"Rottenburg am Neckar, Stadt",Insgesamt,41336,20809,20527
False,8416041,"Tübingen, Universitätsstadt",unter 3 Jahre,2290,1175,1115
False,8416041,"Tübingen, Universitätsstadt",3 -  6 Jahre,2215,1140,1075
False,8416041,"Tübingen, Universitätsstadt",6 - 10 Jahre,2940,1488,1452
False,8416041,"Tübingen, Universitätsstadt",10 - 15 Jahre,3768,1948,1820
False,8416041,"Tübingen, Universitätsstadt",15 - 18 Jahre,2167,1090,1077
False,8416041,"Tübingen, Universitätsstadt",18 - 20 Jahre,1721,792,929
False,8416041,"Tübingen, Universitätsstadt",20 - 25 Jahre,6625,2949,3676
False,8416041,"Tübingen, Universitätsstadt",25 - 30 Jahre,6922,3415,3507
False,8416041,"Tübingen, Universitätsstadt",30 - 35 Jahre,8335,4350,3985
False,8416041,"Tübingen, Universitätsstadt",35 - 40 Jahre,9676,4969,4707
False,8416041,"Tübingen, Universitätsstadt",40 - 45 Jahre,7820,4124,3696
False,8416041,"Tübingen, Universitätsstadt",45 - 50 Jahre,5503,2871,2632
False,8416041,"Tübingen, Universitätsstadt",50 - 55 Jahre,4233,2225,2008
False,8416041,"Tübingen, Universitätsstadt",55 - 60 Jahre,3585,1768,1817
False,8416041,"Tübingen, Universitätsstadt",60 - 65 Jahre,3809,1820,1989
False,8416041,"Tübingen, Universitätsstadt",65 - 75 Jahre,5024,2208,2816
False,8416041,"Tübingen, Universitätsstadt",75 und mehr Jahre,4714,1346,3368
False,8416041,"Tübingen, Universitätsstadt",Insgesamt,81347,39678,41669
False,8416048,Ammerbuch,unter 3 Jahre,478,251,227
False,8416048,Ammerbuch,3 -  6 Jahre,442,231,211
False,8416048,Ammerbuch,6 - 10 Jahre,578,302,276
False,8416048,Ammerbuch,10 - 15 Jahre,788,401,387
False,8416048,Ammerbuch,15 - 18 Jahre,409,229,180
False,8416048,Ammerbuch,18 - 20 Jahre,259,130,129
False,8416048,Ammerbuch,20 - 25 Jahre,624,309,315
False,8416048,Ammerbuch,25 - 30 Jahre,643,301,342
False,8416048,Ammerbuch,30 - 35 Jahre,990,500,490
False,8416048,Ammerbuch,35 - 40 Jahre,1049,525,524
False,8416048,Ammerbuch,40 - 45 Jahre,979,524,455
False,8416048,Ammerbuch,45 - 50 Jahre,765,370,395
False,8416048,Ammerbuch,50 - 55 Jahre,647,345,302
False,8416048,Ammerbuch,55 - 60 Jahre,512,278,234
False,8416048,Ammerbuch,60 - 65 Jahre,663,334,329
False,8416048,Ammerbuch,65 - 75 Jahre,787,375,412
False,8416048,Ammerbuch,75 und mehr Jahre,476,142,334
False,8416048,Ammerbuch,Insgesamt,11089,5547,5542
False,8416049,Neustetten,unter 3 Jahre,128,69,59
False,8416049,Neustetten,3 -  6 Jahre,147,73,74
False,8416049,Neustetten,6 - 10 Jahre,201,95,106
False,8416049,Neustetten,10 - 15 Jahre,262,131,131
False,8416049,Neustetten,15 - 18 Jahre,127,73,54
False,8416049,Neustetten,18 - 20 Jahre,100,53,47
False,8416049,Neustetten,20 - 25 Jahre,193,102,91
False,8416049,Neustetten,25 - 30 Jahre,206,111,95
False,8416049,Neustetten,30 - 35 Jahre,295,147,148
False,8416049,Neustetten,35 - 40 Jahre,315,145,170
False,8416049,Neustetten,40 - 45 Jahre,298,142,156
False,8416049,Neustetten,45 - 50 Jahre,256,149,107
False,8416049,Neustetten,50 - 55 Jahre,176,89,87
False,8416049,Neustetten,55 - 60 Jahre,123,60,63
False,8416049,Neustetten,60 - 65 Jahre,140,73,67
False,8416049,Neustetten,65 - 75 Jahre,211,101,110
False,8416049,Neustetten,75 und mehr Jahre,136,44,92
False,8416049,Neustetten,Insgesamt,3314,1657,1657
False,8416050,Starzach,unter 3 Jahre,144,64,80
False,8416050,Starzach,3 -  6 Jahre,160,79,81
False,8416050,Starzach,6 - 10 Jahre,216,112,104
False,8416050,Starzach,10 - 15 Jahre,315,157,158
False,8416050,Starzach,15 - 18 Jahre,150,71,79
False,8416050,Starzach,18 - 20 Jahre,83,40,43
False,8416050,Starzach,20 - 25 Jahre,200,117,83
False,8416050,Starzach,25 - 30 Jahre,211,125,86
False,8416050,Starzach,30 - 35 Jahre,331,160,171
False,8416050,Starzach,35 - 40 Jahre,435,218,217
False,8416050,Starzach,40 - 45 Jahre,356,189,167
False,8416050,Starzach,45 - 50 Jahre,264,139,125
False,8416050,Starzach,50 - 55 Jahre,164,99,65
False,8416050,Starzach,55 - 60 Jahre,142,71,71
False,8416050,Starzach,60 - 65 Jahre,243,119,124
False,8416050,Starzach,65 - 75 Jahre,391,190,201
False,8416050,Starzach,75 und mehr Jahre,209,68,141
False,8416050,Starzach,Insgesamt,4014,2018,1996
False,8417,Landkreis Zollernalbkreis,unter 3 Jahre,5791,2936,2855
False,8417,Landkreis Zollernalbkreis,3 -  6 Jahre,6308,3324,2984
False,8417,Landkreis Zollernalbkreis,6 - 10 Jahre,9415,4801,4614
False,8417,Landkreis Zollernalbkreis,10 - 15 Jahre,12176,6346,5830
False,8417,Landkreis Zollernalbkreis,15 - 18 Jahre,6586,3385,3201
False,8417,Landkreis Zollernalbkreis,18 - 20 Jahre,4392,2277,2115
False,8417,Landkreis Zollernalbkreis,20 - 25 Jahre,10231,5370,4861
False,8417,Landkreis Zollernalbkreis,25 - 30 Jahre,11209,5776,5433
False,8417,Landkreis Zollernalbkreis,30 - 35 Jahre,14925,7690,7235
False,8417,Landkreis Zollernalbkreis,35 - 40 Jahre,16721,8608,8113
False,8417,Landkreis Zollernalbkreis,40 - 45 Jahre,15032,7738,7294
False,8417,Landkreis Zollernalbkreis,45 - 50 Jahre,12910,6475,6435
False,8417,Landkreis Zollernalbkreis,50 - 55 Jahre,11218,5699,5519
False,8417,Landkreis Zollernalbkreis,55 - 60 Jahre,10235,5083,5152
False,8417,Landkreis Zollernalbkreis,60 - 65 Jahre,13392,6524,6868
False,8417,Landkreis Zollernalbkreis,65 - 75 Jahre,18927,8642,10285
False,8417,Landkreis Zollernalbkreis,75 und mehr Jahre,13423,3976,9447
False,8417,Landkreis Zollernalbkreis,Insgesamt,192891,94650,98241
False,8417002,"Balingen, Stadt",unter 3 Jahre,1030,520,510
False,8417002,"Balingen, Stadt",3 -  6 Jahre,999,529,470
False,8417002,"Balingen, Stadt",6 - 10 Jahre,1479,792,687
False,8417002,"Balingen, Stadt",10 - 15 Jahre,1993,1062,931
False,8417002,"Balingen, Stadt",15 - 18 Jahre,1136,569,567
False,8417002,"Balingen, Stadt",18 - 20 Jahre,747,385,362
False,8417002,"Balingen, Stadt",20 - 25 Jahre,1824,967,857
False,8417002,"Balingen, Stadt",25 - 30 Jahre,1914,1012,902
False,8417002,"Balingen, Stadt",30 - 35 Jahre,2580,1298,1282
False,8417002,"Balingen, Stadt",35 - 40 Jahre,2806,1430,1376
False,8417002,"Balingen, Stadt",40 - 45 Jahre,2587,1261,1326
False,8417002,"Balingen, Stadt",45 - 50 Jahre,2295,1132,1163
False,8417002,"Balingen, Stadt",50 - 55 Jahre,2026,1001,1025
False,8417002,"Balingen, Stadt",55 - 60 Jahre,1948,964,984
False,8417002,"Balingen, Stadt",60 - 65 Jahre,2429,1169,1260
False,8417002,"Balingen, Stadt",65 - 75 Jahre,3344,1533,1811
False,8417002,"Balingen, Stadt",75 und mehr Jahre,2563,783,1780
False,8417002,"Balingen, Stadt",Insgesamt,33700,16407,17293
False,8417008,Bisingen,unter 3 Jahre,247,129,118
False,8417008,Bisingen,3 -  6 Jahre,316,177,139
False,8417008,Bisingen,6 - 10 Jahre,470,240,230
False,8417008,Bisingen,10 - 15 Jahre,601,316,285
False,8417008,Bisingen,15 - 18 Jahre,295,162,133
False,8417008,Bisingen,18 - 20 Jahre,212,119,93
False,8417008,Bisingen,20 - 25 Jahre,518,267,251
False,8417008,Bisingen,25 - 30 Jahre,532,273,259
False,8417008,Bisingen,30 - 35 Jahre,718,375,343
False,8417008,Bisingen,35 - 40 Jahre,822,409,413
False,8417008,Bisingen,40 - 45 Jahre,761,388,373
False,8417008,Bisingen,45 - 50 Jahre,686,360,326
False,8417008,Bisingen,50 - 55 Jahre,547,277,270
False,8417008,Bisingen,55 - 60 Jahre,447,219,228
False,8417008,Bisingen,60 - 65 Jahre,613,314,299
False,8417008,Bisingen,65 - 75 Jahre,851,372,479
False,8417008,Bisingen,75 und mehr Jahre,555,172,383
False,8417008,Bisingen,Insgesamt,9191,4569,4622
False,8417010,Bitz,unter 3 Jahre,91,45,46
False,8417010,Bitz,3 -  6 Jahre,110,58,52
False,8417010,Bitz,6 - 10 Jahre,178,96,82
False,8417010,Bitz,10 - 15 Jahre,199,82,117
False,8417010,Bitz,15 - 18 Jahre,136,78,58
False,8417010,Bitz,18 - 20 Jahre,77,33,44
False,8417010,Bitz,20 - 25 Jahre,158,80,78
False,8417010,Bitz,25 - 30 Jahre,206,110,96
False,8417010,Bitz,30 - 35 Jahre,274,146,128
False,8417010,Bitz,35 - 40 Jahre,325,159,166
False,8417010,Bitz,40 - 45 Jahre,304,163,141
False,8417010,Bitz,45 - 50 Jahre,243,125,118
False,8417010,Bitz,50 - 55 Jahre,237,120,117
False,8417010,Bitz,55 - 60 Jahre,236,110,126
False,8417010,Bitz,60 - 65 Jahre,259,119,140
False,8417010,Bitz,65 - 75 Jahre,430,213,217
False,8417010,Bitz,75 und mehr Jahre,262,76,186
False,8417010,Bitz,Insgesamt,3725,1813,1912
False,8417013,"Burladingen, Stadt",unter 3 Jahre,402,206,196
False,8417013,"Burladingen, Stadt",3 -  6 Jahre,442,226,216
False,8417013,"Burladingen, Stadt",6 - 10 Jahre,688,365,323
False,8417013,"Burladingen, Stadt",10 - 15 Jahre,842,431,411
False,8417013,"Burladingen, Stadt",15 - 18 Jahre,445,226,219
False,8417013,"Burladingen, Stadt",18 - 20 Jahre,281,142,139
False,8417013,"Burladingen, Stadt",20 - 25 Jahre,708,374,334
False,8417013,"Burladingen, Stadt",25 - 30 Jahre,777,389,388
False,8417013,"Burladingen, Stadt",30 - 35 Jahre,1102,586,516
False,8417013,"Burladingen, Stadt",35 - 40 Jahre,1167,593,574
False,8417013,"Burladingen, Stadt",40 - 45 Jahre,1036,549,487
False,8417013,"Burladingen, Stadt",45 - 50 Jahre,883,414,469
False,8417013,"Burladingen, Stadt",50 - 55 Jahre,743,409,334
False,8417013,"Burladingen, Stadt",55 - 60 Jahre,610,307,303
False,8417013,"Burladingen, Stadt",60 - 65 Jahre,885,429,456
False,8417013,"Burladingen, Stadt",65 - 75 Jahre,1290,567,723
False,8417013,"Burladingen, Stadt",75 und mehr Jahre,838,232,606
False,8417013,"Burladingen, Stadt",Insgesamt,13139,6445,6694
False,8417014,Dautmergen,unter 3 Jahre,10,7,3
False,8417014,Dautmergen,3 -  6 Jahre,14,6,8
False,8417014,Dautmergen,6 - 10 Jahre,23,9,14
False,8417014,Dautmergen,10 - 15 Jahre,28,13,15
False,8417014,Dautmergen,15 - 18 Jahre,8,4,4
False,8417014,Dautmergen,18 - 20 Jahre,14,8,6
False,8417014,Dautmergen,20 - 25 Jahre,25,13,12
False,8417014,Dautmergen,25 - 30 Jahre,28,15,13
False,8417014,Dautmergen,30 - 35 Jahre,39,24,15
False,8417014,Dautmergen,35 - 40 Jahre,30,16,14
False,8417014,Dautmergen,40 - 45 Jahre,38,15,23
False,8417014,Dautmergen,45 - 50 Jahre,36,16,20
False,8417014,Dautmergen,50 - 55 Jahre,23,16,7
False,8417014,Dautmergen,55 - 60 Jahre,21,10,11
False,8417014,Dautmergen,60 - 65 Jahre,26,12,14
False,8417014,Dautmergen,65 - 75 Jahre,34,15,19
False,8417014,Dautmergen,75 und mehr Jahre,22,9,13
False,8417014,Dautmergen,Insgesamt,419,208,211
False,8417015,Dormettingen,unter 3 Jahre,43,19,24
False,8417015,Dormettingen,3 -  6 Jahre,51,25,26
False,8417015,Dormettingen,6 - 10 Jahre,76,40,36
False,8417015,Dormettingen,10 - 15 Jahre,74,39,35
False,8417015,Dormettingen,15 - 18 Jahre,47,25,22
False,8417015,Dormettingen,18 - 20 Jahre,27,14,13
False,8417015,Dormettingen,20 - 25 Jahre,52,19,33
False,8417015,Dormettingen,25 - 30 Jahre,52,28,24
False,8417015,Dormettingen,30 - 35 Jahre,90,41,49
False,8417015,Dormettingen,35 - 40 Jahre,117,65,52
False,8417015,Dormettingen,40 - 45 Jahre,96,46,50
False,8417015,Dormettingen,45 - 50 Jahre,64,37,27
False,8417015,Dormettingen,50 - 55 Jahre,40,25,15
False,8417015,Dormettingen,55 - 60 Jahre,40,22,18
False,8417015,Dormettingen,60 - 65 Jahre,61,30,31
False,8417015,Dormettingen,65 - 75 Jahre,83,42,41
False,8417015,Dormettingen,75 und mehr Jahre,62,18,44
False,8417015,Dormettingen,Insgesamt,1075,535,540
False,8417016,Dotternhausen,unter 3 Jahre,58,25,33
False,8417016,Dotternhausen,3 -  6 Jahre,55,30,25
False,8417016,Dotternhausen,6 - 10 Jahre,103,57,46
False,8417016,Dotternhausen,10 - 15 Jahre,133,62,71
False,8417016,Dotternhausen,15 - 18 Jahre,76,38,38
False,8417016,Dotternhausen,18 - 20 Jahre,55,32,23
False,8417016,Dotternhausen,20 - 25 Jahre,97,42,55
False,8417016,Dotternhausen,25 - 30 Jahre,89,45,44
False,8417016,Dotternhausen,30 - 35 Jahre,131,71,60
False,8417016,Dotternhausen,35 - 40 Jahre,154,83,71
False,8417016,Dotternhausen,40 - 45 Jahre,181,83,98
False,8417016,Dotternhausen,45 - 50 Jahre,163,85,78
False,8417016,Dotternhausen,50 - 55 Jahre,93,47,46
False,8417016,Dotternhausen,55 - 60 Jahre,73,38,35
False,8417016,Dotternhausen,60 - 65 Jahre,101,48,53
False,8417016,Dotternhausen,65 - 75 Jahre,144,59,85
False,8417016,Dotternhausen,75 und mehr Jahre,58,17,41
False,8417016,Dotternhausen,Insgesamt,1764,862,902
False,8417022,"Geislingen, Stadt",unter 3 Jahre,224,130,94
False,8417022,"Geislingen, Stadt",3 -  6 Jahre,236,128,108
False,8417022,"Geislingen, Stadt",6 - 10 Jahre,346,180,166
False,8417022,"Geislingen, Stadt",10 - 15 Jahre,413,233,180
False,8417022,"Geislingen, Stadt",15 - 18 Jahre,211,117,94
False,8417022,"Geislingen, Stadt",18 - 20 Jahre,126,64,62
False,8417022,"Geislingen, Stadt",20 - 25 Jahre,294,161,133
False,8417022,"Geislingen, Stadt",25 - 30 Jahre,368,177,191
False,8417022,"Geislingen, Stadt",30 - 35 Jahre,539,256,283
False,8417022,"Geislingen, Stadt",35 - 40 Jahre,602,329,273
False,8417022,"Geislingen, Stadt",40 - 45 Jahre,460,253,207
False,8417022,"Geislingen, Stadt",45 - 50 Jahre,362,180,182
False,8417022,"Geislingen, Stadt",50 - 55 Jahre,339,170,169
False,8417022,"Geislingen, Stadt",55 - 60 Jahre,263,136,127
False,8417022,"Geislingen, Stadt",60 - 65 Jahre,438,213,225
False,8417022,"Geislingen, Stadt",65 - 75 Jahre,558,271,287
False,8417022,"Geislingen, Stadt",75 und mehr Jahre,338,95,243
False,8417022,"Geislingen, Stadt",Insgesamt,6117,3093,3024
False,8417023,Grosselfingen,unter 3 Jahre,70,33,37
False,8417023,Grosselfingen,3 -  6 Jahre,69,41,28
False,8417023,Grosselfingen,6 - 10 Jahre,98,46,52
False,8417023,Grosselfingen,10 - 15 Jahre,113,65,48
False,8417023,Grosselfingen,15 - 18 Jahre,58,40,18
False,8417023,Grosselfingen,18 - 20 Jahre,43,19,24
False,8417023,Grosselfingen,20 - 25 Jahre,93,39,54
False,8417023,Grosselfingen,25 - 30 Jahre,128,73,55
False,8417023,Grosselfingen,30 - 35 Jahre,171,82,89
False,8417023,Grosselfingen,35 - 40 Jahre,186,87,99
False,8417023,Grosselfingen,40 - 45 Jahre,168,97,71
False,8417023,Grosselfingen,45 - 50 Jahre,137,67,70
False,8417023,Grosselfingen,50 - 55 Jahre,110,67,43
False,8417023,Grosselfingen,55 - 60 Jahre,87,48,39
False,8417023,Grosselfingen,60 - 65 Jahre,111,45,66
False,8417023,Grosselfingen,65 - 75 Jahre,177,88,89
False,8417023,Grosselfingen,75 und mehr Jahre,122,30,92
False,8417023,Grosselfingen,Insgesamt,1941,967,974
False,8417025,"Haigerloch, Stadt",unter 3 Jahre,359,176,183
False,8417025,"Haigerloch, Stadt",3 -  6 Jahre,401,212,189
False,8417025,"Haigerloch, Stadt",6 - 10 Jahre,620,309,311
False,8417025,"Haigerloch, Stadt",10 - 15 Jahre,758,392,366
False,8417025,"Haigerloch, Stadt",15 - 18 Jahre,346,191,155
False,8417025,"Haigerloch, Stadt",18 - 20 Jahre,221,99,122
False,8417025,"Haigerloch, Stadt",20 - 25 Jahre,526,294,232
False,8417025,"Haigerloch, Stadt",25 - 30 Jahre,671,338,333
False,8417025,"Haigerloch, Stadt",30 - 35 Jahre,937,485,452
False,8417025,"Haigerloch, Stadt",35 - 40 Jahre,1038,539,499
False,8417025,"Haigerloch, Stadt",40 - 45 Jahre,888,471,417
False,8417025,"Haigerloch, Stadt",45 - 50 Jahre,641,329,312
False,8417025,"Haigerloch, Stadt",50 - 55 Jahre,631,321,310
False,8417025,"Haigerloch, Stadt",55 - 60 Jahre,496,257,239
False,8417025,"Haigerloch, Stadt",60 - 65 Jahre,740,338,402
False,8417025,"Haigerloch, Stadt",65 - 75 Jahre,974,469,505
False,8417025,"Haigerloch, Stadt",75 und mehr Jahre,646,180,466
False,8417025,"Haigerloch, Stadt",Insgesamt,10893,5400,5493
False,8417029,Hausen am Tann,unter 3 Jahre,10,5,5
False,8417029,Hausen am Tann,3 -  6 Jahre,25,11,14
False,8417029,Hausen am Tann,6 - 10 Jahre,28,13,15
False,8417029,Hausen am Tann,10 - 15 Jahre,32,18,14
False,8417029,Hausen am Tann,15 - 18 Jahre,23,9,14
False,8417029,Hausen am Tann,18 - 20 Jahre,17,9,8
False,8417029,Hausen am Tann,20 - 25 Jahre,33,16,17
False,8417029,Hausen am Tann,25 - 30 Jahre,35,22,13
False,8417029,Hausen am Tann,30 - 35 Jahre,30,16,14
False,8417029,Hausen am Tann,35 - 40 Jahre,51,27,24
False,8417029,Hausen am Tann,40 - 45 Jahre,47,27,20
False,8417029,Hausen am Tann,45 - 50 Jahre,34,14,20
False,8417029,Hausen am Tann,50 - 55 Jahre,27,15,12
False,8417029,Hausen am Tann,55 - 60 Jahre,18,13,5
False,8417029,Hausen am Tann,60 - 65 Jahre,25,14,11
False,8417029,Hausen am Tann,65 - 75 Jahre,45,19,26
False,8417029,Hausen am Tann,75 und mehr Jahre,37,13,24
False,8417029,Hausen am Tann,Insgesamt,517,261,256
False,8417031,"Hechingen, Stadt",unter 3 Jahre,590,286,304
False,8417031,"Hechingen, Stadt",3 -  6 Jahre,624,322,302
False,8417031,"Hechingen, Stadt",6 - 10 Jahre,958,481,477
False,8417031,"Hechingen, Stadt",10 - 15 Jahre,1262,646,616
False,8417031,"Hechingen, Stadt",15 - 18 Jahre,728,374,354
False,8417031,"Hechingen, Stadt",18 - 20 Jahre,491,254,237
False,8417031,"Hechingen, Stadt",20 - 25 Jahre,1094,594,500
False,8417031,"Hechingen, Stadt",25 - 30 Jahre,1146,590,556
False,8417031,"Hechingen, Stadt",30 - 35 Jahre,1381,667,714
False,8417031,"Hechingen, Stadt",35 - 40 Jahre,1619,827,792
False,8417031,"Hechingen, Stadt",40 - 45 Jahre,1538,810,728
False,8417031,"Hechingen, Stadt",45 - 50 Jahre,1365,687,678
False,8417031,"Hechingen, Stadt",50 - 55 Jahre,1084,551,533
False,8417031,"Hechingen, Stadt",55 - 60 Jahre,1053,503,550
False,8417031,"Hechingen, Stadt",60 - 65 Jahre,1239,622,617
False,8417031,"Hechingen, Stadt",65 - 75 Jahre,1903,840,1063
False,8417031,"Hechingen, Stadt",75 und mehr Jahre,1381,399,982
False,8417031,"Hechingen, Stadt",Insgesamt,19456,9453,10003
False,8417036,Jungingen,unter 3 Jahre,50,25,25
False,8417036,Jungingen,3 -  6 Jahre,45,22,23
False,8417036,Jungingen,6 - 10 Jahre,55,32,23
False,8417036,Jungingen,10 - 15 Jahre,89,39,50
False,8417036,Jungingen,15 - 18 Jahre,33,19,14
False,8417036,Jungingen,18 - 20 Jahre,32,19,13
False,8417036,Jungingen,20 - 25 Jahre,80,42,38
False,8417036,Jungingen,25 - 30 Jahre,66,35,31
False,8417036,Jungingen,30 - 35 Jahre,105,44,61
False,8417036,Jungingen,35 - 40 Jahre,117,61,56
False,8417036,Jungingen,40 - 45 Jahre,127,61,66
False,8417036,Jungingen,45 - 50 Jahre,107,53,54
False,8417036,Jungingen,50 - 55 Jahre,102,44,58
False,8417036,Jungingen,55 - 60 Jahre,100,56,44
False,8417036,Jungingen,60 - 65 Jahre,106,53,53
False,8417036,Jungingen,65 - 75 Jahre,163,69,94
False,8417036,Jungingen,75 und mehr Jahre,113,43,70
False,8417036,Jungingen,Insgesamt,1490,717,773
False,8417044,"Meßstetten, Stadt",unter 3 Jahre,304,170,134
False,8417044,"Meßstetten, Stadt",3 -  6 Jahre,380,206,174
False,8417044,"Meßstetten, Stadt",6 - 10 Jahre,584,275,309
False,8417044,"Meßstetten, Stadt",10 - 15 Jahre,767,399,368
False,8417044,"Meßstetten, Stadt",15 - 18 Jahre,411,198,213
False,8417044,"Meßstetten, Stadt",18 - 20 Jahre,272,146,126
False,8417044,"Meßstetten, Stadt",20 - 25 Jahre,619,347,272
False,8417044,"Meßstetten, Stadt",25 - 30 Jahre,594,284,310
False,8417044,"Meßstetten, Stadt",30 - 35 Jahre,845,446,399
False,8417044,"Meßstetten, Stadt",35 - 40 Jahre,1103,593,510
False,8417044,"Meßstetten, Stadt",40 - 45 Jahre,940,484,456
False,8417044,"Meßstetten, Stadt",45 - 50 Jahre,741,391,350
False,8417044,"Meßstetten, Stadt",50 - 55 Jahre,604,301,303
False,8417044,"Meßstetten, Stadt",55 - 60 Jahre,565,293,272
False,8417044,"Meßstetten, Stadt",60 - 65 Jahre,693,325,368
False,8417044,"Meßstetten, Stadt",65 - 75 Jahre,911,436,475
False,8417044,"Meßstetten, Stadt",75 und mehr Jahre,545,146,399
False,8417044,"Meßstetten, Stadt",Insgesamt,10878,5440,5438
False,8417045,Nusplingen,unter 3 Jahre,57,31,26
False,8417045,Nusplingen,3 -  6 Jahre,63,30,33
False,8417045,Nusplingen,6 - 10 Jahre,94,58,36
False,8417045,Nusplingen,10 - 15 Jahre,132,67,65
False,8417045,Nusplingen,15 - 18 Jahre,70,33,37
False,8417045,Nusplingen,18 - 20 Jahre,40,21,19
False,8417045,Nusplingen,20 - 25 Jahre,110,54,56
False,8417045,Nusplingen,25 - 30 Jahre,122,67,55
False,8417045,Nusplingen,30 - 35 Jahre,126,67,59
False,8417045,Nusplingen,35 - 40 Jahre,174,91,83
False,8417045,Nusplingen,40 - 45 Jahre,164,85,79
False,8417045,Nusplingen,45 - 50 Jahre,105,60,45
False,8417045,Nusplingen,50 - 55 Jahre,95,44,51
False,8417045,Nusplingen,55 - 60 Jahre,93,49,44
False,8417045,Nusplingen,60 - 65 Jahre,152,74,78
False,8417045,Nusplingen,65 - 75 Jahre,222,106,116
False,8417045,Nusplingen,75 und mehr Jahre,92,22,70
False,8417045,Nusplingen,Insgesamt,1911,959,952
False,8417047,Obernheim,unter 3 Jahre,71,33,38
False,8417047,Obernheim,3 -  6 Jahre,62,30,32
False,8417047,Obernheim,6 - 10 Jahre,91,47,44
False,8417047,Obernheim,10 - 15 Jahre,96,49,47
False,8417047,Obernheim,15 - 18 Jahre,28,11,17
False,8417047,Obernheim,18 - 20 Jahre,25,12,13
False,8417047,Obernheim,20 - 25 Jahre,75,41,34
False,8417047,Obernheim,25 - 30 Jahre,92,54,38
False,8417047,Obernheim,30 - 35 Jahre,132,73,59
False,8417047,Obernheim,35 - 40 Jahre,130,68,62
False,8417047,Obernheim,40 - 45 Jahre,118,57,61
False,8417047,Obernheim,45 - 50 Jahre,99,55,44
False,8417047,Obernheim,50 - 55 Jahre,98,49,49
False,8417047,Obernheim,55 - 60 Jahre,66,32,34
False,8417047,Obernheim,60 - 65 Jahre,102,52,50
False,8417047,Obernheim,65 - 75 Jahre,162,78,84
False,8417047,Obernheim,75 und mehr Jahre,75,19,56
False,8417047,Obernheim,Insgesamt,1522,760,762
False,8417051,Rangendingen,unter 3 Jahre,147,81,66
False,8417051,Rangendingen,3 -  6 Jahre,153,78,75
False,8417051,Rangendingen,6 - 10 Jahre,242,107,135
False,8417051,Rangendingen,10 - 15 Jahre,357,176,181
False,8417051,Rangendingen,15 - 18 Jahre,221,107,114
False,8417051,Rangendingen,18 - 20 Jahre,134,75,59
False,8417051,Rangendingen,20 - 25 Jahre,311,154,157
False,8417051,Rangendingen,25 - 30 Jahre,324,175,149
False,8417051,Rangendingen,30 - 35 Jahre,374,193,181
False,8417051,Rangendingen,35 - 40 Jahre,437,217,220
False,8417051,Rangendingen,40 - 45 Jahre,411,187,224
False,8417051,Rangendingen,45 - 50 Jahre,370,182,188
False,8417051,Rangendingen,50 - 55 Jahre,338,173,165
False,8417051,Rangendingen,55 - 60 Jahre,283,153,130
False,8417051,Rangendingen,60 - 65 Jahre,329,179,150
False,8417051,Rangendingen,65 - 75 Jahre,434,197,237
False,8417051,Rangendingen,75 und mehr Jahre,211,55,156
False,8417051,Rangendingen,Insgesamt,5076,2489,2587
False,8417052,Ratshausen,unter 3 Jahre,23,7,16
False,8417052,Ratshausen,3 -  6 Jahre,25,12,13
False,8417052,Ratshausen,6 - 10 Jahre,49,26,23
False,8417052,Ratshausen,10 - 15 Jahre,48,23,25
False,8417052,Ratshausen,15 - 18 Jahre,28,12,16
False,8417052,Ratshausen,18 - 20 Jahre,17,7,10
False,8417052,Ratshausen,20 - 25 Jahre,37,20,17
False,8417052,Ratshausen,25 - 30 Jahre,46,23,23
False,8417052,Ratshausen,30 - 35 Jahre,64,38,26
False,8417052,Ratshausen,35 - 40 Jahre,68,36,32
False,8417052,Ratshausen,40 - 45 Jahre,59,31,28
False,8417052,Ratshausen,45 - 50 Jahre,44,23,21
False,8417052,Ratshausen,50 - 55 Jahre,55,27,28
False,8417052,Ratshausen,55 - 60 Jahre,39,23,16
False,8417052,Ratshausen,60 - 65 Jahre,44,19,25
False,8417052,Ratshausen,65 - 75 Jahre,57,25,32
False,8417052,Ratshausen,75 und mehr Jahre,94,26,68
False,8417052,Ratshausen,Insgesamt,797,378,419
False,8417054,"Rosenfeld, Stadt",unter 3 Jahre,214,105,109
False,8417054,"Rosenfeld, Stadt",3 -  6 Jahre,275,146,129
False,8417054,"Rosenfeld, Stadt",6 - 10 Jahre,351,169,182
False,8417054,"Rosenfeld, Stadt",10 - 15 Jahre,491,250,241
False,8417054,"Rosenfeld, Stadt",15 - 18 Jahre,237,120,117
False,8417054,"Rosenfeld, Stadt",18 - 20 Jahre,130,75,55
False,8417054,"Rosenfeld, Stadt",20 - 25 Jahre,332,175,157
False,8417054,"Rosenfeld, Stadt",25 - 30 Jahre,352,179,173
False,8417054,"Rosenfeld, Stadt",30 - 35 Jahre,506,262,244
False,8417054,"Rosenfeld, Stadt",35 - 40 Jahre,545,302,243
False,8417054,"Rosenfeld, Stadt",40 - 45 Jahre,471,241,230
False,8417054,"Rosenfeld, Stadt",45 - 50 Jahre,403,209,194
False,8417054,"Rosenfeld, Stadt",50 - 55 Jahre,345,167,178
False,8417054,"Rosenfeld, Stadt",55 - 60 Jahre,314,156,158
False,8417054,"Rosenfeld, Stadt",60 - 65 Jahre,435,219,216
False,8417054,"Rosenfeld, Stadt",65 - 75 Jahre,539,264,275
False,8417054,"Rosenfeld, Stadt",75 und mehr Jahre,375,124,251
False,8417054,"Rosenfeld, Stadt",Insgesamt,6315,3163,3152
False,8417057,"Schömberg, Stadt",unter 3 Jahre,157,78,79
False,8417057,"Schömberg, Stadt",3 -  6 Jahre,189,86,103
False,8417057,"Schömberg, Stadt",6 - 10 Jahre,261,139,122
False,8417057,"Schömberg, Stadt",10 - 15 Jahre,294,161,133
False,8417057,"Schömberg, Stadt",15 - 18 Jahre,167,92,75
False,8417057,"Schömberg, Stadt",18 - 20 Jahre,129,60,69
False,8417057,"Schömberg, Stadt",20 - 25 Jahre,254,134,120
False,8417057,"Schömberg, Stadt",25 - 30 Jahre,287,142,145
False,8417057,"Schömberg, Stadt",30 - 35 Jahre,371,201,170
False,8417057,"Schömberg, Stadt",35 - 40 Jahre,409,208,201
False,8417057,"Schömberg, Stadt",40 - 45 Jahre,347,174,173
False,8417057,"Schömberg, Stadt",45 - 50 Jahre,271,140,131
False,8417057,"Schömberg, Stadt",50 - 55 Jahre,276,144,132
False,8417057,"Schömberg, Stadt",55 - 60 Jahre,200,114,86
False,8417057,"Schömberg, Stadt",60 - 65 Jahre,271,129,142
False,8417057,"Schömberg, Stadt",65 - 75 Jahre,358,167,191
False,8417057,"Schömberg, Stadt",75 und mehr Jahre,282,87,195
False,8417057,"Schömberg, Stadt",Insgesamt,4523,2256,2267
False,8417063,Straßberg,unter 3 Jahre,74,37,37
False,8417063,Straßberg,3 -  6 Jahre,81,41,40
False,8417063,Straßberg,6 - 10 Jahre,138,76,62
False,8417063,Straßberg,10 - 15 Jahre,187,110,77
False,8417063,Straßberg,15 - 18 Jahre,91,47,44
False,8417063,Straßberg,18 - 20 Jahre,66,34,32
False,8417063,Straßberg,20 - 25 Jahre,126,66,60
False,8417063,Straßberg,25 - 30 Jahre,158,76,82
False,8417063,Straßberg,30 - 35 Jahre,217,102,115
False,8417063,Straßberg,35 - 40 Jahre,255,121,134
False,8417063,Straßberg,40 - 45 Jahre,217,122,95
False,8417063,Straßberg,45 - 50 Jahre,183,88,95
False,8417063,Straßberg,50 - 55 Jahre,186,93,93
False,8417063,Straßberg,55 - 60 Jahre,144,65,79
False,8417063,Straßberg,60 - 65 Jahre,188,106,82
False,8417063,Straßberg,65 - 75 Jahre,242,110,132
False,8417063,Straßberg,75 und mehr Jahre,208,45,163
False,8417063,Straßberg,Insgesamt,2761,1339,1422
False,8417071,Weilen unter den Rinnen,unter 3 Jahre,25,13,12
False,8417071,Weilen unter den Rinnen,3 -  6 Jahre,35,17,18
False,8417071,Weilen unter den Rinnen,6 - 10 Jahre,42,20,22
False,8417071,Weilen unter den Rinnen,10 - 15 Jahre,42,18,24
False,8417071,Weilen unter den Rinnen,15 - 18 Jahre,18,7,11
False,8417071,Weilen unter den Rinnen,18 - 20 Jahre,9,5,4
False,8417071,Weilen unter den Rinnen,20 - 25 Jahre,28,9,19
False,8417071,Weilen unter den Rinnen,25 - 30 Jahre,40,19,21
False,8417071,Weilen unter den Rinnen,30 - 35 Jahre,65,32,33
False,8417071,Weilen unter den Rinnen,35 - 40 Jahre,74,40,34
False,8417071,Weilen unter den Rinnen,40 - 45 Jahre,54,32,22
False,8417071,Weilen unter den Rinnen,45 - 50 Jahre,37,19,18
False,8417071,Weilen unter den Rinnen,50 - 55 Jahre,30,16,14
False,8417071,Weilen unter den Rinnen,55 - 60 Jahre,22,13,9
False,8417071,Weilen unter den Rinnen,60 - 65 Jahre,28,11,17
False,8417071,Weilen unter den Rinnen,65 - 75 Jahre,38,19,19
False,8417071,Weilen unter den Rinnen,75 und mehr Jahre,24,7,17
False,8417071,Weilen unter den Rinnen,Insgesamt,611,297,314
False,8417075,Winterlingen,unter 3 Jahre,206,105,101
False,8417075,Winterlingen,3 -  6 Jahre,216,119,97
False,8417075,Winterlingen,6 - 10 Jahre,343,176,167
False,8417075,Winterlingen,10 - 15 Jahre,463,245,218
False,8417075,Winterlingen,15 - 18 Jahre,230,115,115
False,8417075,Winterlingen,18 - 20 Jahre,165,81,84
False,8417075,Winterlingen,20 - 25 Jahre,300,161,139
False,8417075,Winterlingen,25 - 30 Jahre,353,206,147
False,8417075,Winterlingen,30 - 35 Jahre,542,281,261
False,8417075,Winterlingen,35 - 40 Jahre,570,286,284
False,8417075,Winterlingen,40 - 45 Jahre,541,289,252
False,8417075,Winterlingen,45 - 50 Jahre,450,231,219
False,8417075,Winterlingen,50 - 55 Jahre,380,192,188
False,8417075,Winterlingen,55 - 60 Jahre,332,169,163
False,8417075,Winterlingen,60 - 65 Jahre,452,214,238
False,8417075,Winterlingen,65 - 75 Jahre,684,325,359
False,8417075,Winterlingen,75 und mehr Jahre,481,136,345
False,8417075,Winterlingen,Insgesamt,6708,3331,3377
False,8417078,Zimmern unter der Burg,unter 3 Jahre,27,12,15
False,8417078,Zimmern unter der Burg,3 -  6 Jahre,20,7,13
False,8417078,Zimmern unter der Burg,6 - 10 Jahre,37,23,14
False,8417078,Zimmern unter der Burg,10 - 15 Jahre,33,19,14
False,8417078,Zimmern unter der Burg,15 - 18 Jahre,10,4,6
False,8417078,Zimmern unter der Burg,18 - 20 Jahre,9,6,3
False,8417078,Zimmern unter der Burg,20 - 25 Jahre,25,17,8
False,8417078,Zimmern unter der Burg,25 - 30 Jahre,39,23,16
False,8417078,Zimmern unter der Burg,30 - 35 Jahre,47,27,20
False,8417078,Zimmern unter der Burg,35 - 40 Jahre,33,14,19
False,8417078,Zimmern unter der Burg,40 - 45 Jahre,42,23,19
False,8417078,Zimmern unter der Burg,45 - 50 Jahre,21,9,12
False,8417078,Zimmern unter der Burg,50 - 55 Jahre,29,17,12
False,8417078,Zimmern unter der Burg,55 - 60 Jahre,27,17,10
False,8417078,Zimmern unter der Burg,60 - 65 Jahre,27,13,14
False,8417078,Zimmern unter der Burg,65 - 75 Jahre,47,21,26
False,8417078,Zimmern unter der Burg,75 und mehr Jahre,34,8,26
False,8417078,Zimmern unter der Burg,Insgesamt,507,260,247
False,8417079,"Albstadt, Stadt",unter 3 Jahre,1302,658,644
False,8417079,"Albstadt, Stadt",3 -  6 Jahre,1422,765,657
False,8417079,"Albstadt, Stadt",6 - 10 Jahre,2061,1025,1036
False,8417079,"Albstadt, Stadt",10 - 15 Jahre,2729,1431,1298
False,8417079,"Albstadt, Stadt",15 - 18 Jahre,1533,787,746
False,8417079,"Albstadt, Stadt",18 - 20 Jahre,1053,558,495
False,8417079,"Albstadt, Stadt",20 - 25 Jahre,2512,1284,1228
False,8417079,"Albstadt, Stadt",25 - 30 Jahre,2790,1421,1369
False,8417079,"Albstadt, Stadt",30 - 35 Jahre,3539,1877,1662
False,8417079,"Albstadt, Stadt",35 - 40 Jahre,3889,2007,1882
False,8417079,"Albstadt, Stadt",40 - 45 Jahre,3437,1789,1648
False,8417079,"Albstadt, Stadt",45 - 50 Jahre,3170,1569,1601
False,8417079,"Albstadt, Stadt",50 - 55 Jahre,2780,1413,1367
False,8417079,"Albstadt, Stadt",55 - 60 Jahre,2758,1316,1442
False,8417079,"Albstadt, Stadt",60 - 65 Jahre,3638,1777,1861
False,8417079,"Albstadt, Stadt",65 - 75 Jahre,5237,2337,2900
False,8417079,"Albstadt, Stadt",75 und mehr Jahre,4005,1234,2771
False,8417079,"Albstadt, Stadt",Insgesamt,47855,23248,24607
False,8421,Stadtkreis Ulm,unter 3 Jahre,3496,1807,1689
False,8421,Stadtkreis Ulm,3 -  6 Jahre,3383,1732,1651
False,8421,Stadtkreis Ulm,6 - 10 Jahre,4546,2296,2250
False,8421,Stadtkreis Ulm,10 - 15 Jahre,5851,3018,2833
False,8421,Stadtkreis Ulm,15 - 18 Jahre,3549,1780,1769
False,8421,Stadtkreis Ulm,18 - 20 Jahre,2720,1329,1391
False,8421,Stadtkreis Ulm,20 - 25 Jahre,8186,4046,4140
False,8421,Stadtkreis Ulm,25 - 30 Jahre,8881,4562,4319
False,8421,Stadtkreis Ulm,30 - 35 Jahre,10323,5542,4781
False,8421,Stadtkreis Ulm,35 - 40 Jahre,9950,5207,4743
False,8421,Stadtkreis Ulm,40 - 45 Jahre,8457,4264,4193
False,8421,Stadtkreis Ulm,45 - 50 Jahre,7510,3640,3870
False,8421,Stadtkreis Ulm,50 - 55 Jahre,7138,3580,3558
False,8421,Stadtkreis Ulm,55 - 60 Jahre,6952,3521,3431
False,8421,Stadtkreis Ulm,60 - 65 Jahre,7291,3593,3698
False,8421,Stadtkreis Ulm,65 - 75 Jahre,9658,4345,5313
False,8421,Stadtkreis Ulm,75 und mehr Jahre,9342,2827,6515
False,8421,Stadtkreis Ulm,Insgesamt,117233,57089,60144
False,8421000,"Ulm, Universitätsstadt",unter 3 Jahre,3496,1807,1689
False,8421000,"Ulm, Universitätsstadt",3 -  6 Jahre,3383,1732,1651
False,8421000,"Ulm, Universitätsstadt",6 - 10 Jahre,4546,2296,2250
False,8421000,"Ulm, Universitätsstadt",10 - 15 Jahre,5851,3018,2833
False,8421000,"Ulm, Universitätsstadt",15 - 18 Jahre,3549,1780,1769
False,8421000,"Ulm, Universitätsstadt",18 - 20 Jahre,2720,1329,1391
False,8421000,"Ulm, Universitätsstadt",20 - 25 Jahre,8186,4046,4140
False,8421000,"Ulm, Universitätsstadt",25 - 30 Jahre,8881,4562,4319
False,8421000,"Ulm, Universitätsstadt",30 - 35 Jahre,10323,5542,4781
False,8421000,"Ulm, Universitätsstadt",35 - 40 Jahre,9950,5207,4743
False,8421000,"Ulm, Universitätsstadt",40 - 45 Jahre,8457,4264,4193
False,8421000,"Ulm, Universitätsstadt",45 - 50 Jahre,7510,3640,3870
False,8421000,"Ulm, Universitätsstadt",50 - 55 Jahre,7138,3580,3558
False,8421000,"Ulm, Universitätsstadt",55 - 60 Jahre,6952,3521,3431
False,8421000,"Ulm, Universitätsstadt",60 - 65 Jahre,7291,3593,3698
False,8421000,"Ulm, Universitätsstadt",65 - 75 Jahre,9658,4345,5313
False,8421000,"Ulm, Universitätsstadt",75 und mehr Jahre,9342,2827,6515
False,8421000,"Ulm, Universitätsstadt",Insgesamt,117233,57089,60144
False,8425,Landkreis Alb-Donau-Kreis,unter 3 Jahre,6648,3361,3287
False,8425,Landkreis Alb-Donau-Kreis,3 -  6 Jahre,6965,3522,3443
False,8425,Landkreis Alb-Donau-Kreis,6 - 10 Jahre,9554,4977,4577
False,8425,Landkreis Alb-Donau-Kreis,10 - 15 Jahre,12479,6284,6195
False,8425,Landkreis Alb-Donau-Kreis,15 - 18 Jahre,6748,3524,3224
False,8425,Landkreis Alb-Donau-Kreis,18 - 20 Jahre,4503,2355,2148
False,8425,Landkreis Alb-Donau-Kreis,20 - 25 Jahre,10333,5459,4874
False,8425,Landkreis Alb-Donau-Kreis,25 - 30 Jahre,11509,5893,5616
False,8425,Landkreis Alb-Donau-Kreis,30 - 35 Jahre,15169,7874,7295
False,8425,Landkreis Alb-Donau-Kreis,35 - 40 Jahre,16256,8512,7744
False,8425,Landkreis Alb-Donau-Kreis,40 - 45 Jahre,14437,7408,7029
False,8425,Landkreis Alb-Donau-Kreis,45 - 50 Jahre,12433,6458,5975
False,8425,Landkreis Alb-Donau-Kreis,50 - 55 Jahre,10536,5465,5071
False,8425,Landkreis Alb-Donau-Kreis,55 - 60 Jahre,9545,4816,4729
False,8425,Landkreis Alb-Donau-Kreis,60 - 65 Jahre,11589,5840,5749
False,8425,Landkreis Alb-Donau-Kreis,65 - 75 Jahre,15692,7305,8387
False,8425,Landkreis Alb-Donau-Kreis,75 und mehr Jahre,11533,3633,7900
False,8425,Landkreis Alb-Donau-Kreis,Insgesamt,185929,92686,93243
False,8425002,Allmendingen,unter 3 Jahre,175,81,94
False,8425002,Allmendingen,3 -  6 Jahre,170,83,87
False,8425002,Allmendingen,6 - 10 Jahre,230,117,113
False,8425002,Allmendingen,10 - 15 Jahre,315,169,146
False,8425002,Allmendingen,15 - 18 Jahre,180,81,99
False,8425002,Allmendingen,18 - 20 Jahre,100,52,48
False,8425002,Allmendingen,20 - 25 Jahre,246,126,120
False,8425002,Allmendingen,25 - 30 Jahre,264,138,126
False,8425002,Allmendingen,30 - 35 Jahre,351,181,170
False,8425002,Allmendingen,35 - 40 Jahre,382,216,166
False,8425002,Allmendingen,40 - 45 Jahre,360,176,184
False,8425002,Allmendingen,45 - 50 Jahre,307,168,139
False,8425002,Allmendingen,50 - 55 Jahre,254,124,130
False,8425002,Allmendingen,55 - 60 Jahre,218,112,106
False,8425002,Allmendingen,60 - 65 Jahre,307,162,145
False,8425002,Allmendingen,65 - 75 Jahre,394,179,215
False,8425002,Allmendingen,75 und mehr Jahre,256,96,160
False,8425002,Allmendingen,Insgesamt,4509,2261,2248
False,8425004,Altheim,unter 3 Jahre,35,18,17
False,8425004,Altheim,3 -  6 Jahre,27,14,13
False,8425004,Altheim,6 - 10 Jahre,42,27,15
False,8425004,Altheim,10 - 15 Jahre,43,20,23
False,8425004,Altheim,15 - 18 Jahre,20,11,9
False,8425004,Altheim,18 - 20 Jahre,12,3,9
False,8425004,Altheim,20 - 25 Jahre,36,22,14
False,8425004,Altheim,25 - 30 Jahre,42,21,21
False,8425004,Altheim,30 - 35 Jahre,40,21,19
False,8425004,Altheim,35 - 40 Jahre,45,27,18
False,8425004,Altheim,40 - 45 Jahre,22,9,13
False,8425004,Altheim,45 - 50 Jahre,42,20,22
False,8425004,Altheim,50 - 55 Jahre,36,16,20
False,8425004,Altheim,55 - 60 Jahre,30,13,17
False,8425004,Altheim,60 - 65 Jahre,35,18,17
False,8425004,Altheim,65 - 75 Jahre,32,17,15
False,8425004,Altheim,75 und mehr Jahre,14,6,8
False,8425004,Altheim,Insgesamt,553,283,270
False,8425005,Altheim (Alb),unter 3 Jahre,66,36,30
False,8425005,Altheim (Alb),3 -  6 Jahre,69,32,37
False,8425005,Altheim (Alb),6 - 10 Jahre,109,62,47
False,8425005,Altheim (Alb),10 - 15 Jahre,122,60,62
False,8425005,Altheim (Alb),15 - 18 Jahre,63,32,31
False,8425005,Altheim (Alb),18 - 20 Jahre,45,26,19
False,8425005,Altheim (Alb),20 - 25 Jahre,83,47,36
False,8425005,Altheim (Alb),25 - 30 Jahre,85,48,37
False,8425005,Altheim (Alb),30 - 35 Jahre,133,68,65
False,8425005,Altheim (Alb),35 - 40 Jahre,156,82,74
False,8425005,Altheim (Alb),40 - 45 Jahre,137,72,65
False,8425005,Altheim (Alb),45 - 50 Jahre,95,50,45
False,8425005,Altheim (Alb),50 - 55 Jahre,104,54,50
False,8425005,Altheim (Alb),55 - 60 Jahre,76,40,36
False,8425005,Altheim (Alb),60 - 65 Jahre,93,42,51
False,8425005,Altheim (Alb),65 - 75 Jahre,174,86,88
False,8425005,Altheim (Alb),75 und mehr Jahre,112,42,70
False,8425005,Altheim (Alb),Insgesamt,1722,879,843
False,8425008,Amstetten,unter 3 Jahre,162,94,68
False,8425008,Amstetten,3 -  6 Jahre,171,84,87
False,8425008,Amstetten,6 - 10 Jahre,198,105,93
False,8425008,Amstetten,10 - 15 Jahre,281,144,137
False,8425008,Amstetten,15 - 18 Jahre,134,80,54
False,8425008,Amstetten,18 - 20 Jahre,107,63,44
False,8425008,Amstetten,20 - 25 Jahre,202,108,94
False,8425008,Amstetten,25 - 30 Jahre,233,113,120
False,8425008,Amstetten,30 - 35 Jahre,342,175,167
False,8425008,Amstetten,35 - 40 Jahre,320,172,148
False,8425008,Amstetten,40 - 45 Jahre,280,149,131
False,8425008,Amstetten,45 - 50 Jahre,281,140,141
False,8425008,Amstetten,50 - 55 Jahre,194,105,89
False,8425008,Amstetten,55 - 60 Jahre,232,118,114
False,8425008,Amstetten,60 - 65 Jahre,227,117,110
False,8425008,Amstetten,65 - 75 Jahre,347,168,179
False,8425008,Amstetten,75 und mehr Jahre,232,75,157
False,8425008,Amstetten,Insgesamt,3943,2010,1933
False,8425011,Asselfingen,unter 3 Jahre,43,24,19
False,8425011,Asselfingen,3 -  6 Jahre,42,19,23
False,8425011,Asselfingen,6 - 10 Jahre,64,38,26
False,8425011,Asselfingen,10 - 15 Jahre,68,33,35
False,8425011,Asselfingen,15 - 18 Jahre,39,26,13
False,8425011,Asselfingen,18 - 20 Jahre,31,20,11
False,8425011,Asselfingen,20 - 25 Jahre,43,27,16
False,8425011,Asselfingen,25 - 30 Jahre,34,16,18
False,8425011,Asselfingen,30 - 35 Jahre,81,40,41
False,8425011,Asselfingen,35 - 40 Jahre,101,58,43
False,8425011,Asselfingen,40 - 45 Jahre,77,40,37
False,8425011,Asselfingen,45 - 50 Jahre,75,41,34
False,8425011,Asselfingen,50 - 55 Jahre,46,23,23
False,8425011,Asselfingen,55 - 60 Jahre,45,26,19
False,8425011,Asselfingen,60 - 65 Jahre,49,30,19
False,8425011,Asselfingen,65 - 75 Jahre,68,34,34
False,8425011,Asselfingen,75 und mehr Jahre,55,18,37
False,8425011,Asselfingen,Insgesamt,961,513,448
False,8425013,Ballendorf,unter 3 Jahre,19,6,13
False,8425013,Ballendorf,3 -  6 Jahre,29,12,17
False,8425013,Ballendorf,6 - 10 Jahre,34,16,18
False,8425013,Ballendorf,10 - 15 Jahre,52,24,28
False,8425013,Ballendorf,15 - 18 Jahre,17,10,7
False,8425013,Ballendorf,18 - 20 Jahre,10,5,5
False,8425013,Ballendorf,20 - 25 Jahre,33,16,17
False,8425013,Ballendorf,25 - 30 Jahre,33,13,20
False,8425013,Ballendorf,30 - 35 Jahre,55,29,26
False,8425013,Ballendorf,35 - 40 Jahre,58,32,26
False,8425013,Ballendorf,40 - 45 Jahre,52,31,21
False,8425013,Ballendorf,45 - 50 Jahre,48,23,25
False,8425013,Ballendorf,50 - 55 Jahre,20,11,9
False,8425013,Ballendorf,55 - 60 Jahre,39,18,21
False,8425013,Ballendorf,60 - 65 Jahre,39,20,19
False,8425013,Ballendorf,65 - 75 Jahre,74,39,35
False,8425013,Ballendorf,75 und mehr Jahre,62,10,52
False,8425013,Ballendorf,Insgesamt,674,315,359
False,8425014,Beimerstetten,unter 3 Jahre,95,46,49
False,8425014,Beimerstetten,3 -  6 Jahre,94,47,47
False,8425014,Beimerstetten,6 - 10 Jahre,125,62,63
False,8425014,Beimerstetten,10 - 15 Jahre,163,88,75
False,8425014,Beimerstetten,15 - 18 Jahre,86,40,46
False,8425014,Beimerstetten,18 - 20 Jahre,48,24,24
False,8425014,Beimerstetten,20 - 25 Jahre,117,56,61
False,8425014,Beimerstetten,25 - 30 Jahre,154,77,77
False,8425014,Beimerstetten,30 - 35 Jahre,194,95,99
False,8425014,Beimerstetten,35 - 40 Jahre,223,120,103
False,8425014,Beimerstetten,40 - 45 Jahre,215,102,113
False,8425014,Beimerstetten,45 - 50 Jahre,171,88,83
False,8425014,Beimerstetten,50 - 55 Jahre,120,59,61
False,8425014,Beimerstetten,55 - 60 Jahre,129,63,66
False,8425014,Beimerstetten,60 - 65 Jahre,182,91,91
False,8425014,Beimerstetten,65 - 75 Jahre,167,80,87
False,8425014,Beimerstetten,75 und mehr Jahre,150,33,117
False,8425014,Beimerstetten,Insgesamt,2433,1171,1262
False,8425017,Berghülen,unter 3 Jahre,82,37,45
False,8425017,Berghülen,3 -  6 Jahre,81,42,39
False,8425017,Berghülen,6 - 10 Jahre,128,72,56
False,8425017,Berghülen,10 - 15 Jahre,157,85,72
False,8425017,Berghülen,15 - 18 Jahre,83,47,36
False,8425017,Berghülen,18 - 20 Jahre,42,26,16
False,8425017,Berghülen,20 - 25 Jahre,96,66,30
False,8425017,Berghülen,25 - 30 Jahre,120,68,52
False,8425017,Berghülen,30 - 35 Jahre,136,78,58
False,8425017,Berghülen,35 - 40 Jahre,167,84,83
False,8425017,Berghülen,40 - 45 Jahre,175,90,85
False,8425017,Berghülen,45 - 50 Jahre,143,76,67
False,8425017,Berghülen,50 - 55 Jahre,104,59,45
False,8425017,Berghülen,55 - 60 Jahre,94,48,46
False,8425017,Berghülen,60 - 65 Jahre,103,50,53
False,8425017,Berghülen,65 - 75 Jahre,148,68,80
False,8425017,Berghülen,75 und mehr Jahre,108,35,73
False,8425017,Berghülen,Insgesamt,1967,1031,936
False,8425019,Bernstadt,unter 3 Jahre,62,37,25
False,8425019,Bernstadt,3 -  6 Jahre,79,39,40
False,8425019,Bernstadt,6 - 10 Jahre,117,46,71
False,8425019,Bernstadt,10 - 15 Jahre,130,67,63
False,8425019,Bernstadt,15 - 18 Jahre,54,32,22
False,8425019,Bernstadt,18 - 20 Jahre,40,21,19
False,8425019,Bernstadt,20 - 25 Jahre,104,51,53
False,8425019,Bernstadt,25 - 30 Jahre,92,44,48
False,8425019,Bernstadt,30 - 35 Jahre,176,99,77
False,8425019,Bernstadt,35 - 40 Jahre,185,91,94
False,8425019,Bernstadt,40 - 45 Jahre,163,88,75
False,8425019,Bernstadt,45 - 50 Jahre,107,51,56
False,8425019,Bernstadt,50 - 55 Jahre,124,63,61
False,8425019,Bernstadt,55 - 60 Jahre,111,59,52
False,8425019,Bernstadt,60 - 65 Jahre,107,60,47
False,8425019,Bernstadt,65 - 75 Jahre,164,75,89
False,8425019,Bernstadt,75 und mehr Jahre,105,39,66
False,8425019,Bernstadt,Insgesamt,1920,962,958
False,8425020,"Blaubeuren, Stadt",unter 3 Jahre,443,234,209
False,8425020,"Blaubeuren, Stadt",3 -  6 Jahre,478,229,249
False,8425020,"Blaubeuren, Stadt",6 - 10 Jahre,641,320,321
False,8425020,"Blaubeuren, Stadt",10 - 15 Jahre,757,379,378
False,8425020,"Blaubeuren, Stadt",15 - 18 Jahre,398,191,207
False,8425020,"Blaubeuren, Stadt",18 - 20 Jahre,282,148,134
False,8425020,"Blaubeuren, Stadt",20 - 25 Jahre,639,333,306
False,8425020,"Blaubeuren, Stadt",25 - 30 Jahre,724,393,331
False,8425020,"Blaubeuren, Stadt",30 - 35 Jahre,922,496,426
False,8425020,"Blaubeuren, Stadt",35 - 40 Jahre,969,551,418
False,8425020,"Blaubeuren, Stadt",40 - 45 Jahre,851,430,421
False,8425020,"Blaubeuren, Stadt",45 - 50 Jahre,741,392,349
False,8425020,"Blaubeuren, Stadt",50 - 55 Jahre,644,318,326
False,8425020,"Blaubeuren, Stadt",55 - 60 Jahre,657,325,332
False,8425020,"Blaubeuren, Stadt",60 - 65 Jahre,769,354,415
False,8425020,"Blaubeuren, Stadt",65 - 75 Jahre,1145,548,597
False,8425020,"Blaubeuren, Stadt",75 und mehr Jahre,988,275,713
False,8425020,"Blaubeuren, Stadt",Insgesamt,12048,5916,6132
False,8425022,Börslingen,unter 3 Jahre,8,4,4
False,8425022,Börslingen,3 -  6 Jahre,6,2,4
False,8425022,Börslingen,6 - 10 Jahre,13,6,7
False,8425022,Börslingen,10 - 15 Jahre,9,6,3
False,8425022,Börslingen,15 - 18 Jahre,8,5,3
False,8425022,Börslingen,18 - 20 Jahre,4,1,3
False,8425022,Börslingen,20 - 25 Jahre,11,3,8
False,8425022,Börslingen,25 - 30 Jahre,6,5,1
False,8425022,Börslingen,30 - 35 Jahre,9,5,4
False,8425022,Börslingen,35 - 40 Jahre,13,5,8
False,8425022,Börslingen,40 - 45 Jahre,10,6,4
False,8425022,Börslingen,45 - 50 Jahre,13,8,5
False,8425022,Börslingen,50 - 55 Jahre,14,8,6
False,8425022,Börslingen,55 - 60 Jahre,7,4,3
False,8425022,Börslingen,60 - 65 Jahre,6,3,3
False,8425022,Börslingen,65 - 75 Jahre,12,7,5
False,8425022,Börslingen,75 und mehr Jahre,16,6,10
False,8425022,Börslingen,Insgesamt,165,84,81
False,8425024,Breitingen,unter 3 Jahre,3,1,2
False,8425024,Breitingen,3 -  6 Jahre,6,5,1
False,8425024,Breitingen,6 - 10 Jahre,12,4,8
False,8425024,Breitingen,10 - 15 Jahre,18,6,12
False,8425024,Breitingen,15 - 18 Jahre,11,9,2
False,8425024,Breitingen,18 - 20 Jahre,7,3,4
False,8425024,Breitingen,20 - 25 Jahre,12,7,5
False,8425024,Breitingen,25 - 30 Jahre,16,11,5
False,8425024,Breitingen,30 - 35 Jahre,19,9,10
False,8425024,Breitingen,35 - 40 Jahre,21,9,12
False,8425024,Breitingen,40 - 45 Jahre,26,14,12
False,8425024,Breitingen,45 - 50 Jahre,25,11,14
False,8425024,Breitingen,50 - 55 Jahre,12,8,4
False,8425024,Breitingen,55 - 60 Jahre,12,7,5
False,8425024,Breitingen,60 - 65 Jahre,7,3,4
False,8425024,Breitingen,65 - 75 Jahre,27,12,15
False,8425024,Breitingen,75 und mehr Jahre,12,3,9
False,8425024,Breitingen,Insgesamt,246,122,124
False,8425028,"Dietenheim, Stadt",unter 3 Jahre,214,111,103
False,8425028,"Dietenheim, Stadt",3 -  6 Jahre,227,121,106
False,8425028,"Dietenheim, Stadt",6 - 10 Jahre,335,182,153
False,8425028,"Dietenheim, Stadt",10 - 15 Jahre,459,238,221
False,8425028,"Dietenheim, Stadt",15 - 18 Jahre,247,126,121
False,8425028,"Dietenheim, Stadt",18 - 20 Jahre,178,103,75
False,8425028,"Dietenheim, Stadt",20 - 25 Jahre,353,197,156
False,8425028,"Dietenheim, Stadt",25 - 30 Jahre,406,222,184
False,8425028,"Dietenheim, Stadt",30 - 35 Jahre,485,266,219
False,8425028,"Dietenheim, Stadt",35 - 40 Jahre,526,267,259
False,8425028,"Dietenheim, Stadt",40 - 45 Jahre,551,289,262
False,8425028,"Dietenheim, Stadt",45 - 50 Jahre,416,220,196
False,8425028,"Dietenheim, Stadt",50 - 55 Jahre,347,182,165
False,8425028,"Dietenheim, Stadt",55 - 60 Jahre,317,151,166
False,8425028,"Dietenheim, Stadt",60 - 65 Jahre,388,186,202
False,8425028,"Dietenheim, Stadt",65 - 75 Jahre,587,254,333
False,8425028,"Dietenheim, Stadt",75 und mehr Jahre,456,144,312
False,8425028,"Dietenheim, Stadt",Insgesamt,6492,3259,3233
False,8425031,Dornstadt,unter 3 Jahre,287,160,127
False,8425031,Dornstadt,3 -  6 Jahre,286,155,131
False,8425031,Dornstadt,6 - 10 Jahre,401,211,190
False,8425031,Dornstadt,10 - 15 Jahre,544,272,272
False,8425031,Dornstadt,15 - 18 Jahre,260,137,123
False,8425031,Dornstadt,18 - 20 Jahre,196,92,104
False,8425031,Dornstadt,20 - 25 Jahre,530,263,267
False,8425031,Dornstadt,25 - 30 Jahre,517,265,252
False,8425031,Dornstadt,30 - 35 Jahre,670,359,311
False,8425031,Dornstadt,35 - 40 Jahre,713,367,346
False,8425031,Dornstadt,40 - 45 Jahre,642,308,334
False,8425031,Dornstadt,45 - 50 Jahre,605,316,289
False,8425031,Dornstadt,50 - 55 Jahre,520,271,249
False,8425031,Dornstadt,55 - 60 Jahre,530,251,279
False,8425031,Dornstadt,60 - 65 Jahre,580,309,271
False,8425031,Dornstadt,65 - 75 Jahre,683,334,349
False,8425031,Dornstadt,75 und mehr Jahre,559,166,393
False,8425031,Dornstadt,Insgesamt,8523,4236,4287
False,8425033,"Ehingen (Donau), Stadt",unter 3 Jahre,843,434,409
False,8425033,"Ehingen (Donau), Stadt",3 -  6 Jahre,885,423,462
False,8425033,"Ehingen (Donau), Stadt",6 - 10 Jahre,1212,618,594
False,8425033,"Ehingen (Donau), Stadt",10 - 15 Jahre,1658,794,864
False,8425033,"Ehingen (Donau), Stadt",15 - 18 Jahre,918,455,463
False,8425033,"Ehingen (Donau), Stadt",18 - 20 Jahre,630,342,288
False,8425033,"Ehingen (Donau), Stadt",20 - 25 Jahre,1566,804,762
False,8425033,"Ehingen (Donau), Stadt",25 - 30 Jahre,1706,855,851
False,8425033,"Ehingen (Donau), Stadt",30 - 35 Jahre,2048,1046,1002
False,8425033,"Ehingen (Donau), Stadt",35 - 40 Jahre,2147,1175,972
False,8425033,"Ehingen (Donau), Stadt",40 - 45 Jahre,1866,934,932
False,8425033,"Ehingen (Donau), Stadt",45 - 50 Jahre,1686,845,841
False,8425033,"Ehingen (Donau), Stadt",50 - 55 Jahre,1556,794,762
False,8425033,"Ehingen (Donau), Stadt",55 - 60 Jahre,1335,706,629
False,8425033,"Ehingen (Donau), Stadt",60 - 65 Jahre,1514,773,741
False,8425033,"Ehingen (Donau), Stadt",65 - 75 Jahre,1995,896,1099
False,8425033,"Ehingen (Donau), Stadt",75 und mehr Jahre,1526,496,1030
False,8425033,"Ehingen (Donau), Stadt",Insgesamt,25091,12390,12701
False,8425035,Emeringen,unter 3 Jahre,0,0,0
False,8425035,Emeringen,3 -  6 Jahre,8,4,4
False,8425035,Emeringen,6 - 10 Jahre,13,6,7
False,8425035,Emeringen,10 - 15 Jahre,22,10,12
False,8425035,Emeringen,15 - 18 Jahre,5,3,2
False,8425035,Emeringen,18 - 20 Jahre,3,3,0
False,8425035,Emeringen,20 - 25 Jahre,3,2,1
False,8425035,Emeringen,25 - 30 Jahre,5,3,2
False,8425035,Emeringen,30 - 35 Jahre,14,6,8
False,8425035,Emeringen,35 - 40 Jahre,15,7,8
False,8425035,Emeringen,40 - 45 Jahre,9,4,5
False,8425035,Emeringen,45 - 50 Jahre,7,5,2
False,8425035,Emeringen,50 - 55 Jahre,9,5,4
False,8425035,Emeringen,55 - 60 Jahre,5,3,2
False,8425035,Emeringen,60 - 65 Jahre,12,5,7
False,8425035,Emeringen,65 - 75 Jahre,15,10,5
False,8425035,Emeringen,75 und mehr Jahre,7,2,5
False,8425035,Emeringen,Insgesamt,152,78,74
False,8425036,Emerkingen,unter 3 Jahre,48,23,25
False,8425036,Emerkingen,3 -  6 Jahre,35,17,18
False,8425036,Emerkingen,6 - 10 Jahre,39,20,19
False,8425036,Emerkingen,10 - 15 Jahre,42,14,28
False,8425036,Emerkingen,15 - 18 Jahre,16,9,7
False,8425036,Emerkingen,18 - 20 Jahre,20,9,11
False,8425036,Emerkingen,20 - 25 Jahre,64,43,21
False,8425036,Emerkingen,25 - 30 Jahre,65,34,31
False,8425036,Emerkingen,30 - 35 Jahre,65,31,34
False,8425036,Emerkingen,35 - 40 Jahre,81,49,32
False,8425036,Emerkingen,40 - 45 Jahre,44,26,18
False,8425036,Emerkingen,45 - 50 Jahre,45,26,19
False,8425036,Emerkingen,50 - 55 Jahre,41,18,23
False,8425036,Emerkingen,55 - 60 Jahre,41,24,17
False,8425036,Emerkingen,60 - 65 Jahre,40,23,17
False,8425036,Emerkingen,65 - 75 Jahre,49,21,28
False,8425036,Emerkingen,75 und mehr Jahre,34,8,26
False,8425036,Emerkingen,Insgesamt,769,395,374
False,8425039,"Erbach, Stadt",unter 3 Jahre,436,216,220
False,8425039,"Erbach, Stadt",3 -  6 Jahre,471,244,227
False,8425039,"Erbach, Stadt",6 - 10 Jahre,654,354,300
False,8425039,"Erbach, Stadt",10 - 15 Jahre,880,430,450
False,8425039,"Erbach, Stadt",15 - 18 Jahre,520,277,243
False,8425039,"Erbach, Stadt",18 - 20 Jahre,328,164,164
False,8425039,"Erbach, Stadt",20 - 25 Jahre,731,377,354
False,8425039,"Erbach, Stadt",25 - 30 Jahre,746,382,364
False,8425039,"Erbach, Stadt",30 - 35 Jahre,1048,526,522
False,8425039,"Erbach, Stadt",35 - 40 Jahre,1143,618,525
False,8425039,"Erbach, Stadt",40 - 45 Jahre,976,505,471
False,8425039,"Erbach, Stadt",45 - 50 Jahre,947,486,461
False,8425039,"Erbach, Stadt",50 - 55 Jahre,723,380,343
False,8425039,"Erbach, Stadt",55 - 60 Jahre,595,292,303
False,8425039,"Erbach, Stadt",60 - 65 Jahre,781,397,384
False,8425039,"Erbach, Stadt",65 - 75 Jahre,1063,484,579
False,8425039,"Erbach, Stadt",75 und mehr Jahre,672,236,436
False,8425039,"Erbach, Stadt",Insgesamt,12714,6368,6346
False,8425050,Griesingen,unter 3 Jahre,47,22,25
False,8425050,Griesingen,3 -  6 Jahre,37,16,21
False,8425050,Griesingen,6 - 10 Jahre,68,31,37
False,8425050,Griesingen,10 - 15 Jahre,62,30,32
False,8425050,Griesingen,15 - 18 Jahre,43,18,25
False,8425050,Griesingen,18 - 20 Jahre,26,11,15
False,8425050,Griesingen,20 - 25 Jahre,50,28,22
False,8425050,Griesingen,25 - 30 Jahre,62,28,34
False,8425050,Griesingen,30 - 35 Jahre,90,43,47
False,8425050,Griesingen,35 - 40 Jahre,85,45,40
False,8425050,Griesingen,40 - 45 Jahre,91,43,48
False,8425050,Griesingen,45 - 50 Jahre,65,43,22
False,8425050,Griesingen,50 - 55 Jahre,45,24,21
False,8425050,Griesingen,55 - 60 Jahre,28,11,17
False,8425050,Griesingen,60 - 65 Jahre,45,23,22
False,8425050,Griesingen,65 - 75 Jahre,72,32,40
False,8425050,Griesingen,75 und mehr Jahre,43,10,33
False,8425050,Griesingen,Insgesamt,959,458,501
False,8425052,Grundsheim,unter 3 Jahre,8,1,7
False,8425052,Grundsheim,3 -  6 Jahre,10,7,3
False,8425052,Grundsheim,6 - 10 Jahre,6,2,4
False,8425052,Grundsheim,10 - 15 Jahre,14,6,8
False,8425052,Grundsheim,15 - 18 Jahre,6,4,2
False,8425052,Grundsheim,18 - 20 Jahre,7,2,5
False,8425052,Grundsheim,20 - 25 Jahre,10,7,3
False,8425052,Grundsheim,25 - 30 Jahre,12,6,6
False,8425052,Grundsheim,30 - 35 Jahre,20,8,12
False,8425052,Grundsheim,35 - 40 Jahre,16,11,5
False,8425052,Grundsheim,40 - 45 Jahre,16,8,8
False,8425052,Grundsheim,45 - 50 Jahre,9,6,3
False,8425052,Grundsheim,50 - 55 Jahre,13,9,4
False,8425052,Grundsheim,55 - 60 Jahre,3,1,2
False,8425052,Grundsheim,60 - 65 Jahre,16,8,8
False,8425052,Grundsheim,65 - 75 Jahre,23,9,14
False,8425052,Grundsheim,75 und mehr Jahre,20,7,13
False,8425052,Grundsheim,Insgesamt,209,102,107
False,8425055,Hausen am Bussen,unter 3 Jahre,12,7,5
False,8425055,Hausen am Bussen,3 -  6 Jahre,10,6,4
False,8425055,Hausen am Bussen,6 - 10 Jahre,14,9,5
False,8425055,Hausen am Bussen,10 - 15 Jahre,25,11,14
False,8425055,Hausen am Bussen,15 - 18 Jahre,15,7,8
False,8425055,Hausen am Bussen,18 - 20 Jahre,5,1,4
False,8425055,Hausen am Bussen,20 - 25 Jahre,18,11,7
False,8425055,Hausen am Bussen,25 - 30 Jahre,26,14,12
False,8425055,Hausen am Bussen,30 - 35 Jahre,23,12,11
False,8425055,Hausen am Bussen,35 - 40 Jahre,29,13,16
False,8425055,Hausen am Bussen,40 - 45 Jahre,19,15,4
False,8425055,Hausen am Bussen,45 - 50 Jahre,19,9,10
False,8425055,Hausen am Bussen,50 - 55 Jahre,16,8,8
False,8425055,Hausen am Bussen,55 - 60 Jahre,8,3,5
False,8425055,Hausen am Bussen,60 - 65 Jahre,17,8,9
False,8425055,Hausen am Bussen,65 - 75 Jahre,18,10,8
False,8425055,Hausen am Bussen,75 und mehr Jahre,14,6,8
False,8425055,Hausen am Bussen,Insgesamt,288,150,138
False,8425062,Holzkirch,unter 3 Jahre,6,3,3
False,8425062,Holzkirch,3 -  6 Jahre,17,8,9
False,8425062,Holzkirch,6 - 10 Jahre,21,13,8
False,8425062,Holzkirch,10 - 15 Jahre,15,7,8
False,8425062,Holzkirch,15 - 18 Jahre,8,3,5
False,8425062,Holzkirch,18 - 20 Jahre,5,3,2
False,8425062,Holzkirch,20 - 25 Jahre,8,4,4
False,8425062,Holzkirch,25 - 30 Jahre,18,11,7
False,8425062,Holzkirch,30 - 35 Jahre,30,13,17
False,8425062,Holzkirch,35 - 40 Jahre,31,17,14
False,8425062,Holzkirch,40 - 45 Jahre,12,5,7
False,8425062,Holzkirch,45 - 50 Jahre,12,8,4
False,8425062,Holzkirch,50 - 55 Jahre,9,7,2
False,8425062,Holzkirch,55 - 60 Jahre,9,5,4
False,8425062,Holzkirch,60 - 65 Jahre,20,8,12
False,8425062,Holzkirch,65 - 75 Jahre,35,16,19
False,8425062,Holzkirch,75 und mehr Jahre,19,4,15
False,8425062,Holzkirch,Insgesamt,275,135,140
False,8425064,Hüttisheim,unter 3 Jahre,53,17,36
False,8425064,Hüttisheim,3 -  6 Jahre,54,25,29
False,8425064,Hüttisheim,6 - 10 Jahre,81,43,38
False,8425064,Hüttisheim,10 - 15 Jahre,101,55,46
False,8425064,Hüttisheim,15 - 18 Jahre,55,28,27
False,8425064,Hüttisheim,18 - 20 Jahre,34,19,15
False,8425064,Hüttisheim,20 - 25 Jahre,69,32,37
False,8425064,Hüttisheim,25 - 30 Jahre,73,44,29
False,8425064,Hüttisheim,30 - 35 Jahre,124,65,59
False,8425064,Hüttisheim,35 - 40 Jahre,105,47,58
False,8425064,Hüttisheim,40 - 45 Jahre,125,60,65
False,8425064,Hüttisheim,45 - 50 Jahre,90,50,40
False,8425064,Hüttisheim,50 - 55 Jahre,67,36,31
False,8425064,Hüttisheim,55 - 60 Jahre,71,36,35
False,8425064,Hüttisheim,60 - 65 Jahre,95,47,48
False,8425064,Hüttisheim,65 - 75 Jahre,110,51,59
False,8425064,Hüttisheim,75 und mehr Jahre,71,23,48
False,8425064,Hüttisheim,Insgesamt,1378,678,700
False,8425066,Illerrieden,unter 3 Jahre,103,46,57
False,8425066,Illerrieden,3 -  6 Jahre,115,54,61
False,8425066,Illerrieden,6 - 10 Jahre,164,79,85
False,8425066,Illerrieden,10 - 15 Jahre,222,115,107
False,8425066,Illerrieden,15 - 18 Jahre,122,62,60
False,8425066,Illerrieden,18 - 20 Jahre,87,44,43
False,8425066,Illerrieden,20 - 25 Jahre,220,106,114
False,8425066,Illerrieden,25 - 30 Jahre,211,104,107
False,8425066,Illerrieden,30 - 35 Jahre,246,130,116
False,8425066,Illerrieden,35 - 40 Jahre,292,152,140
False,8425066,Illerrieden,40 - 45 Jahre,263,137,126
False,8425066,Illerrieden,45 - 50 Jahre,235,113,122
False,8425066,Illerrieden,50 - 55 Jahre,234,121,113
False,8425066,Illerrieden,55 - 60 Jahre,186,98,88
False,8425066,Illerrieden,60 - 65 Jahre,214,117,97
False,8425066,Illerrieden,65 - 75 Jahre,217,100,117
False,8425066,Illerrieden,75 und mehr Jahre,178,59,119
False,8425066,Illerrieden,Insgesamt,3309,1637,1672
False,8425071,"Laichingen, Stadt",unter 3 Jahre,408,212,196
False,8425071,"Laichingen, Stadt",3 -  6 Jahre,443,216,227
False,8425071,"Laichingen, Stadt",6 - 10 Jahre,582,302,280
False,8425071,"Laichingen, Stadt",10 - 15 Jahre,780,385,395
False,8425071,"Laichingen, Stadt",15 - 18 Jahre,400,218,182
False,8425071,"Laichingen, Stadt",18 - 20 Jahre,236,122,114
False,8425071,"Laichingen, Stadt",20 - 25 Jahre,591,307,284
False,8425071,"Laichingen, Stadt",25 - 30 Jahre,662,336,326
False,8425071,"Laichingen, Stadt",30 - 35 Jahre,902,457,445
False,8425071,"Laichingen, Stadt",35 - 40 Jahre,936,492,444
False,8425071,"Laichingen, Stadt",40 - 45 Jahre,770,418,352
False,8425071,"Laichingen, Stadt",45 - 50 Jahre,673,336,337
False,8425071,"Laichingen, Stadt",50 - 55 Jahre,623,324,299
False,8425071,"Laichingen, Stadt",55 - 60 Jahre,501,266,235
False,8425071,"Laichingen, Stadt",60 - 65 Jahre,683,326,357
False,8425071,"Laichingen, Stadt",65 - 75 Jahre,928,432,496
False,8425071,"Laichingen, Stadt",75 und mehr Jahre,669,198,471
False,8425071,"Laichingen, Stadt",Insgesamt,10787,5347,5440
False,8425072,"Langenau, Stadt",unter 3 Jahre,449,230,219
False,8425072,"Langenau, Stadt",3 -  6 Jahre,496,271,225
False,8425072,"Langenau, Stadt",6 - 10 Jahre,675,346,329
False,8425072,"Langenau, Stadt",10 - 15 Jahre,881,444,437
False,8425072,"Langenau, Stadt",15 - 18 Jahre,518,268,250
False,8425072,"Langenau, Stadt",18 - 20 Jahre,308,162,146
False,8425072,"Langenau, Stadt",20 - 25 Jahre,774,424,350
False,8425072,"Langenau, Stadt",25 - 30 Jahre,827,417,410
False,8425072,"Langenau, Stadt",30 - 35 Jahre,1197,608,589
False,8425072,"Langenau, Stadt",35 - 40 Jahre,1240,634,606
False,8425072,"Langenau, Stadt",40 - 45 Jahre,1128,585,543
False,8425072,"Langenau, Stadt",45 - 50 Jahre,914,483,431
False,8425072,"Langenau, Stadt",50 - 55 Jahre,785,412,373
False,8425072,"Langenau, Stadt",55 - 60 Jahre,658,336,322
False,8425072,"Langenau, Stadt",60 - 65 Jahre,826,412,414
False,8425072,"Langenau, Stadt",65 - 75 Jahre,1176,547,629
False,8425072,"Langenau, Stadt",75 und mehr Jahre,892,270,622
False,8425072,"Langenau, Stadt",Insgesamt,13744,6849,6895
False,8425073,Lauterach,unter 3 Jahre,30,15,15
False,8425073,Lauterach,3 -  6 Jahre,22,9,13
False,8425073,Lauterach,6 - 10 Jahre,26,9,17
False,8425073,Lauterach,10 - 15 Jahre,40,21,19
False,8425073,Lauterach,15 - 18 Jahre,27,15,12
False,8425073,Lauterach,18 - 20 Jahre,15,7,8
False,8425073,Lauterach,20 - 25 Jahre,35,15,20
False,8425073,Lauterach,25 - 30 Jahre,43,26,17
False,8425073,Lauterach,30 - 35 Jahre,48,32,16
False,8425073,Lauterach,35 - 40 Jahre,61,37,24
False,8425073,Lauterach,40 - 45 Jahre,45,29,16
False,8425073,Lauterach,45 - 50 Jahre,49,30,19
False,8425073,Lauterach,50 - 55 Jahre,36,21,15
False,8425073,Lauterach,55 - 60 Jahre,28,11,17
False,8425073,Lauterach,60 - 65 Jahre,20,7,13
False,8425073,Lauterach,65 - 75 Jahre,40,18,22
False,8425073,Lauterach,75 und mehr Jahre,39,17,22
False,8425073,Lauterach,Insgesamt,604,319,285
False,8425075,Lonsee,unter 3 Jahre,192,91,101
False,8425075,Lonsee,3 -  6 Jahre,187,99,88
False,8425075,Lonsee,6 - 10 Jahre,269,130,139
False,8425075,Lonsee,10 - 15 Jahre,342,187,155
False,8425075,Lonsee,15 - 18 Jahre,199,103,96
False,8425075,Lonsee,18 - 20 Jahre,119,62,57
False,8425075,Lonsee,20 - 25 Jahre,249,131,118
False,8425075,Lonsee,25 - 30 Jahre,292,147,145
False,8425075,Lonsee,30 - 35 Jahre,348,172,176
False,8425075,Lonsee,35 - 40 Jahre,454,239,215
False,8425075,Lonsee,40 - 45 Jahre,401,212,189
False,8425075,Lonsee,45 - 50 Jahre,312,156,156
False,8425075,Lonsee,50 - 55 Jahre,268,145,123
False,8425075,Lonsee,55 - 60 Jahre,206,114,92
False,8425075,Lonsee,60 - 65 Jahre,258,131,127
False,8425075,Lonsee,65 - 75 Jahre,365,164,201
False,8425075,Lonsee,75 und mehr Jahre,252,90,162
False,8425075,Lonsee,Insgesamt,4713,2373,2340
False,8425079,Merklingen,unter 3 Jahre,69,32,37
False,8425079,Merklingen,3 -  6 Jahre,74,41,33
False,8425079,Merklingen,6 - 10 Jahre,114,55,59
False,8425079,Merklingen,10 - 15 Jahre,116,59,57
False,8425079,Merklingen,15 - 18 Jahre,45,28,17
False,8425079,Merklingen,18 - 20 Jahre,26,9,17
False,8425079,Merklingen,20 - 25 Jahre,79,39,40
False,8425079,Merklingen,25 - 30 Jahre,113,57,56
False,8425079,Merklingen,30 - 35 Jahre,171,86,85
False,8425079,Merklingen,35 - 40 Jahre,191,106,85
False,8425079,Merklingen,40 - 45 Jahre,134,71,63
False,8425079,Merklingen,45 - 50 Jahre,109,58,51
False,8425079,Merklingen,50 - 55 Jahre,95,47,48
False,8425079,Merklingen,55 - 60 Jahre,91,47,44
False,8425079,Merklingen,60 - 65 Jahre,129,70,59
False,8425079,Merklingen,65 - 75 Jahre,182,84,98
False,8425079,Merklingen,75 und mehr Jahre,86,33,53
False,8425079,Merklingen,Insgesamt,1824,922,902
False,8425081,"Munderkingen, Stadt",unter 3 Jahre,152,76,76
False,8425081,"Munderkingen, Stadt",3 -  6 Jahre,167,88,79
False,8425081,"Munderkingen, Stadt",6 - 10 Jahre,272,147,125
False,8425081,"Munderkingen, Stadt",10 - 15 Jahre,397,188,209
False,8425081,"Munderkingen, Stadt",15 - 18 Jahre,194,101,93
False,8425081,"Munderkingen, Stadt",18 - 20 Jahre,125,57,68
False,8425081,"Munderkingen, Stadt",20 - 25 Jahre,268,146,122
False,8425081,"Munderkingen, Stadt",25 - 30 Jahre,296,157,139
False,8425081,"Munderkingen, Stadt",30 - 35 Jahre,326,175,151
False,8425081,"Munderkingen, Stadt",35 - 40 Jahre,376,165,211
False,8425081,"Munderkingen, Stadt",40 - 45 Jahre,419,214,205
False,8425081,"Munderkingen, Stadt",45 - 50 Jahre,336,173,163
False,8425081,"Munderkingen, Stadt",50 - 55 Jahre,275,140,135
False,8425081,"Munderkingen, Stadt",55 - 60 Jahre,273,133,140
False,8425081,"Munderkingen, Stadt",60 - 65 Jahre,327,164,163
False,8425081,"Munderkingen, Stadt",65 - 75 Jahre,481,232,249
False,8425081,"Munderkingen, Stadt",75 und mehr Jahre,371,102,269
False,8425081,"Munderkingen, Stadt",Insgesamt,5055,2458,2597
False,8425083,Neenstetten,unter 3 Jahre,43,17,26
False,8425083,Neenstetten,3 -  6 Jahre,22,7,15
False,8425083,Neenstetten,6 - 10 Jahre,50,24,26
False,8425083,Neenstetten,10 - 15 Jahre,58,32,26
False,8425083,Neenstetten,15 - 18 Jahre,24,10,14
False,8425083,Neenstetten,18 - 20 Jahre,19,10,9
False,8425083,Neenstetten,20 - 25 Jahre,42,18,24
False,8425083,Neenstetten,25 - 30 Jahre,47,19,28
False,8425083,Neenstetten,30 - 35 Jahre,70,37,33
False,8425083,Neenstetten,35 - 40 Jahre,72,36,36
False,8425083,Neenstetten,40 - 45 Jahre,70,35,35
False,8425083,Neenstetten,45 - 50 Jahre,51,29,22
False,8425083,Neenstetten,50 - 55 Jahre,41,20,21
False,8425083,Neenstetten,55 - 60 Jahre,46,28,18
False,8425083,Neenstetten,60 - 65 Jahre,39,20,19
False,8425083,Neenstetten,65 - 75 Jahre,67,33,34
False,8425083,Neenstetten,75 und mehr Jahre,33,10,23
False,8425083,Neenstetten,Insgesamt,794,385,409
False,8425084,Nellingen,unter 3 Jahre,71,38,33
False,8425084,Nellingen,3 -  6 Jahre,77,35,42
False,8425084,Nellingen,6 - 10 Jahre,101,63,38
False,8425084,Nellingen,10 - 15 Jahre,113,54,59
False,8425084,Nellingen,15 - 18 Jahre,57,30,27
False,8425084,Nellingen,18 - 20 Jahre,48,25,23
False,8425084,Nellingen,20 - 25 Jahre,66,34,32
False,8425084,Nellingen,25 - 30 Jahre,107,53,54
False,8425084,Nellingen,30 - 35 Jahre,155,75,80
False,8425084,Nellingen,35 - 40 Jahre,169,87,82
False,8425084,Nellingen,40 - 45 Jahre,147,83,64
False,8425084,Nellingen,45 - 50 Jahre,124,61,63
False,8425084,Nellingen,50 - 55 Jahre,102,59,43
False,8425084,Nellingen,55 - 60 Jahre,90,46,44
False,8425084,Nellingen,60 - 65 Jahre,103,55,48
False,8425084,Nellingen,65 - 75 Jahre,142,65,77
False,8425084,Nellingen,75 und mehr Jahre,113,40,73
False,8425084,Nellingen,Insgesamt,1785,903,882
False,8425085,Nerenstetten,unter 3 Jahre,16,7,9
False,8425085,Nerenstetten,3 -  6 Jahre,15,9,6
False,8425085,Nerenstetten,6 - 10 Jahre,18,7,11
False,8425085,Nerenstetten,10 - 15 Jahre,33,14,19
False,8425085,Nerenstetten,15 - 18 Jahre,18,10,8
False,8425085,Nerenstetten,18 - 20 Jahre,9,3,6
False,8425085,Nerenstetten,20 - 25 Jahre,23,14,9
False,8425085,Nerenstetten,25 - 30 Jahre,22,11,11
False,8425085,Nerenstetten,30 - 35 Jahre,31,13,18
False,8425085,Nerenstetten,35 - 40 Jahre,30,17,13
False,8425085,Nerenstetten,40 - 45 Jahre,17,6,11
False,8425085,Nerenstetten,45 - 50 Jahre,31,20,11
False,8425085,Nerenstetten,50 - 55 Jahre,15,8,7
False,8425085,Nerenstetten,55 - 60 Jahre,14,9,5
False,8425085,Nerenstetten,60 - 65 Jahre,17,9,8
False,8425085,Nerenstetten,65 - 75 Jahre,26,14,12
False,8425085,Nerenstetten,75 und mehr Jahre,13,3,10
False,8425085,Nerenstetten,Insgesamt,348,174,174
False,8425088,Oberdischingen,unter 3 Jahre,80,34,46
False,8425088,Oberdischingen,3 -  6 Jahre,68,40,28
False,8425088,Oberdischingen,6 - 10 Jahre,96,48,48
False,8425088,Oberdischingen,10 - 15 Jahre,150,90,60
False,8425088,Oberdischingen,15 - 18 Jahre,87,48,39
False,8425088,Oberdischingen,18 - 20 Jahre,39,22,17
False,8425088,Oberdischingen,20 - 25 Jahre,107,57,50
False,8425088,Oberdischingen,25 - 30 Jahre,97,51,46
False,8425088,Oberdischingen,30 - 35 Jahre,157,85,72
False,8425088,Oberdischingen,35 - 40 Jahre,137,59,78
False,8425088,Oberdischingen,40 - 45 Jahre,177,90,87
False,8425088,Oberdischingen,45 - 50 Jahre,141,75,66
False,8425088,Oberdischingen,50 - 55 Jahre,91,47,44
False,8425088,Oberdischingen,55 - 60 Jahre,70,41,29
False,8425088,Oberdischingen,60 - 65 Jahre,109,50,59
False,8425088,Oberdischingen,65 - 75 Jahre,145,68,77
False,8425088,Oberdischingen,75 und mehr Jahre,167,48,119
False,8425088,Oberdischingen,Insgesamt,1918,953,965
False,8425090,Obermarchtal,unter 3 Jahre,67,32,35
False,8425090,Obermarchtal,3 -  6 Jahre,58,31,27
False,8425090,Obermarchtal,6 - 10 Jahre,70,37,33
False,8425090,Obermarchtal,10 - 15 Jahre,94,45,49
False,8425090,Obermarchtal,15 - 18 Jahre,47,24,23
False,8425090,Obermarchtal,18 - 20 Jahre,32,16,16
False,8425090,Obermarchtal,20 - 25 Jahre,66,35,31
False,8425090,Obermarchtal,25 - 30 Jahre,100,47,53
False,8425090,Obermarchtal,30 - 35 Jahre,105,57,48
False,8425090,Obermarchtal,35 - 40 Jahre,98,40,58
False,8425090,Obermarchtal,40 - 45 Jahre,87,46,41
False,8425090,Obermarchtal,45 - 50 Jahre,81,46,35
False,8425090,Obermarchtal,50 - 55 Jahre,73,34,39
False,8425090,Obermarchtal,55 - 60 Jahre,51,23,28
False,8425090,Obermarchtal,60 - 65 Jahre,66,36,30
False,8425090,Obermarchtal,65 - 75 Jahre,95,43,52
False,8425090,Obermarchtal,75 und mehr Jahre,74,25,49
False,8425090,Obermarchtal,Insgesamt,1264,617,647
False,8425091,Oberstadion,unter 3 Jahre,69,40,29
False,8425091,Oberstadion,3 -  6 Jahre,71,43,28
False,8425091,Oberstadion,6 - 10 Jahre,98,58,40
False,8425091,Oberstadion,10 - 15 Jahre,131,72,59
False,8425091,Oberstadion,15 - 18 Jahre,80,42,38
False,8425091,Oberstadion,18 - 20 Jahre,44,28,16
False,8425091,Oberstadion,20 - 25 Jahre,78,49,29
False,8425091,Oberstadion,25 - 30 Jahre,105,50,55
False,8425091,Oberstadion,30 - 35 Jahre,122,58,64
False,8425091,Oberstadion,35 - 40 Jahre,156,93,63
False,8425091,Oberstadion,40 - 45 Jahre,145,70,75
False,8425091,Oberstadion,45 - 50 Jahre,108,59,49
False,8425091,Oberstadion,50 - 55 Jahre,63,43,20
False,8425091,Oberstadion,55 - 60 Jahre,50,20,30
False,8425091,Oberstadion,60 - 65 Jahre,68,35,33
False,8425091,Oberstadion,65 - 75 Jahre,119,58,61
False,8425091,Oberstadion,75 und mehr Jahre,71,22,49
False,8425091,Oberstadion,Insgesamt,1578,840,738
False,8425092,Öllingen,unter 3 Jahre,16,7,9
False,8425092,Öllingen,3 -  6 Jahre,19,11,8
False,8425092,Öllingen,6 - 10 Jahre,32,14,18
False,8425092,Öllingen,10 - 15 Jahre,33,16,17
False,8425092,Öllingen,15 - 18 Jahre,18,4,14
False,8425092,Öllingen,18 - 20 Jahre,11,7,4
False,8425092,Öllingen,20 - 25 Jahre,14,11,3
False,8425092,Öllingen,25 - 30 Jahre,18,9,9
False,8425092,Öllingen,30 - 35 Jahre,35,20,15
False,8425092,Öllingen,35 - 40 Jahre,47,26,21
False,8425092,Öllingen,40 - 45 Jahre,41,26,15
False,8425092,Öllingen,45 - 50 Jahre,22,8,14
False,8425092,Öllingen,50 - 55 Jahre,16,9,7
False,8425092,Öllingen,55 - 60 Jahre,18,8,10
False,8425092,Öllingen,60 - 65 Jahre,44,22,22
False,8425092,Öllingen,65 - 75 Jahre,30,19,11
False,8425092,Öllingen,75 und mehr Jahre,27,10,17
False,8425092,Öllingen,Insgesamt,441,227,214
False,8425093,Öpfingen,unter 3 Jahre,81,50,31
False,8425093,Öpfingen,3 -  6 Jahre,93,43,50
False,8425093,Öpfingen,6 - 10 Jahre,112,64,48
False,8425093,Öpfingen,10 - 15 Jahre,152,71,81
False,8425093,Öpfingen,15 - 18 Jahre,62,31,31
False,8425093,Öpfingen,18 - 20 Jahre,65,26,39
False,8425093,Öpfingen,20 - 25 Jahre,141,75,66
False,8425093,Öpfingen,25 - 30 Jahre,154,78,76
False,8425093,Öpfingen,30 - 35 Jahre,176,100,76
False,8425093,Öpfingen,35 - 40 Jahre,195,91,104
False,8425093,Öpfingen,40 - 45 Jahre,178,94,84
False,8425093,Öpfingen,45 - 50 Jahre,147,64,83
False,8425093,Öpfingen,50 - 55 Jahre,122,65,57
False,8425093,Öpfingen,55 - 60 Jahre,132,63,69
False,8425093,Öpfingen,60 - 65 Jahre,147,83,64
False,8425093,Öpfingen,65 - 75 Jahre,172,83,89
False,8425093,Öpfingen,75 und mehr Jahre,112,43,69
False,8425093,Öpfingen,Insgesamt,2241,1124,1117
False,8425097,Rammingen,unter 3 Jahre,56,31,25
False,8425097,Rammingen,3 -  6 Jahre,44,17,27
False,8425097,Rammingen,6 - 10 Jahre,81,47,34
False,8425097,Rammingen,10 - 15 Jahre,90,45,45
False,8425097,Rammingen,15 - 18 Jahre,38,23,15
False,8425097,Rammingen,18 - 20 Jahre,35,23,12
False,8425097,Rammingen,20 - 25 Jahre,55,27,28
False,8425097,Rammingen,25 - 30 Jahre,91,41,50
False,8425097,Rammingen,30 - 35 Jahre,103,59,44
False,8425097,Rammingen,35 - 40 Jahre,121,68,53
False,8425097,Rammingen,40 - 45 Jahre,91,48,43
False,8425097,Rammingen,45 - 50 Jahre,90,46,44
False,8425097,Rammingen,50 - 55 Jahre,72,39,33
False,8425097,Rammingen,55 - 60 Jahre,72,42,30
False,8425097,Rammingen,60 - 65 Jahre,71,37,34
False,8425097,Rammingen,65 - 75 Jahre,95,51,44
False,8425097,Rammingen,75 und mehr Jahre,66,15,51
False,8425097,Rammingen,Insgesamt,1271,659,612
False,8425098,Rechtenstein,unter 3 Jahre,4,2,2
False,8425098,Rechtenstein,3 -  6 Jahre,4,3,1
False,8425098,Rechtenstein,6 - 10 Jahre,12,5,7
False,8425098,Rechtenstein,10 - 15 Jahre,14,7,7
False,8425098,Rechtenstein,15 - 18 Jahre,22,10,12
False,8425098,Rechtenstein,18 - 20 Jahre,9,5,4
False,8425098,Rechtenstein,20 - 25 Jahre,18,7,11
False,8425098,Rechtenstein,25 - 30 Jahre,14,6,8
False,8425098,Rechtenstein,30 - 35 Jahre,21,14,7
False,8425098,Rechtenstein,35 - 40 Jahre,26,10,16
False,8425098,Rechtenstein,40 - 45 Jahre,30,16,14
False,8425098,Rechtenstein,45 - 50 Jahre,23,12,11
False,8425098,Rechtenstein,50 - 55 Jahre,17,11,6
False,8425098,Rechtenstein,55 - 60 Jahre,11,5,6
False,8425098,Rechtenstein,60 - 65 Jahre,29,15,14
False,8425098,Rechtenstein,65 - 75 Jahre,17,10,7
False,8425098,Rechtenstein,75 und mehr Jahre,17,3,14
False,8425098,Rechtenstein,Insgesamt,288,141,147
False,8425104,Rottenacker,unter 3 Jahre,62,35,27
False,8425104,Rottenacker,3 -  6 Jahre,88,46,42
False,8425104,Rottenacker,6 - 10 Jahre,127,79,48
False,8425104,Rottenacker,10 - 15 Jahre,151,86,65
False,8425104,Rottenacker,15 - 18 Jahre,67,34,33
False,8425104,Rottenacker,18 - 20 Jahre,60,39,21
False,8425104,Rottenacker,20 - 25 Jahre,111,65,46
False,8425104,Rottenacker,25 - 30 Jahre,119,55,64
False,8425104,Rottenacker,30 - 35 Jahre,159,84,75
False,8425104,Rottenacker,35 - 40 Jahre,206,106,100
False,8425104,Rottenacker,40 - 45 Jahre,171,85,86
False,8425104,Rottenacker,45 - 50 Jahre,149,73,76
False,8425104,Rottenacker,50 - 55 Jahre,105,59,46
False,8425104,Rottenacker,55 - 60 Jahre,100,50,50
False,8425104,Rottenacker,60 - 65 Jahre,149,71,78
False,8425104,Rottenacker,65 - 75 Jahre,199,96,103
False,8425104,Rottenacker,75 und mehr Jahre,137,33,104
False,8425104,Rottenacker,Insgesamt,2160,1096,1064
False,8425108,"Schelklingen, Stadt",unter 3 Jahre,239,112,127
False,8425108,"Schelklingen, Stadt",3 -  6 Jahre,236,114,122
False,8425108,"Schelklingen, Stadt",6 - 10 Jahre,334,175,159
False,8425108,"Schelklingen, Stadt",10 - 15 Jahre,459,243,216
False,8425108,"Schelklingen, Stadt",15 - 18 Jahre,303,169,134
False,8425108,"Schelklingen, Stadt",18 - 20 Jahre,233,142,91
False,8425108,"Schelklingen, Stadt",20 - 25 Jahre,440,271,169
False,8425108,"Schelklingen, Stadt",25 - 30 Jahre,503,287,216
False,8425108,"Schelklingen, Stadt",30 - 35 Jahre,586,314,272
False,8425108,"Schelklingen, Stadt",35 - 40 Jahre,546,271,275
False,8425108,"Schelklingen, Stadt",40 - 45 Jahre,527,281,246
False,8425108,"Schelklingen, Stadt",45 - 50 Jahre,432,215,217
False,8425108,"Schelklingen, Stadt",50 - 55 Jahre,380,193,187
False,8425108,"Schelklingen, Stadt",55 - 60 Jahre,346,173,173
False,8425108,"Schelklingen, Stadt",60 - 65 Jahre,440,216,224
False,8425108,"Schelklingen, Stadt",65 - 75 Jahre,668,308,360
False,8425108,"Schelklingen, Stadt",75 und mehr Jahre,450,150,300
False,8425108,"Schelklingen, Stadt",Insgesamt,7122,3634,3488
False,8425110,Schnürpflingen,unter 3 Jahre,38,19,19
False,8425110,Schnürpflingen,3 -  6 Jahre,49,27,22
False,8425110,Schnürpflingen,6 - 10 Jahre,79,32,47
False,8425110,Schnürpflingen,10 - 15 Jahre,116,56,60
False,8425110,Schnürpflingen,15 - 18 Jahre,71,31,40
False,8425110,Schnürpflingen,18 - 20 Jahre,39,20,19
False,8425110,Schnürpflingen,20 - 25 Jahre,77,42,35
False,8425110,Schnürpflingen,25 - 30 Jahre,71,39,32
False,8425110,Schnürpflingen,30 - 35 Jahre,98,50,48
False,8425110,Schnürpflingen,35 - 40 Jahre,113,48,65
False,8425110,Schnürpflingen,40 - 45 Jahre,123,64,59
False,8425110,Schnürpflingen,45 - 50 Jahre,101,52,49
False,8425110,Schnürpflingen,50 - 55 Jahre,101,61,40
False,8425110,Schnürpflingen,55 - 60 Jahre,67,37,30
False,8425110,Schnürpflingen,60 - 65 Jahre,56,29,27
False,8425110,Schnürpflingen,65 - 75 Jahre,86,36,50
False,8425110,Schnürpflingen,75 und mehr Jahre,80,30,50
False,8425110,Schnürpflingen,Insgesamt,1365,673,692
False,8425112,Setzingen,unter 3 Jahre,27,15,12
False,8425112,Setzingen,3 -  6 Jahre,28,17,11
False,8425112,Setzingen,6 - 10 Jahre,28,15,13
False,8425112,Setzingen,10 - 15 Jahre,46,22,24
False,8425112,Setzingen,15 - 18 Jahre,32,16,16
False,8425112,Setzingen,18 - 20 Jahre,19,10,9
False,8425112,Setzingen,20 - 25 Jahre,34,19,15
False,8425112,Setzingen,25 - 30 Jahre,33,14,19
False,8425112,Setzingen,30 - 35 Jahre,53,27,26
False,8425112,Setzingen,35 - 40 Jahre,61,34,27
False,8425112,Setzingen,40 - 45 Jahre,51,23,28
False,8425112,Setzingen,45 - 50 Jahre,41,18,23
False,8425112,Setzingen,50 - 55 Jahre,44,25,19
False,8425112,Setzingen,55 - 60 Jahre,42,22,20
False,8425112,Setzingen,60 - 65 Jahre,30,19,11
False,8425112,Setzingen,65 - 75 Jahre,44,20,24
False,8425112,Setzingen,75 und mehr Jahre,32,7,25
False,8425112,Setzingen,Insgesamt,645,323,322
False,8425123,Untermarchtal,unter 3 Jahre,24,9,15
False,8425123,Untermarchtal,3 -  6 Jahre,27,11,16
False,8425123,Untermarchtal,6 - 10 Jahre,30,14,16
False,8425123,Untermarchtal,10 - 15 Jahre,43,22,21
False,8425123,Untermarchtal,15 - 18 Jahre,16,9,7
False,8425123,Untermarchtal,18 - 20 Jahre,17,6,11
False,8425123,Untermarchtal,20 - 25 Jahre,45,22,23
False,8425123,Untermarchtal,25 - 30 Jahre,40,14,26
False,8425123,Untermarchtal,30 - 35 Jahre,57,28,29
False,8425123,Untermarchtal,35 - 40 Jahre,56,24,32
False,8425123,Untermarchtal,40 - 45 Jahre,52,25,27
False,8425123,Untermarchtal,45 - 50 Jahre,49,23,26
False,8425123,Untermarchtal,50 - 55 Jahre,37,18,19
False,8425123,Untermarchtal,55 - 60 Jahre,46,17,29
False,8425123,Untermarchtal,60 - 65 Jahre,69,19,50
False,8425123,Untermarchtal,65 - 75 Jahre,120,21,99
False,8425123,Untermarchtal,75 und mehr Jahre,188,19,169
False,8425123,Untermarchtal,Insgesamt,916,301,615
False,8425124,Unterstadion,unter 3 Jahre,28,16,12
False,8425124,Unterstadion,3 -  6 Jahre,27,15,12
False,8425124,Unterstadion,6 - 10 Jahre,49,27,22
False,8425124,Unterstadion,10 - 15 Jahre,55,22,33
False,8425124,Unterstadion,15 - 18 Jahre,26,12,14
False,8425124,Unterstadion,18 - 20 Jahre,16,7,9
False,8425124,Unterstadion,20 - 25 Jahre,36,17,19
False,8425124,Unterstadion,25 - 30 Jahre,44,19,25
False,8425124,Unterstadion,30 - 35 Jahre,63,30,33
False,8425124,Unterstadion,35 - 40 Jahre,55,28,27
False,8425124,Unterstadion,40 - 45 Jahre,56,28,28
False,8425124,Unterstadion,45 - 50 Jahre,51,28,23
False,8425124,Unterstadion,50 - 55 Jahre,51,29,22
False,8425124,Unterstadion,55 - 60 Jahre,25,10,15
False,8425124,Unterstadion,60 - 65 Jahre,32,15,17
False,8425124,Unterstadion,65 - 75 Jahre,40,16,24
False,8425124,Unterstadion,75 und mehr Jahre,35,9,26
False,8425124,Unterstadion,Insgesamt,689,328,361
False,8425125,Unterwachingen,unter 3 Jahre,10,6,4
False,8425125,Unterwachingen,3 -  6 Jahre,3,2,1
False,8425125,Unterwachingen,6 - 10 Jahre,9,5,4
False,8425125,Unterwachingen,10 - 15 Jahre,9,6,3
False,8425125,Unterwachingen,15 - 18 Jahre,4,3,1
False,8425125,Unterwachingen,18 - 20 Jahre,6,1,5
False,8425125,Unterwachingen,20 - 25 Jahre,7,4,3
False,8425125,Unterwachingen,25 - 30 Jahre,13,7,6
False,8425125,Unterwachingen,30 - 35 Jahre,20,12,8
False,8425125,Unterwachingen,35 - 40 Jahre,12,9,3
False,8425125,Unterwachingen,40 - 45 Jahre,8,3,5
False,8425125,Unterwachingen,45 - 50 Jahre,12,7,5
False,8425125,Unterwachingen,50 - 55 Jahre,12,7,5
False,8425125,Unterwachingen,55 - 60 Jahre,10,4,6
False,8425125,Unterwachingen,60 - 65 Jahre,12,7,5
False,8425125,Unterwachingen,65 - 75 Jahre,12,4,8
False,8425125,Unterwachingen,75 und mehr Jahre,13,3,10
False,8425125,Unterwachingen,Insgesamt,172,90,82
False,8425130,Weidenstetten,unter 3 Jahre,40,19,21
False,8425130,Weidenstetten,3 -  6 Jahre,63,41,22
False,8425130,Weidenstetten,6 - 10 Jahre,70,35,35
False,8425130,Weidenstetten,10 - 15 Jahre,63,33,30
False,8425130,Weidenstetten,15 - 18 Jahre,33,19,14
False,8425130,Weidenstetten,18 - 20 Jahre,29,14,15
False,8425130,Weidenstetten,20 - 25 Jahre,53,27,26
False,8425130,Weidenstetten,25 - 30 Jahre,67,36,31
False,8425130,Weidenstetten,30 - 35 Jahre,90,42,48
False,8425130,Weidenstetten,35 - 40 Jahre,105,59,46
False,8425130,Weidenstetten,40 - 45 Jahre,105,52,53
False,8425130,Weidenstetten,45 - 50 Jahre,68,40,28
False,8425130,Weidenstetten,50 - 55 Jahre,60,29,31
False,8425130,Weidenstetten,55 - 60 Jahre,62,34,28
False,8425130,Weidenstetten,60 - 65 Jahre,100,43,57
False,8425130,Weidenstetten,65 - 75 Jahre,137,77,60
False,8425130,Weidenstetten,75 und mehr Jahre,46,14,32
False,8425130,Weidenstetten,Insgesamt,1191,614,577
False,8425134,Westerheim,unter 3 Jahre,96,49,47
False,8425134,Westerheim,3 -  6 Jahre,115,61,54
False,8425134,Westerheim,6 - 10 Jahre,135,70,65
False,8425134,Westerheim,10 - 15 Jahre,193,103,90
False,8425134,Westerheim,15 - 18 Jahre,115,57,58
False,8425134,Westerheim,18 - 20 Jahre,70,31,39
False,8425134,Westerheim,20 - 25 Jahre,145,69,76
False,8425134,Westerheim,25 - 30 Jahre,179,93,86
False,8425134,Westerheim,30 - 35 Jahre,216,115,101
False,8425134,Westerheim,35 - 40 Jahre,236,118,118
False,8425134,Westerheim,40 - 45 Jahre,205,99,106
False,8425134,Westerheim,45 - 50 Jahre,193,100,93
False,8425134,Westerheim,50 - 55 Jahre,143,72,71
False,8425134,Westerheim,55 - 60 Jahre,156,74,82
False,8425134,Westerheim,60 - 65 Jahre,211,113,98
False,8425134,Westerheim,65 - 75 Jahre,206,99,107
False,8425134,Westerheim,75 und mehr Jahre,137,40,97
False,8425134,Westerheim,Insgesamt,2751,1363,1388
False,8425135,Westerstetten,unter 3 Jahre,70,38,32
False,8425135,Westerstetten,3 -  6 Jahre,88,42,46
False,8425135,Westerstetten,6 - 10 Jahre,120,59,61
False,8425135,Westerstetten,10 - 15 Jahre,145,78,67
False,8425135,Westerstetten,15 - 18 Jahre,76,44,32
False,8425135,Westerstetten,18 - 20 Jahre,51,31,20
False,8425135,Westerstetten,20 - 25 Jahre,112,65,47
False,8425135,Westerstetten,25 - 30 Jahre,143,70,73
False,8425135,Westerstetten,30 - 35 Jahre,130,64,66
False,8425135,Westerstetten,35 - 40 Jahre,189,94,95
False,8425135,Westerstetten,40 - 45 Jahre,191,94,97
False,8425135,Westerstetten,45 - 50 Jahre,154,92,62
False,8425135,Westerstetten,50 - 55 Jahre,118,54,64
False,8425135,Westerstetten,55 - 60 Jahre,116,63,53
False,8425135,Westerstetten,60 - 65 Jahre,94,45,49
False,8425135,Westerstetten,65 - 75 Jahre,148,66,82
False,8425135,Westerstetten,75 und mehr Jahre,112,35,77
False,8425135,Westerstetten,Insgesamt,2057,1034,1023
False,8425137,Illerkirchberg,unter 3 Jahre,147,75,72
False,8425137,Illerkirchberg,3 -  6 Jahre,177,77,100
False,8425137,Illerkirchberg,6 - 10 Jahre,206,114,92
False,8425137,Illerkirchberg,10 - 15 Jahre,282,131,151
False,8425137,Illerkirchberg,15 - 18 Jahre,148,90,58
False,8425137,Illerkirchberg,18 - 20 Jahre,101,49,52
False,8425137,Illerkirchberg,20 - 25 Jahre,239,121,118
False,8425137,Illerkirchberg,25 - 30 Jahre,250,120,130
False,8425137,Illerkirchberg,30 - 35 Jahre,395,204,191
False,8425137,Illerkirchberg,35 - 40 Jahre,419,222,197
False,8425137,Illerkirchberg,40 - 45 Jahre,352,170,182
False,8425137,Illerkirchberg,45 - 50 Jahre,356,190,166
False,8425137,Illerkirchberg,50 - 55 Jahre,293,150,143
False,8425137,Illerkirchberg,55 - 60 Jahre,245,126,119
False,8425137,Illerkirchberg,60 - 65 Jahre,293,149,144
False,8425137,Illerkirchberg,65 - 75 Jahre,410,203,207
False,8425137,Illerkirchberg,75 und mehr Jahre,279,88,191
False,8425137,Illerkirchberg,Insgesamt,4592,2279,2313
False,8425138,Staig,unter 3 Jahre,107,52,55
False,8425138,Staig,3 -  6 Jahre,119,64,55
False,8425138,Staig,6 - 10 Jahre,155,89,66
False,8425138,Staig,10 - 15 Jahre,209,100,109
False,8425138,Staig,15 - 18 Jahre,122,69,53
False,8425138,Staig,18 - 20 Jahre,76,38,38
False,8425138,Staig,20 - 25 Jahre,157,72,85
False,8425138,Staig,25 - 30 Jahre,166,76,90
False,8425138,Staig,30 - 35 Jahre,270,137,133
False,8425138,Staig,35 - 40 Jahre,315,146,169
False,8425138,Staig,40 - 45 Jahre,255,130,125
False,8425138,Staig,45 - 50 Jahre,211,112,99
False,8425138,Staig,50 - 55 Jahre,182,97,85
False,8425138,Staig,55 - 60 Jahre,186,97,89
False,8425138,Staig,60 - 65 Jahre,229,124,105
False,8425138,Staig,65 - 75 Jahre,249,115,134
False,8425138,Staig,75 und mehr Jahre,178,59,119
False,8425138,Staig,Insgesamt,3186,1577,1609
False,8425139,Heroldstatt,unter 3 Jahre,93,47,46
False,8425139,Heroldstatt,3 -  6 Jahre,106,54,52
False,8425139,Heroldstatt,6 - 10 Jahre,146,78,68
False,8425139,Heroldstatt,10 - 15 Jahre,153,90,63
False,8425139,Heroldstatt,15 - 18 Jahre,70,40,30
False,8425139,Heroldstatt,18 - 20 Jahre,46,23,23
False,8425139,Heroldstatt,20 - 25 Jahre,125,66,59
False,8425139,Heroldstatt,25 - 30 Jahre,127,59,68
False,8425139,Heroldstatt,30 - 35 Jahre,207,107,100
False,8425139,Heroldstatt,35 - 40 Jahre,260,139,121
False,8425139,Heroldstatt,40 - 45 Jahre,192,104,88
False,8425139,Heroldstatt,45 - 50 Jahre,142,77,65
False,8425139,Heroldstatt,50 - 55 Jahre,135,69,66
False,8425139,Heroldstatt,55 - 60 Jahre,111,56,55
False,8425139,Heroldstatt,60 - 65 Jahre,151,67,84
False,8425139,Heroldstatt,65 - 75 Jahre,214,99,115
False,8425139,Heroldstatt,75 und mehr Jahre,140,51,89
False,8425139,Heroldstatt,Insgesamt,2418,1226,1192
False,8425140,Balzheim,unter 3 Jahre,81,36,45
False,8425140,Balzheim,3 -  6 Jahre,98,55,43
False,8425140,Balzheim,6 - 10 Jahre,111,56,55
False,8425140,Balzheim,10 - 15 Jahre,158,94,64
False,8425140,Balzheim,15 - 18 Jahre,73,38,35
False,8425140,Balzheim,18 - 20 Jahre,51,26,25
False,8425140,Balzheim,20 - 25 Jahre,120,61,59
False,8425140,Balzheim,25 - 30 Jahre,97,58,39
False,8425140,Balzheim,30 - 35 Jahre,203,102,101
False,8425140,Balzheim,35 - 40 Jahre,189,102,87
False,8425140,Balzheim,40 - 45 Jahre,193,94,99
False,8425140,Balzheim,45 - 50 Jahre,131,82,49
False,8425140,Balzheim,50 - 55 Jahre,106,60,46
False,8425140,Balzheim,55 - 60 Jahre,73,28,45
False,8425140,Balzheim,60 - 65 Jahre,106,58,48
False,8425140,Balzheim,65 - 75 Jahre,123,65,58
False,8425140,Balzheim,75 und mehr Jahre,98,33,65
False,8425140,Balzheim,Insgesamt,2011,1048,963
False,8425141,Blaustein,unter 3 Jahre,533,261,272
False,8425141,Blaustein,3 -  6 Jahre,474,245,229
False,8425141,Blaustein,6 - 10 Jahre,626,330,296
False,8425141,Blaustein,10 - 15 Jahre,814,405,409
False,8425141,Blaustein,15 - 18 Jahre,448,235,213
False,8425141,Blaustein,18 - 20 Jahre,302,149,153
False,8425141,Blaustein,20 - 25 Jahre,782,413,369
False,8425141,Blaustein,25 - 30 Jahre,1019,526,493
False,8425141,Blaustein,30 - 35 Jahre,1334,709,625
False,8425141,Blaustein,35 - 40 Jahre,1362,697,665
False,8425141,Blaustein,40 - 45 Jahre,1094,572,522
False,8425141,Blaustein,45 - 50 Jahre,948,498,450
False,8425141,Blaustein,50 - 55 Jahre,823,415,408
False,8425141,Blaustein,55 - 60 Jahre,871,419,452
False,8425141,Blaustein,60 - 65 Jahre,1035,539,496
False,8425141,Blaustein,65 - 75 Jahre,1337,629,708
False,8425141,Blaustein,75 und mehr Jahre,897,334,563
False,8425141,Blaustein,Insgesamt,14699,7376,7323
False,8426,Landkreis Biberach,unter 3 Jahre,6486,3304,3182
False,8426,Landkreis Biberach,3 -  6 Jahre,6987,3515,3472
False,8426,Landkreis Biberach,6 - 10 Jahre,9670,4939,4731
False,8426,Landkreis Biberach,10 - 15 Jahre,12747,6607,6140
False,8426,Landkreis Biberach,15 - 18 Jahre,6874,3560,3314
False,8426,Landkreis Biberach,18 - 20 Jahre,4605,2348,2257
False,8426,Landkreis Biberach,20 - 25 Jahre,10223,5244,4979
False,8426,Landkreis Biberach,25 - 30 Jahre,11260,5733,5527
False,8426,Landkreis Biberach,30 - 35 Jahre,14962,7709,7253
False,8426,Landkreis Biberach,35 - 40 Jahre,15662,8125,7537
False,8426,Landkreis Biberach,40 - 45 Jahre,14322,7253,7069
False,8426,Landkreis Biberach,45 - 50 Jahre,12140,6253,5887
False,8426,Landkreis Biberach,50 - 55 Jahre,10159,5290,4869
False,8426,Landkreis Biberach,55 - 60 Jahre,8770,4474,4296
False,8426,Landkreis Biberach,60 - 65 Jahre,11183,5537,5646
False,8426,Landkreis Biberach,65 - 75 Jahre,15149,7052,8097
False,8426,Landkreis Biberach,75 und mehr Jahre,11780,3633,8147
False,8426,Landkreis Biberach,Insgesamt,182979,90576,92403
False,8426001,Achstetten,unter 3 Jahre,145,70,75
False,8426001,Achstetten,3 -  6 Jahre,135,77,58
False,8426001,Achstetten,6 - 10 Jahre,208,99,109
False,8426001,Achstetten,10 - 15 Jahre,270,131,139
False,8426001,Achstetten,15 - 18 Jahre,155,86,69
False,8426001,Achstetten,18 - 20 Jahre,113,58,55
False,8426001,Achstetten,20 - 25 Jahre,242,133,109
False,8426001,Achstetten,25 - 30 Jahre,253,132,121
False,8426001,Achstetten,30 - 35 Jahre,336,165,171
False,8426001,Achstetten,35 - 40 Jahre,359,176,183
False,8426001,Achstetten,40 - 45 Jahre,278,145,133
False,8426001,Achstetten,45 - 50 Jahre,260,125,135
False,8426001,Achstetten,50 - 55 Jahre,224,117,107
False,8426001,Achstetten,55 - 60 Jahre,165,95,70
False,8426001,Achstetten,60 - 65 Jahre,182,88,94
False,8426001,Achstetten,65 - 75 Jahre,261,129,132
False,8426001,Achstetten,75 und mehr Jahre,171,49,122
False,8426001,Achstetten,Insgesamt,3757,1875,1882
False,8426005,Alleshausen,unter 3 Jahre,23,12,11
False,8426005,Alleshausen,3 -  6 Jahre,19,12,7
False,8426005,Alleshausen,6 - 10 Jahre,32,16,16
False,8426005,Alleshausen,10 - 15 Jahre,44,27,17
False,8426005,Alleshausen,15 - 18 Jahre,28,15,13
False,8426005,Alleshausen,18 - 20 Jahre,9,5,4
False,8426005,Alleshausen,20 - 25 Jahre,26,9,17
False,8426005,Alleshausen,25 - 30 Jahre,21,14,7
False,8426005,Alleshausen,30 - 35 Jahre,40,17,23
False,8426005,Alleshausen,35 - 40 Jahre,42,24,18
False,8426005,Alleshausen,40 - 45 Jahre,43,19,24
False,8426005,Alleshausen,45 - 50 Jahre,25,15,10
False,8426005,Alleshausen,50 - 55 Jahre,27,17,10
False,8426005,Alleshausen,55 - 60 Jahre,8,3,5
False,8426005,Alleshausen,60 - 65 Jahre,24,13,11
False,8426005,Alleshausen,65 - 75 Jahre,53,22,31
False,8426005,Alleshausen,75 und mehr Jahre,30,9,21
False,8426005,Alleshausen,Insgesamt,494,249,245
False,8426006,Allmannsweiler,unter 3 Jahre,10,4,6
False,8426006,Allmannsweiler,3 -  6 Jahre,16,6,10
False,8426006,Allmannsweiler,6 - 10 Jahre,23,8,15
False,8426006,Allmannsweiler,10 - 15 Jahre,30,19,11
False,8426006,Allmannsweiler,15 - 18 Jahre,12,9,3
False,8426006,Allmannsweiler,18 - 20 Jahre,8,3,5
False,8426006,Allmannsweiler,20 - 25 Jahre,20,11,9
False,8426006,Allmannsweiler,25 - 30 Jahre,14,8,6
False,8426006,Allmannsweiler,30 - 35 Jahre,25,8,17
False,8426006,Allmannsweiler,35 - 40 Jahre,33,14,19
False,8426006,Allmannsweiler,40 - 45 Jahre,23,12,11
False,8426006,Allmannsweiler,45 - 50 Jahre,22,14,8
False,8426006,Allmannsweiler,50 - 55 Jahre,9,4,5
False,8426006,Allmannsweiler,55 - 60 Jahre,12,6,6
False,8426006,Allmannsweiler,60 - 65 Jahre,22,14,8
False,8426006,Allmannsweiler,65 - 75 Jahre,26,13,13
False,8426006,Allmannsweiler,75 und mehr Jahre,8,4,4
False,8426006,Allmannsweiler,Insgesamt,313,157,156
False,8426008,Altheim,unter 3 Jahre,91,37,54
False,8426008,Altheim,3 -  6 Jahre,75,29,46
False,8426008,Altheim,6 - 10 Jahre,118,54,64
False,8426008,Altheim,10 - 15 Jahre,161,85,76
False,8426008,Altheim,15 - 18 Jahre,84,42,42
False,8426008,Altheim,18 - 20 Jahre,58,35,23
False,8426008,Altheim,20 - 25 Jahre,136,74,62
False,8426008,Altheim,25 - 30 Jahre,127,64,63
False,8426008,Altheim,30 - 35 Jahre,178,90,88
False,8426008,Altheim,35 - 40 Jahre,192,107,85
False,8426008,Altheim,40 - 45 Jahre,202,94,108
False,8426008,Altheim,45 - 50 Jahre,148,81,67
False,8426008,Altheim,50 - 55 Jahre,131,67,64
False,8426008,Altheim,55 - 60 Jahre,99,50,49
False,8426008,Altheim,60 - 65 Jahre,105,54,51
False,8426008,Altheim,65 - 75 Jahre,176,92,84
False,8426008,Altheim,75 und mehr Jahre,131,38,93
False,8426008,Altheim,Insgesamt,2212,1093,1119
False,8426011,Attenweiler,unter 3 Jahre,70,41,29
False,8426011,Attenweiler,3 -  6 Jahre,72,41,31
False,8426011,Attenweiler,6 - 10 Jahre,86,50,36
False,8426011,Attenweiler,10 - 15 Jahre,122,67,55
False,8426011,Attenweiler,15 - 18 Jahre,58,34,24
False,8426011,Attenweiler,18 - 20 Jahre,36,17,19
False,8426011,Attenweiler,20 - 25 Jahre,93,41,52
False,8426011,Attenweiler,25 - 30 Jahre,101,63,38
False,8426011,Attenweiler,30 - 35 Jahre,147,68,79
False,8426011,Attenweiler,35 - 40 Jahre,136,89,47
False,8426011,Attenweiler,40 - 45 Jahre,122,67,55
False,8426011,Attenweiler,45 - 50 Jahre,110,53,57
False,8426011,Attenweiler,50 - 55 Jahre,72,41,31
False,8426011,Attenweiler,55 - 60 Jahre,80,39,41
False,8426011,Attenweiler,60 - 65 Jahre,97,49,48
False,8426011,Attenweiler,65 - 75 Jahre,139,72,67
False,8426011,Attenweiler,75 und mehr Jahre,80,23,57
False,8426011,Attenweiler,Insgesamt,1621,855,766
False,8426013,"Bad Buchau, Stadt",unter 3 Jahre,113,53,60
False,8426013,"Bad Buchau, Stadt",3 -  6 Jahre,120,61,59
False,8426013,"Bad Buchau, Stadt",6 - 10 Jahre,192,93,99
False,8426013,"Bad Buchau, Stadt",10 - 15 Jahre,262,150,112
False,8426013,"Bad Buchau, Stadt",15 - 18 Jahre,145,85,60
False,8426013,"Bad Buchau, Stadt",18 - 20 Jahre,107,50,57
False,8426013,"Bad Buchau, Stadt",20 - 25 Jahre,205,107,98
False,8426013,"Bad Buchau, Stadt",25 - 30 Jahre,211,110,101
False,8426013,"Bad Buchau, Stadt",30 - 35 Jahre,314,167,147
False,8426013,"Bad Buchau, Stadt",35 - 40 Jahre,297,173,124
False,8426013,"Bad Buchau, Stadt",40 - 45 Jahre,292,134,158
False,8426013,"Bad Buchau, Stadt",45 - 50 Jahre,240,115,125
False,8426013,"Bad Buchau, Stadt",50 - 55 Jahre,242,115,127
False,8426013,"Bad Buchau, Stadt",55 - 60 Jahre,231,124,107
False,8426013,"Bad Buchau, Stadt",60 - 65 Jahre,282,139,143
False,8426013,"Bad Buchau, Stadt",65 - 75 Jahre,434,190,244
False,8426013,"Bad Buchau, Stadt",75 und mehr Jahre,401,124,277
False,8426013,"Bad Buchau, Stadt",Insgesamt,4088,1990,2098
False,8426014,"Bad Schussenried, Stadt",unter 3 Jahre,302,156,146
False,8426014,"Bad Schussenried, Stadt",3 -  6 Jahre,311,175,136
False,8426014,"Bad Schussenried, Stadt",6 - 10 Jahre,390,205,185
False,8426014,"Bad Schussenried, Stadt",10 - 15 Jahre,532,267,265
False,8426014,"Bad Schussenried, Stadt",15 - 18 Jahre,291,122,169
False,8426014,"Bad Schussenried, Stadt",18 - 20 Jahre,189,84,105
False,8426014,"Bad Schussenried, Stadt",20 - 25 Jahre,424,191,233
False,8426014,"Bad Schussenried, Stadt",25 - 30 Jahre,455,230,225
False,8426014,"Bad Schussenried, Stadt",30 - 35 Jahre,639,335,304
False,8426014,"Bad Schussenried, Stadt",35 - 40 Jahre,731,367,364
False,8426014,"Bad Schussenried, Stadt",40 - 45 Jahre,645,330,315
False,8426014,"Bad Schussenried, Stadt",45 - 50 Jahre,554,286,268
False,8426014,"Bad Schussenried, Stadt",50 - 55 Jahre,417,217,200
False,8426014,"Bad Schussenried, Stadt",55 - 60 Jahre,431,227,204
False,8426014,"Bad Schussenried, Stadt",60 - 65 Jahre,546,276,270
False,8426014,"Bad Schussenried, Stadt",65 - 75 Jahre,777,372,405
False,8426014,"Bad Schussenried, Stadt",75 und mehr Jahre,667,192,475
False,8426014,"Bad Schussenried, Stadt",Insgesamt,8301,4032,4269
False,8426019,Berkheim,unter 3 Jahre,108,58,50
False,8426019,Berkheim,3 -  6 Jahre,107,58,49
False,8426019,Berkheim,6 - 10 Jahre,127,62,65
False,8426019,Berkheim,10 - 15 Jahre,186,97,89
False,8426019,Berkheim,15 - 18 Jahre,105,57,48
False,8426019,Berkheim,18 - 20 Jahre,73,36,37
False,8426019,Berkheim,20 - 25 Jahre,166,80,86
False,8426019,Berkheim,25 - 30 Jahre,213,98,115
False,8426019,Berkheim,30 - 35 Jahre,204,104,100
False,8426019,Berkheim,35 - 40 Jahre,182,91,91
False,8426019,Berkheim,40 - 45 Jahre,159,82,77
False,8426019,Berkheim,45 - 50 Jahre,194,98,96
False,8426019,Berkheim,50 - 55 Jahre,160,89,71
False,8426019,Berkheim,55 - 60 Jahre,113,56,57
False,8426019,Berkheim,60 - 65 Jahre,137,76,61
False,8426019,Berkheim,65 - 75 Jahre,172,81,91
False,8426019,Berkheim,75 und mehr Jahre,152,44,108
False,8426019,Berkheim,Insgesamt,2558,1267,1291
False,8426020,Betzenweiler,unter 3 Jahre,33,15,18
False,8426020,Betzenweiler,3 -  6 Jahre,34,15,19
False,8426020,Betzenweiler,6 - 10 Jahre,45,26,19
False,8426020,Betzenweiler,10 - 15 Jahre,62,29,33
False,8426020,Betzenweiler,15 - 18 Jahre,20,9,11
False,8426020,Betzenweiler,18 - 20 Jahre,32,18,14
False,8426020,Betzenweiler,20 - 25 Jahre,38,19,19
False,8426020,Betzenweiler,25 - 30 Jahre,46,25,21
False,8426020,Betzenweiler,30 - 35 Jahre,67,32,35
False,8426020,Betzenweiler,35 - 40 Jahre,64,41,23
False,8426020,Betzenweiler,40 - 45 Jahre,43,17,26
False,8426020,Betzenweiler,45 - 50 Jahre,53,31,22
False,8426020,Betzenweiler,50 - 55 Jahre,36,21,15
False,8426020,Betzenweiler,55 - 60 Jahre,25,9,16
False,8426020,Betzenweiler,60 - 65 Jahre,37,18,19
False,8426020,Betzenweiler,65 - 75 Jahre,51,24,27
False,8426020,Betzenweiler,75 und mehr Jahre,40,17,23
False,8426020,Betzenweiler,Insgesamt,726,366,360
False,8426021,"Biberach an der Riß, Stadt",unter 3 Jahre,993,504,489
False,8426021,"Biberach an der Riß, Stadt",3 -  6 Jahre,1015,514,501
False,8426021,"Biberach an der Riß, Stadt",6 - 10 Jahre,1421,733,688
False,8426021,"Biberach an der Riß, Stadt",10 - 15 Jahre,1875,961,914
False,8426021,"Biberach an der Riß, Stadt",15 - 18 Jahre,1013,505,508
False,8426021,"Biberach an der Riß, Stadt",18 - 20 Jahre,708,365,343
False,8426021,"Biberach an der Riß, Stadt",20 - 25 Jahre,1795,925,870
False,8426021,"Biberach an der Riß, Stadt",25 - 30 Jahre,1903,924,979
False,8426021,"Biberach an der Riß, Stadt",30 - 35 Jahre,2483,1313,1170
False,8426021,"Biberach an der Riß, Stadt",35 - 40 Jahre,2545,1315,1230
False,8426021,"Biberach an der Riß, Stadt",40 - 45 Jahre,2407,1167,1240
False,8426021,"Biberach an der Riß, Stadt",45 - 50 Jahre,2067,1008,1059
False,8426021,"Biberach an der Riß, Stadt",50 - 55 Jahre,1908,948,960
False,8426021,"Biberach an der Riß, Stadt",55 - 60 Jahre,1662,826,836
False,8426021,"Biberach an der Riß, Stadt",60 - 65 Jahre,2216,1042,1174
False,8426021,"Biberach an der Riß, Stadt",65 - 75 Jahre,3072,1363,1709
False,8426021,"Biberach an der Riß, Stadt",75 und mehr Jahre,2510,785,1725
False,8426021,"Biberach an der Riß, Stadt",Insgesamt,31593,15198,16395
False,8426028,Burgrieden,unter 3 Jahre,132,60,72
False,8426028,Burgrieden,3 -  6 Jahre,173,95,78
False,8426028,Burgrieden,6 - 10 Jahre,199,97,102
False,8426028,Burgrieden,10 - 15 Jahre,234,139,95
False,8426028,Burgrieden,15 - 18 Jahre,118,63,55
False,8426028,Burgrieden,18 - 20 Jahre,82,45,37
False,8426028,Burgrieden,20 - 25 Jahre,170,96,74
False,8426028,Burgrieden,25 - 30 Jahre,191,84,107
False,8426028,Burgrieden,30 - 35 Jahre,312,163,149
False,8426028,Burgrieden,35 - 40 Jahre,366,193,173
False,8426028,Burgrieden,40 - 45 Jahre,299,158,141
False,8426028,Burgrieden,45 - 50 Jahre,221,114,107
False,8426028,Burgrieden,50 - 55 Jahre,173,95,78
False,8426028,Burgrieden,55 - 60 Jahre,163,94,69
False,8426028,Burgrieden,60 - 65 Jahre,167,71,96
False,8426028,Burgrieden,65 - 75 Jahre,276,123,153
False,8426028,Burgrieden,75 und mehr Jahre,150,63,87
False,8426028,Burgrieden,Insgesamt,3426,1753,1673
False,8426031,Dettingen an der Iller,unter 3 Jahre,85,34,51
False,8426031,Dettingen an der Iller,3 -  6 Jahre,97,49,48
False,8426031,Dettingen an der Iller,6 - 10 Jahre,134,72,62
False,8426031,Dettingen an der Iller,10 - 15 Jahre,201,98,103
False,8426031,Dettingen an der Iller,15 - 18 Jahre,85,40,45
False,8426031,Dettingen an der Iller,18 - 20 Jahre,57,23,34
False,8426031,Dettingen an der Iller,20 - 25 Jahre,97,49,48
False,8426031,Dettingen an der Iller,25 - 30 Jahre,106,55,51
False,8426031,Dettingen an der Iller,30 - 35 Jahre,178,96,82
False,8426031,Dettingen an der Iller,35 - 40 Jahre,207,95,112
False,8426031,Dettingen an der Iller,40 - 45 Jahre,193,104,89
False,8426031,Dettingen an der Iller,45 - 50 Jahre,121,68,53
False,8426031,Dettingen an der Iller,50 - 55 Jahre,83,51,32
False,8426031,Dettingen an der Iller,55 - 60 Jahre,93,47,46
False,8426031,Dettingen an der Iller,60 - 65 Jahre,117,54,63
False,8426031,Dettingen an der Iller,65 - 75 Jahre,155,82,73
False,8426031,Dettingen an der Iller,75 und mehr Jahre,96,33,63
False,8426031,Dettingen an der Iller,Insgesamt,2105,1050,1055
False,8426035,Dürmentingen,unter 3 Jahre,113,59,54
False,8426035,Dürmentingen,3 -  6 Jahre,88,42,46
False,8426035,Dürmentingen,6 - 10 Jahre,148,83,65
False,8426035,Dürmentingen,10 - 15 Jahre,196,103,93
False,8426035,Dürmentingen,15 - 18 Jahre,105,58,47
False,8426035,Dürmentingen,18 - 20 Jahre,75,29,46
False,8426035,Dürmentingen,20 - 25 Jahre,145,70,75
False,8426035,Dürmentingen,25 - 30 Jahre,149,91,58
False,8426035,Dürmentingen,30 - 35 Jahre,195,109,86
False,8426035,Dürmentingen,35 - 40 Jahre,204,105,99
False,8426035,Dürmentingen,40 - 45 Jahre,194,103,91
False,8426035,Dürmentingen,45 - 50 Jahre,169,95,74
False,8426035,Dürmentingen,50 - 55 Jahre,142,69,73
False,8426035,Dürmentingen,55 - 60 Jahre,89,42,47
False,8426035,Dürmentingen,60 - 65 Jahre,147,75,72
False,8426035,Dürmentingen,65 - 75 Jahre,239,101,138
False,8426035,Dürmentingen,75 und mehr Jahre,153,47,106
False,8426035,Dürmentingen,Insgesamt,2551,1281,1270
False,8426036,Dürnau,unter 3 Jahre,19,7,12
False,8426036,Dürnau,3 -  6 Jahre,18,10,8
False,8426036,Dürnau,6 - 10 Jahre,16,10,6
False,8426036,Dürnau,10 - 15 Jahre,26,15,11
False,8426036,Dürnau,15 - 18 Jahre,13,7,6
False,8426036,Dürnau,18 - 20 Jahre,17,10,7
False,8426036,Dürnau,20 - 25 Jahre,31,19,12
False,8426036,Dürnau,25 - 30 Jahre,37,16,21
False,8426036,Dürnau,30 - 35 Jahre,42,21,21
False,8426036,Dürnau,35 - 40 Jahre,32,14,18
False,8426036,Dürnau,40 - 45 Jahre,21,14,7
False,8426036,Dürnau,45 - 50 Jahre,33,15,18
False,8426036,Dürnau,50 - 55 Jahre,28,14,14
False,8426036,Dürnau,55 - 60 Jahre,17,4,13
False,8426036,Dürnau,60 - 65 Jahre,24,13,11
False,8426036,Dürnau,65 - 75 Jahre,39,20,19
False,8426036,Dürnau,75 und mehr Jahre,29,12,17
False,8426036,Dürnau,Insgesamt,442,221,221
False,8426038,Eberhardzell,unter 3 Jahre,145,70,75
False,8426038,Eberhardzell,3 -  6 Jahre,162,81,81
False,8426038,Eberhardzell,6 - 10 Jahre,231,129,102
False,8426038,Eberhardzell,10 - 15 Jahre,290,158,132
False,8426038,Eberhardzell,15 - 18 Jahre,153,89,64
False,8426038,Eberhardzell,18 - 20 Jahre,83,45,38
False,8426038,Eberhardzell,20 - 25 Jahre,185,94,91
False,8426038,Eberhardzell,25 - 30 Jahre,204,92,112
False,8426038,Eberhardzell,30 - 35 Jahre,340,182,158
False,8426038,Eberhardzell,35 - 40 Jahre,358,190,168
False,8426038,Eberhardzell,40 - 45 Jahre,330,159,171
False,8426038,Eberhardzell,45 - 50 Jahre,266,157,109
False,8426038,Eberhardzell,50 - 55 Jahre,184,109,75
False,8426038,Eberhardzell,55 - 60 Jahre,161,78,83
False,8426038,Eberhardzell,60 - 65 Jahre,210,110,100
False,8426038,Eberhardzell,65 - 75 Jahre,253,117,136
False,8426038,Eberhardzell,75 und mehr Jahre,250,81,169
False,8426038,Eberhardzell,Insgesamt,3805,1941,1864
False,8426043,Erlenmoos,unter 3 Jahre,80,39,41
False,8426043,Erlenmoos,3 -  6 Jahre,61,36,25
False,8426043,Erlenmoos,6 - 10 Jahre,89,45,44
False,8426043,Erlenmoos,10 - 15 Jahre,119,67,52
False,8426043,Erlenmoos,15 - 18 Jahre,56,25,31
False,8426043,Erlenmoos,18 - 20 Jahre,41,18,23
False,8426043,Erlenmoos,20 - 25 Jahre,80,38,42
False,8426043,Erlenmoos,25 - 30 Jahre,104,56,48
False,8426043,Erlenmoos,30 - 35 Jahre,147,84,63
False,8426043,Erlenmoos,35 - 40 Jahre,119,67,52
False,8426043,Erlenmoos,40 - 45 Jahre,127,62,65
False,8426043,Erlenmoos,45 - 50 Jahre,97,53,44
False,8426043,Erlenmoos,50 - 55 Jahre,82,52,30
False,8426043,Erlenmoos,55 - 60 Jahre,58,28,30
False,8426043,Erlenmoos,60 - 65 Jahre,102,50,52
False,8426043,Erlenmoos,65 - 75 Jahre,133,71,62
False,8426043,Erlenmoos,75 und mehr Jahre,54,17,37
False,8426043,Erlenmoos,Insgesamt,1549,808,741
False,8426044,Erolzheim,unter 3 Jahre,108,61,47
False,8426044,Erolzheim,3 -  6 Jahre,108,46,62
False,8426044,Erolzheim,6 - 10 Jahre,169,84,85
False,8426044,Erolzheim,10 - 15 Jahre,246,126,120
False,8426044,Erolzheim,15 - 18 Jahre,139,63,76
False,8426044,Erolzheim,18 - 20 Jahre,86,44,42
False,8426044,Erolzheim,20 - 25 Jahre,161,81,80
False,8426044,Erolzheim,25 - 30 Jahre,163,86,77
False,8426044,Erolzheim,30 - 35 Jahre,218,91,127
False,8426044,Erolzheim,35 - 40 Jahre,285,137,148
False,8426044,Erolzheim,40 - 45 Jahre,248,119,129
False,8426044,Erolzheim,45 - 50 Jahre,211,113,98
False,8426044,Erolzheim,50 - 55 Jahre,162,87,75
False,8426044,Erolzheim,55 - 60 Jahre,121,66,55
False,8426044,Erolzheim,60 - 65 Jahre,159,77,82
False,8426044,Erolzheim,65 - 75 Jahre,224,104,120
False,8426044,Erolzheim,75 und mehr Jahre,169,57,112
False,8426044,Erolzheim,Insgesamt,2977,1442,1535
False,8426045,Ertingen,unter 3 Jahre,201,112,89
False,8426045,Ertingen,3 -  6 Jahre,232,117,115
False,8426045,Ertingen,6 - 10 Jahre,318,163,155
False,8426045,Ertingen,10 - 15 Jahre,447,250,197
False,8426045,Ertingen,15 - 18 Jahre,240,121,119
False,8426045,Ertingen,18 - 20 Jahre,137,73,64
False,8426045,Ertingen,20 - 25 Jahre,286,135,151
False,8426045,Ertingen,25 - 30 Jahre,366,180,186
False,8426045,Ertingen,30 - 35 Jahre,444,211,233
False,8426045,Ertingen,35 - 40 Jahre,456,223,233
False,8426045,Ertingen,40 - 45 Jahre,438,218,220
False,8426045,Ertingen,45 - 50 Jahre,356,194,162
False,8426045,Ertingen,50 - 55 Jahre,271,139,132
False,8426045,Ertingen,55 - 60 Jahre,225,118,107
False,8426045,Ertingen,60 - 65 Jahre,336,180,156
False,8426045,Ertingen,65 - 75 Jahre,475,210,265
False,8426045,Ertingen,75 und mehr Jahre,351,100,251
False,8426045,Ertingen,Insgesamt,5579,2744,2835
False,8426058,Hochdorf,unter 3 Jahre,76,40,36
False,8426058,Hochdorf,3 -  6 Jahre,77,36,41
False,8426058,Hochdorf,6 - 10 Jahre,128,58,70
False,8426058,Hochdorf,10 - 15 Jahre,127,65,62
False,8426058,Hochdorf,15 - 18 Jahre,83,39,44
False,8426058,Hochdorf,18 - 20 Jahre,50,26,24
False,8426058,Hochdorf,20 - 25 Jahre,121,57,64
False,8426058,Hochdorf,25 - 30 Jahre,113,55,58
False,8426058,Hochdorf,30 - 35 Jahre,167,97,70
False,8426058,Hochdorf,35 - 40 Jahre,187,98,89
False,8426058,Hochdorf,40 - 45 Jahre,150,70,80
False,8426058,Hochdorf,45 - 50 Jahre,135,74,61
False,8426058,Hochdorf,50 - 55 Jahre,142,69,73
False,8426058,Hochdorf,55 - 60 Jahre,100,52,48
False,8426058,Hochdorf,60 - 65 Jahre,121,65,56
False,8426058,Hochdorf,65 - 75 Jahre,152,75,77
False,8426058,Hochdorf,75 und mehr Jahre,99,38,61
False,8426058,Hochdorf,Insgesamt,2028,1014,1014
False,8426062,Ingoldingen,unter 3 Jahre,82,47,35
False,8426062,Ingoldingen,3 -  6 Jahre,102,50,52
False,8426062,Ingoldingen,6 - 10 Jahre,150,78,72
False,8426062,Ingoldingen,10 - 15 Jahre,206,100,106
False,8426062,Ingoldingen,15 - 18 Jahre,101,52,49
False,8426062,Ingoldingen,18 - 20 Jahre,74,29,45
False,8426062,Ingoldingen,20 - 25 Jahre,178,96,82
False,8426062,Ingoldingen,25 - 30 Jahre,155,83,72
False,8426062,Ingoldingen,30 - 35 Jahre,210,115,95
False,8426062,Ingoldingen,35 - 40 Jahre,175,92,83
False,8426062,Ingoldingen,40 - 45 Jahre,207,108,99
False,8426062,Ingoldingen,45 - 50 Jahre,202,104,98
False,8426062,Ingoldingen,50 - 55 Jahre,165,83,82
False,8426062,Ingoldingen,55 - 60 Jahre,150,85,65
False,8426062,Ingoldingen,60 - 65 Jahre,131,72,59
False,8426062,Ingoldingen,65 - 75 Jahre,209,106,103
False,8426062,Ingoldingen,75 und mehr Jahre,158,58,100
False,8426062,Ingoldingen,Insgesamt,2655,1358,1297
False,8426064,Kanzach,unter 3 Jahre,14,9,5
False,8426064,Kanzach,3 -  6 Jahre,16,5,11
False,8426064,Kanzach,6 - 10 Jahre,32,19,13
False,8426064,Kanzach,10 - 15 Jahre,41,21,20
False,8426064,Kanzach,15 - 18 Jahre,29,15,14
False,8426064,Kanzach,18 - 20 Jahre,20,11,9
False,8426064,Kanzach,20 - 25 Jahre,29,14,15
False,8426064,Kanzach,25 - 30 Jahre,21,11,10
False,8426064,Kanzach,30 - 35 Jahre,35,20,15
False,8426064,Kanzach,35 - 40 Jahre,47,24,23
False,8426064,Kanzach,40 - 45 Jahre,48,25,23
False,8426064,Kanzach,45 - 50 Jahre,38,22,16
False,8426064,Kanzach,50 - 55 Jahre,19,9,10
False,8426064,Kanzach,55 - 60 Jahre,16,7,9
False,8426064,Kanzach,60 - 65 Jahre,32,20,12
False,8426064,Kanzach,65 - 75 Jahre,47,18,29
False,8426064,Kanzach,75 und mehr Jahre,36,13,23
False,8426064,Kanzach,Insgesamt,520,263,257
False,8426065,Kirchberg an der Iller,unter 3 Jahre,45,22,23
False,8426065,Kirchberg an der Iller,3 -  6 Jahre,58,27,31
False,8426065,Kirchberg an der Iller,6 - 10 Jahre,80,41,39
False,8426065,Kirchberg an der Iller,10 - 15 Jahre,143,74,69
False,8426065,Kirchberg an der Iller,15 - 18 Jahre,75,46,29
False,8426065,Kirchberg an der Iller,18 - 20 Jahre,61,33,28
False,8426065,Kirchberg an der Iller,20 - 25 Jahre,100,42,58
False,8426065,Kirchberg an der Iller,25 - 30 Jahre,100,53,47
False,8426065,Kirchberg an der Iller,30 - 35 Jahre,133,65,68
False,8426065,Kirchberg an der Iller,35 - 40 Jahre,148,73,75
False,8426065,Kirchberg an der Iller,40 - 45 Jahre,115,57,58
False,8426065,Kirchberg an der Iller,45 - 50 Jahre,131,66,65
False,8426065,Kirchberg an der Iller,50 - 55 Jahre,113,54,59
False,8426065,Kirchberg an der Iller,55 - 60 Jahre,95,55,40
False,8426065,Kirchberg an der Iller,60 - 65 Jahre,115,57,58
False,8426065,Kirchberg an der Iller,65 - 75 Jahre,158,81,77
False,8426065,Kirchberg an der Iller,75 und mehr Jahre,93,22,71
False,8426065,Kirchberg an der Iller,Insgesamt,1763,868,895
False,8426066,Kirchdorf an der Iller,unter 3 Jahre,138,79,59
False,8426066,Kirchdorf an der Iller,3 -  6 Jahre,144,77,67
False,8426066,Kirchdorf an der Iller,6 - 10 Jahre,205,98,107
False,8426066,Kirchdorf an der Iller,10 - 15 Jahre,296,141,155
False,8426066,Kirchdorf an der Iller,15 - 18 Jahre,160,78,82
False,8426066,Kirchdorf an der Iller,18 - 20 Jahre,104,48,56
False,8426066,Kirchdorf an der Iller,20 - 25 Jahre,209,97,112
False,8426066,Kirchdorf an der Iller,25 - 30 Jahre,192,97,95
False,8426066,Kirchdorf an der Iller,30 - 35 Jahre,278,140,138
False,8426066,Kirchdorf an der Iller,35 - 40 Jahre,343,180,163
False,8426066,Kirchdorf an der Iller,40 - 45 Jahre,268,139,129
False,8426066,Kirchdorf an der Iller,45 - 50 Jahre,249,118,131
False,8426066,Kirchdorf an der Iller,50 - 55 Jahre,185,104,81
False,8426066,Kirchdorf an der Iller,55 - 60 Jahre,163,76,87
False,8426066,Kirchdorf an der Iller,60 - 65 Jahre,169,86,83
False,8426066,Kirchdorf an der Iller,65 - 75 Jahre,240,118,122
False,8426066,Kirchdorf an der Iller,75 und mehr Jahre,175,57,118
False,8426066,Kirchdorf an der Iller,Insgesamt,3518,1733,1785
False,8426067,Langenenslingen,unter 3 Jahre,132,54,78
False,8426067,Langenenslingen,3 -  6 Jahre,166,93,73
False,8426067,Langenenslingen,6 - 10 Jahre,218,104,114
False,8426067,Langenenslingen,10 - 15 Jahre,277,145,132
False,8426067,Langenenslingen,15 - 18 Jahre,147,74,73
False,8426067,Langenenslingen,18 - 20 Jahre,77,40,37
False,8426067,Langenenslingen,20 - 25 Jahre,158,90,68
False,8426067,Langenenslingen,25 - 30 Jahre,210,96,114
False,8426067,Langenenslingen,30 - 35 Jahre,283,149,134
False,8426067,Langenenslingen,35 - 40 Jahre,298,149,149
False,8426067,Langenenslingen,40 - 45 Jahre,295,157,138
False,8426067,Langenenslingen,45 - 50 Jahre,195,108,87
False,8426067,Langenenslingen,50 - 55 Jahre,160,83,77
False,8426067,Langenenslingen,55 - 60 Jahre,126,65,61
False,8426067,Langenenslingen,60 - 65 Jahre,234,116,118
False,8426067,Langenenslingen,65 - 75 Jahre,327,155,172
False,8426067,Langenenslingen,75 und mehr Jahre,237,67,170
False,8426067,Langenenslingen,Insgesamt,3540,1745,1795
False,8426070,"Laupheim, Stadt",unter 3 Jahre,555,294,261
False,8426070,"Laupheim, Stadt",3 -  6 Jahre,600,326,274
False,8426070,"Laupheim, Stadt",6 - 10 Jahre,915,481,434
False,8426070,"Laupheim, Stadt",10 - 15 Jahre,1181,610,571
False,8426070,"Laupheim, Stadt",15 - 18 Jahre,666,342,324
False,8426070,"Laupheim, Stadt",18 - 20 Jahre,518,260,258
False,8426070,"Laupheim, Stadt",20 - 25 Jahre,1090,574,516
False,8426070,"Laupheim, Stadt",25 - 30 Jahre,1251,662,589
False,8426070,"Laupheim, Stadt",30 - 35 Jahre,1481,776,705
False,8426070,"Laupheim, Stadt",35 - 40 Jahre,1568,828,740
False,8426070,"Laupheim, Stadt",40 - 45 Jahre,1426,708,718
False,8426070,"Laupheim, Stadt",45 - 50 Jahre,1279,672,607
False,8426070,"Laupheim, Stadt",50 - 55 Jahre,1116,575,541
False,8426070,"Laupheim, Stadt",55 - 60 Jahre,994,505,489
False,8426070,"Laupheim, Stadt",60 - 65 Jahre,1156,573,583
False,8426070,"Laupheim, Stadt",65 - 75 Jahre,1451,637,814
False,8426070,"Laupheim, Stadt",75 und mehr Jahre,1213,337,876
False,8426070,"Laupheim, Stadt",Insgesamt,18460,9160,9300
False,8426071,Maselheim,unter 3 Jahre,150,71,79
False,8426071,Maselheim,3 -  6 Jahre,185,85,100
False,8426071,Maselheim,6 - 10 Jahre,261,145,116
False,8426071,Maselheim,10 - 15 Jahre,344,169,175
False,8426071,Maselheim,15 - 18 Jahre,154,81,73
False,8426071,Maselheim,18 - 20 Jahre,96,49,47
False,8426071,Maselheim,20 - 25 Jahre,218,114,104
False,8426071,Maselheim,25 - 30 Jahre,245,137,108
False,8426071,Maselheim,30 - 35 Jahre,391,198,193
False,8426071,Maselheim,35 - 40 Jahre,422,204,218
False,8426071,Maselheim,40 - 45 Jahre,376,203,173
False,8426071,Maselheim,45 - 50 Jahre,316,159,157
False,8426071,Maselheim,50 - 55 Jahre,259,140,119
False,8426071,Maselheim,55 - 60 Jahre,211,113,98
False,8426071,Maselheim,60 - 65 Jahre,285,136,149
False,8426071,Maselheim,65 - 75 Jahre,330,162,168
False,8426071,Maselheim,75 und mehr Jahre,251,74,177
False,8426071,Maselheim,Insgesamt,4494,2240,2254
False,8426073,Mietingen,unter 3 Jahre,174,76,98
False,8426073,Mietingen,3 -  6 Jahre,169,82,87
False,8426073,Mietingen,6 - 10 Jahre,220,116,104
False,8426073,Mietingen,10 - 15 Jahre,288,152,136
False,8426073,Mietingen,15 - 18 Jahre,148,80,68
False,8426073,Mietingen,18 - 20 Jahre,109,56,53
False,8426073,Mietingen,20 - 25 Jahre,235,122,113
False,8426073,Mietingen,25 - 30 Jahre,300,167,133
False,8426073,Mietingen,30 - 35 Jahre,362,184,178
False,8426073,Mietingen,35 - 40 Jahre,352,188,164
False,8426073,Mietingen,40 - 45 Jahre,328,168,160
False,8426073,Mietingen,45 - 50 Jahre,245,128,117
False,8426073,Mietingen,50 - 55 Jahre,210,109,101
False,8426073,Mietingen,55 - 60 Jahre,152,78,74
False,8426073,Mietingen,60 - 65 Jahre,172,89,83
False,8426073,Mietingen,65 - 75 Jahre,205,102,103
False,8426073,Mietingen,75 und mehr Jahre,147,51,96
False,8426073,Mietingen,Insgesamt,3816,1948,1868
False,8426074,Mittelbiberach,unter 3 Jahre,129,72,57
False,8426074,Mittelbiberach,3 -  6 Jahre,150,65,85
False,8426074,Mittelbiberach,6 - 10 Jahre,231,112,119
False,8426074,Mittelbiberach,10 - 15 Jahre,274,140,134
False,8426074,Mittelbiberach,15 - 18 Jahre,137,74,63
False,8426074,Mittelbiberach,18 - 20 Jahre,94,43,51
False,8426074,Mittelbiberach,20 - 25 Jahre,211,106,105
False,8426074,Mittelbiberach,25 - 30 Jahre,173,90,83
False,8426074,Mittelbiberach,30 - 35 Jahre,283,132,151
False,8426074,Mittelbiberach,35 - 40 Jahre,343,175,168
False,8426074,Mittelbiberach,40 - 45 Jahre,307,156,151
False,8426074,Mittelbiberach,45 - 50 Jahre,257,130,127
False,8426074,Mittelbiberach,50 - 55 Jahre,231,122,109
False,8426074,Mittelbiberach,55 - 60 Jahre,166,84,82
False,8426074,Mittelbiberach,60 - 65 Jahre,204,99,105
False,8426074,Mittelbiberach,65 - 75 Jahre,236,116,120
False,8426074,Mittelbiberach,75 und mehr Jahre,160,53,107
False,8426074,Mittelbiberach,Insgesamt,3586,1769,1817
False,8426078,Moosburg,unter 3 Jahre,6,4,2
False,8426078,Moosburg,3 -  6 Jahre,10,6,4
False,8426078,Moosburg,6 - 10 Jahre,12,7,5
False,8426078,Moosburg,10 - 15 Jahre,21,13,8
False,8426078,Moosburg,15 - 18 Jahre,4,2,2
False,8426078,Moosburg,18 - 20 Jahre,5,3,2
False,8426078,Moosburg,20 - 25 Jahre,10,3,7
False,8426078,Moosburg,25 - 30 Jahre,9,5,4
False,8426078,Moosburg,30 - 35 Jahre,15,6,9
False,8426078,Moosburg,35 - 40 Jahre,10,5,5
False,8426078,Moosburg,40 - 45 Jahre,11,5,6
False,8426078,Moosburg,45 - 50 Jahre,21,13,8
False,8426078,Moosburg,50 - 55 Jahre,6,2,4
False,8426078,Moosburg,55 - 60 Jahre,10,4,6
False,8426078,Moosburg,60 - 65 Jahre,23,13,10
False,8426078,Moosburg,65 - 75 Jahre,18,8,10
False,8426078,Moosburg,75 und mehr Jahre,10,5,5
False,8426078,Moosburg,Insgesamt,201,104,97
False,8426087,"Ochsenhausen, Stadt",unter 3 Jahre,342,191,151
False,8426087,"Ochsenhausen, Stadt",3 -  6 Jahre,371,187,184
False,8426087,"Ochsenhausen, Stadt",6 - 10 Jahre,500,231,269
False,8426087,"Ochsenhausen, Stadt",10 - 15 Jahre,611,309,302
False,8426087,"Ochsenhausen, Stadt",15 - 18 Jahre,332,180,152
False,8426087,"Ochsenhausen, Stadt",18 - 20 Jahre,221,114,107
False,8426087,"Ochsenhausen, Stadt",20 - 25 Jahre,501,252,249
False,8426087,"Ochsenhausen, Stadt",25 - 30 Jahre,590,275,315
False,8426087,"Ochsenhausen, Stadt",30 - 35 Jahre,743,388,355
False,8426087,"Ochsenhausen, Stadt",35 - 40 Jahre,705,363,342
False,8426087,"Ochsenhausen, Stadt",40 - 45 Jahre,732,395,337
False,8426087,"Ochsenhausen, Stadt",45 - 50 Jahre,562,289,273
False,8426087,"Ochsenhausen, Stadt",50 - 55 Jahre,432,236,196
False,8426087,"Ochsenhausen, Stadt",55 - 60 Jahre,364,180,184
False,8426087,"Ochsenhausen, Stadt",60 - 65 Jahre,482,238,244
False,8426087,"Ochsenhausen, Stadt",65 - 75 Jahre,667,304,363
False,8426087,"Ochsenhausen, Stadt",75 und mehr Jahre,522,159,363
False,8426087,"Ochsenhausen, Stadt",Insgesamt,8677,4291,4386
False,8426090,Oggelshausen,unter 3 Jahre,31,18,13
False,8426090,Oggelshausen,3 -  6 Jahre,46,15,31
False,8426090,Oggelshausen,6 - 10 Jahre,50,23,27
False,8426090,Oggelshausen,10 - 15 Jahre,73,43,30
False,8426090,Oggelshausen,15 - 18 Jahre,30,18,12
False,8426090,Oggelshausen,18 - 20 Jahre,11,7,4
False,8426090,Oggelshausen,20 - 25 Jahre,49,24,25
False,8426090,Oggelshausen,25 - 30 Jahre,51,29,22
False,8426090,Oggelshausen,30 - 35 Jahre,77,39,38
False,8426090,Oggelshausen,35 - 40 Jahre,102,55,47
False,8426090,Oggelshausen,40 - 45 Jahre,86,49,37
False,8426090,Oggelshausen,45 - 50 Jahre,59,34,25
False,8426090,Oggelshausen,50 - 55 Jahre,24,11,13
False,8426090,Oggelshausen,55 - 60 Jahre,51,18,33
False,8426090,Oggelshausen,60 - 65 Jahre,63,32,31
False,8426090,Oggelshausen,65 - 75 Jahre,85,43,42
False,8426090,Oggelshausen,75 und mehr Jahre,49,15,34
False,8426090,Oggelshausen,Insgesamt,937,473,464
False,8426097,"Riedlingen, Stadt",unter 3 Jahre,334,188,146
False,8426097,"Riedlingen, Stadt",3 -  6 Jahre,363,175,188
False,8426097,"Riedlingen, Stadt",6 - 10 Jahre,465,236,229
False,8426097,"Riedlingen, Stadt",10 - 15 Jahre,665,337,328
False,8426097,"Riedlingen, Stadt",15 - 18 Jahre,418,219,199
False,8426097,"Riedlingen, Stadt",18 - 20 Jahre,254,126,128
False,8426097,"Riedlingen, Stadt",20 - 25 Jahre,587,302,285
False,8426097,"Riedlingen, Stadt",25 - 30 Jahre,615,325,290
False,8426097,"Riedlingen, Stadt",30 - 35 Jahre,707,365,342
False,8426097,"Riedlingen, Stadt",35 - 40 Jahre,769,401,368
False,8426097,"Riedlingen, Stadt",40 - 45 Jahre,772,369,403
False,8426097,"Riedlingen, Stadt",45 - 50 Jahre,662,339,323
False,8426097,"Riedlingen, Stadt",50 - 55 Jahre,539,273,266
False,8426097,"Riedlingen, Stadt",55 - 60 Jahre,474,238,236
False,8426097,"Riedlingen, Stadt",60 - 65 Jahre,669,306,363
False,8426097,"Riedlingen, Stadt",65 - 75 Jahre,937,443,494
False,8426097,"Riedlingen, Stadt",75 und mehr Jahre,939,280,659
False,8426097,"Riedlingen, Stadt",Insgesamt,10169,4922,5247
False,8426100,Rot an der Rot,unter 3 Jahre,153,85,68
False,8426100,Rot an der Rot,3 -  6 Jahre,179,89,90
False,8426100,Rot an der Rot,6 - 10 Jahre,245,122,123
False,8426100,Rot an der Rot,10 - 15 Jahre,304,173,131
False,8426100,Rot an der Rot,15 - 18 Jahre,173,87,86
False,8426100,Rot an der Rot,18 - 20 Jahre,108,65,43
False,8426100,Rot an der Rot,20 - 25 Jahre,220,122,98
False,8426100,Rot an der Rot,25 - 30 Jahre,303,163,140
False,8426100,Rot an der Rot,30 - 35 Jahre,376,171,205
False,8426100,Rot an der Rot,35 - 40 Jahre,368,203,165
False,8426100,Rot an der Rot,40 - 45 Jahre,328,182,146
False,8426100,Rot an der Rot,45 - 50 Jahre,269,144,125
False,8426100,Rot an der Rot,50 - 55 Jahre,229,124,105
False,8426100,Rot an der Rot,55 - 60 Jahre,211,102,109
False,8426100,Rot an der Rot,60 - 65 Jahre,274,148,126
False,8426100,Rot an der Rot,65 - 75 Jahre,339,169,170
False,8426100,Rot an der Rot,75 und mehr Jahre,249,73,176
False,8426100,Rot an der Rot,Insgesamt,4328,2222,2106
False,8426108,Schwendi,unter 3 Jahre,222,106,116
False,8426108,Schwendi,3 -  6 Jahre,262,117,145
False,8426108,Schwendi,6 - 10 Jahre,337,183,154
False,8426108,Schwendi,10 - 15 Jahre,428,206,222
False,8426108,Schwendi,15 - 18 Jahre,236,126,110
False,8426108,Schwendi,18 - 20 Jahre,141,79,62
False,8426108,Schwendi,20 - 25 Jahre,327,163,164
False,8426108,Schwendi,25 - 30 Jahre,373,195,178
False,8426108,Schwendi,30 - 35 Jahre,504,259,245
False,8426108,Schwendi,35 - 40 Jahre,556,285,271
False,8426108,Schwendi,40 - 45 Jahre,461,238,223
False,8426108,Schwendi,45 - 50 Jahre,393,192,201
False,8426108,Schwendi,50 - 55 Jahre,335,192,143
False,8426108,Schwendi,55 - 60 Jahre,286,150,136
False,8426108,Schwendi,60 - 65 Jahre,352,184,168
False,8426108,Schwendi,65 - 75 Jahre,457,235,222
False,8426108,Schwendi,75 und mehr Jahre,381,96,285
False,8426108,Schwendi,Insgesamt,6051,3006,3045
False,8426109,Seekirch,unter 3 Jahre,19,5,14
False,8426109,Seekirch,3 -  6 Jahre,12,6,6
False,8426109,Seekirch,6 - 10 Jahre,17,7,10
False,8426109,Seekirch,10 - 15 Jahre,9,4,5
False,8426109,Seekirch,15 - 18 Jahre,6,4,2
False,8426109,Seekirch,18 - 20 Jahre,4,3,1
False,8426109,Seekirch,20 - 25 Jahre,9,2,7
False,8426109,Seekirch,25 - 30 Jahre,15,5,10
False,8426109,Seekirch,30 - 35 Jahre,33,13,20
False,8426109,Seekirch,35 - 40 Jahre,27,17,10
False,8426109,Seekirch,40 - 45 Jahre,18,9,9
False,8426109,Seekirch,45 - 50 Jahre,15,6,9
False,8426109,Seekirch,50 - 55 Jahre,4,4,0
False,8426109,Seekirch,55 - 60 Jahre,9,3,6
False,8426109,Seekirch,60 - 65 Jahre,24,12,12
False,8426109,Seekirch,65 - 75 Jahre,22,10,12
False,8426109,Seekirch,75 und mehr Jahre,6,2,4
False,8426109,Seekirch,Insgesamt,249,112,137
False,8426113,Steinhausen an der Rottum,unter 3 Jahre,54,29,25
False,8426113,Steinhausen an der Rottum,3 -  6 Jahre,84,44,40
False,8426113,Steinhausen an der Rottum,6 - 10 Jahre,119,51,68
False,8426113,Steinhausen an der Rottum,10 - 15 Jahre,149,69,80
False,8426113,Steinhausen an der Rottum,15 - 18 Jahre,69,38,31
False,8426113,Steinhausen an der Rottum,18 - 20 Jahre,46,31,15
False,8426113,Steinhausen an der Rottum,20 - 25 Jahre,100,52,48
False,8426113,Steinhausen an der Rottum,25 - 30 Jahre,124,65,59
False,8426113,Steinhausen an der Rottum,30 - 35 Jahre,177,93,84
False,8426113,Steinhausen an der Rottum,35 - 40 Jahre,182,101,81
False,8426113,Steinhausen an der Rottum,40 - 45 Jahre,142,78,64
False,8426113,Steinhausen an der Rottum,45 - 50 Jahre,115,62,53
False,8426113,Steinhausen an der Rottum,50 - 55 Jahre,88,47,41
False,8426113,Steinhausen an der Rottum,55 - 60 Jahre,60,32,28
False,8426113,Steinhausen an der Rottum,60 - 65 Jahre,100,50,50
False,8426113,Steinhausen an der Rottum,65 - 75 Jahre,145,71,74
False,8426113,Steinhausen an der Rottum,75 und mehr Jahre,109,37,72
False,8426113,Steinhausen an der Rottum,Insgesamt,1863,950,913
False,8426117,Tannheim,unter 3 Jahre,88,40,48
False,8426117,Tannheim,3 -  6 Jahre,93,45,48
False,8426117,Tannheim,6 - 10 Jahre,110,56,54
False,8426117,Tannheim,10 - 15 Jahre,143,80,63
False,8426117,Tannheim,15 - 18 Jahre,88,50,38
False,8426117,Tannheim,18 - 20 Jahre,62,39,23
False,8426117,Tannheim,20 - 25 Jahre,125,56,69
False,8426117,Tannheim,25 - 30 Jahre,155,69,86
False,8426117,Tannheim,30 - 35 Jahre,202,106,96
False,8426117,Tannheim,35 - 40 Jahre,185,102,83
False,8426117,Tannheim,40 - 45 Jahre,185,95,90
False,8426117,Tannheim,45 - 50 Jahre,171,90,81
False,8426117,Tannheim,50 - 55 Jahre,108,58,50
False,8426117,Tannheim,55 - 60 Jahre,118,57,61
False,8426117,Tannheim,60 - 65 Jahre,140,66,74
False,8426117,Tannheim,65 - 75 Jahre,219,94,125
False,8426117,Tannheim,75 und mehr Jahre,100,41,59
False,8426117,Tannheim,Insgesamt,2292,1144,1148
False,8426118,Tiefenbach,unter 3 Jahre,22,9,13
False,8426118,Tiefenbach,3 -  6 Jahre,26,14,12
False,8426118,Tiefenbach,6 - 10 Jahre,20,7,13
False,8426118,Tiefenbach,10 - 15 Jahre,27,13,14
False,8426118,Tiefenbach,15 - 18 Jahre,23,9,14
False,8426118,Tiefenbach,18 - 20 Jahre,10,6,4
False,8426118,Tiefenbach,20 - 25 Jahre,23,14,9
False,8426118,Tiefenbach,25 - 30 Jahre,42,19,23
False,8426118,Tiefenbach,30 - 35 Jahre,54,31,23
False,8426118,Tiefenbach,35 - 40 Jahre,30,16,14
False,8426118,Tiefenbach,40 - 45 Jahre,28,14,14
False,8426118,Tiefenbach,45 - 50 Jahre,24,14,10
False,8426118,Tiefenbach,50 - 55 Jahre,16,9,7
False,8426118,Tiefenbach,55 - 60 Jahre,29,10,19
False,8426118,Tiefenbach,60 - 65 Jahre,35,20,15
False,8426118,Tiefenbach,65 - 75 Jahre,47,23,24
False,8426118,Tiefenbach,75 und mehr Jahre,20,8,12
False,8426118,Tiefenbach,Insgesamt,476,236,240
False,8426120,Ummendorf,unter 3 Jahre,154,72,82
False,8426120,Ummendorf,3 -  6 Jahre,176,89,87
False,8426120,Ummendorf,6 - 10 Jahre,201,104,97
False,8426120,Ummendorf,10 - 15 Jahre,278,126,152
False,8426120,Ummendorf,15 - 18 Jahre,135,59,76
False,8426120,Ummendorf,18 - 20 Jahre,100,52,48
False,8426120,Ummendorf,20 - 25 Jahre,245,129,116
False,8426120,Ummendorf,25 - 30 Jahre,264,146,118
False,8426120,Ummendorf,30 - 35 Jahre,377,195,182
False,8426120,Ummendorf,35 - 40 Jahre,357,189,168
False,8426120,Ummendorf,40 - 45 Jahre,303,164,139
False,8426120,Ummendorf,45 - 50 Jahre,251,124,127
False,8426120,Ummendorf,50 - 55 Jahre,261,127,134
False,8426120,Ummendorf,55 - 60 Jahre,207,111,96
False,8426120,Ummendorf,60 - 65 Jahre,282,135,147
False,8426120,Ummendorf,65 - 75 Jahre,308,147,161
False,8426120,Ummendorf,75 und mehr Jahre,215,69,146
False,8426120,Ummendorf,Insgesamt,4114,2038,2076
False,8426121,Unlingen,unter 3 Jahre,107,54,53
False,8426121,Unlingen,3 -  6 Jahre,110,46,64
False,8426121,Unlingen,6 - 10 Jahre,145,79,66
False,8426121,Unlingen,10 - 15 Jahre,180,108,72
False,8426121,Unlingen,15 - 18 Jahre,87,56,31
False,8426121,Unlingen,18 - 20 Jahre,54,23,31
False,8426121,Unlingen,20 - 25 Jahre,152,90,62
False,8426121,Unlingen,25 - 30 Jahre,166,84,82
False,8426121,Unlingen,30 - 35 Jahre,203,97,106
False,8426121,Unlingen,35 - 40 Jahre,219,113,106
False,8426121,Unlingen,40 - 45 Jahre,180,94,86
False,8426121,Unlingen,45 - 50 Jahre,148,82,66
False,8426121,Unlingen,50 - 55 Jahre,124,63,61
False,8426121,Unlingen,55 - 60 Jahre,117,58,59
False,8426121,Unlingen,60 - 65 Jahre,156,93,63
False,8426121,Unlingen,65 - 75 Jahre,177,84,93
False,8426121,Unlingen,75 und mehr Jahre,127,38,89
False,8426121,Unlingen,Insgesamt,2452,1262,1190
False,8426124,Uttenweiler,unter 3 Jahre,141,73,68
False,8426124,Uttenweiler,3 -  6 Jahre,152,71,81
False,8426124,Uttenweiler,6 - 10 Jahre,189,107,82
False,8426124,Uttenweiler,10 - 15 Jahre,304,160,144
False,8426124,Uttenweiler,15 - 18 Jahre,161,89,72
False,8426124,Uttenweiler,18 - 20 Jahre,101,47,54
False,8426124,Uttenweiler,20 - 25 Jahre,206,108,98
False,8426124,Uttenweiler,25 - 30 Jahre,219,106,113
False,8426124,Uttenweiler,30 - 35 Jahre,269,155,114
False,8426124,Uttenweiler,35 - 40 Jahre,302,161,141
False,8426124,Uttenweiler,40 - 45 Jahre,318,157,161
False,8426124,Uttenweiler,45 - 50 Jahre,250,137,113
False,8426124,Uttenweiler,50 - 55 Jahre,175,85,90
False,8426124,Uttenweiler,55 - 60 Jahre,133,75,58
False,8426124,Uttenweiler,60 - 65 Jahre,166,84,82
False,8426124,Uttenweiler,65 - 75 Jahre,272,115,157
False,8426124,Uttenweiler,75 und mehr Jahre,215,73,142
False,8426124,Uttenweiler,Insgesamt,3573,1803,1770
False,8426125,Wain,unter 3 Jahre,43,22,21
False,8426125,Wain,3 -  6 Jahre,66,37,29
False,8426125,Wain,6 - 10 Jahre,80,43,37
False,8426125,Wain,10 - 15 Jahre,112,64,48
False,8426125,Wain,15 - 18 Jahre,78,48,30
False,8426125,Wain,18 - 20 Jahre,42,20,22
False,8426125,Wain,20 - 25 Jahre,90,53,37
False,8426125,Wain,25 - 30 Jahre,81,42,39
False,8426125,Wain,30 - 35 Jahre,105,55,50
False,8426125,Wain,35 - 40 Jahre,116,63,53
False,8426125,Wain,40 - 45 Jahre,104,50,54
False,8426125,Wain,45 - 50 Jahre,106,52,54
False,8426125,Wain,50 - 55 Jahre,104,55,49
False,8426125,Wain,55 - 60 Jahre,73,51,22
False,8426125,Wain,60 - 65 Jahre,81,35,46
False,8426125,Wain,65 - 75 Jahre,107,52,55
False,8426125,Wain,75 und mehr Jahre,114,26,88
False,8426125,Wain,Insgesamt,1502,768,734
False,8426128,Warthausen,unter 3 Jahre,164,85,79
False,8426128,Warthausen,3 -  6 Jahre,153,79,74
False,8426128,Warthausen,6 - 10 Jahre,224,122,102
False,8426128,Warthausen,10 - 15 Jahre,313,157,156
False,8426128,Warthausen,15 - 18 Jahre,156,73,83
False,8426128,Warthausen,18 - 20 Jahre,97,55,42
False,8426128,Warthausen,20 - 25 Jahre,233,123,110
False,8426128,Warthausen,25 - 30 Jahre,258,145,113
False,8426128,Warthausen,30 - 35 Jahre,374,207,167
False,8426128,Warthausen,35 - 40 Jahre,396,186,210
False,8426128,Warthausen,40 - 45 Jahre,354,177,177
False,8426128,Warthausen,45 - 50 Jahre,312,151,161
False,8426128,Warthausen,50 - 55 Jahre,282,153,129
False,8426128,Warthausen,55 - 60 Jahre,290,136,154
False,8426128,Warthausen,60 - 65 Jahre,305,157,148
False,8426128,Warthausen,65 - 75 Jahre,386,177,209
False,8426128,Warthausen,75 und mehr Jahre,252,97,155
False,8426128,Warthausen,Insgesamt,4549,2280,2269
False,8426134,Schemmerhofen,unter 3 Jahre,271,135,136
False,8426134,Schemmerhofen,3 -  6 Jahre,293,142,151
False,8426134,Schemmerhofen,6 - 10 Jahre,447,217,230
False,8426134,Schemmerhofen,10 - 15 Jahre,519,276,243
False,8426134,Schemmerhofen,15 - 18 Jahre,272,141,131
False,8426134,Schemmerhofen,18 - 20 Jahre,181,94,87
False,8426134,Schemmerhofen,20 - 25 Jahre,397,200,197
False,8426134,Schemmerhofen,25 - 30 Jahre,460,229,231
False,8426134,Schemmerhofen,30 - 35 Jahre,659,311,348
False,8426134,Schemmerhofen,35 - 40 Jahre,675,345,330
False,8426134,Schemmerhofen,40 - 45 Jahre,571,308,263
False,8426134,Schemmerhofen,45 - 50 Jahre,457,237,220
False,8426134,Schemmerhofen,50 - 55 Jahre,385,200,185
False,8426134,Schemmerhofen,55 - 60 Jahre,344,177,167
False,8426134,Schemmerhofen,60 - 65 Jahre,404,203,201
False,8426134,Schemmerhofen,65 - 75 Jahre,548,268,280
False,8426134,Schemmerhofen,75 und mehr Jahre,346,114,232
False,8426134,Schemmerhofen,Insgesamt,7229,3597,3632
False,8426135,Gutenzell-Hürbel,unter 3 Jahre,69,32,37
False,8426135,Gutenzell-Hürbel,3 -  6 Jahre,81,43,38
False,8426135,Gutenzell-Hürbel,6 - 10 Jahre,123,63,60
False,8426135,Gutenzell-Hürbel,10 - 15 Jahre,131,63,68
False,8426135,Gutenzell-Hürbel,15 - 18 Jahre,86,50,36
False,8426135,Gutenzell-Hürbel,18 - 20 Jahre,54,31,23
False,8426135,Gutenzell-Hürbel,20 - 25 Jahre,100,67,33
False,8426135,Gutenzell-Hürbel,25 - 30 Jahre,111,52,59
False,8426135,Gutenzell-Hürbel,30 - 35 Jahre,155,86,69
False,8426135,Gutenzell-Hürbel,35 - 40 Jahre,172,88,84
False,8426135,Gutenzell-Hürbel,40 - 45 Jahre,145,74,71
False,8426135,Gutenzell-Hürbel,45 - 50 Jahre,131,71,60
False,8426135,Gutenzell-Hürbel,50 - 55 Jahre,96,51,45
False,8426135,Gutenzell-Hürbel,55 - 60 Jahre,68,40,28
False,8426135,Gutenzell-Hürbel,60 - 65 Jahre,98,49,49
False,8426135,Gutenzell-Hürbel,65 - 75 Jahre,105,53,52
False,8426135,Gutenzell-Hürbel,75 und mehr Jahre,115,35,80
False,8426135,Gutenzell-Hürbel,Insgesamt,1840,948,892
False,8435,Landkreis Bodenseekreis,unter 3 Jahre,6184,3198,2986
False,8435,Landkreis Bodenseekreis,3 -  6 Jahre,6660,3423,3237
False,8435,Landkreis Bodenseekreis,6 - 10 Jahre,9195,4783,4412
False,8435,Landkreis Bodenseekreis,10 - 15 Jahre,11965,6037,5928
False,8435,Landkreis Bodenseekreis,15 - 18 Jahre,6732,3458,3274
False,8435,Landkreis Bodenseekreis,18 - 20 Jahre,4806,2376,2430
False,8435,Landkreis Bodenseekreis,20 - 25 Jahre,10444,5296,5148
False,8435,Landkreis Bodenseekreis,25 - 30 Jahre,11556,5946,5610
False,8435,Landkreis Bodenseekreis,30 - 35 Jahre,16147,8214,7933
False,8435,Landkreis Bodenseekreis,35 - 40 Jahre,16857,8571,8286
False,8435,Landkreis Bodenseekreis,40 - 45 Jahre,14992,7620,7372
False,8435,Landkreis Bodenseekreis,45 - 50 Jahre,13132,6461,6671
False,8435,Landkreis Bodenseekreis,50 - 55 Jahre,12458,6097,6361
False,8435,Landkreis Bodenseekreis,55 - 60 Jahre,12610,6325,6285
False,8435,Landkreis Bodenseekreis,60 - 65 Jahre,14024,6986,7038
False,8435,Landkreis Bodenseekreis,65 - 75 Jahre,16757,7963,8794
False,8435,Landkreis Bodenseekreis,75 und mehr Jahre,14662,4534,10128
False,8435,Landkreis Bodenseekreis,Insgesamt,199181,97288,101893
False,8435005,Bermatingen,unter 3 Jahre,118,58,60
False,8435005,Bermatingen,3 -  6 Jahre,162,73,89
False,8435005,Bermatingen,6 - 10 Jahre,210,103,107
False,8435005,Bermatingen,10 - 15 Jahre,229,118,111
False,8435005,Bermatingen,15 - 18 Jahre,118,59,59
False,8435005,Bermatingen,18 - 20 Jahre,78,37,41
False,8435005,Bermatingen,20 - 25 Jahre,176,87,89
False,8435005,Bermatingen,25 - 30 Jahre,212,106,106
False,8435005,Bermatingen,30 - 35 Jahre,319,145,174
False,8435005,Bermatingen,35 - 40 Jahre,354,169,185
False,8435005,Bermatingen,40 - 45 Jahre,320,164,156
False,8435005,Bermatingen,45 - 50 Jahre,257,132,125
False,8435005,Bermatingen,50 - 55 Jahre,236,134,102
False,8435005,Bermatingen,55 - 60 Jahre,225,112,113
False,8435005,Bermatingen,60 - 65 Jahre,246,133,113
False,8435005,Bermatingen,65 - 75 Jahre,297,140,157
False,8435005,Bermatingen,75 und mehr Jahre,169,62,107
False,8435005,Bermatingen,Insgesamt,3726,1832,1894
False,8435010,Daisendorf,unter 3 Jahre,38,20,18
False,8435010,Daisendorf,3 -  6 Jahre,32,18,14
False,8435010,Daisendorf,6 - 10 Jahre,64,29,35
False,8435010,Daisendorf,10 - 15 Jahre,65,29,36
False,8435010,Daisendorf,15 - 18 Jahre,34,26,8
False,8435010,Daisendorf,18 - 20 Jahre,40,16,24
False,8435010,Daisendorf,20 - 25 Jahre,61,27,34
False,8435010,Daisendorf,25 - 30 Jahre,55,37,18
False,8435010,Daisendorf,30 - 35 Jahre,116,48,68
False,8435010,Daisendorf,35 - 40 Jahre,120,57,63
False,8435010,Daisendorf,40 - 45 Jahre,110,49,61
False,8435010,Daisendorf,45 - 50 Jahre,90,53,37
False,8435010,Daisendorf,50 - 55 Jahre,101,51,50
False,8435010,Daisendorf,55 - 60 Jahre,119,59,60
False,8435010,Daisendorf,60 - 65 Jahre,120,64,56
False,8435010,Daisendorf,65 - 75 Jahre,117,59,58
False,8435010,Daisendorf,75 und mehr Jahre,110,38,72
False,8435010,Daisendorf,Insgesamt,1392,680,712
False,8435013,Eriskirch,unter 3 Jahre,145,79,66
False,8435013,Eriskirch,3 -  6 Jahre,149,74,75
False,8435013,Eriskirch,6 - 10 Jahre,216,113,103
False,8435013,Eriskirch,10 - 15 Jahre,285,154,131
False,8435013,Eriskirch,15 - 18 Jahre,123,63,60
False,8435013,Eriskirch,18 - 20 Jahre,95,45,50
False,8435013,Eriskirch,20 - 25 Jahre,202,88,114
False,8435013,Eriskirch,25 - 30 Jahre,249,129,120
False,8435013,Eriskirch,30 - 35 Jahre,384,209,175
False,8435013,Eriskirch,35 - 40 Jahre,436,228,208
False,8435013,Eriskirch,40 - 45 Jahre,357,185,172
False,8435013,Eriskirch,45 - 50 Jahre,314,158,156
False,8435013,Eriskirch,50 - 55 Jahre,310,149,161
False,8435013,Eriskirch,55 - 60 Jahre,255,128,127
False,8435013,Eriskirch,60 - 65 Jahre,269,139,130
False,8435013,Eriskirch,65 - 75 Jahre,320,159,161
False,8435013,Eriskirch,75 und mehr Jahre,243,83,160
False,8435013,Eriskirch,Insgesamt,4352,2183,2169
False,8435015,Frickingen,unter 3 Jahre,104,50,54
False,8435015,Frickingen,3 -  6 Jahre,113,57,56
False,8435015,Frickingen,6 - 10 Jahre,161,85,76
False,8435015,Frickingen,10 - 15 Jahre,193,92,101
False,8435015,Frickingen,15 - 18 Jahre,101,47,54
False,8435015,Frickingen,18 - 20 Jahre,69,40,29
False,8435015,Frickingen,20 - 25 Jahre,128,72,56
False,8435015,Frickingen,25 - 30 Jahre,128,67,61
False,8435015,Frickingen,30 - 35 Jahre,171,72,99
False,8435015,Frickingen,35 - 40 Jahre,208,108,100
False,8435015,Frickingen,40 - 45 Jahre,191,105,86
False,8435015,Frickingen,45 - 50 Jahre,175,96,79
False,8435015,Frickingen,50 - 55 Jahre,157,79,78
False,8435015,Frickingen,55 - 60 Jahre,159,87,72
False,8435015,Frickingen,60 - 65 Jahre,150,71,79
False,8435015,Frickingen,65 - 75 Jahre,228,119,109
False,8435015,Frickingen,75 und mehr Jahre,152,45,107
False,8435015,Frickingen,Insgesamt,2588,1292,1296
False,8435016,"Friedrichshafen, Stadt",unter 3 Jahre,1641,849,792
False,8435016,"Friedrichshafen, Stadt",3 -  6 Jahre,1765,917,848
False,8435016,"Friedrichshafen, Stadt",6 - 10 Jahre,2373,1223,1150
False,8435016,"Friedrichshafen, Stadt",10 - 15 Jahre,3265,1633,1632
False,8435016,"Friedrichshafen, Stadt",15 - 18 Jahre,1846,932,914
False,8435016,"Friedrichshafen, Stadt",18 - 20 Jahre,1396,666,730
False,8435016,"Friedrichshafen, Stadt",20 - 25 Jahre,3207,1647,1560
False,8435016,"Friedrichshafen, Stadt",25 - 30 Jahre,3519,1832,1687
False,8435016,"Friedrichshafen, Stadt",30 - 35 Jahre,4547,2376,2171
False,8435016,"Friedrichshafen, Stadt",35 - 40 Jahre,4587,2431,2156
False,8435016,"Friedrichshafen, Stadt",40 - 45 Jahre,4067,2059,2008
False,8435016,"Friedrichshafen, Stadt",45 - 50 Jahre,3706,1763,1943
False,8435016,"Friedrichshafen, Stadt",50 - 55 Jahre,3656,1847,1809
False,8435016,"Friedrichshafen, Stadt",55 - 60 Jahre,3801,1865,1936
False,8435016,"Friedrichshafen, Stadt",60 - 65 Jahre,4266,2141,2125
False,8435016,"Friedrichshafen, Stadt",65 - 75 Jahre,5118,2393,2725
False,8435016,"Friedrichshafen, Stadt",75 und mehr Jahre,4403,1409,2994
False,8435016,"Friedrichshafen, Stadt",Insgesamt,57163,27983,29180
False,8435018,Hagnau am Bodensee,unter 3 Jahre,38,19,19
False,8435018,Hagnau am Bodensee,3 -  6 Jahre,48,25,23
False,8435018,Hagnau am Bodensee,6 - 10 Jahre,63,33,30
False,8435018,Hagnau am Bodensee,10 - 15 Jahre,57,27,30
False,8435018,Hagnau am Bodensee,15 - 18 Jahre,49,24,25
False,8435018,Hagnau am Bodensee,18 - 20 Jahre,36,16,20
False,8435018,Hagnau am Bodensee,20 - 25 Jahre,54,28,26
False,8435018,Hagnau am Bodensee,25 - 30 Jahre,76,37,39
False,8435018,Hagnau am Bodensee,30 - 35 Jahre,90,42,48
False,8435018,Hagnau am Bodensee,35 - 40 Jahre,95,44,51
False,8435018,Hagnau am Bodensee,40 - 45 Jahre,101,52,49
False,8435018,Hagnau am Bodensee,45 - 50 Jahre,99,48,51
False,8435018,Hagnau am Bodensee,50 - 55 Jahre,97,44,53
False,8435018,Hagnau am Bodensee,55 - 60 Jahre,79,44,35
False,8435018,Hagnau am Bodensee,60 - 65 Jahre,113,51,62
False,8435018,Hagnau am Bodensee,65 - 75 Jahre,136,64,72
False,8435018,Hagnau am Bodensee,75 und mehr Jahre,134,48,86
False,8435018,Hagnau am Bodensee,Insgesamt,1365,646,719
False,8435020,Heiligenberg,unter 3 Jahre,92,43,49
False,8435020,Heiligenberg,3 -  6 Jahre,99,63,36
False,8435020,Heiligenberg,6 - 10 Jahre,166,95,71
False,8435020,Heiligenberg,10 - 15 Jahre,214,105,109
False,8435020,Heiligenberg,15 - 18 Jahre,127,65,62
False,8435020,Heiligenberg,18 - 20 Jahre,82,44,38
False,8435020,Heiligenberg,20 - 25 Jahre,196,96,100
False,8435020,Heiligenberg,25 - 30 Jahre,137,76,61
False,8435020,Heiligenberg,30 - 35 Jahre,201,116,85
False,8435020,Heiligenberg,35 - 40 Jahre,261,123,138
False,8435020,Heiligenberg,40 - 45 Jahre,241,128,113
False,8435020,Heiligenberg,45 - 50 Jahre,218,124,94
False,8435020,Heiligenberg,50 - 55 Jahre,133,57,76
False,8435020,Heiligenberg,55 - 60 Jahre,117,56,61
False,8435020,Heiligenberg,60 - 65 Jahre,144,60,84
False,8435020,Heiligenberg,65 - 75 Jahre,264,134,130
False,8435020,Heiligenberg,75 und mehr Jahre,235,62,173
False,8435020,Heiligenberg,Insgesamt,2927,1447,1480
False,8435024,Immenstaad am Bodensee,unter 3 Jahre,177,86,91
False,8435024,Immenstaad am Bodensee,3 -  6 Jahre,159,64,95
False,8435024,Immenstaad am Bodensee,6 - 10 Jahre,211,112,99
False,8435024,Immenstaad am Bodensee,10 - 15 Jahre,285,139,146
False,8435024,Immenstaad am Bodensee,15 - 18 Jahre,189,104,85
False,8435024,Immenstaad am Bodensee,18 - 20 Jahre,116,52,64
False,8435024,Immenstaad am Bodensee,20 - 25 Jahre,276,129,147
False,8435024,Immenstaad am Bodensee,25 - 30 Jahre,293,143,150
False,8435024,Immenstaad am Bodensee,30 - 35 Jahre,407,216,191
False,8435024,Immenstaad am Bodensee,35 - 40 Jahre,460,241,219
False,8435024,Immenstaad am Bodensee,40 - 45 Jahre,478,250,228
False,8435024,Immenstaad am Bodensee,45 - 50 Jahre,422,199,223
False,8435024,Immenstaad am Bodensee,50 - 55 Jahre,421,202,219
False,8435024,Immenstaad am Bodensee,55 - 60 Jahre,481,244,237
False,8435024,Immenstaad am Bodensee,60 - 65 Jahre,478,244,234
False,8435024,Immenstaad am Bodensee,65 - 75 Jahre,469,244,225
False,8435024,Immenstaad am Bodensee,75 und mehr Jahre,353,97,256
False,8435024,Immenstaad am Bodensee,Insgesamt,5675,2766,2909
False,8435029,Kressbronn am Bodensee,unter 3 Jahre,250,133,117
False,8435029,Kressbronn am Bodensee,3 -  6 Jahre,270,136,134
False,8435029,Kressbronn am Bodensee,6 - 10 Jahre,336,174,162
False,8435029,Kressbronn am Bodensee,10 - 15 Jahre,445,228,217
False,8435029,Kressbronn am Bodensee,15 - 18 Jahre,214,108,106
False,8435029,Kressbronn am Bodensee,18 - 20 Jahre,185,96,89
False,8435029,Kressbronn am Bodensee,20 - 25 Jahre,349,200,149
False,8435029,Kressbronn am Bodensee,25 - 30 Jahre,438,206,232
False,8435029,Kressbronn am Bodensee,30 - 35 Jahre,512,272,240
False,8435029,Kressbronn am Bodensee,35 - 40 Jahre,605,305,300
False,8435029,Kressbronn am Bodensee,40 - 45 Jahre,506,265,241
False,8435029,Kressbronn am Bodensee,45 - 50 Jahre,457,229,228
False,8435029,Kressbronn am Bodensee,50 - 55 Jahre,479,222,257
False,8435029,Kressbronn am Bodensee,55 - 60 Jahre,501,242,259
False,8435029,Kressbronn am Bodensee,60 - 65 Jahre,538,263,275
False,8435029,Kressbronn am Bodensee,65 - 75 Jahre,644,293,351
False,8435029,Kressbronn am Bodensee,75 und mehr Jahre,633,186,447
False,8435029,Kressbronn am Bodensee,Insgesamt,7362,3558,3804
False,8435030,Langenargen,unter 3 Jahre,216,112,104
False,8435030,Langenargen,3 -  6 Jahre,240,118,122
False,8435030,Langenargen,6 - 10 Jahre,274,151,123
False,8435030,Langenargen,10 - 15 Jahre,351,177,174
False,8435030,Langenargen,15 - 18 Jahre,202,105,97
False,8435030,Langenargen,18 - 20 Jahre,137,80,57
False,8435030,Langenargen,20 - 25 Jahre,283,148,135
False,8435030,Langenargen,25 - 30 Jahre,388,190,198
False,8435030,Langenargen,30 - 35 Jahre,603,302,301
False,8435030,Langenargen,35 - 40 Jahre,588,287,301
False,8435030,Langenargen,40 - 45 Jahre,513,261,252
False,8435030,Langenargen,45 - 50 Jahre,471,239,232
False,8435030,Langenargen,50 - 55 Jahre,491,235,256
False,8435030,Langenargen,55 - 60 Jahre,490,245,245
False,8435030,Langenargen,60 - 65 Jahre,585,281,304
False,8435030,Langenargen,65 - 75 Jahre,702,323,379
False,8435030,Langenargen,75 und mehr Jahre,616,190,426
False,8435030,Langenargen,Insgesamt,7150,3444,3706
False,8435034,"Markdorf, Stadt",unter 3 Jahre,380,202,178
False,8435034,"Markdorf, Stadt",3 -  6 Jahre,392,183,209
False,8435034,"Markdorf, Stadt",6 - 10 Jahre,561,278,283
False,8435034,"Markdorf, Stadt",10 - 15 Jahre,715,329,386
False,8435034,"Markdorf, Stadt",15 - 18 Jahre,401,199,202
False,8435034,"Markdorf, Stadt",18 - 20 Jahre,273,149,124
False,8435034,"Markdorf, Stadt",20 - 25 Jahre,721,355,366
False,8435034,"Markdorf, Stadt",25 - 30 Jahre,777,426,351
False,8435034,"Markdorf, Stadt",30 - 35 Jahre,1029,525,504
False,8435034,"Markdorf, Stadt",35 - 40 Jahre,971,490,481
False,8435034,"Markdorf, Stadt",40 - 45 Jahre,913,467,446
False,8435034,"Markdorf, Stadt",45 - 50 Jahre,757,342,415
False,8435034,"Markdorf, Stadt",50 - 55 Jahre,784,376,408
False,8435034,"Markdorf, Stadt",55 - 60 Jahre,833,409,424
False,8435034,"Markdorf, Stadt",60 - 65 Jahre,977,501,476
False,8435034,"Markdorf, Stadt",65 - 75 Jahre,950,472,478
False,8435034,"Markdorf, Stadt",75 und mehr Jahre,718,199,519
False,8435034,"Markdorf, Stadt",Insgesamt,12152,5902,6250
False,8435035,Meckenbeuren,unter 3 Jahre,458,229,229
False,8435035,Meckenbeuren,3 -  6 Jahre,467,253,214
False,8435035,Meckenbeuren,6 - 10 Jahre,596,311,285
False,8435035,Meckenbeuren,10 - 15 Jahre,753,398,355
False,8435035,Meckenbeuren,15 - 18 Jahre,421,205,216
False,8435035,Meckenbeuren,18 - 20 Jahre,306,165,141
False,8435035,Meckenbeuren,20 - 25 Jahre,719,372,347
False,8435035,Meckenbeuren,25 - 30 Jahre,821,426,395
False,8435035,Meckenbeuren,30 - 35 Jahre,1246,669,577
False,8435035,Meckenbeuren,35 - 40 Jahre,1218,606,612
False,8435035,Meckenbeuren,40 - 45 Jahre,992,504,488
False,8435035,Meckenbeuren,45 - 50 Jahre,898,468,430
False,8435035,Meckenbeuren,50 - 55 Jahre,751,377,374
False,8435035,Meckenbeuren,55 - 60 Jahre,704,359,345
False,8435035,Meckenbeuren,60 - 65 Jahre,794,398,396
False,8435035,Meckenbeuren,65 - 75 Jahre,919,437,482
False,8435035,Meckenbeuren,75 und mehr Jahre,721,221,500
False,8435035,Meckenbeuren,Insgesamt,12784,6398,6386
False,8435036,"Meersburg, Stadt",unter 3 Jahre,156,78,78
False,8435036,"Meersburg, Stadt",3 -  6 Jahre,160,82,78
False,8435036,"Meersburg, Stadt",6 - 10 Jahre,211,101,110
False,8435036,"Meersburg, Stadt",10 - 15 Jahre,270,145,125
False,8435036,"Meersburg, Stadt",15 - 18 Jahre,122,56,66
False,8435036,"Meersburg, Stadt",18 - 20 Jahre,106,46,60
False,8435036,"Meersburg, Stadt",20 - 25 Jahre,270,119,151
False,8435036,"Meersburg, Stadt",25 - 30 Jahre,358,178,180
False,8435036,"Meersburg, Stadt",30 - 35 Jahre,557,282,275
False,8435036,"Meersburg, Stadt",35 - 40 Jahre,461,234,227
False,8435036,"Meersburg, Stadt",40 - 45 Jahre,383,207,176
False,8435036,"Meersburg, Stadt",45 - 50 Jahre,313,155,158
False,8435036,"Meersburg, Stadt",50 - 55 Jahre,362,161,201
False,8435036,"Meersburg, Stadt",55 - 60 Jahre,366,178,188
False,8435036,"Meersburg, Stadt",60 - 65 Jahre,422,196,226
False,8435036,"Meersburg, Stadt",65 - 75 Jahre,463,216,247
False,8435036,"Meersburg, Stadt",75 und mehr Jahre,466,129,337
False,8435036,"Meersburg, Stadt",Insgesamt,5446,2563,2883
False,8435042,Neukirch,unter 3 Jahre,118,69,49
False,8435042,Neukirch,3 -  6 Jahre,113,60,53
False,8435042,Neukirch,6 - 10 Jahre,143,79,64
False,8435042,Neukirch,10 - 15 Jahre,196,106,90
False,8435042,Neukirch,15 - 18 Jahre,83,40,43
False,8435042,Neukirch,18 - 20 Jahre,75,33,42
False,8435042,Neukirch,20 - 25 Jahre,141,73,68
False,8435042,Neukirch,25 - 30 Jahre,161,81,80
False,8435042,Neukirch,30 - 35 Jahre,238,119,119
False,8435042,Neukirch,35 - 40 Jahre,264,134,130
False,8435042,Neukirch,40 - 45 Jahre,211,110,101
False,8435042,Neukirch,45 - 50 Jahre,165,92,73
False,8435042,Neukirch,50 - 55 Jahre,134,69,65
False,8435042,Neukirch,55 - 60 Jahre,108,65,43
False,8435042,Neukirch,60 - 65 Jahre,130,70,60
False,8435042,Neukirch,65 - 75 Jahre,152,75,77
False,8435042,Neukirch,75 und mehr Jahre,140,41,99
False,8435042,Neukirch,Insgesamt,2572,1316,1256
False,8435045,Oberteuringen,unter 3 Jahre,155,73,82
False,8435045,Oberteuringen,3 -  6 Jahre,159,79,80
False,8435045,Oberteuringen,6 - 10 Jahre,229,121,108
False,8435045,Oberteuringen,10 - 15 Jahre,296,141,155
False,8435045,Oberteuringen,15 - 18 Jahre,153,80,73
False,8435045,Oberteuringen,18 - 20 Jahre,89,47,42
False,8435045,Oberteuringen,20 - 25 Jahre,183,90,93
False,8435045,Oberteuringen,25 - 30 Jahre,210,103,107
False,8435045,Oberteuringen,30 - 35 Jahre,362,181,181
False,8435045,Oberteuringen,35 - 40 Jahre,390,203,187
False,8435045,Oberteuringen,40 - 45 Jahre,348,167,181
False,8435045,Oberteuringen,45 - 50 Jahre,285,155,130
False,8435045,Oberteuringen,50 - 55 Jahre,236,122,114
False,8435045,Oberteuringen,55 - 60 Jahre,238,126,112
False,8435045,Oberteuringen,60 - 65 Jahre,234,116,118
False,8435045,Oberteuringen,65 - 75 Jahre,277,145,132
False,8435045,Oberteuringen,75 und mehr Jahre,198,66,132
False,8435045,Oberteuringen,Insgesamt,4042,2015,2027
False,8435047,Owingen,unter 3 Jahre,155,73,82
False,8435047,Owingen,3 -  6 Jahre,158,83,75
False,8435047,Owingen,6 - 10 Jahre,220,127,93
False,8435047,Owingen,10 - 15 Jahre,330,158,172
False,8435047,Owingen,15 - 18 Jahre,139,67,72
False,8435047,Owingen,18 - 20 Jahre,112,52,60
False,8435047,Owingen,20 - 25 Jahre,197,106,91
False,8435047,Owingen,25 - 30 Jahre,247,102,145
False,8435047,Owingen,30 - 35 Jahre,344,166,178
False,8435047,Owingen,35 - 40 Jahre,351,180,171
False,8435047,Owingen,40 - 45 Jahre,352,190,162
False,8435047,Owingen,45 - 50 Jahre,300,151,149
False,8435047,Owingen,50 - 55 Jahre,250,133,117
False,8435047,Owingen,55 - 60 Jahre,199,110,89
False,8435047,Owingen,60 - 65 Jahre,243,121,122
False,8435047,Owingen,65 - 75 Jahre,321,178,143
False,8435047,Owingen,75 und mehr Jahre,187,61,126
False,8435047,Owingen,Insgesamt,4105,2058,2047
False,8435052,Salem,unter 3 Jahre,349,184,165
False,8435052,Salem,3 -  6 Jahre,419,218,201
False,8435052,Salem,6 - 10 Jahre,632,324,308
False,8435052,Salem,10 - 15 Jahre,864,441,423
False,8435052,Salem,15 - 18 Jahre,632,338,294
False,8435052,Salem,18 - 20 Jahre,279,144,135
False,8435052,Salem,20 - 25 Jahre,623,313,310
False,8435052,Salem,25 - 30 Jahre,616,348,268
False,8435052,Salem,30 - 35 Jahre,772,393,379
False,8435052,Salem,35 - 40 Jahre,937,443,494
False,8435052,Salem,40 - 45 Jahre,877,425,452
False,8435052,Salem,45 - 50 Jahre,754,366,388
False,8435052,Salem,50 - 55 Jahre,640,324,316
False,8435052,Salem,55 - 60 Jahre,574,304,270
False,8435052,Salem,60 - 65 Jahre,595,304,291
False,8435052,Salem,65 - 75 Jahre,714,342,372
False,8435052,Salem,75 und mehr Jahre,724,229,495
False,8435052,Salem,Insgesamt,11001,5440,5561
False,8435053,Sipplingen,unter 3 Jahre,58,37,21
False,8435053,Sipplingen,3 -  6 Jahre,42,22,20
False,8435053,Sipplingen,6 - 10 Jahre,93,46,47
False,8435053,Sipplingen,10 - 15 Jahre,122,61,61
False,8435053,Sipplingen,15 - 18 Jahre,63,32,31
False,8435053,Sipplingen,18 - 20 Jahre,51,25,26
False,8435053,Sipplingen,20 - 25 Jahre,102,55,47
False,8435053,Sipplingen,25 - 30 Jahre,109,57,52
False,8435053,Sipplingen,30 - 35 Jahre,160,83,77
False,8435053,Sipplingen,35 - 40 Jahre,194,102,92
False,8435053,Sipplingen,40 - 45 Jahre,163,84,79
False,8435053,Sipplingen,45 - 50 Jahre,142,72,70
False,8435053,Sipplingen,50 - 55 Jahre,136,64,72
False,8435053,Sipplingen,55 - 60 Jahre,132,72,60
False,8435053,Sipplingen,60 - 65 Jahre,169,86,83
False,8435053,Sipplingen,65 - 75 Jahre,243,119,124
False,8435053,Sipplingen,75 und mehr Jahre,213,72,141
False,8435053,Sipplingen,Insgesamt,2192,1089,1103
False,8435054,Stetten,unter 3 Jahre,19,7,12
False,8435054,Stetten,3 -  6 Jahre,26,11,15
False,8435054,Stetten,6 - 10 Jahre,36,16,20
False,8435054,Stetten,10 - 15 Jahre,65,34,31
False,8435054,Stetten,15 - 18 Jahre,35,24,11
False,8435054,Stetten,18 - 20 Jahre,12,5,7
False,8435054,Stetten,20 - 25 Jahre,46,23,23
False,8435054,Stetten,25 - 30 Jahre,45,23,22
False,8435054,Stetten,30 - 35 Jahre,59,21,38
False,8435054,Stetten,35 - 40 Jahre,94,44,50
False,8435054,Stetten,40 - 45 Jahre,80,40,40
False,8435054,Stetten,45 - 50 Jahre,79,35,44
False,8435054,Stetten,50 - 55 Jahre,47,25,22
False,8435054,Stetten,55 - 60 Jahre,66,30,36
False,8435054,Stetten,60 - 65 Jahre,84,42,42
False,8435054,Stetten,65 - 75 Jahre,74,39,35
False,8435054,Stetten,75 und mehr Jahre,90,23,67
False,8435054,Stetten,Insgesamt,957,442,515
False,8435057,"Tettnang, Stadt",unter 3 Jahre,575,310,265
False,8435057,"Tettnang, Stadt",3 -  6 Jahre,667,347,320
False,8435057,"Tettnang, Stadt",6 - 10 Jahre,944,497,447
False,8435057,"Tettnang, Stadt",10 - 15 Jahre,1108,550,558
False,8435057,"Tettnang, Stadt",15 - 18 Jahre,583,306,277
False,8435057,"Tettnang, Stadt",18 - 20 Jahre,390,185,205
False,8435057,"Tettnang, Stadt",20 - 25 Jahre,907,475,432
False,8435057,"Tettnang, Stadt",25 - 30 Jahre,997,513,484
False,8435057,"Tettnang, Stadt",30 - 35 Jahre,1533,803,730
False,8435057,"Tettnang, Stadt",35 - 40 Jahre,1670,863,807
False,8435057,"Tettnang, Stadt",40 - 45 Jahre,1412,751,661
False,8435057,"Tettnang, Stadt",45 - 50 Jahre,1189,578,611
False,8435057,"Tettnang, Stadt",50 - 55 Jahre,1082,556,526
False,8435057,"Tettnang, Stadt",55 - 60 Jahre,1083,583,500
False,8435057,"Tettnang, Stadt",60 - 65 Jahre,1118,568,550
False,8435057,"Tettnang, Stadt",65 - 75 Jahre,1353,646,707
False,8435057,"Tettnang, Stadt",75 und mehr Jahre,1072,342,730
False,8435057,"Tettnang, Stadt",Insgesamt,17683,8873,8810
False,8435059,"Überlingen, Stadt",unter 3 Jahre,536,281,255
False,8435059,"Überlingen, Stadt",3 -  6 Jahre,575,305,270
False,8435059,"Überlingen, Stadt",6 - 10 Jahre,841,427,414
False,8435059,"Überlingen, Stadt",10 - 15 Jahre,1110,597,513
False,8435059,"Überlingen, Stadt",15 - 18 Jahre,705,369,336
False,8435059,"Überlingen, Stadt",18 - 20 Jahre,627,297,330
False,8435059,"Überlingen, Stadt",20 - 25 Jahre,1008,497,511
False,8435059,"Überlingen, Stadt",25 - 30 Jahre,1055,529,526
False,8435059,"Überlingen, Stadt",30 - 35 Jahre,1429,659,770
False,8435059,"Überlingen, Stadt",35 - 40 Jahre,1441,683,758
False,8435059,"Überlingen, Stadt",40 - 45 Jahre,1383,654,729
False,8435059,"Überlingen, Stadt",45 - 50 Jahre,1303,614,689
False,8435059,"Überlingen, Stadt",50 - 55 Jahre,1255,537,718
False,8435059,"Überlingen, Stadt",55 - 60 Jahre,1395,665,730
False,8435059,"Überlingen, Stadt",60 - 65 Jahre,1635,780,855
False,8435059,"Überlingen, Stadt",65 - 75 Jahre,2115,942,1173
False,8435059,"Überlingen, Stadt",75 und mehr Jahre,2378,694,1684
False,8435059,"Überlingen, Stadt",Insgesamt,20791,9530,11261
False,8435066,Uhldingen-Mühlhofen,unter 3 Jahre,262,142,120
False,8435066,Uhldingen-Mühlhofen,3 -  6 Jahre,299,157,142
False,8435066,Uhldingen-Mühlhofen,6 - 10 Jahre,388,216,172
False,8435066,Uhldingen-Mühlhofen,10 - 15 Jahre,459,229,230
False,8435066,Uhldingen-Mühlhofen,15 - 18 Jahre,253,140,113
False,8435066,Uhldingen-Mühlhofen,18 - 20 Jahre,188,103,85
False,8435066,Uhldingen-Mühlhofen,20 - 25 Jahre,376,192,184
False,8435066,Uhldingen-Mühlhofen,25 - 30 Jahre,420,203,217
False,8435066,Uhldingen-Mühlhofen,30 - 35 Jahre,670,322,348
False,8435066,Uhldingen-Mühlhofen,35 - 40 Jahre,745,383,362
False,8435066,Uhldingen-Mühlhofen,40 - 45 Jahre,650,315,335
False,8435066,Uhldingen-Mühlhofen,45 - 50 Jahre,495,268,227
False,8435066,Uhldingen-Mühlhofen,50 - 55 Jahre,496,230,266
False,8435066,Uhldingen-Mühlhofen,55 - 60 Jahre,501,257,244
False,8435066,Uhldingen-Mühlhofen,60 - 65 Jahre,477,238,239
False,8435066,Uhldingen-Mühlhofen,65 - 75 Jahre,573,268,305
False,8435066,Uhldingen-Mühlhofen,75 und mehr Jahre,496,173,323
False,8435066,Uhldingen-Mühlhofen,Insgesamt,7748,3836,3912
False,8435067,Deggenhausertal,unter 3 Jahre,144,64,80
False,8435067,Deggenhausertal,3 -  6 Jahre,146,78,68
False,8435067,Deggenhausertal,6 - 10 Jahre,227,122,105
False,8435067,Deggenhausertal,10 - 15 Jahre,288,146,142
False,8435067,Deggenhausertal,15 - 18 Jahre,139,69,70
False,8435067,Deggenhausertal,18 - 20 Jahre,64,33,31
False,8435067,Deggenhausertal,20 - 25 Jahre,219,104,115
False,8435067,Deggenhausertal,25 - 30 Jahre,245,134,111
False,8435067,Deggenhausertal,30 - 35 Jahre,398,193,205
False,8435067,Deggenhausertal,35 - 40 Jahre,407,213,194
False,8435067,Deggenhausertal,40 - 45 Jahre,344,188,156
False,8435067,Deggenhausertal,45 - 50 Jahre,243,124,119
False,8435067,Deggenhausertal,50 - 55 Jahre,204,103,101
False,8435067,Deggenhausertal,55 - 60 Jahre,184,85,99
False,8435067,Deggenhausertal,60 - 65 Jahre,237,119,118
False,8435067,Deggenhausertal,65 - 75 Jahre,308,156,152
False,8435067,Deggenhausertal,75 und mehr Jahre,211,64,147
False,8435067,Deggenhausertal,Insgesamt,4008,1995,2013
False,8436,Landkreis Ravensburg,unter 3 Jahre,9082,4594,4488
False,8436,Landkreis Ravensburg,3 -  6 Jahre,9683,4995,4688
False,8436,Landkreis Ravensburg,6 - 10 Jahre,13360,6951,6409
False,8436,Landkreis Ravensburg,10 - 15 Jahre,17541,9050,8491
False,8436,Landkreis Ravensburg,15 - 18 Jahre,9516,4905,4611
False,8436,Landkreis Ravensburg,18 - 20 Jahre,6539,3306,3233
False,8436,Landkreis Ravensburg,20 - 25 Jahre,15273,7673,7600
False,8436,Landkreis Ravensburg,25 - 30 Jahre,16851,8497,8354
False,8436,Landkreis Ravensburg,30 - 35 Jahre,22933,11627,11306
False,8436,Landkreis Ravensburg,35 - 40 Jahre,23419,11985,11434
False,8436,Landkreis Ravensburg,40 - 45 Jahre,20294,10195,10099
False,8436,Landkreis Ravensburg,45 - 50 Jahre,17345,8737,8608
False,8436,Landkreis Ravensburg,50 - 55 Jahre,15479,7936,7543
False,8436,Landkreis Ravensburg,55 - 60 Jahre,14486,7363,7123
False,8436,Landkreis Ravensburg,60 - 65 Jahre,16519,8276,8243
False,8436,Landkreis Ravensburg,65 - 75 Jahre,22028,10154,11874
False,8436,Landkreis Ravensburg,75 und mehr Jahre,18422,5698,12724
False,8436,Landkreis Ravensburg,Insgesamt,268770,131942,136828
False,8436001,Achberg,unter 3 Jahre,62,31,31
False,8436001,Achberg,3 -  6 Jahre,65,35,30
False,8436001,Achberg,6 - 10 Jahre,93,58,35
False,8436001,Achberg,10 - 15 Jahre,110,53,57
False,8436001,Achberg,15 - 18 Jahre,61,30,31
False,8436001,Achberg,18 - 20 Jahre,23,13,10
False,8436001,Achberg,20 - 25 Jahre,75,31,44
False,8436001,Achberg,25 - 30 Jahre,83,38,45
False,8436001,Achberg,30 - 35 Jahre,145,79,66
False,8436001,Achberg,35 - 40 Jahre,129,68,61
False,8436001,Achberg,40 - 45 Jahre,105,55,50
False,8436001,Achberg,45 - 50 Jahre,81,37,44
False,8436001,Achberg,50 - 55 Jahre,68,41,27
False,8436001,Achberg,55 - 60 Jahre,68,35,33
False,8436001,Achberg,60 - 65 Jahre,64,28,36
False,8436001,Achberg,65 - 75 Jahre,116,54,62
False,8436001,Achberg,75 und mehr Jahre,99,34,65
False,8436001,Achberg,Insgesamt,1447,720,727
False,8436003,Aichstetten,unter 3 Jahre,108,59,49
False,8436003,Aichstetten,3 -  6 Jahre,103,48,55
False,8436003,Aichstetten,6 - 10 Jahre,132,67,65
False,8436003,Aichstetten,10 - 15 Jahre,209,102,107
False,8436003,Aichstetten,15 - 18 Jahre,103,45,58
False,8436003,Aichstetten,18 - 20 Jahre,60,29,31
False,8436003,Aichstetten,20 - 25 Jahre,150,82,68
False,8436003,Aichstetten,25 - 30 Jahre,196,98,98
False,8436003,Aichstetten,30 - 35 Jahre,236,130,106
False,8436003,Aichstetten,35 - 40 Jahre,214,114,100
False,8436003,Aichstetten,40 - 45 Jahre,210,112,98
False,8436003,Aichstetten,45 - 50 Jahre,145,73,72
False,8436003,Aichstetten,50 - 55 Jahre,146,72,74
False,8436003,Aichstetten,55 - 60 Jahre,143,86,57
False,8436003,Aichstetten,60 - 65 Jahre,154,80,74
False,8436003,Aichstetten,65 - 75 Jahre,200,97,103
False,8436003,Aichstetten,75 und mehr Jahre,114,37,77
False,8436003,Aichstetten,Insgesamt,2623,1331,1292
False,8436004,Aitrach,unter 3 Jahre,98,61,37
False,8436004,Aitrach,3 -  6 Jahre,100,65,35
False,8436004,Aitrach,6 - 10 Jahre,132,70,62
False,8436004,Aitrach,10 - 15 Jahre,152,77,75
False,8436004,Aitrach,15 - 18 Jahre,88,51,37
False,8436004,Aitrach,18 - 20 Jahre,61,33,28
False,8436004,Aitrach,20 - 25 Jahre,154,72,82
False,8436004,Aitrach,25 - 30 Jahre,159,86,73
False,8436004,Aitrach,30 - 35 Jahre,218,119,99
False,8436004,Aitrach,35 - 40 Jahre,205,107,98
False,8436004,Aitrach,40 - 45 Jahre,178,97,81
False,8436004,Aitrach,45 - 50 Jahre,148,70,78
False,8436004,Aitrach,50 - 55 Jahre,178,85,93
False,8436004,Aitrach,55 - 60 Jahre,179,95,84
False,8436004,Aitrach,60 - 65 Jahre,192,101,91
False,8436004,Aitrach,65 - 75 Jahre,226,108,118
False,8436004,Aitrach,75 und mehr Jahre,145,48,97
False,8436004,Aitrach,Insgesamt,2613,1345,1268
False,8436005,Altshausen,unter 3 Jahre,100,47,53
False,8436005,Altshausen,3 -  6 Jahre,123,66,57
False,8436005,Altshausen,6 - 10 Jahre,184,105,79
False,8436005,Altshausen,10 - 15 Jahre,253,135,118
False,8436005,Altshausen,15 - 18 Jahre,173,85,88
False,8436005,Altshausen,18 - 20 Jahre,86,43,43
False,8436005,Altshausen,20 - 25 Jahre,226,115,111
False,8436005,Altshausen,25 - 30 Jahre,290,167,123
False,8436005,Altshausen,30 - 35 Jahre,274,141,133
False,8436005,Altshausen,35 - 40 Jahre,297,168,129
False,8436005,Altshausen,40 - 45 Jahre,352,199,153
False,8436005,Altshausen,45 - 50 Jahre,332,201,131
False,8436005,Altshausen,50 - 55 Jahre,298,198,100
False,8436005,Altshausen,55 - 60 Jahre,269,169,100
False,8436005,Altshausen,60 - 65 Jahre,357,232,125
False,8436005,Altshausen,65 - 75 Jahre,460,247,213
False,8436005,Altshausen,75 und mehr Jahre,423,113,310
False,8436005,Altshausen,Insgesamt,4497,2431,2066
False,8436006,Amtzell,unter 3 Jahre,120,62,58
False,8436006,Amtzell,3 -  6 Jahre,124,61,63
False,8436006,Amtzell,6 - 10 Jahre,194,100,94
False,8436006,Amtzell,10 - 15 Jahre,250,132,118
False,8436006,Amtzell,15 - 18 Jahre,126,69,57
False,8436006,Amtzell,18 - 20 Jahre,84,39,45
False,8436006,Amtzell,20 - 25 Jahre,190,96,94
False,8436006,Amtzell,25 - 30 Jahre,209,101,108
False,8436006,Amtzell,30 - 35 Jahre,253,134,119
False,8436006,Amtzell,35 - 40 Jahre,302,138,164
False,8436006,Amtzell,40 - 45 Jahre,278,133,145
False,8436006,Amtzell,45 - 50 Jahre,259,131,128
False,8436006,Amtzell,50 - 55 Jahre,202,110,92
False,8436006,Amtzell,55 - 60 Jahre,164,79,85
False,8436006,Amtzell,60 - 65 Jahre,135,81,54
False,8436006,Amtzell,65 - 75 Jahre,222,94,128
False,8436006,Amtzell,75 und mehr Jahre,246,70,176
False,8436006,Amtzell,Insgesamt,3358,1630,1728
False,8436008,"Aulendorf, Stadt",unter 3 Jahre,334,173,161
False,8436008,"Aulendorf, Stadt",3 -  6 Jahre,343,177,166
False,8436008,"Aulendorf, Stadt",6 - 10 Jahre,470,236,234
False,8436008,"Aulendorf, Stadt",10 - 15 Jahre,695,362,333
False,8436008,"Aulendorf, Stadt",15 - 18 Jahre,383,213,170
False,8436008,"Aulendorf, Stadt",18 - 20 Jahre,251,131,120
False,8436008,"Aulendorf, Stadt",20 - 25 Jahre,510,259,251
False,8436008,"Aulendorf, Stadt",25 - 30 Jahre,547,290,257
False,8436008,"Aulendorf, Stadt",30 - 35 Jahre,679,357,322
False,8436008,"Aulendorf, Stadt",35 - 40 Jahre,805,367,438
False,8436008,"Aulendorf, Stadt",40 - 45 Jahre,716,356,360
False,8436008,"Aulendorf, Stadt",45 - 50 Jahre,598,309,289
False,8436008,"Aulendorf, Stadt",50 - 55 Jahre,574,295,279
False,8436008,"Aulendorf, Stadt",55 - 60 Jahre,437,227,210
False,8436008,"Aulendorf, Stadt",60 - 65 Jahre,509,237,272
False,8436008,"Aulendorf, Stadt",65 - 75 Jahre,799,352,447
False,8436008,"Aulendorf, Stadt",75 und mehr Jahre,669,207,462
False,8436008,"Aulendorf, Stadt",Insgesamt,9319,4548,4771
False,8436009,"Bad Waldsee, Stadt",unter 3 Jahre,653,324,329
False,8436009,"Bad Waldsee, Stadt",3 -  6 Jahre,683,339,344
False,8436009,"Bad Waldsee, Stadt",6 - 10 Jahre,952,474,478
False,8436009,"Bad Waldsee, Stadt",10 - 15 Jahre,1312,699,613
False,8436009,"Bad Waldsee, Stadt",15 - 18 Jahre,683,345,338
False,8436009,"Bad Waldsee, Stadt",18 - 20 Jahre,477,228,249
False,8436009,"Bad Waldsee, Stadt",20 - 25 Jahre,1058,538,520
False,8436009,"Bad Waldsee, Stadt",25 - 30 Jahre,1159,549,610
False,8436009,"Bad Waldsee, Stadt",30 - 35 Jahre,1552,755,797
False,8436009,"Bad Waldsee, Stadt",35 - 40 Jahre,1589,800,789
False,8436009,"Bad Waldsee, Stadt",40 - 45 Jahre,1462,721,741
False,8436009,"Bad Waldsee, Stadt",45 - 50 Jahre,1274,640,634
False,8436009,"Bad Waldsee, Stadt",50 - 55 Jahre,1115,533,582
False,8436009,"Bad Waldsee, Stadt",55 - 60 Jahre,1035,501,534
False,8436009,"Bad Waldsee, Stadt",60 - 65 Jahre,1124,563,561
False,8436009,"Bad Waldsee, Stadt",65 - 75 Jahre,1542,651,891
False,8436009,"Bad Waldsee, Stadt",75 und mehr Jahre,1356,389,967
False,8436009,"Bad Waldsee, Stadt",Insgesamt,19026,9049,9977
False,8436010,"Bad Wurzach, Stadt",unter 3 Jahre,531,258,273
False,8436010,"Bad Wurzach, Stadt",3 -  6 Jahre,598,311,287
False,8436010,"Bad Wurzach, Stadt",6 - 10 Jahre,809,433,376
False,8436010,"Bad Wurzach, Stadt",10 - 15 Jahre,1022,502,520
False,8436010,"Bad Wurzach, Stadt",15 - 18 Jahre,546,283,263
False,8436010,"Bad Wurzach, Stadt",18 - 20 Jahre,378,213,165
False,8436010,"Bad Wurzach, Stadt",20 - 25 Jahre,808,418,390
False,8436010,"Bad Wurzach, Stadt",25 - 30 Jahre,977,518,459
False,8436010,"Bad Wurzach, Stadt",30 - 35 Jahre,1247,654,593
False,8436010,"Bad Wurzach, Stadt",35 - 40 Jahre,1233,662,571
False,8436010,"Bad Wurzach, Stadt",40 - 45 Jahre,1017,548,469
False,8436010,"Bad Wurzach, Stadt",45 - 50 Jahre,851,440,411
False,8436010,"Bad Wurzach, Stadt",50 - 55 Jahre,730,369,361
False,8436010,"Bad Wurzach, Stadt",55 - 60 Jahre,663,352,311
False,8436010,"Bad Wurzach, Stadt",60 - 65 Jahre,839,435,404
False,8436010,"Bad Wurzach, Stadt",65 - 75 Jahre,1058,506,552
False,8436010,"Bad Wurzach, Stadt",75 und mehr Jahre,829,247,582
False,8436010,"Bad Wurzach, Stadt",Insgesamt,14136,7149,6987
False,8436011,Baienfurt,unter 3 Jahre,223,119,104
False,8436011,Baienfurt,3 -  6 Jahre,245,127,118
False,8436011,Baienfurt,6 - 10 Jahre,357,171,186
False,8436011,Baienfurt,10 - 15 Jahre,450,217,233
False,8436011,Baienfurt,15 - 18 Jahre,251,137,114
False,8436011,Baienfurt,18 - 20 Jahre,162,69,93
False,8436011,Baienfurt,20 - 25 Jahre,366,166,200
False,8436011,Baienfurt,25 - 30 Jahre,403,212,191
False,8436011,Baienfurt,30 - 35 Jahre,610,309,301
False,8436011,Baienfurt,35 - 40 Jahre,606,314,292
False,8436011,Baienfurt,40 - 45 Jahre,536,276,260
False,8436011,Baienfurt,45 - 50 Jahre,496,238,258
False,8436011,Baienfurt,50 - 55 Jahre,395,201,194
False,8436011,Baienfurt,55 - 60 Jahre,437,219,218
False,8436011,Baienfurt,60 - 65 Jahre,488,230,258
False,8436011,Baienfurt,65 - 75 Jahre,658,312,346
False,8436011,Baienfurt,75 und mehr Jahre,406,123,283
False,8436011,Baienfurt,Insgesamt,7089,3440,3649
False,8436012,Baindt,unter 3 Jahre,153,80,73
False,8436012,Baindt,3 -  6 Jahre,147,76,71
False,8436012,Baindt,6 - 10 Jahre,225,110,115
False,8436012,Baindt,10 - 15 Jahre,313,174,139
False,8436012,Baindt,15 - 18 Jahre,169,82,87
False,8436012,Baindt,18 - 20 Jahre,116,61,55
False,8436012,Baindt,20 - 25 Jahre,261,122,139
False,8436012,Baindt,25 - 30 Jahre,268,135,133
False,8436012,Baindt,30 - 35 Jahre,374,177,197
False,8436012,Baindt,35 - 40 Jahre,380,197,183
False,8436012,Baindt,40 - 45 Jahre,356,167,189
False,8436012,Baindt,45 - 50 Jahre,352,176,176
False,8436012,Baindt,50 - 55 Jahre,289,149,140
False,8436012,Baindt,55 - 60 Jahre,307,154,153
False,8436012,Baindt,60 - 65 Jahre,307,161,146
False,8436012,Baindt,65 - 75 Jahre,388,181,207
False,8436012,Baindt,75 und mehr Jahre,207,74,133
False,8436012,Baindt,Insgesamt,4612,2276,2336
False,8436013,Berg,unter 3 Jahre,149,84,65
False,8436013,Berg,3 -  6 Jahre,151,81,70
False,8436013,Berg,6 - 10 Jahre,172,98,74
False,8436013,Berg,10 - 15 Jahre,256,143,113
False,8436013,Berg,15 - 18 Jahre,124,75,49
False,8436013,Berg,18 - 20 Jahre,82,43,39
False,8436013,Berg,20 - 25 Jahre,198,104,94
False,8436013,Berg,25 - 30 Jahre,253,130,123
False,8436013,Berg,30 - 35 Jahre,336,183,153
False,8436013,Berg,35 - 40 Jahre,289,142,147
False,8436013,Berg,40 - 45 Jahre,282,127,155
False,8436013,Berg,45 - 50 Jahre,261,119,142
False,8436013,Berg,50 - 55 Jahre,241,130,111
False,8436013,Berg,55 - 60 Jahre,252,108,144
False,8436013,Berg,60 - 65 Jahre,240,134,106
False,8436013,Berg,65 - 75 Jahre,291,133,158
False,8436013,Berg,75 und mehr Jahre,216,68,148
False,8436013,Berg,Insgesamt,3793,1902,1891
False,8436014,Bergatreute,unter 3 Jahre,123,62,61
False,8436014,Bergatreute,3 -  6 Jahre,141,79,62
False,8436014,Bergatreute,6 - 10 Jahre,188,113,75
False,8436014,Bergatreute,10 - 15 Jahre,264,126,138
False,8436014,Bergatreute,15 - 18 Jahre,132,58,74
False,8436014,Bergatreute,18 - 20 Jahre,79,41,38
False,8436014,Bergatreute,20 - 25 Jahre,146,72,74
False,8436014,Bergatreute,25 - 30 Jahre,172,92,80
False,8436014,Bergatreute,30 - 35 Jahre,283,157,126
False,8436014,Bergatreute,35 - 40 Jahre,285,139,146
False,8436014,Bergatreute,40 - 45 Jahre,249,140,109
False,8436014,Bergatreute,45 - 50 Jahre,213,106,107
False,8436014,Bergatreute,50 - 55 Jahre,152,87,65
False,8436014,Bergatreute,55 - 60 Jahre,115,56,59
False,8436014,Bergatreute,60 - 65 Jahre,186,93,93
False,8436014,Bergatreute,65 - 75 Jahre,225,106,119
False,8436014,Bergatreute,75 und mehr Jahre,117,37,80
False,8436014,Bergatreute,Insgesamt,3070,1564,1506
False,8436018,Bodnegg,unter 3 Jahre,121,60,61
False,8436018,Bodnegg,3 -  6 Jahre,96,47,49
False,8436018,Bodnegg,6 - 10 Jahre,153,75,78
False,8436018,Bodnegg,10 - 15 Jahre,193,106,87
False,8436018,Bodnegg,15 - 18 Jahre,97,45,52
False,8436018,Bodnegg,18 - 20 Jahre,62,30,32
False,8436018,Bodnegg,20 - 25 Jahre,149,79,70
False,8436018,Bodnegg,25 - 30 Jahre,159,93,66
False,8436018,Bodnegg,30 - 35 Jahre,272,136,136
False,8436018,Bodnegg,35 - 40 Jahre,293,165,128
False,8436018,Bodnegg,40 - 45 Jahre,235,116,119
False,8436018,Bodnegg,45 - 50 Jahre,214,108,106
False,8436018,Bodnegg,50 - 55 Jahre,196,109,87
False,8436018,Bodnegg,55 - 60 Jahre,172,89,83
False,8436018,Bodnegg,60 - 65 Jahre,211,100,111
False,8436018,Bodnegg,65 - 75 Jahre,270,144,126
False,8436018,Bodnegg,75 und mehr Jahre,166,52,114
False,8436018,Bodnegg,Insgesamt,3059,1554,1505
False,8436019,Boms,unter 3 Jahre,21,8,13
False,8436019,Boms,3 -  6 Jahre,19,9,10
False,8436019,Boms,6 - 10 Jahre,33,27,6
False,8436019,Boms,10 - 15 Jahre,56,32,24
False,8436019,Boms,15 - 18 Jahre,26,13,13
False,8436019,Boms,18 - 20 Jahre,15,6,9
False,8436019,Boms,20 - 25 Jahre,32,21,11
False,8436019,Boms,25 - 30 Jahre,28,15,13
False,8436019,Boms,30 - 35 Jahre,63,26,37
False,8436019,Boms,35 - 40 Jahre,59,30,29
False,8436019,Boms,40 - 45 Jahre,50,26,24
False,8436019,Boms,45 - 50 Jahre,46,25,21
False,8436019,Boms,50 - 55 Jahre,23,15,8
False,8436019,Boms,55 - 60 Jahre,17,9,8
False,8436019,Boms,60 - 65 Jahre,19,12,7
False,8436019,Boms,65 - 75 Jahre,42,19,23
False,8436019,Boms,75 und mehr Jahre,32,8,24
False,8436019,Boms,Insgesamt,581,301,280
False,8436024,Ebenweiler,unter 3 Jahre,53,28,25
False,8436024,Ebenweiler,3 -  6 Jahre,41,23,18
False,8436024,Ebenweiler,6 - 10 Jahre,81,45,36
False,8436024,Ebenweiler,10 - 15 Jahre,94,46,48
False,8436024,Ebenweiler,15 - 18 Jahre,44,28,16
False,8436024,Ebenweiler,18 - 20 Jahre,18,9,9
False,8436024,Ebenweiler,20 - 25 Jahre,52,30,22
False,8436024,Ebenweiler,25 - 30 Jahre,63,32,31
False,8436024,Ebenweiler,30 - 35 Jahre,103,50,53
False,8436024,Ebenweiler,35 - 40 Jahre,107,51,56
False,8436024,Ebenweiler,40 - 45 Jahre,85,45,40
False,8436024,Ebenweiler,45 - 50 Jahre,65,36,29
False,8436024,Ebenweiler,50 - 55 Jahre,50,31,19
False,8436024,Ebenweiler,55 - 60 Jahre,45,20,25
False,8436024,Ebenweiler,60 - 65 Jahre,47,26,21
False,8436024,Ebenweiler,65 - 75 Jahre,63,30,33
False,8436024,Ebenweiler,75 und mehr Jahre,52,20,32
False,8436024,Ebenweiler,Insgesamt,1063,550,513
False,8436027,Eichstegen,unter 3 Jahre,25,11,14
False,8436027,Eichstegen,3 -  6 Jahre,16,10,6
False,8436027,Eichstegen,6 - 10 Jahre,27,12,15
False,8436027,Eichstegen,10 - 15 Jahre,49,25,24
False,8436027,Eichstegen,15 - 18 Jahre,21,14,7
False,8436027,Eichstegen,18 - 20 Jahre,11,5,6
False,8436027,Eichstegen,20 - 25 Jahre,31,15,16
False,8436027,Eichstegen,25 - 30 Jahre,33,16,17
False,8436027,Eichstegen,30 - 35 Jahre,41,19,22
False,8436027,Eichstegen,35 - 40 Jahre,65,36,29
False,8436027,Eichstegen,40 - 45 Jahre,41,19,22
False,8436027,Eichstegen,45 - 50 Jahre,28,15,13
False,8436027,Eichstegen,50 - 55 Jahre,20,10,10
False,8436027,Eichstegen,55 - 60 Jahre,12,5,7
False,8436027,Eichstegen,60 - 65 Jahre,28,17,11
False,8436027,Eichstegen,65 - 75 Jahre,43,23,20
False,8436027,Eichstegen,75 und mehr Jahre,34,10,24
False,8436027,Eichstegen,Insgesamt,525,262,263
False,8436032,Fleischwangen,unter 3 Jahre,30,15,15
False,8436032,Fleischwangen,3 -  6 Jahre,42,27,15
False,8436032,Fleischwangen,6 - 10 Jahre,51,33,18
False,8436032,Fleischwangen,10 - 15 Jahre,51,24,27
False,8436032,Fleischwangen,15 - 18 Jahre,25,17,8
False,8436032,Fleischwangen,18 - 20 Jahre,8,6,2
False,8436032,Fleischwangen,20 - 25 Jahre,31,10,21
False,8436032,Fleischwangen,25 - 30 Jahre,35,11,24
False,8436032,Fleischwangen,30 - 35 Jahre,54,29,25
False,8436032,Fleischwangen,35 - 40 Jahre,67,37,30
False,8436032,Fleischwangen,40 - 45 Jahre,49,25,24
False,8436032,Fleischwangen,45 - 50 Jahre,28,12,16
False,8436032,Fleischwangen,50 - 55 Jahre,34,17,17
False,8436032,Fleischwangen,55 - 60 Jahre,31,18,13
False,8436032,Fleischwangen,60 - 65 Jahre,23,15,8
False,8436032,Fleischwangen,65 - 75 Jahre,30,13,17
False,8436032,Fleischwangen,75 und mehr Jahre,14,5,9
False,8436032,Fleischwangen,Insgesamt,603,314,289
False,8436039,Grünkraut,unter 3 Jahre,106,56,50
False,8436039,Grünkraut,3 -  6 Jahre,116,63,53
False,8436039,Grünkraut,6 - 10 Jahre,155,71,84
False,8436039,Grünkraut,10 - 15 Jahre,202,118,84
False,8436039,Grünkraut,15 - 18 Jahre,103,41,62
False,8436039,Grünkraut,18 - 20 Jahre,63,27,36
False,8436039,Grünkraut,20 - 25 Jahre,177,67,110
False,8436039,Grünkraut,25 - 30 Jahre,187,92,95
False,8436039,Grünkraut,30 - 35 Jahre,288,152,136
False,8436039,Grünkraut,35 - 40 Jahre,258,136,122
False,8436039,Grünkraut,40 - 45 Jahre,233,115,118
False,8436039,Grünkraut,45 - 50 Jahre,204,105,99
False,8436039,Grünkraut,50 - 55 Jahre,171,80,91
False,8436039,Grünkraut,55 - 60 Jahre,165,87,78
False,8436039,Grünkraut,60 - 65 Jahre,161,85,76
False,8436039,Grünkraut,65 - 75 Jahre,211,100,111
False,8436039,Grünkraut,75 und mehr Jahre,123,43,80
False,8436039,Grünkraut,Insgesamt,2923,1438,1485
False,8436040,Guggenhausen,unter 3 Jahre,9,3,6
False,8436040,Guggenhausen,3 -  6 Jahre,12,5,7
False,8436040,Guggenhausen,6 - 10 Jahre,10,9,1
False,8436040,Guggenhausen,10 - 15 Jahre,16,5,11
False,8436040,Guggenhausen,15 - 18 Jahre,8,4,4
False,8436040,Guggenhausen,18 - 20 Jahre,2,2,0
False,8436040,Guggenhausen,20 - 25 Jahre,20,14,6
False,8436040,Guggenhausen,25 - 30 Jahre,18,11,7
False,8436040,Guggenhausen,30 - 35 Jahre,11,5,6
False,8436040,Guggenhausen,35 - 40 Jahre,18,11,7
False,8436040,Guggenhausen,40 - 45 Jahre,20,15,5
False,8436040,Guggenhausen,45 - 50 Jahre,13,6,7
False,8436040,Guggenhausen,50 - 55 Jahre,9,4,5
False,8436040,Guggenhausen,55 - 60 Jahre,6,4,2
False,8436040,Guggenhausen,60 - 65 Jahre,13,7,6
False,8436040,Guggenhausen,65 - 75 Jahre,16,10,6
False,8436040,Guggenhausen,75 und mehr Jahre,10,1,9
False,8436040,Guggenhausen,Insgesamt,211,116,95
False,8436047,Hoßkirch,unter 3 Jahre,23,15,8
False,8436047,Hoßkirch,3 -  6 Jahre,27,17,10
False,8436047,Hoßkirch,6 - 10 Jahre,44,26,18
False,8436047,Hoßkirch,10 - 15 Jahre,55,30,25
False,8436047,Hoßkirch,15 - 18 Jahre,31,20,11
False,8436047,Hoßkirch,18 - 20 Jahre,17,9,8
False,8436047,Hoßkirch,20 - 25 Jahre,30,18,12
False,8436047,Hoßkirch,25 - 30 Jahre,33,19,14
False,8436047,Hoßkirch,30 - 35 Jahre,45,21,24
False,8436047,Hoßkirch,35 - 40 Jahre,56,35,21
False,8436047,Hoßkirch,40 - 45 Jahre,66,27,39
False,8436047,Hoßkirch,45 - 50 Jahre,60,33,27
False,8436047,Hoßkirch,50 - 55 Jahre,64,37,27
False,8436047,Hoßkirch,55 - 60 Jahre,32,18,14
False,8436047,Hoßkirch,60 - 65 Jahre,45,25,20
False,8436047,Hoßkirch,65 - 75 Jahre,42,19,23
False,8436047,Hoßkirch,75 und mehr Jahre,35,10,25
False,8436047,Hoßkirch,Insgesamt,705,379,326
False,8436049,"Isny im Allgäu, Stadt",unter 3 Jahre,401,206,195
False,8436049,"Isny im Allgäu, Stadt",3 -  6 Jahre,444,232,212
False,8436049,"Isny im Allgäu, Stadt",6 - 10 Jahre,637,322,315
False,8436049,"Isny im Allgäu, Stadt",10 - 15 Jahre,794,426,368
False,8436049,"Isny im Allgäu, Stadt",15 - 18 Jahre,504,274,230
False,8436049,"Isny im Allgäu, Stadt",18 - 20 Jahre,395,195,200
False,8436049,"Isny im Allgäu, Stadt",20 - 25 Jahre,1009,484,525
False,8436049,"Isny im Allgäu, Stadt",25 - 30 Jahre,1012,496,516
False,8436049,"Isny im Allgäu, Stadt",30 - 35 Jahre,1428,609,819
False,8436049,"Isny im Allgäu, Stadt",35 - 40 Jahre,1327,647,680
False,8436049,"Isny im Allgäu, Stadt",40 - 45 Jahre,1012,495,517
False,8436049,"Isny im Allgäu, Stadt",45 - 50 Jahre,856,444,412
False,8436049,"Isny im Allgäu, Stadt",50 - 55 Jahre,779,383,396
False,8436049,"Isny im Allgäu, Stadt",55 - 60 Jahre,745,387,358
False,8436049,"Isny im Allgäu, Stadt",60 - 65 Jahre,794,398,396
False,8436049,"Isny im Allgäu, Stadt",65 - 75 Jahre,1116,492,624
False,8436049,"Isny im Allgäu, Stadt",75 und mehr Jahre,1056,320,736
False,8436049,"Isny im Allgäu, Stadt",Insgesamt,14309,6810,7499
False,8436052,Kißlegg,unter 3 Jahre,310,165,145
False,8436052,Kißlegg,3 -  6 Jahre,343,184,159
False,8436052,Kißlegg,6 - 10 Jahre,509,265,244
False,8436052,Kißlegg,10 - 15 Jahre,633,345,288
False,8436052,Kißlegg,15 - 18 Jahre,378,183,195
False,8436052,Kißlegg,18 - 20 Jahre,220,108,112
False,8436052,Kißlegg,20 - 25 Jahre,508,272,236
False,8436052,Kißlegg,25 - 30 Jahre,506,251,255
False,8436052,Kißlegg,30 - 35 Jahre,668,321,347
False,8436052,Kißlegg,35 - 40 Jahre,740,380,360
False,8436052,Kißlegg,40 - 45 Jahre,655,343,312
False,8436052,Kißlegg,45 - 50 Jahre,568,310,258
False,8436052,Kißlegg,50 - 55 Jahre,496,254,242
False,8436052,Kißlegg,55 - 60 Jahre,405,207,198
False,8436052,Kißlegg,60 - 65 Jahre,464,228,236
False,8436052,Kißlegg,65 - 75 Jahre,676,321,355
False,8436052,Kißlegg,75 und mehr Jahre,637,196,441
False,8436052,Kißlegg,Insgesamt,8716,4333,4383
False,8436053,Königseggwald,unter 3 Jahre,23,10,13
False,8436053,Königseggwald,3 -  6 Jahre,31,13,18
False,8436053,Königseggwald,6 - 10 Jahre,47,25,22
False,8436053,Königseggwald,10 - 15 Jahre,49,28,21
False,8436053,Königseggwald,15 - 18 Jahre,24,13,11
False,8436053,Königseggwald,18 - 20 Jahre,18,8,10
False,8436053,Königseggwald,20 - 25 Jahre,40,23,17
False,8436053,Königseggwald,25 - 30 Jahre,34,19,15
False,8436053,Königseggwald,30 - 35 Jahre,63,30,33
False,8436053,Königseggwald,35 - 40 Jahre,62,37,25
False,8436053,Königseggwald,40 - 45 Jahre,42,17,25
False,8436053,Königseggwald,45 - 50 Jahre,45,24,21
False,8436053,Königseggwald,50 - 55 Jahre,26,16,10
False,8436053,Königseggwald,55 - 60 Jahre,37,16,21
False,8436053,Königseggwald,60 - 65 Jahre,44,26,18
False,8436053,Königseggwald,65 - 75 Jahre,64,28,36
False,8436053,Königseggwald,75 und mehr Jahre,18,7,11
False,8436053,Königseggwald,Insgesamt,667,340,327
False,8436055,"Leutkirch im Allgäu, Stadt",unter 3 Jahre,771,395,376
False,8436055,"Leutkirch im Allgäu, Stadt",3 -  6 Jahre,875,455,420
False,8436055,"Leutkirch im Allgäu, Stadt",6 - 10 Jahre,1216,634,582
False,8436055,"Leutkirch im Allgäu, Stadt",10 - 15 Jahre,1531,780,751
False,8436055,"Leutkirch im Allgäu, Stadt",15 - 18 Jahre,857,442,415
False,8436055,"Leutkirch im Allgäu, Stadt",18 - 20 Jahre,588,319,269
False,8436055,"Leutkirch im Allgäu, Stadt",20 - 25 Jahre,1220,634,586
False,8436055,"Leutkirch im Allgäu, Stadt",25 - 30 Jahre,1287,646,641
False,8436055,"Leutkirch im Allgäu, Stadt",30 - 35 Jahre,1705,883,822
False,8436055,"Leutkirch im Allgäu, Stadt",35 - 40 Jahre,1812,939,873
False,8436055,"Leutkirch im Allgäu, Stadt",40 - 45 Jahre,1643,823,820
False,8436055,"Leutkirch im Allgäu, Stadt",45 - 50 Jahre,1394,709,685
False,8436055,"Leutkirch im Allgäu, Stadt",50 - 55 Jahre,1282,666,616
False,8436055,"Leutkirch im Allgäu, Stadt",55 - 60 Jahre,1131,595,536
False,8436055,"Leutkirch im Allgäu, Stadt",60 - 65 Jahre,1317,653,664
False,8436055,"Leutkirch im Allgäu, Stadt",65 - 75 Jahre,1796,830,966
False,8436055,"Leutkirch im Allgäu, Stadt",75 und mehr Jahre,1604,511,1093
False,8436055,"Leutkirch im Allgäu, Stadt",Insgesamt,22029,10914,11115
False,8436064,"Ravensburg, Stadt",unter 3 Jahre,1438,699,739
False,8436064,"Ravensburg, Stadt",3 -  6 Jahre,1508,792,716
False,8436064,"Ravensburg, Stadt",6 - 10 Jahre,1982,1021,961
False,8436064,"Ravensburg, Stadt",10 - 15 Jahre,2609,1309,1300
False,8436064,"Ravensburg, Stadt",15 - 18 Jahre,1448,748,700
False,8436064,"Ravensburg, Stadt",18 - 20 Jahre,1021,510,511
False,8436064,"Ravensburg, Stadt",20 - 25 Jahre,2700,1321,1379
False,8436064,"Ravensburg, Stadt",25 - 30 Jahre,3184,1500,1684
False,8436064,"Ravensburg, Stadt",30 - 35 Jahre,4211,2118,2093
False,8436064,"Ravensburg, Stadt",35 - 40 Jahre,4185,2140,2045
False,8436064,"Ravensburg, Stadt",40 - 45 Jahre,3655,1850,1805
False,8436064,"Ravensburg, Stadt",45 - 50 Jahre,2985,1425,1560
False,8436064,"Ravensburg, Stadt",50 - 55 Jahre,2823,1416,1407
False,8436064,"Ravensburg, Stadt",55 - 60 Jahre,2873,1417,1456
False,8436064,"Ravensburg, Stadt",60 - 65 Jahre,3207,1552,1655
False,8436064,"Ravensburg, Stadt",65 - 75 Jahre,4146,1859,2287
False,8436064,"Ravensburg, Stadt",75 und mehr Jahre,3793,1155,2638
False,8436064,"Ravensburg, Stadt",Insgesamt,47768,22832,24936
False,8436067,Riedhausen,unter 3 Jahre,31,13,18
False,8436067,Riedhausen,3 -  6 Jahre,32,15,17
False,8436067,Riedhausen,6 - 10 Jahre,53,31,22
False,8436067,Riedhausen,10 - 15 Jahre,50,28,22
False,8436067,Riedhausen,15 - 18 Jahre,25,15,10
False,8436067,Riedhausen,18 - 20 Jahre,17,5,12
False,8436067,Riedhausen,20 - 25 Jahre,26,13,13
False,8436067,Riedhausen,25 - 30 Jahre,43,19,24
False,8436067,Riedhausen,30 - 35 Jahre,50,25,25
False,8436067,Riedhausen,35 - 40 Jahre,53,27,26
False,8436067,Riedhausen,40 - 45 Jahre,47,25,22
False,8436067,Riedhausen,45 - 50 Jahre,27,19,8
False,8436067,Riedhausen,50 - 55 Jahre,21,12,9
False,8436067,Riedhausen,55 - 60 Jahre,16,9,7
False,8436067,Riedhausen,60 - 65 Jahre,29,14,15
False,8436067,Riedhausen,65 - 75 Jahre,39,17,22
False,8436067,Riedhausen,75 und mehr Jahre,20,9,11
False,8436067,Riedhausen,Insgesamt,579,296,283
False,8436069,Schlier,unter 3 Jahre,123,58,65
False,8436069,Schlier,3 -  6 Jahre,148,77,71
False,8436069,Schlier,6 - 10 Jahre,195,100,95
False,8436069,Schlier,10 - 15 Jahre,261,129,132
False,8436069,Schlier,15 - 18 Jahre,132,65,67
False,8436069,Schlier,18 - 20 Jahre,89,49,40
False,8436069,Schlier,20 - 25 Jahre,207,107,100
False,8436069,Schlier,25 - 30 Jahre,210,107,103
False,8436069,Schlier,30 - 35 Jahre,276,142,134
False,8436069,Schlier,35 - 40 Jahre,347,165,182
False,8436069,Schlier,40 - 45 Jahre,321,148,173
False,8436069,Schlier,45 - 50 Jahre,274,146,128
False,8436069,Schlier,50 - 55 Jahre,191,95,96
False,8436069,Schlier,55 - 60 Jahre,206,116,90
False,8436069,Schlier,60 - 65 Jahre,238,128,110
False,8436069,Schlier,65 - 75 Jahre,269,132,137
False,8436069,Schlier,75 und mehr Jahre,170,67,103
False,8436069,Schlier,Insgesamt,3657,1831,1826
False,8436077,Unterwaldhausen,unter 3 Jahre,7,4,3
False,8436077,Unterwaldhausen,3 -  6 Jahre,9,5,4
False,8436077,Unterwaldhausen,6 - 10 Jahre,21,10,11
False,8436077,Unterwaldhausen,10 - 15 Jahre,32,14,18
False,8436077,Unterwaldhausen,15 - 18 Jahre,12,7,5
False,8436077,Unterwaldhausen,18 - 20 Jahre,5,3,2
False,8436077,Unterwaldhausen,20 - 25 Jahre,13,8,5
False,8436077,Unterwaldhausen,25 - 30 Jahre,13,7,6
False,8436077,Unterwaldhausen,30 - 35 Jahre,26,14,12
False,8436077,Unterwaldhausen,35 - 40 Jahre,33,15,18
False,8436077,Unterwaldhausen,40 - 45 Jahre,20,12,8
False,8436077,Unterwaldhausen,45 - 50 Jahre,21,12,9
False,8436077,Unterwaldhausen,50 - 55 Jahre,17,9,8
False,8436077,Unterwaldhausen,55 - 60 Jahre,10,6,4
False,8436077,Unterwaldhausen,60 - 65 Jahre,7,5,2
False,8436077,Unterwaldhausen,65 - 75 Jahre,19,11,8
False,8436077,Unterwaldhausen,75 und mehr Jahre,17,3,14
False,8436077,Unterwaldhausen,Insgesamt,282,145,137
False,8436078,Vogt,unter 3 Jahre,191,106,85
False,8436078,Vogt,3 -  6 Jahre,191,106,85
False,8436078,Vogt,6 - 10 Jahre,255,126,129
False,8436078,Vogt,10 - 15 Jahre,337,164,173
False,8436078,Vogt,15 - 18 Jahre,155,74,81
False,8436078,Vogt,18 - 20 Jahre,118,74,44
False,8436078,Vogt,20 - 25 Jahre,217,120,97
False,8436078,Vogt,25 - 30 Jahre,257,132,125
False,8436078,Vogt,30 - 35 Jahre,377,197,180
False,8436078,Vogt,35 - 40 Jahre,388,191,197
False,8436078,Vogt,40 - 45 Jahre,390,183,207
False,8436078,Vogt,45 - 50 Jahre,318,163,155
False,8436078,Vogt,50 - 55 Jahre,251,139,112
False,8436078,Vogt,55 - 60 Jahre,263,131,132
False,8436078,Vogt,60 - 65 Jahre,262,133,129
False,8436078,Vogt,65 - 75 Jahre,288,139,149
False,8436078,Vogt,75 und mehr Jahre,244,80,164
False,8436078,Vogt,Insgesamt,4502,2258,2244
False,8436079,Waldburg,unter 3 Jahre,133,61,72
False,8436079,Waldburg,3 -  6 Jahre,135,67,68
False,8436079,Waldburg,6 - 10 Jahre,155,72,83
False,8436079,Waldburg,10 - 15 Jahre,198,103,95
False,8436079,Waldburg,15 - 18 Jahre,101,59,42
False,8436079,Waldburg,18 - 20 Jahre,44,17,27
False,8436079,Waldburg,20 - 25 Jahre,131,61,70
False,8436079,Waldburg,25 - 30 Jahre,159,83,76
False,8436079,Waldburg,30 - 35 Jahre,249,118,131
False,8436079,Waldburg,35 - 40 Jahre,270,130,140
False,8436079,Waldburg,40 - 45 Jahre,231,132,99
False,8436079,Waldburg,45 - 50 Jahre,183,96,87
False,8436079,Waldburg,50 - 55 Jahre,158,81,77
False,8436079,Waldburg,55 - 60 Jahre,136,65,71
False,8436079,Waldburg,60 - 65 Jahre,172,89,83
False,8436079,Waldburg,65 - 75 Jahre,192,94,98
False,8436079,Waldburg,75 und mehr Jahre,188,62,126
False,8436079,Waldburg,Insgesamt,2835,1390,1445
False,8436081,"Wangen im Allgäu, Stadt",unter 3 Jahre,881,431,450
False,8436081,"Wangen im Allgäu, Stadt",3 -  6 Jahre,955,448,507
False,8436081,"Wangen im Allgäu, Stadt",6 - 10 Jahre,1318,672,646
False,8436081,"Wangen im Allgäu, Stadt",10 - 15 Jahre,1685,836,849
False,8436081,"Wangen im Allgäu, Stadt",15 - 18 Jahre,855,442,413
False,8436081,"Wangen im Allgäu, Stadt",18 - 20 Jahre,610,300,310
False,8436081,"Wangen im Allgäu, Stadt",20 - 25 Jahre,1367,676,691
False,8436081,"Wangen im Allgäu, Stadt",25 - 30 Jahre,1498,751,747
False,8436081,"Wangen im Allgäu, Stadt",30 - 35 Jahre,2216,1130,1086
False,8436081,"Wangen im Allgäu, Stadt",35 - 40 Jahre,2279,1159,1120
False,8436081,"Wangen im Allgäu, Stadt",40 - 45 Jahre,1857,930,927
False,8436081,"Wangen im Allgäu, Stadt",45 - 50 Jahre,1611,781,830
False,8436081,"Wangen im Allgäu, Stadt",50 - 55 Jahre,1589,824,765
False,8436081,"Wangen im Allgäu, Stadt",55 - 60 Jahre,1490,769,721
False,8436081,"Wangen im Allgäu, Stadt",60 - 65 Jahre,1635,765,870
False,8436081,"Wangen im Allgäu, Stadt",65 - 75 Jahre,2344,1116,1228
False,8436081,"Wangen im Allgäu, Stadt",75 und mehr Jahre,2064,631,1433
False,8436081,"Wangen im Allgäu, Stadt",Insgesamt,26254,12661,13593
False,8436082,"Weingarten, Stadt",unter 3 Jahre,656,344,312
False,8436082,"Weingarten, Stadt",3 -  6 Jahre,645,344,301
False,8436082,"Weingarten, Stadt",6 - 10 Jahre,859,472,387
False,8436082,"Weingarten, Stadt",10 - 15 Jahre,1268,685,583
False,8436082,"Weingarten, Stadt",15 - 18 Jahre,719,369,350
False,8436082,"Weingarten, Stadt",18 - 20 Jahre,567,288,279
False,8436082,"Weingarten, Stadt",20 - 25 Jahre,1523,760,763
False,8436082,"Weingarten, Stadt",25 - 30 Jahre,1668,898,770
False,8436082,"Weingarten, Stadt",30 - 35 Jahre,2046,1114,932
False,8436082,"Weingarten, Stadt",35 - 40 Jahre,2086,1107,979
False,8436082,"Weingarten, Stadt",40 - 45 Jahre,1731,851,880
False,8436082,"Weingarten, Stadt",45 - 50 Jahre,1562,764,798
False,8436082,"Weingarten, Stadt",50 - 55 Jahre,1333,637,696
False,8436082,"Weingarten, Stadt",55 - 60 Jahre,1354,656,698
False,8436082,"Weingarten, Stadt",60 - 65 Jahre,1646,820,826
False,8436082,"Weingarten, Stadt",65 - 75 Jahre,2188,960,1228
False,8436082,"Weingarten, Stadt",75 und mehr Jahre,1753,562,1191
False,8436082,"Weingarten, Stadt",Insgesamt,23604,11631,11973
False,8436083,Wilhelmsdorf,unter 3 Jahre,150,70,80
False,8436083,Wilhelmsdorf,3 -  6 Jahre,211,117,94
False,8436083,Wilhelmsdorf,6 - 10 Jahre,294,159,135
False,8436083,Wilhelmsdorf,10 - 15 Jahre,399,206,193
False,8436083,Wilhelmsdorf,15 - 18 Jahre,194,100,94
False,8436083,Wilhelmsdorf,18 - 20 Jahre,124,66,58
False,8436083,Wilhelmsdorf,20 - 25 Jahre,259,134,125
False,8436083,Wilhelmsdorf,25 - 30 Jahre,270,145,125
False,8436083,Wilhelmsdorf,30 - 35 Jahre,392,205,187
False,8436083,Wilhelmsdorf,35 - 40 Jahre,453,235,218
False,8436083,Wilhelmsdorf,40 - 45 Jahre,378,171,207
False,8436083,Wilhelmsdorf,45 - 50 Jahre,290,159,131
False,8436083,Wilhelmsdorf,50 - 55 Jahre,249,119,130
False,8436083,Wilhelmsdorf,55 - 60 Jahre,234,113,121
False,8436083,Wilhelmsdorf,60 - 65 Jahre,250,124,126
False,8436083,Wilhelmsdorf,65 - 75 Jahre,340,149,191
False,8436083,Wilhelmsdorf,75 und mehr Jahre,254,94,160
False,8436083,Wilhelmsdorf,Insgesamt,4741,2366,2375
False,8436085,Wolfegg,unter 3 Jahre,134,64,70
False,8436085,Wolfegg,3 -  6 Jahre,120,56,64
False,8436085,Wolfegg,6 - 10 Jahre,183,98,85
False,8436085,Wolfegg,10 - 15 Jahre,196,96,100
False,8436085,Wolfegg,15 - 18 Jahre,118,56,62
False,8436085,Wolfegg,18 - 20 Jahre,66,35,31
False,8436085,Wolfegg,20 - 25 Jahre,189,97,92
False,8436085,Wolfegg,25 - 30 Jahre,205,99,106
False,8436085,Wolfegg,30 - 35 Jahre,299,169,130
False,8436085,Wolfegg,35 - 40 Jahre,247,123,124
False,8436085,Wolfegg,40 - 45 Jahre,226,106,120
False,8436085,Wolfegg,45 - 50 Jahre,206,109,97
False,8436085,Wolfegg,50 - 55 Jahre,181,88,93
False,8436085,Wolfegg,55 - 60 Jahre,161,76,85
False,8436085,Wolfegg,60 - 65 Jahre,227,117,110
False,8436085,Wolfegg,65 - 75 Jahre,274,143,131
False,8436085,Wolfegg,75 und mehr Jahre,272,75,197
False,8436085,Wolfegg,Insgesamt,3304,1607,1697
False,8436087,Wolpertswende,unter 3 Jahre,138,65,73
False,8436087,Wolpertswende,3 -  6 Jahre,159,86,73
False,8436087,Wolpertswende,6 - 10 Jahre,219,110,109
False,8436087,Wolpertswende,10 - 15 Jahre,282,156,126
False,8436087,Wolpertswende,15 - 18 Jahre,149,70,79
False,8436087,Wolpertswende,18 - 20 Jahre,108,55,53
False,8436087,Wolpertswende,20 - 25 Jahre,242,123,119
False,8436087,Wolpertswende,25 - 30 Jahre,242,120,122
False,8436087,Wolpertswende,30 - 35 Jahre,354,170,184
False,8436087,Wolpertswende,35 - 40 Jahre,353,177,176
False,8436087,Wolpertswende,40 - 45 Jahre,317,157,160
False,8436087,Wolpertswende,45 - 50 Jahre,287,150,137
False,8436087,Wolpertswende,50 - 55 Jahre,246,140,106
False,8436087,Wolpertswende,55 - 60 Jahre,193,100,93
False,8436087,Wolpertswende,60 - 65 Jahre,258,130,128
False,8436087,Wolpertswende,65 - 75 Jahre,306,142,164
False,8436087,Wolpertswende,75 und mehr Jahre,191,57,134
False,8436087,Wolpertswende,Insgesamt,4044,2008,2036
False,8436093,Ebersbach-Musbach,unter 3 Jahre,87,47,40
False,8436093,Ebersbach-Musbach,3 -  6 Jahre,79,37,42
False,8436093,Ebersbach-Musbach,6 - 10 Jahre,105,55,50
False,8436093,Ebersbach-Musbach,10 - 15 Jahre,139,69,70
False,8436093,Ebersbach-Musbach,15 - 18 Jahre,59,25,34
False,8436093,Ebersbach-Musbach,18 - 20 Jahre,45,20,25
False,8436093,Ebersbach-Musbach,20 - 25 Jahre,98,59,39
False,8436093,Ebersbach-Musbach,25 - 30 Jahre,93,54,39
False,8436093,Ebersbach-Musbach,30 - 35 Jahre,136,72,64
False,8436093,Ebersbach-Musbach,35 - 40 Jahre,192,100,92
False,8436093,Ebersbach-Musbach,40 - 45 Jahre,173,99,74
False,8436093,Ebersbach-Musbach,45 - 50 Jahre,111,64,47
False,8436093,Ebersbach-Musbach,50 - 55 Jahre,65,33,32
False,8436093,Ebersbach-Musbach,55 - 60 Jahre,80,50,30
False,8436093,Ebersbach-Musbach,60 - 65 Jahre,92,55,37
False,8436093,Ebersbach-Musbach,65 - 75 Jahre,117,53,64
False,8436093,Ebersbach-Musbach,75 und mehr Jahre,88,30,58
False,8436093,Ebersbach-Musbach,Insgesamt,1759,922,837
False,8436094,Argenbühl,unter 3 Jahre,211,121,90
False,8436094,Argenbühl,3 -  6 Jahre,227,97,130
False,8436094,Argenbühl,6 - 10 Jahre,361,186,175
False,8436094,Argenbühl,10 - 15 Jahre,433,218,215
False,8436094,Argenbühl,15 - 18 Jahre,248,136,112
False,8436094,Argenbühl,18 - 20 Jahre,192,94,98
False,8436094,Argenbühl,20 - 25 Jahre,349,189,160
False,8436094,Argenbühl,25 - 30 Jahre,342,178,164
False,8436094,Argenbühl,30 - 35 Jahre,497,260,237
False,8436094,Argenbühl,35 - 40 Jahre,488,243,245
False,8436094,Argenbühl,40 - 45 Jahre,410,207,203
False,8436094,Argenbühl,45 - 50 Jahre,373,191,182
False,8436094,Argenbühl,50 - 55 Jahre,343,194,149
False,8436094,Argenbühl,55 - 60 Jahre,259,131,128
False,8436094,Argenbühl,60 - 65 Jahre,288,148,140
False,8436094,Argenbühl,65 - 75 Jahre,401,190,211
False,8436094,Argenbühl,75 und mehr Jahre,347,112,235
False,8436094,Argenbühl,Insgesamt,5769,2895,2874
False,8436095,Horgenzell,unter 3 Jahre,173,89,84
False,8436095,Horgenzell,3 -  6 Jahre,192,99,93
False,8436095,Horgenzell,6 - 10 Jahre,233,130,103
False,8436095,Horgenzell,10 - 15 Jahre,331,181,150
False,8436095,Horgenzell,15 - 18 Jahre,185,89,96
False,8436095,Horgenzell,18 - 20 Jahre,140,71,69
False,8436095,Horgenzell,20 - 25 Jahre,282,144,138
False,8436095,Horgenzell,25 - 30 Jahre,308,161,147
False,8436095,Horgenzell,30 - 35 Jahre,455,230,225
False,8436095,Horgenzell,35 - 40 Jahre,404,218,186
False,8436095,Horgenzell,40 - 45 Jahre,326,154,172
False,8436095,Horgenzell,45 - 50 Jahre,259,137,122
False,8436095,Horgenzell,50 - 55 Jahre,230,125,105
False,8436095,Horgenzell,55 - 60 Jahre,162,84,78
False,8436095,Horgenzell,60 - 65 Jahre,235,119,116
False,8436095,Horgenzell,65 - 75 Jahre,259,132,127
False,8436095,Horgenzell,75 und mehr Jahre,225,71,154
False,8436095,Horgenzell,Insgesamt,4399,2234,2165
False,8436096,Fronreute,unter 3 Jahre,182,90,92
False,8436096,Fronreute,3 -  6 Jahre,187,99,88
False,8436096,Fronreute,6 - 10 Jahre,256,130,126
False,8436096,Fronreute,10 - 15 Jahre,312,169,143
False,8436096,Fronreute,15 - 18 Jahre,159,83,76
False,8436096,Fronreute,18 - 20 Jahre,117,52,65
False,8436096,Fronreute,20 - 25 Jahre,229,119,110
False,8436096,Fronreute,25 - 30 Jahre,248,126,122
False,8436096,Fronreute,30 - 35 Jahre,401,187,214
False,8436096,Fronreute,35 - 40 Jahre,443,235,208
False,8436096,Fronreute,40 - 45 Jahre,340,173,167
False,8436096,Fronreute,45 - 50 Jahre,307,154,153
False,8436096,Fronreute,50 - 55 Jahre,244,132,112
False,8436096,Fronreute,55 - 60 Jahre,182,104,78
False,8436096,Fronreute,60 - 65 Jahre,212,110,102
False,8436096,Fronreute,65 - 75 Jahre,292,147,145
False,8436096,Fronreute,75 und mehr Jahre,188,60,128
False,8436096,Fronreute,Insgesamt,4299,2170,2129
False,8437,Landkreis Sigmaringen,unter 3 Jahre,4576,2374,2202
False,8437,Landkreis Sigmaringen,3 -  6 Jahre,4900,2461,2439
False,8437,Landkreis Sigmaringen,6 - 10 Jahre,6903,3546,3357
False,8437,Landkreis Sigmaringen,10 - 15 Jahre,9060,4680,4380
False,8437,Landkreis Sigmaringen,15 - 18 Jahre,5066,2516,2550
False,8437,Landkreis Sigmaringen,18 - 20 Jahre,3348,1772,1576
False,8437,Landkreis Sigmaringen,20 - 25 Jahre,7818,4189,3629
False,8437,Landkreis Sigmaringen,25 - 30 Jahre,8169,4185,3984
False,8437,Landkreis Sigmaringen,30 - 35 Jahre,11227,5990,5237
False,8437,Landkreis Sigmaringen,35 - 40 Jahre,12127,6369,5758
False,8437,Landkreis Sigmaringen,40 - 45 Jahre,10096,5197,4899
False,8437,Landkreis Sigmaringen,45 - 50 Jahre,8497,4252,4245
False,8437,Landkreis Sigmaringen,50 - 55 Jahre,7099,3673,3426
False,8437,Landkreis Sigmaringen,55 - 60 Jahre,6381,3199,3182
False,8437,Landkreis Sigmaringen,60 - 65 Jahre,8265,4024,4241
False,8437,Landkreis Sigmaringen,65 - 75 Jahre,11476,5281,6195
False,8437,Landkreis Sigmaringen,75 und mehr Jahre,8492,2635,5857
False,8437,Landkreis Sigmaringen,Insgesamt,133500,66343,67157
False,8437005,Beuron,unter 3 Jahre,22,12,10
False,8437005,Beuron,3 -  6 Jahre,23,11,12
False,8437005,Beuron,6 - 10 Jahre,28,16,12
False,8437005,Beuron,10 - 15 Jahre,43,22,21
False,8437005,Beuron,15 - 18 Jahre,14,5,9
False,8437005,Beuron,18 - 20 Jahre,17,6,11
False,8437005,Beuron,20 - 25 Jahre,35,19,16
False,8437005,Beuron,25 - 30 Jahre,21,11,10
False,8437005,Beuron,30 - 35 Jahre,37,18,19
False,8437005,Beuron,35 - 40 Jahre,54,33,21
False,8437005,Beuron,40 - 45 Jahre,54,26,28
False,8437005,Beuron,45 - 50 Jahre,51,31,20
False,8437005,Beuron,50 - 55 Jahre,59,24,35
False,8437005,Beuron,55 - 60 Jahre,45,32,13
False,8437005,Beuron,60 - 65 Jahre,71,39,32
False,8437005,Beuron,65 - 75 Jahre,90,52,38
False,8437005,Beuron,75 und mehr Jahre,107,35,72
False,8437005,Beuron,Insgesamt,771,392,379
False,8437008,Bingen,unter 3 Jahre,109,50,59
False,8437008,Bingen,3 -  6 Jahre,127,63,64
False,8437008,Bingen,6 - 10 Jahre,150,66,84
False,8437008,Bingen,10 - 15 Jahre,187,94,93
False,8437008,Bingen,15 - 18 Jahre,99,45,54
False,8437008,Bingen,18 - 20 Jahre,50,29,21
False,8437008,Bingen,20 - 25 Jahre,148,79,69
False,8437008,Bingen,25 - 30 Jahre,185,91,94
False,8437008,Bingen,30 - 35 Jahre,262,115,147
False,8437008,Bingen,35 - 40 Jahre,281,154,127
False,8437008,Bingen,40 - 45 Jahre,211,111,100
False,8437008,Bingen,45 - 50 Jahre,191,100,91
False,8437008,Bingen,50 - 55 Jahre,178,95,83
False,8437008,Bingen,55 - 60 Jahre,148,73,75
False,8437008,Bingen,60 - 65 Jahre,177,91,86
False,8437008,Bingen,65 - 75 Jahre,242,110,132
False,8437008,Bingen,75 und mehr Jahre,157,49,108
False,8437008,Bingen,Insgesamt,2902,1415,1487
False,8437031,"Gammertingen, Stadt",unter 3 Jahre,210,105,105
False,8437031,"Gammertingen, Stadt",3 -  6 Jahre,223,131,92
False,8437031,"Gammertingen, Stadt",6 - 10 Jahre,336,163,173
False,8437031,"Gammertingen, Stadt",10 - 15 Jahre,458,240,218
False,8437031,"Gammertingen, Stadt",15 - 18 Jahre,287,143,144
False,8437031,"Gammertingen, Stadt",18 - 20 Jahre,220,118,102
False,8437031,"Gammertingen, Stadt",20 - 25 Jahre,416,201,215
False,8437031,"Gammertingen, Stadt",25 - 30 Jahre,429,227,202
False,8437031,"Gammertingen, Stadt",30 - 35 Jahre,519,287,232
False,8437031,"Gammertingen, Stadt",35 - 40 Jahre,625,305,320
False,8437031,"Gammertingen, Stadt",40 - 45 Jahre,539,276,263
False,8437031,"Gammertingen, Stadt",45 - 50 Jahre,481,229,252
False,8437031,"Gammertingen, Stadt",50 - 55 Jahre,391,198,193
False,8437031,"Gammertingen, Stadt",55 - 60 Jahre,373,178,195
False,8437031,"Gammertingen, Stadt",60 - 65 Jahre,468,227,241
False,8437031,"Gammertingen, Stadt",65 - 75 Jahre,542,242,300
False,8437031,"Gammertingen, Stadt",75 und mehr Jahre,380,114,266
False,8437031,"Gammertingen, Stadt",Insgesamt,6897,3384,3513
False,8437044,Herbertingen,unter 3 Jahre,199,114,85
False,8437044,Herbertingen,3 -  6 Jahre,226,113,113
False,8437044,Herbertingen,6 - 10 Jahre,301,154,147
False,8437044,Herbertingen,10 - 15 Jahre,372,181,191
False,8437044,Herbertingen,15 - 18 Jahre,179,85,94
False,8437044,Herbertingen,18 - 20 Jahre,118,61,57
False,8437044,Herbertingen,20 - 25 Jahre,248,135,113
False,8437044,Herbertingen,25 - 30 Jahre,322,163,159
False,8437044,Herbertingen,30 - 35 Jahre,448,222,226
False,8437044,Herbertingen,35 - 40 Jahre,433,234,199
False,8437044,Herbertingen,40 - 45 Jahre,328,178,150
False,8437044,Herbertingen,45 - 50 Jahre,327,173,154
False,8437044,Herbertingen,50 - 55 Jahre,248,126,122
False,8437044,Herbertingen,55 - 60 Jahre,228,114,114
False,8437044,Herbertingen,60 - 65 Jahre,276,137,139
False,8437044,Herbertingen,65 - 75 Jahre,366,166,200
False,8437044,Herbertingen,75 und mehr Jahre,293,96,197
False,8437044,Herbertingen,Insgesamt,4912,2452,2460
False,8437047,"Hettingen, Stadt",unter 3 Jahre,69,35,34
False,8437047,"Hettingen, Stadt",3 -  6 Jahre,74,35,39
False,8437047,"Hettingen, Stadt",6 - 10 Jahre,123,57,66
False,8437047,"Hettingen, Stadt",10 - 15 Jahre,145,79,66
False,8437047,"Hettingen, Stadt",15 - 18 Jahre,87,45,42
False,8437047,"Hettingen, Stadt",18 - 20 Jahre,50,22,28
False,8437047,"Hettingen, Stadt",20 - 25 Jahre,105,64,41
False,8437047,"Hettingen, Stadt",25 - 30 Jahre,118,57,61
False,8437047,"Hettingen, Stadt",30 - 35 Jahre,168,94,74
False,8437047,"Hettingen, Stadt",35 - 40 Jahre,192,106,86
False,8437047,"Hettingen, Stadt",40 - 45 Jahre,161,82,79
False,8437047,"Hettingen, Stadt",45 - 50 Jahre,130,66,64
False,8437047,"Hettingen, Stadt",50 - 55 Jahre,104,57,47
False,8437047,"Hettingen, Stadt",55 - 60 Jahre,98,51,47
False,8437047,"Hettingen, Stadt",60 - 65 Jahre,141,69,72
False,8437047,"Hettingen, Stadt",65 - 75 Jahre,167,74,93
False,8437047,"Hettingen, Stadt",75 und mehr Jahre,98,41,57
False,8437047,"Hettingen, Stadt",Insgesamt,2030,1034,996
False,8437053,Hohentengen,unter 3 Jahre,151,84,67
False,8437053,Hohentengen,3 -  6 Jahre,184,88,96
False,8437053,Hohentengen,6 - 10 Jahre,239,125,114
False,8437053,Hohentengen,10 - 15 Jahre,321,181,140
False,8437053,Hohentengen,15 - 18 Jahre,146,62,84
False,8437053,Hohentengen,18 - 20 Jahre,100,54,46
False,8437053,Hohentengen,20 - 25 Jahre,232,139,93
False,8437053,Hohentengen,25 - 30 Jahre,273,150,123
False,8437053,Hohentengen,30 - 35 Jahre,491,324,167
False,8437053,Hohentengen,35 - 40 Jahre,454,277,177
False,8437053,Hohentengen,40 - 45 Jahre,317,166,151
False,8437053,Hohentengen,45 - 50 Jahre,268,150,118
False,8437053,Hohentengen,50 - 55 Jahre,218,119,99
False,8437053,Hohentengen,55 - 60 Jahre,181,91,90
False,8437053,Hohentengen,60 - 65 Jahre,270,137,133
False,8437053,Hohentengen,65 - 75 Jahre,340,165,175
False,8437053,Hohentengen,75 und mehr Jahre,230,73,157
False,8437053,Hohentengen,Insgesamt,4415,2385,2030
False,8437056,Illmensee,unter 3 Jahre,74,38,36
False,8437056,Illmensee,3 -  6 Jahre,70,36,34
False,8437056,Illmensee,6 - 10 Jahre,138,67,71
False,8437056,Illmensee,10 - 15 Jahre,154,86,68
False,8437056,Illmensee,15 - 18 Jahre,69,44,25
False,8437056,Illmensee,18 - 20 Jahre,49,25,24
False,8437056,Illmensee,20 - 25 Jahre,111,56,55
False,8437056,Illmensee,25 - 30 Jahre,113,58,55
False,8437056,Illmensee,30 - 35 Jahre,138,71,67
False,8437056,Illmensee,35 - 40 Jahre,166,82,84
False,8437056,Illmensee,40 - 45 Jahre,197,100,97
False,8437056,Illmensee,45 - 50 Jahre,153,80,73
False,8437056,Illmensee,50 - 55 Jahre,125,70,55
False,8437056,Illmensee,55 - 60 Jahre,67,32,35
False,8437056,Illmensee,60 - 65 Jahre,91,46,45
False,8437056,Illmensee,65 - 75 Jahre,155,76,79
False,8437056,Illmensee,75 und mehr Jahre,98,29,69
False,8437056,Illmensee,Insgesamt,1968,996,972
False,8437059,Inzigkofen,unter 3 Jahre,120,73,47
False,8437059,Inzigkofen,3 -  6 Jahre,93,33,60
False,8437059,Inzigkofen,6 - 10 Jahre,115,59,56
False,8437059,Inzigkofen,10 - 15 Jahre,224,109,115
False,8437059,Inzigkofen,15 - 18 Jahre,100,54,46
False,8437059,Inzigkofen,18 - 20 Jahre,68,32,36
False,8437059,Inzigkofen,20 - 25 Jahre,156,74,82
False,8437059,Inzigkofen,25 - 30 Jahre,152,77,75
False,8437059,Inzigkofen,30 - 35 Jahre,239,127,112
False,8437059,Inzigkofen,35 - 40 Jahre,280,140,140
False,8437059,Inzigkofen,40 - 45 Jahre,240,130,110
False,8437059,Inzigkofen,45 - 50 Jahre,184,87,97
False,8437059,Inzigkofen,50 - 55 Jahre,160,83,77
False,8437059,Inzigkofen,55 - 60 Jahre,126,65,61
False,8437059,Inzigkofen,60 - 65 Jahre,166,92,74
False,8437059,Inzigkofen,65 - 75 Jahre,273,132,141
False,8437059,Inzigkofen,75 und mehr Jahre,164,54,110
False,8437059,Inzigkofen,Insgesamt,2860,1421,1439
False,8437065,Krauchenwies,unter 3 Jahre,156,81,75
False,8437065,Krauchenwies,3 -  6 Jahre,214,112,102
False,8437065,Krauchenwies,6 - 10 Jahre,293,154,139
False,8437065,Krauchenwies,10 - 15 Jahre,347,169,178
False,8437065,Krauchenwies,15 - 18 Jahre,212,101,111
False,8437065,Krauchenwies,18 - 20 Jahre,151,80,71
False,8437065,Krauchenwies,20 - 25 Jahre,330,177,153
False,8437065,Krauchenwies,25 - 30 Jahre,287,153,134
False,8437065,Krauchenwies,30 - 35 Jahre,404,199,205
False,8437065,Krauchenwies,35 - 40 Jahre,426,212,214
False,8437065,Krauchenwies,40 - 45 Jahre,438,228,210
False,8437065,Krauchenwies,45 - 50 Jahre,369,191,178
False,8437065,Krauchenwies,50 - 55 Jahre,252,129,123
False,8437065,Krauchenwies,55 - 60 Jahre,219,114,105
False,8437065,Krauchenwies,60 - 65 Jahre,279,134,145
False,8437065,Krauchenwies,65 - 75 Jahre,399,179,220
False,8437065,Krauchenwies,75 und mehr Jahre,268,80,188
False,8437065,Krauchenwies,Insgesamt,5044,2493,2551
False,8437072,Leibertingen,unter 3 Jahre,76,43,33
False,8437072,Leibertingen,3 -  6 Jahre,93,42,51
False,8437072,Leibertingen,6 - 10 Jahre,102,59,43
False,8437072,Leibertingen,10 - 15 Jahre,166,79,87
False,8437072,Leibertingen,15 - 18 Jahre,91,53,38
False,8437072,Leibertingen,18 - 20 Jahre,53,26,27
False,8437072,Leibertingen,20 - 25 Jahre,124,66,58
False,8437072,Leibertingen,25 - 30 Jahre,139,73,66
False,8437072,Leibertingen,30 - 35 Jahre,201,108,93
False,8437072,Leibertingen,35 - 40 Jahre,225,120,105
False,8437072,Leibertingen,40 - 45 Jahre,189,107,82
False,8437072,Leibertingen,45 - 50 Jahre,131,64,67
False,8437072,Leibertingen,50 - 55 Jahre,107,52,55
False,8437072,Leibertingen,55 - 60 Jahre,94,53,41
False,8437072,Leibertingen,60 - 65 Jahre,141,78,63
False,8437072,Leibertingen,65 - 75 Jahre,212,100,112
False,8437072,Leibertingen,75 und mehr Jahre,103,35,68
False,8437072,Leibertingen,Insgesamt,2247,1158,1089
False,8437076,"Mengen, Stadt",unter 3 Jahre,359,185,174
False,8437076,"Mengen, Stadt",3 -  6 Jahre,353,168,185
False,8437076,"Mengen, Stadt",6 - 10 Jahre,520,267,253
False,8437076,"Mengen, Stadt",10 - 15 Jahre,676,367,309
False,8437076,"Mengen, Stadt",15 - 18 Jahre,323,179,144
False,8437076,"Mengen, Stadt",18 - 20 Jahre,243,139,104
False,8437076,"Mengen, Stadt",20 - 25 Jahre,539,278,261
False,8437076,"Mengen, Stadt",25 - 30 Jahre,649,329,320
False,8437076,"Mengen, Stadt",30 - 35 Jahre,797,389,408
False,8437076,"Mengen, Stadt",35 - 40 Jahre,876,452,424
False,8437076,"Mengen, Stadt",40 - 45 Jahre,723,370,353
False,8437076,"Mengen, Stadt",45 - 50 Jahre,650,327,323
False,8437076,"Mengen, Stadt",50 - 55 Jahre,572,305,267
False,8437076,"Mengen, Stadt",55 - 60 Jahre,511,242,269
False,8437076,"Mengen, Stadt",60 - 65 Jahre,685,345,340
False,8437076,"Mengen, Stadt",65 - 75 Jahre,910,403,507
False,8437076,"Mengen, Stadt",75 und mehr Jahre,671,200,471
False,8437076,"Mengen, Stadt",Insgesamt,10057,4945,5112
False,8437078,"Meßkirch, Stadt",unter 3 Jahre,297,148,149
False,8437078,"Meßkirch, Stadt",3 -  6 Jahre,308,168,140
False,8437078,"Meßkirch, Stadt",6 - 10 Jahre,487,245,242
False,8437078,"Meßkirch, Stadt",10 - 15 Jahre,683,360,323
False,8437078,"Meßkirch, Stadt",15 - 18 Jahre,370,184,186
False,8437078,"Meßkirch, Stadt",18 - 20 Jahre,222,112,110
False,8437078,"Meßkirch, Stadt",20 - 25 Jahre,529,272,257
False,8437078,"Meßkirch, Stadt",25 - 30 Jahre,507,259,248
False,8437078,"Meßkirch, Stadt",30 - 35 Jahre,636,318,318
False,8437078,"Meßkirch, Stadt",35 - 40 Jahre,786,394,392
False,8437078,"Meßkirch, Stadt",40 - 45 Jahre,663,361,302
False,8437078,"Meßkirch, Stadt",45 - 50 Jahre,542,277,265
False,8437078,"Meßkirch, Stadt",50 - 55 Jahre,438,221,217
False,8437078,"Meßkirch, Stadt",55 - 60 Jahre,355,180,175
False,8437078,"Meßkirch, Stadt",60 - 65 Jahre,521,237,284
False,8437078,"Meßkirch, Stadt",65 - 75 Jahre,837,387,450
False,8437078,"Meßkirch, Stadt",75 und mehr Jahre,575,176,399
False,8437078,"Meßkirch, Stadt",Insgesamt,8756,4299,4457
False,8437082,Neufra,unter 3 Jahre,60,33,27
False,8437082,Neufra,3 -  6 Jahre,71,32,39
False,8437082,Neufra,6 - 10 Jahre,92,46,46
False,8437082,Neufra,10 - 15 Jahre,115,55,60
False,8437082,Neufra,15 - 18 Jahre,85,38,47
False,8437082,Neufra,18 - 20 Jahre,48,18,30
False,8437082,Neufra,20 - 25 Jahre,91,45,46
False,8437082,Neufra,25 - 30 Jahre,110,53,57
False,8437082,Neufra,30 - 35 Jahre,146,73,73
False,8437082,Neufra,35 - 40 Jahre,166,82,84
False,8437082,Neufra,40 - 45 Jahre,185,89,96
False,8437082,Neufra,45 - 50 Jahre,134,73,61
False,8437082,Neufra,50 - 55 Jahre,99,42,57
False,8437082,Neufra,55 - 60 Jahre,106,57,49
False,8437082,Neufra,60 - 65 Jahre,133,74,59
False,8437082,Neufra,65 - 75 Jahre,164,70,94
False,8437082,Neufra,75 und mehr Jahre,129,36,93
False,8437082,Neufra,Insgesamt,1934,916,1018
False,8437086,Ostrach,unter 3 Jahre,273,148,125
False,8437086,Ostrach,3 -  6 Jahre,270,127,143
False,8437086,Ostrach,6 - 10 Jahre,419,214,205
False,8437086,Ostrach,10 - 15 Jahre,556,271,285
False,8437086,Ostrach,15 - 18 Jahre,317,161,156
False,8437086,Ostrach,18 - 20 Jahre,157,83,74
False,8437086,Ostrach,20 - 25 Jahre,354,191,163
False,8437086,Ostrach,25 - 30 Jahre,388,188,200
False,8437086,Ostrach,30 - 35 Jahre,568,296,272
False,8437086,Ostrach,35 - 40 Jahre,615,295,320
False,8437086,Ostrach,40 - 45 Jahre,555,272,283
False,8437086,Ostrach,45 - 50 Jahre,456,253,203
False,8437086,Ostrach,50 - 55 Jahre,316,169,147
False,8437086,Ostrach,55 - 60 Jahre,284,133,151
False,8437086,Ostrach,60 - 65 Jahre,371,185,186
False,8437086,Ostrach,65 - 75 Jahre,541,250,291
False,8437086,Ostrach,75 und mehr Jahre,389,113,276
False,8437086,Ostrach,Insgesamt,6829,3349,3480
False,8437088,"Pfullendorf, Stadt",unter 3 Jahre,513,274,239
False,8437088,"Pfullendorf, Stadt",3 -  6 Jahre,521,262,259
False,8437088,"Pfullendorf, Stadt",6 - 10 Jahre,756,404,352
False,8437088,"Pfullendorf, Stadt",10 - 15 Jahre,902,480,422
False,8437088,"Pfullendorf, Stadt",15 - 18 Jahre,522,268,254
False,8437088,"Pfullendorf, Stadt",18 - 20 Jahre,341,186,155
False,8437088,"Pfullendorf, Stadt",20 - 25 Jahre,825,437,388
False,8437088,"Pfullendorf, Stadt",25 - 30 Jahre,915,468,447
False,8437088,"Pfullendorf, Stadt",30 - 35 Jahre,1077,582,495
False,8437088,"Pfullendorf, Stadt",35 - 40 Jahre,1258,691,567
False,8437088,"Pfullendorf, Stadt",40 - 45 Jahre,1031,550,481
False,8437088,"Pfullendorf, Stadt",45 - 50 Jahre,773,382,391
False,8437088,"Pfullendorf, Stadt",50 - 55 Jahre,712,365,347
False,8437088,"Pfullendorf, Stadt",55 - 60 Jahre,631,322,309
False,8437088,"Pfullendorf, Stadt",60 - 65 Jahre,775,388,387
False,8437088,"Pfullendorf, Stadt",65 - 75 Jahre,1002,467,535
False,8437088,"Pfullendorf, Stadt",75 und mehr Jahre,636,212,424
False,8437088,"Pfullendorf, Stadt",Insgesamt,13190,6738,6452
False,8437100,"Bad Saulgau, Stadt",unter 3 Jahre,627,323,304
False,8437100,"Bad Saulgau, Stadt",3 -  6 Jahre,625,298,327
False,8437100,"Bad Saulgau, Stadt",6 - 10 Jahre,791,413,378
False,8437100,"Bad Saulgau, Stadt",10 - 15 Jahre,1111,571,540
False,8437100,"Bad Saulgau, Stadt",15 - 18 Jahre,688,342,346
False,8437100,"Bad Saulgau, Stadt",18 - 20 Jahre,416,225,191
False,8437100,"Bad Saulgau, Stadt",20 - 25 Jahre,1041,535,506
False,8437100,"Bad Saulgau, Stadt",25 - 30 Jahre,1121,539,582
False,8437100,"Bad Saulgau, Stadt",30 - 35 Jahre,1405,706,699
False,8437100,"Bad Saulgau, Stadt",35 - 40 Jahre,1402,708,694
False,8437100,"Bad Saulgau, Stadt",40 - 45 Jahre,1219,593,626
False,8437100,"Bad Saulgau, Stadt",45 - 50 Jahre,1083,491,592
False,8437100,"Bad Saulgau, Stadt",50 - 55 Jahre,959,501,458
False,8437100,"Bad Saulgau, Stadt",55 - 60 Jahre,895,442,453
False,8437100,"Bad Saulgau, Stadt",60 - 65 Jahre,1140,536,604
False,8437100,"Bad Saulgau, Stadt",65 - 75 Jahre,1671,740,931
False,8437100,"Bad Saulgau, Stadt",75 und mehr Jahre,1410,435,975
False,8437100,"Bad Saulgau, Stadt",Insgesamt,17604,8398,9206
False,8437101,"Scheer, Stadt",unter 3 Jahre,90,45,45
False,8437101,"Scheer, Stadt",3 -  6 Jahre,99,57,42
False,8437101,"Scheer, Stadt",6 - 10 Jahre,151,73,78
False,8437101,"Scheer, Stadt",10 - 15 Jahre,167,96,71
False,8437101,"Scheer, Stadt",15 - 18 Jahre,86,44,42
False,8437101,"Scheer, Stadt",18 - 20 Jahre,68,41,27
False,8437101,"Scheer, Stadt",20 - 25 Jahre,153,71,82
False,8437101,"Scheer, Stadt",25 - 30 Jahre,147,77,70
False,8437101,"Scheer, Stadt",30 - 35 Jahre,224,102,122
False,8437101,"Scheer, Stadt",35 - 40 Jahre,245,125,120
False,8437101,"Scheer, Stadt",40 - 45 Jahre,218,106,112
False,8437101,"Scheer, Stadt",45 - 50 Jahre,176,88,88
False,8437101,"Scheer, Stadt",50 - 55 Jahre,171,89,82
False,8437101,"Scheer, Stadt",55 - 60 Jahre,115,58,57
False,8437101,"Scheer, Stadt",60 - 65 Jahre,168,82,86
False,8437101,"Scheer, Stadt",65 - 75 Jahre,236,118,118
False,8437101,"Scheer, Stadt",75 und mehr Jahre,177,60,117
False,8437101,"Scheer, Stadt",Insgesamt,2691,1332,1359
False,8437102,Schwenningen,unter 3 Jahre,76,40,36
False,8437102,Schwenningen,3 -  6 Jahre,74,42,32
False,8437102,Schwenningen,6 - 10 Jahre,99,45,54
False,8437102,Schwenningen,10 - 15 Jahre,124,54,70
False,8437102,Schwenningen,15 - 18 Jahre,75,40,35
False,8437102,Schwenningen,18 - 20 Jahre,51,22,29
False,8437102,Schwenningen,20 - 25 Jahre,72,38,34
False,8437102,Schwenningen,25 - 30 Jahre,78,40,38
False,8437102,Schwenningen,30 - 35 Jahre,111,51,60
False,8437102,Schwenningen,35 - 40 Jahre,168,95,73
False,8437102,Schwenningen,40 - 45 Jahre,115,54,61
False,8437102,Schwenningen,45 - 50 Jahre,111,61,50
False,8437102,Schwenningen,50 - 55 Jahre,74,35,39
False,8437102,Schwenningen,55 - 60 Jahre,81,45,36
False,8437102,Schwenningen,60 - 65 Jahre,109,45,64
False,8437102,Schwenningen,65 - 75 Jahre,157,82,75
False,8437102,Schwenningen,75 und mehr Jahre,89,21,68
False,8437102,Schwenningen,Insgesamt,1664,810,854
False,8437104,"Sigmaringen, Stadt",unter 3 Jahre,445,218,227
False,8437104,"Sigmaringen, Stadt",3 -  6 Jahre,525,279,246
False,8437104,"Sigmaringen, Stadt",6 - 10 Jahre,684,365,319
False,8437104,"Sigmaringen, Stadt",10 - 15 Jahre,954,500,454
False,8437104,"Sigmaringen, Stadt",15 - 18 Jahre,581,277,304
False,8437104,"Sigmaringen, Stadt",18 - 20 Jahre,428,222,206
False,8437104,"Sigmaringen, Stadt",20 - 25 Jahre,1076,610,466
False,8437104,"Sigmaringen, Stadt",25 - 30 Jahre,1049,542,507
False,8437104,"Sigmaringen, Stadt",30 - 35 Jahre,1589,977,612
False,8437104,"Sigmaringen, Stadt",35 - 40 Jahre,1732,1026,706
False,8437104,"Sigmaringen, Stadt",40 - 45 Jahre,1161,578,583
False,8437104,"Sigmaringen, Stadt",45 - 50 Jahre,1012,488,524
False,8437104,"Sigmaringen, Stadt",50 - 55 Jahre,853,445,408
False,8437104,"Sigmaringen, Stadt",55 - 60 Jahre,858,410,448
False,8437104,"Sigmaringen, Stadt",60 - 65 Jahre,1056,479,577
False,8437104,"Sigmaringen, Stadt",65 - 75 Jahre,1424,629,795
False,8437104,"Sigmaringen, Stadt",75 und mehr Jahre,1324,417,907
False,8437104,"Sigmaringen, Stadt",Insgesamt,16751,8462,8289
False,8437105,Sigmaringendorf,unter 3 Jahre,109,59,50
False,8437105,Sigmaringendorf,3 -  6 Jahre,117,69,48
False,8437105,Sigmaringendorf,6 - 10 Jahre,180,88,92
False,8437105,Sigmaringendorf,10 - 15 Jahre,211,104,107
False,8437105,Sigmaringendorf,15 - 18 Jahre,136,61,75
False,8437105,Sigmaringendorf,18 - 20 Jahre,92,54,38
False,8437105,Sigmaringendorf,20 - 25 Jahre,192,104,88
False,8437105,Sigmaringendorf,25 - 30 Jahre,186,92,94
False,8437105,Sigmaringendorf,30 - 35 Jahre,271,145,126
False,8437105,Sigmaringendorf,35 - 40 Jahre,296,149,147
False,8437105,Sigmaringendorf,40 - 45 Jahre,260,132,128
False,8437105,Sigmaringendorf,45 - 50 Jahre,235,118,117
False,8437105,Sigmaringendorf,50 - 55 Jahre,250,119,131
False,8437105,Sigmaringendorf,55 - 60 Jahre,248,131,117
False,8437105,Sigmaringendorf,60 - 65 Jahre,274,137,137
False,8437105,Sigmaringendorf,65 - 75 Jahre,364,170,194
False,8437105,Sigmaringendorf,75 und mehr Jahre,253,72,181
False,8437105,Sigmaringendorf,Insgesamt,3674,1804,1870
False,8437107,Stetten am kalten Markt,unter 3 Jahre,182,90,92
False,8437107,Stetten am kalten Markt,3 -  6 Jahre,222,106,116
False,8437107,Stetten am kalten Markt,6 - 10 Jahre,274,127,147
False,8437107,Stetten am kalten Markt,10 - 15 Jahre,376,191,185
False,8437107,Stetten am kalten Markt,15 - 18 Jahre,205,103,102
False,8437107,Stetten am kalten Markt,18 - 20 Jahre,138,82,56
False,8437107,Stetten am kalten Markt,20 - 25 Jahre,451,309,142
False,8437107,Stetten am kalten Markt,25 - 30 Jahre,377,238,139
False,8437107,Stetten am kalten Markt,30 - 35 Jahre,543,346,197
False,8437107,Stetten am kalten Markt,35 - 40 Jahre,452,206,246
False,8437107,Stetten am kalten Markt,40 - 45 Jahre,368,194,174
False,8437107,Stetten am kalten Markt,45 - 50 Jahre,357,189,168
False,8437107,Stetten am kalten Markt,50 - 55 Jahre,274,137,137
False,8437107,Stetten am kalten Markt,55 - 60 Jahre,277,146,131
False,8437107,Stetten am kalten Markt,60 - 65 Jahre,323,163,160
False,8437107,Stetten am kalten Markt,65 - 75 Jahre,487,223,264
False,8437107,Stetten am kalten Markt,75 und mehr Jahre,370,104,266
False,8437107,Stetten am kalten Markt,Insgesamt,5676,2954,2722
False,8437114,"Veringenstadt, Stadt",unter 3 Jahre,83,41,42
False,8437114,"Veringenstadt, Stadt",3 -  6 Jahre,95,50,45
False,8437114,"Veringenstadt, Stadt",6 - 10 Jahre,144,83,61
False,8437114,"Veringenstadt, Stadt",10 - 15 Jahre,151,81,70
False,8437114,"Veringenstadt, Stadt",15 - 18 Jahre,89,49,40
False,8437114,"Veringenstadt, Stadt",18 - 20 Jahre,54,27,27
False,8437114,"Veringenstadt, Stadt",20 - 25 Jahre,134,70,64
False,8437114,"Veringenstadt, Stadt",25 - 30 Jahre,147,74,73
False,8437114,"Veringenstadt, Stadt",30 - 35 Jahre,177,90,87
False,8437114,"Veringenstadt, Stadt",35 - 40 Jahre,174,89,85
False,8437114,"Veringenstadt, Stadt",40 - 45 Jahre,189,100,89
False,8437114,"Veringenstadt, Stadt",45 - 50 Jahre,161,72,89
False,8437114,"Veringenstadt, Stadt",50 - 55 Jahre,155,83,72
False,8437114,"Veringenstadt, Stadt",55 - 60 Jahre,110,56,54
False,8437114,"Veringenstadt, Stadt",60 - 65 Jahre,158,81,77
False,8437114,"Veringenstadt, Stadt",65 - 75 Jahre,205,94,111
False,8437114,"Veringenstadt, Stadt",75 und mehr Jahre,135,48,87
False,8437114,"Veringenstadt, Stadt",Insgesamt,2361,1188,1173
False,8437118,Wald,unter 3 Jahre,89,40,49
False,8437118,Wald,3 -  6 Jahre,72,34,38
False,8437118,Wald,6 - 10 Jahre,159,83,76
False,8437118,Wald,10 - 15 Jahre,216,112,104
False,8437118,Wald,15 - 18 Jahre,105,34,71
False,8437118,Wald,18 - 20 Jahre,94,36,58
False,8437118,Wald,20 - 25 Jahre,189,80,109
False,8437118,Wald,25 - 30 Jahre,161,64,97
False,8437118,Wald,30 - 35 Jahre,291,106,185
False,8437118,Wald,35 - 40 Jahre,233,117,116
False,8437118,Wald,40 - 45 Jahre,223,113,110
False,8437118,Wald,45 - 50 Jahre,174,91,83
False,8437118,Wald,50 - 55 Jahre,118,61,57
False,8437118,Wald,55 - 60 Jahre,86,50,36
False,8437118,Wald,60 - 65 Jahre,167,72,95
False,8437118,Wald,65 - 75 Jahre,223,107,116
False,8437118,Wald,75 und mehr Jahre,149,38,111
False,8437118,Wald,Insgesamt,2749,1238,1511
False,8437123,Sauldorf,unter 3 Jahre,100,53,47
False,8437123,Sauldorf,3 -  6 Jahre,108,52,56
False,8437123,Sauldorf,6 - 10 Jahre,147,78,69
False,8437123,Sauldorf,10 - 15 Jahre,178,97,81
False,8437123,Sauldorf,15 - 18 Jahre,91,39,52
False,8437123,Sauldorf,18 - 20 Jahre,45,25,20
False,8437123,Sauldorf,20 - 25 Jahre,101,52,49
False,8437123,Sauldorf,25 - 30 Jahre,128,68,60
False,8437123,Sauldorf,30 - 35 Jahre,232,122,110
False,8437123,Sauldorf,35 - 40 Jahre,230,110,120
False,8437123,Sauldorf,40 - 45 Jahre,218,118,100
False,8437123,Sauldorf,45 - 50 Jahre,129,69,60
False,8437123,Sauldorf,50 - 55 Jahre,96,52,44
False,8437123,Sauldorf,55 - 60 Jahre,96,41,55
False,8437123,Sauldorf,60 - 65 Jahre,151,80,71
False,8437123,Sauldorf,65 - 75 Jahre,250,129,121
False,8437123,Sauldorf,75 und mehr Jahre,137,41,96
False,8437123,Sauldorf,Insgesamt,2437,1226,1211
False,8437124,Herdwangen-Schönach,unter 3 Jahre,87,42,45
False,8437124,Herdwangen-Schönach,3 -  6 Jahre,113,53,60
False,8437124,Herdwangen-Schönach,6 - 10 Jahre,175,95,80
False,8437124,Herdwangen-Schönach,10 - 15 Jahre,223,101,122
False,8437124,Herdwangen-Schönach,15 - 18 Jahre,109,60,49
False,8437124,Herdwangen-Schönach,18 - 20 Jahre,75,47,28
False,8437124,Herdwangen-Schönach,20 - 25 Jahre,166,87,79
False,8437124,Herdwangen-Schönach,25 - 30 Jahre,167,94,73
False,8437124,Herdwangen-Schönach,30 - 35 Jahre,253,122,131
False,8437124,Herdwangen-Schönach,35 - 40 Jahre,358,167,191
False,8437124,Herdwangen-Schönach,40 - 45 Jahre,294,163,131
False,8437124,Herdwangen-Schönach,45 - 50 Jahre,219,102,117
False,8437124,Herdwangen-Schönach,50 - 55 Jahre,170,96,74
False,8437124,Herdwangen-Schönach,55 - 60 Jahre,149,83,66
False,8437124,Herdwangen-Schönach,60 - 65 Jahre,154,70,84
False,8437124,Herdwangen-Schönach,65 - 75 Jahre,219,116,103
False,8437124,Herdwangen-Schönach,75 und mehr Jahre,150,56,94
False,8437124,Herdwangen-Schönach,Insgesamt,3081,1554,1527
